OTIXFEXWODTH    : FXKSCECIIYYVLX  AOMTRAWKE       ILARNR          PLDHVBDS        FGQXIUHCMII    
SEHRMK          : RQNTAPYWJOVED   XSUCNJP         DKOQIXCISBU    
XFONMTQFMIPDDA  : EUNLOO          EYPK            HHFIUXL         MDDRT           DWTM            XOCCAAVRUL     
KECHVFEDEWJ     : INAYDCCSXHJETEJ WSPG            IXSXFRVLWTKK    YOGVVAJEIILDL  
OWBD            : AXNGG           MJAYA           SHBBF          
GUKSQEXDO       : KVGNXXICI       XOGGIAWCGISPT   VFMIERM         OVXWP           AHAWRIKHTJUBTR 
JTSLF           : QDHYOPOSBOS     HAQAMDQCDUPHETH QNIMLJVPT       WXWGVNNN        NJNXVYTXF      
POVUSBBQLPHKQLH : CPDDHHLIXDW     XQKPXIIE        QIOPFWWDBBVLSD  QIILKBDKGUEIUR  LPQMGAINJB     
GTSYAQFPJOLDCQ  : HGMIDRVQ        KHBOTNF         IYQNCVA         IOVQWRSOMJTIE  
RGYMYCPRN       : XWNSSVCRGJMDWTA TXFOTAWTXM      RPRDSLCEFYSYQDB
AAWNJWVE        : BJHDTBCRSCKI    FLIABXMVPEOKCN  MWSM           
UGIA            : EWMKFFHUXC      YNGQDC          QIOPFWWDBBVLSD  KRMNGYAJPEWCYVP MKALHFY         FLUGGNDYLVLST  
SOIXQBBKHCYJGP  : WFHLTQSMDJXRLBT IDPAKWDLSKPRUJW EFUXEECVJMKDAW 
UVBUUQF         : HHKPHTKLPU      NCFO            EYTM            QYOENDJDUEPWLN  GWCLLNDN        BRKG            FPUTVVWEKLSY   
MLJIRSIQNA      : ETVUQ           PQNAYN         
NSCQGMU         : JHPCW           PHFIMHU         LDTMHFIGSNQBOS  NJNXVYTXF      
VBUYXS          : MCHXA           EYPK            GVLLJPBDHEXKHT  VREVR           NNGABLRQMYP    
TOTBIHOS        : PWQWYQFLDDYYRXN VHDLCNMODO      ULYN            PIOCBCY         YQHQPKHFSUQES   FGQXIUHCMII    
INAYDCCSXHJETEJ : KECHVFEDEWJ     VGRDYVODRA      ETVUQ           SQOESYASMEW     VBMPFYABWVI     BDCUEMENRRDSA  
FHQGA           : XQHHAHKCDKWYN   MHLMHTMWXYJKELP DLUMK           WKENSVXKDHLN    BGCIDAHR        SUKXNIFGNNIHQK  EPOMU          
AQQDCXTWPCM     : KYFOFI          GUIDHTKIFQFSWS  ODDGWKODPENQ    DMFJMCTKGVWLVR  USTHJK         
ERUG            : FYYXIXGMKD      EUVJMAXTKNFIOKB OIBHFTOXEPAP    WQGLBCYHH       YDJGELQOP       HESDRDGMVSH    
SNTWJAIDH       : YDAOFBNVOFJ     SYCDWEFS       
WNSSPLJUNJ      : UHTMGIYHRBUOI   KVWN            MKALHFY         DBCBJXTPTNFMU   JYIBBCGDPVJNGWV
KYRYPVQMEBFSW   : KDCNF           MURRSUVWKU      MHVLGC         
EWMKFFHUXC      : UGIA            XIYYXFOE        WCBHRMLQ        IDBPOVHIGWNLOO  CAIMOVSRPOMWVG  VOXIMDMXGT      DWTM            DBCBJXTPTNFMU  
JMGAXVMXPM      : CHPAPDCGTKE     RGHXALWBCVXNARW PRKLWDRHFCIA    IABE           
LDCPHHKELRCX    : HXXHAOCM        XCVKWAO        
JFLEDNRPCBR     : DHFMVJVQX       UJVNVH          GPWHYEET        XOCCAAVRUL      XSHBH           XAXTFCSRNGCGMS 
WEYMSO          : XQIHVGYCEKWG    MXKDC           KIVITYPPLXWEGPD EIJIMDJA        KCIBSMXIICTLLBP MVLTNWO         VHDLCNMODO      OCLRLHUQC      
WEYMSO          : PIOCBCY        
WSPG            : KECHVFEDEWJ     UINIFN          WIETBV          NRRFNBEJWYKLYX  SHDITUUI       
DKNUONYXTKF     : BHCVJALPJCBXA   AXNGG           BMQEOBSXOSAM    YAKJCBXGXAOFPA 
AYOF            : QIJNX           IJYVCRJ        
GGWNHLGXLFQEL   : CNJSRGFGTWMBR   XQKPXIIE        MHANQVC        
HWGELVDMPPTPPS  : JIOPJKS         KORYQKKC        YNGQDC          AHKXHCEHQMJ     VCFSNCCTPWCV   
UTNDSBMHHMU     : VGRDYVODRA      OXQYQTBNKQXTH   KIVCMPXBOMMBNC 
FYYXIXGMKD      : ERUG            MGVXEDXWNOBRSAH WHRNCNQX       
YUHUKXNRUJFBFGN : VQDXJBMESMLSWV  PXFBVOIFXGWXDQ  BDYELODGXNW    
PBHFIJFJRDPHPUY : QKBTRXN         WETGQQNWMGHOYJ  LVDREMYJUVKGTYI PIOCBCY         IYQNCVA        
QHLBHCUELAF     : ETVRFXQGGKGUYV 
ITFBWPGHBL      : AHAWRIKHTJUBTR  UPFTSAPTBWQCXMN
URHCJE          : LYLTOBANYGKP    FGRSPSG         XSKVPBTWTET     FNWCNQUUF       BROKN           UNKWDNTCHJWLPD  ACNJTHUJHATV    ASDW           
BUNOYWQTBFWH    : KHLSGGUJAWCIL   OLXIQSUS        BNBGQADAUDIRDJ 
HDIIAXPJYBBV    : AOMTRAWKE       VRRUICH         FMJBASXY        IJYVCRJ        
KYFOFI          : AQQDCXTWPCM     EUNLOO          TNFCMWKBGFAUCSU WXVKQDHAL       IYQNCVA         GYXEVCKRNDFC   
UYNRSJSAGA      : OXWKEQH         OWTCQV          XNSLM           LXTCVXDW       
ODIYFIOPJSQ     : HIQTHAL         NCFO            IMDLGNTJSI      SUVRGXV        
NDHURMFG        : PYEPQG          OBJPDJDIBK     
FTYAETAMUADALD  : WBEEPWDF        HAREORCO        IYQNCVA        
TRAE            : SMOTIHLR        VSHIVKSDHANERWM
QKBTRXN         : PBHFIJFJRDPHPUY SVPXYTYKQLOAJQL FLIABXMVPEOKCN  UHTMGIYHRBUOI   IOOLMXFRPGFI    JYIBBCGDPVJNGWV
EUNLOO          : XFONMTQFMIPDDA  KYFOFI          OHRPJHYGX       RKBSIWUYCWA     ACNJTHUJHATV    EPOMU           XOCCAAVRUL     
UINIFN          : WSPG            IGUDFRDL        GPWHYEET        TVAE           
GBOQVHQATJMUFEV : XEANEKSGBU      XSKVPBTWTET     FOXNLKQQCMK    
KAPAN           : VJQJIGB         CAIMOVSRPOMWVG  YHDMDTGP        QLOGNSUK       
QBCYOMHCYPGPGC  : WOWA            AXFJRHP         LIKHAQFC        MDDRT           LJMQHGJVAFXXQM  CDXWKXCAMFYSRY 
WETGQQNWMGHOYJ  : PBHFIJFJRDPHPUY FOMEWX          OLPRMSPALU      FKBVFYXAYSVRDSF KHWMFTF         YDTCTHPAPVWVPF  SCTBJHGQDKXUFR 
GAFKB           : KJLLAYYHR       EAACHSKTVMPRONI ILARNR          HLLKXDDIDFQ     LAUWRAYMBGWF   
XIYYXFOE        : EWMKFFHUXC      QMLOUWNW        DLNSJ           GWCLLNDN        EKTUSTEBEITTA  
QDNMLEDYBSIKJH  : WPVNTTHHYIGSTN  BAAFBVRLSIKU    LXTCVXDW        BWLWLI          TEXMYJPCBU      FTLMHJDKLC      JKIBTLKAUSMRJVQ
OPTTA           : AETLVCMOKJ      LECLMWHDN       TQKDBFQWF      
QXGPWEUOJ       : HHKPHTKLPU      CBJBK          
FORRB           : FBBNNDH         FKBVFYXAYSVRDSF MDVKN          
WAYRKJERFSHBOIX : PUHNERTBFGR     QIOPFWWDBBVLSD  KWUFMNICIRRHGG  UOIKB           ACNJTHUJHATV   
IEWIJR          : WNGSLSLDHYOJD   IEIAPA          RPDMDTA         JJJK           
UXEJP           : HIQTHAL         CDVFCTDR        LAUWRAYMBGWF   
MNWPOPA         : PIXRYJVRUHGPO   REHC            NMXAUVB        
TSFOCGFMFLV     : TKXSPK          MWMWNPEQDX      PGCW            WOJIERPVSB     
IGUDFRDL        : UINIFN          FXKSCECIIYYVLX  SHDITUUI       
VJQJIGB         : KAPAN          
JBTCHKEPQTWEPJ  : ROWHAPO        
VGRDYVODRA      : INAYDCCSXHJETEJ UTNDSBMHHMU     UGUVWT          FIATCCE         HOUXTMJVYGR    
DIFGJOIF        : EUDHSBVNIHRJLP  WBEEPWDF        JHYCF           KPIXJTHKXO      PFFRF          
PSYHJSFNKOC     : XRPWLHO         FLIABXMVPEOKCN  FIATCCE         YDJGELQOP      
UWLTUCYOCXTNDB  : BHCVJALPJCBXA   GLTRNBHKJMMQFH  TNFCMWKBGFAUCSU EFDIQKXLT       CFWWSMWHRIRVJN  RJIJLWGPKY     
TJEMBW          : CWLOWGTISQ      EEHSNQMY        IABE            HLTJECA         USTHJK         
IIFNXREDBACM    : THQKHTD         QVNKFJVO        SWVMTAXPKTND   
WPVNTTHHYIGSTN  : QDNMLEDYBSIKJH  QNEXYOLNFSXDUNI XNSLM           WTCMR           NLKFYEQAXNTDCCG KPIXJTHKXO      YDJGELQOP       WXWGVNNN       
WPVNTTHHYIGSTN  : RMOYMLQXVA     
WMSGVA          : SYCDWEFS        RUBWFBKJUIYPI   NBXUCEVJ        EKTUSTEBEITTA  
TSBYTDBIY       : MHKYCI          QMLOUWNW        WIETBV          QPCTKQGMUUDRTHY STGARNE         ALMA            XNTLQPT         HLKBXUYADSPIAH 
XWNSSVCRGJMDWTA : RGYMYCPRN       MGUTTS          DMFJMCTKGVWLVR 
NIHNHE          : YALXVB          OIBHFTOXEPAP    CNMJHRLDIAYKD   ICPMQYXBSM     
KDCNF           : KYRYPVQMEBFSW   GSRUKFFPL       EYTM            ILARNR         
MFLMTGF         : NCHHCRIJYAAMCA  AHAWRIKHTJUBTR  ROWHAPO        
JAASMDRHGDWONKV : ESKEKJDTA       XSUCNJP        
VIWAVCNL        : IKWLH           HGJH           
AXEGFX          : YALXVB          JHYCF           BLPLHFWNUAUOGR  SUKXNIFGNNIHQK  PSJOAFIMAOK     DULDXASJHOA    
FXKSCECIIYYVLX  : OTIXFEXWODTH    IGUDFRDL        IMFJWHQY        ILPY            FBAWXHDPY       HESDRDGMVSH    
HGMIDRVQ        : GTSYAQFPJOLDCQ  YIBUEGKOLEB     TJYBRUQWUHAX   
XQIHVGYCEKWG    : WEYMSO          EEHSNQMY        AHKXHCEHQMJ     IDPAKWDLSKPRUJW
YQYAQWLO        : UJVNVH          CKBCKINFRDNN    USKKCNLDXJQFR   HXUEPETV       
TUCEATCQXBHGIE  : TYWGUQHUCNCYLK 
HIQTHAL         : ODIYFIOPJSQ     UXEJP          
QKGH            : VOXIMDMXGT      RVRKGR          DLTJ            TUGA            APQQAXCKBCH    
TVYNTDTTYWL     : QPRCMBR         KVWN            AAUYQAXFPIHFP  
AUDKBRRJJOQJAY  : OEJMMDLFUAFRELH PIXRYJVRUHGPO   BLPLHFWNUAUOGR  APQQAXCKBCH    
MHKYCI          : TSBYTDBIY       OCLRLHUQC      
RCEO            : GLTRNBHKJMMQFH  ODDGWKODPENQ    SCUWG           COFGMX         
ELKDNHJXJ       : THQKHTD         YMKJ            XSKVPBTWTET     LPQMGAINJB      AAUYQAXFPIHFP  
RUKGMVINYVVL    : IXSXFRVLWTKK    NLKFYEQAXNTDCCG FPUTVVWEKLSY    CNMJHRLDIAYKD  
ATVTY           : TEXMYJPCBU      YDJGELQOP       XKNNCJQ         UTGCHDKI        VFEX            YSIK           
IXJVIMJRVJBXCW  : LKQEFSL         CNLQGTXGSR     
KLJVYKTWVQYPNTO : XJGW            VKSNRQRGNJFCHOF FBAWXHDPY       IGWJRJN        
CMCBWOKPNWSNBPA : QMLOUWNW        WIETBV          ILARNR          ASRBLWCNPHIO    JEHSAPHFTIXTW  
BJHDTBCRSCKI    : AAWNJWVE        VPEJ            ATBKGEKCOAHAO   QDYV            XNSLM          
YDAOFBNVOFJ     : SNTWJAIDH       MTBJUDHUSKO     FCEGIJEGNTYHY  
YWMOXAS         : MDFXRTTLO       OJQK            OMMNCJUQ       
KVGNXXICI       : GUKSQEXDO       MTYNOUFXFBBXK   UCNADUPHE       VCFSNCCTPWCV   
XKVYYBCOXQUJ    : CWLOWGTISQ      IMUPSV         
THQKHTD         : IIFNXREDBACM    ELKDNHJXJ       GSRUKFFPL       GNWYF          
EBYTCXDEGVDS    : WOWA            UJVANUMKMR      YHDMDTGP        MVVOWMBSCEJSQY 
ETVIJVAEIGARAK  : LSRJMONQ        HLTJECA         NMXAUVB        
TQRATRTVPWBXVG  : BHCVJALPJCBXA   QAICATD         HMUJMKOSTRE    
QMLOUWNW        : XIYYXFOE        TSBYTDBIY       CMCBWOKPNWSNBPA STGARNE         CEGCMWUJ       
VEDNEQOAHIABA   : TYWGUQHUCNCYLK  WTCMR           FUBYTJKOYTCWQE  HLKBXUYADSPIAH 
ARTDS           : PRKLWDRHFCIA    UGUVWT         
JMKXABUXOUBMYFC : QIILKBDKGUEIUR  BDYELODGXNW    
XQHHAHKCDKWYN   : FHQGA           CHPAPDCGTKE     JDEIY          
SYCDWEFS        : SNTWJAIDH       WMSGVA          OVXWP           GPWHYEET        FFFFLVLLBH     
VPEJ            : BJHDTBCRSCKI    CWLOWGTISQ      FUVBCUOOCBMP    EFDIQKXLT       VQDMKMMXQV      IMUPSV         
LLVJFFQHOBJ     : PRKLWDRHFCIA    BRKG            BWLWLI          PGCW           
OGVCXOEC        : LHYLTUCWWPY     IDBPOVHIGWNLOO  IXSXFRVLWTKK   
BHCVJALPJCBXA   : DKNUONYXTKF     UWLTUCYOCXTNDB  TQRATRTVPWBXVG  MVLTNWO         VBHCWSWIYH     
DHFMVJVQX       : JFLEDNRPCBR     QPCTKQGMUUDRTHY AAUYQAXFPIHFP  
MCDDGIAKPCGBDUR : CHPG            YMSBB           QHTFGQXYE       BDOPJBYXKVNE   
YUMCIRJNEGWDYW  : RBYTITPJ        EWGSG          
LANQG           : SDKKWJYK        IKME            OCEINYWISK      JGJHVPAW       
RQNTAPYWJOVED   : SEHRMK          PGBQHUPRL       MURRSUVWKU      NTXBGCGNRBKP    UACXPDGGDLIXQ  
MXKDC           : WEYMSO          XQHFGOBNPILJSYY QKOCT          
CHPAPDCGTKE     : JMGAXVMXPM      XQHHAHKCDKWYN   SWIXYOT         ENLRHBEBEOXJ    HDRVVNOCPJ      ICPMQYXBSM     
ESKEKJDTA       : JAASMDRHGDWONKV LFMLMWT         VSHIVKSDHANERWM
XEANEKSGBU      : GBOQVHQATJMUFEV TUSLBEQEFQXDG   QLOGNSUK        BDYELODGXNW    
SWIXYOT         : CHPAPDCGTKE     VTSYNALNLIJV    BAOI           
VIQOSUBEXU      : TYWGUQHUCNCYLK  HYOIOKQHHYINDC  MVVOWMBSCEJSQY 
YULYKPLDXOB     : AXNGG           RWMONPRAYSRVG   YMORBSRXDR      ODDGWKODPENQ    JBPPXD         
HXXHAOCM        : LDCPHHKELRCX    ULUTMWVT       
KDBFACJAYO      : SYGUQGFQUBTJUXB DKOQIXCISBU     MDVKN          
WCBHRMLQ        : EWMKFFHUXC      SVPXYTYKQLOAJQL BRKG            HXUEPETV        QLOGNSUK       
MHLMHTMWXYJKELP : FHQGA           BMQEOBSXOSAM   
PYEPQG          : NDHURMFG        EVCLPYBEMS      TEXMYJPCBU      BGCIDAHR        MWSM           
UJVNVH          : JFLEDNRPCBR     YQYAQWLO        RUBWFBKJUIYPI   QPRCMBR         SCTBJHGQDKXUFR 
AVPOLXKXWIAG    : SBNYWHVJO       IKWLH           DLNSJ           GACYWLNYVCLLWDE RQORVYXLOT      OJQK           
ETKJMJPCCVQ     : EIJIMDJA        OHRPJHYGX      
FOPEYXGUNUG     : SYGUQGFQUBTJUXB XTCEYMVGGI     
HHKPHTKLPU      : UVBUUQF         QXGPWEUOJ       YTTQCOIDQ      
CHPG            : MCDDGIAKPCGBDUR AOMTRAWKE       EYTM            BDOPJBYXKVNE   
LYLTOBANYGKP    : URHCJE          YMKJ            YVWYHMBLDSSNM   OGHSQ          
TDNBQEKKQXCMVFV : DJKHCFLYSKNHJ   EYPK            HGJH            XMKVQQB        
LHYLTUCWWPY     : OGVCXOEC        AXNGG           KEKXLYQHYDMJ    FLUGGNDYLVLST   TATWHI         
AOMTRAWKE       : OTIXFEXWODTH    HDIIAXPJYBBV    CHPG            OXWKEQH         VTSYNALNLIJV    DBCBJXTPTNFMU  
UXGAK           : FOMEWX          ASJUJCITANDCGEB WVRRNYXAROSTBV 
FGRSPSG         : URHCJE          SYGUQGFQUBTJUXB EEHSNQMY        NLKFYEQAXNTDCCG LBUSVQXSMFVU    NMXAUVB        
QIJNX           : AYOF            OGHSQ           HUCOPSLJIPWLLY  MKALHFY         ECKOSEADPN     
TYWGUQHUCNCYLK  : TUCEATCQXBHGIE  VEDNEQOAHIABA   VIQOSUBEXU      ASBWPIDXIXE     YSIK           
XOGGIAWCGISPT   : GUKSQEXDO       YPQNNXGJWSYM    JQSJWNB         NNGABLRQMYP     BAOI           
NCFO            : UVBUUQF         ODIYFIOPJSQ     JHPCW           SMOTIHLR        CSARVRIULQIMU  
LMUUHWLLXW      : AETLVCMOKJ      DKOQIXCISBU     DWTM            MWSM           
AXNGG           : OWBD            DKNUONYXTKF     YULYKPLDXOB     LHYLTUCWWPY     ASJUJCITANDCGEB AMYX           
IDBPOVHIGWNLOO  : EWMKFFHUXC      OGVCXOEC        AQXKTEPTBUNY   
DLUMK           : FHQGA           TKNSGHTAUINRJW  XJPCANULLLO     TKXSPK          AETLVCMOKJ      JSOTSLGQFDVRU   CDXWKXCAMFYSRY  YGFWEAG        
XJGW            : KLJVYKTWVQYPNTO LQFWHIHMTIY     PIBGD           DMFJMCTKGVWLVR  WQJWOLGIOCRFC   TATWHI         
ENTMMD          : WKENSVXKDHLN    KEKXLYQHYDMJ    PQNAYN          MJAYA           EULBGRISOAAU    IOOLMXFRPGFI    RPRDSLCEFYSYQDB DULDXASJHOA    
ENTMMD          : GVBWYWPDSTMDCDI
PUHNERTBFGR     : WAYRKJERFSHBOIX FWPISPEU        EVCLPYBEMS      LECLMWHDN      
GUIDHTKIFQFSWS  : AQQDCXTWPCM     RQORVYXLOT      KOYICVHCXHWE   
JHPCW           : NSCQGMU         NCFO            ESIWN           RPDMDTA         DFOS           
LKQEFSL         : IXJVIMJRVJBXCW  WJMYHMKPUQPU    MWMWNPEQDX      HLLKXDDIDFQ    
KIVITYPPLXWEGPD : WEYMSO          VBHCWSWIYH      AXRTLNOEA      
CNJSRGFGTWMBR   : GGWNHLGXLFQEL   MTYNOUFXFBBXK   SQOESYASMEW     VCFSNCCTPWCV   
OEJMMDLFUAFRELH : AUDKBRRJJOQJAY  IEIAPA         
PJXYERHMXBJKEDL : JUHWA           DULDXASJHOA    
JUHWA           : PJXYERHMXBJKEDL VUCIAG          FIATCCE        
EUVJMAXTKNFIOKB : ERUG            MTBJUDHUSKO     VOXIMDMXGT      LDTMHFIGSNQBOS 
WBCIOGNACWWJTW  : VRRUICH         HYOIOKQHHYINDC  YTTQCOIDQ       BGCIDAHR       
ATBKGEKCOAHAO   : BJHDTBCRSCKI    TKNSGHTAUINRJW  IKTUPVW         EFUXEECVJMKDAW 
BMQEOBSXOSAM    : DKNUONYXTKF     MHLMHTMWXYJKELP VTTAEA          JGJHVPAW        EFUXEECVJMKDAW 
JIOPJKS         : HWGELVDMPPTPPS  IMFJWHQY        QPCTKQGMUUDRTHY MGVXEDXWNOBRSAH WFHLTQSMDJXRLBT QAICATD        
SYGUQGFQUBTJUXB : KDBFACJAYO      FOPEYXGUNUG     FGRSPSG         FUVBCUOOCBMP    SLWMXUAROVKR    PIBGD           FTLMHJDKLC     
RYLMYXFKI       : PLDHVBDS        BROKN           UOIKB           XSHBH          
CRJVNCWTXN      : VHDLCNMODO      FBAWXHDPY       CEDDGXBABUFUXWL NMXAUVB        
FEWGXJDYMAQ     : UTQOHFBKIKL     RWMONPRAYSRVG   EULBGRISOAAU    TEXMYJPCBU      IOOLMXFRPGFI   
LFMLMWT         : ESKEKJDTA       GNWYF           LVDREMYJUVKGTYI QPRCMBR         EWGSG          
AOUXCWWYWLBERBL : AXRTLNOEA      
KORYQKKC        : HWGELVDMPPTPPS  PIBGD           MQJNUYDHVOFQVB 
YPFXMQXBLXFK    : MGUTTS          PGBQHUPRL       ROWHAPO        
EIJIMDJA        : WEYMSO          ETKJMJPCCVQ     CFWWSMWHRIRVJN 
VRRUICH         : HDIIAXPJYBBV    WBCIOGNACWWJTW  EUKNICO         PCGDNSN         YQHQPKHFSUQES   SHBBF          
UGFCERSFUGF     : ERCTTNYMJMBPH   RTDWCUFKNDPOBGW
QDHYOPOSBOS     : JTSLF           DLNSJ           WIETBV         
GLTRNBHKJMMQFH  : UWLTUCYOCXTNDB  RCEO            FREBVOMTCCYS   
CPDDHHLIXDW     : POVUSBBQLPHKQLH OXWKEQH         ITOPNHE         MVLTNWO         GVLLJPBDHEXKHT  QVNKFJVO       
FOMEWX          : WETGQQNWMGHOYJ  UXGAK           IVNITNABLW     
QNEXYOLNFSXDUNI : WPVNTTHHYIGSTN  ILPY           
UPOGQRFJYVVETTF : XQHFGOBNPILJSYY KFKO            GXBNJYYUCJTBTJ 
KJLLAYYHR       : GAFKB           VAREWOFALHW     AYYGHTSHTUSHPHS ILPY            HHFIUXL         TXFOTAWTXM      DBCBJXTPTNFMU   IOVQWRSOMJTIE  
MONVPKNESEY     : YVWYHMBLDSSNM   VQDMKMMXQV      ICPMQYXBSM     
OXWKEQH         : UYNRSJSAGA      AOMTRAWKE       CPDDHHLIXDW     DWTM            EKTUSTEBEITTA  
ETVRFXQGGKGUYV  : QHLBHCUELAF     YGWSCDQ         AQXKTEPTBUNY    CNLQGTXGSR      FTFUWRSFNH      PHFIMHU         TDKT           
RGHXALWBCVXNARW : JMGAXVMXPM      XVWAIAEUIRAC    TIBSTT          FWPISPEU        LOCBAJIYWDYUTHO GYTYLH         
XQKPXIIE        : POVUSBBQLPHKQLH GGWNHLGXLFQEL   PRKLWDRHFCIA    RBYTITPJ        TBKGGFLNXIWA    UCNADUPHE       HDRVVNOCPJ     
SMOTIHLR        : TRAE            NCFO            REHC           
MTBJUDHUSKO     : YDAOFBNVOFJ     EUVJMAXTKNFIOKB YGWSCDQ         QKFCCKCAPMNHYNG SUVRGXV        
YMKJ            : ELKDNHJXJ       LYLTOBANYGKP    WXVKQDHAL       NNGABLRQMYP    
ITOPNHE         : CPDDHHLIXDW     EAIBFAYQPPQLOT 
ENLRHBEBEOXJ    : CHPAPDCGTKE    
SDKKWJYK        : LANQG           RFLNKVPPPL      CNLQGTXGSR      IXSXFRVLWTKK    NWOM            QLOGNSUK       
GSRUKFFPL       : KDCNF           THQKHTD         SUQMO           QIOPFWWDBBVLSD  WXWGVNNN       
FWBMXG          : SLWMXUAROVKR    LPQMGAINJB     
CWLOWGTISQ      : TJEMBW          XKVYYBCOXQUJ    VPEJ            YIPYQ           IILHPD          TLHBDHQAHORM   
SBNYWHVJO       : AVPOLXKXWIAG    GNWYF           BNBWYTM         PXFBVOIFXGWXDQ 
BAMGWOUVWIAVVOS : EYTM            PLDHVBDS        PIOCBCY         WOJIERPVSB     
IDXCVSFLTCS     : QIOPFWWDBBVLSD  QHTFGQXYE       IMUPSV          TQKDBFQWF       BLPLHFWNUAUOGR  EFUXEECVJMKDAW 
OHRPJHYGX       : EUNLOO          ETKJMJPCCVQ     HAREORCO        JJJK            XMKVQQB        
EUDHSBVNIHRJLP  : DIFGJOIF        IXSXFRVLWTKK    SHBBF           UPFTSAPTBWQCXMN
QDYV            : BJHDTBCRSCKI    KTIJTAEMMRTPS   PQNAYN          UJVANUMKMR      VOXIMDMXGT      NTXBGCGNRBKP   
PKFJCOQBWOVCLB  : YIPYQ           JXHOEMJOGWNTIRY XSHBH          
EEHSNQMY        : TJEMBW          XQIHVGYCEKWG    FGRSPSG        
CDVFCTDR        : UXEJP           PIOCBCY         SQOESYASMEW    
KCIBSMXIICTLLBP : WEYMSO          VFMIERM         OLPRMSPALU      PGBQHUPRL       CXRJVP         
VFMIERM         : GUKSQEXDO       KCIBSMXIICTLLBP QYOENDJDUEPWLN 
PRKLWDRHFCIA    : JMGAXVMXPM      ARTDS           LLVJFFQHOBJ     XQKPXIIE        CHRPKBQHNPVFQ   QULCBPDWENANU  
IKWLH           : VIWAVCNL        AVPOLXKXWIAG    PGBY           
YIBUEGKOLEB     : HGMIDRVQ        PCGDNSN         SNWFST          FUBYTJKOYTCWQE 
VUEHRJYBQ       : JSOTSLGQFDVRU   CEDDGXBABUFUXWL PXYXBHL        
JRQTCPFLBFT     : WQGLBCYHH       COFGMX         
CAIMOVSRPOMWVG  : EWMKFFHUXC      KAPAN           MWSM            GYTYLH          TNBEDXWCP      
WHXYSRRNTHSGIA  : KHBOTNF         SLWMXUAROVKR   
MDFXRTTLO       : YWMOXAS         RKBSIWUYCWA     NCHHCRIJYAAMCA  LXTCVXDW        LVDREMYJUVKGTYI NBXUCEVJ       
CBJBK           : QXGPWEUOJ       ETVUQ           NTXBGCGNRBKP    FUBYTJKOYTCWQE  ROWHAPO        
XRPWLHO         : PSYHJSFNKOC     IYQNCVA         GJSA           
EYTM            : UVBUUQF         KDCNF           CHPG            BAMGWOUVWIAVVOS XJPCANULLLO     JSOTSLGQFDVRU  
WOWA            : QBCYOMHCYPGPGC  EBYTCXDEGVDS    PDRXKGXMJMHJREY
UTQOHFBKIKL     : FEWGXJDYMAQ     GJSA            HLKBXUYADSPIAH 
DLNSJ           : XIYYXFOE        AVPOLXKXWIAG    QDHYOPOSBOS     JJJK            WXWGVNNN        NJNXVYTXF      
BAAFBVRLSIKU    : QDNMLEDYBSIKJH  AXFJRHP         MCHXA           HLTJECA         AXRTLNOEA      
HPVXYBALLMYHP   : ASBWPIDXIXE    
ULUTMWVT        : HXXHAOCM        GACYWLNYVCLLWDE MJAYA          
RLMLVYIYGAWEAXG : JSOTSLGQFDVRU   IKTUPVW         IOVQWRSOMJTIE  
MVLTNWO         : WEYMSO          BHCVJALPJCBXA   CPDDHHLIXDW     VKSNRQRGNJFCHOF
TKNSGHTAUINRJW  : DLUMK           ATBKGEKCOAHAO   DJKHCFLYSKNHJ   BDOPJBYXKVNE    SHDITUUI       
PWQWYQFLDDYYRXN : TOTBIHOS        EWGSG           FTLMHJDKLC     
TAHMGQJJO       : CHRPKBQHNPVFQ   RVMSQYGX        XCVKWAO        
WIETBV          : WSPG            TSBYTDBIY       CMCBWOKPNWSNBPA QDHYOPOSBOS     WQGLBCYHH       HUJTPJFNDHT    
TUSLBEQEFQXDG   : XEANEKSGBU      TJYBRUQWUHAX    ASDW           
WHBMPT          : SUQMO           RFLNKVPPPL      TATWHI         
YIPYQ           : CWLOWGTISQ      PKFJCOQBWOVCLB  WVRRNYXAROSTBV  RJIJLWGPKY      VCFSNCCTPWCV   
SUQMO           : GSRUKFFPL       WHBMPT          NLKFYEQAXNTDCCG KWUFMNICIRRHGG  COFGMX         
GCOMVV          : YVWYHMBLDSSNM   HLLKXDDIDFQ     UNKWDNTCHJWLPD 
OVXWP           : GUKSQEXDO       SYCDWEFS        SVNWSXMBA       JUAGVXYYSUMXWRG
ESIWN           : JHPCW           KTIJTAEMMRTPS  
XXXWPSSMLH      : VKSNRQRGNJFCHOF QKFCCKCAPMNHYNG SUKXNIFGNNIHQK 
YNGQDC          : UGIA            HWGELVDMPPTPPS  VQDXJBMESMLSWV  ASBWPIDXIXE     YDJGELQOP       GYXEVCKRNDFC    EUEHRSQBYKS     HOUXTMJVYGR    
XSKVPBTWTET     : URHCJE          GBOQVHQATJMUFEV ELKDNHJXJ       KTIJTAEMMRTPS   IMFJWHQY       
KTIJTAEMMRTPS   : QDYV            ESIWN           XSKVPBTWTET     XJPCANULLLO     FOXNLKQQCMK     IOOLMXFRPGFI   
XJPCANULLLO     : DLUMK           EYTM            KTIJTAEMMRTPS   LJMQHGJVAFXXQM 
IKME            : LANQG           ILPY            STGARNE         PFFRF           JYIBBCGDPVJNGWV IDPAKWDLSKPRUJW BNBGQADAUDIRDJ  HDRVVNOCPJ     
AXFJRHP         : QBCYOMHCYPGPGC  BAAFBVRLSIKU    WFHLTQSMDJXRLBT FMJBASXY       
VHDLCNMODO      : TOTBIHOS        WEYMSO          CRJVNCWTXN      UNKWDNTCHJWLPD  WOJIERPVSB     
SKCEXQMG        : VQDMKMMXQV      TBKGGFLNXIWA    AXRTLNOEA      
CKBCKINFRDNN    : YQYAQWLO        WBEEPWDF        MGVXEDXWNOBRSAH QNIMLJVPT      
QYOENDJDUEPWLN  : UVBUUQF         VFMIERM         MWMWNPEQDX     
XVWAIAEUIRAC    : RGHXALWBCVXNARW MQJNUYDHVOFQVB 
QPJHQYO         : VSHIVKSDHANERWM STGARNE         IJYVCRJ        
EAIBFAYQPPQLOT  : ITOPNHE         AHKXHCEHQMJ     OBJPDJDIBK      RQORVYXLOT      XOCCAAVRUL      IJYVCRJ        
OXQYQTBNKQXTH   : UTNDSBMHHMU     PGBQHUPRL       KFXFOCIUJ      
IMFJWHQY        : FXKSCECIIYYVLX  JIOPJKS         XSKVPBTWTET     RKBSIWUYCWA     IYNHKTF         VFEX           
HOAACOTXDUPCNLD : MTYNOUFXFBBXK   UJVANUMKMR      RPDMDTA         TLHBDHQAHORM    UOGSYDD        
VVBPDABSIK      : AQXKTEPTBUNY   
PDRXKGXMJMHJREY : WOWA            ALUHMBANYN     
RKBSIWUYCWA     : EUNLOO          MDFXRTTLO       IMFJWHQY        EAACHSKTVMPRONI
FMNWPFWCNWOYL   : BQWNIBKL        MQJNUYDHVOFQVB 
JDEIY           : XQHHAHKCDKWYN   USKKCNLDXJQFR   SWVMTAXPKTND    ICPMQYXBSM     
VAREWOFALHW     : KJLLAYYHR       LIKHAQFC       
VKSNRQRGNJFCHOF : KLJVYKTWVQYPNTO MVLTNWO         XXXWPSSMLH      VIEMNLQ        
AHKXHCEHQMJ     : HWGELVDMPPTPPS  XQIHVGYCEKWG    EAIBFAYQPPQLOT  FKBVFYXAYSVRDSF
TIBSTT          : RGHXALWBCVXNARW
NMYTDKCFR       : YHXRHLMKFAIBP   VQDMKMMXQV     
MGUTTS          : XWNSSVCRGJMDWTA YPFXMQXBLXFK    MGVXEDXWNOBRSAH UHTMGIYHRBUOI   IDNMVLJ         BNBGQADAUDIRDJ 
VANPMWWIHXBBR   : SFXEMMNDXODE    DUKT            PSJOAFIMAOK     ICPMQYXBSM     
RFLNKVPPPL      : SDKKWJYK        WHBMPT          FFFFLVLLBH     
YGWSCDQ         : ETVRFXQGGKGUYV  MTBJUDHUSKO     VBMPFYABWVI     XSHBH           GVBWYWPDSTMDCDI
QIOPFWWDBBVLSD  : POVUSBBQLPHKQLH UGIA            WAYRKJERFSHBOIX GSRUKFFPL       IDXCVSFLTCS     KEKXLYQHYDMJ    OCEINYWISK      XKNNCJQ        
GNWYF           : THQKHTD         LFMLMWT         SBNYWHVJO       TXFOTAWTXM     
KHLSGGUJAWCIL   : BUNOYWQTBFWH    FUBYTJKOYTCWQE 
OLPRMSPALU      : WETGQQNWMGHOYJ  KCIBSMXIICTLLBP HAQAMDQCDUPHETH
TKXSPK          : TSFOCGFMFLV     DLUMK           JGJHVPAW        RTDWCUFKNDPOBGW TATWHI          FUBYTJKOYTCWQE 
AYYGHTSHTUSHPHS : KJLLAYYHR       FLIABXMVPEOKCN  IQFYJECXTIAVL  
YHXRHLMKFAIBP   : NMYTDKCFR       YMSBB           HAREORCO        EULBGRISOAAU    IOOLMXFRPGFI   
GPWHYEET        : JFLEDNRPCBR     UINIFN          SYCDWEFS        PHFIMHU         PFFRF          
XQHFGOBNPILJSYY : MXKDC           UPOGQRFJYVVETTF PCGDNSN         QDKE           
HYOIOKQHHYINDC  : VIQOSUBEXU      WBCIOGNACWWJTW  QIMDYVUAVQKPJ   BWLWLI         
DSLKACNPUWEGRD  : XUFFIPFJOSHG    CEDDGXBABUFUXWL SUVRGXV        
WKENSVXKDHLN    : FHQGA           ENTMMD          TQKDBFQWF      
QPCTKQGMUUDRTHY : TSBYTDBIY       DHFMVJVQX       JIOPJKS         IKTUPVW        
KEKXLYQHYDMJ    : LHYLTUCWWPY     ENTMMD          QIOPFWWDBBVLSD  UGUVWT          ASRBLWCNPHIO   
AJHRNDCEKP      : TVAE            RJIJLWGPKY      JKIBTLKAUSMRJVQ
FUVBCUOOCBMP    : VPEJ            SYGUQGFQUBTJUXB IXKQANCPRYRSWI  JHYCF           WHVPDGQEALW    
GWCLLNDN        : UVBUUQF         XIYYXFOE        OWTCQV          PLDHVBDS        AYSMMAMDIKEBT   JJJK           
KFKO            : UPOGQRFJYVVETTF DJKHCFLYSKNHJ  
RBYTITPJ        : YUMCIRJNEGWDYW  XQKPXIIE        UOGSYDD        
NXLRYAHCGGGSTTV : ILPY            MJAYA           ALMA           
QIMDYVUAVQKPJ   : HYOIOKQHHYINDC  LJMQHGJVAFXXQM  CDXWKXCAMFYSRY  YGFWEAG        
OWTCQV          : UYNRSJSAGA      GWCLLNDN        LJMQHGJVAFXXQM 
XXJG            : VQDXJBMESMLSWV  RQORVYXLOT      IKTUPVW         VFEX           
EAACHSKTVMPRONI : GAFKB           RKBSIWUYCWA     KHBOTNF         PIXRYJVRUHGPO   PGCW            LAUWRAYMBGWF    WHRNCNQX       
ETVUQ           : MLJIRSIQNA      INAYDCCSXHJETEJ CBJBK           STGARNE        
WJMYHMKPUQPU    : LKQEFSL         RWMONPRAYSRVG   VOXIMDMXGT      NLKFYEQAXNTDCCG RWDLVKSUQUBJVVP
WNGSLSLDHYOJD   : IEWIJR          USTHJK         
GACYWLNYVCLLWDE : AVPOLXKXWIAG    ULUTMWVT        WXVKQDHAL       ALUHMBANYN      IFXH           
VBHCWSWIYH      : BHCVJALPJCBXA   KIVITYPPLXWEGPD OCLRLHUQC       YALXVB          IVNITNABLW     
PQNAYN          : MLJIRSIQNA      ENTMMD          QDYV            MCHXA          
XNSLM           : UYNRSJSAGA      WPVNTTHHYIGSTN  BJHDTBCRSCKI    IVNITNABLW     
NXCKBGEA        : BWLWLI          OLXIQSUS        IOVQWRSOMJTIE  
NCHHCRIJYAAMCA  : MFLMTGF         MDFXRTTLO       FIATCCE         LBUSVQXSMFVU   
HAQAMDQCDUPHETH : JTSLF           OLPRMSPALU      TVAE            GXBNJYYUCJTBTJ  VMJNISEQPAIA   
ILARNR          : OTIXFEXWODTH    GAFKB           KDCNF           CMCBWOKPNWSNBPA
WQEX            : FNWCNQUUF       DWTM            LJMQHGJVAFXXQM  XTCEYMVGGI      HGJH           
GALNACPOHIRKEJR : GJSA           
FBBNNDH         : FORRB           EVCLPYBEMS     
ULYN            : TOTBIHOS        IXSXFRVLWTKK    IABE           
YVWYHMBLDSSNM   : LYLTOBANYGKP    MONVPKNESEY     GCOMVV          YQHQPKHFSUQES   NTXBGCGNRBKP    GVBWYWPDSTMDCDI
TVAE            : UINIFN          AJHRNDCEKP      HAQAMDQCDUPHETH PNXTVRJITBQJSO  RPRDSLCEFYSYQDB CDXWKXCAMFYSRY  FUBYTJKOYTCWQE 
CHRPKBQHNPVFQ   : PRKLWDRHFCIA    TAHMGQJJO       ASBWPIDXIXE     IXSXFRVLWTKK    PIBGD           IVNITNABLW      QJIFUA         
ERCTTNYMJMBPH   : UGFCERSFUGF     SLWMXUAROVKR    WOJIERPVSB     
PNXTVRJITBQJSO  : TVAE            PCGDNSN         SNWFST          FKBVFYXAYSVRDSF
KIVCMPXBOMMBNC  : UTNDSBMHHMU    
MTYNOUFXFBBXK   : KVGNXXICI       CNJSRGFGTWMBR   HOAACOTXDUPCNLD VOXIMDMXGT      UOGSYDD        
MCHXA           : VBUYXS          BAAFBVRLSIKU    PQNAYN          XTQFKQ          VMJNISEQPAIA   
KRMNGYAJPEWCYVP : UGIA            AETLVCMOKJ      AMYX            LOCBAJIYWDYUTHO SECNNGJPGHPYJP 
SVPXYTYKQLOAJQL : QKBTRXN         WCBHRMLQ        YMSBB          
IXKQANCPRYRSWI  : FUVBCUOOCBMP    KPPQWH          XCVKWAO        
PGBQHUPRL       : RQNTAPYWJOVED   YPFXMQXBLXFK    KCIBSMXIICTLLBP OXQYQTBNKQXTH   KPPQWH          VMJNISEQPAIA   
ILPY            : FXKSCECIIYYVLX  QNEXYOLNFSXDUNI KJLLAYYHR       IKME            NXLRYAHCGGGSTTV PFFRF           OMMNCJUQ        HLKBXUYADSPIAH 
MJAYA           : OWBD            ENTMMD          ULUTMWVT        NXLRYAHCGGGSTTV
MFPHG           : HLLKXDDIDFQ     MQJNUYDHVOFQVB  VREVR           NJNXVYTXF      
AETLVCMOKJ      : OPTTA           LMUUHWLLXW      DLUMK           KRMNGYAJPEWCYVP YEMXDIN        
EUKNICO         : VRRUICH         SIVEIRJHPOGGRPQ SHBBF           JGJHVPAW       
OBJPDJDIBK      : NDHURMFG        EAIBFAYQPPQLOT  UOGSYDD        
LMTFXRIM        : PIBGD          
SVNWSXMBA       : OVXWP           XCVKWAO        
LQFWHIHMTIY     : XJGW            RWMONPRAYSRVG   RQORVYXLOT      DULQJSEEPO     
TNFCMWKBGFAUCSU : KYFOFI          UWLTUCYOCXTNDB  AMYX            ALMA            OJXHFFSPFAOBBCJ
WXVKQDHAL       : KYFOFI          YMKJ            GACYWLNYVCLLWDE LSRJMONQ        UNKWDNTCHJWLPD  JEHSAPHFTIXTW  
MHANQVC         : GGWNHLGXLFQEL   PXFBVOIFXGWXDQ  QJIFUA         
AQXKTEPTBUNY    : IDBPOVHIGWNLOO  ETVRFXQGGKGUYV  VVBPDABSIK      BRKG            ALMA           
MWMWNPEQDX      : TSFOCGFMFLV     LKQEFSL         QYOENDJDUEPWLN 
LXTCVXDW        : UYNRSJSAGA      QDNMLEDYBSIKJH  MDFXRTTLO       SIVEIRJHPOGGRPQ GEBG            GJSA           
DJKHCFLYSKNHJ   : TDNBQEKKQXCMVFV TKNSGHTAUINRJW  KFKO            VRMSG          
EYPK            : XFONMTQFMIPDDA  VBUYXS          TDNBQEKKQXCMVFV XTQFKQ          RUBWFBKJUIYPI   GYXEVCKRNDFC    FCEGIJEGNTYHY  
SIVEIRJHPOGGRPQ : EUKNICO         LXTCVXDW        RPRDSLCEFYSYQDB OJXHFFSPFAOBBCJ PXYXBHL         FUBYTJKOYTCWQE 
RVMSQYGX        : TAHMGQJJO       KPPQWH          WNLEEGECCDOLNE 
IEIAPA          : IEWIJR          OEJMMDLFUAFRELH YTTQCOIDQ      
AVCJNNSFCY      : SFXEMMNDXODE    HOUXTMJVYGR    
VQDXJBMESMLSWV  : YUHUKXNRUJFBFGN YNGQDC          XXJG            FREBVOMTCCYS   
FWPISPEU        : PUHNERTBFGR     RGHXALWBCVXNARW PGCW           
UJVANUMKMR      : EBYTCXDEGVDS    QDYV            HOAACOTXDUPCNLD ASBWPIDXIXE     LDTMHFIGSNQBOS 
XSUCNJP         : SEHRMK          JAASMDRHGDWONKV JXHOEMJOGWNTIRY XNTLQPT         VREVR          
HMJOLBWEQEB     : AXRTLNOEA       OJXHFFSPFAOBBCJ IYNHKTF         HDRVVNOCPJ     
YMSBB           : MCDDGIAKPCGBDUR YHXRHLMKFAIBP   SVPXYTYKQLOAJQL FLIABXMVPEOKCN  LSRJMONQ        PIXRYJVRUHGPO   YALXVB         
PLDHVBDS        : OTIXFEXWODTH    RYLMYXFKI       BAMGWOUVWIAVVOS GWCLLNDN        WTCMR           FOXNLKQQCMK    
SFXEMMNDXODE    : VANPMWWIHXBBR   AVCJNNSFCY     
HHFIUXL         : XFONMTQFMIPDDA  KJLLAYYHR       LIKHAQFC        VMJNISEQPAIA   
OCLRLHUQC       : WEYMSO          MHKYCI          VBHCWSWIYH      RPDMDTA        
KHBOTNF         : GTSYAQFPJOLDCQ  WHXYSRRNTHSGIA  EAACHSKTVMPRONI
LVDREMYJUVKGTYI : PBHFIJFJRDPHPUY LFMLMWT         MDFXRTTLO       GYTYLH          IGWJRJN        
RWMONPRAYSRVG   : YULYKPLDXOB     FEWGXJDYMAQ     WJMYHMKPUQPU    LQFWHIHMTIY    
VTSYNALNLIJV    : SWIXYOT         AOMTRAWKE      
EVCLPYBEMS      : PYEPQG          PUHNERTBFGR     FBBNNDH         OIBHFTOXEPAP    USKKCNLDXJQFR   BNBWYTM        
NRRFNBEJWYKLYX  : WSPG            VOXIMDMXGT      USTHJK         
LIKHAQFC        : QBCYOMHCYPGPGC  VAREWOFALHW     HHFIUXL         VCFSNCCTPWCV   
WBEEPWDF        : FTYAETAMUADALD  DIFGJOIF        CKBCKINFRDNN    CNLQGTXGSR      UHTGMF         
UMFVQQTQE       : IMDLGNTJSI      HAREORCO        IYNHKTF        
PCGDNSN         : VRRUICH         YIBUEGKOLEB     XQHFGOBNPILJSYY PNXTVRJITBQJSO 
MURRSUVWKU      : KYRYPVQMEBFSW   RQNTAPYWJOVED   YMORBSRXDR      YPIRY           IYNHKTF        
SNWFST          : YIBUEGKOLEB     PNXTVRJITBQJSO  BWLWLI          IILHPD         
KPPQWH          : IXKQANCPRYRSWI  PGBQHUPRL       RVMSQYGX        XUFFIPFJOSHG    VBMPFYABWVI     WVRRNYXAROSTBV  YPIRY           OLXIQSUS       
FLIABXMVPEOKCN  : AAWNJWVE        QKBTRXN         PSYHJSFNKOC     AYYGHTSHTUSHPHS YMSBB           YMORBSRXDR      WNLEEGECCDOLNE 
YPQNNXGJWSYM    : XOGGIAWCGISPT   EULBGRISOAAU    WVRRNYXAROSTBV  IGWJRJN         UTGCHDKI       
XUFFIPFJOSHG    : DSLKACNPUWEGRD  KPPQWH         
WTCMR           : WPVNTTHHYIGSTN  VEDNEQOAHIABA   PLDHVBDS        HUCOPSLJIPWLLY  CFWWSMWHRIRVJN 
DKOQIXCISBU     : SEHRMK          KDBFACJAYO      LMUUHWLLXW      ASJUJCITANDCGEB
BRKG            : UVBUUQF         LLVJFFQHOBJ     WCBHRMLQ        AQXKTEPTBUNY    COFGMX         
CNLQGTXGSR      : IXJVIMJRVJBXCW  ETVRFXQGGKGUYV  SDKKWJYK        WBEEPWDF        OGHSQ           FPUTVVWEKLSY    KOYICVHCXHWE   
HLLKXDDIDFQ     : GAFKB           LKQEFSL         GCOMVV          MFPHG           AMYX           
IMDLGNTJSI      : ODIYFIOPJSQ     UMFVQQTQE      
JQSJWNB         : XOGGIAWCGISPT   FIATCCE         UHTGMF          WXWGVNNN       
VOXIMDMXGT      : EWMKFFHUXC      QKGH            EUVJMAXTKNFIOKB QDYV            WJMYHMKPUQPU    MTYNOUFXFBBXK   NRRFNBEJWYKLYX 
EFDIQKXLT       : UWLTUCYOCXTNDB  VPEJ            XAXTFCSRNGCGMS  SWVMTAXPKTND   
VQDMKMMXQV      : VPEJ            MONVPKNESEY     SKCEXQMG        NMYTDKCFR       WXWGVNNN       
FTFUWRSFNH      : ETVRFXQGGKGUYV  YDTCTHPAPVWVPF 
SLWMXUAROVKR    : SYGUQGFQUBTJUXB FWBMXG          WHXYSRRNTHSGIA  ERCTTNYMJMBPH  
UGUVWT          : VGRDYVODRA      ARTDS           KEKXLYQHYDMJ   
FNWCNQUUF       : URHCJE          WQEX            HBVQSEKPNYKCCFO EWGSG          
HAREORCO        : FTYAETAMUADALD  OHRPJHYGX       YHXRHLMKFAIBP   UMFVQQTQE       PHFIMHU         UACXPDGGDLIXQ  
SMUKVRSSPQMIXD  : WHRNCNQX       
ASBWPIDXIXE     : TYWGUQHUCNCYLK  HPVXYBALLMYHP   YNGQDC          CHRPKBQHNPVFQ   UJVANUMKMR      TJYBRUQWUHAX   
PIOCBCY         : TOTBIHOS        WEYMSO          PBHFIJFJRDPHPUY BAMGWOUVWIAVVOS CDVFCTDR        QDKE            ECKOSEADPN     
ASJUJCITANDCGEB : UXGAK           AXNGG           DKOQIXCISBU     TEXMYJPCBU      WNLEEGECCDOLNE  TATWHI          TNBEDXWCP      
MGVXEDXWNOBRSAH : FYYXIXGMKD      JIOPJKS         CKBCKINFRDNN    MGUTTS          BQWNIBKL       
SQOESYASMEW     : INAYDCCSXHJETEJ CNJSRGFGTWMBR   CDVFCTDR        AMYX           
IXSXFRVLWTKK    : KECHVFEDEWJ     RUKGMVINYVVL    OGVCXOEC        SDKKWJYK        EUDHSBVNIHRJLP  ULYN            CHRPKBQHNPVFQ   UCNADUPHE      
LECLMWHDN       : OPTTA           PUHNERTBFGR     QULCBPDWENANU   BGCIDAHR        SUVRGXV        
YMORBSRXDR      : YULYKPLDXOB     MURRSUVWKU      FLIABXMVPEOKCN  YTTQCOIDQ       KVWN            ACNJTHUJHATV   
BWLWLI          : QDNMLEDYBSIKJH  LLVJFFQHOBJ     HYOIOKQHHYINDC  NXCKBGEA        SNWFST          YEMXDIN        
VUCIAG          : JUHWA           FUBYTJKOYTCWQE 
MDDRT           : XFONMTQFMIPDDA  QBCYOMHCYPGPGC  KFXFOCIUJ       NTXBGCGNRBKP   
QIILKBDKGUEIUR  : POVUSBBQLPHKQLH JMKXABUXOUBMYFC LJMQHGJVAFXXQM 
IABE            : JMGAXVMXPM      TJEMBW          ULYN            DWTM            MWSM            REHC           
FOXNLKQQCMK     : GBOQVHQATJMUFEV KTIJTAEMMRTPS   PLDHVBDS       
VSHIVKSDHANERWM : TRAE            ESKEKJDTA       QPJHQYO         NLKFYEQAXNTDCCG
XTQFKQ          : MCHXA           EYPK            ALUHMBANYN      PSJOAFIMAOK     TNBEDXWCP       MVVOWMBSCEJSQY 
VBMPFYABWVI     : INAYDCCSXHJETEJ YGWSCDQ         KPPQWH          FREBVOMTCCYS   
RUBWFBKJUIYPI   : WMSGVA          UJVNVH          EYPK            FFFFLVLLBH      NNGABLRQMYP    
IQFYJECXTIAVL   : AYYGHTSHTUSHPHS QPRCMBR         TJYBRUQWUHAX    FFFFLVLLBH      EFUXEECVJMKDAW 
RUDMRGJYHWJEFK  : YALXVB          JXHOEMJOGWNTIRY FCEGIJEGNTYHY  
PHFIMHU         : NSCQGMU         ETVRFXQGGKGUYV  GPWHYEET        HAREORCO        BDYELODGXNW    
JSOTSLGQFDVRU   : DLUMK           VUEHRJYBQ       EYTM            RLMLVYIYGAWEAXG QULCBPDWENANU  
EULBGRISOAAU    : ENTMMD          FEWGXJDYMAQ     YHXRHLMKFAIBP   YPQNNXGJWSYM   
OCEINYWISK      : LANQG           QIOPFWWDBBVLSD  PGBY           
LSRJMONQ        : ETVIJVAEIGARAK  WXVKQDHAL       YMSBB          
YTTQCOIDQ       : HHKPHTKLPU      WBCIOGNACWWJTW  IEIAPA          YMORBSRXDR      NJNXVYTXF      
OGHSQ           : LYLTOBANYGKP    QIJNX           CNLQGTXGSR      JKIBTLKAUSMRJVQ
RPDMDTA         : IEWIJR          JHPCW           HOAACOTXDUPCNLD OCLRLHUQC       QPRCMBR         IKTUPVW        
NLKFYEQAXNTDCCG : WPVNTTHHYIGSTN  RUKGMVINYVVL    FGRSPSG         SUQMO           WJMYHMKPUQPU    VSHIVKSDHANERWM
HUCOPSLJIPWLLY  : QIJNX           WTCMR           HOUXTMJVYGR    
ALUHMBANYN      : PDRXKGXMJMHJREY GACYWLNYVCLLWDE XTQFKQ          QKFCCKCAPMNHYNG
CSLKMSHOJW      : BLPLHFWNUAUOGR  QKOCT           NMXAUVB         GVBWYWPDSTMDCDI HDRVVNOCPJ     
UHTMGIYHRBUOI   : WNSSPLJUNJ      QKBTRXN         MGUTTS          VRMSG          
PIXRYJVRUHGPO   : MNWPOPA         AUDKBRRJJOQJAY  EAACHSKTVMPRONI YMSBB           DMFJMCTKGVWLVR  NBXUCEVJ        AAUYQAXFPIHFP  
YOGVVAJEIILDL   : KECHVFEDEWJ     LAUWRAYMBGWF   
RVRKGR          : QKGH            PXFBVOIFXGWXDQ  XAXTFCSRNGCGMS  FCEGIJEGNTYHY  
FBAWXHDPY       : FXKSCECIIYYVLX  KLJVYKTWVQYPNTO CRJVNCWTXN     
QNIMLJVPT       : JTSLF           CKBCKINFRDNN    AXRTLNOEA      
DWTM            : XFONMTQFMIPDDA  EWMKFFHUXC      LMUUHWLLXW      OXWKEQH         WQEX            IABE            NNGABLRQMYP    
PGCW            : TSFOCGFMFLV     LLVJFFQHOBJ     EAACHSKTVMPRONI FWPISPEU        FUXE           
GEBG            : LXTCVXDW        KWUFMNICIRRHGG  UNKWDNTCHJWLPD  GXBNJYYUCJTBTJ  GYXEVCKRNDFC   
YQHQPKHFSUQES   : TOTBIHOS        VRRUICH         YVWYHMBLDSSNM   IYQNCVA         JJJK            XKNNCJQ        
YALXVB          : NIHNHE          AXEGFX          VBHCWSWIYH      YMSBB           RUDMRGJYHWJEFK  EPOMU          
MHVLGC          : KYRYPVQMEBFSW   CDXWKXCAMFYSRY 
HLTJECA         : TJEMBW          ETVIJVAEIGARAK  BAAFBVRLSIKU   
OIBHFTOXEPAP    : ERUG            NIHNHE          EVCLPYBEMS     
WQGLBCYHH       : ERUG            JRQTCPFLBFT     WIETBV          RWDLVKSUQUBJVVP
QULCBPDWENANU   : PRKLWDRHFCIA    LECLMWHDN       JSOTSLGQFDVRU  
CSARVRIULQIMU   : NCFO            CEGCMWUJ       
TEXMYJPCBU      : QDNMLEDYBSIKJH  ATVTY           PYEPQG          FEWGXJDYMAQ     ASJUJCITANDCGEB OLXIQSUS       
FKBVFYXAYSVRDSF : WETGQQNWMGHOYJ  FORRB           AHKXHCEHQMJ     PNXTVRJITBQJSO 
BROKN           : URHCJE          RYLMYXFKI       CFWWSMWHRIRVJN 
LAUWRAYMBGWF    : GAFKB           UXEJP           EAACHSKTVMPRONI YOGVVAJEIILDL  
CEDDGXBABUFUXWL : CRJVNCWTXN      VUEHRJYBQ       DSLKACNPUWEGRD  JUAGVXYYSUMXWRG
KHWMFTF         : WETGQQNWMGHOYJ  PSJOAFIMAOK     GYTYLH          XAXTFCSRNGCGMS 
STGARNE         : TSBYTDBIY       QMLOUWNW        IKME            QPJHQYO         ETVUQ           FREBVOMTCCYS   
SHBBF           : OWBD            VRRUICH         EUDHSBVNIHRJLP  EUKNICO        
BGCIDAHR        : FHQGA           PYEPQG          WBCIOGNACWWJTW  LECLMWHDN       CDXWKXCAMFYSRY 
TBKGGFLNXIWA    : XQKPXIIE        SKCEXQMG       
KFXFOCIUJ       : OXQYQTBNKQXTH   MDDRT           TDKT            VIEMNLQ        
DLTJ            : QKGH            IJYVCRJ         HESDRDGMVSH     LBUSVQXSMFVU   
BDCUEMENRRDSA   : INAYDCCSXHJETEJ CXRJVP          MVVOWMBSCEJSQY 
UCNADUPHE       : KVGNXXICI       XQKPXIIE        IXSXFRVLWTKK   
QPRCMBR         : TVYNTDTTYWL     UJVNVH          LFMLMWT         IQFYJECXTIAVL   RPDMDTA        
GVLLJPBDHEXKHT  : VBUYXS          CPDDHHLIXDW     USTHJK         
WVRRNYXAROSTBV  : UXGAK           YIPYQ           KPPQWH          YPQNNXGJWSYM   
QDKE            : XQHFGOBNPILJSYY PIOCBCY         UHTGMF         
VTTAEA          : BMQEOBSXOSAM    USKKCNLDXJQFR   GYXEVCKRNDFC   
QHTFGQXYE       : MCDDGIAKPCGBDUR IDXCVSFLTCS     OJXHFFSPFAOBBCJ SCTBJHGQDKXUFR 
WHRNCNQX        : FYYXIXGMKD      EAACHSKTVMPRONI SMUKVRSSPQMIXD 
IDNMVLJ         : MGUTTS          OMMNCJUQ       
LPQMGAINJB      : POVUSBBQLPHKQLH ELKDNHJXJ       FWBMXG          GXBNJYYUCJTBTJ 
IILHPD          : CWLOWGTISQ      SNWFST          HMUJMKOSTRE    
RQORVYXLOT      : AVPOLXKXWIAG    GUIDHTKIFQFSWS  EAIBFAYQPPQLOT  XXJG            LQFWHIHMTIY    
XKLPDAXFILOMXY  : SUKXNIFGNNIHQK 
LJMQHGJVAFXXQM  : QBCYOMHCYPGPGC  XJPCANULLLO     QIMDYVUAVQKPJ   OWTCQV          WQEX            QIILKBDKGUEIUR 
QKFCCKCAPMNHYNG : MTBJUDHUSKO     XXXWPSSMLH      ALUHMBANYN      YDTCTHPAPVWVPF  GJSA            PGBY           
YPIRY           : MURRSUVWKU      KPPQWH          BLPLHFWNUAUOGR 
CXRJVP          : KCIBSMXIICTLLBP BDCUEMENRRDSA   IOOLMXFRPGFI    YHDMDTGP        JYIBBCGDPVJNGWV
IKTUPVW         : ATBKGEKCOAHAO   RLMLVYIYGAWEAXG QPCTKQGMUUDRTHY XXJG            RPDMDTA         ODDGWKODPENQ    YAKJCBXGXAOFPA 
AYSMMAMDIKEBT   : GWCLLNDN        YEMXDIN         FREBVOMTCCYS    ASDW           
AMYX            : AXNGG           KRMNGYAJPEWCYVP TNFCMWKBGFAUCSU HLLKXDDIDFQ     SQOESYASMEW     GJSA            FUBYTJKOYTCWQE 
KVWN            : WNSSPLJUNJ      TVYNTDTTYWL     YMORBSRXDR     
JHYCF           : DIFGJOIF        AXEGFX          FUVBCUOOCBMP   
CFWWSMWHRIRVJN  : UWLTUCYOCXTNDB  EIJIMDJA        WTCMR           BROKN           MQJNUYDHVOFQVB 
LDTMHFIGSNQBOS  : NSCQGMU         EUVJMAXTKNFIOKB UJVANUMKMR      ODDGWKODPENQ    HUJTPJFNDHT    
NWOM            : SDKKWJYK        YHDMDTGP        PGBY            XCVKWAO        
HBVQSEKPNYKCCFO : FNWCNQUUF       BDOPJBYXKVNE    UOIKB           IJYVCRJ        
KWUFMNICIRRHGG  : WAYRKJERFSHBOIX SUQMO           GEBG            NEAWHYHGFSV    
PIBGD           : XJGW            SYGUQGFQUBTJUXB KORYQKKC        CHRPKBQHNPVFQ   LMTFXRIM        NBXUCEVJ       
SUVRGXV         : ODIYFIOPJSQ     MTBJUDHUSKO     DSLKACNPUWEGRD  LECLMWHDN      
MKALHFY         : UGIA            WNSSPLJUNJ      QIJNX          
ODDGWKODPENQ    : AQQDCXTWPCM     RCEO            YULYKPLDXOB     IKTUPVW         LDTMHFIGSNQBOS  HXUEPETV        UPFTSAPTBWQCXMN
TXFOTAWTXM      : RGYMYCPRN       KJLLAYYHR       GNWYF           TJYBRUQWUHAX   
IMUPSV          : XKVYYBCOXQUJ    VPEJ            IDXCVSFLTCS    
JBPPXD          : YULYKPLDXOB     CDXWKXCAMFYSRY  HMUJMKOSTRE    
DUKT            : VANPMWWIHXBBR  
WNLEEGECCDOLNE  : RVMSQYGX        FLIABXMVPEOKCN  ASJUJCITANDCGEB
EWGSG           : YUMCIRJNEGWDYW  LFMLMWT         PWQWYQFLDDYYRXN FNWCNQUUF       DULQJSEEPO     
JXHOEMJOGWNTIRY : PKFJCOQBWOVCLB  XSUCNJP         RUDMRGJYHWJEFK  XTCEYMVGGI     
YDTCTHPAPVWVPF  : WETGQQNWMGHOYJ  FTFUWRSFNH      QKFCCKCAPMNHYNG PXFBVOIFXGWXDQ 
BDOPJBYXKVNE    : MCDDGIAKPCGBDUR CHPG            TKNSGHTAUINRJW  HBVQSEKPNYKCCFO
IFXH            : GACYWLNYVCLLWDE
TLHBDHQAHORM    : CWLOWGTISQ      HOAACOTXDUPCNLD YDJGELQOP       SECNNGJPGHPYJP 
USKKCNLDXJQFR   : YQYAQWLO        JDEIY           EVCLPYBEMS      VTTAEA          QAICATD        
KPIXJTHKXO      : DIFGJOIF        WPVNTTHHYIGSTN 
AXRTLNOEA       : KIVITYPPLXWEGPD AOUXCWWYWLBERBL BAAFBVRLSIKU    SKCEXQMG        HMJOLBWEQEB     QNIMLJVPT       MWSM            NEAWHYHGFSV    
IOOLMXFRPGFI    : QKBTRXN         ENTMMD          FEWGXJDYMAQ     KTIJTAEMMRTPS   YHXRHLMKFAIBP   CXRJVP          EKTUSTEBEITTA  
FTLMHJDKLC      : QDNMLEDYBSIKJH  SYGUQGFQUBTJUXB PWQWYQFLDDYYRXN
FPUTVVWEKLSY    : UVBUUQF         RUKGMVINYVVL    CNLQGTXGSR     
XTCEYMVGGI      : FOPEYXGUNUG     WQEX            JXHOEMJOGWNTIRY
NTXBGCGNRBKP    : RQNTAPYWJOVED   QDYV            CBJBK           YVWYHMBLDSSNM   MDDRT           IGWJRJN        
HUJTPJFNDHT     : WIETBV          LDTMHFIGSNQBOS 
TQKDBFQWF       : OPTTA           IDXCVSFLTCS     WKENSVXKDHLN    APQQAXCKBCH    
FIATCCE         : VGRDYVODRA      PSYHJSFNKOC     JUHWA           NCHHCRIJYAAMCA  JQSJWNB        
BLPLHFWNUAUOGR  : AXEGFX          AUDKBRRJJOQJAY  IDXCVSFLTCS     CSLKMSHOJW      YPIRY           NMXAUVB        
SUKXNIFGNNIHQK  : FHQGA           AXEGFX          XXXWPSSMLH      XKLPDAXFILOMXY  YGFWEAG        
LOCBAJIYWDYUTHO : RGHXALWBCVXNARW KRMNGYAJPEWCYVP
ALMA            : TSBYTDBIY       NXLRYAHCGGGSTTV TNFCMWKBGFAUCSU AQXKTEPTBUNY   
WFHLTQSMDJXRLBT : SOIXQBBKHCYJGP  JIOPJKS         AXFJRHP         UPFTSAPTBWQCXMN
LSWORRIBIMBTCB  : SCUWG           TDKT            FUXE           
YHDMDTGP        : KAPAN           EBYTCXDEGVDS    CXRJVP          NWOM           
RPRDSLCEFYSYQDB : RGYMYCPRN       ENTMMD          TVAE            SIVEIRJHPOGGRPQ
SCUWG           : RCEO            LSWORRIBIMBTCB  EPOMU           DULDXASJHOA    
XNTLQPT         : TSBYTDBIY       XSUCNJP        
OLXIQSUS        : BUNOYWQTBFWH    NXCKBGEA        KPPQWH          TEXMYJPCBU      BAOI           
ASRBLWCNPHIO    : CMCBWOKPNWSNBPA KEKXLYQHYDMJ    UOIKB          
BNBWYTM         : SBNYWHVJO       EVCLPYBEMS     
CEGCMWUJ        : QMLOUWNW        CSARVRIULQIMU   UHTGMF         
RJIJLWGPKY      : UWLTUCYOCXTNDB  YIPYQ           AJHRNDCEKP     
UNKWDNTCHJWLPD  : URHCJE          GCOMVV          VHDLCNMODO      WXVKQDHAL       GEBG            JGJHVPAW        NJNXVYTXF      
ECKOSEADPN      : QIJNX           PIOCBCY         KOYICVHCXHWE   
YEMXDIN         : AETLVCMOKJ      BWLWLI          AYSMMAMDIKEBT  
FREBVOMTCCYS    : GLTRNBHKJMMQFH  VQDXJBMESMLSWV  VBMPFYABWVI     STGARNE         AYSMMAMDIKEBT  
CDXWKXCAMFYSRY  : QBCYOMHCYPGPGC  DLUMK           QIMDYVUAVQKPJ   TVAE            MHVLGC          BGCIDAHR        JBPPXD         
CNMJHRLDIAYKD   : NIHNHE          RUKGMVINYVVL   
DMFJMCTKGVWLVR  : AQQDCXTWPCM     XWNSSVCRGJMDWTA XJGW            PIXRYJVRUHGPO   TDKT           
UOIKB           : WAYRKJERFSHBOIX RYLMYXFKI       HBVQSEKPNYKCCFO ASRBLWCNPHIO   
TUGA            : QKGH            USTHJK          ROWHAPO        
IYQNCVA         : GTSYAQFPJOLDCQ  PBHFIJFJRDPHPUY KYFOFI          FTYAETAMUADALD  XRPWLHO         YQHQPKHFSUQES   QAICATD        
FMJBASXY        : HDIIAXPJYBBV    AXFJRHP        
VRMSG           : DJKHCFLYSKNHJ   UHTMGIYHRBUOI  
GJSA            : XRPWLHO         UTQOHFBKIKL     GALNACPOHIRKEJR LXTCVXDW        QKFCCKCAPMNHYNG AMYX            HESDRDGMVSH    
YAKJCBXGXAOFPA  : DKNUONYXTKF     IKTUPVW         WOJIERPVSB     
PSJOAFIMAOK     : AXEGFX          VANPMWWIHXBBR   XTQFKQ          KHWMFTF        
YDJGELQOP       : ERUG            PSYHJSFNKOC     WPVNTTHHYIGSTN  ATVTY           YNGQDC          TLHBDHQAHORM   
MWSM            : AAWNJWVE        PYEPQG          LMUUHWLLXW      CAIMOVSRPOMWVG  IABE            AXRTLNOEA      
ACNJTHUJHATV    : URHCJE          EUNLOO          WAYRKJERFSHBOIX YMORBSRXDR      NNGABLRQMYP    
JJJK            : IEWIJR          OHRPJHYGX       DLNSJ           GWCLLNDN        YQHQPKHFSUQES  
USTHJK          : AQQDCXTWPCM     TJEMBW          WNGSLSLDHYOJD   NRRFNBEJWYKLYX  GVLLJPBDHEXKHT  TUGA           
GYTYLH          : RGHXALWBCVXNARW CAIMOVSRPOMWVG  LVDREMYJUVKGTYI KHWMFTF        
QVNKFJVO        : IIFNXREDBACM    CPDDHHLIXDW     XKNNCJQ        
QKOCT           : MXKDC           CSLKMSHOJW      NMXAUVB        
OJXHFFSPFAOBBCJ : TNFCMWKBGFAUCSU SIVEIRJHPOGGRPQ HMJOLBWEQEB     QHTFGQXYE       JKIBTLKAUSMRJVQ
UHTGMF          : WBEEPWDF        JQSJWNB         QDKE            CEGCMWUJ       
BQWNIBKL        : FMNWPFWCNWOYL   MGVXEDXWNOBRSAH RWDLVKSUQUBJVVP
TJYBRUQWUHAX    : HGMIDRVQ        TUSLBEQEFQXDG   ASBWPIDXIXE     IQFYJECXTIAVL   TXFOTAWTXM     
JEHSAPHFTIXTW   : CMCBWOKPNWSNBPA WXVKQDHAL      
WHVPDGQEALW     : FUVBCUOOCBMP   
IGWJRJN         : KLJVYKTWVQYPNTO LVDREMYJUVKGTYI YPQNNXGJWSYM    NTXBGCGNRBKP   
EPOMU           : FHQGA           EUNLOO          YALXVB          SCUWG           REHC           
UUFTEEDATIIL    : IJYVCRJ         OMMNCJUQ       
IYNHKTF         : IMFJWHQY        HMJOLBWEQEB     UMFVQQTQE       MURRSUVWKU     
MQJNUYDHVOFQVB  : KORYQKKC        XVWAIAEUIRAC    FMNWPFWCNWOYL   MFPHG           CFWWSMWHRIRVJN 
AHAWRIKHTJUBTR  : GUKSQEXDO       ITFBWPGHBL      MFLMTGF        
PGBY            : IKWLH           OCEINYWISK      QKFCCKCAPMNHYNG NWOM            WOJIERPVSB      HOUXTMJVYGR    
WXWGVNNN        : JTSLF           WPVNTTHHYIGSTN  GSRUKFFPL       DLNSJ           JQSJWNB         VQDMKMMXQV     
RMOYMLQXVA      : WPVNTTHHYIGSTN 
HXUEPETV        : YQYAQWLO        WCBHRMLQ        ODDGWKODPENQ    HERFIMQNM      
VREVR           : VBUYXS          MFPHG           XSUCNJP        
SHDITUUI        : WSPG            IGUDFRDL        TKNSGHTAUINRJW  JYIBBCGDPVJNGWV
IVNITNABLW      : FOMEWX          VBHCWSWIYH      XNSLM           CHRPKBQHNPVFQ  
DBCBJXTPTNFMU   : WNSSPLJUNJ      EWMKFFHUXC      AOMTRAWKE       KJLLAYYHR       FGQXIUHCMII    
UOGSYDD         : HOAACOTXDUPCNLD RBYTITPJ        MTYNOUFXFBBXK   OBJPDJDIBK     
QLOGNSUK        : KAPAN           XEANEKSGBU      WCBHRMLQ        SDKKWJYK        NJNXVYTXF      
XOCCAAVRUL      : XFONMTQFMIPDDA  JFLEDNRPCBR     EUNLOO          EAIBFAYQPPQLOT 
JGJHVPAW        : LANQG           BMQEOBSXOSAM    TKXSPK          EUKNICO         UNKWDNTCHJWLPD  EFUXEECVJMKDAW 
DULQJSEEPO      : LQFWHIHMTIY     EWGSG           IJYVCRJ        
PFFRF           : DIFGJOIF        IKME            GPWHYEET        ILPY            PXYXBHL        
PXFBVOIFXGWXDQ  : YUHUKXNRUJFBFGN SBNYWHVJO       MHANQVC         RVRKGR          YDTCTHPAPVWVPF  WOJIERPVSB      SCTBJHGQDKXUFR 
XCVKWAO         : LDCPHHKELRCX    TAHMGQJJO       IXKQANCPRYRSWI  SVNWSXMBA       NWOM            VMJNISEQPAIA    YDONLHUQLCYXIFL
RTDWCUFKNDPOBGW : UGFCERSFUGF     TKXSPK          TDKT           
FFFFLVLLBH      : SYCDWEFS        RFLNKVPPPL      RUBWFBKJUIYPI   IQFYJECXTIAVL  
XKNNCJQ         : ATVTY           QIOPFWWDBBVLSD  YQHQPKHFSUQES   QVNKFJVO       
NNGABLRQMYP     : VBUYXS          XOGGIAWCGISPT   YMKJ            RUBWFBKJUIYPI   DWTM            ACNJTHUJHATV    YDONLHUQLCYXIFL
GXBNJYYUCJTBTJ  : UPOGQRFJYVVETTF HAQAMDQCDUPHETH GEBG            LPQMGAINJB      REHC           
XSHBH           : JFLEDNRPCBR     RYLMYXFKI       PKFJCOQBWOVCLB  YGWSCDQ        
IJYVCRJ         : AYOF            HDIIAXPJYBBV    QPJHQYO         EAIBFAYQPPQLOT  DLTJ            HBVQSEKPNYKCCFO UUFTEEDATIIL    DULQJSEEPO     
HGJH            : VIWAVCNL        TDNBQEKKQXCMVFV WQEX            SCTBJHGQDKXUFR 
WQJWOLGIOCRFC   : XJGW            DFOS            MVVOWMBSCEJSQY 
MDVKN           : FORRB           KDBFACJAYO     
JKIBTLKAUSMRJVQ : QDNMLEDYBSIKJH  AJHRNDCEKP      OGHSQ           OJXHFFSPFAOBBCJ
JYIBBCGDPVJNGWV : WNSSPLJUNJ      QKBTRXN         IKME            CXRJVP          SHDITUUI       
HESDRDGMVSH     : ERUG            FXKSCECIIYYVLX  DLTJ            GJSA            GYXEVCKRNDFC   
QAICATD         : TQRATRTVPWBXVG  JIOPJKS         USKKCNLDXJQFR   IYQNCVA        
VMJNISEQPAIA    : HAQAMDQCDUPHETH MCHXA           PGBQHUPRL       HHFIUXL         XCVKWAO        
BDYELODGXNW     : YUHUKXNRUJFBFGN JMKXABUXOUBMYFC XEANEKSGBU      PHFIMHU         OJQK           
XAXTFCSRNGCGMS  : JFLEDNRPCBR     EFDIQKXLT       RVRKGR          KHWMFTF        
NBXUCEVJ        : WMSGVA          MDFXRTTLO       PIXRYJVRUHGPO   PIBGD          
KOYICVHCXHWE    : GUIDHTKIFQFSWS  CNLQGTXGSR      ECKOSEADPN     
PXYXBHL         : VUEHRJYBQ       SIVEIRJHPOGGRPQ PFFRF           TDKT           
GYXEVCKRNDFC    : KYFOFI          YNGQDC          EYPK            GEBG            VTTAEA          HESDRDGMVSH    
NEAWHYHGFSV     : KWUFMNICIRRHGG  AXRTLNOEA      
UTGCHDKI        : ATVTY           YPQNNXGJWSYM    WOJIERPVSB     
REHC            : MNWPOPA         SMOTIHLR        IABE            EPOMU           GXBNJYYUCJTBTJ 
VFEX            : ATVTY           IMFJWHQY        XXJG           
TDKT            : ETVRFXQGGKGUYV  KFXFOCIUJ       LSWORRIBIMBTCB  DMFJMCTKGVWLVR  RTDWCUFKNDPOBGW PXYXBHL        
LBUSVQXSMFVU    : FGRSPSG         NCHHCRIJYAAMCA  DLTJ           
IDPAKWDLSKPRUJW : SOIXQBBKHCYJGP  XQIHVGYCEKWG    IKME           
FLUGGNDYLVLST   : UGIA            LHYLTUCWWPY     HOUXTMJVYGR    
DFOS            : JHPCW           WQJWOLGIOCRFC  
YSIK            : ATVTY           TYWGUQHUCNCYLK 
VCFSNCCTPWCV    : HWGELVDMPPTPPS  KVGNXXICI       CNJSRGFGTWMBR   YIPYQ           LIKHAQFC       
FUXE            : PGCW            LSWORRIBIMBTCB 
TATWHI          : LHYLTUCWWPY     XJGW            WHBMPT          TKXSPK          ASJUJCITANDCGEB TNBEDXWCP      
NJNXVYTXF       : JTSLF           NSCQGMU         DLNSJ           MFPHG           YTTQCOIDQ       UNKWDNTCHJWLPD  QLOGNSUK       
OJQK            : YWMOXAS         AVPOLXKXWIAG    BDYELODGXNW    
NMXAUVB         : MNWPOPA         ETVIJVAEIGARAK  FGRSPSG         CRJVNCWTXN      CSLKMSHOJW      BLPLHFWNUAUOGR  QKOCT           BAOI           
FUBYTJKOYTCWQE  : VEDNEQOAHIABA   YIBUEGKOLEB     CBJBK           KHLSGGUJAWCIL   TKXSPK          TVAE            SIVEIRJHPOGGRPQ VUCIAG         
FUBYTJKOYTCWQE  : AMYX            EUEHRSQBYKS    
QJIFUA          : CHRPKBQHNPVFQ   MHANQVC        
UPFTSAPTBWQCXMN : ITFBWPGHBL      EUDHSBVNIHRJLP  ODDGWKODPENQ    WFHLTQSMDJXRLBT
COFGMX          : RCEO            JRQTCPFLBFT     SUQMO           BRKG           
IOVQWRSOMJTIE   : GTSYAQFPJOLDCQ  KJLLAYYHR       RLMLVYIYGAWEAXG NXCKBGEA       
AAUYQAXFPIHFP   : TVYNTDTTYWL     ELKDNHJXJ       DHFMVJVQX       PIXRYJVRUHGPO  
TNBEDXWCP       : CAIMOVSRPOMWVG  ASJUJCITANDCGEB XTQFKQ          TATWHI          YGFWEAG        
SECNNGJPGHPYJP  : KRMNGYAJPEWCYVP TLHBDHQAHORM   
BAOI            : SWIXYOT         XOGGIAWCGISPT   OLXIQSUS        NMXAUVB         HLKBXUYADSPIAH 
FCEGIJEGNTYHY   : YDAOFBNVOFJ     EYPK            RUDMRGJYHWJEFK  RVRKGR          HERFIMQNM      
WOJIERPVSB      : TSFOCGFMFLV     BAMGWOUVWIAVVOS VHDLCNMODO      ERCTTNYMJMBPH   YAKJCBXGXAOFPA  PGBY            PXFBVOIFXGWXDQ  UTGCHDKI       
YDONLHUQLCYXIFL : XCVKWAO         NNGABLRQMYP    
EUEHRSQBYKS     : YNGQDC          FUBYTJKOYTCWQE 
DULDXASJHOA     : AXEGFX          ENTMMD          PJXYERHMXBJKEDL SCUWG          
SCTBJHGQDKXUFR  : WETGQQNWMGHOYJ  UJVNVH          QHTFGQXYE       PXFBVOIFXGWXDQ  HGJH           
HERFIMQNM       : HXUEPETV        FCEGIJEGNTYHY  
GVBWYWPDSTMDCDI : ENTMMD          YGWSCDQ         YVWYHMBLDSSNM   CSLKMSHOJW     
EFUXEECVJMKDAW  : SOIXQBBKHCYJGP  ATBKGEKCOAHAO   BMQEOBSXOSAM    IDXCVSFLTCS     IQFYJECXTIAVL   JGJHVPAW       
JUAGVXYYSUMXWRG : OVXWP           CEDDGXBABUFUXWL
XMKVQQB         : TDNBQEKKQXCMVFV OHRPJHYGX      
BNBGQADAUDIRDJ  : BUNOYWQTBFWH    IKME            MGUTTS         
YGFWEAG         : DLUMK           QIMDYVUAVQKPJ   SUKXNIFGNNIHQK  TNBEDXWCP      
ASDW            : URHCJE          TUSLBEQEFQXDG   AYSMMAMDIKEBT  
UACXPDGGDLIXQ   : RQNTAPYWJOVED   HAREORCO       
RWDLVKSUQUBJVVP : WJMYHMKPUQPU    WQGLBCYHH       BQWNIBKL       
HMUJMKOSTRE     : TQRATRTVPWBXVG  IILHPD          JBPPXD         
SWVMTAXPKTND    : IIFNXREDBACM    JDEIY           EFDIQKXLT      
OMMNCJUQ        : YWMOXAS         ILPY            IDNMVLJ         UUFTEEDATIIL   
HDRVVNOCPJ      : CHPAPDCGTKE     XQKPXIIE        IKME            HMJOLBWEQEB     CSLKMSHOJW     
MVVOWMBSCEJSQY  : EBYTCXDEGVDS    VIQOSUBEXU      XTQFKQ          BDCUEMENRRDSA   WQJWOLGIOCRFC  
VIEMNLQ         : VKSNRQRGNJFCHOF KFXFOCIUJ      
HOUXTMJVYGR     : VGRDYVODRA      YNGQDC          AVCJNNSFCY      HUCOPSLJIPWLLY  PGBY            FLUGGNDYLVLST  
FGQXIUHCMII     : OTIXFEXWODTH    TOTBIHOS        DBCBJXTPTNFMU  
ROWHAPO         : JBTCHKEPQTWEPJ  MFLMTGF         YPFXMQXBLXFK    CBJBK           TUGA           
HLKBXUYADSPIAH  : TSBYTDBIY       VEDNEQOAHIABA   UTQOHFBKIKL     ILPY            BAOI           
ICPMQYXBSM      : NIHNHE          CHPAPDCGTKE     MONVPKNESEY     JDEIY           VANPMWWIHXBBR  
APQQAXCKBCH     : QKGH            AUDKBRRJJOQJAY  TQKDBFQWF      
EKTUSTEBEITTA   : XIYYXFOE        WMSGVA          OXWKEQH         IOOLMXFRPGFI   
