UFWBXMCWWVBWXW  : EAPEOAWMNUJ     YSOTXKHW        TMJJFFJQYMPFQC  RPEJAAYSCH      YEPUTSJCJKUA    CEUSMYRVMRKS   
UABITPGJXQOFOPE : NXEDBAQS        ESNPHSFDVJ      ESBYSITCRTQOP   EAHMNXMRSOPCS   LYDLQOEKN       KQOAXD         
LMMOMCSJY       : MLESACGPGCD     HCVPXCBE        WCNDCKK        
MXOJLJMPRGHAS   : BHVLVVLXEOR     AYQFPSISFEWNQTO HFOJAI         
RHNGXRVLGJASLSE : AXCGASKA        TBWG            KQVCYKXMFXD     GROEVF          CEHOIKJNMBRQP  
JRKXDYHP        : UNNRC           SAENTEPMHBMU   
YYXCRE          : WWXVSFMQ        CHLLHGDLBKWEHH  TCPHW           RLHKDELP        QEXUTUQOETYQ    AIEJXNNNLD      JSQVVSXBWR     
YRAYL           : HSIQMSOPTVIIXJJ WXOLNF          AIKX            FELGPOWEO       UDIRNSTUJKUIV   UBKVGWUFQCS     SDSOQVNERVDLOWC
KUIMN           : PTMVONTOGI      HTTDLPRH       
HSIQMSOPTVIIXJJ : YRAYL           WMLP            DSCCIDJ         CAFYBWVHKL      ICFSMLY        
BNTCHV          : WDPQQCRIEQIS    MNNJNBDB       
UUMPDCGYJYHBNDP : TUIBFVUQFTPH   
WOPIMYROCHIFQG  : QPPXSAHFL       SRHWYTIQXODR    RUUSJDONBQFI    CVPXVSVSQVEBVEH MEGJMGPLHQOFSM 
LCXEHAKHKLQNYVD : XVTMJT          EJNMJAWI        OXRSBMFPURSX   
TRUEG           : EXCULKDL       
XUYHFGXMR       : ESNPHSFDVJ      XRQJYAKQI       KRXT            TENVON         
QPPXSAHFL       : WOPIMYROCHIFQG  VJMBMOLTL       UWROU           SUBOCTFQRG      WGWBXCU        
SMUXRQSOWYMUUL  : AIUKELSHDIURWM  OODTJJMPTSKUKVI HCVPXCBE        FUEAXTYTRRISWDR WBVNABBHE       MVMCDJ          KMJYMTESA       WGWBXCU        
CTCOLOHEEGWFPES : PTMVONTOGI     
YGMWADP         : FASM            HBBPLH          HWOOS           OPHMFVKPOF      WTKDXILNHHQ    
BRDXORD         : EUPRJMLAMLRQ    EQDGPW         
LFGXTPEBVBIMHB  : MCXDIQOWYALWPE  UELVRRLOL       LSLYDFOGUMR     FFKADRWWCBB     OESVQLPQMSKSWP 
GJPFJVXCYPG     : SAENTEPMHBMU   
EXCULKDL        : TRUEG           CHGLDDP         ULWUMUHNO       DJPDFAO         ADVL            HUITLVQWNMU    
TPHRSPGATMIDCO  : GCTINX          BXKDSL          QMQRINDVHSXEMY  JYLTMXKWKXSTXHS ALPLMLXPAONIWWW
AMRB            : WWSLAWNYOKIMKO  ACSEIKLPJ       HEVMYOA        
ABKAFH          : UWIL            KNGVOIC         HPEFXWVCUXDSCX  WGWBXCU        
PNXW            : JPPKH           UMCWMJKJFBV     BHNFE          
OEBJWKKQWSVBJLE : LTONRPTU        VQOAGOKVLUQCE   CEUAIFJD       
GFCG            : EXNHGRFPBYCU    KYMMMYQWY       SGVEXISK       
OHOWV           : UORXYJJFGN      VKTY            OLRQCSHVEJFDL   UWDUHOQTBR      AYQFPSISFEWNQTO BTNGRDI         NELONS         
KTBTKIWUHHH     : XFFLOST         BJGKL           MBUANSL        
GCVIMKMKSTPYD   : THWMTQSYADHQK   NYBPJB         
IRDE            : SKDAROIHFFNVHSP NOVE           
NBAJNKJKRSRRAWP : XYFCBBUSS       MEWQNKVRAJJFH   LVTRGYBCVKK    
JCYVU           : RJGBGOAG        VKOWWSVNIH      GENSUXYREVDK    CEUSMYRVMRKS   
NWXSHP          : XKOXKSDCBOYFBEJ UDIRNSTUJKUIV   UCVHWHQY       
MOMPOXDBHOSB    : FAEJUBSEQTKTUKK PCILQQTPHCCNQGV SDLQPQMCYNEY    TBYDEKQNBDQP   
MDFE            : ABCFUFSOWHWC    KWTNBWMVFWTSTO 
QHOPEJ          : NHEPSNTSPVRTV   SUCXUKXSP       AJRXOACX       
BIXJ            : ULEREYFB        NVIIILLQSH      CPEIIKUITWVXRGX TSXJJSTFLDCAF  
WXOLNF          : YRAYL           TBWG            UPLM           
SGTJBWSNAASPTC  : RBHIF           BLWNAYD        
LGROKCPVDOTR    : YINWYN          WISAOC          UWDUHOQTBR      RQJCDUDAODEMAGO
JXLCGFOIEHX     : XHMYPJEI        QGFGWAPPGXE     DFJYQGR         HRLBEITGRHY    
JSXFUEQEYI      : NJQBWFIR        FKOUNGRIYVEBDM  XFFLOST         KRFPJVBOFTTIOVQ
BAMEOIYORYCVF   : MWKLFUEQEIE     HNWTOK          XQFLYKFOHODM    LRVXYMWR        MGIIR           EIWCTBVA        NUVFUPRCA      
KPOTOVGHTLFB    : OYHETAQPAVB     FKAERT          ESNPHSFDVJ      CSQJWFFJEJHU    SOARPDNMSBHY   
LANCBNO         : SEPMFQLGCDAMH   KGCHBKEI        HFXBJ           SOARPDNMSBHY   
EWHUQGWM        : OLGUUK          ATGWKKRRC       PTMVONTOGI      NJQWEPC         SVOBIHREGMEJMWE
HAEYTSWCCQOJ    : OESVQLPQMSKSWP 
VUTJWXYLGFKN    : KRXT            GRXKYTIB        HENKHAETXJHAN   KGYHIWLTUPP     NAJGCV          PKRLEFN        
BVWQJHSNIOIFR   : AMDO            JPGOEM          HILGQJGXVI      GOTPCYTN       
VGWQESMNPKOEQTQ : BDKLKPSOYSR     NVLDKINL       
VUCUNMCGCKUNRMB : WWSLAWNYOKIMKO  MGIIR           XBLYIJSKT       LUSAUYFJ        RVIRXBDKMR      JHNWANEFCI      WCGLEALTFNGGE  
UAHYSVOL        : EJBSTHTHKQVDA   JAJYBRFYSFV     TRHNNRCN        EYGWRY         
FRABI           : MSXRKLBCE       LIFTNUG         AUTYDEACMR     
WFLUS           : TDVDCGPVXSM    
WBFKYSENTULTCK  : MWKLFUEQEIE    
BCDIJUKNFTM     : CLDO            BJOBEC          GPKXQYCH        YRTXXJLVDKYKG  
GHIIHKNTJGXWCTI : ATKUFIFKOCKXJT  XJUYDIONHCF     SWECGCDRJEWTP   GBYKCPYB       
XVQYATJJQUYXOML : WMEKKSLM        OLGUUK          ULWUMUHNO       YRDG           
TUIBFVUQFTPH    : UUMPDCGYJYHBNDP IKJWVIQQQUXNPO  KNWDKWYPU      
YINWYN          : LGROKCPVDOTR    PCIOJFINKHMOF   GQTEQINKAPEP   
UWIL            : ABKAFH          DDBKEUVVDSJGPMO HRLBEITGRHY     ILXSCGW         LSPDYAQJKKOAWMB
IKJWVIQQQUXNPO  : TUIBFVUQFTPH    UGCUHEMC        FGHB            WEQJR           TDTDNJCRUY     
LHCBGLPFMDCIC   : UWROU           FDAOSFXWTFUGRT  WXVREUQTPRXG   
VUWGGT          : WGJAYGPUNPE     OGQRSXAGGTULPC  NWCSDBEPOOQP    ETHN            XSJMWRWQXFEEOSB
QNXIIWXXNSMUWN  : YRFCG           OEXCBUUXNFYIGRY CUXU           
KFIXKMINC       : IINPAHI         PJLOAGBTHEMPMEQ KAGB           
IBLQVQH         : GKPHCELLXMXCVWF JEKOQKL         NELONS         
ORTNPTEKGBIWF   : WDITQLUS        BTKWTNDJXS      HTTDLPRH        HEVMYOA        
CPQNDBBHGLIT    : MCNSEIMEN       RHPGFCX         BEJLPTXMU      
EMLPDELRV       : NUVFUPRCA       JDXGC          
XHMYPJEI        : JXLCGFOIEHX     DLDOREUJACAXGD  YXCSCPYTXSOXCRY AVGCFKOFUMCES   JOMINRKIFXHEF  
WCCAFFH         : YYHLKEVXHPPTW   ETCHTGVC        GFYKVOR        
SRHWYTIQXODR    : WOPIMYROCHIFQG  FLHDJQEKUW     
JPSXOIIVSY      : WTKDXILNHHQ    
WDUDIEQBVYAUS   : JXXFOQWUPDSHLH  JTLJIBCJDQOGSEY PHQIWDXO        NWCSDBEPOOQP    KNWDKWYPU      
MSXRKLBCE       : FRABI           AMYDQPCPUUSE   
TOJRJIKJLHMV    : JMSQI           UWROU           WYEUKOEFDBA     EQDGPW         
FYJEYHAKV       : WRSXHIGIM       MTSBJNYMR       SKREFHK         EYOJAXAR        JOMINRKIFXHEF  
KNGVOIC         : ABKAFH          HBYAFPNIGSS     GVPDCAXSL       JEUHOYAMDCYYQ   XBLYIJSKT       KQOAXD          QEXUTUQOETYQ   
CQCTCKG         : JUIBCER         WDITQLUS        UBASBSTTMDDFGS 
YPAUDGWNMV      : GKPHCELLXMXCVWF CCNNOHSEBLYF    WISAOC          YRDG           
MGSIQ           : UNNRC          
OOWYQOEHQAKEJXD : GCTINX          BCJUFXRYGLA     MFJGMO          KXVEVWWLW       OIVBWXU        
YADHWSTV        : AJRXOACX        WWKRXKFA        IXOBYRYENJNP    FVDUJJTCEBI    
HEKRV           : NVTUMQSF        YAOCOQQDHVWQF   DKTUYQOLLFBFX   PCMOYBWXMKHRL   XGQNNBRS        YESUU          
GKPHCELLXMXCVWF : IBLQVQH         YPAUDGWNMV      MDYOAUE         DEHQELPJEXDUHFC
XHAFHUYF        : DMXEDRO         UMCWMJKJFBV     AHSYAEYAUAQFJG  AVGCFKOFUMCES   PCIOJFINKHMOF   UAAUMYGQ        ECEBS           MEGJMGPLHQOFSM 
XHAFHUYF        : AXOPKAOLSR     
IJWAHPIUF       : BPBTEUFAH       KGYHIWLTUPP    
WMEKKSLM        : XVQYATJJQUYXOML NATK            RLHKDELP        GOTPCYTN        MUBGWIHFOMT    
ITOI            : SNAPAMFPEEFTAF  NEKEFPBUA       BTKWTNDJXS      VBOFKIACERUVXP 
QNKMOPYXCYAJOJ  : RBHIF           EYOJAXAR        FHBEQGONOOXOEYN
UCDJIOV         : XKOXKSDCBOYFBEJ BTKWTNDJXS      LKXXMTOCI      
AIUKELSHDIURWM  : SMUXRQSOWYMUUL  LKXXMTOCI       MNPMCE         
UORXYJJFGN      : OHOWV           JUMJXLGNMVJAUSH XKWIIKQINPP     WOISTIO         POWPBSSVNO      FSKNFQKFFKQPN  
PVXLAAVVMA      : CVPXVSVSQVEBVEH CTGAN           YYLJPPQSSTKRERE XYFCBBUSS       FMBLOFAETUJWERV MBUANSL        
FJMPGGMTA       : DUKVPNTC        HBYAFPNIGSS     TQWO            HAWBWWM        
KTILDRRJFB      : AYIHLMIR        FAEJUBSEQTKTUKK FGSMDGRWGA      KEPQJELM       
DBMEDICPKLWWYMD : XYTFSQXMVSKI    XWSFDJ          PHQIWDXO       
YYHLKEVXHPPTW   : WCCAFFH         KIOPQFNLLWDNLR  JPGOEM          XGQNNBRS        EUCSDVKYTNFAHCL
UBVIHYS         : PVNJXTDJJFWLJD 
QGUND           : DDBKEUVVDSJGPMO LBIUV           MMVIOFTMISJS    EFUXII          JUMJXLGNMVJAUSH
AIECIL          : BTOXJW          CURQQEAFE      
UPMSACLTAG      : TIWOXJUL        RYAODSFUXIPJY   LSIHGPVQNXKW   
DDBKEUVVDSJGPMO : UWIL            QGUND           DKTUYQOLLFBFX   WGENITJXXMHOTVY LVTRGYBCVKK    
OYHETAQPAVB     : KPOTOVGHTLFB    EHIVFEROJGELAJ  VJIRJRGCOIAKT   EXNHGRFPBYCU    SIMH            EAPEOAWMNUJ     BMYVVWAIEE      XFDLM          
VJMBMOLTL       : QPPXSAHFL       YPNKYVWYAPUURF  AXCGASKA        IMTMAQQ         ILXSCGW         NELONS         
POEBW           : PPINHCJWLUKVJ   YAOCOQQDHVWQF   QPXTWKM         HOCRXPFBJ       SXYCMLTQJOKO   
NNRCNAJJ        : BAQCBSFPLSFU    CMFGCAKRQ       EPRGTG         
AYCVCXTMMUBBIWM : TRAILCCEM       ILXSCGW         NIRMCMVJUWG     RQJCDUDAODEMAGO IUFYVHPSF      
MDYOAUE         : GKPHCELLXMXCVWF ATKUFIFKOCKXJT  ILWBBEBWEWLTVLG
NHEPSNTSPVRTV   : QHOPEJ          EXNHGRFPBYCU    YMUIHHENY       LEYTS          
GKLKMVHBSWF     : XXHKCUDGFRMTL   MVMCDJ          WWQCBPBKSIKKCET XVVWBJHPUHVDO  
NHORVEBCVT      : DKHELHNUNITUO   SHBWLYUOFDYUXS  JXXFOQWUPDSHLH 
PPINHCJWLUKVJ   : POEBW           QEVGALTOU       AKDGHDCUHLUPDJX FLHDJQEKUW      RFOSSKIRU      
FKAERT          : KPOTOVGHTLFB    XDVIXQKOHVCPY   HENKHAETXJHAN   HPLCH           JAVQNOLONFSL    OEXCBUUXNFYIGRY
AIKX            : YRAYL           CEUSMYRVMRKS   
NBLITEXCRHECE   : PIMEL           BDKLKPSOYSR    
YPNKYVWYAPUURF  : VJMBMOLTL       BAQCBSFPLSFU    HRLBEITGRHY     PBVRBNMUKYCL    QEVGALTOU      
RUUSJDONBQFI    : WOPIMYROCHIFQG  JAJYBRFYSFV     GCGUI           WEQJR           AUTYDEACMR      DTDLUYLICK      NVIIILLQSH     
JPPKH           : PNXW            VKTY            LCVTAKMUKOMB    ERUGYIIXMAYULA 
UGCUHEMC        : IKJWVIQQQUXNPO  ABCFUFSOWHWC    JNSTNUVISBMWI   AGDADOOORDDHIWE LNKRIOILVWDA    ROTQHVDINDTYRJ  AIEJXNNNLD      JHSBPTYV       
EHIVFEROJGELAJ  : OYHETAQPAVB     MWKLFUEQEIE     PTMVONTOGI      HSOIOFE        
XVNPGUVE        : WRSXHIGIM       XKHMKERCPLRNTY  KOMRNKEKVNUMXL  EIWCTBVA        YTBFGOCYNWDINV  OMCUPDUU       
AYIHLMIR        : KTILDRRJFB      NQYRWIIBVXLD    EAHMNXMRSOPCS   KEPQJELM       
RPCXHSHQWUQGT   : NYBPJB         
CHGLDDP         : EXCULKDL        EAFFTDSGTM      UJPOGJUA        GUIMWWVWWXPCS   FJVUHIXWLOJ     VBOFKIACERUVXP 
DQPKCCVTYNL     : PHQIWDXO        OGDNXQYOIC     
NVTUMQSF        : HEKRV           KNNDIHGXNLIFHPD MPXQICPEYFSBW   ADVL            PRTJRSAKFAYQ   
MVETCPWHHENXT   : TWRDHKCUFFWR   
AXVVX           : WMLP            FGINUSKLHMIVOPU FMEL            PVLVUPFCQLD     FKOUNGRIYVEBDM  SNWIFWTMEP     
KYYGTU          : YNYEWFVYTIKF    AEPVSYUMIYLNG   FBXWIVUH        EJLLVYSNSTY    
MPXMCVRXXJXI    : LWORJSAO        IHSXXKABIEUY    MCNSEIMEN      
CVPXVSVSQVEBVEH : WOPIMYROCHIFQG  PVXLAAVVMA      MSIEEEBVW      
BCGQATUXNSWWQ   : CKAQFJTIWQ      FDJJBNMADFHJEYB KQVCYKXMFXD     EUPRJMLAMLRQ    SDHNFENKPFXYGP 
QUDJUYETTU      : FAEJUBSEQTKTUKK SIMFPTBCBLPK    QQHJV           RVYPCHK         PHCXGXH        
YYNFGHGJOYLITK  : YRFCG           PVADGVMAOMKC    PLGFPFG         LORGMEOYQLTVR   IWIPE           UROTYDIWHEMNVQ  UERWEHMXT      
MJWGSQDVAYW     : NWSI            RPIYBASVFCEHVH  GENSUXYREVDK   
URYKSABXHIGS    : QYFTLPA         RBHIF           SDHNFENKPFXYGP  LTXWDPSNNX      KWLEPDTROAICGGD
FGHB            : IKJWVIQQQUXNPO 
HPEFXWVCUXDSCX  : ABKAFH          HBRIBCWYMPCQ    WRSRUKHAPTJ     YQSUAFOUF       ECDKNNUKVQHTO  
DKHELHNUNITUO   : NHORVEBCVT      BNOYMJGA        FAEJUBSEQTKTUKK PHGAVXXMHDEN    SXYCMLTQJOKO   
XKJNOQMOM       : IXGLGHPJKQMY    FDAOSFXWTFUGRT  OLUCTKXR       
JKTEORQSCAYQ    : LEYTS           EYGWRY         
MLWUHTLJRVVINM  : WISAOC          XQNHGPCULIFUCSE
CCNNOHSEBLYF    : YPAUDGWNMV      FQKMOCRDA       SAENTEPMHBMU   
XVTMJT          : LCXEHAKHKLQNYVD CFEJYB          MEBLOISDXMYN   
RNUBIRYQF       : POWPBSSVNO      IYOUVIOCKRFI    OREWFKDLUHN     AOLKSJSUU      
NJQBWFIR        : JSXFUEQEYI      OGQRSXAGGTULPC  MEGJMGPLHQOFSM  NOVE           
JEKOQKL         : IBLQVQH         FASM            IJRNGHON        OJQNTDGHI       WBWUYGLHVU      HRLBEITGRHY     HFXBJ           BJGKL          
JEKOQKL         : YWWAIAATHKTU   
WWGGOUCQDVRVDG  : FMEL            WCNDCKK         EMIOEXHXTBKLF   BMSERJLIYCWYQ   YHYDCVTNNNBIXV  DEESVS          DDWANNG        
MWKLFUEQEIE     : BAMEOIYORYCVF   WBFKYSENTULTCK  EHIVFEROJGELAJ  AJVJPFUFCYYHBFY HGDCITC        
BQINOGUWURBN    : WYTLIOULSYGUAG  DQRFDHGPCMM    
WISAOC          : LGROKCPVDOTR    YPAUDGWNMV      MLWUHTLJRVVINM  SVCYMVOB        IJVKWUQBBDVHOM  FMWXFVQFSBGRDOD PRTJRSAKFAYQ   
OODTJJMPTSKUKVI : SMUXRQSOWYMUUL  CSQJWFFJEJHU    XKHMKERCPLRNTY  YDIMFR         
EFXBWAR         : YAOCOQQDHVWQF   BFPIJWCLFEOX    BJJVRDKPRDOKPGI UFSMKAMWYPKKQB 
YAOCOQQDHVWQF   : HEKRV           POEBW           EFXBWAR         MJJDNX          YTBFGOCYNWDINV 
GYFTTRRF        : BVFAXSQWPCELKY  EYOJAXAR        KRFPJVBOFTTIOVQ AXOPKAOLSR     
VKTY            : OHOWV           JPPKH           NUVFUPRCA       BJGKL          
TQGSQVUGOO      : PVAS            QAQBQ           PVNJXTDJJFWLJD  XQFLYKFOHODM    EIWCTBVA        SNCMCPOISQ     
WMLP            : HSIQMSOPTVIIXJJ AXVVX          
XYTFSQXMVSKI    : DBMEDICPKLWWYMD EYOJAXAR        LKXXMTOCI      
JUIBCER         : CQCTCKG         GJPNYG          PLGFPFG         THWMTQSYADHQK   ANWFBGKUDLPOKFP YTBFGOCYNWDINV  INUUIH         
YAQPMPFXGXXFT   : FMBLOFAETUJWERV TMOAUTUPKWPLQ  
AMDO            : BVWQJHSNIOIFR   LTONRPTU        OLGXDJW         FQTWAAEYEOYWMD  FQKMOCRDA      
WYTLIOULSYGUAG  : BQINOGUWURBN    ATKUFIFKOCKXJT  GOTPCYTN       
SUCXUKXSP       : QHOPEJ          OXTIPTCMEQQJ    EAPEOAWMNUJ     NCKJGWXS        EDYAFOJCXDCTQR 
YRFCG           : QNXIIWXXNSMUWN  YYNFGHGJOYLITK  HFOJAI          UROTYDIWHEMNVQ 
BFLNQDI         : OGREOTSAQGLP    MNUMNQNHLG      RFOSSKIRU       IFRA            CEHJCSDPQ       SOARPDNMSBHY   
VJIRJRGCOIAKT   : OYHETAQPAVB     EOBGLBQAV       LLHTMM          PTMVONTOGI      XJUYDIONHCF     ULEREYFB        NAJGCV          RIGIFUTO       
DLSCGXHMPI      : EBVASSBULGWGLOR QAQBQ           XGQNNBRS        GOTPCYTN        RPEJAAYSCH     
EXNHGRFPBYCU    : GFCG            OYHETAQPAVB     NHEPSNTSPVRTV   GCTINX          AEPVSYUMIYLNG   PMCNTYYUGXYK    ACSEIKLPJ      
EJOHTKFAXAC     : VCJFWMYD        RWBQPPDDS       REDWYE          HIDSPVEECWQ    
XLTQUQUSG       : NHCMJT         
CXJTYJVVODIF    : OLGUUK          BCMV            KVPYRPXVF       UCTXGFJVCKLWEWO
CRREQSJWSUSJPJG : ESKFMN         
PKPOUJPEG       : RUHVWEI         THWMTQSYADHQK   LTXWDPSNNX      LKXXMTOCI       TEBKPGVCIF     
ULWBVBSNGLGPJC  : NJQWEPC        
CLDO            : BCDIJUKNFTM     DULPJIAXWERWJ   XMYQQHP         QYILKQQENNEPU   DJMXYKDCWR     
QGFGWAPPGXE     : JXLCGFOIEHX     CAOQNNHMORTA   
JBDHEXXK        : JDXGC          
GCTINX          : TPHRSPGATMIDCO  OOWYQOEHQAKEJXD EXNHGRFPBYCU    FDMXHJXUV      
SMPJ            : ALHDVXR         VKOWWSVNIH      UUOQV           POWPBSSVNO      SORWG           EIPTEVAISSR    
WRSXHIGIM       : FYJEYHAKV       XVNPGUVE        YQAWXL          IFABKTMXCLACM   YDIMFR         
TPNCUM          : EOIXGGFGXLJXMVA DLDOREUJACAXGD  BYTVK           VATYYSENWQG     KBFFCROENVAPTVH
HYGKSPA         : QFAGVJ          HJRYEXDBAW     
MSIEEEBVW       : CVPXVSVSQVEBVEH JGFGQXFSBLRP    CMFGCAKRQ       FMKPFEASCHK     MGPBC           QEXUTUQOETYQ   
FGINUSKLHMIVOPU : AXVVX          
CPOCKD          : BJOBEC          XFFLOST         EQDGPW         
SHBWLYUOFDYUXS  : NHORVEBCVT      KQVCYKXMFXD     OLGXDJW        
LCVTAKMUKOMB    : JPPKH           ESHICUK         NOVE           
WFQQO           : JXNKQEVRHJIPU   BUYUEFUFJDC     XXHKCUDGFRMTL   AIVW           
NATK            : WMEKKSLM        UMJWSJEY        TCPHW           HPLCH          
BNOYMJGA        : DKHELHNUNITUO   TIWOXJUL        PSKXTBR         MEWQNKVRAJJFH   MUBGWIHFOMT     JHSBPTYV       
DULPJIAXWERWJ   : CLDO            FPTFUKYTFOWAVLH RWBQPPDDS       ANWFBGKUDLPOKFP
NXEDBAQS        : UABITPGJXQOFOPE YVPVNSRQGMQUXU  SYJGATHVCXTRH   OINF           
EJBSTHTHKQVDA   : UAHYSVOL        WOISTIO         DDWANNG        
FAEJUBSEQTKTUKK : MOMPOXDBHOSB    KTILDRRJFB      QUDJUYETTU      DKHELHNUNITUO   UUIWGXCHEVENUI  BVOVIA          BJGKL           BSOCHQP        
MRYPMSXGDKYYPB  : HBYAFPNIGSS     ULEREYFB        FMWXFVQFSBGRDOD
VCJFWMYD        : EJOHTKFAXAC     QYFTLPA        
SNAPAMFPEEFTAF  : ITOI            HNWTOK          MKULN          
DSCCIDJ         : HSIQMSOPTVIIXJJ IHSXXKABIEUY    JUMJXLGNMVJAUSH EUPRJMLAMLRQ    LSBSUT          UXPIIPEPD      
HVMEILHOGWOX    : YMUIHHENY       AQYDNIMJAGHFUC 
BFPIJWCLFEOX    : EFXBWAR         FDMXHJXUV       MDKKXAVD        SNWIFWTMEP     
SIMFPTBCBLPK    : QUDJUYETTU      QAQBQ           WWXVSFMQ        WDPQQCRIEQIS    LEYTS          
XKOXKSDCBOYFBEJ : NWXSHP          UCDJIOV         RPLCV           FGTTUTUUTJHB    XYFCBBUSS       BTNGRDI         WCGLEALTFNGGE  
ESNPHSFDVJ      : UABITPGJXQOFOPE XUYHFGXMR       KPOTOVGHTLFB    IUFXKIGUOG      WWQCBPBKSIKKCET
HBRIBCWYMPCQ    : HPEFXWVCUXDSCX  KSHDEBWGLYY     POWPBSSVNO      TMOAUTUPKWPLQ  
QPXTWKM         : POEBW           XFFLOST         FQTWAAEYEOYWMD  BDIJQUCIBP      OEXCBUUXNFYIGRY QXQBBMTKQS     
FASM            : YGMWADP         JEKOQKL         STDHGCTDMCKQRLU
XRQJYAKQI       : XUYHFGXMR       BHVLVVLXEOR     LTONRPTU        CTGAN           HOCRXPFBJ      
SIMH            : OYHETAQPAVB     HCMY            HJRYEXDBAW      ILWBBEBWEWLTVLG BSOCHQP        
OXTIPTCMEQQJ    : SUCXUKXSP       RKVLSIEAT       WYTITDOPCIVSTTN NBQES           ICFSMLY         KBFFCROENVAPTVH
JXNKQEVRHJIPU   : WFQQO           KNNDIHGXNLIFHPD JNSTNUVISBMWI   YVPVNSRQGMQUXU 
XKKBYKWJA       : ACGJHLWS        BUKOFJDDDGTNTA  HFXTALHEWDTTP   QWDSCVJCWIG     RVIRXBDKMR     
MPXDGJWRIKEBRBS : PVNJXTDJJFWLJD  RUHVWEI         LSBSUT          UBASBSTTMDDFGS 
KDQHGRRQSTDPDD  : TOOXTXYW        WBVNABBHE      
RSGVBQUVB       : WOISTIO         WJFFSTHFR       HEVMYOA        
AEBBYCNCT       : TMJJFFJQYMPFQC  JHNWANEFCI     
KNNDIHGXNLIFHPD : NVTUMQSF        JXNKQEVRHJIPU   YXBLP           RJGBGOAG        XXHKCUDGFRMTL   JAVQNOLONFSL    WYQSLTYDQIFRB   KQURPCLPWKBND  
KNNDIHGXNLIFHPD : KWLEPDTROAICGGD YQSUAFOUF      
IXGLGHPJKQMY    : XKJNOQMOM       QCWGFNMXJC      FANKP           XVMNWWKCY      
IUFXKIGUOG      : ESNPHSFDVJ      CONJGRUQRBCA    WDITQLUS        WSFNLJPGSLF    
CONJGRUQRBCA    : IUFXKIGUOG      IWIPE           SORWG           HTXIUVAO       
TKVKYWHHRMF     : HUUMFMKUSC      SAILSKLYTCLVBX  QYILKQQENNEPU   IATDDFVSVIWWXB 
WLYNRJQIXAPRUGJ : LORGMEOYQLTVR   TNSKKXXOALBUY   CDARQSRPQ      
LKJFUFSTCCDVP   : RJLIKOUNQV      ESHICUK         OINF            JSQVVSXBWR     
DMXEDRO         : XHAFHUYF        HTNSRG          HUITLVQWNMU    
AOVRGRB         : BCMV            NVLDKINL        MVMCDJ          ROTQHVDINDTYRJ 
QMCCTYIO        : OIVBWXU        
MRXLJKQXK       : QAQBQ           WRSRUKHAPTJ     ULETXIELUCJHVXL AXTYKLG         DJMXYKDCWR     
BCJUFXRYGLA     : OOWYQOEHQAKEJXD RRPOYYK         UXTKEHAGRMITDDN MKXJNAQOYWNN   
EOBGLBQAV       : VJIRJRGCOIAKT   WMTKGLYVKHKP    SRJWQCDOI       WCGLEALTFNGGE  
TWRDHKCUFFWR    : MVETCPWHHENXT   LVTRGYBCVKK     QEXUTUQOETYQ    JHSBPTYV       
ERUGYIIXMAYULA  : JPPKH           LBIUV           TNWFOAPCMFVDG   HIDSPVEECWQ     HSOIOFE        
NWSI            : MJWGSQDVAYW     GNSWDQFGVOPVYIE
MLDWPXEV        : UXPIIPEPD      
VYEOVKNEVNSVMNH : DKTUYQOLLFBFX   OODO            FUEAXTYTRRISWDR
AUMU            : CACUJHAMEIXG    KIOPQFNLLWDNLR  MUAIRYYTAQXMKG  KOKFVDUJGJI     MOIKLVHAMYHYE   EPVCLGHKQSAYBRG
IJRNGHON        : JEKOQKL         JGFGQXFSBLRP    OLUCTKXR       
MLESACGPGCD     : LMMOMCSJY      
XQNHGPCULIFUCSE : MLWUHTLJRVVINM  HCVPXCBE        HMSFIPCDYJ      SEIMVYBWAOD     ECYAFNQFPSAMHQ  TMOAUTUPKWPLQ   ADVKQGTCYSGYVHB
HTRVFXR         : BJJVRDKPRDOKPGI TOOXTXYW        FUEAXTYTRRISWDR ICFSMLY         REDWYE          IUFYVHPSF       GPKXQYCH       
BXXJCCJCUY      : PLGFPFG         FGWIJKIBYFDUR   EPVCLGHKQSAYBRG
DONXCXDAA       : CVUJQ           HUUMFMKUSC     
EOIXGGFGXLJXMVA : TPNCUM          KHAEOQAYITQHS   WRSRUKHAPTJ     APMNYMVCY       MCNSEIMEN       KQVCYKXMFXD     OXEWAUJJVQR    
FELGPOWEO       : YRAYL           ODDDN           KWLEPDTROAICGGD
ETCHTGVC        : WCCAFFH         NHCMJT          XXSNKLBGKFQDDN  HOKAMTVOYG      YEPUTSJCJKUA   
EJNMJAWI        : LCXEHAKHKLQNYVD GFBXUYPYSOK     ETHN           
SKDAROIHFFNVHSP : IRDE            RJLIKOUNQV      XJUYDIONHCF     VBOFKIACERUVXP 
AJRXOACX        : QHOPEJ          YADHWSTV        EGYFKOKMULQRH   NJQWEPC         SWHDOEVSOLNJTWG QEXUTUQOETYQ    UNOMQJCWMPLUJ  
OJQNTDGHI       : JEKOQKL         GCPP            QIFHDLEQCV      GVYSENJUSYI    
YYQGEYUC        : MTSBJNYMR       TPTFXJSFRNNE    EYGWRY          YOOVSLA        
PRQRDKPRLTR     : JTLJIBCJDQOGSEY ONFULEL         FMCXBDPWRKH    
ICQWXVFFGQEFHN  : UWROU           YQAWXL         
IINPAHI         : KFIXKMINC       TIWOXJUL        ALHDVXR         RBQW           
KSHDEBWGLYY     : HBRIBCWYMPCQ    BYTVK           PBFVPEOXQWWQH   HQEAPDCQEHVHU  
XWSFDJ          : DBMEDICPKLWWYMD CRAYDAEK        QQHJV          
ISXTCIJRI       : VNMCRQMWQMHT    QAQBQ           ULWUMUHNO       FWXIFBWUBG      JOMINRKIFXHEF   HOJRCVRTCKOWQ  
CACUJHAMEIXG    : AUMU            KYMMMYQWY       DKTUYQOLLFBFX   GELCQIHBPTQUFQ  MEBLOISDXMYN   
LGFELJNXTGVQKGA : BMYVVWAIEE      DEESVS          MBUANSL        
OTGQXCCFEO      : VQOAGOKVLUQCE   YPRQCMPYNJWTW   OPOIJCENYVFQD   PJLOAGBTHEMPMEQ EAHMNXMRSOPCS  
OPTWBCFFOQUO    : MEBLOISDXMYN   
DLDOREUJACAXGD  : XHMYPJEI        TPNCUM          GCPP            EAFFTDSGTM      YSPRVAYLLDTBCYK YOOVSLA        
MTSBJNYMR       : FYJEYHAKV       YYQGEYUC        BUYUEFUFJDC     QYFTLPA         JPGOEM          RQOMCHJWJK     
TIWOXJUL        : UPMSACLTAG      BNOYMJGA        IINPAHI         RPLCV           SEUYHJXDWUINWA  FVGQONCAGLKJSR  KEPQJELM       
JFTGOTIRTQW     : HWOOS           FJVUHIXWLOJ    
DQRFDHGPCMM     : BQINOGUWURBN    BTKWTNDJXS      TMOAUTUPKWPLQ  
LBIUV           : QGUND           ERUGYIIXMAYULA  OLRQCSHVEJFDL   EVPIMDXULO      WGJAYGPUNPE    
KHAEOQAYITQHS   : EOIXGGFGXLJXMVA
YNYEWFVYTIKF    : KYYGTU          XKWIIKQINPP     BMSERJLIYCWYQ   GOTPCYTN        WNCCHNXAECY    
UDIRNSTUJKUIV   : YRAYL           NWXSHP          BTKWTNDJXS      YOOVSLA        
BDKVEAWKA       : GRXKYTIB        RBQW            FANKP           SXYCMLTQJOKO   
HBBPLH          : YGMWADP         CPSDM           BXKDSL          YCXFTKHCNPT     MEBLOISDXMYN   
JMNBCIWWRHU     : SXYCMLTQJOKO   
FMEL            : AXVVX           WWGGOUCQDVRVDG 
CRAYDAEK        : XWSFDJ          MUGRWFKQ        VRTWPMH        
GCPP            : OJQNTDGHI       DLDOREUJACAXGD  IJVKWUQBBDVHOM  GENSUXYREVDK    OESVQLPQMSKSWP 
BEWEGFBGYIBD    : NVLDKINL        BDIJQUCIBP      QXKIWHBBCKORUG 
NHCMJT          : XLTQUQUSG       ETCHTGVC        EAHMNXMRSOPCS   QVJGJUNQW       KBALN           TENVON         
LWORJSAO        : MPXMCVRXXJXI    KYMMMYQWY       YJFYAL          WTKDXILNHHQ    
PVLVUPFCQLD     : AXVVX           NUKUPJWUJYR     NXSJAR          KKWYHGM        
OGREOTSAQGLP    : BFLNQDI         LORGMEOYQLTVR  
EAPEOAWMNUJ     : UFWBXMCWWVBWXW  OYHETAQPAVB     SUCXUKXSP       WGENITJXXMHOTVY LPGGHYCHXPVELYG OEXCBUUXNFYIGRY
ALTN            : YCXVNTNNMHRK    MGBRU           MEBLOISDXMYN   
VEWP            : FQTWAAEYEOYWMD  QWDSCVJCWIG    
NMCODKASJGUAL   : TPTFXJSFRNNE    BVOVIA         
CKAQFJTIWQ      : BCGQATUXNSWWQ   WDITQLUS        BVAVYPQNKAULGLN JPGOEM          GOTPCYTN        NWCSDBEPOOQP    BTNGRDI        
NOBNELBQ        : BMYVVWAIEE      XFXCTDRPLCJR    HUITLVQWNMU    
PVAS            : TQGSQVUGOO      GVYSENJUSYI     BVFAXSQWPCELKY  OPITOQAIR       HSOIOFE        
KYMMMYQWY       : GFCG            CACUJHAMEIXG    LWORJSAO        ONFULEL         WNCCHNXAECY    
FLGNKWJ         : HNWTOK          AQYDNIMJAGHFUC 
NMORYPLOGHRB    : SNWIFWTMEP     
CAOQNNHMORTA    : QGFGWAPPGXE     OVXCJ           BVPPOLFLHP      UUIWGXCHEVENUI  SNWIFWTMEP      WSFNLJPGSLF     YOOVSLA        
HNWTOK          : BAMEOIYORYCVF   SNAPAMFPEEFTAF  FLGNKWJ         WYTITDOPCIVSTTN ELEQHQSX       
DEHSP           : EFUXII         
BAQCBSFPLSFU    : NNRCNAJJ        YPNKYVWYAPUURF  FFKADRWWCBB     KBFFCROENVAPTVH
UMCWMJKJFBV     : PNXW            XHAFHUYF        BXKDSL         
EBVASSBULGWGLOR : DLSCGXHMPI      BHVLVVLXEOR     WWXVSFMQ        AVKKWFQTWIFJWF  KAGB           
UNNRC           : JRKXDYHP        MGSIQ           WCNDCKK         VKOWWSVNIH      RQJCDUDAODEMAGO
QPECBJDAX       : FDMXHJXUV       XGQNNBRS        RIGIFUTO       
DUKVPNTC        : FJMPGGMTA      
QIFHDLEQCV      : OJQNTDGHI       TBQUENPNGSRT    WCNDCKK         VBOFKIACERUVXP  WXMMJIMPNENYXL  XFDLM           AOLKSJSUU      
VNMCRQMWQMHT    : ISXTCIJRI       PKRLEFN        
TRAILCCEM       : AYCVCXTMMUBBIWM CLJXFDMTOTIUEQ  TRHNNRCN       
MPXQICPEYFSBW   : NVTUMQSF        KGCHBKEI       
PVADGVMAOMKC    : YYNFGHGJOYLITK  XFFLOST         FMBLOFAETUJWERV FGWIJKIBYFDUR   OEVXNUKXN      
PHGAVXXMHDEN    : DKHELHNUNITUO   OPOIJCENYVFQD   FMKPFEASCHK     HTTDLPRH        NVIIILLQSH     
JGFGQXFSBLRP    : MSIEEEBVW       IJRNGHON        OMCKKEYJCUHFDN  HXVM            GROEVF         
GFYKVOR         : WCCAFFH         EFUXII          ICFSMLY         FGWIJKIBYFDUR   FMWXFVQFSBGRDOD
QNDQDKTHAXRI    : WMTKGLYVKHKP    KJALFKS         XEEXFNWVDW      YRTXXJLVDKYKG  
ABCFUFSOWHWC    : MDFE            UGCUHEMC        ALPLMLXPAONIWWW PRTJRSAKFAYQ   
HBYAFPNIGSS     : KNGVOIC         FJMPGGMTA       MRYPMSXGDKYYPB  AYQFPSISFEWNQTO BMSERJLIYCWYQ   NVIIILLQSH     
BUYUEFUFJDC     : WFQQO           MTSBJNYMR       OREWFKDLUHN    
XQOHPQPXROXXGN  : JPGOEM          STDHGCTDMCKQRLU MOIKLVHAMYHYE   HOCRXPFBJ       MPCSF          
PHCQKW          : TDVDCGPVXSM    
FDXCLJHP        : WDITQLUS        EMIOEXHXTBKLF   IUNYA          
GJPNYG          : JUIBCER         OUXGNINL        AMAREPNYOW     
WBWUYGLHVU      : JEKOQKL         UPCMGOBROOLUJ   VUPPNJFGBGAVBAD
MFJGMO          : OOWYQOEHQAKEJXD GVYSENJUSYI     TNSKKXXOALBUY   KQURPCLPWKBND  
QAQBQ           : TQGSQVUGOO      DLSCGXHMPI      SIMFPTBCBLPK    MRXLJKQXK       ISXTCIJRI       CTGAN           SWVNPJQA        ACSEIKLPJ      
JAJYBRFYSFV     : UAHYSVOL        RUUSJDONBQFI    FLHDJQEKUW      UVNWTQW        
LHCHENVJYC      : EDYAFOJCXDCTQR  IFRA           
OLRQCSHVEJFDL   : OHOWV           LBIUV           NQYRWIIBVXLD   
JMSQI           : TOJRJIKJLHMV    SWHDOEVSOLNJTWG
CSQJWFFJEJHU    : KPOTOVGHTLFB    OODTJJMPTSKUKVI RBHIF           IPYHSVE         FJVUHIXWLOJ     SVOBIHREGMEJMWE
BMYVVWAIEE      : OYHETAQPAVB     LGFELJNXTGVQKGA NOBNELBQ        FLSWEQLW        OMCUPDUU        EAHMNXMRSOPCS  
CPIWGQJKJBTJIB  : TNSKKXXOALBUY   LTXWDPSNNX     
OMCKKEYJCUHFDN  : JGFGQXFSBLRP    EIWCTBVA        KXVEVWWLW      
BRBJOJDYTOCPXK  : HNDJDMGX        IYOUVIOCKRFI   
QYFTLPA         : URYKSABXHIGS    VCJFWMYD        MTSBJNYMR       XMYQQHP        
ACGJHLWS        : XKKBYKWJA       EVPIMDXULO      PHCXGXH        
PVYGHCHDRJ      : EVPIMDXULO      WLPSYY          CAFYBWVHKL      LORGMEOYQLTVR   XUYFAEL         AOLKSJSUU      
PVNJXTDJJFWLJD  : UBVIHYS         TQGSQVUGOO      MPXDGJWRIKEBRBS WYEUKOEFDBA    
TQWO            : FJMPGGMTA       APMNYMVCY       MCKMAAO         ODDDN           ACSEIKLPJ      
OLGUUK          : EWHUQGWM        XVQYATJJQUYXOML CXJTYJVVODIF    OKMIBSGROUN    
BCMV            : CXJTYJVVODIF    AOVRGRB         WSFNLJPGSLF    
LKEJEJUPQRCA    : NUKUPJWUJYR     PAJEPNE         YQSUAFOUF       MWJCX          
BTOXJW          : AIECIL          KGYHIWLTUPP     XVVWBJHPUHVDO   RQOMCHJWJK     
WDITQLUS        : ORTNPTEKGBIWF   CQCTCKG         IUFXKIGUOG      CKAQFJTIWQ      FDXCLJHP        THWMTQSYADHQK   XXPUYEQMFT      XDIBIBMMXHEOWY 
WDITQLUS        : GXYKD           FFKADRWWCBB    
RPLCV           : XKOXKSDCBOYFBEJ TIWOXJUL        ADOCDB          KWTNBWMVFWTSTO 
IHSXXKABIEUY    : MPXMCVRXXJXI    DSCCIDJ         DRDFWLVBLLAQ    BDIJQUCIBP      MOIKLVHAMYHYE   ECEBS          
GVPDCAXSL       : KNGVOIC         FWXIFBWUBG     
NNMEAO          : RWBQPPDDS       KGCHBKEI        UVNWTQW         OESVQLPQMSKSWP  ETHN           
WWKRXKFA        : YADHWSTV        YXBLP           UMJWSJEY        DXPSHGWO        JYSYRQA         BJGKL           CDARQSRPQ      
NEHOHNMWTQWTLK  : SRJWQCDOI       QXKIWHBBCKORUG  ALRD           
AXCGASKA        : RHNGXRVLGJASLSE VJMBMOLTL       RJLIKOUNQV      XWKFVGRC        OFMTGKRGDQYR   
UROGWQT         : DFJYQGR         NYBPJB          IUNYA          
VBDDRQCN        : OPHMFVKPOF      XSOIDVGNA      
BHVLVVLXEOR     : MXOJLJMPRGHAS   XRQJYAKQI       EBVASSBULGWGLOR HNDJDMGX        SEIMVYBWAOD     XKWIIKQINPP    
OKMIBSGROUN     : OLGUUK          MCXDIQOWYALWPE  HCMY            LEYTS           HFOJAI          GENSUXYREVDK   
YQKRUXBVFWJ     : QTTETLFNAXXKV   UFSMKAMWYPKKQB  NUVFUPRCA      
SVCYMVOB        : WISAOC          UXTKEHAGRMITDDN FFKADRWWCBB    
BJJVRDKPRDOKPGI : EFXBWAR         HTRVFXR         AVKKWFQTWIFJWF  VKOWWSVNIH      POWPBSSVNO      SOARPDNMSBHY   
JEUHOYAMDCYYQ   : KNGVOIC         TOOXTXYW        SDHNFENKPFXYGP  VRTWPMH        
HTNSRG          : DMXEDRO         HRLBEITGRHY     WRSRUKHAPTJ    
EVPIMDXULO      : LBIUV           ACGJHLWS        PVYGHCHDRJ      QXKIWHBBCKORUG 
RJLIKOUNQV      : LKJFUFSTCCDVP   SKDAROIHFFNVHSP AXCGASKA        YRDG           
JXXFOQWUPDSHLH  : WDUDIEQBVYAUS   NHORVEBCVT      CTGAN           TDTDNJCRUY      CEHOIKJNMBRQP   XBDVVMLSE      
MCXDIQOWYALWPE  : LFGXTPEBVBIMHB  OKMIBSGROUN     RJGBGOAG        RBQW           
FPTFUKYTFOWAVLH : DULPJIAXWERWJ   BTNGRDI         YDIMFR          KQURPCLPWKBND  
ALHDVXR         : SMPJ            IINPAHI         MNPMCE          IUNYA           CEUSMYRVMRKS    BYEVYOBCPTXKCT 
ATGWKKRRC       : EWHUQGWM        NTNXGFGLRJFYIQ  QWDSCVJCWIG    
WWXVSFMQ        : YYXCRE          SIMFPTBCBLPK    EBVASSBULGWGLOR
JEQSEECHBD      : UJPOGJUA        HXVM            NIRMCMVJUWG     NCKJGWXS        EPVCLGHKQSAYBRG
TDVDCGPVXSM     : WFLUS           PHCQKW          OPITOQAIR      
RKVLSIEAT       : OXTIPTCMEQQJ    WXVREUQTPRXG    WNCCHNXAECY     ALRD           
TOOXTXYW        : KDQHGRRQSTDPDD  HTRVFXR         JEUHOYAMDCYYQ   EGYFKOKMULQRH  
VCUYEBQ         : MGPBC           PAJEPNE         KMJYMTESA      
BJOBEC          : BCDIJUKNFTM     CPOCKD          OESVQLPQMSKSWP 
RUHVWEI         : PKPOUJPEG       MPXDGJWRIKEBRBS SNWIFWTMEP     
UWROU           : QPPXSAHFL       LHCBGLPFMDCIC   TOJRJIKJLHMV    ICQWXVFFGQEFHN  FGWIJKIBYFDUR  
LTONRPTU        : OEBJWKKQWSVBJLE AMDO            XRQJYAKQI      
WWSLAWNYOKIMKO  : AMRB            VUCUNMCGCKUNRMB FVKEYSUIL       MGBRU           RPVPPOFUDIK     QEXUTUQOETYQ    AOLKSJSUU      
DKTUYQOLLFBFX   : HEKRV           DDBKEUVVDSJGPMO VYEOVKNEVNSVMNH CACUJHAMEIXG    YWWAIAATHKTU    RVYPCHK        
AHSYAEYAUAQFJG  : XHAFHUYF        OXRSBMFPURSX    EJLLVYSNSTY    
XDVIXQKOHVCPY   : FKAERT          MUAIRYYTAQXMKG  RQJCDUDAODEMAGO
NUKUPJWUJYR     : PVLVUPFCQLD     LKEJEJUPQRCA    PIMEL           ODDDN           FOKUCRHDOSN    
SYUBRVENGEG     : PIMEL           FGWIJKIBYFDUR   WSFNLJPGSLF    
VQOAGOKVLUQCE   : OEBJWKKQWSVBJLE OTGQXCCFEO      AQYDNIMJAGHFUC 
YPRQCMPYNJWTW   : OTGQXCCFEO      BDIJQUCIBP      VBOFKIACERUVXP 
YGWWWO          : STULLUTQYWPCDH  HFOJAI         
DFJYQGR         : JXLCGFOIEHX     UROGWQT         KRFPJVBOFTTIOVQ
LJTDB           : IAXRPSYX        KNWDKWYPU       FFKADRWWCBB     YSYWI           MEBLOISDXMYN   
HNDJDMGX        : BRBJOJDYTOCPXK  BHVLVVLXEOR     UEHEHUEO        OLUCTKXR       
MYSKVPYUUEF     : YQAWXL          BMII           
WLPSYY          : PVYGHCHDRJ      XTGJPANOC       RYAODSFUXIPJY   UXTKEHAGRMITDDN PBFVPEOXQWWQH  
FDAOSFXWTFUGRT  : LHCBGLPFMDCIC   XKJNOQMOM       STDHGCTDMCKQRLU RPEJAAYSCH     
CPSDM           : HBBPLH         
JTLJIBCJDQOGSEY : WDUDIEQBVYAUS   PRQRDKPRLTR     DAAPOBEMEGE    
CVUJQ           : DONXCXDAA       AJVJPFUFCYYHBFY MNPMCE          YSYWI           VIOCQGX        
CMFGCAKRQ       : NNRCNAJJ        MSIEEEBVW       CUXU           
LCFTGJEJBU      : XTGJPANOC       HENKHAETXJHAN   FGWIJKIBYFDUR   YDIMFR         
TBQUENPNGSRT    : QIFHDLEQCV      CFEJYB          UJPOGJUA        OXRSBMFPURSX    RHPGFCX        
YXBLP           : KNNDIHGXNLIFHPD WWKRXKFA       
HCVPXCBE        : LMMOMCSJY       SMUXRQSOWYMUUL  XQNHGPCULIFUCSE YVPVNSRQGMQUXU  KQOAXD         
CAFYBWVHKL      : HSIQMSOPTVIIXJJ PVYGHCHDRJ      BUKOFJDDDGTNTA  VYMXLHBYJIEYJ   ONXE            XVMNWWKCY      
SEPMFQLGCDAMH   : LANCBNO         EGYFKOKMULQRH   PJLOAGBTHEMPMEQ OAHJJBWTXC      OEVXNUKXN      
EGYFKOKMULQRH   : AJRXOACX        TOOXTXYW        SEPMFQLGCDAMH   NEKEFPBUA       LIEYEVOMEWQUFG  UPLM           
ESXWYQMGJ       : XYFCBBUSS       ULETXIELUCJHVXL
OODO            : VYEOVKNEVNSVMNH EAHMNXMRSOPCS   VQCAP          
LLHTMM          : VJIRJRGCOIAKT   WDPQQCRIEQIS    OACTFPPK        ECEBS          
BYTVK           : TPNCUM          KSHDEBWGLYY     KIOPQFNLLWDNLR  XQFLYKFOHODM   
PTMVONTOGI      : KUIMN           CTCOLOHEEGWFPES EWHUQGWM        EHIVFEROJGELAJ  VJIRJRGCOIAKT   DJMXYKDCWR     
PIMEL           : NBLITEXCRHECE   NUKUPJWUJYR     SYUBRVENGEG     TEBKPGVCIF     
HWOOS           : YGMWADP         JFTGOTIRTQW     AEPVSYUMIYLNG   SEUYHJXDWUINWA  IJVKWUQBBDVHOM 
EAFFTDSGTM      : CHGLDDP         DLDOREUJACAXGD  UBKVGWUFQCS     FBXWIVUH       
PCILQQTPHCCNQGV : MOMPOXDBHOSB    HTCHTXB         ROTQHVDINDTYRJ 
UMJWSJEY        : NATK            WWKRXKFA        NCKJGWXS        WGWBXCU        
HRLBEITGRHY     : JXLCGFOIEHX     UWIL            YPNKYVWYAPUURF  JEKOQKL         HTNSRG          GCGUI           LCLOBLEOULG    
EPRGTG          : NNRCNAJJ        MDKKXAVD        SWVNPJQA        STBYF           XFDLM          
AEPVSYUMIYLNG   : KYYGTU          EXNHGRFPBYCU    HWOOS           FROWYYCTFTOXG   HEVMYOA        
YKJHGSBNR       : XDIBIBMMXHEOWY  MNNJNBDB       
RJGBGOAG        : JCYVU           KNNDIHGXNLIFHPD MCXDIQOWYALWPE  VUERWB          CTGAN           MMVIOFTMISJS    AMYDQPCPUUSE    BMSERJLIYCWYQ  
PCMOYBWXMKHRL   : HEKRV           SRJWQCDOI      
BVAVYPQNKAULGLN : CKAQFJTIWQ      PHQIWDXO        CHLLHGDLBKWEHH 
FGTTUTUUTJHB    : XKOXKSDCBOYFBEJ AULMIDMOMETUF   CSAGMMWOJ      
VUERWB          : RJGBGOAG        IPYHSVE         TBYDEKQNBDQP    FQKMOCRDA      
NRHATENDPBS     : GELCQIHBPTQUFQ  REDWYE         
HMSFIPCDYJ      : XQNHGPCULIFUCSE OLNGOH          HTJRDYUCV       HQEAPDCQEHVHU  
CFEJYB          : XVTMJT          TBQUENPNGSRT    LUSAUYFJ       
UQGCQCIGF       : HFOJAI          ONFULEL         YYWRAAJJ       
IAXRPSYX        : LJTDB           QEVGALTOU       KWTNBWMVFWTSTO  RVIRXBDKMR     
BDKLKPSOYSR     : VGWQESMNPKOEQTQ NBLITEXCRHECE   MNUMNQNHLG      GQFAPFMVNUYQ    AFYTVGQVOX      CEHOIKJNMBRQP   LCLOBLEOULG    
NLTREVCL        : XKWIIKQINPP     FQTWAAEYEOYWMD  CEHOIKJNMBRQP  
CTGAN           : PVXLAAVVMA      XRQJYAKQI       QAQBQ           JXXFOQWUPDSHLH  RJGBGOAG        DCDRXNRNBHDFA  
TNWFOAPCMFVDG   : ERUGYIIXMAYULA  XDIBIBMMXHEOWY 
XTGJPANOC       : WLPSYY          LCFTGJEJBU      ESKFMN          AXOPKAOLSR     
SEUYHJXDWUINWA  : TIWOXJUL        HWOOS           THQMAYKHPA      SNCMCPOISQ     
KIOPQFNLLWDNLR  : YYHLKEVXHPPTW   AUMU            BYTVK          
MMVIOFTMISJS    : QGUND           RJGBGOAG        NYBPJB          XSJMWRWQXFEEOSB
GVYSENJUSYI     : OJQNTDGHI       PVAS            MFJGMO          NGQJBMUBJSEI    JOMINRKIFXHEF  
WMTKGLYVKHKP    : EOBGLBQAV       QNDQDKTHAXRI    OIVBWXU         HQEAPDCQEHVHU   YRTXXJLVDKYKG  
WYTITDOPCIVSTTN : OXTIPTCMEQQJ    HNWTOK         
CURQQEAFE       : AIECIL          SKREFHK         FQTWAAEYEOYWMD  FQVPJLXBQDCHR  
PLGFPFG         : YYNFGHGJOYLITK  JUIBCER         BXXJCCJCUY      RWBQPPDDS       FQTWAAEYEOYWMD 
NBQES           : OXTIPTCMEQQJ    DEHQELPJEXDUHFC FLSWEQLW        XSOIDVGNA       KKWXVVWSHM     
OPOIJCENYVFQD   : OTGQXCCFEO      PHGAVXXMHDEN    ULEREYFB        NGQJBMUBJSEI    SSJRESOLVRNGGH 
XHDNSLU         : BHNFE           RPIYBASVFCEHVH  FWXIFBWUBG      XSJMWRWQXFEEOSB
QCWGFNMXJC      : IXGLGHPJKQMY   
AMYDQPCPUUSE    : MSXRKLBCE       RJGBGOAG        KQURPCLPWKBND  
AHIUSE          : XFFLOST         UNOMQJCWMPLUJ  
LIFTNUG         : FRABI           KVPYRPXVF      
FIEF            : DTDLUYLICK      FQKMOCRDA       GVWO           
FKOUNGRIYVEBDM  : JSXFUEQEYI      AXVVX          
XQFLYKFOHODM    : BAMEOIYORYCVF   TQGSQVUGOO      BYTVK           SNCMCPOISQ     
HUUMFMKUSC      : TKVKYWHHRMF     DONXCXDAA       PBVRBNMUKYCL   
UBKVGWUFQCS     : YRAYL           EAFFTDSGTM      HFOJAI         
OYFWP           : EIWCTBVA       
LORGMEOYQLTVR   : YYNFGHGJOYLITK  WLYNRJQIXAPRUGJ OGREOTSAQGLP    PVYGHCHDRJ     
WCNDCKK         : LMMOMCSJY       WWGGOUCQDVRVDG  UNNRC           QIFHDLEQCV     
NEKEFPBUA       : ITOI            EGYFKOKMULQRH  
LRVXYMWR        : BAMEOIYORYCVF  
TNSKKXXOALBUY   : WLYNRJQIXAPRUGJ MFJGMO          CPIWGQJKJBTJIB 
FDMXHJXUV       : GCTINX          BFPIJWCLFEOX    QPECBJDAX       IFRA            VRTWPMH         SETSQYED       
QTTETLFNAXXKV   : YQKRUXBVFWJ     AMAREPNYOW      UFQEO          
BXKDSL          : TPHRSPGATMIDCO  HBBPLH          UMCWMJKJFBV     GRXKYTIB        RBQW            SUXSYS          TENVON         
YQAWXL          : WRSXHIGIM       ICQWXVFFGQEFHN  MYSKVPYUUEF     HTJRDYUCV       MNPMCE         
UJPOGJUA        : CHGLDDP         JEQSEECHBD      TBQUENPNGSRT    UPLM            GQTEQINKAPEP   
APXAPIWQ        : BTKWTNDJXS      UCVHWHQY        KAGB            LIEYEVOMEWQUFG  AIEJXNNNLD     
WDPQQCRIEQIS    : BNTCHV          SIMFPTBCBLPK    LLHTMM          MUGRWFKQ        PCIOJFINKHMOF   JYSYRQA        
GCGUI           : RUUSJDONBQFI    HRLBEITGRHY    
PKPPCNRUYQLJ    : AUTYDEACMR      TCPHW           CPEIIKUITWVXRGX
RBHIF           : SGTJBWSNAASPTC  QNKMOPYXCYAJOJ  URYKSABXHIGS    CSQJWFFJEJHU    CUXU           
SKREFHK         : FYJEYHAKV       CURQQEAFE       FROWYYCTFTOXG   KJWRXVPES       NUVFUPRCA      
PHQIWDXO        : WDUDIEQBVYAUS   DBMEDICPKLWWYMD DQPKCCVTYNL     BVAVYPQNKAULGLN
OGDNXQYOIC      : DQPKCCVTYNL     AVGCFKOFUMCES  
THWMTQSYADHQK   : GCVIMKMKSTPYD   JUIBCER         PKPOUJPEG       WDITQLUS        BVFAXSQWPCELKY  CEUAIFJD        FGSMDGRWGA     
YJFYAL          : LWORJSAO        IGTTIKIFJ       HAWBWWM         AUTYDEACMR      XNUSPYGK       
HQDHICXQETK     : EMIOEXHXTBKLF   GUIMWWVWWXPCS   JYLTMXKWKXSTXHS ROTQHVDINDTYRJ  BYEVYOBCPTXKCT  GPKXQYCH       
SAILSKLYTCLVBX  : TKVKYWHHRMF     MWJCX          
DXPSHGWO        : WWKRXKFA        NYBPJB         
BMII            : MYSKVPYUUEF     PAJEPNE         HOJRCVRTCKOWQ  
UWDUHOQTBR      : OHOWV           LGROKCPVDOTR    AUTYDEACMR      KOMRNKEKVNUMXL 
FDJJBNMADFHJEYB : BCGQATUXNSWWQ   RQJCDUDAODEMAGO
NJQWEPC         : EWHUQGWM        ULWBVBSNGLGPJC  AJRXOACX        YMUIHHENY       HTCHTXB         QFAGVJ          RHPGFCX        
WRSRUKHAPTJ     : HPEFXWVCUXDSCX  MRXLJKQXK       EOIXGGFGXLJXMVA HTNSRG         
HXVM            : JGFGQXFSBLRP    JEQSEECHBD      FMKPFEASCHK     YLWFUXHTQKECXCW BLWNAYD        
FVKEYSUIL       : WWSLAWNYOKIMKO  OLGXDJW         ORLTCBFKQVRA   
PBVRBNMUKYCL    : YPNKYVWYAPUURF  HUUMFMKUSC     
XWKFVGRC        : AXCGASKA       
QMQRINDVHSXEMY  : TPHRSPGATMIDCO  POWPBSSVNO      OIVBWXU        
BVFAXSQWPCELKY  : GYFTTRRF        PVAS            THWMTQSYADHQK   YJNQMURGTX     
WRDQJNEMJMHJQT  : FBXWIVUH        XBDVVMLSE      
MUGRWFKQ        : CRAYDAEK        WDPQQCRIEQIS    ORWLSRXSQE      WWQCBPBKSIKKCET XNUSPYGK       
BUKOFJDDDGTNTA  : XKKBYKWJA       CAFYBWVHKL     
FMKPFEASCHK     : MSIEEEBVW       PHGAVXXMHDEN    HXVM            SRJWQCDOI       LSQNCYOGI      
OXRSBMFPURSX    : LCXEHAKHKLQNYVD AHSYAEYAUAQFJG  TBQUENPNGSRT    HCMY            TRHNNRCN        QXKIWHBBCKORUG 
BTKWTNDJXS      : ORTNPTEKGBIWF   ITOI            UCDJIOV         DQRFDHGPCMM     UDIRNSTUJKUIV   APXAPIWQ       
ESHICUK         : LCVTAKMUKOMB    LKJFUFSTCCDVP   CLJXFDMTOTIUEQ 
UELVRRLOL       : LFGXTPEBVBIMHB  KOMRNKEKVNUMXL 
MGIIR           : BAMEOIYORYCVF   VUCUNMCGCKUNRMB IXOBYRYENJNP   
CHLLHGDLBKWEHH  : YYXCRE          BVAVYPQNKAULGLN FROWYYCTFTOXG   EAHMNXMRSOPCS   IATDDFVSVIWWXB  UVNWTQW        
CLJXFDMTOTIUEQ  : TRAILCCEM       ESHICUK         ULEREYFB       
OVXCJ           : CAOQNNHMORTA    EUPRJMLAMLRQ    PBFVPEOXQWWQH   MBUANSL        
IMTMAQQ         : VJMBMOLTL       LKXXMTOCI      
APMNYMVCY       : EOIXGGFGXLJXMVA TQWO            YMUIHHENY       MKXJNAQOYWNN   
SUBOCTFQRG      : QPPXSAHFL       HCMY            OMCUPDUU       
ELEQHQSX        : HNWTOK          ONFULEL         GFBXUYPYSOK    
DAAPOBEMEGE     : JTLJIBCJDQOGSEY AVGCFKOFUMCES   LIEYEVOMEWQUFG 
BHNFE           : PNXW            XHDNSLU         RWBQPPDDS       ADOCDB          OXEWAUJJVQR    
YXCSCPYTXSOXCRY : XHMYPJEI        BQHTIUHRK       UAAUMYGQ       
JPGOEM          : BVWQJHSNIOIFR   YYHLKEVXHPPTW   MTSBJNYMR       CKAQFJTIWQ      XQOHPQPXROXXGN  SNCMCPOISQ      FFKADRWWCBB    
ILXSCGW         : UWIL            VJMBMOLTL       AYCVCXTMMUBBIWM FUEAXTYTRRISWDR RFOSSKIRU       NYYCHMNHORY    
FUEAXTYTRRISWDR : SMUXRQSOWYMUUL  VYEOVKNEVNSVMNH HTRVFXR         ILXSCGW         DJPDFAO         MEBLOISDXMYN    VHXYYXPQLQA    
MJJDNX          : YAOCOQQDHVWQF   WOISTIO         IJVKWUQBBDVHOM  XBDVVMLSE      
XMYQQHP         : CLDO            QYFTLPA         ADVL            OINF           
MNUMNQNHLG      : BFLNQDI         BDKLKPSOYSR     XXHKCUDGFRMTL   HGDCITC         AWYJYONXSO      RQOMCHJWJK     
EFUXII          : QGUND           DEHSP           GFYKVOR         XBLYIJSKT       OEXCBUUXNFYIGRY OPITOQAIR      
ULWUMUHNO       : EXCULKDL        XVQYATJJQUYXOML ISXTCIJRI       IWIPE           GQTEQINKAPEP   
WEQJR           : IKJWVIQQQUXNPO  RUUSJDONBQFI    GELCQIHBPTQUFQ  YRDG            HILGQJGXVI      AVKKWFQTWIFJWF  IDLHHVSEDRUBL  
XFFLOST         : KTBTKIWUHHH     JSXFUEQEYI      CPOCKD          QPXTWKM         PVADGVMAOMKC    AHIUSE          YYWRAAJJ        HOCRXPFBJ      
WYEUKOEFDBA     : TOJRJIKJLHMV    PVNJXTDJJFWLJD  IIMNEYQYURXA    JSQVVSXBWR     
XKHMKERCPLRNTY  : XVNPGUVE        OODTJJMPTSKUKVI VATYYSENWQG    
KRXT            : XUYHFGXMR       VUTJWXYLGFKN    YYWRAAJJ       
YYLJPPQSSTKRERE : PVXLAAVVMA      BMSERJLIYCWYQ   WNCCHNXAECY     LIEYEVOMEWQUFG  XBDVVMLSE      
XXSNKLBGKFQDDN  : ETCHTGVC        GFBXUYPYSOK     LYDLQOEKN      
EMIOEXHXTBKLF   : WWGGOUCQDVRVDG  FDXCLJHP        HQDHICXQETK     OAHJJBWTXC      AIVW           
RWBQPPDDS       : EJOHTKFAXAC     DULPJIAXWERWJ   NNMEAO          PLGFPFG         BHNFE           YHYDCVTNNNBIXV  HEVMYOA        
OACTFPPK        : LLHTMM          HTJRDYUCV      
XBLYIJSKT       : VUCUNMCGCKUNRMB KNGVOIC         EFUXII          YDIMFR          SYJGATHVCXTRH  
RYAODSFUXIPJY   : UPMSACLTAG      WLPSYY          POWPBSSVNO     
OUXGNINL        : GJPNYG          NCKJGWXS        KJALFKS         RPVPPOFUDIK     RGBGR          
YMUIHHENY       : NHEPSNTSPVRTV   HVMEILHOGWOX    NJQWEPC         APMNYMVCY       AULMIDMOMETUF  
QQHJV           : QUDJUYETTU      XWSFDJ          VQCAP          
IGTTIKIFJ       : YJFYAL          YSOTXKHW        NYBPJB          VQCAP           GXYKD           ADVKQGTCYSGYVHB MKULN          
STDHGCTDMCKQRLU : FASM            XQOHPQPXROXXGN  FDAOSFXWTFUGRT 
CEUAIFJD        : OEBJWKKQWSVBJLE THWMTQSYADHQK   XSJMWRWQXFEEOSB
RPIYBASVFCEHVH  : MJWGSQDVAYW     XHDNSLU         FJVUHIXWLOJ     KBALN          
ATKUFIFKOCKXJT  : GHIIHKNTJGXWCTI MDYOAUE         WYTLIOULSYGUAG  OLNGOH          TBYDEKQNBDQP   
JNSTNUVISBMWI   : UGCUHEMC        JXNKQEVRHJIPU   JDXGC          
GELCQIHBPTQUFQ  : CACUJHAMEIXG    NRHATENDPBS     WEQJR           XEEXFNWVDW     
BVPPOLFLHP      : CAOQNNHMORTA    UEHEHUEO        ONFULEL        
ICFSMLY         : HSIQMSOPTVIIXJJ OXTIPTCMEQQJ    HTRVFXR         GFYKVOR         MGPBC          
PSKXTBR         : BNOYMJGA        XFDLM          
XYFCBBUSS       : NBAJNKJKRSRRAWP PVXLAAVVMA      XKOXKSDCBOYFBEJ ESXWYQMGJ       EYGWRY          XBDVVMLSE      
XGQNNBRS        : HEKRV           YYHLKEVXHPPTW   DLSCGXHMPI      QPECBJDAX       WOISTIO        
EHVH            : UCKIPVTNK       HTXIUVAO       
ORWLSRXSQE      : MUGRWFKQ        QFAGVJ          VYCGKBLUCVDR   
THQMAYKHPA      : SEUYHJXDWUINWA 
RRPOYYK         : BCJUFXRYGLA     HTCHTXB         AJVJPFUFCYYHBFY TRHNNRCN        YRTXXJLVDKYKG  
YCXVNTNNMHRK    : ALTN            GQFAPFMVNUYQ    YSYWI          
ADOCDB          : RPLCV           BHNFE           GROEVF          NQYRWIIBVXLD   
SEIMVYBWAOD     : XQNHGPCULIFUCSE BHVLVVLXEOR    
QEVGALTOU       : PPINHCJWLUKVJ   YPNKYVWYAPUURF  IAXRPSYX        JQQOPBDDQNSRST 
AYQFPSISFEWNQTO : MXOJLJMPRGHAS   OHOWV           HBYAFPNIGSS    
SRJWQCDOI       : EOBGLBQAV       NEHOHNMWTQWTLK  PCMOYBWXMKHRL   FMKPFEASCHK    
DETXSVYJCOFMIMQ : FLHDJQEKUW     
CKDRFWLQVC      : SVOBIHREGMEJMWE
YRDG            : XVQYATJJQUYXOML YPAUDGWNMV      RJLIKOUNQV      WEQJR           EIWCTBVA        LAFFOBVYWBJMGD 
HAWBWWM         : FJMPGGMTA       YJFYAL          AIEJXNNNLD      BVLI           
NTNXGFGLRJFYIQ  : ATGWKKRRC       MNPMCE         
ESKFMN          : CRREQSJWSUSJPJG XTGJPANOC       HPLCH          
JUMJXLGNMVJAUSH : UORXYJJFGN      QGUND           DSCCIDJ         YVPVNSRQGMQUXU 
EYOJAXAR        : FYJEYHAKV       QNKMOPYXCYAJOJ  GYFTTRRF        XYTFSQXMVSKI    KGYHIWLTUPP    
UCKIPVTNK       : EHVH            OLNGOH         
NVLDKINL        : VGWQESMNPKOEQTQ AOVRGRB         BEWEGFBGYIBD    HFOJAI          ECEBS          
GUIMWWVWWXPCS   : CHGLDDP         HQDHICXQETK     JHNWANEFCI      XNUSPYGK       
MDKKXAVD        : BFPIJWCLFEOX    EPRGTG          FANKP          
TPTFXJSFRNNE    : YYQGEYUC        NMCODKASJGUAL   FLHDJQEKUW      MNPMCE         
MCKMAAO         : TQWO            JSQVVSXBWR     
TBWG            : RHNGXRVLGJASLSE WXOLNF          QFAGVJ          KXVEVWWLW      
WGJAYGPUNPE     : VUWGGT          LBIUV           UROTYDIWHEMNVQ  YLWFUXHTQKECXCW
UXTKEHAGRMITDDN : BCJUFXRYGLA     SVCYMVOB        WLPSYY          GFBXUYPYSOK    
AUTYDEACMR      : FRABI           RUUSJDONBQFI    PKPPCNRUYQLJ    YJFYAL          UWDUHOQTBR      TEBKPGVCIF     
AKDGHDCUHLUPDJX : PPINHCJWLUKVJ   HOJRCVRTCKOWQ  
MCNSEIMEN       : CPQNDBBHGLIT    MPXMCVRXXJXI    EOIXGGFGXLJXMVA ODDDN           PJLOAGBTHEMPMEQ YWFMEK         
GQFAPFMVNUYQ    : BDKLKPSOYSR     YCXVNTNNMHRK    XEEXFNWVDW     
HCMY            : SIMH            OKMIBSGROUN     OXRSBMFPURSX    SUBOCTFQRG     
XXHKCUDGFRMTL   : GKLKMVHBSWF     WFQQO           KNNDIHGXNLIFHPD MNUMNQNHLG      ORLTCBFKQVRA   
KQVCYKXMFXD     : RHNGXRVLGJASLSE BCGQATUXNSWWQ   SHBWLYUOFDYUXS  EOIXGGFGXLJXMVA GENSUXYREVDK   
HILGQJGXVI      : BVWQJHSNIOIFR   WEQJR           JOMINRKIFXHEF   FOKUCRHDOSN    
BPBTEUFAH       : IJWAHPIUF       YSOTXKHW        PDQJPWSALYR     VYCGKBLUCVDR   
XKWIIKQINPP     : UORXYJJFGN      YNYEWFVYTIKF    BHVLVVLXEOR     NLTREVCL        SDSOQVNERVDLOWC RFOSSKIRU       XSOIDVGNA       BOGREJXJANC    
EYONFP          : XDIBIBMMXHEOWY  CSAGMMWOJ       YLWFUXHTQKECXCW
OLNGOH          : HMSFIPCDYJ      ATKUFIFKOCKXJT  UCKIPVTNK       LIEYEVOMEWQUFG  VYCGKBLUCVDR   
KOMRNKEKVNUMXL  : XVNPGUVE        UWDUHOQTBR      UELVRRLOL       CUXU           
OJGPBWUS        : IWIPE          
LEYTS           : NHEPSNTSPVRTV   JKTEORQSCAYQ    SIMFPTBCBLPK    OKMIBSGROUN     GNSWDQFGVOPVYIE AXTYKLG        
HFXTALHEWDTTP   : XKKBYKWJA       XUYFAEL        
HTJRDYUCV       : HMSFIPCDYJ      YQAWXL          OACTFPPK        HOCRXPFBJ       OREWFKDLUHN    
NIRMCMVJUWG     : AYCVCXTMMUBBIWM JEQSEECHBD      MKXJNAQOYWNN   
IPYHSVE         : CSQJWFFJEJHU    VUERWB          TRHNNRCN        KXVEVWWLW       ROTQHVDINDTYRJ  EQDGPW          JSQVVSXBWR     
OLGXDJW         : AMDO            SHBWLYUOFDYUXS  FVKEYSUIL       RGBGR          
LSLYDFOGUMR     : LFGXTPEBVBIMHB 
JAMS            : VKOWWSVNIH     
NCKJGWXS        : SUCXUKXSP       JEQSEECHBD      UMJWSJEY        OUXGNINL        HJRYEXDBAW     
XXPUYEQMFT      : WDITQLUS        OFMTGKRGDQYR    MGPBC           YWWAIAATHKTU   
TCPHW           : YYXCRE          NATK            PKPPCNRUYQLJ    WXVREUQTPRXG    XBDVVMLSE      
SWVNPJQA        : QAQBQ           EPRGTG          HTCHTXB         IATDDFVSVIWWXB  EPVCLGHKQSAYBRG
WXVREUQTPRXG    : LHCBGLPFMDCIC   RKVLSIEAT       TCPHW          
EDYAFOJCXDCTQR  : SUCXUKXSP       LHCHENVJYC      KJALFKS        
HTCHTXB         : PCILQQTPHCCNQGV NJQWEPC         RRPOYYK         SWVNPJQA        CUXU            AXOPKAOLSR     
STULLUTQYWPCDH  : YGWWWO          LKXXMTOCI       BVOVIA          SVOBIHREGMEJMWE
HFOJAI          : MXOJLJMPRGHAS   YRFCG           OKMIBSGROUN     YGWWWO          UQGCQCIGF       UBKVGWUFQCS     NVLDKINL        ONFULEL        
GRXKYTIB        : VUTJWXYLGFKN    BDKVEAWKA       BXKDSL         
EUPRJMLAMLRQ    : BRDXORD         BCGQATUXNSWWQ   DSCCIDJ         OVXCJ          
YCXFTKHCNPT     : HBBPLH         
AVKKWFQTWIFJWF  : EBVASSBULGWGLOR BJJVRDKPRDOKPGI WEQJR           FGWIJKIBYFDUR   YOOVSLA        
IXOBYRYENJNP    : YADHWSTV        MGIIR           PRYQ            JHNWANEFCI      SUXSYS         
DJPDFAO         : EXCULKDL        FUEAXTYTRRISWDR SDHNFENKPFXYGP  KWLEPDTROAICGGD
FHBEQGONOOXOEYN : QNKMOPYXCYAJOJ  LSBSUT          NUVFUPRCA      
AULMIDMOMETUF   : FGTTUTUUTJHB    YMUIHHENY       HTTDLPRH       
BMSERJLIYCWYQ   : WWGGOUCQDVRVDG  YNYEWFVYTIKF    HBYAFPNIGSS     RJGBGOAG        YYLJPPQSSTKRERE UCVHWHQY       
AGDADOOORDDHIWE : UGCUHEMC        PKRLEFN        
IFABKTMXCLACM   : WRSXHIGIM      
FMBLOFAETUJWERV : PVXLAAVVMA      YAQPMPFXGXXFT   PVADGVMAOMKC    PHCXGXH        
HENKHAETXJHAN   : VUTJWXYLGFKN    FKAERT          LCFTGJEJBU      KQURPCLPWKBND   ROTQHVDINDTYRJ  UCTXGFJVCKLWEWO
UUIWGXCHEVENUI  : FAEJUBSEQTKTUKK CAOQNNHMORTA    JOMINRKIFXHEF   ROTQHVDINDTYRJ 
QQPVGADHHAHS    : XBDVVMLSE      
KGCHBKEI        : LANCBNO         MPXQICPEYFSBW   NNMEAO          YLWFUXHTQKECXCW XNUSPYGK        EQDGPW         
GROEVF          : RHNGXRVLGJASLSE JGFGQXFSBLRP    ADOCDB         
GNSWDQFGVOPVYIE : NWSI            LEYTS           TDTDNJCRUY     
OGQRSXAGGTULPC  : VUWGGT          NJQBWFIR       
XPHWVXDEURTQ    : EUCSDVKYTNFAHCL JYLTMXKWKXSTXHS CDARQSRPQ       RQOMCHJWJK     
EUCSDVKYTNFAHCL : YYHLKEVXHPPTW   XPHWVXDEURTQ    KQOAXD          GPKXQYCH        OEVXNUKXN      
FBXWIVUH        : KYYGTU          EAFFTDSGTM      WRDQJNEMJMHJQT  LAFFOBVYWBJMGD 
YESUU           : HEKRV           GXYKD           IUNYA           ECEBS          
YSOTXKHW        : UFWBXMCWWVBWXW  IGTTIKIFJ       BPBTEUFAH       RPVPPOFUDIK    
UEHEHUEO        : HNDJDMGX        BVPPOLFLHP     
FLHDJQEKUW      : SRHWYTIQXODR    PPINHCJWLUKVJ   JAJYBRFYSFV     DETXSVYJCOFMIMQ TPTFXJSFRNNE    SDLQPQMCYNEY   
RLHKDELP        : YYXCRE          WMEKKSLM        INUUIH          AXOPKAOLSR     
IWIPE           : YYNFGHGJOYLITK  CONJGRUQRBCA    ULWUMUHNO       OJGPBWUS        AWYJYONXSO      CDARQSRPQ      
WBVNABBHE       : SMUXRQSOWYMUUL  KDQHGRRQSTDPDD  LUSAUYFJ       
AIXW            : MKULN          
GOTPCYTN        : BVWQJHSNIOIFR   WMEKKSLM        WYTLIOULSYGUAG  DLSCGXHMPI      YNYEWFVYTIKF    CKAQFJTIWQ     
HVLRNRHKV       : KFTMG           LIEYEVOMEWQUFG  GVWO           
AVGCFKOFUMCES   : XHMYPJEI        XHAFHUYF        OGDNXQYOIC      DAAPOBEMEGE     FMWXFVQFSBGRDOD
XJUYDIONHCF     : GHIIHKNTJGXWCTI VJIRJRGCOIAKT   SKDAROIHFFNVHSP OINF           
WOISTIO         : UORXYJJFGN      EJBSTHTHKQVDA   RSGVBQUVB       MJJDNX          XGQNNBRS        OFMTGKRGDQYR   
MVMCDJ          : SMUXRQSOWYMUUL  GKLKMVHBSWF     AOVRGRB        
HOKAMTVOYG      : ETCHTGVC        LYDLQOEKN       QEXUTUQOETYQ   
ONFULEL         : PRQRDKPRLTR     KYMMMYQWY       UQGCQCIGF       ELEQHQSX        BVPPOLFLHP      HFOJAI          ULEREYFB        AMAREPNYOW     
WGENITJXXMHOTVY : DDBKEUVVDSJGPMO EAPEOAWMNUJ     PBFVPEOXQWWQH  
LUSAUYFJ        : VUCUNMCGCKUNRMB CFEJYB          WBVNABBHE       GBYKCPYB       
MGBRU           : ALTN            WWSLAWNYOKIMKO  SWECGCDRJEWTP   JYSYRQA        
ODDDN           : FELGPOWEO       TQWO            NUKUPJWUJYR     MCNSEIMEN      
OLUCTKXR        : XKJNOQMOM       IJRNGHON        HNDJDMGX        JHSBPTYV       
SDHNFENKPFXYGP  : BCGQATUXNSWWQ   URYKSABXHIGS    JEUHOYAMDCYYQ   DJPDFAO         NELONS         
FGWIJKIBYFDUR   : BXXJCCJCUY      PVADGVMAOMKC    GFYKVOR         UWROU           SYUBRVENGEG     LCFTGJEJBU      AVKKWFQTWIFJWF  SDLQPQMCYNEY   
MEWQNKVRAJJFH   : NBAJNKJKRSRRAWP BNOYMJGA        VFBWVC         
NWCSDBEPOOQP    : VUWGGT          WDUDIEQBVYAUS   CKAQFJTIWQ      HOJRCVRTCKOWQ  
VKOWWSVNIH      : JCYVU           SMPJ            UNNRC           BJJVRDKPRDOKPGI JAMS           
AJVJPFUFCYYHBFY : MWKLFUEQEIE     CVUJQ           RRPOYYK         ULETXIELUCJHVXL
TRHNNRCN        : UAHYSVOL        TRAILCCEM       OXRSBMFPURSX    RRPOYYK         IPYHSVE         FGSMDGRWGA      JYSYRQA         UPCMGOBROOLUJ  
WJFFSTHFR       : RSGVBQUVB       BOGREJXJANC     UPLM           
WWQCBPBKSIKKCET : GKLKMVHBSWF     ESNPHSFDVJ      MUGRWFKQ       
SNWIFWTMEP      : AXVVX           BFPIJWCLFEOX    NMORYPLOGHRB    CAOQNNHMORTA    RUHVWEI        
MUAIRYYTAQXMKG  : AUMU            XDVIXQKOHVCPY   LPGGHYCHXPVELYG POWPBSSVNO      JGFDVTHLPHKLP   LROUFBV        
ULEREYFB        : BIXJ            VJIRJRGCOIAKT   MRYPMSXGDKYYPB  OPOIJCENYVFQD   CLJXFDMTOTIUEQ  ONFULEL        
KXBYDSHRNH      : GVWO           
HGDCITC         : MWKLFUEQEIE     MNUMNQNHLG      ESBYSITCRTQOP   ECEBS          
EIWCTBVA        : BAMEOIYORYCVF   XVNPGUVE        TQGSQVUGOO      OMCKKEYJCUHFDN  OYFWP           YRDG            EJLLVYSNSTY    
DEHQELPJEXDUHFC : GKPHCELLXMXCVWF NBQES           AQYDNIMJAGHFUC  AFYTVGQVOX     
KGYHIWLTUPP     : VUTJWXYLGFKN    IJWAHPIUF       BTOXJW          EYOJAXAR       
NQYRWIIBVXLD    : AYIHLMIR        OLRQCSHVEJFDL   ADOCDB          BQHTIUHRK       FVDUJJTCEBI    
OXEWAUJJVQR     : EOIXGGFGXLJXMVA BHNFE          
FLSWEQLW        : BMYVVWAIEE      NBQES          
DTDLUYLICK      : RUUSJDONBQFI    FIEF           
AQYDNIMJAGHFUC  : HVMEILHOGWOX    FLGNKWJ         VQOAGOKVLUQCE   DEHQELPJEXDUHFC
YVPVNSRQGMQUXU  : NXEDBAQS        JXNKQEVRHJIPU   HCVPXCBE        JUMJXLGNMVJAUSH SUXSYS         
XVVWBJHPUHVDO   : GKLKMVHBSWF     BTOXJW         
HTTDLPRH        : KUIMN           ORTNPTEKGBIWF   PHGAVXXMHDEN    AULMIDMOMETUF   BLWNAYD         ILWBBEBWEWLTVLG
KNWDKWYPU       : TUIBFVUQFTPH    WDUDIEQBVYAUS   LJTDB           UROTYDIWHEMNVQ  ORLTCBFKQVRA    JJBVSITNOYFJA  
LTXWDPSNNX      : URYKSABXHIGS    PKPOUJPEG       CPIWGQJKJBTJIB 
HFXBJ           : LANCBNO         JEKOQKL        
TDTDNJCRUY      : IKJWVIQQQUXNPO  JXXFOQWUPDSHLH  GNSWDQFGVOPVYIE
KVPYRPXVF       : CXJTYJVVODIF    LIFTNUG        
LSQNCYOGI       : FMKPFEASCHK     IYOUVIOCKRFI    BLWNAYD        
ANWFBGKUDLPOKFP : JUIBCER         DULPJIAXWERWJ   CUXU            UERWEHMXT      
WNCCHNXAECY     : YNYEWFVYTIKF    KYMMMYQWY       RKVLSIEAT       YYLJPPQSSTKRERE ADVL           
IJVKWUQBBDVHOM  : WISAOC          GCPP            HWOOS           MJJDNX          UCVHWHQY       
BTNGRDI         : OHOWV           XKOXKSDCBOYFBEJ CKAQFJTIWQ      FPTFUKYTFOWAVLH
KWTNBWMVFWTSTO  : MDFE            RPLCV           IAXRPSYX        SSJRESOLVRNGGH  SOARPDNMSBHY   
UROTYDIWHEMNVQ  : YYNFGHGJOYLITK  YRFCG           WGJAYGPUNPE     KNWDKWYPU       UPCMGOBROOLUJ  
SDSOQVNERVDLOWC : YRAYL           XKWIIKQINPP     NYYCHMNHORY    
UUOQV           : SMPJ            FFKADRWWCBB    
YTBFGOCYNWDINV  : XVNPGUVE        YAOCOQQDHVWQF   JUIBCER         AIVW           
ECYAFNQFPSAMHQ  : XQNHGPCULIFUCSE
DRDFWLVBLLAQ    : IHSXXKABIEUY    OESVQLPQMSKSWP  CEHOIKJNMBRQP  
OMCUPDUU        : XVNPGUVE        BMYVVWAIEE      SUBOCTFQRG      INUUIH          JSQVVSXBWR     
NAJGCV          : VUTJWXYLGFKN    VJIRJRGCOIAKT   TMOAUTUPKWPLQ  
UFSMKAMWYPKKQB  : EFXBWAR         YQKRUXBVFWJ     IUFYVHPSF      
HPLCH           : FKAERT          NATK            ESKFMN         
YDIMFR          : OODTJJMPTSKUKVI WRSXHIGIM       FPTFUKYTFOWAVLH LCFTGJEJBU      XBLYIJSKT      
KOKFVDUJGJI     : AUMU            RIGIFUTO       
YSPRVAYLLDTBCYK : DLDOREUJACAXGD  FANKP          
GENSUXYREVDK    : JCYVU           MJWGSQDVAYW     GCPP            OKMIBSGROUN     KQVCYKXMFXD    
LPGGHYCHXPVELYG : EAPEOAWMNUJ     MUAIRYYTAQXMKG  TSXJJSTFLDCAF  
JAVQNOLONFSL    : FKAERT          KNNDIHGXNLIFHPD
FQTWAAEYEOYWMD  : AMDO            QPXTWKM         VEWP            NLTREVCL        CURQQEAFE       PLGFPFG         EYGWRY          NVIIILLQSH     
LKXXMTOCI       : UCDJIOV         AIUKELSHDIURWM  XYTFSQXMVSKI    PKPOUJPEG       IMTMAQQ         STULLUTQYWPCDH 
QYILKQQENNEPU   : CLDO            TKVKYWHHRMF     YQSUAFOUF       FQVPJLXBQDCHR   BYEVYOBCPTXKCT  DJMXYKDCWR     
ULETXIELUCJHVXL : MRXLJKQXK       ESXWYQMGJ       AJVJPFUFCYYHBFY LAFFOBVYWBJMGD 
BDIJQUCIBP      : QPXTWKM         BEWEGFBGYIBD    IHSXXKABIEUY    YPRQCMPYNJWTW  
FGSMDGRWGA      : KTILDRRJFB      THWMTQSYADHQK   TRHNNRCN       
SWECGCDRJEWTP   : GHIIHKNTJGXWCTI MGBRU           KXVEVWWLW       BJGKL           SUXSYS         
PRYQ            : IXOBYRYENJNP    QVJGJUNQW       JJBVSITNOYFJA  
WYQSLTYDQIFRB   : KNNDIHGXNLIFHPD JSQVVSXBWR     
XDIBIBMMXHEOWY  : WDITQLUS        YKJHGSBNR       TNWFOAPCMFVDG   EYONFP         
PJLOAGBTHEMPMEQ : KFIXKMINC       OTGQXCCFEO      SEPMFQLGCDAMH   MCNSEIMEN       XVMNWWKCY      
FWXIFBWUBG      : ISXTCIJRI       GVPDCAXSL       XHDNSLU         SWHDOEVSOLNJTWG
QFAGVJ          : HYGKSPA         NJQWEPC         ORWLSRXSQE      TBWG            FOKUCRHDOSN    
KJALFKS         : QNDQDKTHAXRI    OUXGNINL        EDYAFOJCXDCTQR 
AFYTVGQVOX      : BDKLKPSOYSR     DEHQELPJEXDUHFC KBALN          
LSBSUT          : DSCCIDJ         MPXDGJWRIKEBRBS FHBEQGONOOXOEYN BEJLPTXMU      
UCVHWHQY        : NWXSHP          APXAPIWQ        BMSERJLIYCWYQ   IJVKWUQBBDVHOM  UCTXGFJVCKLWEWO
YJNQMURGTX      : BVFAXSQWPCELKY 
POWPBSSVNO      : UORXYJJFGN      RNUBIRYQF       SMPJ            HBRIBCWYMPCQ    BJJVRDKPRDOKPGI QMQRINDVHSXEMY  RYAODSFUXIPJY   MUAIRYYTAQXMKG 
POWPBSSVNO      : XBDVVMLSE      
KQURPCLPWKBND   : KNNDIHGXNLIFHPD MFJGMO          FPTFUKYTFOWAVLH AMYDQPCPUUSE    HENKHAETXJHAN  
KXVEVWWLW       : OOWYQOEHQAKEJXD OMCKKEYJCUHFDN  TBWG            IPYHSVE         SWECGCDRJEWTP  
OPHMFVKPOF      : YGMWADP         VBDDRQCN        ORLTCBFKQVRA    SGVEXISK       
FJVUHIXWLOJ     : CHGLDDP         JFTGOTIRTQW     CSQJWFFJEJHU    RPIYBASVFCEHVH 
MOIKLVHAMYHYE   : AUMU            XQOHPQPXROXXGN  IHSXXKABIEUY    QXQBBMTKQS      LAFFOBVYWBJMGD 
LVTRGYBCVKK     : NBAJNKJKRSRRAWP DDBKEUVVDSJGPMO TWRDHKCUFFWR    PBFVPEOXQWWQH   PHCXGXH         HTXIUVAO       
JYLTMXKWKXSTXHS : TPHRSPGATMIDCO  HQDHICXQETK     XPHWVXDEURTQ    QXQBBMTKQS      VHXYYXPQLQA    
IYOUVIOCKRFI    : RNUBIRYQF       BRBJOJDYTOCPXK  LSQNCYOGI       NYBPJB          KMJYMTESA      
RFOSSKIRU       : PPINHCJWLUKVJ   BFLNQDI         ILXSCGW         XKWIIKQINPP     RHPGFCX        
ESBYSITCRTQOP   : UABITPGJXQOFOPE HGDCITC         MEGJMGPLHQOFSM  UPLM           
FROWYYCTFTOXG   : AEPVSYUMIYLNG   SKREFHK         CHLLHGDLBKWEHH 
REDWYE          : EJOHTKFAXAC     HTRVFXR         NRHATENDPBS    
SORWG           : SMPJ            CONJGRUQRBCA    FMWXFVQFSBGRDOD
QWDSCVJCWIG     : XKKBYKWJA       VEWP            ATGWKKRRC      
PCIOJFINKHMOF   : YINWYN          XHAFHUYF        WDPQQCRIEQIS   
EAHMNXMRSOPCS   : UABITPGJXQOFOPE AYIHLMIR        OTGQXCCFEO      NHCMJT          BMYVVWAIEE      OODO            CHLLHGDLBKWEHH  TMJJFFJQYMPFQC 
EAHMNXMRSOPCS   : YRTXXJLVDKYKG  
KAGB            : KFIXKMINC       EBVASSBULGWGLOR APXAPIWQ        OAHJJBWTXC      DDWANNG        
ORLTCBFKQVRA    : FVKEYSUIL       XXHKCUDGFRMTL   KNWDKWYPU       OPHMFVKPOF      LAFFOBVYWBJMGD 
RHPGFCX         : CPQNDBBHGLIT    TBQUENPNGSRT    NJQWEPC         RFOSSKIRU       MGPBC          
SNCMCPOISQ      : TQGSQVUGOO      SEUYHJXDWUINWA  XQFLYKFOHODM    JPGOEM         
KFTMG           : HVLRNRHKV       RVYPCHK         MKULN          
YYWRAAJJ        : UQGCQCIGF       XFFLOST         KRXT            XEEXFNWVDW     
RPVPPOFUDIK     : WWSLAWNYOKIMKO  OUXGNINL        YSOTXKHW       
SDLQPQMCYNEY    : MOMPOXDBHOSB    FLHDJQEKUW      FGWIJKIBYFDUR   EPVCLGHKQSAYBRG
VBOFKIACERUVXP  : ITOI            CHGLDDP         SKDAROIHFFNVHSP QIFHDLEQCV      YPRQCMPYNJWTW   INUUIH          LSPDYAQJKKOAWMB OUPHCPWF       
IATDDFVSVIWWXB  : TKVKYWHHRMF     CHLLHGDLBKWEHH  SWVNPJQA       
NYYCHMNHORY     : ILXSCGW         SDSOQVNERVDLOWC
NYBPJB          : GCVIMKMKSTPYD   RPCXHSHQWUQGT   UROGWQT         MMVIOFTMISJS    DXPSHGWO        IGTTIKIFJ       IYOUVIOCKRFI   
NGQJBMUBJSEI    : GVYSENJUSYI     OPOIJCENYVFQD  
EJLLVYSNSTY     : KYYGTU          AHSYAEYAUAQFJG  EIWCTBVA        HOCRXPFBJ      
TBYDEKQNBDQP    : MOMPOXDBHOSB    VUERWB          ATKUFIFKOCKXJT 
RBQW            : IINPAHI         BDKVEAWKA       MCXDIQOWYALWPE  BXKDSL          CEHJCSDPQ      
ADVL            : EXCULKDL        NVTUMQSF        XMYQQHP         WNCCHNXAECY     GXYKD           KJWRXVPES      
TMJJFFJQYMPFQC  : UFWBXMCWWVBWXW  AEBBYCNCT       EAHMNXMRSOPCS  
GFBXUYPYSOK     : EJNMJAWI        ELEQHQSX        XXSNKLBGKFQDDN  UXTKEHAGRMITDDN JHNWANEFCI     
RIGIFUTO        : VJIRJRGCOIAKT   QPECBJDAX       KOKFVDUJGJI     RGBGR           PRTJRSAKFAYQ   
AXTYKLG         : MRXLJKQXK       LEYTS          
OFMTGKRGDQYR    : AXCGASKA        XXPUYEQMFT      WOISTIO        
TMOAUTUPKWPLQ   : YAQPMPFXGXXFT   HBRIBCWYMPCQ    XQNHGPCULIFUCSE DQRFDHGPCMM     NAJGCV          JJBVSITNOYFJA  
XFXCTDRPLCJR    : NOBNELBQ        CDARQSRPQ      
CSAGMMWOJ       : FGTTUTUUTJHB    EYONFP          QXQBBMTKQS     
LYDLQOEKN       : UABITPGJXQOFOPE XXSNKLBGKFQDDN  HOKAMTVOYG      IUNYA           OINF            UXPIIPEPD       NELONS          VHXYYXPQLQA    
KRFPJVBOFTTIOVQ : JSXFUEQEYI      GYFTTRRF        DFJYQGR         ILWBBEBWEWLTVLG
INUUIH          : JUIBCER         RLHKDELP        OMCUPDUU        VBOFKIACERUVXP  HUITLVQWNMU    
LSPDYAQJKKOAWMB : UWIL            VBOFKIACERUVXP  PBFVPEOXQWWQH  
SWHDOEVSOLNJTWG : AJRXOACX        JMSQI           FWXIFBWUBG     
RVIRXBDKMR      : VUCUNMCGCKUNRMB XKKBYKWJA       IAXRPSYX       
JHNWANEFCI      : VUCUNMCGCKUNRMB AEBBYCNCT       GUIMWWVWWXPCS   IXOBYRYENJNP    GFBXUYPYSOK    
WXMMJIMPNENYXL  : QIFHDLEQCV     
BVOVIA          : FAEJUBSEQTKTUKK NMCODKASJGUAL   STULLUTQYWPCDH 
YWFMEK          : MCNSEIMEN       HIDSPVEECWQ     FOKUCRHDOSN    
MNPMCE          : AIUKELSHDIURWM  ALHDVXR         CVUJQ           YQAWXL          NTNXGFGLRJFYIQ  TPTFXJSFRNNE   
KQOAXD          : UABITPGJXQOFOPE KNGVOIC         HCVPXCBE        EUCSDVKYTNFAHCL
VQCAP           : OODO            QQHJV           IGTTIKIFJ       PKRLEFN        
VATYYSENWQG     : TPNCUM          XKHMKERCPLRNTY 
GXYKD           : WDITQLUS        IGTTIKIFJ       YESUU           ADVL            BQHTIUHRK       TEBKPGVCIF     
UVNWTQW         : JAJYBRFYSFV     NNMEAO          CHLLHGDLBKWEHH  YQSUAFOUF      
JYSYRQA         : WWKRXKFA        WDPQQCRIEQIS    MGBRU           TRHNNRCN        YHYDCVTNNNBIXV 
PBFVPEOXQWWQH   : KSHDEBWGLYY     WLPSYY          OVXCJ           WGENITJXXMHOTVY LVTRGYBCVKK     LSPDYAQJKKOAWMB
OEXCBUUXNFYIGRY : QNXIIWXXNSMUWN  FKAERT          QPXTWKM         EAPEOAWMNUJ     EFUXII          NOVE            IUFYVHPSF      
FQKMOCRDA       : CCNNOHSEBLYF    AMDO            VUERWB          FIEF           
AWYJYONXSO      : MNUMNQNHLG      IWIPE          
OPITOQAIR       : PVAS            TDVDCGPVXSM     EFUXII         
OIVBWXU         : OOWYQOEHQAKEJXD QMCCTYIO        WMTKGLYVKHKP    QMQRINDVHSXEMY  SXYCMLTQJOKO   
XEEXFNWVDW      : QNDQDKTHAXRI    GELCQIHBPTQUFQ  GQFAPFMVNUYQ    YYWRAAJJ       
RPEJAAYSCH      : UFWBXMCWWVBWXW  DLSCGXHMPI      FDAOSFXWTFUGRT 
NXSJAR          : PVLVUPFCQLD     HTXIUVAO       
WTKDXILNHHQ     : YGMWADP         JPSXOIIVSY      LWORJSAO        UFQEO          
YLWFUXHTQKECXCW : HXVM            WGJAYGPUNPE     EYONFP          KGCHBKEI        ALPLMLXPAONIWWW
EPVCLGHKQSAYBRG : AUMU            BXXJCCJCUY      JEQSEECHBD      SWVNPJQA        SDLQPQMCYNEY    HEVMYOA        
FFKADRWWCBB     : LFGXTPEBVBIMHB  BAQCBSFPLSFU    WDITQLUS        SVCYMVOB        LJTDB           JPGOEM          UUOQV          
FANKP           : IXGLGHPJKQMY    BDKVEAWKA       MDKKXAVD        YSPRVAYLLDTBCYK
OESVQLPQMSKSWP  : LFGXTPEBVBIMHB  HAEYTSWCCQOJ    GCPP            NNMEAO          BJOBEC          DRDFWLVBLLAQ    EQDGPW         
HQEAPDCQEHVHU   : KSHDEBWGLYY     HMSFIPCDYJ      WMTKGLYVKHKP   
YHYDCVTNNNBIXV  : WWGGOUCQDVRVDG  RWBQPPDDS       JYSYRQA         VYMXLHBYJIEYJ  
OUPHCPWF        : VBOFKIACERUVXP  LBVMB          
PMCNTYYUGXYK    : EXNHGRFPBYCU    FVDUJJTCEBI     BLWNAYD        
SYJGATHVCXTRH   : NXEDBAQS        XBLYIJSKT       SGVEXISK        BEJLPTXMU      
JGFDVTHLPHKLP   : MUAIRYYTAQXMKG 
KBFFCROENVAPTVH : TPNCUM          OXTIPTCMEQQJ    BAQCBSFPLSFU   
VSHC            : IUNYA           YSYWI          
FVGQONCAGLKJSR  : TIWOXJUL       
MGPBC           : MSIEEEBVW       VCUYEBQ         ICFSMLY         XXPUYEQMFT      RHPGFCX        
QXQBBMTKQS      : QPXTWKM         MOIKLVHAMYHYE   JYLTMXKWKXSTXHS CSAGMMWOJ       KEPQJELM       
PAJEPNE         : LKEJEJUPQRCA    VCUYEBQ         BMII           
BQHTIUHRK       : YXCSCPYTXSOXCRY NQYRWIIBVXLD    GXYKD           AXOPKAOLSR     
VFBWVC          : MEWQNKVRAJJFH  
KWLEPDTROAICGGD : URYKSABXHIGS    KNNDIHGXNLIFHPD FELGPOWEO       DJPDFAO         NVIIILLQSH      MKULN           TSXJJSTFLDCAF  
OAHJJBWTXC      : SEPMFQLGCDAMH   EMIOEXHXTBKLF   KAGB           
UAAUMYGQ        : XHAFHUYF        YXCSCPYTXSOXCRY BYEVYOBCPTXKCT 
KMJYMTESA       : SMUXRQSOWYMUUL  VCUYEBQ         IYOUVIOCKRFI    GVWO           
RQJCDUDAODEMAGO : LGROKCPVDOTR    AYCVCXTMMUBBIWM UNNRC           XDVIXQKOHVCPY   FDJJBNMADFHJEYB
UPCMGOBROOLUJ   : WBWUYGLHVU      TRHNNRCN        UROTYDIWHEMNVQ 
CEHOIKJNMBRQP   : RHNGXRVLGJASLSE JXXFOQWUPDSHLH  BDKLKPSOYSR     NLTREVCL        DRDFWLVBLLAQ   
YEPUTSJCJKUA    : UFWBXMCWWVBWXW  ETCHTGVC       
IUNYA           : FDXCLJHP        UROGWQT         ALHDVXR         YESUU           LYDLQOEKN       VSHC           
HOCRXPFBJ       : POEBW           XRQJYAKQI       XQOHPQPXROXXGN  XFFLOST         HTJRDYUCV       EJLLVYSNSTY     FVDUJJTCEBI    
QEXUTUQOETYQ    : YYXCRE          KNGVOIC         MSIEEEBVW       TWRDHKCUFFWR    AJRXOACX        WWSLAWNYOKIMKO  HOKAMTVOYG     
YSYWI           : LJTDB           CVUJQ           YCXVNTNNMHRK    VSHC            EYGWRY         
WCGLEALTFNGGE   : VUCUNMCGCKUNRMB XKOXKSDCBOYFBEJ EOBGLBQAV       LROUFBV        
ECEBS           : XHAFHUYF        IHSXXKABIEUY    LLHTMM          NVLDKINL        YESUU           HGDCITC        
FMWXFVQFSBGRDOD : WISAOC          MRYPMSXGDKYYPB  GFYKVOR         AVGCFKOFUMCES   SORWG          
OREWFKDLUHN     : RNUBIRYQF       BUYUEFUFJDC     HTJRDYUCV       YQSUAFOUF      
KJWRXVPES       : SKREFHK         ADVL           
LNKRIOILVWDA    : UGCUHEMC        MWJCX          
KKWYHGM         : PVLVUPFCQLD    
QXKIWHBBCKORUG  : BEWEGFBGYIBD    NEHOHNMWTQWTLK  EVPIMDXULO      OXRSBMFPURSX    GVWO           
JOMINRKIFXHEF   : XHMYPJEI        FYJEYHAKV       ISXTCIJRI       GVYSENJUSYI     HILGQJGXVI      UUIWGXCHEVENUI 
SSJRESOLVRNGGH  : OPOIJCENYVFQD   KWTNBWMVFWTSTO 
OINF            : NXEDBAQS        LKJFUFSTCCDVP   XMYQQHP         XJUYDIONHCF     LYDLQOEKN      
XSOIDVGNA       : VBDDRQCN        NBQES           XKWIIKQINPP     WSFNLJPGSLF    
ETHN            : VUWGGT          EJNMJAWI        NNMEAO          CEHJCSDPQ      
LIEYEVOMEWQUFG  : EGYFKOKMULQRH   APXAPIWQ        DAAPOBEMEGE     YYLJPPQSSTKRERE OLNGOH          HVLRNRHKV       BSOCHQP        
CEUSMYRVMRKS    : UFWBXMCWWVBWXW  JCYVU           AIKX            ALHDVXR        
RGBGR           : OUXGNINL        OLGXDJW         RIGIFUTO       
FVDUJJTCEBI     : YADHWSTV        NQYRWIIBVXLD    PMCNTYYUGXYK    HOCRXPFBJ      
FMCXBDPWRKH     : PRQRDKPRLTR     BETWQNHX        XBDVVMLSE      
ACSEIKLPJ       : AMRB            EXNHGRFPBYCU    QAQBQ           TQWO           
MUBGWIHFOMT     : WMEKKSLM        BNOYMJGA       
NUVFUPRCA       : BAMEOIYORYCVF   EMLPDELRV       VKTY            YQKRUXBVFWJ     SKREFHK         FHBEQGONOOXOEYN MBUANSL        
GVWO            : FIEF            HVLRNRHKV       KXBYDSHRNH      KMJYMTESA       QXKIWHBBCKORUG  SUXSYS         
IFRA            : BFLNQDI         LHCHENVJYC      FDMXHJXUV       EIPTEVAISSR    
MEBLOISDXMYN    : XVTMJT          CACUJHAMEIXG    OPTWBCFFOQUO    HBBPLH          ALTN            LJTDB           FUEAXTYTRRISWDR
WSFNLJPGSLF     : IUFXKIGUOG      CAOQNNHMORTA    BCMV            SYUBRVENGEG     XSOIDVGNA       AOLKSJSUU      
UNOMQJCWMPLUJ   : AJRXOACX        AHIUSE          NOVE           
UXPIIPEPD       : DSCCIDJ         MLDWPXEV        LYDLQOEKN       IDLHHVSEDRUBL  
CUXU            : QNXIIWXXNSMUWN  CMFGCAKRQ       RBHIF           KOMRNKEKVNUMXL  HTCHTXB         ANWFBGKUDLPOKFP IXRBDLVVLBCK   
DEESVS          : WWGGOUCQDVRVDG  LGFELJNXTGVQKGA
HUITLVQWNMU     : EXCULKDL        DMXEDRO         NOBNELBQ        INUUIH          HJRYEXDBAW     
WGWBXCU         : QPPXSAHFL       SMUXRQSOWYMUUL  ABKAFH          UMJWSJEY       
XUYFAEL         : PVYGHCHDRJ      HFXTALHEWDTTP   UBASBSTTMDDFGS  AOLKSJSUU      
CEHJCSDPQ       : BFLNQDI         RBQW            ETHN           
MEGJMGPLHQOFSM  : WOPIMYROCHIFQG  XHAFHUYF        NJQBWFIR        ESBYSITCRTQOP   HSOIOFE        
STBYF           : EPRGTG         
BJGKL           : KTBTKIWUHHH     JEKOQKL         VKTY            FAEJUBSEQTKTUKK WWKRXKFA        SWECGCDRJEWTP  
PDQJPWSALYR     : BPBTEUFAH      
IIMNEYQYURXA    : WYEUKOEFDBA    
BLWNAYD         : SGTJBWSNAASPTC  HXVM            HTTDLPRH        LSQNCYOGI       PMCNTYYUGXYK    HEVMYOA        
ROTQHVDINDTYRJ  : UGCUHEMC        AOVRGRB         PCILQQTPHCCNQGV HQDHICXQETK     IPYHSVE         HENKHAETXJHAN   UUIWGXCHEVENUI 
SAENTEPMHBMU    : JRKXDYHP        GJPFJVXCYPG     CCNNOHSEBLYF   
LAFFOBVYWBJMGD  : YRDG            FBXWIVUH        ULETXIELUCJHVXL MOIKLVHAMYHYE   ORLTCBFKQVRA   
XNUSPYGK        : YJFYAL          MUGRWFKQ        GUIMWWVWWXPCS   KGCHBKEI       
VYMXLHBYJIEYJ   : CAFYBWVHKL      YHYDCVTNNNBIXV 
AIEJXNNNLD      : YYXCRE          UGCUHEMC        APXAPIWQ        HAWBWWM        
FSKNFQKFFKQPN   : UORXYJJFGN     
YWWAIAATHKTU    : JEKOQKL         DKTUYQOLLFBFX   XXPUYEQMFT     
HIDSPVEECWQ     : EJOHTKFAXAC     ERUGYIIXMAYULA  YWFMEK          VRTWPMH        
CDARQSRPQ       : WLYNRJQIXAPRUGJ WWKRXKFA        XPHWVXDEURTQ    IWIPE           XFXCTDRPLCJR    IXRBDLVVLBCK   
YQSUAFOUF       : HPEFXWVCUXDSCX  KNNDIHGXNLIFHPD LKEJEJUPQRCA    QYILKQQENNEPU   UVNWTQW         OREWFKDLUHN    
EIPTEVAISSR     : SMPJ            IFRA           
VUPPNJFGBGAVBAD : WBWUYGLHVU      LROUFBV        
VIOCQGX         : CVUJQ           NVIIILLQSH     
EYGWRY          : UAHYSVOL        JKTEORQSCAYQ    YYQGEYUC        XYFCBBUSS       FQTWAAEYEOYWMD  YSYWI          
QVJGJUNQW       : NHCMJT          PRYQ           
SUXSYS          : BXKDSL          IXOBYRYENJNP    YVPVNSRQGMQUXU  SWECGCDRJEWTP   GVWO           
JHSBPTYV        : UGCUHEMC        BNOYMJGA        TWRDHKCUFFWR    OLUCTKXR       
HSOIOFE         : EHIVFEROJGELAJ  ERUGYIIXMAYULA  PVAS            MEGJMGPLHQOFSM 
NOVE            : IRDE            NJQBWFIR        LCVTAKMUKOMB    OEXCBUUXNFYIGRY UNOMQJCWMPLUJ   DDWANNG        
UBASBSTTMDDFGS  : CQCTCKG         MPXDGJWRIKEBRBS XUYFAEL        
FQVPJLXBQDCHR   : CURQQEAFE       QYILKQQENNEPU  
LBVMB           : OUPHCPWF       
NVIIILLQSH      : BIXJ            RUUSJDONBQFI    PHGAVXXMHDEN    HBYAFPNIGSS     FQTWAAEYEOYWMD  KWLEPDTROAICGGD VIOCQGX        
AXOPKAOLSR      : XHAFHUYF        GYFTTRRF        XTGJPANOC       HTCHTXB         RLHKDELP        BQHTIUHRK       LSIHGPVQNXKW   
ALPLMLXPAONIWWW : TPHRSPGATMIDCO  ABCFUFSOWHWC    YLWFUXHTQKECXCW
PRTJRSAKFAYQ    : NVTUMQSF        WISAOC          ABCFUFSOWHWC    RIGIFUTO       
SGVEXISK        : GFCG            OPHMFVKPOF      SYJGATHVCXTRH  
KKWXVVWSHM      : NBQES          
BYEVYOBCPTXKCT  : ALHDVXR         HQDHICXQETK     QYILKQQENNEPU   UAAUMYGQ        UPLM           
BEJLPTXMU       : CPQNDBBHGLIT    LSBSUT          SYJGATHVCXTRH  
LROUFBV         : MUAIRYYTAQXMKG  WCGLEALTFNGGE   VUPPNJFGBGAVBAD
IUFYVHPSF       : AYCVCXTMMUBBIWM HTRVFXR         UFSMKAMWYPKKQB  OEXCBUUXNFYIGRY
UCTXGFJVCKLWEWO : CXJTYJVVODIF    HENKHAETXJHAN   UCVHWHQY        GQTEQINKAPEP   
RVYPCHK         : QUDJUYETTU      DKTUYQOLLFBFX   KFTMG          
HJRYEXDBAW      : HYGKSPA         SIMH            NCKJGWXS        HUITLVQWNMU    
IDLHHVSEDRUBL   : WEQJR           UXPIIPEPD      
ADVKQGTCYSGYVHB : XQNHGPCULIFUCSE IGTTIKIFJ       AOLKSJSUU      
JJBVSITNOYFJA   : KNWDKWYPU       PRYQ            TMOAUTUPKWPLQ  
DDWANNG         : WWGGOUCQDVRVDG  EJBSTHTHKQVDA   KAGB            NOVE            EQDGPW         
PHCXGXH         : QUDJUYETTU      ACGJHLWS        FMBLOFAETUJWERV LVTRGYBCVKK    
VRTWPMH         : CRAYDAEK        JEUHOYAMDCYYQ   FDMXHJXUV       HIDSPVEECWQ    
BVLI            : HAWBWWM        
LCLOBLEOULG     : HRLBEITGRHY     BDKLKPSOYSR    
NELONS          : OHOWV           IBLQVQH         VJMBMOLTL       SDHNFENKPFXYGP  LYDLQOEKN      
FOKUCRHDOSN     : NUKUPJWUJYR     HILGQJGXVI      QFAGVJ          YWFMEK         
GPKXQYCH        : BCDIJUKNFTM     HTRVFXR         HQDHICXQETK     EUCSDVKYTNFAHCL
ONXE            : CAFYBWVHKL     
LSIHGPVQNXKW    : UPMSACLTAG      AXOPKAOLSR      BSOCHQP        
YRTXXJLVDKYKG   : BCDIJUKNFTM     QNDQDKTHAXRI    WMTKGLYVKHKP    RRPOYYK         EAHMNXMRSOPCS  
BETWQNHX        : FMCXBDPWRKH    
XVMNWWKCY       : IXGLGHPJKQMY    CAFYBWVHKL      PJLOAGBTHEMPMEQ
VYCGKBLUCVDR    : ORWLSRXSQE      BPBTEUFAH       OLNGOH         
ILWBBEBWEWLTVLG : MDYOAUE         SIMH            HTTDLPRH        KRFPJVBOFTTIOVQ
MKULN           : SNAPAMFPEEFTAF  IGTTIKIFJ       AIXW            KFTMG           KWLEPDTROAICGGD
YOOVSLA         : YYQGEYUC        DLDOREUJACAXGD  UDIRNSTUJKUIV   CAOQNNHMORTA    AVKKWFQTWIFJWF 
MKXJNAQOYWNN    : BCJUFXRYGLA     APMNYMVCY       NIRMCMVJUWG     OEVXNUKXN      
KBALN           : NHCMJT          RPIYBASVFCEHVH  AFYTVGQVOX     
GBYKCPYB        : GHIIHKNTJGXWCTI LUSAUYFJ        IRLVHTTLCAMK   
MBUANSL         : KTBTKIWUHHH     PVXLAAVVMA      LGFELJNXTGVQKGA OVXCJ           NUVFUPRCA      
UERWEHMXT       : YYNFGHGJOYLITK  ANWFBGKUDLPOKFP
XFDLM           : OYHETAQPAVB     QIFHDLEQCV      EPRGTG          PSKXTBR        
MWJCX           : LKEJEJUPQRCA    SAILSKLYTCLVBX  LNKRIOILVWDA   
MNNJNBDB        : BNTCHV          YKJHGSBNR       AMAREPNYOW     
AIVW            : WFQQO           EMIOEXHXTBKLF   YTBFGOCYNWDINV 
DJMXYKDCWR      : CLDO            MRXLJKQXK       PTMVONTOGI      QYILKQQENNEPU   RQOMCHJWJK     
JQQOPBDDQNSRST  : QEVGALTOU      
SETSQYED        : FDMXHJXUV      
EQDGPW          : BRDXORD         TOJRJIKJLHMV    CPOCKD          IPYHSVE         KGCHBKEI        OESVQLPQMSKSWP  DDWANNG        
BOGREJXJANC     : XKWIIKQINPP     WJFFSTHFR      
IXRBDLVVLBCK    : CUXU            CDARQSRPQ      
UPLM            : WXOLNF          EGYFKOKMULQRH   UJPOGJUA        WJFFSTHFR       ESBYSITCRTQOP   BYEVYOBCPTXKCT 
CPEIIKUITWVXRGX : BIXJ            PKPPCNRUYQLJ   
JDXGC           : EMLPDELRV       JBDHEXXK        JNSTNUVISBMWI  
HEVMYOA         : AMRB            ORTNPTEKGBIWF   RSGVBQUVB       AEPVSYUMIYLNG   RWBQPPDDS       EPVCLGHKQSAYBRG BLWNAYD        
ECDKNNUKVQHTO   : HPEFXWVCUXDSCX 
AOLKSJSUU       : RNUBIRYQF       QIFHDLEQCV      PVYGHCHDRJ      WWSLAWNYOKIMKO  WSFNLJPGSLF     XUYFAEL         ADVKQGTCYSGYVHB
BSOCHQP         : FAEJUBSEQTKTUKK SIMH            LIEYEVOMEWQUFG  LSIHGPVQNXKW   
TSXJJSTFLDCAF   : BIXJ            LPGGHYCHXPVELYG KWLEPDTROAICGGD
RQOMCHJWJK      : MTSBJNYMR       BTOXJW          MNUMNQNHLG      XPHWVXDEURTQ    DJMXYKDCWR     
AMAREPNYOW      : GJPNYG          QTTETLFNAXXKV   ONFULEL         MNNJNBDB       
JSQVVSXBWR      : YYXCRE          LKJFUFSTCCDVP   WYEUKOEFDBA     MCKMAAO         IPYHSVE         OMCUPDUU        WYQSLTYDQIFRB  
OEVXNUKXN       : PVADGVMAOMKC    SEPMFQLGCDAMH   EUCSDVKYTNFAHCL MKXJNAQOYWNN    MPCSF          
MPCSF           : XQOHPQPXROXXGN  OEVXNUKXN      
SVOBIHREGMEJMWE : EWHUQGWM        CSQJWFFJEJHU    CKDRFWLQVC      STULLUTQYWPCDH 
DCDRXNRNBHDFA   : CTGAN          
XSJMWRWQXFEEOSB : VUWGGT          MMVIOFTMISJS    XHDNSLU         CEUAIFJD       
VHXYYXPQLQA     : FUEAXTYTRRISWDR JYLTMXKWKXSTXHS LYDLQOEKN      
XBDVVMLSE       : JXXFOQWUPDSHLH  WRDQJNEMJMHJQT  MJJDNX          YYLJPPQSSTKRERE XYFCBBUSS       TCPHW           QQPVGADHHAHS    POWPBSSVNO     
XBDVVMLSE       : FMCXBDPWRKH    
KEPQJELM        : KTILDRRJFB      AYIHLMIR        TIWOXJUL        QXQBBMTKQS      TENVON         
HTXIUVAO        : CONJGRUQRBCA    EHVH            LVTRGYBCVKK     NXSJAR         
SOARPDNMSBHY    : KPOTOVGHTLFB    LANCBNO         BFLNQDI         BJJVRDKPRDOKPGI KWTNBWMVFWTSTO 
TEBKPGVCIF      : PKPOUJPEG       PIMEL           AUTYDEACMR      GXYKD          
GQTEQINKAPEP    : YINWYN          UJPOGJUA        ULWUMUHNO       UCTXGFJVCKLWEWO
TENVON          : XUYHFGXMR       NHCMJT          BXKDSL          KEPQJELM       
IRLVHTTLCAMK    : GBYKCPYB       
HOJRCVRTCKOWQ   : ISXTCIJRI       BMII            AKDGHDCUHLUPDJX NWCSDBEPOOQP   
UFQEO           : QTTETLFNAXXKV   WTKDXILNHHQ    
PKRLEFN         : VUTJWXYLGFKN    VNMCRQMWQMHT    AGDADOOORDDHIWE VQCAP          
SXYCMLTQJOKO    : POEBW           DKHELHNUNITUO   BDKVEAWKA       JMNBCIWWRHU     OIVBWXU        
ALRD            : NEHOHNMWTQWTLK  RKVLSIEAT      
