GEQOYHAEBB      : GNRYHWHUPIE     DECPSGV        
MTBDMXIOWXJ     : CPIDWNMGSDDTA   BYJSSYA         TDBJAWICJHXYKE 
SOABST          : OLXX            MLVVMQQK        JRAOK           DECPSGV        
KASCRTJ         : VEWAYPLG        BCFLRFXSYCMNIK  FRTOHOYWEUHG    LYQJMKXVTYAG    MRSTWCLT        YDLTMHOPPHS    
AMVFYPGEEH      : FSPQN           XNHTCISUMJB     FLDAHPDVTAMNTFE
SGNDCHREKLXXXB  : UBDI            JPHQQIWTUWN     MJUBILKWXITRJV  LEDFTTXDXNCNT   SPFS            HSDMCR          BOYCIWGLAUXYH   BAVPYWJQE      
AULJOLWKS       : OUHS            FSPQN           LLVEIJQKOA     
BADFJQBPGE      : OASWDLAVB       YDLTMHOPPHS     SGLFNA          MJKDOGPDHRUJ    TLCWFHIWWDFX   
PVBAJA          : PPJTSFSPYSB     ILWBYYAAMYQQD   UNQYALPIJWIPS   BAAOWCYMRJD     OMDRRNF         QSIAAYG         VYOLXLSEXDHEY   EOHHMRJ        
IDRK            : DMWKXPLQWPNMOON VEWAYPLG        LYKD            JJBDAQ          HIHYTLSW        KQTVQLKXKTWRGI  QSIAAYG         HNAQAGNL       
IDRK            : YOKKDSRHJIFE    KJWLVKSNUGHLEH 
FWMTVAM         : VMUKSWIPHMBI   
DMWKXPLQWPNMOON : IDRK            GNRALSDIPTO     NMNXBSDXWSVRKIF YXCMRWOLQAT     NGWWXN         
QOIT            : SRDDCCEMYAKW    RAYYTXE        
TTMSJGOJSIMI    : IEXWRJDQAFG     KAGNLKCMXHWC    RLUVVYSDJYPLHYJ GIQRHFQJDJDGBAQ JTNMRXSHTFTDMAF
WIXLYUBMKREASU  : OULTOHJWVKVAFF  JPHQQIWTUWN     QEKLEXYGJ       YQTMYINWLXP    
DRWYLJRURG      : WGJPWNMGBQLFQDH
LPUVXUEX        : MDHFJQHQAT      OPQQNCTITYTE    TMBAY          
GVJUGCYIWUYAMV  : XAJCLNJN        TDBJAWICJHXYKE  EAGDEPMVPEINP   EEXRHDETTIOX    OEJCQOVLYRB    
AIRXA           : OLBXDXIMOJEOOB  PAGSSVWWGXT    
ENSAJQWQQDYMOTS : NKTGGJBKUBAOD   AYAQGTCJBW      VKDYJ           CJMEHFFVTA      DAOQNKJHYKJFX  
TBNQAQD         : DSKDULHACAVWFXL NSPKANC         UPNW            HDXFVWYMXARIYWE BOGLIDBBSNCBI  
QFHKDHLIXEKJWH  : LXCV            GBTEGTOTK       UXWMPMQK        DHKOLKERUKTPWE 
OMBBBVWURAKID   : HDXFVWYMXARIYWE YOKKDSRHJIFE    VCWUXFUMWTMWU  
NCTSLHWU        : OVAEEJSU        XGTHODHK        UYCDN          
HSATDYD         : XPSIBRTGTIS     JCAIDDB         BAAOWCYMRJD    
PPJTSFSPYSB     : PVBAJA          PHPBUFMXGFE     ILWBYYAAMYQQD   OUIPOEGRFGGCKF  OBKF           
VEWAYPLG        : KASCRTJ         IDRK            CTHWIMJSRADL    TFNEW           KEVJPLCSDFH    
HBVCDRHFUP      : BRNQBQOEWHLCE   LTCBWYQUMBBD    GNRYHWHUPIE     QPDGDSCPUKITSD 
MYQGEJVDDYMBEJE : ETIBKUSNO       PIOHO           VMHBPPS        
BRNQBQOEWHLCE   : HBVCDRHFUP      GAQQ            DRDFLTFHAQM     JYEIJLWX        ITQFPUIAKBM    
YRCQXIAVN       : QHYOPFOR        XODGOKI        
XAJCLNJN        : GVJUGCYIWUYAMV  RACIQVEFBSHXH  
WGJPWNMGBQLFQDH : DRWYLJRURG      WHYOOULYRNCFWN  QUFOAXHAEI      IYISC           UPNW           
DQLBERYH        : DNRSUFTOWIIN    TOPD            VHUJLTD         RWLSVDEJDSLRII  XGGQAYJM        BOYCIWGLAUXYH   OFRMECQIEXOSQR 
BUQMIXLQJCOWQ   : WELGRSRYOFIOFP  OUHS            NALDICRGMCYT    MCQXSAFK        SEUGMTQLJ      
BIIGYLPIQ       : OIDYGFGLOPY     AHICPYUYEXWKWGL EAGDEPMVPEINP   MXSOIN         
TSPNRWQVRJKDKW  : IEDJROQSDFCVU   EFTXWMIV        VGKY            UKTLHBW         WHYOOULYRNCFWN 
TYKT            : AKUNRO          RFIJWLH         SXDPNYUEG       QEGNACCCBHILUB 
IUAQ            : OULTOHJWVKVAFF  EBGYJYUSX       ESHUOTVT        DWNFHRCKPPNOYT  CQJKBNYAASN     OJMMWQIPCHAH    TPGIQGWFSSS    
BFUJV           : LYKD            KEVJPLCSDFH     RAYYTXE         OTLGMDFKKPBTE  
GQTVLSPHMY      : OXSSVKVM        SPSHDNIHO       PEJCEHKHSS      MOERAAVSV       BRLWOOUHPBOSH   FVDHBPGJNBD    
RLQOGPBC        : EXQCSOCBCJ      NFDTGHRJSOTCC   LQIFYD         
LYKD            : IDRK            BFUJV           XIEOXNEF        BDNDI          
MKWXIBEA        : QBHHIOVHW       DSJQUYETJYHU    ADPKEXIYXKLKWVD
DNRSUFTOWIIN    : DQLBERYH        QBHHIOVHW       PEGF           
XPSIBRTGTIS     : HSATDYD         GOYYYAQUJMDC    PSJOPVIADXT     DHTARL          EJJOYQDSWSPEYGJ
GCWNETQRML      : YIULKONTAEXBRRG YRKOAFHSBMH     TBBTVIOCX       FFUWNVRLBIBD   
THFSPN          : PSJYNAEIA       MVSNXPDYOGXVQE  PEIBCURP        DAABLTNPU       DTBUL          
GOYYYAQUJMDC    : XPSIBRTGTIS     UNQYALPIJWIPS   SUAW            FGGG            HEYUIMWY       
KGFXKBQEPC      : EOGX            DNTHFOFD       
JJBDAQ          : IDRK            VKKQFNYBMKI     TYXYXTHOMVVE    LSGFHLTNPSIQEIT
GFLIFNBAW       : JQGEYMD         QERWODSTSEWIPFS QPXEB          
GCYQIEQV        : IXUULQWE        GITOULV         WIBTMSXRFPWX    EKYDVERB       
HCXJXH          : XUWFUTWQWYBV    MMKUBNNXQB      GMTCILBKUIMK    GOCOPN         
BMUR            : TTDLNTAPPKLQFRV MXSOIN         
EAMMFBNHAENEDGP : PDAQSBKUHP      BWHCSWXQBLDVRTK
WNREPPPPWLQMIL  : WIPHVULDXT      NRLFWMNAYVXTVRC IGINNWM        
MLBBSERAG       : YUCFSCWDSQXXNGB OWLAKHTHHSTYINL HRBIBWNFVIJDK   PHHTVXLTOIRFA  
QLCYBLWODDGSTWS : VCIPNKOPEPA     EFPFTVK        
PHPBUFMXGFE     : PPJTSFSPYSB     BDLOVTDOAD      UGGHYFRR        QDYDXAXHT      
ILWBYYAAMYQQD   : PVBAJA          PPJTSFSPYSB    
LYTG            : ACGWLYHBG       QTDINSY         OASWDLAVB       GSGHSJIMNA      SUAW            TBBTVIOCX       OHNABGDLSMOSVV 
MNANLFB         : BKPHWIEIIUIVJC  LLVEIJQKOA     
OIQMQEL         : JCAIDDB         AQEYNXRKKTOSD   WIPHVULDXT     
DMSFATVSYUEAR   : UBMW            URGUWHYLKOMDEDA RACIQVEFBSHXH   GNRVQXYL       
IEDJROQSDFCVU   : TSPNRWQVRJKDKW  LEDFTTXDXNCNT   GFEMGW          QPQWCE          GBTEGTOTK      
AGNFTIKTCI      : DWNFHRCKPPNOYT  RLUVVYSDJYPLHYJ WRDGAFCGBI      BUSQHXLVYS     
EDSE            : HNQULYALQT      FNGTYWSIGM      QUFOAXHAEI      CQJKBNYAASN    
IPYMBRBR        : QOOIQ           SHTPQHYVW       ODJI            TKDM            LKXYGEH         LQIFYD          SPFS           
EXQCSOCBCJ      : RLQOGPBC        UGNHDOHUWWQV    PSJYNAEIA       SYTECPRBOPYPKM  UBMW            NPJMXYLKWEWVTS 
MTQQEFU         : FDVUXFMOJSGQCP  PKELHBMM        TKAWS           LADQYWQLMNTQTRH BAMAFWDVDNJGQLT
BCFLRFXSYCMNIK  : KASCRTJ         XVDKECKHFIE     YXINKXXHIEAEQFF QPQWCE         
LFVNJAXGMTXFY   : TGYB           
DJIF            : BYJSSYA         MQWIRNVR        JXEMJRQI        QLMEFUXC       
UYVSR           : VMLSGMQEY       JRAOK          
WELGRSRYOFIOFP  : BUQMIXLQJCOWQ   SVEJ            YXOQREKW        FMDBYUBIXAL     CQJKBNYAASN     YCFR            OIHCOOVTBMBM    TFYMPFITQRWH   
WELGRSRYOFIOFP  : IVVIEECEDN      HHEC           
CPIDWNMGSDDTA   : MTBDMXIOWXJ     PSJYNAEIA       FQRRUBXCYTCP    MJBKNDLHGYXK    WOSCOTV         QRLTGBYPLNBOCKO EDPRJVEGGNLD    HEYUIMWY       
LWVSKCMDTLT     : PAPKCBDFJUBAU   MXSOIN          XFTW           
WIJMNLEYOBMDJI  : KEVJPLCSDFH     CWSAOLSSWR      KCGUSIC         SOKPJD          QSOHHDFMHLAQSN  SSQQK          
OCKPQILJUPXYLLS : SXXSGUMDLJCO    CVEMQCOCJKNBVIS JEFVSMB         QPXEB           IGINNWM        
IEXWRJDQAFG     : TTMSJGOJSIMI    QTDINSY         QGMJUXUTOYYQ    THJBLKBWWV      XWSMHKEYN      
QOOIQ           : IPYMBRBR        TGYB            TOPD           
XHLLSHBSGOF     : JFVRHOIEKVTF    GHTWA          
DNFCNANQQ       : BYJSSYA         PAGSSVWWGXT    
XYXRNMAHQ       : VODONVRKNWKNW   WEOEOF          FGBQE          
OCLKJMDRB       : RWLVAPRKMBW     JXEMJRQI        FEFTAQWOO       SSQQK          
TGYB            : LFVNJAXGMTXFY   QOOIQ           RBPN            CWKJINDCD      
OBWFUPGTNX      : ETIBKUSNO      
DAPT            : LXCV            JCMKIKTN        ICCG            WGONR          
GVJSIXWA        : TDINVEXUQXR     RBPN            PXEXLWQTOGIQ    CNLRTTYQUMMPES 
HVHIXSWYRF      : WTOTBCKYPLYB    KKLKLCFBDIEC    LSQDAKCOUMJ     YPTBFSEJT      
HNQULYALQT      : EDSE            UGLIDVX         PSJOPVIADXT     UESV            FMLE            MARRNDBHOUKHPYO
YSWSBWPDAYAHIXC : GFWLM           HYEJVHE         UPTCOHODTTJAURK HSDMCR         
WTOTBCKYPLYB    : HVHIXSWYRF      GITOULV        
VODONVRKNWKNW   : XYXRNMAHQ       MNHDLONMVN      CLQKAXKDCC      LKXYGEH         AJOCJRNDGFBWUV  YDLTMHOPPHS    
XUWFUTWQWYBV    : HCXJXH          AQEYNXRKKTOSD   RACIQVEFBSHXH   DJHKIHWRKMRKL  
OXSSVKVM        : GQTVLSPHMY      JMGATRVBMU      ADPKEXIYXKLKWVD HKSKEDWFQWFSPSD HRBIBWNFVIJDK  
UGLIDVX         : HNQULYALQT      VCIPNKOPEPA     VPMXKILEDHB     XMNUQ          
SXXSGUMDLJCO    : OCKPQILJUPXYLLS LQUS            GKSHDXGA        MWJIJXJLU       EDPRJVEGGNLD   
TDINVEXUQXR     : GVJSIXWA        QAWPL           RVRLYRSPWXFKO   OIKXD          
JCAIDDB         : HSATDYD         OIQMQEL         ODJI            AHICPYUYEXWKWGL NMNXBSDXWSVRKIF WUBJXK         
CTHWIMJSRADL    : VEWAYPLG        FLFADOFCDUJG    CCWXXU         
LBCPBYIAQHJT    : AWTXM           VOHEYOODGNWTKV  WRDGAFCGBI     
RWLVAPRKMBW     : OCLKJMDRB       PDBDKFKEBJJBW   WOSCOTV         QERWODSTSEWIPFS GIKS            YSUXOHXI       
VOYYDFMEHC      : MBCWYKSKOGOHO   VNGRLDH         MVSNXPDYOGXVQE  MTLJXXNPHL      OIHCOOVTBMBM   
JMGATRVBMU      : OXSSVKVM        QPUQH           DULCKJWV        QPXEB           BWHCSWXQBLDVRTK XYIOHBLPBVQNWP 
IVEAGTBFRYUSXXX : BRLWOOUHPBOSH   RVAXQYQIDRQ     RVRLYRSPWXFKO  
EIOKRBS         : TNUSGGAEX       HIIHEWQVTPUOGF  SRDDCCEMYAKW    RKNCK           PEGF           
UNQYALPIJWIPS   : PVBAJA          GOYYYAQUJMDC    GHTWA           NROCQ           AJOCJRNDGFBWUV 
VMLSGMQEY       : UYVSR           QUQLAYYQBISF    SVEJ            RRLFFJD        
OQIGRDBPQRQS    : HGMONNGCTMQQHBM VGKST           RAYYTXE        
IBNFMF          : LDUQFJIDSGIIMD  MTGTTKRXOFUNP  
BDLOVTDOAD      : PHPBUFMXGFE     NVNIFQXO        AWDOSWX         MBCWYKSKOGOHO   MBAGKPRQK      
PVWVPCWHVO      : SNWVWAMYUMCEIF  SXDPNYUEG       BAMAFWDVDNJGQLT
OUHS            : AULJOLWKS       BUQMIXLQJCOWQ   RBPN            MTLJXXNPHL      NROCQ           BRLWOOUHPBOSH  
OFPPIVDWRWDHWI  : DSJQUYETJYHU    JXPJHNTLNE     
MESJTUIC        : FQRRUBXCYTCP    TKDM            QPDGDSCPUKITSD 
ACGWLYHBG       : LYTG           
SOUVNNSQWP      : FDVUXFMOJSGQCP  KRAJI           COKW           
SFFNQAIYECBGIX  : SXDPNYUEG       FEFTAQWOO      
JFVRHOIEKVTF    : XHLLSHBSGOF     GHQAH           PYEULX          GJUCDYTTW      
QUQLAYYQBISF    : VMLSGMQEY       ODJI            FNGTYWSIGM     
TNUSGGAEX       : EIOKRBS         OIDYGFGLOPY     MEDADNNHI       PHEAXIKT        XNMYVRFE       
UGOFEI          : LYQJMKXVTYAG    JEFVSMB         WOBDXQAX       
VCIPNKOPEPA     : QLCYBLWODDGSTWS UGLIDVX         DJHRHMNNBG      JRCPOLQ         PYEULX          XMNUQ          
WMSKHNTNQXNATT  : VNAJTGM         SBRNSQEHFGOGC   THJBLKBWWV      WEKPAOVLROXLYIL GFFITPTXGAPJHJ 
BAAOWCYMRJD     : PVBAJA          HSATDYD         PXEXLWQTOGIQ   
PSJOPVIADXT     : XPSIBRTGTIS     HNQULYALQT      VYOLXLSEXDHEY  
OUIPOEGRFGGCKF  : PPJTSFSPYSB     QBHHIOVHW       EKYDVERB        SLFMHNDIG       YKLFPKLTOXWQ   
FRTOHOYWEUHG    : KASCRTJ         IUYDJ           WSBXA           CWKJINDCD       AHPTJF         
FDVUXFMOJSGQCP  : MTQQEFU         SOUVNNSQWP      JUWKHQMQ        DEUAEALNR       OBKF           
OULTOHJWVKVAFF  : WIXLYUBMKREASU  IUAQ            AJOCJRNDGFBWUV  TSWDMUFMOEGYJ   SHXJKYBDMLP     JROPGCDDGJ     
IKMFHKMVYXPHPTW : IIWBKUT         FMLE            SBRNSQEHFGOGC   YIEOGXAKJBPXXVI
IUYDJ           : FRTOHOYWEUHG    YQJEDPUNS       WXMY            ABEFOPTTFCO     CPGRSVMCMCWQT   TPGIQGWFSSS     TLCWFHIWWDFX   
OIDYGFGLOPY     : BIIGYLPIQ       TNUSGGAEX       MMKUBNNXQB     
UGNHDOHUWWQV    : EXQCSOCBCJ      RHBNGFGFHKM     WUBJXK          JYXJJAAGOKRPP   HEYUIMWY       
YQJEDPUNS       : IUYDJ           TFNEW           UYCDN          
UBDI            : SGNDCHREKLXXXB  VNAJTGM         YNVVCFVEHR      HDRGMWMJKOU     QGMJUXUTOYYQ    OHNABGDLSMOSVV  IFATKKTLVQUPUUQ NPJMXYLKWEWVTS 
SHTPQHYVW       : IPYMBRBR        NSPKANC         YPOGLMEAHUIB    DSCC           
SVEJ            : WELGRSRYOFIOFP  VMLSGMQEY       PVFVGWQQCHAFQ   LSGFHLTNPSIQEIT
OILAP           : FQRRUBXCYTCP    JGPJHN          PHEAXIKT        TKINJLKX       
PKELHBMM        : MTQQEFU         ETUIVHA         NMNXBSDXWSVRKIF
EFTXWMIV        : TSPNRWQVRJKDKW  GIQRHFQJDJDGBAQ AHPTJF         
HEBDKMWBX       : HRDMD           TDPUGJMUSPGGSTO GEEY            YMAOPVFFVUHRPH 
BNYRAGFJ        : UBMW            SPFS            HKSKEDWFQWFSPSD PDBIDJGV       
RVTV            : KRAJI           TKOBBUGQTURWSIA HHEC           
QWADF           : ICPFEMXGBVMHL   FQRRUBXCYTCP    LDUQFJIDSGIIMD  MWJIJXJLU      
OMDRRNF         : PVBAJA          OASWDLAVB       RKNCK           EEQFMOELEC     
PDAQSBKUHP      : EAMMFBNHAENEDGP KGXFQ           XEAARB          TQJVIEFH       
RHBNGFGFHKM     : UGNHDOHUWWQV    LSTULYOSCFBJLI  JMSNLFBHDNAU    NESMWGWWRS      FFUWNVRLBIBD   
BYJSSYA         : MTBDMXIOWXJ     DJIF            DNFCNANQQ       MTGTTKRXOFUNP  
ODJI            : IPYMBRBR        JCAIDDB         QUQLAYYQBISF    HGMONNGCTMQQHBM
LSTULYOSCFBJLI  : RHBNGFGFHKM     HKFXTGOSLHPKEP  LTVRVYH         GJUCDYTTW       JROPGCDDGJ     
VUAYVLSOKSYCYIM : KEVJPLCSDFH     NRLFWMNAYVXTVRC KOVFIQETJMAAPCM
VHST            : NNFCTSMJT       IFATKKTLVQUPUUQ
TIOYNRICBCXVC   : QBHHIOVHW       VOJWWCUTTOBY    FVDHBPGJNBD    
SPSHDNIHO       : GQTVLSPHMY      REBGEN          CQJKBNYAASN     OHNABGDLSMOSVV 
TOPD            : DQLBERYH        QOOIQ           QWYKLODCRVLTKDY DMMXKQCNSXEVR   TPGIQGWFSSS     BUSQHXLVYS     
LWEWLDKDNMEQND  : PEJCEHKHSS      TKDM            KCGUSIC         OBKF            EYUMAGHN       
NVNIFQXO        : BDLOVTDOAD      PEIBCURP        RWLSVDEJDSLRII 
NITCAWLMTRJHWVN : FSMXFQDDVWABR  
LTCBWYQUMBBD    : HBVCDRHFUP      BTKXYXVB        XGTHODHK        MBAGKPRQK       JROPGCDDGJ     
PDMAW           : GMTCILBKUIMK    FMDBYUBIXAL    
AWDOSWX         : BDLOVTDOAD      JWHPVPQQELQVQG  SHXJKYBDMLP    
UWQG            : GFWLM           HRDMD           XNHTCISUMJB     AJOCJRNDGFBWUV  FGGG           
KKLKLCFBDIEC    : HVHIXSWYRF      HNROBUUXWBYIPSD XNMYVRFE       
KRAJI           : SOUVNNSQWP      RVTV            OYQRK           FJEPCV          FUOPUG         
GNRALSDIPTO     : DMWKXPLQWPNMOON QHYOPFOR        ITQFPUIAKBM    
GBLSMPBN        : DULCKJWV        GBTEGTOTK      
JUWKHQMQ        : FDVUXFMOJSGQCP  WUBJXK          WIPHVULDXT      QSOHHDFMHLAQSN  MBNESEMUJ      
PAPKCBDFJUBAU   : LWVSKCMDTLT     AYAQGTCJBW      MUOYVGNU       
DIDSXEIUND      : IYISC          
AMLNGNDGDN      : KJWLVKSNUGHLEH 
FSPQN           : AMVFYPGEEH      AULJOLWKS       LYQJMKXVTYAG    WWUEKYJOG       DSXIWSLRVKGL    VOTRQSORXL     
TKAWS           : MTQQEFU         OLXX            PXFQU          
PSJYNAEIA       : THFSPN          EXQCSOCBCJ      CPIDWNMGSDDTA   ILWNWYVPTBPU   
VNAJTGM         : WMSKHNTNQXNATT  UBDI            YSUXOHXI        VTSSYJSHENDCKJA
QTDINSY         : LYTG            IEXWRJDQAFG    
EBGYJYUSX       : IUAQ            SRDDCCEMYAKW    XSYQOX          XGGQAYJM       
UESV            : HNQULYALQT      BMTQNORRORELX   ETBMC           ETDYOLDYBBT     UXFKFJI        
OLXX            : SOABST          TKAWS           DHTARL          GHTWA           BRLWOOUHPBOSH   VMHBPPS        
GNRYHWHUPIE     : GEQOYHAEBB      HBVCDRHFUP      UGGHYFRR        WRDGAFCGBI      DUKD            QDYDXAXHT      
MLVVMQQK        : SOABST          CJMEHFFVTA      FIVKD          
MQWIRNVR        : DJIF            YFUJFV          IHBFIAR         BDNDI           YCFR           
EBCXALU         : AHICPYUYEXWKWGL RFPRUVNAN       VMHBPPS        
JMSNLFBHDNAU    : RHBNGFGFHKM     QPQWCE          BLBQYVNSWENKS   QLMEFUXC        AVUBP          
DHTARL          : XPSIBRTGTIS     OLXX            LJEVLOMNXFC     EKYDVERB        FYAXYIVESANLAI  GTSDIS         
NFDTGHRJSOTCC   : RLQOGPBC        ODDBBP          QUFOAXHAEI      KHDAGFWQOCIRO   WOEYPA          BOGLIDBBSNCBI   BUSQHXLVYS     
SNWVWAMYUMCEIF  : PVWVPCWHVO      WRDGAFCGBI      PFGKQBP        
VTMCYIII        : JYEIJLWX        OWLAKHTHHSTYINL SLFMHNDIG      
RBPN            : TGYB            GVJSIXWA        OUHS            VGUAVSP         TGVUL           BLBQYVNSWENKS  
TDBJAWICJHXYKE  : MTBDMXIOWXJ     GVJUGCYIWUYAMV  EFPFTVK         HSSDXAGSIHD     BLPEXCBLANEOI  
RDGNR           : FGBQE           EVEAQIR         ILWNWYVPTBPU   
OASWDLAVB       : BADFJQBPGE      LYTG            OMDRRNF         KEVJPLCSDFH     KBGTDDONHK     
PEJCEHKHSS      : GQTVLSPHMY      LWEWLDKDNMEQND  VQVKBDXCLAVDK   PSLRJ           REBGEN          SOIIHCMYLT      SFWQSGRKV      
TFNEW           : VEWAYPLG        YQJEDPUNS       MTLJXXNPHL      XEAARB          VMFOCUMVGLHYNF 
MMKUBNNXQB      : HCXJXH          OIDYGFGLOPY     EAGDEPMVPEINP   ABEFOPTTFCO     AOVJBNWTFVNPMPX SHXJKYBDMLP    
MDHFJQHQAT      : LPUVXUEX        TKDM            YIULKONTAEXBRRG DAABLTNPU       IGINNWM        
VOJPVWVSQKHDFI  : UBJLEYR         URGUWHYLKOMDEDA EDPRJVEGGNLD    PFGKQBP        
VGKY            : TSPNRWQVRJKDKW  EDPRJVEGGNLD   
WEOEOF          : XYXRNMAHQ       ADOKYDGKBSPU    JRQKETBLJBOPGC 
HIIHEWQVTPUOGF  : EIOKRBS         ICPFEMXGBVMHL   WJFOFWHXCSPAJ   GNRVQXYL        ATGI           
MNHDLONMVN      : VODONVRKNWKNW   DRDFLTFHAQM     PEIBCURP        YAJWHSDABXJAXU 
MTIRIPCQYGP     : FJEPCV          HRDMD          
FLFADOFCDUJG    : CTHWIMJSRADL    LADQYWQLMNTQTRH GABVDENUYKCL    PAGSSVWWGXT    
AWTXM           : LBCPBYIAQHJT    GMTCILBKUIMK    RVAXQYQIDRQ     OAKWVD         
KGXFQ           : PDAQSBKUHP      UKTLHBW         DRHCTRBBEEX     EDDPUKMCFGUCGK 
HHOOAETN        : QBHHIOVHW       GDGWIRNMTTMOSQ  XYIOHBLPBVQNWP 
VQCDUFYHOHHN    : CSUQHQEJKRLR    IIOLBNJYTD      RWFFFIKSVC      XEAN           
GAQQ            : BRNQBQOEWHLCE   QSOHHDFMHLAQSN  ITQFPUIAKBM     RAYYTXE        
OVAEEJSU        : NCTSLHWU        PYEULX          NKOXV           ROELQ          
WQALMQNR        : WOBDXQAX        TQJVIEFH        DRHCTRBBEEX     XWSMHKEYN      
VQVKBDXCLAVDK   : PEJCEHKHSS      AKUNRO          SYTECPRBOPYPKM  RFIJWLH         JGPJHN          HSDMCR          VNKYJQELHA     
BKPHWIEIIUIVJC  : MNANLFB         UCOT           
ESHUOTVT        : IUAQ            MTLJXXNPHL      SUAW            VULCHSOPDLJP    XMNUQ          
BGTYLHJMTBW     : MVSNXPDYOGXVQE  MTGTTKRXOFUNP   SOIIHCMYLT      EDPRJVEGGNLD   
MBCWYKSKOGOHO   : VOYYDFMEHC      BDLOVTDOAD      VMFOCUMVGLHYNF  ROELQ          
VKKQFNYBMKI     : JJBDAQ          TVHTVWMDJCJL   
YDAVTMAVLBJ     : PDBDKFKEBJJBW   MEDADNNHI       UXWMPMQK       
NALDICRGMCYT    : BUQMIXLQJCOWQ   RIDWIOUKT       UKTLHBW         QDYDXAXHT       LQPXPVXOPQQRFW 
XVDKECKHFIE     : BCFLRFXSYCMNIK  NMNXBSDXWSVRKIF AOVJBNWTFVNPMPX
KAGNLKCMXHWC    : TTMSJGOJSIMI    BTKXYXVB        XNHTCISUMJB    
DRDFLTFHAQM     : BRNQBQOEWHLCE   MNHDLONMVN      QUFOAXHAEI      LFTQVJOA        XSYQOX         
DTJNXEBBKO      : JTNMRXSHTFTDMAF
WSBXA           : FRTOHOYWEUHG    OSFOY           PCVVOPO         YWGSXHWCICJ     HRBIBWNFVIJDK  
CBETFLIBSPBLEI  : MWJIJXJLU       MJKDOGPDHRUJ   
YTFYXG          : IIWBKUT         RVAXQYQIDRQ     OJMMWQIPCHAH    EEXRHDETTIOX    DRNBHXAQOEDWGCE
KWRKQUKQV       : UBJLEYR         SFWQSGRKV      
UCJANTBIJDUO    : LXCV            TAXFCK          OHNABGDLSMOSVV 
JPHQQIWTUWN     : SGNDCHREKLXXXB  WIXLYUBMKREASU  NMNXBSDXWSVRKIF ODDBBP          GUNHLSSIP      
NKTGGJBKUBAOD   : ENSAJQWQQDYMOTS YIULKONTAEXBRRG
XIEOXNEF        : LYKD            XODGOKI         VCWUXFUMWTMWU  
VNGRLDH         : VOYYDFMEHC      TTDLNTAPPKLQFRV
QRNABWBLRFMG    : TSWDMUFMOEGYJ   ATGI            VTSSYJSHENDCKJA
VGUAVSP         : RBPN            DMMXKQCNSXEVR   PHHTVXLTOIRFA  
AYAQGTCJBW      : ENSAJQWQQDYMOTS PAPKCBDFJUBAU   LYQJMKXVTYAG    VHUJLTD         OAKWVD         
VKDYJ           : ENSAJQWQQDYMOTS NROCQ          
KDLYLVW         : FLDAHPDVTAMNTFE PAWWUMOT       
QYQLRSMQ        : HYEJVHE         LFTQVJOA        OHNABGDLSMOSVV 
DWNFHRCKPPNOYT  : IUAQ            AGNFTIKTCI      OIHCOOVTBMBM    CAKQ            AHPTJF          DSCC           
FGBQE           : XYXRNMAHQ       RDGNR           IIOLBNJYTD      YPOGLMEAHUIB   
LXACJRXVIRBGH   : OBKF            ODDBBP          QSOHHDFMHLAQSN  HMUVCAJNSKQVX  
NYLAODPFEJH     : MWJIJXJLU       QGSOJL          QEGNACCCBHILUB 
RIDWIOUKT       : NALDICRGMCYT    OPACNPG         PVFVGWQQCHAFQ   GDRCFP          WOPQIDHDON     
CRFLLGTSP       : YRKOAFHSBMH     BAMAFWDVDNJGQLT UXFKFJI        
UBJLEYR         : VOJPVWVSQKHDFI  KWRKQUKQV       GJUCDYTTW       DRNBHXAQOEDWGCE
KBUDLXCTOWHIF   : MXSOIN          PEIBCURP       
AKUNRO          : TYKT            VQVKBDXCLAVDK   NRLFWMNAYVXTVRC
JXEMJRQI        : DJIF            OCLKJMDRB       FVDHBPGJNBD    
BTKXYXVB        : LTCBWYQUMBBD    KAGNLKCMXHWC   
LXCV            : QFHKDHLIXEKJWH  DAPT            UCJANTBIJDUO    FMLE            LJEVLOMNXFC    
LYQJMKXVTYAG    : KASCRTJ         UGOFEI          FSPQN           AYAQGTCJBW      VQJEYEXNESER    DHKOLKERUKTPWE 
SYTECPRBOPYPKM  : EXQCSOCBCJ      VQVKBDXCLAVDK  
MJUBILKWXITRJV  : SGNDCHREKLXXXB  AHICPYUYEXWKWGL NSPKANC         PLLV            GNRVQXYL       
UQBOXEEPHSHI    : POSRNGH         ILWNWYVPTBPU    HDXFVWYMXARIYWE
UVAJHUKRJUOH    : DSKDULHACAVWFXL MARRNDBHOUKHPYO HKATA          
ICPFEMXGBVMHL   : QWADF           HIIHEWQVTPUOGF  QBHHIOVHW       OWLIKGIIHICP    QPQWCE          RVAXQYQIDRQ     RVRLYRSPWXFKO  
CVEMQCOCJKNBVIS : OCKPQILJUPXYLLS CWSAOLSSWR      FEACQFCIAXN     BAVPYWJQE      
QBHHIOVHW       : MKWXIBEA        DNRSUFTOWIIN    OUIPOEGRFGGCKF  TIOYNRICBCXVC   HHOOAETN        ICPFEMXGBVMHL   RKNCK           YXCMRWOLQAT    
QBHHIOVHW       : MBAGKPRQK      
DJHRHMNNBG      : VCIPNKOPEPA     MEDADNNHI       VWGVUTCDAKAI   
QICDVGYHYEXCOH  : PAWWUMOT       
DEUAEALNR       : FDVUXFMOJSGQCP  XSYQOX          IIOLBNJYTD     
AHICPYUYEXWKWGL : BIIGYLPIQ       JCAIDDB         EBCXALU         MJUBILKWXITRJV  RRLFFJD         VXYUEURBWUBKWL  GBLTJCDVMD     
HNROBUUXWBYIPSD : KKLKLCFBDIEC    EVEAQIR         DRHCTRBBEEX    
BMTQNORRORELX   : UESV            TDPUGJMUSPGGSTO
RFIJWLH         : TYKT            VQVKBDXCLAVDK   ETUIVHA         ITQFPUIAKBM    
KEVJPLCSDFH     : VEWAYPLG        BFUJV           WIJMNLEYOBMDJI  VUAYVLSOKSYCYIM OASWDLAVB       YDLTMHOPPHS    
YXOQREKW        : WELGRSRYOFIOFP  XHOH            GITOULV         HMUVCAJNSKQVX   HGLLRENGCAARA  
JQJQYVPLDK      : VOHEYOODGNWTKV  NGIIUD          ATGI           
HIHYTLSW        : IDRK            CWSAOLSSWR      OWLAKHTHHSTYINL
CWSAOLSSWR      : WIJMNLEYOBMDJI  CVEMQCOCJKNBVIS HIHYTLSW        MXQQCTBKHVOI    BAMAFWDVDNJGQLT
IIWBKUT         : IKMFHKMVYXPHPTW YTFYXG          QPUQH           MARRNDBHOUKHPYO YLVU            ESXPKU          QEKLEXYGJ       VCWUXFUMWTMWU  
XGTHODHK        : NCTSLHWU        LTCBWYQUMBBD    WOSCOTV         MEDADNNHI       BLPEXCBLANEOI   XTQF           
CJMEHFFVTA      : ENSAJQWQQDYMOTS MLVVMQQK        QPQWCE          CQJKBNYAASN    
SRDDCCEMYAKW    : QOIT            EIOKRBS         EBGYJYUSX       NMNXBSDXWSVRKIF NJFK            UGGHYFRR        NMNSBVHHGPI    
GFWLM           : YSWSBWPDAYAHIXC UWQG            LSGFHLTNPSIQEIT FVDHBPGJNBD     XGGQAYJM       
FQRRUBXCYTCP    : CPIDWNMGSDDTA   MESJTUIC        OILAP           QWADF           JCMKIKTN        PYEULX          EOHHMRJ        
VUPBAVNYYBY     : SBRNSQEHFGOGC  
JEFVSMB         : OCKPQILJUPXYLLS UGOFEI          JRCPOLQ         ILWNWYVPTBPU    XEAN           
GSGHSJIMNA      : LYTG            AMNMQGDLJ       QIAGYLUNKLWCOGC
MVSNXPDYOGXVQE  : THFSPN          VOYYDFMEHC      BGTYLHJMTBW     XEAARB         
OYQRK           : KRAJI           HNAQAGNL        OHASVFQPAD      EEXRHDETTIOX   
KRJGDRUSSW      : VPMXKILEDHB     VWGVUTCDAKAI    OYAQCLRPRIXEG  
QPUQH           : JMGATRVBMU      IIWBKUT         PXFQU           AAMHJUUCFABIAOV LQPXPVXOPQQRFW  GFFITPTXGAPJHJ 
PXFQU           : TKAWS           QPUQH           IIOLBNJYTD      GFFITPTXGAPJHJ 
WXMY            : IUYDJ           DULCKJWV        WHYOOULYRNCFWN  NRLFWMNAYVXTVRC BLPEXCBLANEOI  
EJSRDCXI        : XHOH            QLMEFUXC       
UCOT            : BKPHWIEIIUIVJC  QGMJUXUTOYYQ    FIVKD           DRNBHXAQOEDWGCE
HKFXTGOSLHPKEP  : LSTULYOSCFBJLI  ADOKYDGKBSPU    LQIFYD          TMBAY           LOTLFWRUK      
FJEPCV          : KRAJI           MTIRIPCQYGP     ETBMC           ODDBBP          LKXYGEH        
EVEAQIR         : RDGNR           HNROBUUXWBYIPSD OWLAKHTHHSTYINL RWFFFIKSVC     
TYXYXTHOMVVE    : JJBDAQ          CWKJINDCD      
CUHIELAIHWMF    : HKSKEDWFQWFSPSD ROELQ          
OWLIKGIIHICP    : ICPFEMXGBVMHL   WIBTMSXRFPWX    SFWQSGRKV       GBLTJCDVMD     
RLUVVYSDJYPLHYJ : TTMSJGOJSIMI    AGNFTIKTCI      BNEUDCAAFY      WJFOFWHXCSPAJ  
FMLE            : HNQULYALQT      IKMFHKMVYXPHPTW LXCV           
VOHEYOODGNWTKV  : LBCPBYIAQHJT    JQJQYVPLDK      RYQLLBH         RGRTOIFMGN      GUNHLSSIP       CQJKBNYAASN    
KQTVQLKXKTWRGI  : IDRK            FEACQFCIAXN     QSOHHDFMHLAQSN  XYIOHBLPBVQNWP 
HGMONNGCTMQQHBM : OQIGRDBPQRQS    ODJI            POSRNGH         YUCFSCWDSQXXNGB
NESMWGWWRS      : RHBNGFGFHKM     BWHCSWXQBLDVRTK
JYEIJLWX        : BRNQBQOEWHLCE   VTMCYIII        OBKF            TBBTVIOCX       DTBUL          
LEDFTTXDXNCNT   : SGNDCHREKLXXXB  IEDJROQSDFCVU   JGPJHN          PVFVGWQQCHAFQ  
AQEYNXRKKTOSD   : OIQMQEL         XUWFUTWQWYBV    XNHTCISUMJB     OIHCOOVTBMBM   
PDBDKFKEBJJBW   : RWLVAPRKMBW     YDAVTMAVLBJ     NMNXBSDXWSVRKIF KBGTDDONHK     
PSLRJ           : PEJCEHKHSS      XEAARB          UKCIXVOM       
RYQLLBH         : VOHEYOODGNWTKV  XHOH           
TKDM            : IPYMBRBR        MESJTUIC        LWEWLDKDNMEQND  MDHFJQHQAT      VMFOCUMVGLHYNF  MUOYVGNU        VOJWWCUTTOBY    SGLFNA         
HRDMD           : HEBDKMWBX       UWQG            MTIRIPCQYGP     GABVDENUYKCL    WKWDW           RWFFFIKSVC     
POSRNGH         : UQBOXEEPHSHI    HGMONNGCTMQQHBM WTIMASAGLQEXLRF YVVAWQYGHBEYWLL VWGVUTCDAKAI   
SBRNSQEHFGOGC   : WMSKHNTNQXNATT  IKMFHKMVYXPHPTW VUPBAVNYYBY    
LQUS            : SXXSGUMDLJCO    YDLTMHOPPHS    
XHOH            : YXOQREKW        EJSRDCXI        RYQLLBH         PLLV            OAKWVD         
DCRQIYWDCOQVHXF : CMSMKNKUJGRVKDX UXFKFJI        
ETUIVHA         : PKELHBMM        RFIJWLH        
CLQKAXKDCC      : VODONVRKNWKNW   GUNHLSSIP      
LDUQFJIDSGIIMD  : IBNFMF          QWADF           YQTMYINWLXP    
UBMW            : DMSFATVSYUEAR   EXQCSOCBCJ      BNYRAGFJ        XEAARB          CPGRSVMCMCWQT   WOEYPA          HHEC           
RKNCK           : EIOKRBS         OMDRRNF         QBHHIOVHW       DSKDULHACAVWFXL GFEMGW          MAGSXFRMR       ATGI           
OPQQNCTITYTE    : LPUVXUEX        ETBMC          
NMNXBSDXWSVRKIF : DMWKXPLQWPNMOON JCAIDDB         PKELHBMM        XVDKECKHFIE     JPHQQIWTUWN     SRDDCCEMYAKW    PDBDKFKEBJJBW  
TTDLNTAPPKLQFRV : BMUR            VNGRLDH         VOJWWCUTTOBY   
GKSHDXGA        : SXXSGUMDLJCO    EAGDEPMVPEINP   DECPSGV         VMUKSWIPHMBI    SLFMHNDIG      
ETBMC           : UESV            FJEPCV          OPQQNCTITYTE    XNHTCISUMJB     HNAQAGNL        MYYXVGAUXNIBD  
IXUULQWE        : GCYQIEQV        COKW           
JRAOK           : SOABST          UYVSR           WEKPAOVLROXLYIL GTSDIS         
JQGEYMD         : GFLIFNBAW       UOKCRAINGKNGQ   TSWDMUFMOEGYJ   XODGOKI        
MTLJXXNPHL      : VOYYDFMEHC      OUHS            TFNEW           ESHUOTVT        WUBJXK         
EAGDEPMVPEINP   : GVJUGCYIWUYAMV  BIIGYLPIQ       MMKUBNNXQB      GKSHDXGA        HNAQAGNL        MCQXSAFK        XODGOKI        
WUBJXK          : JCAIDDB         UGNHDOHUWWQV    JUWKHQMQ        MTLJXXNPHL      ODDBBP          FEACQFCIAXN     MWGWTTMIEC      VRERPVEBUDIFCT 
TVHTVWMDJCJL    : VKKQFNYBMKI     BDNDI          
OPACNPG         : RIDWIOUKT       NNFCTSMJT       GIKS            QPDGDSCPUKITSD  MBNESEMUJ      
GVYD            : IVVIEECEDN      EDDPUKMCFGUCGK 
CMSMKNKUJGRVKDX : DCRQIYWDCOQVHXF MXSOIN          VHUJLTD         XGTLIBTEFCQV   
OHLGHPWA        : ESXPKU          GNRVQXYL       
TGVUL           : RBPN            MJBKNDLHGYXK    IFATKKTLVQUPUUQ
YXINKXXHIEAEQFF : BCFLRFXSYCMNIK  YXCMRWOLQAT     DSJQUYETJYHU    GUNHLSSIP      
WOBDXQAX        : UGOFEI          WQALMQNR        VMUKSWIPHMBI    WXMDBEOKN      
VGKST           : OQIGRDBPQRQS    GHTWA           AMNMQGDLJ       DAOQNKJHYKJFX   WOEYPA         
RRLFFJD         : VMLSGMQEY       AHICPYUYEXWKWGL FMDBYUBIXAL     SHXJKYBDMLP     DUKD           
TKOBBUGQTURWSIA : RVTV            SUAW            ILCSRDF         OELQCADASWCOXOV DECPSGV        
YXCMRWOLQAT     : DMWKXPLQWPNMOON QBHHIOVHW       YXINKXXHIEAEQFF
MWJIJXJLU       : SXXSGUMDLJCO    QWADF           CBETFLIBSPBLEI  NYLAODPFEJH    
COKW            : SOUVNNSQWP      IXUULQWE        ESXPKU          DISW            GBLTJCDVMD     
GHQAH           : JFVRHOIEKVTF    QSIAAYG        
ETIBKUSNO       : MYQGEJVDDYMBEJE OBWFUPGTNX      PCVVOPO         AHPTJF         
CNAKXBUJVMNN    : YUCFSCWDSQXXNGB YRKOAFHSBMH     PXEXLWQTOGIQ    XODGOKI         HEYUIMWY       
KCGUSIC         : WIJMNLEYOBMDJI  LWEWLDKDNMEQND  VXYUEURBWUBKWL 
MXSOIN          : BIIGYLPIQ       BMUR            LWVSKCMDTLT     KBUDLXCTOWHIF   CMSMKNKUJGRVKDX PSNKYIUWV      
XEAARB          : PDAQSBKUHP      TFNEW           MVSNXPDYOGXVQE  PSLRJ           UBMW           
PEIBCURP        : THFSPN          NVNIFQXO        MNHDLONMVN      KBUDLXCTOWHIF   VHUJLTD         IYISC           EEXRHDETTIOX   
ETDYOLDYBBT     : UESV            PCVVOPO         MUOYVGNU        SYVVETMINJDESDT XNMYVRFE       
MJBKNDLHGYXK    : CPIDWNMGSDDTA   TGVUL           EJJOYQDSWSPEYGJ VRERPVEBUDIFCT 
BNEUDCAAFY      : RLUVVYSDJYPLHYJ PUCPTASQWUQI    PEGF           
TDPUGJMUSPGGSTO : HEBDKMWBX       BMTQNORRORELX   VPMXKILEDHB     WWUEKYJOG       DJHKIHWRKMRKL   OFRMECQIEXOSQR  YAJWHSDABXJAXU 
UOKCRAINGKNGQ   : JQGEYMD         XODGOKI        
UKTLHBW         : TSPNRWQVRJKDKW  KGXFQ           NALDICRGMCYT    URGUWHYLKOMDEDA MRSTWCLT       
VQJEYEXNESER    : LYQJMKXVTYAG   
WTIMASAGLQEXLRF : POSRNGH         JCMKIKTN        YOKKDSRHJIFE    VRERPVEBUDIFCT 
OBKF            : PPJTSFSPYSB     FDVUXFMOJSGQCP  LWEWLDKDNMEQND  LXACJRXVIRBGH   JYEIJLWX       
RFPRUVNAN       : EBCXALU         RWLSVDEJDSLRII 
YIULKONTAEXBRRG : GCWNETQRML      MDHFJQHQAT      NKTGGJBKUBAOD   FIVKD           ICCG           
GITOULV         : GCYQIEQV        WTOTBCKYPLYB    YXOQREKW        BIXSXCJLJ       HGLLRENGCAARA   IGINNWM        
DSJQUYETJYHU    : MKWXIBEA        OFPPIVDWRWDHWI  YXINKXXHIEAEQFF MEDADNNHI       QWYKLODCRVLTKDY EOHHMRJ         AVUBP          
WOSCOTV         : CPIDWNMGSDDTA   RWLVAPRKMBW     XGTHODHK        OLBXDXIMOJEOOB 
ADOKYDGKBSPU    : WEOEOF          HKFXTGOSLHPKEP  ABEFOPTTFCO     GPVWRTFFOD     
JRCPOLQ         : VCIPNKOPEPA     JEFVSMB         YCOCM           NJFK            PLLV            TAXFCK         
GHTWA           : XHLLSHBSGOF     UNQYALPIJWIPS   OLXX            VGKST           TSWDMUFMOEGYJ   XEQEF          
LTVRVYH         : LSTULYOSCFBJLI  VPMXKILEDHB     GFFITPTXGAPJHJ 
AMNMQGDLJ       : GSGHSJIMNA      VGKST           JGPJHN         
FNGTYWSIGM      : EDSE            QUQLAYYQBISF    PVFVGWQQCHAFQ   NUFEQXXKOPK    
GMTCILBKUIMK    : HCXJXH          PDMAW           AWTXM           UMDAPUSFBIN     DMMXKQCNSXEVR  
ABEFOPTTFCO     : IUYDJ           MMKUBNNXQB      ADOKYDGKBSPU    YVVAWQYGHBEYWLL FUOPUG         
YHPGVWOKQTUFUF  : YMAOPVFFVUHRPH  EKYDVERB        NUFEQXXKOPK    
DSKDULHACAVWFXL : TBNQAQD         UVAJHUKRJUOH    RKNCK           EDPRJVEGGNLD   
YUCFSCWDSQXXNGB : MLBBSERAG       HGMONNGCTMQQHBM CNAKXBUJVMNN    ATGI           
YNVVCFVEHR      : UBDI            OHNABGDLSMOSVV  JYXJJAAGOKRPP  
NROCQ           : UNQYALPIJWIPS   OUHS            VKDYJ           QERWODSTSEWIPFS OHASVFQPAD      SSQQK          
HYEJVHE         : YSWSBWPDAYAHIXC QYQLRSMQ        QPXEB           TBBTVIOCX      
GFEMGW          : IEDJROQSDFCVU   RKNCK           CCWXXU         
VUJXAHF         : REBGEN          QRLTGBYPLNBOCKO BOYCIWGLAUXYH  
BIXSXCJLJ       : GITOULV         FEFTAQWOO       JRQKETBLJBOPGC  SSQQK          
QSIAAYG         : PVBAJA          IDRK            GHQAH          
DULCKJWV        : JMGATRVBMU      GBLSMPBN        WXMY            UKCIXVOM        GDRCFP         
ADPKEXIYXKLKWVD : MKWXIBEA        OXSSVKVM        YFUJFV          EEQFMOELEC      LOYET           YAJWHSDABXJAXU 
HDRGMWMJKOU     : UBDI            FEACQFCIAXN     HKSKEDWFQWFSPSD YMAOPVFFVUHRPH 
OSFOY           : WSBXA           PXEXLWQTOGIQ    XGTLIBTEFCQV   
YFUJFV          : MQWIRNVR        ADPKEXIYXKLKWVD YSUXOHXI        MJKDOGPDHRUJ   
QGSOJL          : NYLAODPFEJH     PAWWUMOT        WKWDW           XYIOHBLPBVQNWP 
ODDBBP          : NFDTGHRJSOTCC   JPHQQIWTUWN     LXACJRXVIRBGH   FJEPCV          WUBJXK          MEDADNNHI       RVAXQYQIDRQ     OFRMECQIEXOSQR 
ODDBBP          : XUVHJEBXKFOSM   YPTBFSEJT      
NGIIUD          : JQJQYVPLDK      DSXIWSLRVKGL   
JCMKIKTN        : DAPT            FQRRUBXCYTCP    WTIMASAGLQEXLRF ILWNWYVPTBPU    RWLSVDEJDSLRII 
QGMJUXUTOYYQ    : IEXWRJDQAFG     UBDI            UCOT           
QERWODSTSEWIPFS : GFLIFNBAW       RWLVAPRKMBW     NROCQ          
UYCDN           : NCTSLHWU        YQJEDPUNS       GEKUJ           XEAN           
XNHTCISUMJB     : AMVFYPGEEH      UWQG            KAGNLKCMXHWC    AQEYNXRKKTOSD   ETBMC          
HPICK           : BLBQYVNSWENKS  
IJLAQGMNFOQUDQI : MBNESEMUJ      
LLVEIJQKOA      : AULJOLWKS       MNANLFB         YCOCM           GTSDIS         
YCOCM           : JRCPOLQ         LLVEIJQKOA      HDVRAUUHUFWPK  
QPQWCE          : IEDJROQSDFCVU   BCFLRFXSYCMNIK  JMSNLFBHDNAU    ICPFEMXGBVMHL   CJMEHFFVTA      DNTHFOFD        TQJVIEFH        PAGSSVWWGXT    
QPQWCE          : OYAQCLRPRIXEG  
SUAW            : GOYYYAQUJMDC    LYTG            ESHUOTVT        TKOBBUGQTURWSIA UMDAPUSFBIN     WXMDBEOKN      
LKXYGEH         : IPYMBRBR        VODONVRKNWKNW   FJEPCV         
URGUWHYLKOMDEDA : DMSFATVSYUEAR   VOJPVWVSQKHDFI  UKTLHBW         WEKPAOVLROXLYIL
IHBFIAR         : MQWIRNVR        RGRTOIFMGN     
MRSTWCLT        : KASCRTJ         UKTLHBW         WWUEKYJOG      
UPTCOHODTTJAURK : YSWSBWPDAYAHIXC MOERAAVSV       QEGNACCCBHILUB  QWYKLODCRVLTKDY VULCHSOPDLJP    FYAXYIVESANLAI 
VPMXKILEDHB     : UGLIDVX         KRJGDRUSSW      TDPUGJMUSPGGSTO LTVRVYH         GEEY           
SXDPNYUEG       : TYKT            PVWVPCWHVO      SFFNQAIYECBGIX  PHEAXIKT        AYODBPORWHMIXA 
KBGTDDONHK      : OASWDLAVB       PDBDKFKEBJJBW   JGPJHN          CNLRTTYQUMMPES  GEKUJ          
WIPHVULDXT      : WNREPPPPWLQMIL  OIQMQEL         JUWKHQMQ        YIEOGXAKJBPXXVI GFFITPTXGAPJHJ 
VYOLXLSEXDHEY   : PVBAJA          PSJOPVIADXT     GDGWIRNMTTMOSQ  DHKOLKERUKTPWE 
HNAQAGNL        : IDRK            OYQRK           ETBMC           EAGDEPMVPEINP   AOVJBNWTFVNPMPX
VHUJLTD         : DQLBERYH        AYAQGTCJBW      CMSMKNKUJGRVKDX PEIBCURP        LFTQVJOA        DYTEFALLJTT    
REBGEN          : SPSHDNIHO       PEJCEHKHSS      VUJXAHF         MLVWFKWLY      
ILCSRDF         : TKOBBUGQTURWSIA
RGRTOIFMGN      : VOHEYOODGNWTKV  IHBFIAR         NKOXV           UDKPPGTVOJKSN  
PYEULX          : JFVRHOIEKVTF    VCIPNKOPEPA     OVAEEJSU        FQRRUBXCYTCP    JGPJHN          HGLLRENGCAARA   VCWUXFUMWTMWU  
MEDADNNHI       : TNUSGGAEX       YDAVTMAVLBJ     DJHRHMNNBG      XGTHODHK        DSJQUYETJYHU    ODDBBP          ROELQ          
LQIFYD          : RLQOGPBC        IPYMBRBR        HKFXTGOSLHPKEP  GBTEGTOTK       WKWDW          
NNFCTSMJT       : VHST            OPACNPG        
EFPFTVK         : QLCYBLWODDGSTWS TDBJAWICJHXYKE  YVVAWQYGHBEYWLL
AAMHJUUCFABIAOV : QPUQH          
QPXEB           : GFLIFNBAW       OCKPQILJUPXYLLS JMGATRVBMU      HYEJVHE         RMYCWHHDRCKPO  
WHYOOULYRNCFWN  : WGJPWNMGBQLFQDH TSPNRWQVRJKDKW  WXMY            PHHTVXLTOIRFA  
SPFS            : SGNDCHREKLXXXB  IPYMBRBR        BNYRAGFJ        CPGRSVMCMCWQT   RVRLYRSPWXFKO  
QUFOAXHAEI      : WGJPWNMGBQLFQDH EDSE            NFDTGHRJSOTCC   DRDFLTFHAQM     PLLV            DMMXKQCNSXEVR  
CSUQHQEJKRLR    : VQCDUFYHOHHN    SOIIHCMYLT      GDRCFP          UDKPPGTVOJKSN  
YRKOAFHSBMH     : GCWNETQRML      CRFLLGTSP       CNAKXBUJVMNN    TMBAY          
MOERAAVSV       : GQTVLSPHMY      UPTCOHODTTJAURK
AOVJBNWTFVNPMPX : MMKUBNNXQB      XVDKECKHFIE     HNAQAGNL        YOKKDSRHJIFE   
IYISC           : WGJPWNMGBQLFQDH DIDSXEIUND      PEIBCURP        WGONR          
JGPJHN          : OILAP           VQVKBDXCLAVDK   LEDFTTXDXNCNT   AMNMQGDLJ       KBGTDDONHK      PYEULX          BAMAFWDVDNJGQLT LOTLFWRUK      
FEFTAQWOO       : OCLKJMDRB       SFFNQAIYECBGIX  BIXSXCJLJ       OHASVFQPAD     
VMFOCUMVGLHYNF  : TFNEW           MBCWYKSKOGOHO   TKDM            ALOFPRLQ        JWHPVPQQELQVQG  WGONR          
WWUEKYJOG       : FSPQN           TDPUGJMUSPGGSTO MRSTWCLT        HSDMCR          YQTMYINWLXP     DTBUL          
RACIQVEFBSHXH   : XAJCLNJN        DMSFATVSYUEAR   XUWFUTWQWYBV    MUOYVGNU        XYIOHBLPBVQNWP 
GUNHLSSIP       : JPHQQIWTUWN     VOHEYOODGNWTKV  CLQKAXKDCC      YXINKXXHIEAEQFF DAOQNKJHYKJFX   YKLFPKLTOXWQ   
MCQXSAFK        : BUQMIXLQJCOWQ   EAGDEPMVPEINP  
HSSDXAGSIHD     : TDBJAWICJHXYKE  ILWNWYVPTBPU    WGKTJC         
PXEXLWQTOGIQ    : GVJSIXWA        BAAOWCYMRJD     CNAKXBUJVMNN    OSFOY           YXBVUYXLBTJP   
ILWNWYVPTBPU    : PSJYNAEIA       RDGNR           UQBOXEEPHSHI    JEFVSMB         JCMKIKTN        HSSDXAGSIHD    
LFTQVJOA        : DRDFLTFHAQM     QYQLRSMQ        VHUJLTD        
BYCWNI          : SOKPJD          HGLLRENGCAARA   FIVKD          
GIQRHFQJDJDGBAQ : TTMSJGOJSIMI    EFTXWMIV        EOGX            DHKOLKERUKTPWE 
FMDBYUBIXAL     : WELGRSRYOFIOFP  PDMAW           RRLFFJD         PWNJLUWEPCDK    MAGSXFRMR      
PVFVGWQQCHAFQ   : SVEJ            RIDWIOUKT       LEDFTTXDXNCNT   FNGTYWSIGM      QIAGYLUNKLWCOGC
LSGFHLTNPSIQEIT : JJBDAQ          SVEJ            GFWLM           TBBTVIOCX      
FJPNGYKYPMGPTA  : FEACQFCIAXN     MARRNDBHOUKHPYO XGGQAYJM       
HSDMCR          : SGNDCHREKLXXXB  YSWSBWPDAYAHIXC VQVKBDXCLAVDK   WWUEKYJOG       ARYXTHPVEMS    
PHEAXIKT        : TNUSGGAEX       OILAP           SXDPNYUEG      
SEUGMTQLJ       : BUQMIXLQJCOWQ   FGGG            QDYDXAXHT       YKLFPKLTOXWQ   
TBBTVIOCX       : GCWNETQRML      LYTG            JYEIJLWX        HYEJVHE         LSGFHLTNPSIQEIT RVRLYRSPWXFKO  
THJBLKBWWV      : IEXWRJDQAFG     WMSKHNTNQXNATT 
PCVVOPO         : WSBXA           ETIBKUSNO       ETDYOLDYBBT     YLVU            FSMXFQDDVWABR   BDNDI          
YVVAWQYGHBEYWLL : POSRNGH         ABEFOPTTFCO     EFPFTVK         BWHCSWXQBLDVRTK AHPTJF          VOTRQSORXL     
YXBVUYXLBTJP    : PXEXLWQTOGIQ    ITQFPUIAKBM    
BRLWOOUHPBOSH   : GQTVLSPHMY      IVEAGTBFRYUSXXX OUHS            OLXX            EOGX            XFTW           
PUCPTASQWUQI    : BNEUDCAAFY      NKOXV           TMBAY           NUFEQXXKOPK    
MUOYVGNU        : PAPKCBDFJUBAU   TKDM            ETDYOLDYBBT     RACIQVEFBSHXH  
CPGRSVMCMCWQT   : IUYDJ           UBMW            SPFS            DJHKIHWRKMRKL   DRNBHXAQOEDWGCE
SOKPJD          : WIJMNLEYOBMDJI  BYCWNI          EJJOYQDSWSPEYGJ QIAGYLUNKLWCOGC
GPVWRTFFOD      : ADOKYDGKBSPU    TMBAY          
FLDAHPDVTAMNTFE : AMVFYPGEEH      KDLYLVW         GNRVQXYL       
VOJWWCUTTOBY    : TIOYNRICBCXVC   TKDM            TTDLNTAPPKLQFRV DECPSGV        
GIKS            : RWLVAPRKMBW     OPACNPG         HDVRAUUHUFWPK  
LADQYWQLMNTQTRH : MTQQEFU         FLFADOFCDUJG   
QEGNACCCBHILUB  : TYKT            NYLAODPFEJH     UPTCOHODTTJAURK DJHKIHWRKMRKL   LSQDAKCOUMJ    
GEEY            : HEBDKMWBX       VPMXKILEDHB     NGWWXN         
BPQPFMGAGQGYU   : FUOPUG          VNKYJQELHA     
MXQQCTBKHVOI    : CWSAOLSSWR     
UMDAPUSFBIN     : GMTCILBKUIMK    SUAW            LOTLFWRUK       RAYYTXE        
OELQCADASWCOXOV : TKOBBUGQTURWSIA LQPXPVXOPQQRFW 
FEACQFCIAXN     : CVEMQCOCJKNBVIS KQTVQLKXKTWRGI  WUBJXK          HDRGMWMJKOU     FJPNGYKYPMGPTA 
GDGWIRNMTTMOSQ  : HHOOAETN        VYOLXLSEXDHEY  
QHYOPFOR        : YRCQXIAVN       GNRALSDIPTO     GABVDENUYKCL   
VWGVUTCDAKAI    : DJHRHMNNBG      KRJGDRUSSW      POSRNGH         HMUVCAJNSKQVX   XWSMHKEYN      
QWYKLODCRVLTKDY : TOPD            DSJQUYETJYHU    UPTCOHODTTJAURK
VXYUEURBWUBKWL  : AHICPYUYEXWKWGL KCGUSIC         SSQQK           BOGLIDBBSNCBI  
NKOXV           : OVAEEJSU        RGRTOIFMGN      PUCPTASQWUQI    CWKJINDCD       XTQF           
DAABLTNPU       : THFSPN          MDHFJQHQAT     
NSPKANC         : TBNQAQD         SHTPQHYVW       MJUBILKWXITRJV  FVDHBPGJNBD     EEQFMOELEC     
MWGWTTMIEC      : WUBJXK         
AJOCJRNDGFBWUV  : VODONVRKNWKNW   UNQYALPIJWIPS   OULTOHJWVKVAFF  UWQG            UXWMPMQK       
FVDHBPGJNBD     : GQTVLSPHMY      TIOYNRICBCXVC   JXEMJRQI        GFWLM           NSPKANC         HGLLRENGCAARA   XSYQOX          MLVWFKWLY      
FVDHBPGJNBD     : TMBAY          
LJEVLOMNXFC     : DHTARL          LXCV           
NJFK            : SRDDCCEMYAKW    JRCPOLQ         WOBAMMLVMCFUP  
BAMAFWDVDNJGQLT : MTQQEFU         PVWVPCWHVO      CRFLLGTSP       CWSAOLSSWR      JGPJHN         
QSOHHDFMHLAQSN  : WIJMNLEYOBMDJI  JUWKHQMQ        GAQQ            LXACJRXVIRBGH   KQTVQLKXKTWRGI 
UPNW            : TBNQAQD         WGJPWNMGBQLFQDH FIVKD          
MARRNDBHOUKHPYO : HNQULYALQT      UVAJHUKRJUOH    IIWBKUT         FJPNGYKYPMGPTA  OEJCQOVLYRB    
CWKJINDCD       : TGYB            FRTOHOYWEUHG    TYXYXTHOMVVE    NKOXV           MLVWFKWLY       YWGSXHWCICJ    
YSUXOHXI        : RWLVAPRKMBW     VNAJTGM         YFUJFV         
OLBXDXIMOJEOOB  : AIRXA           WOSCOTV         VTSSYJSHENDCKJA EDDPUKMCFGUCGK 
ALOFPRLQ        : VMFOCUMVGLHYNF  NGWWXN          UKCIXVOM        ROELQ           HDVRAUUHUFWPK  
GOCOPN          : HCXJXH          YPTBFSEJT      
GBTEGTOTK       : QFHKDHLIXEKJWH  IEDJROQSDFCVU   GBLSMPBN        LQIFYD         
AYODBPORWHMIXA  : SXDPNYUEG       GTSDIS          NUFEQXXKOPK    
PEGF            : DNRSUFTOWIIN    EIOKRBS         BNEUDCAAFY      MLVWFKWLY       NMNSBVHHGPI    
YLVU            : IIWBKUT         PCVVOPO        
EOGX            : KGFXKBQEPC      GIQRHFQJDJDGBAQ BRLWOOUHPBOSH   ROELQ          
GABVDENUYKCL    : FLFADOFCDUJG    HRDMD           QHYOPFOR        NGWWXN         
CNLRTTYQUMMPES  : GVJSIXWA        KBGTDDONHK     
MTGTTKRXOFUNP   : IBNFMF          BYJSSYA         BGTYLHJMTBW    
BLBQYVNSWENKS   : JMSNLFBHDNAU    RBPN            HPICK          
QLMEFUXC        : DJIF            JMSNLFBHDNAU    EJSRDCXI        FGGG           
PAWWUMOT        : KDLYLVW         QICDVGYHYEXCOH  QGSOJL          DSCC           
BWHCSWXQBLDVRTK : EAMMFBNHAENEDGP JMGATRVBMU      NESMWGWWRS      YVVAWQYGHBEYWLL
ARYXTHPVEMS     : HSDMCR          DHKOLKERUKTPWE 
EOHHMRJ         : PVBAJA          FQRRUBXCYTCP    DSJQUYETJYHU    FFUWNVRLBIBD    PITTMR          RVRLYRSPWXFKO  
OHASVFQPAD      : OYQRK           NROCQ           FEFTAQWOO       TSWDMUFMOEGYJ  
AVUBP           : JMSNLFBHDNAU    DSJQUYETJYHU    OAKWVD         
SOIIHCMYLT      : PEJCEHKHSS      BGTYLHJMTBW     CSUQHQEJKRLR   
FFUWNVRLBIBD    : GCWNETQRML      RHBNGFGFHKM     EOHHMRJ        
WGKTJC          : HSSDXAGSIHD     GTSDIS         
CQJKBNYAASN     : IUAQ            EDSE            WELGRSRYOFIOFP  SPSHDNIHO       CJMEHFFVTA      VOHEYOODGNWTKV  DNTHFOFD       
YIEOGXAKJBPXXVI : IKMFHKMVYXPHPTW WIPHVULDXT     
HKSKEDWFQWFSPSD : OXSSVKVM        BNYRAGFJ        CUHIELAIHWMF    HDRGMWMJKOU    
DJHKIHWRKMRKL   : XUWFUTWQWYBV    TDPUGJMUSPGGSTO CPGRSVMCMCWQT   QEGNACCCBHILUB  TPGIQGWFSSS    
FSMXFQDDVWABR   : NITCAWLMTRJHWVN PCVVOPO         WEKPAOVLROXLYIL UXWMPMQK        FYAXYIVESANLAI  HRBIBWNFVIJDK  
VULCHSOPDLJP    : ESHUOTVT        UPTCOHODTTJAURK QEKLEXYGJ       GEKUJ          
BDNDI           : LYKD            MQWIRNVR        TVHTVWMDJCJL    PCVVOPO         ICCG           
PIOHO           : MYQGEJVDDYMBEJE XWSMHKEYN      
DNTHFOFD        : KGFXKBQEPC      QPQWCE          CQJKBNYAASN    
HMUVCAJNSKQVX   : LXACJRXVIRBGH   YXOQREKW        VWGVUTCDAKAI    XMNUQ           EEXRHDETTIOX   
EJJOYQDSWSPEYGJ : XPSIBRTGTIS     MJBKNDLHGYXK    SOKPJD         
ITQFPUIAKBM     : BRNQBQOEWHLCE   GNRALSDIPTO     GAQQ            RFIJWLH         YXBVUYXLBTJP   
WKWDW           : HRDMD           QGSOJL          LQIFYD         
RVAXQYQIDRQ     : IVEAGTBFRYUSXXX AWTXM           YTFYXG          ICPFEMXGBVMHL   ODDBBP          ESXPKU         
XYIOHBLPBVQNWP  : JMGATRVBMU      HHOOAETN        KQTVQLKXKTWRGI  QGSOJL          RACIQVEFBSHXH   YCFR           
TSWDMUFMOEGYJ   : OULTOHJWVKVAFF  QRNABWBLRFMG    JQGEYMD         GHTWA           OHASVFQPAD     
QAWPL           : TDINVEXUQXR    
YMAOPVFFVUHRPH  : HEBDKMWBX       YHPGVWOKQTUFUF  HDRGMWMJKOU     XEQEF           CAKQ           
DECPSGV         : GEQOYHAEBB      SOABST          GKSHDXGA        TKOBBUGQTURWSIA VOJWWCUTTOBY    OSDDVQCRTTNJ   
RWLSVDEJDSLRII  : DQLBERYH        NVNIFQXO        RFPRUVNAN       JCMKIKTN        PHHTVXLTOIRFA  
NGWWXN          : DMWKXPLQWPNMOON GEEY            ALOFPRLQ        GABVDENUYKCL   
TQJVIEFH        : PDAQSBKUHP      WQALMQNR        QPQWCE          BBSQBRNYO       EDDPUKMCFGUCGK 
WEKPAOVLROXLYIL : WMSKHNTNQXNATT  JRAOK           URGUWHYLKOMDEDA FSMXFQDDVWABR  
OJMMWQIPCHAH    : IUAQ            YTFYXG          PDBIDJGV        SLFMHNDIG      
HGLLRENGCAARA   : YXOQREKW        GITOULV         PYEULX          BYCWNI          FVDHBPGJNBD    
QIAGYLUNKLWCOGC : GSGHSJIMNA      PVFVGWQQCHAFQ   SOKPJD          UXWMPMQK        NRUYIYSLULFELQ  VOTRQSORXL     
UKCIXVOM        : PSLRJ           DULCKJWV        ALOFPRLQ        LOTLFWRUK       FYAXYIVESANLAI  HDVRAUUHUFWPK  
ROELQ           : OVAEEJSU        MBCWYKSKOGOHO   CUHIELAIHWMF    MEDADNNHI       ALOFPRLQ        EOGX            RHHQJMLDSQVUW   XUVHJEBXKFOSM  
EYUMAGHN        : LWEWLDKDNMEQND  MLVWFKWLY      
VMUKSWIPHMBI    : FWMTVAM         GKSHDXGA        WOBDXQAX        FUOPUG          XNMYVRFE       
PWNJLUWEPCDK    : FMDBYUBIXAL     MAGSXFRMR       TLCWFHIWWDFX   
FSYS            : PHHTVXLTOIRFA  
UGGHYFRR        : PHPBUFMXGFE     GNRYHWHUPIE     SRDDCCEMYAKW    RHHQJMLDSQVUW  
ESXPKU          : IIWBKUT         OHLGHPWA        COKW            RVAXQYQIDRQ    
WIBTMSXRFPWX    : GCYQIEQV        OWLIKGIIHICP    KHDAGFWQOCIRO   GEKUJ          
PLLV            : MJUBILKWXITRJV  XHOH            JRCPOLQ         QUFOAXHAEI      MAGSXFRMR      
UXWMPMQK        : QFHKDHLIXEKJWH  YDAVTMAVLBJ     AJOCJRNDGFBWUV  FSMXFQDDVWABR   QIAGYLUNKLWCOGC
JWHPVPQQELQVQG  : AWDOSWX         VMFOCUMVGLHYNF 
OWLAKHTHHSTYINL : MLBBSERAG       VTMCYIII        HIHYTLSW        EVEAQIR        
WJFOFWHXCSPAJ   : HIIHEWQVTPUOGF  RLUVVYSDJYPLHYJ FIVKD          
TAXFCK          : UCJANTBIJDUO    JRCPOLQ         NUFEQXXKOPK    
XSYQOX          : EBGYJYUSX       DRDFLTFHAQM     DEUAEALNR       FVDHBPGJNBD    
EKYDVERB        : GCYQIEQV        OUIPOEGRFGGCKF  DHTARL          YHPGVWOKQTUFUF 
YCFR            : WELGRSRYOFIOFP  MQWIRNVR        XYIOHBLPBVQNWP  JTNMRXSHTFTDMAF EEXRHDETTIOX    XGTLIBTEFCQV   
GDRCFP          : RIDWIOUKT       DULCKJWV        CSUQHQEJKRLR    NMNSBVHHGPI     BOGLIDBBSNCBI   GFFITPTXGAPJHJ 
HDXFVWYMXARIYWE : TBNQAQD         OMBBBVWURAKID   UQBOXEEPHSHI    HEYUIMWY       
RHHQJMLDSQVUW   : ROELQ           UGGHYFRR       
EEQFMOELEC      : OMDRRNF         ADPKEXIYXKLKWVD NSPKANC        
XMNUQ           : UGLIDVX         VCIPNKOPEPA     ESHUOTVT        HMUVCAJNSKQVX   GBLTJCDVMD     
MBAGKPRQK       : BDLOVTDOAD      LTCBWYQUMBBD    QBHHIOVHW      
OIHCOOVTBMBM    : WELGRSRYOFIOFP  VOYYDFMEHC      DWNFHRCKPPNOYT  AQEYNXRKKTOSD  
DAOQNKJHYKJFX   : ENSAJQWQQDYMOTS VGKST           GUNHLSSIP       BBSQBRNYO       YWGSXHWCICJ    
YOKKDSRHJIFE    : IDRK            OMBBBVWURAKID   WTIMASAGLQEXLRF AOVJBNWTFVNPMPX
SHXJKYBDMLP     : OULTOHJWVKVAFF  AWDOSWX         MMKUBNNXQB      RRLFFJD         AHPTJF         
MAGSXFRMR       : RKNCK           FMDBYUBIXAL     PWNJLUWEPCDK    PLLV            XGGQAYJM       
RMYCWHHDRCKPO   : QPXEB          
QPDGDSCPUKITSD  : HBVCDRHFUP      MESJTUIC        OPACNPG        
KHDAGFWQOCIRO   : NFDTGHRJSOTCC   WIBTMSXRFPWX   
GNRVQXYL        : DMSFATVSYUEAR   HIIHEWQVTPUOGF  MJUBILKWXITRJV  OHLGHPWA        FLDAHPDVTAMNTFE SFWQSGRKV       DUWXTGAMRWA    
OHNABGDLSMOSVV  : LYTG            UBDI            SPSHDNIHO       UCJANTBIJDUO    QYQLRSMQ        YNVVCFVEHR     
MLVWFKWLY       : REBGEN          FVDHBPGJNBD     CWKJINDCD       PEGF            EYUMAGHN        JTNMRXSHTFTDMAF
JRQKETBLJBOPGC  : WEOEOF          BIXSXCJLJ      
VRERPVEBUDIFCT  : WUBJXK          MJBKNDLHGYXK    WTIMASAGLQEXLRF XEQEF           BFJIROT         VCWUXFUMWTMWU  
TFYMPFITQRWH    : WELGRSRYOFIOFP  GBLTJCDVMD     
GJUCDYTTW       : JFVRHOIEKVTF    LSTULYOSCFBJLI  UBJLEYR        
WRDGAFCGBI      : AGNFTIKTCI      LBCPBYIAQHJT    GNRYHWHUPIE     SNWVWAMYUMCEIF  DSCC           
OAKWVD          : AWTXM           AYAQGTCJBW      XHOH            AVUBP          
TMBAY           : LPUVXUEX        HKFXTGOSLHPKEP  YRKOAFHSBMH     PUCPTASQWUQI    GPVWRTFFOD      FVDHBPGJNBD    
CCWXXU          : CTHWIMJSRADL    GFEMGW         
XODGOKI         : YRCQXIAVN       XIEOXNEF        JQGEYMD         EAGDEPMVPEINP   CNAKXBUJVMNN    UOKCRAINGKNGQ  
OSDDVQCRTTNJ    : DECPSGV         DYTEFALLJTT    
PITTMR          : EOHHMRJ         NRUYIYSLULFELQ 
LOTLFWRUK       : HKFXTGOSLHPKEP  JGPJHN          UMDAPUSFBIN     UKCIXVOM        OEJCQOVLYRB    
SYVVETMINJDESDT : ETDYOLDYBBT    
WOPQIDHDON      : RIDWIOUKT      
IIOLBNJYTD      : VQCDUFYHOHHN    FGBQE           DEUAEALNR       PXFQU           XFTW           
DSXIWSLRVKGL    : FSPQN           NGIIUD          RAYYTXE         KJWLVKSNUGHLEH 
QRLTGBYPLNBOCKO : CPIDWNMGSDDTA   VUJXAHF         NMNSBVHHGPI    
PDBIDJGV        : BNYRAGFJ        OJMMWQIPCHAH    YDLTMHOPPHS    
ATGI            : HIIHEWQVTPUOGF  QRNABWBLRFMG    JQJQYVPLDK      RKNCK           YUCFSCWDSQXXNGB WICPWAC        
MYYXVGAUXNIBD   : ETBMC           IVVIEECEDN      HRBIBWNFVIJDK   VTSSYJSHENDCKJA KOVFIQETJMAAPCM
NRLFWMNAYVXTVRC : WNREPPPPWLQMIL  VUAYVLSOKSYCYIM AKUNRO          WXMY           
WOEYPA          : NFDTGHRJSOTCC   UBMW            VGKST           QDYDXAXHT       UXFKFJI         PSNKYIUWV       TKINJLKX       
RWFFFIKSVC      : VQCDUFYHOHHN    EVEAQIR         HRDMD           HHEC            EEXRHDETTIOX   
BBSQBRNYO       : TQJVIEFH        DAOQNKJHYKJFX   DRNBHXAQOEDWGCE
SSQQK           : WIJMNLEYOBMDJI  OCLKJMDRB       NROCQ           BIXSXCJLJ       VXYUEURBWUBKWL 
RAYYTXE         : QOIT            BFUJV           OQIGRDBPQRQS    GAQQ            UMDAPUSFBIN     DSXIWSLRVKGL   
DMMXKQCNSXEVR   : TOPD            VGUAVSP         GMTCILBKUIMK    QUFOAXHAEI     
XGGQAYJM        : DQLBERYH        EBGYJYUSX       GFWLM           FJPNGYKYPMGPTA  MAGSXFRMR       YDLTMHOPPHS    
BOYCIWGLAUXYH   : SGNDCHREKLXXXB  DQLBERYH        VUJXAHF        
DUKD            : GNRYHWHUPIE     RRLFFJD        
IVVIEECEDN      : WELGRSRYOFIOFP  GVYD            MYYXVGAUXNIBD   XFTW           
DRHCTRBBEEX     : KGXFQ           WQALMQNR        HNROBUUXWBYIPSD
FIVKD           : MLVVMQQK        UCOT            YIULKONTAEXBRRG BYCWNI          UPNW            WJFOFWHXCSPAJ   VGKNIHLPD      
OFRMECQIEXOSQR  : DQLBERYH        TDPUGJMUSPGGSTO ODDBBP         
YWGSXHWCICJ     : WSBXA           CWKJINDCD       DAOQNKJHYKJFX   XEQEF          
XUVHJEBXKFOSM   : ODDBBP          ROELQ           OEJCQOVLYRB    
HHEC            : WELGRSRYOFIOFP  RVTV            UBMW            RWFFFIKSVC     
FYAXYIVESANLAI  : DHTARL          UPTCOHODTTJAURK FSMXFQDDVWABR   UKCIXVOM       
JTNMRXSHTFTDMAF : TTMSJGOJSIMI    DTJNXEBBKO      YCFR            MLVWFKWLY      
FGGG            : GOYYYAQUJMDC    UWQG            SEUGMTQLJ       QLMEFUXC       
QEKLEXYGJ       : WIXLYUBMKREASU  IIWBKUT         VULCHSOPDLJP    YQTMYINWLXP    
QDYDXAXHT       : PHPBUFMXGFE     GNRYHWHUPIE     NALDICRGMCYT    SEUGMTQLJ       WOEYPA         
DYTEFALLJTT     : VHUJLTD         OSDDVQCRTTNJ   
XEQEF           : GHTWA           YMAOPVFFVUHRPH  VRERPVEBUDIFCT  YWGSXHWCICJ    
LOYET           : ADPKEXIYXKLKWVD HEYUIMWY       
HRBIBWNFVIJDK   : MLBBSERAG       OXSSVKVM        WSBXA           FSMXFQDDVWABR   MYYXVGAUXNIBD  
RVRLYRSPWXFKO   : TDINVEXUQXR     IVEAGTBFRYUSXXX ICPFEMXGBVMHL   SPFS            TBBTVIOCX       EOHHMRJ         SLFMHNDIG       DUWXTGAMRWA    
OIKXD           : TDINVEXUQXR    
GEKUJ           : UYCDN           KBGTDDONHK      VULCHSOPDLJP    WIBTMSXRFPWX    XGTLIBTEFCQV   
FUOPUG          : KRAJI           ABEFOPTTFCO     BPQPFMGAGQGYU   VMUKSWIPHMBI    UDKPPGTVOJKSN  
OTLGMDFKKPBTE   : BFUJV          
EDPRJVEGGNLD    : CPIDWNMGSDDTA   SXXSGUMDLJCO    VOJPVWVSQKHDFI  VGKY            BGTYLHJMTBW     DSKDULHACAVWFXL EDDPUKMCFGUCGK 
CAKQ            : DWNFHRCKPPNOYT  YMAOPVFFVUHRPH  JXPJHNTLNE     
EEXRHDETTIOX    : GVJUGCYIWUYAMV  YTFYXG          OYQRK           PEIBCURP        HMUVCAJNSKQVX   YCFR            RWFFFIKSVC     
UDKPPGTVOJKSN   : RGRTOIFMGN      CSUQHQEJKRLR    FUOPUG          EDDPUKMCFGUCGK 
UXFKFJI         : UESV            CRFLLGTSP       DCRQIYWDCOQVHXF WOEYPA          XTQF           
SLFMHNDIG       : OUIPOEGRFGGCKF  VTMCYIII        GKSHDXGA        OJMMWQIPCHAH    RVRLYRSPWXFKO  
LSQDAKCOUMJ     : HVHIXSWYRF      QEGNACCCBHILUB 
BFJIROT         : VRERPVEBUDIFCT 
NMNSBVHHGPI     : SRDDCCEMYAKW    PEGF            GDRCFP          QRLTGBYPLNBOCKO
JYXJJAAGOKRPP   : UGNHDOHUWWQV    YNVVCFVEHR      XTQF           
AHPTJF          : FRTOHOYWEUHG    EFTXWMIV        DWNFHRCKPPNOYT  ETIBKUSNO       YVVAWQYGHBEYWLL SHXJKYBDMLP    
YAJWHSDABXJAXU  : MNHDLONMVN      TDPUGJMUSPGGSTO ADPKEXIYXKLKWVD
XWSMHKEYN       : IEXWRJDQAFG     WQALMQNR        VWGVUTCDAKAI    PIOHO          
IFATKKTLVQUPUUQ : UBDI            VHST            TGVUL           YPOGLMEAHUIB   
GTSDIS          : DHTARL          JRAOK           LLVEIJQKOA      AYODBPORWHMIXA  WGKTJC         
DHKOLKERUKTPWE  : QFHKDHLIXEKJWH  LYQJMKXVTYAG    VYOLXLSEXDHEY   GIQRHFQJDJDGBAQ ARYXTHPVEMS    
ICCG            : DAPT            YIULKONTAEXBRRG BDNDI           MBNESEMUJ      
YDLTMHOPPHS     : KASCRTJ         BADFJQBPGE      VODONVRKNWKNW   KEVJPLCSDFH     LQUS            PDBIDJGV        XGGQAYJM       
OEJCQOVLYRB     : GVJUGCYIWUYAMV  MARRNDBHOUKHPYO LOTLFWRUK       XUVHJEBXKFOSM  
VMHBPPS         : MYQGEJVDDYMBEJE OLXX            EBCXALU        
SGLFNA          : BADFJQBPGE      TKDM           
DISW            : COKW           
WICPWAC         : ATGI           
SFWQSGRKV       : PEJCEHKHSS      KWRKQUKQV       OWLIKGIIHICP    GNRVQXYL       
YQTMYINWLXP     : WIXLYUBMKREASU  LDUQFJIDSGIIMD  WWUEKYJOG       QEKLEXYGJ      
YPTBFSEJT       : HVHIXSWYRF      ODDBBP          GOCOPN         
PSNKYIUWV       : MXSOIN          WOEYPA          PAGSSVWWGXT     JXPJHNTLNE     
NPJMXYLKWEWVTS  : EXQCSOCBCJ      UBDI            GFFITPTXGAPJHJ 
BOGLIDBBSNCBI   : TBNQAQD         NFDTGHRJSOTCC   VXYUEURBWUBKWL  GDRCFP         
WGONR           : DAPT            IYISC           VMFOCUMVGLHYNF 
LQPXPVXOPQQRFW  : NALDICRGMCYT    QPUQH           OELQCADASWCOXOV
PAGSSVWWGXT     : AIRXA           DNFCNANQQ       FLFADOFCDUJG    QPQWCE          PSNKYIUWV      
PHHTVXLTOIRFA   : MLBBSERAG       VGUAVSP         WHYOOULYRNCFWN  RWLSVDEJDSLRII  FSYS           
VTSSYJSHENDCKJA : VNAJTGM         QRNABWBLRFMG    OLBXDXIMOJEOOB  MYYXVGAUXNIBD  
YPOGLMEAHUIB    : SHTPQHYVW       FGBQE           IFATKKTLVQUPUUQ
KOVFIQETJMAAPCM : VUAYVLSOKSYCYIM MYYXVGAUXNIBD  
DTBUL           : THFSPN          JYEIJLWX        WWUEKYJOG      
JXPJHNTLNE      : OFPPIVDWRWDHWI  CAKQ            PSNKYIUWV      
MJKDOGPDHRUJ    : BADFJQBPGE      CBETFLIBSPBLEI  YFUJFV          XGTLIBTEFCQV   
WOBAMMLVMCFUP   : NJFK           
GFFITPTXGAPJHJ  : WMSKHNTNQXNATT  QPUQH           PXFQU           LTVRVYH         WIPHVULDXT      GDRCFP          NPJMXYLKWEWVTS  BUSQHXLVYS     
TPGIQGWFSSS     : IUAQ            IUYDJ           TOPD            DJHKIHWRKMRKL  
XNMYVRFE        : TNUSGGAEX       KKLKLCFBDIEC    ETDYOLDYBBT     VMUKSWIPHMBI   
WXMDBEOKN       : WOBDXQAX        SUAW           
EDDPUKMCFGUCGK  : KGXFQ           GVYD            OLBXDXIMOJEOOB  TQJVIEFH        EDPRJVEGGNLD    UDKPPGTVOJKSN  
IGINNWM         : WNREPPPPWLQMIL  OCKPQILJUPXYLLS MDHFJQHQAT      GITOULV        
JROPGCDDGJ      : OULTOHJWVKVAFF  LSTULYOSCFBJLI  LTCBWYQUMBBD   
XGTLIBTEFCQV    : CMSMKNKUJGRVKDX OSFOY           YCFR            GEKUJ           MJKDOGPDHRUJ   
XEAN            : VQCDUFYHOHHN    JEFVSMB         UYCDN          
MBNESEMUJ       : JUWKHQMQ        OPACNPG         IJLAQGMNFOQUDQI ICCG           
DSCC            : SHTPQHYVW       DWNFHRCKPPNOYT  PAWWUMOT        WRDGAFCGBI      DRNBHXAQOEDWGCE HKATA          
VNKYJQELHA      : VQVKBDXCLAVDK   BPQPFMGAGQGYU  
HEYUIMWY        : GOYYYAQUJMDC    CPIDWNMGSDDTA   UGNHDOHUWWQV    CNAKXBUJVMNN    HDXFVWYMXARIYWE LOYET           VGKNIHLPD      
PFGKQBP         : SNWVWAMYUMCEIF  VOJPVWVSQKHDFI 
DRNBHXAQOEDWGCE : YTFYXG          UBJLEYR         UCOT            CPGRSVMCMCWQT   BBSQBRNYO       DSCC           
BAVPYWJQE       : SGNDCHREKLXXXB  CVEMQCOCJKNBVIS
BUSQHXLVYS      : AGNFTIKTCI      TOPD            NFDTGHRJSOTCC   GFFITPTXGAPJHJ 
YKLFPKLTOXWQ    : OUIPOEGRFGGCKF  GUNHLSSIP       SEUGMTQLJ       NUFEQXXKOPK    
NRUYIYSLULFELQ  : QIAGYLUNKLWCOGC PITTMR         
KJWLVKSNUGHLEH  : IDRK            AMLNGNDGDN      DSXIWSLRVKGL   
DUWXTGAMRWA     : GNRVQXYL        RVRLYRSPWXFKO  
BLPEXCBLANEOI   : TDBJAWICJHXYKE  XGTHODHK        WXMY           
XTQF            : XGTHODHK        NKOXV           UXFKFJI         JYXJJAAGOKRPP  
VCWUXFUMWTMWU   : OMBBBVWURAKID   XIEOXNEF        IIWBKUT         PYEULX          VRERPVEBUDIFCT 
OYAQCLRPRIXEG   : KRJGDRUSSW      QPQWCE         
VOTRQSORXL      : FSPQN           YVVAWQYGHBEYWLL QIAGYLUNKLWCOGC
XFTW            : LWVSKCMDTLT     BRLWOOUHPBOSH   IIOLBNJYTD      IVVIEECEDN     
TLCWFHIWWDFX    : BADFJQBPGE      IUYDJ           PWNJLUWEPCDK   
NUFEQXXKOPK     : FNGTYWSIGM      YHPGVWOKQTUFUF  PUCPTASQWUQI    AYODBPORWHMIXA  TAXFCK          YKLFPKLTOXWQ    TKINJLKX       
TKINJLKX        : OILAP           WOEYPA          NUFEQXXKOPK    
HDVRAUUHUFWPK   : YCOCM           GIKS            ALOFPRLQ        UKCIXVOM       
HKATA           : UVAJHUKRJUOH    DSCC           
GBLTJCDVMD      : AHICPYUYEXWKWGL OWLIKGIIHICP    COKW            XMNUQ           TFYMPFITQRWH   
VGKNIHLPD       : FIVKD           HEYUIMWY       
