YYVASLWADPVGB   : NNEYJLRHFNJF    YNGYWHPYGFAYMI  VAUSSDLMHH      DVCETQRVGWX    
UDVUL           : WMNMRAYJBMF     RTOCGFOIEYHLCHB LUXKO           WPAVR           TJSVSNSIIA      CDCCTRBNMBTHDCM UPYDPXM         OIBUDAPYVDD    
NNEYJLRHFNJF    : YYVASLWADPVGB   RGIGCLRMUDQFDP  TESBUANWUKVICF  ICISBNE         ORCUWANQ        WRNII          
GFHTDIWUEFXW    : XDJSKMHYYYVNJ   LLNV            SURHUTUTL       OUWTRXH        
CUWN            : XDJSKMHYYYVNJ   WBBXYJYYP       RNRRVLVVKNRFNMO TABBKIMMYYULLV 
LBFKMQFUX       : RKOGQNJIIAMQF   CPQTTAYAFQBUNI  LLNV            LJAETIVORHOBGP  RWFDUQCJ       
EDIMLPIQAINHN   : CPQTTAYAFQBUNI  JLYAETGWYGLHUB  XRHAUKGL        FKOC            JVFMJV         
GQPBNDEBGJMVC   : BTYLULNANOXGO   CWUJ            MXKCAUYFWEAMSFM
QAMWGW          : OABQUXH         DCQMBQLAEXR     KMBBISFDJN      XLVBFHTDAHVL   
TNSMPBAWRN      : BLVHIKE         YEGXGSO        
IEGXJKASVOOAK   : DDCRJAKIG       MPEPJ           XFHRKBDIKX     
BWEJU           : UJMPTMYJGGNUSI  YMMJJWXMGP      EUSQ            CSQQLXTMBAJNE  
FKKRANTAFJFPN   : HMCUWWKRJD      FUWCJITAVJB     DGQGU          
OABQUXH         : QAMWGW          WMNMRAYJBMF     MSKR            PCWSJJYHBQEJO   GTBUFBILJC      CIIQWA         
XRSB            : SERJFAIWKY      ASFPI           EHFDFR          WPAVR           YKBROLWLDG      HAFSQIEGVATG   
WMNMRAYJBMF     : UDVUL           OABQUXH         AJUFD           IMAJPKJAJYG    
UPIKF           : GBBNNXPXDU      CLBIVR          SHUSDR         
BHYTCYBNYUGBMG  : WBXGXQCYMXQHIF  OKPI            TESBUANWUKVICF  BNOXJCGBE       JJWVON          RWFDUQCJ       
CSIDT           : JEQMHJ          RHYVOQ          JPQKNBFQT      
GGAJBRTMW       : MSKR            MFYXHYE         MXCCHVXLHDRAG   GBYDSPXRFOE    
PFSKJRNA        : RIJVBHJFASNG    UGQEAOGMNLJRHBA FKOC            TABBKIMMYYULLV 
JITXO           : NSSVK           KMBBISFDJN     
AJUFD           : WMNMRAYJBMF     DCQMBQLAEXR     JTKJH          
NKQWNIRCI       : JCVL            GBXLRLYK       
SNEDYXQY        : PLEK            ALYRNUL        
CILA            : RTOCGFOIEYHLCHB GSWBHWTJNVOFL   JLCHSA          GIAPCDSGPBUCDT 
XDJSKMHYYYVNJ   : GFHTDIWUEFXW    CUWN            BCPSGUUW        VHTUYNFHHMJJQ   WCNNMGSQHQSIE   XLVBFHTDAHVL   
PRDIHJ          : TEYFIJT         RQGSWESHWVMTOWD DLPVM           TPWGCEPPPOT     TWRVUDI         FGMWBLVUXBKG   
HHHIYJS         : RFBLLSXYVAH     TSBMQDIFUR      MPEPJ           SPREO           BPJABIXIJTN    
MSKR            : OABQUXH         GGAJBRTMW       FESLH           OLYNDCVUNMAG    KIXCWNJN       
DCQMBQLAEXR     : QAMWGW          AJUFD           AOUIVRNIPBPOGW  DLIU            TESBUANWUKVICF  PLEK           
PVFXHSFP        : XQHYCLFDDF      WRNII          
NQMJ            : BTKAH          
BCPSGUUW        : XDJSKMHYYYVNJ   UCLXNFYEHKJULJ  YPPLQF          AOFMYMSC        VUCHAXU         WPDNFOW         FGMWBLVUXBKG   
WPVYVTQSJOAHWSO : RKOGQNJIIAMQF   PAKAGGWJPWDY    CDCCTRBNMBTHDCM LGJTQAYXKTD     OOTPFCYNVJ     
XFFK            : JJWVON          NPPLDWXBM      
MLSCE           : XQRORAVGYLQYX   AGJFVKXERFH     PINQUAKEBNGYWDH MABPPGYQAJLPWPK
WBXGXQCYMXQHIF  : BHYTCYBNYUGBMG  KXXHPXJ         FIAAQNRWESYDUYN DLABUFJWFBKY    ALJACBDXO      
REBJSYOALFMYXO  : SFCFYCHYI      
YNGYWHPYGFAYMI  : YYVASLWADPVGB   ORCUWANQ       
UCLXNFYEHKJULJ  : BCPSGUUW        EHFDFR          OCIPJOF         CAWRVSXUHPUY    XCKMH           TFDSMRHBDCQXYWD HVMJYQIHT      
QKAWKYGCXN      : YAFTLQSKHHUJY  
AOUIVRNIPBPOGW  : DCQMBQLAEXR     RDUOGFJAHPCYYK  HVEWWSA         XWSIILT        
RTOCGFOIEYHLCHB : UDVUL           CILA            TWRVUDI        
IPISOAG         : QMLEV           NIVNTJG         ABSNSWYTXGGSKA 
RKOGQNJIIAMQF   : LBFKMQFUX       WPVYVTQSJOAHWSO RNRRVLVVKNRFNMO OUWTRXH         TDBW            IJQUSC         
YMDGAHNDT       : TFDSMRHBDCQXYWD
SERJFAIWKY      : XRSB            JKMLINVCX      
BPRMASBQADP     : PMEPENJALH      KNSEBADE       
JXOQNRMMNR      : KHVFAFXSNCMPGEU COWABDQA        QSIKQDOBCYCAIRY
WYGIXR          : PKRMRAWRM       EUEFWOCHWDCDT   HDYN            QHCHSWQQLWSVI  
GSWBHWTJNVOFL   : CILA            AUFKJDMJESW    
DARRUGGKAMHY    : GFBGT          
PAKAGGWJPWDY    : WPVYVTQSJOAHWSO XMIHIDIXLQFXCP  KUCKFDDKUNFRNE  MYFVBTRIBUIUDJ  IVGR            TIJQFFISDHVNMCE LXHPQFQ        
CQSNQ           : XWKJDMEFYLUC    PYFVFKQS        TABBKIMMYYULLV 
PKRMRAWRM       : WYGIXR          NIVNTJG         OAKQB           RXHSUDPQAP     
TGWVSYEYWOP     : BRESSD          SNYTSPWQB       MFYXHYE         LXHPQFQ         KCBCWICEJPLBH  
TQIVJDLBE       : PFLXCSBTERDKSP  PNXUWYTIWU      QBUTDGCJOVJ     XFHRKBDIKX      QSIKQDOBCYCAIRY
LXQFYOAL        : BNOXJCGBE       FIFOIJRL        CIIQWA         
VTURNUVOTKGRF   : NWGDMHD         QHCHSWQQLWSVI  
CDJIPM          : PINQUAKEBNGYWDH MRHNXEIPCGRLFX  TNTQHLILBJLPOAS MEUQLJAI       
TBKKIJBIXYET    : VQWDLRIGMHHDDY  UDCQJ           JYQIVJ          OUWTRXH         BYXQPQPCYRMFHX 
VHTUYNFHHMJJQ   : XDJSKMHYYYVNJ   JJWVON          BBWKILKTENS    
RGIGCLRMUDQFDP  : NNEYJLRHFNJF    WRNII           HVMJYQIHT      
XMIHIDIXLQFXCP  : PAKAGGWJPWDY    PFLXCSBTERDKSP  IJVT            RXAU            SKRUPAXFWCBA   
XJWJQYWKORPF    : UGCNASFAQNC     CVRSDBJCOUEH    YHROKRJLOIQMQR 
TWKRM           : EKQKQE          TPWGCEPPPOT     ABSNSWYTXGGSKA 
BUYKTKDYKFQC    : NWGDMHD         BPJABIXIJTN    
BBRTDOERHTYHPX  : BPBJHHKFWNTRMD  YHROKRJLOIQMQR  FYGBQLQOWEAQ    TGTCMMPODEAXHMB
JKMLINVCX       : SERJFAIWKY      UPRKSRJ         SLHITILNOE      YMMJJWXMGP     
DLIU            : DCQMBQLAEXR     GBXLRLYK       
OXQGRTVXNFT     : PNXUWYTIWU      SIEGND         
OKPI            : BHYTCYBNYUGBMG  QBHFNW          XWKJDMEFYLUC    MYFVBTRIBUIUDJ  DEGA           
AUFKJDMJESW     : GSWBHWTJNVOFL   FESLH           GJAFORSV        TCYBSQPC        XCKMH          
PMEPENJALH      : BPRMASBQADP     SWMSCOCXAXOL    ORCUWANQ        XAJVEGMGJCGYL  
QBHFNW          : OKPI            ARDIVQJRYLIO    WBBXYJYYP       NBIDBN         
IAKPKVTA        : PCWSJJYHBQEJO   KFGGRYAC        UPOUYMOJIRXF    KCBCWICEJPLBH   NBVWO          
ASFPI           : XRSB            NWSJWHEYXGYXG   WCNNMGSQHQSIE   HGAMOCQKDQ      NJTNRUGFN       NGMWTPIFI       CCDAIXQJFRISJ  
WXYKH           : RDUOGFJAHPCYYK  RATLLQAFAQGHG   IGOIMYLFEOAKEC 
XQRORAVGYLQYX   : MLSCE           NWSJWHEYXGYXG   UARP            VQWDLRIGMHHDDY  SKRUPAXFWCBA   
KUCKFDDKUNFRNE  : PAKAGGWJPWDY    NPPLDWXBM      
UGCNASFAQNC     : XJWJQYWKORPF    IATDSYKGPRDTO   VUCHAXU         RWUAWHVJB      
GBBNNXPXDU      : UPIKF           JHRDDELGXPOWGXO LLNV            RPCYDDEOQP     
NSSVK           : JITXO           CWUJ            SQPEPXJRV       PINQUAKEBNGYWDH VUCHAXU         IWINERVJD       DLABUFJWFBKY   
ARDIVQJRYLIO    : QBHFNW          SQPEPXJRV       KBLYHTG        
LVROLFMDGR      : HNXNEKUPQLAMBTX OAKQB          
JHRDDELGXPOWGXO : GBBNNXPXDU      KFGGRYAC        PPIJ            TGTCMMPODEAXHMB
MWWCKSTBEAPHGHI : ROCSWMESH       EUSQ           
PCWSJJYHBQEJO   : OABQUXH         IAKPKVTA        YPPLQF          OUWTRXH         OAKQB          
RDUOGFJAHPCYYK  : AOUIVRNIPBPOGW  WXYKH           YPPLQF          CRGHNOFWD       TWRVUDI         IJQUSC         
IDWMCRVNTG      : FGLOHUD         THYCAXJVGBSBU   RWUAWHVJB       FYGBQLQOWEAQ   
KMBBISFDJN      : QAMWGW          JITXO           BATKELDXHEYH    RWUAWHVJB      
UPRKSRJ         : JKMLINVCX       YIQBEUSIHNALK   FESLH           YLASRUTEBJX     YEGXGSO        
BTKAH           : NQMJ            XHSTKRUH        UQACNMFBEPYMXHN TWRVUDI         AFYYLYVEY       FIFOIJRL        JAVVWTVX        EFFUMWEAYKCUD  
BTKAH           : GFBGT          
RFBLLSXYVAH     : HHHIYJS         TCYBSQPC        HNXNEKUPQLAMBTX TGTCMMPODEAXHMB
HMCUWWKRJD      : FKKRANTAFJFPN   PFLXCSBTERDKSP  AOXNJJS        
UJMPTMYJGGNUSI  : BWEJU           NAYCRVOS        LCBE            ABSNSWYTXGGSKA 
TESBUANWUKVICF  : NNEYJLRHFNJF    BHYTCYBNYUGBMG  DCQMBQLAEXR     PNXUWYTIWU      CXALYT          AMPRNKWCOLNSJA 
NAYCRVOS        : UJMPTMYJGGNUSI  VAUSSDLMHH      SHUSDR          GDASLJSIS      
VAUSSDLMHH      : YYVASLWADPVGB   NAYCRVOS        PYFVFKQS        XFHRKBDIKX      CXALYT          JAHW            CIPU           
EHFDFR          : XRSB            UCLXNFYEHKJULJ  SNYTSPWQB       UOPMTFNJQR      DVCETQRVGWX     TCYBSQPC        MHYDRIWG       
NWGDMHD         : VTURNUVOTKGRF   BUYKTKDYKFQC    JYQIVJ          YYTMDOFQXHY     RWFDUQCJ       
BYGUG           : PNXUWYTIWU      GFBGT          
UCWPF           : DVCETQRVGWX     YAFTLQSKHHUJY   CIIQWA         
CPQTTAYAFQBUNI  : LBFKMQFUX       EDIMLPIQAINHN   GJAFORSV        KMOQPTMJUBVY    BPJABIXIJTN     SKRUPAXFWCBA   
BRESSD          : TGWVSYEYWOP     YPPLQF          LHRGIWFMYSIHF   GICYL           IVGR           
PLEK            : SNEDYXQY        DCQMBQLAEXR     THYCAXJVGBSBU   YBQVRWMLGLGA    KFGGRYAC        XMEV           
BATKELDXHEYH    : KMBBISFDJN      DISDDKY         MPARYFUJB       KMOQPTMJUBVY    FDVSMDPYFQTSK  
SLHITILNOE      : JKMLINVCX       LLNV            SIBJCDCBVPAR    HBCPOLLRIP      AFYYLYVEY      
TEYFIJT         : PRDIHJ          GICYL           FYGBQLQOWEAQ   
MPWQBARKEQSSJG  : WPAVR           BXKNOFM         RBHS            SIEGND          FEATNCXUYWXFX  
SAMEPBLXUPWC    : OCIPJOF        
JVLVNIMQLGC     : UOPMTFNJQR     
XWKJDMEFYLUC    : CQSNQ           OKPI            RJVFGFYOG       MHYDRIWG       
SWMSCOCXAXOL    : PMEPENJALH      CCRD            YIQBEUSIHNALK   NSJYJMMXKSPDMXP RHYVOQ         
FYTJQTGEDLSKSU  : IATDSYKGPRDTO   PNXUWYTIWU      BVTSQQ         
NWSJWHEYXGYXG   : ASFPI           XQRORAVGYLQYX   JEQMHJ          GFKHEU         
LUXKO           : UDVUL           DBPCG           JEQMHJ         
EKQKQE          : TWKRM           JEQMHJ         
BXAYLAT         : FGPBI           DRUTURNVWDKEE   GFKHEU         
WBBXYJYYP       : CUWN            QBHFNW          IATDSYKGPRDTO  
LLNV            : GFHTDIWUEFXW    LBFKMQFUX       GBBNNXPXDU      SLHITILNOE      QHYJPRYD        BYXQPQPCYRMFHX 
WCNNMGSQHQSIE   : XDJSKMHYYYVNJ   ASFPI           FSBMSGKOV       FESLH           MAYXKFRKL      
CCRD            : SWMSCOCXAXOL    WPAVR           DISDDKY         GFKHEU         
PEPRFHJQ        : BBWKILKTENS     CSQQLXTMBAJNE   QQHWY          
WPAVR           : UDVUL           XRSB            MPWQBARKEQSSJG  CCRD           
KHVFAFXSNCMPGEU : JXOQNRMMNR      JYQIVJ         
WBGOGN          : AOFMYMSC        BPBJHHKFWNTRMD  NIVNTJG        
ALYRNUL         : SNEDYXQY        ROCSWMESH       GICYL           BVJKYEPC       
FSBMSGKOV       : WCNNMGSQHQSIE   MXKCAUYFWEAMSFM AFYYLYVEY      
BLVHIKE         : TNSMPBAWRN      NSJYJMMXKSPDMXP AGJFVKXERFH     RWUAWHVJB       DGQGU           LUMWD          
SURHUTUTL       : GFHTDIWUEFXW    JNXMLAQGSJ      TNTQHLILBJLPOAS
PANWSOM         : ECRDNVUG       
UWDSMGELNO      : NGMWTPIFI      
UARP            : XQRORAVGYLQYX   ORCUWANQ        AMPRNKWCOLNSJA  HVMJYQIHT       QHCHSWQQLWSVI   FHHIAOMHKJYB   
BNOXJCGBE       : BHYTCYBNYUGBMG  LXQFYOAL        BXKNOFM         QSIKQDOBCYCAIRY
BXKNOFM         : MPWQBARKEQSSJG  BNOXJCGBE       IATDSYKGPRDTO   NJTNRUGFN       JAHW           
ACAGNNUNIWFBQI  : GJAFORSV        TKTPNC          FUWCJITAVJB     MFPPDIOLBLQSCQ 
HGAMOCQKDQ      : ASFPI           YLASRUTEBJX     SMHNRLHBTFCM    FIAAQNRWESYDUYN AFIAOUETDNEHP   BYXQPQPCYRMFHX 
SFCFYCHYI       : REBJSYOALFMYXO  QHCHSWQQLWSVI  
PFLXCSBTERDKSP  : TQIVJDLBE       XMIHIDIXLQFXCP  HMCUWWKRJD     
WJMCAK          : ORCUWANQ        JYQIVJ          DBPCG           ICYWXQEBP      
IMAJPKJAJYG     : WMNMRAYJBMF     YBQVRWMLGLGA   
YIQBEUSIHNALK   : UPRKSRJ         SWMSCOCXAXOL    UOPMTFNJQR      SHUSDR          HKDU            PIGRS          
YMMJJWXMGP      : BWEJU           JKMLINVCX       FGPBI           TWRVUDI        
RQGSWESHWVMTOWD : PRDIHJ          GTBUFBILJC     
YPPLQF          : BCPSGUUW        PCWSJJYHBQEJO   RDUOGFJAHPCYYK  BRESSD          FEATNCXUYWXFX  
COWABDQA        : JXOQNRMMNR      EUEFWOCHWDCDT   IWINERVJD       JAHW           
JJQIPJ          : THYCAXJVGBSBU   JTKJH           OLTBKBW        
MFEIWDLEFB      : RJVFGFYOG      
QTBQ            : UTFQLQYHTWNUF   VQWDLRIGMHHDDY  XCKMH           GUYGFGXP       
SNYTSPWQB       : TGWVSYEYWOP     EHFDFR          NIVNTJG         DRUTURNVWDKEE  
IJVT            : XMIHIDIXLQFXCP  OPWTR          
ICISBNE         : NNEYJLRHFNJF    HBCPOLLRIP      GOTIYST        
SIBJCDCBVPAR    : SLHITILNOE      OPWTR           RJVFGFYOG       WMDO           
ROCSWMESH       : MWWCKSTBEAPHGHI ALYRNUL         HBCPOLLRIP      HVMJYQIHT       YDCTQ           CIIQWA          QQHWY          
DLPVM           : PRDIHJ          RNRRVLVVKNRFNMO VKHYTGOLI       UDCQJ          
BTYLULNANOXGO   : GQPBNDEBGJMVC   ABSNSWYTXGGSKA 
RIJVBHJFASNG    : PFSKJRNA        AGJFVKXERFH     QMLEV           UPOUYMOJIRXF    FGMWBLVUXBKG   
FESLH           : MSKR            AUFKJDMJESW     UPRKSRJ         WCNNMGSQHQSIE   OLYNDCVUNMAG   
NSJYJMMXKSPDMXP : SWMSCOCXAXOL    BLVHIKE         YAFTLQSKHHUJY  
CWUJ            : GQPBNDEBGJMVC   NSSVK           GJAFORSV        WPDNFOW        
PYFVFKQS        : CQSNQ           VAUSSDLMHH      JLYAETGWYGLHUB  QSIKQDOBCYCAIRY PIGRS          
FGLOHUD         : IDWMCRVNTG      KMOQPTMJUBVY    BOENBTCT        MEUQLJAI       
UOPMTFNJQR      : EHFDFR          JVLVNIMQLGC     YIQBEUSIHNALK   CAWRVSXUHPUY    FGPBI          
NBIDBN          : QBHFNW          VBQXLYEKAVP     KCBCWICEJPLBH  
IATDSYKGPRDTO   : UGCNASFAQNC     FYTJQTGEDLSKSU  WBBXYJYYP       BXKNOFM         RPCYDDEOQP      UDCQJ          
KHPGMFSFWBSAJXD : EUEFWOCHWDCDT   VUCHAXU         CXALYT         
YLASRUTEBJX     : UPRKSRJ         HGAMOCQKDQ     
FNHPW           : BBWKILKTENS     LXIWMUBTQQFPH  
WLCPQBQJBDH     : AOFMYMSC        LGJTQAYXKTD     JAVVWTVX        NNSQLOK         QMUWGTT        
DISDDKY         : BATKELDXHEYH    CCRD            XCKMH           PIGRS          
OCIPJOF         : UCLXNFYEHKJULJ  SAMEPBLXUPWC    AEEWVBDYIVQX    RXHSUDPQAP     
ECRDNVUG        : PANWSOM         VKHYTGOLI       PQFTWPCJTYNFY   UPOUYMOJIRXF   
MPARYFUJB       : BATKELDXHEYH    UCHWPFUUO       SMHNRLHBTFCM    EUSQ            XMEV            QHCHSWQQLWSVI  
OLYNDCVUNMAG    : MSKR            FESLH           GOTIYST         MXCCHVXLHDRAG   GGCONGUINWJNPBE
CAWRVSXUHPUY    : UCLXNFYEHKJULJ  UOPMTFNJQR      RHYVOQ         
DVCETQRVGWX     : YYVASLWADPVGB   EHFDFR          UCWPF           UTFQLQYHTWNUF  
RNRRVLVVKNRFNMO : CUWN            RKOGQNJIIAMQF   DLPVM           DBPCG          
JNXMLAQGSJ      : SURHUTUTL       YSOJSTC         RWUAWHVJB       RXHSUDPQAP      XWSIILT        
YIEGBRXSNLRJVH  : THYCAXJVGBSBU   UDCQJ           RHYVOQ         
CVRSDBJCOUEH    : XJWJQYWKORPF    ORCUWANQ        NJTNRUGFN       WMDO           
XQHYCLFDDF      : PVFXHSFP        CDCCTRBNMBTHDCM GBYDSPXRFOE     DGQGU          
SQPEPXJRV       : NSSVK           ARDIVQJRYLIO    ULPAMAYDKGXUY   CIIQWA         
MYFVBTRIBUIUDJ  : PAKAGGWJPWDY    OKPI            CXALYT         
ORCUWANQ        : NNEYJLRHFNJF    YNGYWHPYGFAYMI  PMEPENJALH      UARP            WJMCAK          CVRSDBJCOUEH    KFGGRYAC        TKTPNC         
ORCUWANQ        : AOXNJJS         DEGA           
UGQEAOGMNLJRHBA : PFSKJRNA        GJAFORSV        GOTIYST        
VKHYTGOLI       : DLPVM           ECRDNVUG        KDGODMVHEJNYTDX
JLYAETGWYGLHUB  : EDIMLPIQAINHN   PYFVFKQS        OPWTR           KNSEBADE        LXIWMUBTQQFPH   XWSIILT        
EUEFWOCHWDCDT   : WYGIXR          COWABDQA        KHPGMFSFWBSAJXD RBHS            DBPCG          
MFYXHYE         : GGAJBRTMW       TGWVSYEYWOP     DDCRJAKIG       JCVL            OFSCOPOQWMG    
HBCPOLLRIP      : SLHITILNOE      ICISBNE         ROCSWMESH       UPYDPXM         UQACNMFBEPYMXHN
MXKCAUYFWEAMSFM : GQPBNDEBGJMVC   FSBMSGKOV       UDCQJ           SPREO          
MNWQVAU         : RPCYDDEOQP     
QHYJPRYD        : LLNV            RBHS            TJSVSNSIIA     
LHRGIWFMYSIHF   : BRESSD          DDCRJAKIG       FEATNCXUYWXFX   TIJQFFISDHVNMCE CIPU            IGOIMYLFEOAKEC 
TSBMQDIFUR      : HHHIYJS         CLBIVR          JLCHSA         
GJAFORSV        : AUFKJDMJESW     CPQTTAYAFQBUNI  ACAGNNUNIWFBQI  CWUJ            UGQEAOGMNLJRHBA QSIKQDOBCYCAIRY
AGJFVKXERFH     : MLSCE           BLVHIKE         RIJVBHJFASNG   
YKBROLWLDG      : XRSB            GOTIYST         DLABUFJWFBKY   
PIYEBRDMTLXCH   : HVEWWSA         ABSNSWYTXGGSKA 
CLBIVR          : UPIKF           TSBMQDIFUR      QMLEV           KFGGRYAC        BLPMVNICP       AFYYLYVEY       YYUJAMUCQDCBMXO
GTBUFBILJC      : OABQUXH         RQGSWESHWVMTOWD NJTNRUGFN       GGCONGUINWJNPBE
RBHS            : MPWQBARKEQSSJG  EUEFWOCHWDCDT   QHYJPRYD        REEVNFJ         MFPPDIOLBLQSCQ 
MGRYGTGP        : BOENBTCT       
UTFQLQYHTWNUF   : QTBQ            DVCETQRVGWX    
GICYL           : BRESSD          TEYFIJT         ALYRNUL         JEQMHJ          RXAU           
THYCAXJVGBSBU   : IDWMCRVNTG      PLEK            JJQIPJ          YIEGBRXSNLRJVH  RPCYDDEOQP      KHUY           
TJSVSNSIIA      : UDVUL           QHYJPRYD        YEGXGSO        
PINQUAKEBNGYWDH : MLSCE           CDJIPM          NSSVK           UCHWPFUUO       MPEPJ           VORDYOICAKAQFY 
XLVBFHTDAHVL    : QAMWGW          XDJSKMHYYYVNJ   OMKBO           HDYN            ABSNSWYTXGGSKA 
WUKHLBELLJO     : KHUY           
PNXUWYTIWU      : TQIVJDLBE       OXQGRTVXNFT     TESBUANWUKVICF  BYGUG           FYTJQTGEDLSKSU  MPEPJ           LJAETIVORHOBGP 
GOTIYST         : ICISBNE         OLYNDCVUNMAG    UGQEAOGMNLJRHBA YKBROLWLDG      VQDNVJL         QSIKQDOBCYCAIRY XMEV            GVMCF          
RPCYDDEOQP      : GBBNNXPXDU      IATDSYKGPRDTO   MNWQVAU         THYCAXJVGBSBU   YEGXGSO         FIAAQNRWESYDUYN
SHUSDR          : UPIKF           NAYCRVOS        YIQBEUSIHNALK   UTSLCBVBH       FHHIAOMHKJYB   
YBQVRWMLGLGA    : PLEK            IMAJPKJAJYG     VBQXLYEKAVP     IWINERVJD       JLCHSA         
XRHAUKGL        : EDIMLPIQAINHN  
VQWDLRIGMHHDDY  : TBKKIJBIXYET    XQRORAVGYLQYX   QTBQ            EFFUMWEAYKCUD   GVMCF          
QMLEV           : IPISOAG         RIJVBHJFASNG    CLBIVR          YEGXGSO        
IVGR            : PAKAGGWJPWDY    BRESSD          LXHPQFQ        
DDCRJAKIG       : IEGXJKASVOOAK   MFYXHYE         LHRGIWFMYSIHF   WRNII           PQFTWPCJTYNFY   FIAAQNRWESYDUYN
AOFMYMSC        : BCPSGUUW        WBGOGN          WLCPQBQJBDH     YHROKRJLOIQMQR 
VUCHAXU         : BCPSGUUW        UGCNASFAQNC     NSSVK           KHPGMFSFWBSAJXD LUMWD          
UDCQJ           : TBKKIJBIXYET    DLPVM           IATDSYKGPRDTO   YIEGBRXSNLRJVH  MXKCAUYFWEAMSFM LJAETIVORHOBGP 
VBQXLYEKAVP     : NBIDBN          YBQVRWMLGLGA    TNTQHLILBJLPOAS CCDAIXQJFRISJ   LUMWD           YDCTQ          
UCHWPFUUO       : MPARYFUJB       PINQUAKEBNGYWDH KIXCWNJN        XMEV            JLCHSA         
SMHNRLHBTFCM    : HGAMOCQKDQ      MPARYFUJB      
OMKBO           : XLVBFHTDAHVL   
RFBVNAOUWJ      : LXIWMUBTQQFPH  
TCYBSQPC        : AUFKJDMJESW     RFBLLSXYVAH     EHFDFR          TDBW           
JJWVON          : BHYTCYBNYUGBMG  XFFK            VHTUYNFHHMJJQ  
BPBJHHKFWNTRMD  : BBRTDOERHTYHPX  WBGOGN          CCDAIXQJFRISJ   TOXOB          
HIFK            : BOENBTCT        DGQGU           FIFOIJRL        GFKHEU         
YAFTLQSKHHUJY   : QKAWKYGCXN      UCWPF           NSJYJMMXKSPDMXP AMPRNKWCOLNSJA  ULPAMAYDKGXUY   GFBGT          
SIEGND          : OXQGRTVXNFT     MPWQBARKEQSSJG  GAJVMTOGGINW    OUWTRXH        
IWINERVJD       : NSSVK           COWABDQA        YBQVRWMLGLGA    TKTPNC          JPQKNBFQT       JAHW           
KFGGRYAC        : IAKPKVTA        JHRDDELGXPOWGXO PLEK            ORCUWANQ        CLBIVR         
JYQIVJ          : TBKKIJBIXYET    NWGDMHD         KHVFAFXSNCMPGEU WJMCAK          WPDNFOW         JPQKNBFQT      
CRGHNOFWD       : RDUOGFJAHPCYYK 
QBUTDGCJOVJ     : TQIVJDLBE       XHSTKRUH        LXIWMUBTQQFPH   XWSIILT        
XSAYJKXUDCNK    : NIVNTJG        
DBPCG           : LUXKO           WJMCAK          RNRRVLVVKNRFNMO EUEFWOCHWDCDT   HDYN            SPREO           HVMJYQIHT      
TKTPNC          : ACAGNNUNIWFBQI  ORCUWANQ        IWINERVJD       HKDU           
WRNII           : NNEYJLRHFNJF    PVFXHSFP        RGIGCLRMUDQFDP  DDCRJAKIG       XMEV            FHHIAOMHKJYB   
BLPMVNICP       : CLBIVR          AOXNJJS        
MABPPGYQAJLPWPK : MLSCE          
HAFSQIEGVATG    : XRSB            XFHRKBDIKX      NGMWTPIFI       RXAU           
JEQMHJ          : CSIDT           NWSJWHEYXGYXG   LUXKO           EKQKQE          GICYL           CXALYT          FDVSMDPYFQTSK  
NIVNTJG         : IPISOAG         PKRMRAWRM       WBGOGN          SNYTSPWQB       XSAYJKXUDCNK    JBRIRVSLWGSVEPN OIBUDAPYVDD    
YSOJSTC         : JNXMLAQGSJ      JCVL            JVFMJV         
FGPBI           : BXAYLAT         YMMJJWXMGP      UOPMTFNJQR     
HNXNEKUPQLAMBTX : LVROLFMDGR      RFBLLSXYVAH     NNSQLOK         NBVWO           GIAPCDSGPBUCDT 
MXCCHVXLHDRAG   : GGAJBRTMW       OLYNDCVUNMAG   
NPPLDWXBM       : XFFK            KUCKFDDKUNFRNE  MPEPJ          
MPEPJ           : IEGXJKASVOOAK   HHHIYJS         PINQUAKEBNGYWDH PNXUWYTIWU      NPPLDWXBM      
AWDC            : KHUY           
MAYXKFRKL       : WCNNMGSQHQSIE   BVTSQQ          FJKECWJRXOJSJVO
XCKMH           : UCLXNFYEHKJULJ  AUFKJDMJESW     QTBQ            DISDDKY        
KIXCWNJN        : MSKR            UCHWPFUUO       PQFTWPCJTYNFY   YEGXGSO         NBVWO          
OPWTR           : IJVT            SIBJCDCBVPAR    JLYAETGWYGLHUB  BPJABIXIJTN    
GUYGFGXP        : QTBQ            OFSCOPOQWMG    
TPWGCEPPPOT     : PRDIHJ          TWKRM           RWUAWHVJB      
CDCCTRBNMBTHDCM : UDVUL           WPVYVTQSJOAHWSO XQHYCLFDDF      RHYVOQ         
AEEWVBDYIVQX    : OCIPJOF         TFDSMRHBDCQXYWD
KMOQPTMJUBVY    : CPQTTAYAFQBUNI  BATKELDXHEYH    FGLOHUD         FEATNCXUYWXFX   WMDO           
FEATNCXUYWXFX   : MPWQBARKEQSSJG  YPPLQF          LHRGIWFMYSIHF   KMOQPTMJUBVY   
BOENBTCT        : FGLOHUD         MGRYGTGP        HIFK            PYBYNSJ         XAJVEGMGJCGYL   LCBE           
XHSTKRUH        : BTKAH           QBUTDGCJOVJ     CSQQLXTMBAJNE  
YHROKRJLOIQMQR  : XJWJQYWKORPF    BBRTDOERHTYHPX  AOFMYMSC        GFBGT          
XFHRKBDIKX      : IEGXJKASVOOAK   TQIVJDLBE       VAUSSDLMHH      HAFSQIEGVATG    RWUAWHVJB      
UPYDPXM         : UDVUL           HBCPOLLRIP      KDGODMVHEJNYTDX
PYBYNSJ         : BOENBTCT       
HDYN            : WYGIXR          XLVBFHTDAHVL    DBPCG           LGJTQAYXKTD    
EUSQ            : BWEJU           MWWCKSTBEAPHGHI MPARYFUJB       PIGRS          
XAJVEGMGJCGYL   : PMEPENJALH      BOENBTCT        MHYDRIWG       
AOXNJJS         : HMCUWWKRJD      ORCUWANQ        BLPMVNICP       QMUWGTT         OFSCOPOQWMG    
MRHNXEIPCGRLFX  : CDJIPM         
REEVNFJ         : RBHS            LGJTQAYXKTD    
GAJVMTOGGINW    : SIEGND          JCVL            GLCKAC         
RHYVOQ          : CSIDT           SWMSCOCXAXOL    CAWRVSXUHPUY    YIEGBRXSNLRJVH  CDCCTRBNMBTHDCM
VQDNVJL         : GOTIYST        
RWUAWHVJB       : UGCNASFAQNC     IDWMCRVNTG      KMBBISFDJN      BLVHIKE         JNXMLAQGSJ      TPWGCEPPPOT     XFHRKBDIKX      TOXOB          
RJVFGFYOG       : XWKJDMEFYLUC    MFEIWDLEFB      SIBJCDCBVPAR   
FYGBQLQOWEAQ    : BBRTDOERHTYHPX  IDWMCRVNTG      TEYFIJT         RATLLQAFAQGHG   IJQUSC         
UQACNMFBEPYMXHN : BTKAH           HBCPOLLRIP      FGMWBLVUXBKG    TABBKIMMYYULLV 
NJTNRUGFN       : ASFPI           BXKNOFM         CVRSDBJCOUEH    GTBUFBILJC     
DRUTURNVWDKEE   : BXAYLAT         SNYTSPWQB       TFDSMRHBDCQXYWD XWSIILT         GVMCF          
TFDSMRHBDCQXYWD : UCLXNFYEHKJULJ  YMDGAHNDT       AEEWVBDYIVQX    DRUTURNVWDKEE   MHYDRIWG        QMUWGTT         GFKHEU         
TIJQFFISDHVNMCE : PAKAGGWJPWDY    LHRGIWFMYSIHF   AFIAOUETDNEHP  
HKDU            : YIQBEUSIHNALK   TKTPNC         
LXHPQFQ         : PAKAGGWJPWDY    TGWVSYEYWOP     IVGR            DLABUFJWFBKY    MFPPDIOLBLQSCQ 
LGJTQAYXKTD     : WPVYVTQSJOAHWSO WLCPQBQJBDH     HDYN            REEVNFJ        
PQFTWPCJTYNFY   : ECRDNVUG        DDCRJAKIG       KIXCWNJN        AMPRNKWCOLNSJA  BPJABIXIJTN     OFSCOPOQWMG    
WPDNFOW         : BCPSGUUW        CWUJ            JYQIVJ          FKOC           
JPQKNBFQT       : CSIDT           IWINERVJD       JYQIVJ          EFFUMWEAYKCUD  
JBRIRVSLWGSVEPN : NIVNTJG         OIBUDAPYVDD     RATLLQAFAQGHG  
FUWCJITAVJB     : FKKRANTAFJFPN   ACAGNNUNIWFBQI  UPOUYMOJIRXF   
CXALYT          : TESBUANWUKVICF  VAUSSDLMHH      KHPGMFSFWBSAJXD MYFVBTRIBUIUDJ  JEQMHJ         
SPREO           : HHHIYJS         MXKCAUYFWEAMSFM DBPCG          
WMDO            : SIBJCDCBVPAR    CVRSDBJCOUEH    KMOQPTMJUBVY    GIAPCDSGPBUCDT 
NUWMYIXTITDMWGM : TOXOB          
TNTQHLILBJLPOAS : CDJIPM          SURHUTUTL       VBQXLYEKAVP     BVJKYEPC        RXAU           
UPOUYMOJIRXF    : IAKPKVTA        RIJVBHJFASNG    ECRDNVUG        FUWCJITAVJB     GBYDSPXRFOE     CSQQLXTMBAJNE   KDGODMVHEJNYTDX
KHUY            : THYCAXJVGBSBU   WUKHLBELLJO     AWDC            YEGXGSO        
NGMWTPIFI       : ASFPI           UWDSMGELNO      HAFSQIEGVATG    CIPU            GDASLJSIS      
GBYDSPXRFOE     : GGAJBRTMW       XQHYCLFDDF      UPOUYMOJIRXF    YDCTQ           GGCONGUINWJNPBE
JCVL            : NKQWNIRCI       MFYXHYE         YSOJSTC         GAJVMTOGGINW   
DGQGU           : FKKRANTAFJFPN   BLVHIKE         XQHYCLFDDF      HIFK            FJKECWJRXOJSJVO AFIAOUETDNEHP  
UTSLCBVBH       : SHUSDR         
AMPRNKWCOLNSJA  : TESBUANWUKVICF  UARP            YAFTLQSKHHUJY   PQFTWPCJTYNFY  
OIBUDAPYVDD     : UDVUL           NIVNTJG         JBRIRVSLWGSVEPN JAHW           
YEGXGSO         : TNSMPBAWRN      UPRKSRJ         TJSVSNSIIA      RPCYDDEOQP      QMLEV           KIXCWNJN        KHUY           
GBXLRLYK        : NKQWNIRCI       DLIU            KNSEBADE       
BVJKYEPC        : ALYRNUL         TNTQHLILBJLPOAS
RXAU            : XMIHIDIXLQFXCP  GICYL           HAFSQIEGVATG    TNTQHLILBJLPOAS
CCDAIXQJFRISJ   : ASFPI           VBQXLYEKAVP     BPBJHHKFWNTRMD  FHHIAOMHKJYB    GLCKAC         
TWRVUDI         : PRDIHJ          RTOCGFOIEYHLCHB RDUOGFJAHPCYYK  BTKAH           YMMJJWXMGP     
KXXHPXJ         : WBXGXQCYMXQHIF  FIFOIJRL        FKOC            MFPPDIOLBLQSCQ 
ULPAMAYDKGXUY   : SQPEPXJRV       YAFTLQSKHHUJY   LXIWMUBTQQFPH  
QSIKQDOBCYCAIRY : JXOQNRMMNR      TQIVJDLBE       BNOXJCGBE       PYFVFKQS        GJAFORSV        GOTIYST         BBWKILKTENS    
HVEWWSA         : AOUIVRNIPBPOGW  PIYEBRDMTLXCH   OAKQB          
XMEV            : PLEK            MPARYFUJB       GOTIYST         UCHWPFUUO       WRNII          
FIAAQNRWESYDUYN : WBXGXQCYMXQHIF  HGAMOCQKDQ      RPCYDDEOQP      DDCRJAKIG       MFPPDIOLBLQSCQ 
AFYYLYVEY       : BTKAH           SLHITILNOE      FSBMSGKOV       CLBIVR          KCBCWICEJPLBH   LREKXXFMSERX   
DLABUFJWFBKY    : WBXGXQCYMXQHIF  NSSVK           YKBROLWLDG      LXHPQFQ         KNSEBADE        TGTCMMPODEAXHMB
OUWTRXH         : GFHTDIWUEFXW    RKOGQNJIIAMQF   TBKKIJBIXYET    PCWSJJYHBQEJO   SIEGND          RWFDUQCJ       
BPJABIXIJTN     : HHHIYJS         BUYKTKDYKFQC    CPQTTAYAFQBUNI  OPWTR           PQFTWPCJTYNFY  
VORDYOICAKAQFY  : PINQUAKEBNGYWDH
YYUJAMUCQDCBMXO : CLBIVR          MEUQLJAI       
TDBW            : RKOGQNJIIAMQF   TCYBSQPC        FGMWBLVUXBKG   
PIGRS           : YIQBEUSIHNALK   PYFVFKQS        DISDDKY         EUSQ            CSQQLXTMBAJNE   JVFMJV          NBVWO           IGOIMYLFEOAKEC 
JAHW            : VAUSSDLMHH      BXKNOFM         COWABDQA        IWINERVJD       OIBUDAPYVDD     RXHSUDPQAP      TGTCMMPODEAXHMB
JTKJH           : AJUFD           JJQIPJ         
OAKQB           : PKRMRAWRM       LVROLFMDGR      PCWSJJYHBQEJO   HVEWWSA         FGMWBLVUXBKG   
PPIJ            : JHRDDELGXPOWGXO SLATURGTWUDVD   GDASLJSIS      
LJAETIVORHOBGP  : LBFKMQFUX       PNXUWYTIWU      UDCQJ          
BBWKILKTENS     : VHTUYNFHHMJJQ   PEPRFHJQ        FNHPW           QSIKQDOBCYCAIRY GLCKAC         
DEGA            : OKPI            ORCUWANQ        AFIAOUETDNEHP  
RATLLQAFAQGHG   : WXYKH           FYGBQLQOWEAQ    JBRIRVSLWGSVEPN
IJQUSC          : RKOGQNJIIAMQF   RDUOGFJAHPCYYK  FYGBQLQOWEAQ   
OGUH            : GIAPCDSGPBUCDT 
ALJACBDXO       : WBXGXQCYMXQHIF 
OOTPFCYNVJ      : WPVYVTQSJOAHWSO AFIAOUETDNEHP  
MEUQLJAI        : CDJIPM          FGLOHUD         YYUJAMUCQDCBMXO
FIFOIJRL        : LXQFYOAL        BTKAH           HIFK            KXXHPXJ         JVFMJV         
ICYWXQEBP       : WJMCAK          FJKECWJRXOJSJVO
YYTMDOFQXHY     : NWGDMHD         NQJRRUHXH      
MHYDRIWG        : EHFDFR          XWKJDMEFYLUC    XAJVEGMGJCGYL   TFDSMRHBDCQXYWD
FKOC            : EDIMLPIQAINHN   PFSKJRNA        WPDNFOW         KXXHPXJ         LREKXXFMSERX   
FGMWBLVUXBKG    : PRDIHJ          BCPSGUUW        RIJVBHJFASNG    UQACNMFBEPYMXHN TDBW            OAKQB           GGCONGUINWJNPBE
KNSEBADE        : BPRMASBQADP     JLYAETGWYGLHUB  GBXLRLYK        DLABUFJWFBKY   
LCBE            : UJMPTMYJGGNUSI  BOENBTCT        NBVWO          
LUMWD           : BLVHIKE         VUCHAXU         VBQXLYEKAVP     EFFUMWEAYKCUD  
JAVVWTVX        : BTKAH           WLCPQBQJBDH     KBLYHTG        
CSQQLXTMBAJNE   : BWEJU           PEPRFHJQ        XHSTKRUH        UPOUYMOJIRXF    PIGRS           SKRUPAXFWCBA   
TOXOB           : BPBJHHKFWNTRMD  RWUAWHVJB       NUWMYIXTITDMWGM
RXHSUDPQAP      : PKRMRAWRM       OCIPJOF         JNXMLAQGSJ      JAHW           
CIPU            : VAUSSDLMHH      LHRGIWFMYSIHF   NGMWTPIFI       LXIWMUBTQQFPH  
NQJRRUHXH       : YYTMDOFQXHY    
MFPPDIOLBLQSCQ  : ACAGNNUNIWFBQI  RBHS            LXHPQFQ         KXXHPXJ         FIAAQNRWESYDUYN
BVTSQQ          : FYTJQTGEDLSKSU  MAYXKFRKL      
KCBCWICEJPLBH   : TGWVSYEYWOP     IAKPKVTA        NBIDBN          AFYYLYVEY      
JVFMJV          : EDIMLPIQAINHN   YSOJSTC         PIGRS           FIFOIJRL       
NNSQLOK         : WLCPQBQJBDH     HNXNEKUPQLAMBTX
HVMJYQIHT       : UCLXNFYEHKJULJ  RGIGCLRMUDQFDP  UARP            ROCSWMESH       DBPCG           IGOIMYLFEOAKEC 
SLATURGTWUDVD   : PPIJ            GIAPCDSGPBUCDT 
LXIWMUBTQQFPH   : FNHPW           JLYAETGWYGLHUB  RFBVNAOUWJ      QBUTDGCJOVJ     ULPAMAYDKGXUY   CIPU           
YDCTQ           : ROCSWMESH       VBQXLYEKAVP     GBYDSPXRFOE     GFKHEU         
QMUWGTT         : WLCPQBQJBDH     AOXNJJS         TFDSMRHBDCQXYWD
RWFDUQCJ        : LBFKMQFUX       BHYTCYBNYUGBMG  NWGDMHD         OUWTRXH        
EFFUMWEAYKCUD   : BTKAH           VQWDLRIGMHHDDY  JPQKNBFQT       LUMWD          
LREKXXFMSERX    : AFYYLYVEY       FKOC            GIAPCDSGPBUCDT  GDASLJSIS      
KBLYHTG         : ARDIVQJRYLIO    JAVVWTVX       
GFKHEU          : NWSJWHEYXGYXG   BXAYLAT         CCRD            HIFK            TFDSMRHBDCQXYWD YDCTQ           SKRUPAXFWCBA   
ABSNSWYTXGGSKA  : IPISOAG         TWKRM           UJMPTMYJGGNUSI  BTYLULNANOXGO   PIYEBRDMTLXCH   XLVBFHTDAHVL    GFBGT          
OLTBKBW         : JJQIPJ          JLCHSA         
FDVSMDPYFQTSK   : BATKELDXHEYH    JEQMHJ          FJKECWJRXOJSJVO
TGTCMMPODEAXHMB : BBRTDOERHTYHPX  JHRDDELGXPOWGXO RFBLLSXYVAH     DLABUFJWFBKY    JAHW           
FJKECWJRXOJSJVO : MAYXKFRKL       DGQGU           ICYWXQEBP       FDVSMDPYFQTSK  
CIIQWA          : OABQUXH         LXQFYOAL        UCWPF           ROCSWMESH       SQPEPXJRV      
AFIAOUETDNEHP   : HGAMOCQKDQ      TIJQFFISDHVNMCE DGQGU           DEGA            OOTPFCYNVJ     
QHCHSWQQLWSVI   : WYGIXR          VTURNUVOTKGRF   UARP            SFCFYCHYI       MPARYFUJB       SKRUPAXFWCBA   
SKRUPAXFWCBA    : XMIHIDIXLQFXCP  XQRORAVGYLQYX   CPQTTAYAFQBUNI  CSQQLXTMBAJNE   GFKHEU          QHCHSWQQLWSVI  
FHHIAOMHKJYB    : UARP            SHUSDR          WRNII           CCDAIXQJFRISJ  
XWSIILT         : AOUIVRNIPBPOGW  JNXMLAQGSJ      JLYAETGWYGLHUB  QBUTDGCJOVJ     DRUTURNVWDKEE  
JLCHSA          : CILA            TSBMQDIFUR      YBQVRWMLGLGA    UCHWPFUUO       OLTBKBW        
TABBKIMMYYULLV  : CUWN            PFSKJRNA        CQSNQ           UQACNMFBEPYMXHN GIAPCDSGPBUCDT 
GVMCF           : GOTIYST         VQWDLRIGMHHDDY  DRUTURNVWDKEE  
NBVWO           : IAKPKVTA        HNXNEKUPQLAMBTX KIXCWNJN        PIGRS           LCBE           
GIAPCDSGPBUCDT  : CILA            HNXNEKUPQLAMBTX WMDO            OGUH            SLATURGTWUDVD   LREKXXFMSERX    TABBKIMMYYULLV 
OFSCOPOQWMG     : MFYXHYE         GUYGFGXP        AOXNJJS         PQFTWPCJTYNFY  
IGOIMYLFEOAKEC  : WXYKH           LHRGIWFMYSIHF   PIGRS           HVMJYQIHT      
GFBGT           : DARRUGGKAMHY    BTKAH           BYGUG           YAFTLQSKHHUJY   YHROKRJLOIQMQR  ABSNSWYTXGGSKA 
BYXQPQPCYRMFHX  : TBKKIJBIXYET    LLNV            HGAMOCQKDQ     
GLCKAC          : GAJVMTOGGINW    CCDAIXQJFRISJ   BBWKILKTENS    
GGCONGUINWJNPBE : OLYNDCVUNMAG    GTBUFBILJC      GBYDSPXRFOE     FGMWBLVUXBKG   
GDASLJSIS       : NAYCRVOS        NGMWTPIFI       PPIJ            LREKXXFMSERX   
KDGODMVHEJNYTDX : VKHYTGOLI       UPYDPXM         UPOUYMOJIRXF   
QQHWY           : PEPRFHJQ        ROCSWMESH      
