NRWY            : UAKERMNJVNHF   
CNINTATLNMOEBXR : ASQUHW          DIQHKTUBXGVF    YFBTRY          JMDUNJIBHEHR   
GONUXC          : QXSAXGNBG       JJWJYSEMJJP     TYIK           
PSXFMUELXTTNNTJ : DEYJEOTQ        EBXPX           XERBEHBISSGYG   UFLFLOQCH       WHQXBPPN        TCPDFJLRTUOM   
JVQQ            : RNJFQFFLCA      KWPLMJRYCLXQOY  UHPKNSIHQPURDS  AHBIOWOYTBNCRY  MJNOWHIEJD      PRUCFN          IHUT           
OIMWWARWCVOWTU  : EMYMYSYRLKA     NICCIN          XLQDXEKMXA     
QBVQVRHLOQNAN   : EOUDVYVNJYMARAQ QXSAXGNBG       RCJWTEILF       MOGTMJJQ        EDFPOU         
QMXBBUBCPX      : WEQFPQVKVR      FMSLCJJOHBK     LHPXQYLJHMXXJY  EWWSTWVTR      
LNGHISXJ        : YKIXETQS        QFLAPWE         IHUT           
RHIYTWPJXFQ     : QXSAXGNBG       GYHQQJP         VFXHXSFHT       DWEFEPASOIHE   
SQSTLTXBTHOHNV  : EBTMNBJUKLHWU   GXCWSAV         HGJJDKWJOBKIAG 
IWEYO           : OFLFCJMECDK     IBIJYKIUBDCOPUH FPPSOTBF       
JNHHDTHLM       : RNJFQFFLCA      CQOOWLS         VRJS            CGILVHNNEBPO    OJVQQW          TTDKGFGPSRFO   
EDUXO           : RGEXKBCKFWILU   YKIXETQS        PTKEOKREFGI     GOBTVM         
YSLGHUVGNEDTFTH : XLHHCYAWNHVB    WCIXOUUMQR      DGTGGAJQLRP     OOYFMJLKWJECJJU BALQJFNCLRO     YQMBYKXNHGEIJVX
HPVMLFAXI       : NXTEOLPNOCRRDEM NJCPD           YSEXOKN        
DDFTUEMGMWBIF   : LOWI            UCAPHWAQ        VDCBOIYBLNGQN   UHPKNSIHQPURDS  NORMXTGADKPLAD  DCKXQKRX        RENC           
OKKT            : LAOA            DRJARBAKP       OLJXBVJCDYB    
SINKHCXODV      : HXLRWBNRNGL     QQUI            DSTQNUJPMNO    
HYBOSVSIEH      : NQLJ            IAYKYHBIKPV     KNJXYAKC        EGQJVF          JWUHTSGFCJLNFT 
FPMY            : SWLFQAPOGSJVYW  USGQSOHTVL      OOYFMJLKWJECJJU VFXHXSFHT       JVXMKXHNC       HGIYRPYTGPKYOYP
WJXBEJQQQSOFX   : SYODUFUIIJF     GRYWWIOWGDKEM  
FILGWHESPIAYP   : PMJRRBYDRJOBKW  TFJAJKJADICI    MOVACPYAUHPMFA  VWJXQIOLEODSC   KBSPSFWSMFEWBM  DMQNEENXVMVF    RSMLLBAFG      
LOWI            : DDFTUEMGMWBIF   FHTM            UFGUJSYYLR      QNEXOAKEBTAN    EGQJVF         
XLHHCYAWNHVB    : YSLGHUVGNEDTFTH YORLMSTQUKV     RTYBDCPFU       CIDMVTPFBJBE    EGQJVF         
EOUDVYVNJYMARAQ : QBVQVRHLOQNAN   HAWGHTEIEDCL    OGLQCVOKC       NNXCENINTV      JCLULJ          RNTQLOQ        
ITOVCXADAXQ     : UWRWQMLN        HYCWSSMRNBW     YKMJONGSJQLOLK 
VTWCLSFJTEXEDM  : UNAS            UFXFELDPGJ      QEHBQFKOEI     
UNYJXTBUXYUBAUR : KAFPRU          VOTAPRHOBDE    
QOHSACBJWF      : EOIJAYDXAWAUTP  LBDCVXRD        ALTVCMVIUHJYHN  VNDOCISUYAIFSI 
DIYJD           : FNRSQYW         PENQAFCBHPQYAF  SBYMJIBMFILFHM 
IOOEPLCPJD      : CWEKIAUYQYAGNE  DCKXQKRX        YSEXOKN         ILJAFEQULMRIB  
EXCXMJSOMTALBKO : RAPBSMMQEXFOPFQ YWADHLJTNQMHLKB ESQQTDB         WMEQFHPXUOKVHW  FLCRSCWN       
LAOA            : OKKT            FOFMWE          WEQFPQVKVR      CTOBNI          WOHLTKKNFOPVVG  MEAHGK         
EOPTDRLMVF      : NKRDQRHSLQF     KNJXYAKC        GVMELH         
VHOKTKYI        : PKNUIFDYGEMHTOU RJDEASHMTKQPLIT PCYXEFMY        QBXNAG         
BVILKRY         : QDYNDM          SSSANSXYNI      LTVMDHUP        NHRXTLWNWJU     MLEUQL         
JBWNSMJVFXIDDY  : XERBEHBISSGYG   LGLKSLMSV       BKGBEXRVTFFGT  
NQLJ            : HYBOSVSIEH      UQDBIEWWIY     
KTJLPRACMBOV    : JKDIYMLSMU      URMSAAUHDTMGNEI NICCIN          DEYGN          
LJVYU           : JKDIYMLSMU      CIYINJFUTK      UHACVTUQGVEBH   PXPCCUGHVFB    
GSALWBMKTX      : GLIALMSQHVE     CWEKIAUYQYAGNE 
WIPHVFBXHNAVL   : KBUWPKLWNR      GUMPUYGR        JWUHTSGFCJLNFT 
JUBISUQ         : IBCWNJTJS       CRFHVNUL       
WCIXOUUMQR      : YSLGHUVGNEDTFTH LHSEJMVUDPQ     NLBGEJBHNJ      NTCGVU          GJFQS           NJGNELMAAOF    
IBVNDTWS        : IBITTEUFD       DHABEQXFA       VQBBODKPKX      JJIJKDISWO     
UFBFCEPUY       : WSIRDWJYEUXMKU  OOYFMJLKWJECJJU RCJWTEILF      
HXLRWBNRNGL     : SINKHCXODV      OBWRUW          QTVRVJNTMKYFKA  RRQRSLHMNN      TTDKGFGPSRFO    RHGPSS         
RNJFQFFLCA      : JVQQ            JNHHDTHLM       IXHUE           LDHHBLPQHLUG   
FHTM            : LOWI            AMRJ            SEMEWAA         PKLUFUB         OWVCVOVXITPRB   EDFPOU         
ONHXMSQLTGF     : DDOUGV          JRLICD          VIOPFFVBLYIXNTP IAOQDEJJHOBOE   YCHXKVBNWPECKA  NXARO          
OQXGG           : WSIRDWJYEUXMKU  IEOQCTMQLWQASL  WGABAJ          ENMVIYTSFHPTWCN YHNYSGIBTMMNEE  JWVGALGQNNK    
MYOTLSTCBC      : SWLFQAPOGSJVYW  ARCQWUTAWN      YGGK            QTLBMIQ        
NCNDJLPECDBKINA : IVIEPYEGCKUYJB  IKOMOO          AMKJRKLRSBK     GSRNKOUCTYDSNWG OPWYEVEHUIDAXAV
NGIWUIL         : RWCGM           CWEKIAUYQYAGNE  BSPLFXYOOQRYMQ  GLXEXEOUTI     
TFLXIPWVRKYDXRJ : PENQAFCBHPQYAF  HNAWEJOWUR     
WKNGXNK         : UFGUJSYYLR      IILPNUX         DSTQNUJPMNO    
WSIRDWJYEUXMKU  : UFBFCEPUY       OQXGG           BDITNWCGDWXRK   OFLFCJMECDK     VIOPFFVBLYIXNTP
EHLHFDS         : QATQVGQMKHWV    PBJPEJABKDGGVBU HGDDOEWFPDJKR  
DEYJEOTQ        : PSXFMUELXTTNNTJ KAQII           UINCYCXAQDRCMLA KYIGIXKHBLJROC  JCLULJ         
OBGSAPRE        : WIJS            GVMELH          BGTIGAD         TWTJLFOGNI      YKSKAAGHESOTF  
RQWMDB          : GIXDYAX         WINBDHMYYYA     IYQXYLC         IDMFQT          SNXLR          
PKEUDOXJ        : QXSAXGNBG       FMSLCJJOHBK     OLJXBVJCDYB     OWVCVOVXITPRB   FPPSOTBF       
JODFHQ          : FWODVLHBTAJHVGI EODBXRXHN       KQXRKVOBWKOP    CJYBDWWN        BKDSNJLHDH     
KWPLMJRYCLXQOY  : JVQQ            LTYSLLJW        VFNGCBLONK      JBLPUM         
ELRARGABW       : GXKDMD          BOMXVOTOK       TBLNVIGXNXSFWD  OYLCNNRFXCO    
RAPBSMMQEXFOPFQ : EXCXMJSOMTALBKO
FJSFWWSQYK      : XUXYXKGWTSRC    LBDCVXRD        PPNOFTLO        MJDFXTKXBH     
AOWKGYCIRPUIT   : XNLAUPOEKJA     VVDINPVKULLAN   WMEQFHPXUOKVHW  OWVCVOVXITPRB  
QKMXDQDNJI      : FWVXQFAYLQRP    YUXB            XKQJM          
GEEIOCIDBUMAW   : AUNMM           PAWHGGKJSNPYJRW
RORDLOTVBRATWP  : QEHBQFKOEI     
IAMMEUBIFHJATLW : NDEVQLWCIKUGCG  XLLTJFGGFV      AROVNGDVQCGY    GUMPUYGR       
EOIJAYDXAWAUTP  : QOHSACBJWF      MCSVRJFYF       NQSKSFLHC       PBJPEJABKDGGVBU MLEUQL         
CQOOWLS         : JNHHDTHLM       RMGXEPWFDMDBYS  APIXXC          CTOBNI         
QATQVGQMKHWV    : EHLHFDS         VORIXMV         QDYNDM          CIYINJFUTK      YSEXOKN         YHLLHGFAPQWMASF
VYHXXI          : MAFBJNVINIBJ    NQLMWOK         SFPH            RNTQLOQ        
TXVYQMPOYIYPKS  : SNXLR           XIEKFINGOAMXWX  AGGBWJBH        CJYBDWWN       
IBCWNJTJS       : JUBISUQ        
KAQII           : DEYJEOTQ        SEBLJKTESUEQKU  IHOYELBTVPFAD   IBIJYKIUBDCOPUH FLCRSCWN        KBSPSFWSMFEWBM 
FHJEXWTOXF      : HSOOMHLE        GSRNKOUCTYDSNWG LSGAMQUBRPHJQ   EIQYWCLXEQFSJB 
NRJYDKBAYKUIFM  : WTNHJV          KXUYYAFHJ       UDHYHTQDNC     
GFEORLXDPWA     : NAWFOKLPV       UBWVBV          AGGBWJBH       
NXTEOLPNOCRRDEM : HPVMLFAXI       SYODUFUIIJF     LGRVGJYIU       XTFAP           JIENXP         
KBKQHQ          : GGGGWLDR        BXEJ            QBXNAG         
BDGESF          : UJKBHYKXLU      ATIFIVW         OPWYEVEHUIDAXAV XMUHJ          
HSHBY           : TDLUEF          KYQODNREBYKVA   UFXFELDPGJ      FOFMWE          OXHWQ           WAYYCSM         DACDMH         
NOOET           : CRFHVNUL        TVVILT         
VWMKLWMVPVPX    : LXMEVXLOYC      XTFAP           JJWJYSEMJJP    
SEBLJKTESUEQKU  : KAQII           RGEXKBCKFWILU   DXYAPBDJBBAS    IPPFDICXKEEQP  
RONPOBBCXPBQNQ  : VRJS            IMXTIAHF        GUMPUYGR       
KJUNWEBQKTO     : QOHGJFLANPBA    RMWAGEAND      
MBMUUDINRLQUMGX : GPWPNOV         MJDFXTKXBH      GUMPUYGR        IOVHOUVVMVPATDX
VORIXMV         : QATQVGQMKHWV    TTSC            TDLUEF         
SYODUFUIIJF     : WJXBEJQQQSOFX   NXTEOLPNOCRRDEM CNROWFAD        KTGTU          
MPRH            : JJWJYSEMJJP     JRBSEMA         ACXIUBBCTPUOTU  LOSAXQDTD       JVXMKXHNC      
IEOQCTMQLWQASL  : OQXGG           UHQUIE          XMSDSSWQPXUB   
UCAPHWAQ        : DDFTUEMGMWBIF   KYQODNREBYKVA   JFVFTBTWSSCRX   KHRDAQT         VXIMJNREBERBHBL TYWYOJUJHWTUUUC
FWVXQFAYLQRP    : QKMXDQDNJI      GXCKRMLCHP      PCYXEFMY       
GIXDYAX         : RQWMDB          EBNWVJAUISW     HMDAKVWYCUNTQR  NVQRPQDEQQTUPY 
USPWJWU         : FTNQHPMNFBJNA   KUJGHYUHEKDDALQ FFVTUPI        
PDRMBPDGRE      : GDCXJOFIOBBXFBI VUBI            LGTEAF          VRPRKYCU       
IXHUE           : RNJFQFFLCA      XTJJBEPMTOIWEB 
UHQUIE          : IEOQCTMQLWQASL  AFQYHCQCAXAFC   FXDXRINYXLYPCNO LDHHBLPQHLUG    TJWQVVIVPO     
BTMMSJYLNSAO    : XVGEACCXCBXR    XNLAUPOEKJA     XAYFHLETMX      AHBIOWOYTBNCRY  RQYXCYLUDNARB   UGJATGMIJ      
GXCKRMLCHP      : FWVXQFAYLQRP    FTXILRHHL       TJIHLKPYXNEE   
CALYIROLNDBIP   : FNRSQYW        
TDUUTFDTH       : GVMELH          MOVACPYAUHPMFA  RILCSIJMDU     
MTBODRKH        : PMJRRBYDRJOBKW  NCHHOYUWD       JBMJKCIPCRQWXX  JSTWJ          
VGCPW           : DCQMRSIWNF      TFJAJKJADICI    QHUMECNSB       DQNLLFSTMVQS    FRJHRYN         PHYHIUNY       
DCQMRSIWNF      : VGCPW           BBEGLOGK        QKJQBRGOXWRSY  
UINCYCXAQDRCMLA : DEYJEOTQ        GQKQJQITNBBEVPN JMDUNJIBHEHR    PGLUTUTIOK      TBTISFUWUKAEFK  TVVILT         
PQRGVWYIOUT     : IVIEPYEGCKUYJB  IFYF            WHQXBPPN        GRYWWIOWGDKEM   YSEXOKN        
KYIGIXKHBLJROC  : DEYJEOTQ        FGDUWQMV        GQRTNE         
EPYYIRRQNOPYF   : ASCKR           GHXWEPQFTKU    
STXREGCDSJEE    : XVXWA           XDRJA           CFNOQTWNH       TYCB            JSSA            IILPNUX         CWEKIAUYQYAGNE  EQUVDYI        
XVXWA           : STXREGCDSJEE    JRSSPJOI       
XYXPSOF         : HUJOIQKUQE      IYSVVP          BSQSSAK         LBAVDTL        
HERTY           : AVRLPLMPOGB     WTNHJV          CNHXCVKJ        APFMSX          VDFICACBXF     
TTSC            : VORIXMV         FTXILRHHL      
XVGEACCXCBXR    : BTMMSJYLNSAO    IYQXYLC         AIFACXGNSAIMKA  SFPH            HBDMWJEXIDHWB  
ASQUHW          : CNINTATLNMOEBXR XIXDESCAOY      AVRLPLMPOGB     BALQJFNCLRO     TBTISFUWUKAEFK  YWRESQPEIVT    
QDYNDM          : BVILKRY         QATQVGQMKHWV    IFYF            OTLCYBJLBQQGB  
WHMSFIBJ        : HBDMWJEXIDHWB  
FOJHPJCRJUIFE   : INSMYTPTJCCCVEE NUSNFDUAAGMFBL  WFWFUEDHWGKFL   IAYKYHBIKPV     CBWWED         
MVLLJQASNIH     : GPJOYVVY        YBFPSLRALGSMA   EPSBAAWGAK     
PPMABRQ         : ACXIUBBCTPUOTU  SNQHRSKDEMTWSVP KHNNWKWPWTN     UGJATGMIJ      
CIVGAG          : YJYAAIUPVVHXEV 
LNHSCDEP        : HQGBOWL         JDPMEQWQDN     
WPKKARVQ        : JRGP            LTYSLLJW        BURKYCLPQJLG    LSLPPSVRWESFUCK NJGNELMAAOF     QQHSI           YKSKAAGHESOTF  
KSLEJAGRV       : RHHCMQQTHS      IMXTIAHF        QFLAPWE        
SERGTAYVFGNWD   : RQSUTYSJPKWROIJ MAFBJNVINIBJ    MCGWMU          XFNXMAJS       
HQGBOWL         : LNHSCDEP        DXYAPBDJBBAS    CJAKJJSBYCFO    YITIS           JHXYLGQFLUQJK   BUVTPHHHSKPVFM 
PYDYYMTXB       : JJFSU          
CVUYVTWDCLAGR   : LGRVGJYIU       DXYAPBDJBBAS    WXHSW           WMWYANMKXWWJE  
YXLNXWMNYPPXE   : VKMMX          
XIXDESCAOY      : ASQUHW          LEXGXDBQKIE     HYCWSSMRNBW     SSSANSXYNI      XKAIOWFB        IHUT            YHLLHGFAPQWMASF
RMGXEPWFDMDBYS  : CQOOWLS         YTSTW           GSCNGWMTQOIEHD  FPPSOTBF       
QIAVRYEPCIK     : HTWHVTAVPI      HNAWEJOWUR      QJDHRRRUCTTC    RHGPSS         
KAFPRU          : UNYJXTBUXYUBAUR RWCGM           EBNWVJAUISW    
RBQQ            : ENMVIYTSFHPTWCN DHABEQXFA       TBTISFUWUKAEFK  WSUHUHDFIBH     KTGTU          
TDLUEF          : HSHBY           VORIXMV         EBNWVJAUISW     XFRQLYFRB       NSUDWDQY       
UNAS            : VTWCLSFJTEXEDM  SVDVNYTMJP      RPLHTWBV        WMUR            WMRNHWSOIJC     KNJXYAKC        NMXVOEAPPITGF  
YWADHLJTNQMHLKB : EXCXMJSOMTALBKO PGLUTUTIOK      WOLVBV         
BRVVWISBNSXBURJ : APIXXC          HJFYNG          DAHSWQSIN       NVQRPQDEQQTUPY 
QMYYXKULBHU     : JCHJYV          QQUI           
SVDVNYTMJP      : UNAS           
WINBDHMYYYA     : RQWMDB          MEADRBRVYQINRMT UFXFELDPGJ      FKDGNGYE        MWUSBEUOP       IOVHOUVVMVPATDX
WKSKLDFBVB      : BELUYG          INSMYTPTJCCCVEE IUGDEMPH        APFMSX         
TQIOF           : DMIOJHXPFILDRFG KTGTU           HJFYNG         
EUPOLSTSFSRFUR  : HMDAKVWYCUNTQR  YHQR            VXIMJNREBERBHBL
FNRSQYW         : DIYJD           CALYIROLNDBIP   YENGVOVLPNDKU  
BDITNWCGDWXRK   : WSIRDWJYEUXMKU  HXNMDXNUXW      ARCQWUTAWN      DHABEQXFA      
LEXGXDBQKIE     : XIXDESCAOY      UYNDOQGO        FUIIVF          JRJQY          
CWDY            : XWQBUMQQUJ      PVJJRCHP        VGXMYWIF        YENGVOVLPNDKU  
EETBUT          : EVYGSP          TFARHTSPHIIXII  TYWYOJUJHWTUUUC
DWCBRPTFTRMTXP  : PSHLLQQNTFYJ    OXJNNYBFGWQUWB  XMSDSSWQPXUB    BSQSSAK        
KYQODNREBYKVA   : HSHBY           UCAPHWAQ        PENQAFCBHPQYAF  UPCCSWV        
PFIOJLGYFOUAB   : QXSAXGNBG       EEVDSEP         CWOTRVBJJ      
ASCKR           : EPYYIRRQNOPYF   XUXYXKGWTSRC    CJUHHOS         JWVGALGQNNK     WKXAMWSSQ      
YWLQB           : GLIALMSQHVE     HTWHVTAVPI      NXARO          
PMJRRBYDRJOBKW  : FILGWHESPIAYP   MTBODRKH        BWNLSGO        
IYQXYLC         : RQWMDB          XVGEACCXCBXR    QNEXOAKEBTAN    LQVFLS          BOTPVSDOUIQMUX 
GXKDMD          : ELRARGABW       JCHJYV          UFLFLOQCH       NQYHEXJYLKDUYA 
AVRLPLMPOGB     : HERTY           ASQUHW          LUWGGXISXJTCOF  IYSVVP         
HNDWVE          : ELAJU           BGTIGAD        
VDCBOIYBLNGQN   : DDFTUEMGMWBIF   VXIMJNREBERBHBL LBAVDTL        
KBUWPKLWNR      : WIPHVFBXHNAVL   JDGM            VSXVESF         TPVLDOPBRE      IPPFDICXKEEQP   ESQQTDB         VCYEIHN        
BWCABTVGVWW     : XUXYXKGWTSRC    VIOPFFVBLYIXNTP
YXUMHLDLYEGVUS  : PCYXEFMY        WMLYJGNTAORNB  
RGEXKBCKFWILU   : EDUXO           SEBLJKTESUEQKU  IBIJYKIUBDCOPUH
JCHJYV          : QMYYXKULBHU     GXKDMD          INOTDEFLQL      RHGPSS         
MBDLGLHDFTW     : EODBXRXHN       CVFBQTGWTKKXCL 
XUXYXKGWTSRC    : FJSFWWSQYK      ASCKR           BWCABTVGVWW     IGDAOGUH        AWGB            WFWFUEDHWGKFL   TWPNNACKFW     
VLNUJHILMT      : WFWFUEDHWGKFL   JTWVX           EIVP            MLEUQL         
XEWDXTRVQPW     : TFJAJKJADICI    EWDNQOABJBDU    QBXNAG          XQHDNQEBDQFNJJ  VYVSA           BRKTQWEXUDM     IOJDFTLJLAB    
BELUYG          : WKSKLDFBVB      VRJS            TNFNVLG         BYSNWMAQMLNWO  
DCMSAVAIHMEDNIA : GHXWEPQFTKU     FXMQBBIEUM      IYSVVP          YUPAYIPGCMNYIP  MPKENDKG       
IVIEPYEGCKUYJB  : NCNDJLPECDBKINA PQRGVWYIOUT     MBWAJURGIJVOT   FLCRSCWN        WKXAMWSSQ      
OFMHFIKPSYUVMF  : PPCFOWIFBAGD    VCYEIHN         XKDEYTWTXCIN    OBIVXEG         DVCMQLVRSLIWUHX JCLULJ         
EOWO            : LSLPPSVRWESFUCK SNXLR           MJDFXTKXBH      CIDMVTPFBJBE   
MPYTRJOQUP      : EBXPX           XLLTJFGGFV      NXOP            RRQRSLHMNN     
JWFTDOESJDPF    : CYGWSYGMSWQMUA  VSXVESF         NVQRPQDEQQTUPY  JFPAGKJGDH     
VGWM            : UMTICC          KKMKFRW         SRCYFALHJGMCBGA
LHSEJMVUDPQ     : WCIXOUUMQR      OLJXBVJCDYB     DACDMH         
ICSOVXFAQOGJVYF : AHBIOWOYTBNCRY  UEGRC          
XTJJBEPMTOIWEB  : IXHUE           JJFSU          
OFLFCJMECDK     : IWEYO           WSIRDWJYEUXMKU  WTNHJV          FOFMWE          LAJDLAIIQYHP    AIKKOBJGRTBIMGD
CJUHHOS         : ASCKR           EEVDSEP         JWUHTSGFCJLNFT 
SWLFQAPOGSJVYW  : FPMY            MYOTLSTCBC      RQSUTYSJPKWROIJ ELGE            MSTGEQKXM       MRMYMPIBGAIUJO  WAYYCSM         QFCLVOQDJYH    
SWLFQAPOGSJVYW  : IIIFG          
DIQHKTUBXGVF    : CNINTATLNMOEBXR LTYSLLJW        CNROWFAD       
LXMEVXLOYC      : VWMKLWMVPVPX    DTYI            UHALWNAKQK      DAHSWQSIN      
FWODVLHBTAJHVGI : JODFHQ          NHRXTLWNWJU    
MEADRBRVYQINRMT : WINBDHMYYYA     FDDEPPYEMCNQ    LCELRRLNIAR     WHQXBPPN        DMQNEENXVMVF    WKXAMWSSQ      
JKDIYMLSMU      : KTJLPRACMBOV    LJVYU           EWDNQOABJBDU    RHHCMQQTHS      VASL           
IDMFQT          : RQWMDB          KHRDAQT         VCYEIHN         SXFFK           SFPH            ULVLRRY        
VLJOKIHUVBHRA   : OGLQCVOKC       PCYXEFMY        MSITMBS         WKHVE          
FDDEPPYEMCNQ    : MEADRBRVYQINRMT QQUI            YUJSKSFDDQEV    FLOWGMA         KBSPSFWSMFEWBM  RNTQLOQ        
UJKBHYKXLU      : BDGESF          TMFIKCDEDBWSN   TKRBFNNFYJ      BKGBEXRVTFFGT  
GRGPLHKQM       : QFUUIPUFFBS     VQBBODKPKX     
UFGUJSYYLR      : LOWI            WKNGXNK         DHABEQXFA      
UFXFELDPGJ      : VTWCLSFJTEXEDM  HSHBY           WINBDHMYYYA     NKVQBTWYGCFAJNA OYLCNNRFXCO     SPUP           
ARNMBXFQODV     : XRUMF          
AFQYHCQCAXAFC   : UHQUIE          TYCB            INHCM          
ITUTRUO         : PUBF            CBUNOCO        
JRGP            : WPKKARVQ        GQKQJQITNBBEVPN HPUXOQLYAKKVRA  KHRDAQT         WMEQFHPXUOKVHW  MOGTMJJQ        YKSDA          
USGQSOHTVL      : FPMY            NNYWIGKKKFUOGSM
XNLAUPOEKJA     : AOWKGYCIRPUIT   BTMMSJYLNSAO   
GQKQJQITNBBEVPN : UINCYCXAQDRCMLA JRGP            LQVFLS          KNNGNVCFQFKMK  
LCELRRLNIAR     : MEADRBRVYQINRMT ANRLJOFNR       MOGTMJJQ       
LTYSLLJW        : KWPLMJRYCLXQOY  WPKKARVQ        DIQHKTUBXGVF    HSHLAXVEKVPFE   WKDIKGXWBMXP    PIWTKKMQJATJ   
RQSUTYSJPKWROIJ : SERGTAYVFGNWD   SWLFQAPOGSJVYW  CFNOQTWNH       MKRXALMGJ       MYFOYOOPHTTSDE  WMWYANMKXWWJE  
UWRWQMLN        : ITOVCXADAXQ     NOHACWXFRBR     NORMXTGADKPLAD  QJDHRRRUCTTC   
EBXPX           : PSXFMUELXTTNNTJ MPYTRJOQUP      DGTGGAJQLRP     AGGBWJBH       
JQWGLWYWMJUG    : CGILVHNNEBPO    EIVP           
DRJARBAKP       : OKKT            XLLTJFGGFV      VUBI           
XERBEHBISSGYG   : PSXFMUELXTTNNTJ JBWNSMJVFXIDDY  DFIBRAJ         EWDNQOABJBDU    RHHCMQQTHS      NTCGVU         
XDRJA           : STXREGCDSJEE    UPCCSWV         DGTGGAJQLRP     GYHQQJP         BALQJFNCLRO     KBSPSFWSMFEWBM 
LGRVGJYIU       : NXTEOLPNOCRRDEM CVUYVTWDCLAGR   JSTWJ           NXARO           UHALWNAKQK     
TSTLUAU         : RTWRACPURYKMN   CNHXCVKJ        WJIHYQYNOVO    
INQOOYTO        : IGDAOGUH        TWPNNACKFW      QKJQBRGOXWRSY   LTVMDHUP        BUVTPHHHSKPVFM 
LXFLKL          : JDPMEQWQDN      FGDUWQMV       
IUNHDIWAESLB    : URCCRNBRHD      CIDMVTPFBJBE   
HYCWSSMRNBW     : ITOVCXADAXQ     XIXDESCAOY      KEOFCWTSEAQ     CBWWED          TWLJRGNM       
CFNOQTWNH       : STXREGCDSJEE    RQSUTYSJPKWROIJ WWMQVAADTUHLVIT EDWNHJEAF       VQBBODKPKX     
RSERYYFCSOB     : EBTMNBJUKLHWU   TBLNVIGXNXSFWD  VYHO           
MTRBOFENHI      : YUXB            JVXMKXHNC       NHRXTLWNWJU    
WWMQVAADTUHLVIT : CFNOQTWNH       XLLTJFGGFV      GLIALMSQHVE    
DICCWXU         : IBITTEUFD       IAOQDEJJHOBOE   NVTJAYW         RCVMCMB         RTYBDCPFU      
MAFBJNVINIBJ    : VYHXXI          SERGTAYVFGNWD   HAWGHTEIEDCL    NICCIN          WEQFPQVKVR      JRSSPJOI        WJUNKCFSIDI     EWWSTWVTR      
EODBXRXHN       : JODFHQ          MBDLGLHDFTW    
KXANVYKXNMD     : PYGVCJMIJUYO    VRPRKYCU        EIQYWCLXEQFSJB 
WTNHJV          : NRJYDKBAYKUIFM  HERTY           OFLFCJMECDK     OOYFMJLKWJECJJU
UHPKNSIHQPURDS  : JVQQ            DDFTUEMGMWBIF   LFRA           
SQSD            : MDRISARFYMBBSXP DQNLLFSTMVQS    JJIJKDISWO     
HPUXOQLYAKKVRA  : JRGP            EAJUFXUJBAKAAAC
HSOOMHLE        : FHJEXWTOXF      GHXWEPQFTKU     MPJHVJWPWBX     WFWFUEDHWGKFL   AMKJRKLRSBK     XJVYUB          NMXVOEAPPITGF  
FXDXRINYXLYPCNO : UHQUIE          UEGRC           WXPCCFABUXGREEY
XYYRBHA         : JCURVLOGGKPBAAE VUBI            FGWX           
VQIDD           : KHRDAQT         QQUI            LSAJPKNF       
PKNUIFDYGEMHTOU : VHOKTKYI        LAKDVVGXBEDHHF  MCGWMU          NOUMYDKEXBY     PPNOFTLO        GQRTNE          RENC           
RUHSPKC         : JRSSPJOI        PTHQUHPFB       BRKTQWEXUDM     AEUOKRLENKAKC  
GYIPELGWXTRJBX  : VFXHXSFHT       VRPRKYCU        GMCQDBOHMMLFTG 
JCURVLOGGKPBAAE : XYYRBHA         WKXAMWSSQ      
GDCXJOFIOBBXFBI : PDRMBPDGRE      NQSKSFLHC       BSPLFXYOOQRYMQ 
DFIBRAJ         : XERBEHBISSGYG   SDKARLEEMACCGEH NOHACWXFRBR     ECMUJOYI       
KYYMYDGHII      : UMTICC         
UYNDOQGO        : LEXGXDBQKIE     RBSNNPGFTCTVQ   TMFIKCDEDBWSN   WJUNKCFSIDI    
HXNMDXNUXW      : BDITNWCGDWXRK   XNQPITDDGCJ     VYHO           
KXUYYAFHJ       : NRJYDKBAYKUIFM  ACXIUBBCTPUOTU  CHNCVAFNMK      AHRBFAM        
PGRDJI          : BWNLSGO         INYA            AEET            XFNXMAJS       
QXSAXGNBG       : GONUXC          QBVQVRHLOQNAN   RHIYTWPJXFQ     PKEUDOXJ        PFIOJLGYFOUAB   DXYAPBDJBBAS    RQYXCYLUDNARB  
YFBTRY          : CNINTATLNMOEBXR UYHFXYHXHNBFYF 
RBRYIBRXJKDSUY  : JMPNQL          PCYXEFMY        VRPRKYCU       
URMSAAUHDTMGNEI : KTJLPRACMBOV    YHBPGPLDKOVM    PYGVCJMIJUYO    MKRVVSXTXTHHWD 
XJYXRCRRLCWE    : QHCEAJU         RTDRC           QEHBQFKOEI      RENC           
VQUOFOOHLXMFK   : QHCEAJU         VFNGCBLONK      JDPMEQWQDN      WMEQFHPXUOKVHW 
URCCRNBRHD      : IUNHDIWAESLB    JBLPUM         
BOMXVOTOK       : ELRARGABW       WIJS            MPGCKCV        
TYCB            : STXREGCDSJEE    AFQYHCQCAXAFC   YGGK           
ANRLJOFNR       : LCELRRLNIAR     ARCQWUTAWN      JJIJKDISWO      VXIMJNREBERBHBL
BURKYCLPQJLG    : WPKKARVQ        RHGPSS         
AQQVRSYCTPVHYK  : KGQTCYE         NAWFOKLPV       YBFPSLRALGSMA  
PENQAFCBHPQYAF  : DIYJD           TFLXIPWVRKYDXRJ KYQODNREBYKVA   XAYFHLETMX      LDKBKTIAXCHNJCB NSUDWDQY        CTFNVUMARSKA   
GHXWEPQFTKU     : EPYYIRRQNOPYF   DCMSAVAIHMEDNIA HSOOMHLE        NDEVQLWCIKUGCG  EEVDSEP         SFPH            YJYAAIUPVVHXEV  CGEXJ          
GHXWEPQFTKU     : DAHSWQSIN      
RWCGM           : NGIWUIL         KAFPRU         
TFJAJKJADICI    : FILGWHESPIAYP   VGCPW           XEWDXTRVQPW     HVIKSIYATLDOBO  LPOPPEHDNGXCQIF HMDAKVWYCUNTQR  QKJQBRGOXWRSY  
ISNHYDXEWKC     : LDHHBLPQHLUG    VNDOCISUYAIFSI 
EBTMNBJUKLHWU   : SQSTLTXBTHOHNV  RSERYYFCSOB     HSHLAXVEKVPFE  
AGNLVVEK        : MVWY            QKJQBRGOXWRSY  
FPGJ            : OFTUHKDDTDJVP   RYOIMDDYFHKLH  
QNEXOAKEBTAN    : LOWI            IYQXYLC         QKJQBRGOXWRSY  
JMDUNJIBHEHR    : CNINTATLNMOEBXR UINCYCXAQDRCMLA MKRXALMGJ       ELGE            SFGEEYK         OSALPROB       
MKRXALMGJ       : RQSUTYSJPKWROIJ JMDUNJIBHEHR    VKMMX          
HVIKSIYATLDOBO  : TFJAJKJADICI    QXJEJIFDOALAA   BCSIEXXVNVHDJHA
EWDNQOABJBDU    : XEWDXTRVQPW     JKDIYMLSMU      XERBEHBISSGYG   VBKQLEBT        IAYKYHBIKPV    
KGQTCYE         : AQQVRSYCTPVHYK  XLLTJFGGFV      FUIIVF          VYVSA           BKDSNJLHDH     
JFVFTBTWSSCRX   : UCAPHWAQ        XTFAP           WOLVBV          RRQRSLHMNN     
INSMYTPTJCCCVEE : FOJHPJCRJUIFE   WKSKLDFBVB      RAKUWYSQKUS     MSTGEQKXM      
APIXXC          : CQOOWLS         BRVVWISBNSXBURJ CIYINJFUTK      MOVACPYAUHPMFA  OUYIAJUHIOJ     PUBF           
RAVNENLVYB      : VBKQLEBT        NQSKSFLHC       DDRHFTFUL      
LAKDVVGXBEDHHF  : PKNUIFDYGEMHTOU HTLGRGIJLPKNVDN RQYXCYLUDNARB   EVNBGSBESYQVRXI VXIMJNREBERBHBL
QFUUIPUFFBS     : GRGPLHKQM       CWOTRVBJJ       TWLJRGNM       
XRUMF           : ARNMBXFQODV     YTSTW           UQDBIEWWIY      LTVMDHUP        XMUHJ          
AJTXRTYV        : ELAJU           XFWPC          
GGGGWLDR        : KBKQHQ          IKOMOO          OSALPROB        QCDQMMGIMWABX  
UPCCSWV         : KYQODNREBYKVA   XDRJA           PGLUTUTIOK      VVDINPVKULLAN  
PQGWPGGLGAGG    : DGTGGAJQLRP    
FOFMWE          : LAOA            HSHBY           OFLFCJMECDK     NRAUSNJRBVNKWG 
DXYAPBDJBBAS    : SEBLJKTESUEQKU  HQGBOWL         CVUYVTWDCLAGR   QXSAXGNBG       VIOPFFVBLYIXNTP IAOQDEJJHOBOE  
GPJOYVVY        : MVLLJQASNIH     QBXNAG          BSPLFXYOOQRYMQ 
EAJUFXUJBAKAAAC : HPUXOQLYAKKVRA  UHYXAX          SXFFK           VDFICACBXF     
JDGM            : KBUWPKLWNR      LBDCVXRD        IGDAOGUH        TVVILT          XFWPC           QQHSI          
AUNMM           : GEEIOCIDBUMAW   AHBIOWOYTBNCRY  BWNLSGO         TPVLDOPBRE      GQRTNE          RTYBDCPFU       CIDMVTPFBJBE    MYUTWUAVIPPIW  
IKOMOO          : NCNDJLPECDBKINA GGGGWLDR        JJFSU          
LUWGGXISXJTCOF  : AVRLPLMPOGB     FTNQHPMNFBJNA   LSLPPSVRWESFUCK RMWAGEAND       GUMPUYGR        MJCFT          
XTFAP           : NXTEOLPNOCRRDEM VWMKLWMVPVPX    JFVFTBTWSSCRX  
MCGWMU          : SERGTAYVFGNWD   PKNUIFDYGEMHTOU YHNYSGIBTMMNEE  KRAHYEACXNR     JWUHTSGFCJLNFT 
DMIOJHXPFILDRFG : TQIOF           OOYFMJLKWJECJJU AROVNGDVQCGY    MOGTMJJQ        CBUNOCO         PLGRY          
MPJHVJWPWBX     : HSOOMHLE        AIFACXGNSAIMKA  RILCSIJMDU     
PVISISJR        : VUBI            RBNPQAIVBYX    
JJFSU           : PYDYYMTXB       XTJJBEPMTOIWEB  IKOMOO          SDYYRAC         HYFOKFNHMXFCFKA
MCSVRJFYF       : EOIJAYDXAWAUTP  LDHHBLPQHLUG   
XWQBUMQQUJ      : CWDY            OBWRUW          YAAIJSH        
NUSNFDUAAGMFBL  : FOJHPJCRJUIFE   FUIIVF          BRKTQWEXUDM     JCLULJ         
KQXRKVOBWKOP    : JODFHQ          MDRISARFYMBBSXP JDPMEQWQDN     
LBDCVXRD        : QOHSACBJWF      FJSFWWSQYK      JDGM            BSQSSAK        
NDEVQLWCIKUGCG  : IAMMEUBIFHJATLW GHXWEPQFTKU     YKMJONGSJQLOLK  MLNVKQ         
RJDEASHMTKQPLIT : VHOKTKYI       
VYUTPGRTQE      : NOUMYDKEXBY     NTCGVU         
WGABAJ          : OQXGG           SNXLR           TMFIKCDEDBWSN   DFDHIJHANKU    
EMYMYSYRLKA     : OIMWWARWCVOWTU  YSWACXJNWVXR    YCHXKVBNWPECKA  MDRISARFYMBBSXP HGIYRPYTGPKYOYP ALTVCMVIUHJYHN 
CYGWSYGMSWQMUA  : JWFTDOESJDPF    JXKENUOML       OKCECXGGPFIMMX  JWNLWULOJ       WJUNKCFSIDI     QEHBQFKOEI      XFNXMAJS       
XAYFHLETMX      : BTMMSJYLNSAO    PENQAFCBHPQYAF  KHRDAQT         SSSANSXYNI      OJVQQW         
ELGE            : SWLFQAPOGSJVYW  JMDUNJIBHEHR    WIJS            OBWRUW         
IFYF            : PQRGVWYIOUT     QDYNDM          JVXMKXHNC       JWUHTSGFCJLNFT 
XLLTJFGGFV      : IAMMEUBIFHJATLW MPYTRJOQUP      DRJARBAKP       WWMQVAADTUHLVIT KGQTCYE         YUXB            UQDBIEWWIY      JBMJKCIPCRQWXX 
HUJOIQKUQE      : XYXPSOF         HBSQQI          VEMT            UBWVBV          OGLQCVOKC       ACXIUBBCTPUOTU  WIJS            VFNGCBLONK     
HUJOIQKUQE      : WOLVBV          NQYHEXJYLKDUYA  WKHVE          
CMHWUNXAOWOC    : KQRFRCSKXGGD    VFXHXSFHT       RAKUWYSQKUS    
AHBIOWOYTBNCRY  : JVQQ            BTMMSJYLNSAO    ICSOVXFAQOGJVYF AUNMM           XFRQLYFRB      
IFCMRK          : SDKARLEEMACCGEH NVQRPQDEQQTUPY 
MAHOOGFQBHB     : HBSQQI          ULVLRRY        
PPCFOWIFBAGD    : OFMHFIKPSYUVMF  YCHXKVBNWPECKA  UPCIGVKN       
LFWFRGRTPIIWOCX : FUIIVF          YHNYSGIBTMMNEE  EQUVDYI         WXPCCFABUXGREEY WLJDDJSIQXPAJA 
DDOUGV          : ONHXMSQLTGF     TMBPXVTUHANYV   MLNVKQ         
DGTGGAJQLRP     : YSLGHUVGNEDTFTH EBXPX           XDRJA           PQGWPGGLGAGG    HAWGHTEIEDCL    AMKJRKLRSBK    
JXKENUOML       : CYGWSYGMSWQMUA  EVNBGSBESYQVRXI HJFYNG          ALTVCMVIUHJYHN 
NKVQBTWYGCFAJNA : UFXFELDPGJ      CRTLYIADEOF     XFWPC          
ENMVIYTSFHPTWCN : OQXGG           RBQQ            PLGRY          
MLBNFBO         : NSNLIJE         DCHVPSJWLDK     EDFPOU          XFNXMAJS       
FTNQHPMNFBJNA   : USPWJWU         LUWGGXISXJTCOF 
IHOYELBTVPFAD   : KAQII           XLEEMQXAL       NJCPD           DMQNEENXVMVF   
DTYI            : LXMEVXLOYC      EVYGSP          ISDQFSOQTDYVQ   QFLAPWE         MLNVKQ         
NAWFOKLPV       : GFEORLXDPWA     AQQVRSYCTPVHYK  JRLICD          EVNBGSBESYQVRXI
SDKARLEEMACCGEH : DFIBRAJ         IFCMRK          BSQSSAK         BKGBEXRVTFFGT  
HBSQQI          : HUJOIQKUQE      MAHOOGFQBHB     FXMQBBIEUM      XNQPITDDGCJ     SNQHRSKDEMTWSVP FMKBHAXAQ      
NOHACWXFRBR     : UWRWQMLN        DFIBRAJ         DMELTAPFE       CUFSEWYTTMAIW   TPTMYNU        
SDYYRAC         : JJFSU           GQRTNE          JFPAGKJGDH      YHLLHGFAPQWMASF
IGDAOGUH        : XUXYXKGWTSRC    INQOOYTO        JDGM            WXHSW           WHQXBPPN        DQNLLFSTMVQS    QTVRVJNTMKYFKA 
ECMUJOYI        : DFIBRAJ         CUFSEWYTTMAIW   YKMJONGSJQLOLK 
EBNWVJAUISW     : GIXDYAX         KAFPRU          TDLUEF          GLXEXEOUTI      YKSKAAGHESOTF  
OFTUHKDDTDJVP   : FPGJ            SXFFK           WMLYJGNTAORNB   AEUOKRLENKAKC  
HFFPTJ          : XKAIOWFB       
KGOTJMCCLP      : SNXLR           TPTMYNU         WVAUFWTNAFUSUID
RLPBV           : LQVFLS          RSMLLBAFG      
GPWPNOV         : MBMUUDINRLQUMGX MPLAFPTWNI      RPDGHGDDA       LFRA           
VBKQLEBT        : EWDNQOABJBDU    RAVNENLVYB      LRJFPXYSPTAEU  
UDHYHTQDNC      : NRJYDKBAYKUIFM  IAYKYHBIKPV     NXOP           
OAOVRLNFBMA     : XMSDSSWQPXUB    UFLFLOQCH      
NNPBTQXO        : WOHLTKKNFOPVVG  HTIHCDS         JHXYLGQFLUQJK   NVQRPQDEQQTUPY 
BWNLSGO         : PMJRRBYDRJOBKW  PGRDJI          AUNMM          
JJWJYSEMJJP     : GONUXC          VWMKLWMVPVPX    MPRH            HGJJDKWJOBKIAG 
MPLAFPTWNI      : GPWPNOV         UPIVMIGQ        JWNLWULOJ       NSUDWDQY        TWTJLFOGNI     
QHCEAJU         : XJYXRCRRLCWE    VQUOFOOHLXMFK   NQSKSFLHC       AFAO            BOTPVSDOUIQMUX 
SFGEEYK         : JMDUNJIBHEHR    DEYGN           MYUTWUAVIPPIW  
KUJGHYUHEKDDALQ : USPWJWU         SSSANSXYNI      GRYWWIOWGDKEM   EQUVDYI         YKSKAAGHESOTF  
VSXVESF         : KBUWPKLWNR      JWFTDOESJDPF    HTLGRGIJLPKNVDN VWJXQIOLEODSC   MQODCQNHLESYN  
XLEEMQXAL       : IHOYELBTVPFAD  
IUGDEMPH        : WKSKLDFBVB      NORMXTGADKPLAD  MJCFT          
PVJJRCHP        : CWDY            MYFOYOOPHTTSDE  WAYYCSM        
AWGB            : XUXYXKGWTSRC   
MFXEFXRMG       : XMSDSSWQPXUB    NQFUTRIFPJF     GJFQS          
UMTICC          : VGWM            KYYMYDGHII      HMDAKVWYCUNTQR  GOTNYLDBA      
UAKERMNJVNHF    : NRWY            QYFRPF          LSTUB          
RTWRACPURYKMN   : TSTLUAU         KTVU           
UPIVMIGQ        : MPLAFPTWNI      UBWVBV          MPGCKCV         BUVTPHHHSKPVFM 
VEMT            : HUJOIQKUQE      ISDQFSOQTDYVQ   MYUTWUAVIPPIW  
TBLNVIGXNXSFWD  : ELRARGABW       RSERYYFCSOB     JMPNQL          WXHSW           CGEXJ           CJYBDWWN        XMUHJ          
MKPFSLRCULGQPSM : INYA            LOSAXQDTD       HMDAKVWYCUNTQR  ROVJNLXWCRSRXSE EWWSTWVTR      
OOYFMJLKWJECJJU : YSLGHUVGNEDTFTH FPMY            UFBFCEPUY       WTNHJV          DMIOJHXPFILDRFG
TMBPXVTUHANYV   : DDOUGV          LSGAMQUBRPHJQ   JBLPUM          AEUOKRLENKAKC   MKRVVSXTXTHHWD 
MKPNPCWDOUNUYY  : AFAO            XKAIOWFB        QDXIYXJHJLGNJ   TWTJLFOGNI     
VUBI            : PDRMBPDGRE      DRJARBAKP       XYYRBHA         PVISISJR        UBWVBV          BSPLFXYOOQRYMQ 
QHUMECNSB       : VGCPW           QXJEJIFDOALAA   NKRDQRHSLQF     DFSJGC          TWPNNACKFW      UEGRC           YKSDA          
TPVLDOPBRE      : KBUWPKLWNR      AUNMM           RNFEHIUSSIWCMY  WVAUFWTNAFUSUID NVQRPQDEQQTUPY 
HAWGHTEIEDCL    : EOUDVYVNJYMARAQ MAFBJNVINIBJ    DGTGGAJQLRP     NXOP           
OSCELF          : MVWY            YHQR            BKVMGCHJJ       IIIFG          
FXMQBBIEUM      : DCMSAVAIHMEDNIA HBSQQI          EEVDSEP         OXJNNYBFGWQUWB  EGQJVF          EIQYWCLXEQFSJB 
DMELTAPFE       : NOHACWXFRBR     BBEGLOGK        JGPCTGPFSNSJRS  AIKKOBJGRTBIMGD
JSSA            : STXREGCDSJEE    VFNGCBLONK     
WFWFUEDHWGKFL   : FOJHPJCRJUIFE   XUXYXKGWTSRC    VLNUJHILMT      HSOOMHLE        QKJQBRGOXWRSY  
RPLHTWBV        : UNAS            YSWACXJNWVXR    OLJXBVJCDYB    
IBITTEUFD       : IBVNDTWS        DICCWXU         JRLICD          XLQDXEKMXA      WKHVE          
CIYINJFUTK      : LJVYU           QATQVGQMKHWV    APIXXC          JFPAGKJGDH     
CCXNJUNNQBV     : AIFACXGNSAIMKA  FLGSCTIBTQJG   
LSLPPSVRWESFUCK : WPKKARVQ        EOWO            LUWGGXISXJTCOF  FMSLCJJOHBK     AKWCXIKUGP      MSITMBS         BYSNWMAQMLNWO  
YUXB            : QKMXDQDNJI      MTRBOFENHI      XLLTJFGGFV      JRLICD         
VRJS            : JNHHDTHLM       RONPOBBCXPBQNQ  BELUYG         
YKIXETQS        : LNGHISXJ        EDUXO           WMUR            RENC            DAHSWQSIN      
GLIALMSQHVE     : GSALWBMKTX      YWLQB           WWMQVAADTUHLVIT BXEJ           
UBWVBV          : GFEORLXDPWA     HUJOIQKUQE      UPIVMIGQ        VUBI            FTXILRHHL      
NOUMYDKEXBY     : PKNUIFDYGEMHTOU VYUTPGRTQE      WXHSW           GQUMKYBRESFLYU  PCYXEFMY        SEBTYAKXCS      FQISIKRPQX     
HKSHVHBP        : OYLCNNRFXCO     ALTVCMVIUHJYHN  JCLULJ          TJWQVVIVPO     
YTSTW           : RMGXEPWFDMDBYS  XRUMF           OEXO            YJYAAIUPVVHXEV  PLGRY          
RYOIMDDYFHKLH   : FPGJ            GSRNKOUCTYDSNWG
KTVU            : RTWRACPURYKMN   VWJXQIOLEODSC  
FTXILRHHL       : GXCKRMLCHP      TTSC            UBWVBV          YNYQHEEP       
EEVDSEP         : PFIOJLGYFOUAB   CJUHHOS         GHXWEPQFTKU     FXMQBBIEUM     
JRBSEMA         : MPRH            DWEFEPASOIHE    DFDHIJHANKU    
WVNUKVQJECB     : XKDEYTWTXCIN   
JMPNQL          : RBRYIBRXJKDSUY  TBLNVIGXNXSFWD  PCYXEFMY        KQBYQPSMR       AEET            BYSNWMAQMLNWO   MJCFT          
JRLICD          : ONHXMSQLTGF     NAWFOKLPV       IBITTEUFD       YUXB            XBELILBKJG     
UHYXAX          : EAJUFXUJBAKAAAC HTLGRGIJLPKNVDN
PSHLLQQNTFYJ    : DWCBRPTFTRMTXP  BNSGWLDXN      
NCHHOYUWD       : MTBODRKH        BRKTQWEXUDM    
IBIJYKIUBDCOPUH : IWEYO           KAQII           RGEXKBCKFWILU   RBSNNPGFTCTVQ   QEHBQFKOEI     
PMFBIUDRET      : JIENXP          EQUVDYI         MLNVKQ         
YSWACXJNWVXR    : EMYMYSYRLKA     RPLHTWBV       
CWOTRVBJJ       : PFIOJLGYFOUAB   QFUUIPUFFBS     KHRDAQT         SEBTYAKXCS      DQNLLFSTMVQS   
KTDQLHKCHEB     : RMWAGEAND       LTVMDHUP        OJVQQW         
IYSVVP          : XYXPSOF         AVRLPLMPOGB     DCMSAVAIHMEDNIA
QOYPFUHC        : YENGVOVLPNDKU   EWNNSXHTFW      LRJFPXYSPTAEU  
RNFEHIUSSIWCMY  : TPVLDOPBRE      RBLCIATGJXPT    DACDMH          GUMPUYGR       
WXHSW           : CVUYVTWDCLAGR   IGDAOGUH        TBLNVIGXNXSFWD  NOUMYDKEXBY    
PPNOFTLO        : FJSFWWSQYK      PKNUIFDYGEMHTOU
IILPNUX         : WKNGXNK         STXREGCDSJEE    GOTNYLDBA       MRMYMPIBGAIUJO  WVAUFWTNAFUSUID CVUMB           KBSPSFWSMFEWBM 
NQSKSFLHC       : EOIJAYDXAWAUTP  GDCXJOFIOBBXFBI RAVNENLVYB      QHCEAJU         BCSIEXXVNVHDJHA AEUOKRLENKAKC   DVCMQLVRSLIWUHX
OXJNNYBFGWQUWB  : DWCBRPTFTRMTXP  FXMQBBIEUM      EDWNHJEAF      
KQRFRCSKXGGD    : CMHWUNXAOWOC    YSEXOKN        
NICCIN          : OIMWWARWCVOWTU  KTJLPRACMBOV    MAFBJNVINIBJ    ISDQFSOQTDYVQ  
XMSDSSWQPXUB    : IEOQCTMQLWQASL  DWCBRPTFTRMTXP  OAOVRLNFBMA     MFXEFXRMG       MVWY            IOJDFTLJLAB    
OGLQCVOKC       : EOUDVYVNJYMARAQ VLJOKIHUVBHRA   HUJOIQKUQE      RHHCMQQTHS     
CRFHVNUL        : JUBISUQ         NOOET           DEYGN          
KHRDAQT         : UCAPHWAQ        IDMFQT          JRGP            VQIDD           XAYFHLETMX      CWOTRVBJJ       YHLLHGFAPQWMASF
QQUI            : SINKHCXODV      QMYYXKULBHU     FDDEPPYEMCNQ    VQIDD          
EVYGSP          : EETBUT          DTYI            OUYIAJUHIOJ     SPUP           
WMUR            : UNAS            YKIXETQS        PTKEOKREFGI     CGILVHNNEBPO    GUMPUYGR        LRJFPXYSPTAEU  
CNHXCVKJ        : HERTY           TSTLUAU        
NLGKFYDBKJF     : VVDINPVKULLAN  
INYA            : PGRDJI          MKPFSLRCULGQPSM BBEGLOGK        WMEQFHPXUOKVHW 
YNYQHEEP        : FTXILRHHL       LPOPPEHDNGXCQIF SNXLR           PHYHIUNY       
INOTDEFLQL      : JCHJYV          QKJQBRGOXWRSY  
UMWETE          : DFSJGC          DWEFEPASOIHE   
HFONEEOWMSE     : DACDMH          MKRVVSXTXTHHWD 
WMRNHWSOIJC     : UNAS            QICISDSHHN      RQYXCYLUDNARB  
GQUMKYBRESFLYU  : NOUMYDKEXBY     JWNLWULOJ       RTDRC           QEHBQFKOEI     
LPOPPEHDNGXCQIF : TFJAJKJADICI    YNYQHEEP        BTXNULOHKQFSBAB AMRJ            LDKBKTIAXCHNJCB TKRBFNNFYJ     
QXJEJIFDOALAA   : HVIKSIYATLDOBO  QHUMECNSB       OSNJKRIKYP      GJFQS          
NNXCENINTV      : EOUDVYVNJYMARAQ BSQSSAK        
RBLCIATGJXPT    : RNFEHIUSSIWCMY  TNFNVLG         VQBBODKPKX     
TJIHLKPYXNEE    : GXCKRMLCHP      XCJMUAWMYANQM   UEGRC           DDTESXKOALNCVFD
OSALPROB        : JMDUNJIBHEHR    GGGGWLDR       
WEQFPQVKVR      : QMXBBUBCPX      LAOA            MAFBJNVINIBJ    BOTPVSDOUIQMUX  BKDSNJLHDH     
GYHQQJP         : RHIYTWPJXFQ     XDRJA           QFLAPWE         KKMKFRW        
PTKEOKREFGI     : EDUXO           WMUR            AKWCXIKUGP      BKVMGCHJJ      
FMSLCJJOHBK     : QMXBBUBCPX      PKEUDOXJ        LSLPPSVRWESFUCK EDWNHJEAF       AEUOKRLENKAKC   BKGBEXRVTFFGT  
CUFSEWYTTMAIW   : NOHACWXFRBR     ECMUJOYI        HDWEQN         
PCYXEFMY        : VHOKTKYI        FWVXQFAYLQRP    YXUMHLDLYEGVUS  VLJOKIHUVBHRA   RBRYIBRXJKDSUY  NOUMYDKEXBY     JMPNQL          RHHCMQQTHS     
PCYXEFMY        : NSNLIJE         JVXMKXHNC       EHIWBPIVWIEN    OBIVXEG        
QICISDSHHN      : WMRNHWSOIJC     CHMOQEOHEA      VGENLHXPLSDYQ   UYHFXYHXHNBFYF 
CTOBNI          : LAOA            CQOOWLS         JJIJKDISWO     
OSNJKRIKYP      : QXJEJIFDOALAA   BSQSSAK         JBMJKCIPCRQWXX  WKHVE           HGJJDKWJOBKIAG 
XKQJM           : QKMXDQDNJI      YORLMSTQUKV     RCVMCMB        
CRTLYIADEOF     : NKVQBTWYGCFAJNA VYVSA          
YUJSKSFDDQEV    : FDDEPPYEMCNQ    QOHGJFLANPBA    NMXVOEAPPITGF  
CGILVHNNEBPO    : JNHHDTHLM       JQWGLWYWMJUG    WMUR            QFLAPWE        
SSSANSXYNI      : BVILKRY         XIXDESCAOY      XAYFHLETMX      KUJGHYUHEKDDALQ OBIVXEG        
SNXLR           : RQWMDB          TXVYQMPOYIYPKS  EOWO            WGABAJ          KGOTJMCCLP      YNYQHEEP        AFAO            MPGCKCV        
CWEKIAUYQYAGNE  : IOOEPLCPJD      GSALWBMKTX      NGIWUIL         STXREGCDSJEE    OLJXBVJCDYB     YXMKUWSKL      
GXCWSAV         : SQSTLTXBTHOHNV  GLBC            BOTPVSDOUIQMUX  AXNYOMXMWKXLD   RHGPSS         
KQBYQPSMR       : JMPNQL          TKRBFNNFYJ      DMHNMJ         
SEBTYAKXCS      : NOUMYDKEXBY     CWOTRVBJJ      
HTWHVTAVPI      : QIAVRYEPCIK     YWLQB           VIOPFFVBLYIXNTP NSUDWDQY        FMKBHAXAQ      
ILIYBBLSRHAU    : MPGCKCV         LTVMDHUP       
YUPAYIPGCMNYIP  : DCMSAVAIHMEDNIA WFYEYNM         DDTESXKOALNCVFD IOVHOUVVMVPATDX PLGRY          
BXEJ            : KBKQHQ          GLIALMSQHVE    
MJNOWHIEJD      : JVQQ            LOSAXQDTD      
IAYKYHBIKPV     : HYBOSVSIEH      FOJHPJCRJUIFE   EWDNQOABJBDU    UDHYHTQDNC     
YMICMNLWAWLQU   : TPTMYNU         NMXVOEAPPITGF   TVVILT          ILJAFEQULMRIB  
BBEGLOGK        : DCQMRSIWNF      DMELTAPFE       INYA           
ISDQFSOQTDYVQ   : DTYI            VEMT            NICCIN          HYFOKFNHMXFCFKA JRJQY           JFPAGKJGDH     
IPPFDICXKEEQP   : SEBLJKTESUEQKU  KBUWPKLWNR      DCHVPSJWLDK    
ACXIUBBCTPUOTU  : MPRH            PPMABRQ         KXUYYAFHJ       HUJOIQKUQE      RTYBDCPFU       HGDDOEWFPDJKR   XCJMUAWMYANQM  
MLUCBBGMDGWJ    : RQYXCYLUDNARB   CGEXJ           PHYHIUNY       
PBJPEJABKDGGVBU : EHLHFDS         EOIJAYDXAWAUTP  VOTAPRHOBDE     WLJDDJSIQXPAJA 
XIEKFINGOAMXWX  : TXVYQMPOYIYPKS  XCJMUAWMYANQM  
PAWHGGKJSNPYJRW : GEEIOCIDBUMAW  
RHHCMQQTHS      : KSLEJAGRV       JKDIYMLSMU      XERBEHBISSGYG   OGLQCVOKC       PCYXEFMY        XKDEYTWTXCIN    WKHVE          
FQISIKRPQX      : NOUMYDKEXBY     GJFQS           LSTUB          
BSQSSAK         : XYXPSOF         DWCBRPTFTRMTXP  LBDCVXRD        SDKARLEEMACCGEH NNXCENINTV      OSNJKRIKYP      JTWVX           XBELILBKJG     
EDWNHJEAF       : CFNOQTWNH       OXJNNYBFGWQUWB  FMSLCJJOHBK    
TPTMYNU         : NOHACWXFRBR     KGOTJMCCLP      YMICMNLWAWLQU  
FKDGNGYE        : WINBDHMYYYA     VYVSA           AHRBFAM        
TGKJMPIB        : BRKTQWEXUDM    
UHACVTUQGVEBH   : LJVYU           DEYGN          
NKRDQRHSLQF     : EOPTDRLMVF      QHUMECNSB       DQNLLFSTMVQS   
FUIIVF          : LEXGXDBQKIE     KGQTCYE         NUSNFDUAAGMFBL  LFWFRGRTPIIWOCX
VIOPFFVBLYIXNTP : ONHXMSQLTGF     WSIRDWJYEUXMKU  BWCABTVGVWW     DXYAPBDJBBAS    HTWHVTAVPI      YQMBYKXNHGEIJVX ITORFTQSBVV     MJCFT          
MJDFXTKXBH      : FJSFWWSQYK      MBMUUDINRLQUMGX EOWO           
KEOFCWTSEAQ     : HYCWSSMRNBW     PXPCCUGHVFB     YWRESQPEIVT    
NSNLIJE         : MLBNFBO         PCYXEFMY        MRMYMPIBGAIUJO  CTFNVUMARSKA    DWEFEPASOIHE   
YPEGPXTNC       : LDHHBLPQHLUG   
WOHLTKKNFOPVVG  : LAOA            NNPBTQXO        AIKKOBJGRTBIMGD FPPSOTBF       
JTWVX           : VLNUJHILMT      BSQSSAK         BKVMGCHJJ      
UQDBIEWWIY      : NQLJ            XRUMF           XLLTJFGGFV      YCHXKVBNWPECKA  XKDEYTWTXCIN    CTFNVUMARSKA   
WIJS            : OBGSAPRE        BOMXVOTOK       ELGE            HUJOIQKUQE      JWUHTSGFCJLNFT 
VGXMYWIF        : CWDY            OTLCYBJLBQQGB   MRMYMPIBGAIUJO  FRJHRYN        
TYLRAMMS        : AEET            JHXYLGQFLUQJK   KBSPSFWSMFEWBM 
QBXNAG          : VHOKTKYI        KBKQHQ          XEWDXTRVQPW     GPJOYVVY        HBDMWJEXIDHWB   INHCM           XFWPC          
VFXHXSFHT       : RHIYTWPJXFQ     FPMY            GYIPELGWXTRJBX  CMHWUNXAOWOC    MBWAJURGIJVOT   FLCRSCWN       
GSCNGWMTQOIEHD  : RMGXEPWFDMDBYS  SBYMJIBMFILFHM 
JBMJKCIPCRQWXX  : MTBODRKH        XLLTJFGGFV      OSNJKRIKYP      ROVJNLXWCRSRXSE EPSBAAWGAK      JJIJKDISWO      CJYBDWWN        XFNXMAJS       
PGLUTUTIOK      : UINCYCXAQDRCMLA YWADHLJTNQMHLKB UPCCSWV         NLBGEJBHNJ      HDWEQN          JSTWJ           JRJQY          
XQHDNQEBDQFNJJ  : XEWDXTRVQPW     MDRISARFYMBBSXP
AIFACXGNSAIMKA  : XVGEACCXCBXR    MPJHVJWPWBX     CCXNJUNNQBV     EWWSTWVTR      
IAOQDEJJHOBOE   : ONHXMSQLTGF     DICCWXU         DXYAPBDJBBAS    LGLKSLMSV       MPKENDKG       
AMKJRKLRSBK     : NCNDJLPECDBKINA HSOOMHLE        DGTGGAJQLRP     WJIHYQYNOVO     HGIYRPYTGPKYOYP ESABYCKRY       FGWX           
MYFOYOOPHTTSDE  : RQSUTYSJPKWROIJ PVJJRCHP        BTXNULOHKQFSBAB EPSBAAWGAK     
ESQQTDB         : EXCXMJSOMTALBKO KBUWPKLWNR      YHBPGPLDKOVM    CJYBDWWN       
XNQPITDDGCJ     : HXNMDXNUXW      HBSQQI          CHNCVAFNMK      RMWAGEAND       OPWYEVEHUIDAXAV DMQNEENXVMVF   
BALQJFNCLRO     : YSLGHUVGNEDTFTH ASQUHW          XDRJA          
MGHIL           : JHXYLGQFLUQJK  
NLBGEJBHNJ      : WCIXOUUMQR      PGLUTUTIOK      HTIHCDS         LRJFPXYSPTAEU  
YHNYSGIBTMMNEE  : OQXGG           MCGWMU          LFWFRGRTPIIWOCX VVDINPVKULLAN   WKXAMWSSQ      
KNJXYAKC        : HYBOSVSIEH      EOPTDRLMVF      UNAS           
OLJXBVJCDYB     : OKKT            PKEUDOXJ        LHSEJMVUDPQ     RPLHTWBV        CWEKIAUYQYAGNE  DDRHFTFUL       BUVTPHHHSKPVFM 
GLBC            : GXCWSAV         LSAJPKNF       
NQFUTRIFPJF     : MFXEFXRMG       VYHO            YTCBUTTCFMEO   
LOSAXQDTD       : MPRH            MKPFSLRCULGQPSM MJNOWHIEJD     
YCHXKVBNWPECKA  : ONHXMSQLTGF     EMYMYSYRLKA     PPCFOWIFBAGD    UQDBIEWWIY     
UFLFLOQCH       : PSXFMUELXTTNNTJ GXKDMD          OAOVRLNFBMA     QOHGJFLANPBA   
CBWWED          : FOJHPJCRJUIFE   HYCWSSMRNBW     MEAHGK         
IMXTIAHF        : RONPOBBCXPBQNQ  KSLEJAGRV       YITIS           PTHQUHPFB       DDRHFTFUL       NORMXTGADKPLAD  LSAJPKNF       
NJCPD           : HPVMLFAXI       IHOYELBTVPFAD  
UPCIGVKN        : PPCFOWIFBAGD    EPNBHRJIBCGGKQ 
NQLMWOK         : VYHXXI          LSAJPKNF       
CJAKJJSBYCFO    : HQGBOWL         FLGSCTIBTQJG    YKSDA           TJWQVVIVPO     
ELAJU           : HNDWVE          AJTXRTYV        JGPCTGPFSNSJRS  LAJDLAIIQYHP    BUVTPHHHSKPVFM 
FFVTUPI         : USPWJWU        
MWUSBEUOP       : WINBDHMYYYA     XDCFLS          TJWQVVIVPO     
HSHLAXVEKVPFE   : LTYSLLJW        EBTMNBJUKLHWU   SNQHRSKDEMTWSVP NNYWIGKKKFUOGSM
MDRISARFYMBBSXP : SQSD            KQXRKVOBWKOP    EMYMYSYRLKA     XQHDNQEBDQFNJJ  WHQXBPPN       
HYFOKFNHMXFCFKA : JJFSU           ISDQFSOQTDYVQ   KRAHYEACXNR    
NTCGVU          : WCIXOUUMQR      XERBEHBISSGYG   VYUTPGRTQE     
WHQXBPPN        : PSXFMUELXTTNNTJ PQRGVWYIOUT     MEADRBRVYQINRMT IGDAOGUH        MDRISARFYMBBSXP DQNLLFSTMVQS   
OTLCYBJLBQQGB   : QDYNDM          VGXMYWIF        AROVNGDVQCGY    CVUMB           KHNNWKWPWTN    
YQMBYKXNHGEIJVX : YSLGHUVGNEDTFTH VIOPFFVBLYIXNTP VYVSA           ESABYCKRY      
SNQHRSKDEMTWSVP : PPMABRQ         HBSQQI          HSHLAXVEKVPFE   GSRNKOUCTYDSNWG RBSNNPGFTCTVQ  
OEXO            : YTSTW           WFYEYNM        
VCYEIHN         : KBUWPKLWNR      OFMHFIKPSYUVMF  IDMFQT         
HNAWEJOWUR      : TFLXIPWVRKYDXRJ QIAVRYEPCIK    
HMDAKVWYCUNTQR  : GIXDYAX         EUPOLSTSFSRFUR  TFJAJKJADICI    UMTICC          MKPFSLRCULGQPSM
XBELILBKJG      : JRLICD          BSQSSAK         JDPMEQWQDN      XKAIOWFB        OPWYEVEHUIDAXAV
XFRQLYFRB       : TDLUEF          AHBIOWOYTBNCRY 
NXOP            : MPYTRJOQUP      UDHYHTQDNC      HAWGHTEIEDCL    JRSSPJOI        VNDOCISUYAIFSI  XMUHJ          
FLOWGMA         : FDDEPPYEMCNQ    RYXHI           MQODCQNHLESYN  
AKWCXIKUGP      : LSLPPSVRWESFUCK PTKEOKREFGI    
YENGVOVLPNDKU   : FNRSQYW         CWDY            QOYPFUHC       
BTXNULOHKQFSBAB : LPOPPEHDNGXCQIF MYFOYOOPHTTSDE 
MBWAJURGIJVOT   : IVIEPYEGCKUYJB  VFXHXSFHT      
GVMELH          : EOPTDRLMVF      OBGSAPRE        TDUUTFDTH       HTLGRGIJLPKNVDN CHNCVAFNMK      PTHQUHPFB      
ARCQWUTAWN      : MYOTLSTCBC      BDITNWCGDWXRK   ANRLJOFNR       EQUVDYI        
AMRJ            : FHTM            LPOPPEHDNGXCQIF PRUCFN          DAHSWQSIN      
JRSSPJOI        : XVXWA           MAFBJNVINIBJ    RUHSPKC         NXOP            EPSBAAWGAK      BSPLFXYOOQRYMQ 
MVWY            : AGNLVVEK        OSCELF          XMSDSSWQPXUB    TWLJRGNM       
OBWRUW          : HXLRWBNRNGL     XWQBUMQQUJ      ELGE            JDPMEQWQDN      MRMYMPIBGAIUJO 
OYLCNNRFXCO     : ELRARGABW       UFXFELDPGJ      HKSHVHBP        EPNBHRJIBCGGKQ 
WJIHYQYNOVO     : TSTLUAU         AMKJRKLRSBK    
LQVFLS          : IYQXYLC         GQKQJQITNBBEVPN RLPBV           FGDUWQMV       
ATIFIVW         : BDGESF          HTLGRGIJLPKNVDN RMWAGEAND       SPUP           
VYHO            : RSERYYFCSOB     HXNMDXNUXW      NQFUTRIFPJF     NORMXTGADKPLAD 
QYFRPF          : UAKERMNJVNHF    VFNGCBLONK      LDKBKTIAXCHNJCB WLJDDJSIQXPAJA 
HDWEQN          : CUFSEWYTTMAIW   PGLUTUTIOK      JBLPUM          CUQGATBN       
VYVSA           : XEWDXTRVQPW     KGQTCYE         CRTLYIADEOF     FKDGNGYE        YQMBYKXNHGEIJVX HJFYNG         
DHABEQXFA       : IBVNDTWS        RBQQ            BDITNWCGDWXRK   UFGUJSYYLR      VYYGJA         
DQNLLFSTMVQS    : VGCPW           SQSD            IGDAOGUH        CWOTRVBJJ       NKRDQRHSLQF     WHQXBPPN        HBDMWJEXIDHWB   RENC           
HTLGRGIJLPKNVDN : LAKDVVGXBEDHHF  VSXVESF         UHYXAX          GVMELH          ATIFIVW         IOJDFTLJLAB    
DCHVPSJWLDK     : MLBNFBO         IPPFDICXKEEQP   MPGCKCV         FPPSOTBF       
WFYEYNM         : YUPAYIPGCMNYIP  OEXO            ITORFTQSBVV     EIQYWCLXEQFSJB 
VVDINPVKULLAN   : AOWKGYCIRPUIT   UPCCSWV         NLGKFYDBKJF     YHNYSGIBTMMNEE  RSMLLBAFG      
VFNGCBLONK      : KWPLMJRYCLXQOY  VQUOFOOHLXMFK   HUJOIQKUQE      JSSA            QYFRPF          TKRBFNNFYJ      BNSGWLDXN      
MOVACPYAUHPMFA  : FILGWHESPIAYP   TDUUTFDTH       APIXXC         
QOHGJFLANPBA    : KJUNWEBQKTO     YUJSKSFDDQEV    UFLFLOQCH       QPJOQFFTLWEQSL 
OKCECXGGPFIMMX  : CYGWSYGMSWQMUA  QDXIYXJHJLGNJ  
TYIK            : GONUXC          RCVMCMB         KRAHYEACXNR    
RQYXCYLUDNARB   : BTMMSJYLNSAO    QXSAXGNBG       LAKDVVGXBEDHHF  WMRNHWSOIJC     MLUCBBGMDGWJ    LSGAMQUBRPHJQ  
XDCFLS          : MWUSBEUOP       PYGVCJMIJUYO   
TFARHTSPHIIXII  : EETBUT          SBYMJIBMFILFHM  CVFBQTGWTKKXCL  LTVMDHUP        CBUNOCO        
JVXMKXHNC       : FPMY            MPRH            MTRBOFENHI      IFYF            PCYXEFMY       
SEMEWAA         : FHTM           
AROVNGDVQCGY    : IAMMEUBIFHJATLW DMIOJHXPFILDRFG OTLCYBJLBQQGB   TMFIKCDEDBWSN   UEGRC          
SXFFK           : IDMFQT          EAJUFXUJBAKAAAC OFTUHKDDTDJVP   RBNPQAIVBYX    
OXHWQ           : HSHBY           LGLKSLMSV       CTFNVUMARSKA    ITORFTQSBVV     IIIFG          
JWNLWULOJ       : CYGWSYGMSWQMUA  MPLAFPTWNI      GQUMKYBRESFLYU  XLQDXEKMXA      FPPSOTBF       
EPNBHRJIBCGGKQ  : UPCIGVKN        OYLCNNRFXCO     INHCM          
YOWXHLIE        : TLOFWJE        
TBTISFUWUKAEFK  : UINCYCXAQDRCMLA ASQUHW          RBQQ            LGTEAF          QCDQMMGIMWABX   HJFYNG         
GOTNYLDBA       : UMTICC          IILPNUX         JUPKBRCGOXL    
YKMJONGSJQLOLK  : ITOVCXADAXQ     NDEVQLWCIKUGCG  ECMUJOYI        LSTUB          
XLQDXEKMXA      : OIMWWARWCVOWTU  IBITTEUFD       JWNLWULOJ       CHMOQEOHEA      CVFBQTGWTKKXCL  DAHSWQSIN       EIQYWCLXEQFSJB 
JDPMEQWQDN      : LNHSCDEP        LXFLKL          VQUOFOOHLXMFK   KQXRKVOBWKOP    XBELILBKJG      OBWRUW          QFLAPWE         WKHVE          
JGPCTGPFSNSJRS  : DMELTAPFE       ELAJU           DFSJGC         
CHNCVAFNMK      : KXUYYAFHJ       XNQPITDDGCJ     GVMELH          DMQNEENXVMVF   
LDKBKTIAXCHNJCB : PENQAFCBHPQYAF  LPOPPEHDNGXCQIF QYFRPF          TUWNORPLNTYRARC
NSUDWDQY        : TDLUEF          PENQAFCBHPQYAF  MPLAFPTWNI      HTWHVTAVPI      MLNVKQ         
SFPH            : VYHXXI          XVGEACCXCBXR    IDMFQT          GHXWEPQFTKU    
WSUHUHDFIBH     : RBQQ            LGTEAF          NRAUSNJRBVNKWG 
QTVRVJNTMKYFKA  : HXLRWBNRNGL     IGDAOGUH        KTGTU           MJCFT          
RRGJQCGAY       : YITIS           MSTGEQKXM       MOGTMJJQ       
DEYGN           : KTJLPRACMBOV    SFGEEYK         CRFHVNUL        UHACVTUQGVEBH   PRUCFN         
YHQR            : EUPOLSTSFSRFUR  OSCELF         
AFAO            : QHCEAJU         MKPNPCWDOUNUYY  SNXLR           JWUHTSGFCJLNFT 
YTCBUTTCFMEO    : NQFUTRIFPJF     VWJXQIOLEODSC  
DFSJGC          : QHUMECNSB       UMWETE          JGPCTGPFSNSJRS  YKSKAAGHESOTF  
YBFPSLRALGSMA   : MVLLJQASNIH     AQQVRSYCTPVHYK  RAKUWYSQKUS    
NVTJAYW         : DICCWXU        
PKLUFUB         : FHTM           
RCJWTEILF       : QBVQVRHLOQNAN   UFBFCEPUY       ITORFTQSBVV    
RAKUWYSQKUS     : INSMYTPTJCCCVEE CMHWUNXAOWOC    YBFPSLRALGSMA   PLGRY          
BKVMGCHJJ       : OSCELF          PTKEOKREFGI     JTWVX          
OUYIAJUHIOJ     : APIXXC          EVYGSP          PRUCFN         
LGTEAF          : PDRMBPDGRE      TBTISFUWUKAEFK  WSUHUHDFIBH     AIKKOBJGRTBIMGD
UQCFNONRVADXOYY : RCVMCMB         EDHJRKEKO       KBSPSFWSMFEWBM 
YITIS           : HQGBOWL         IMXTIAHF        RRGJQCGAY       DDTESXKOALNCVFD
RMWAGEAND       : KJUNWEBQKTO     LUWGGXISXJTCOF  KTDQLHKCHEB     XNQPITDDGCJ     ATIFIVW         GMCQDBOHMMLFTG 
FGDUWQMV        : KYIGIXKHBLJROC  LXFLKL          LQVFLS          FRJHRYN         BNSGWLDXN      
PTHQUHPFB       : RUHSPKC         IMXTIAHF        GVMELH         
YORLMSTQUKV     : XLHHCYAWNHVB    XKQJM           MQODCQNHLESYN  
RCVMCMB         : DICCWXU         XKQJM           TYIK            UQCFNONRVADXOYY IIIFG           TVVILT          JCLULJ         
GSRNKOUCTYDSNWG : NCNDJLPECDBKINA FHJEXWTOXF      RYOIMDDYFHKLH   SNQHRSKDEMTWSVP OWVCVOVXITPRB  
RBSNNPGFTCTVQ   : UYNDOQGO        IBIJYKIUBDCOPUH SNQHRSKDEMTWSVP TLOFWJE        
TWPNNACKFW      : XUXYXKGWTSRC    INQOOYTO        QHUMECNSB       EQUVDYI        
KRAHYEACXNR     : MCGWMU          HYFOKFNHMXFCFKA TYIK            MQTIF          
VWJXQIOLEODSC   : FILGWHESPIAYP   VSXVESF         KTVU            YTCBUTTCFMEO    LSAJPKNF       
WOLVBV          : YWADHLJTNQMHLKB JFVFTBTWSSCRX   HUJOIQKUQE     
DDRHFTFUL       : RAVNENLVYB      OLJXBVJCDYB     IMXTIAHF       
QKJQBRGOXWRSY   : DCQMRSIWNF      INQOOYTO        TFJAJKJADICI    AGNLVVEK        QNEXOAKEBTAN    WFWFUEDHWGKFL   INOTDEFLQL      CVFBQTGWTKKXCL 
QKJQBRGOXWRSY   : TJWQVVIVPO     
QPJOQFFTLWEQSL  : QOHGJFLANPBA    EHIWBPIVWIEN   
GJFQS           : WCIXOUUMQR      MFXEFXRMG       QXJEJIFDOALAA   FQISIKRPQX     
TMFIKCDEDBWSN   : UJKBHYKXLU      UYNDOQGO        WGABAJ          AROVNGDVQCGY   
MSTGEQKXM       : SWLFQAPOGSJVYW  INSMYTPTJCCCVEE RRGJQCGAY       DCKXQKRX        RILCSIJMDU     
MSITMBS         : VLJOKIHUVBHRA   LSLPPSVRWESFUCK XKAIOWFB        XJVYUB          EWWSTWVTR      
PXPCCUGHVFB     : LJVYU           KEOFCWTSEAQ    
TNFNVLG         : BELUYG          RBLCIATGJXPT    CNROWFAD        EQUVDYI         IHUT           
LSGAMQUBRPHJQ   : FHJEXWTOXF      TMBPXVTUHANYV   RQYXCYLUDNARB   WMEQFHPXUOKVHW  ESABYCKRY      
LSTUB           : UAKERMNJVNHF    FQISIKRPQX      YKMJONGSJQLOLK  TJWQVVIVPO     
AEET            : PGRDJI          JMPNQL          TYLRAMMS       
LHPXQYLJHMXXJY  : QMXBBUBCPX      ESABYCKRY      
YHBPGPLDKOVM    : URMSAAUHDTMGNEI ESQQTDB         RILCSIJMDU      FGWX           
CHMOQEOHEA      : QICISDSHHN      XLQDXEKMXA      MPKENDKG       
NORMXTGADKPLAD  : DDFTUEMGMWBIF   UWRWQMLN        IUGDEMPH        IMXTIAHF        VYHO           
MRMYMPIBGAIUJO  : SWLFQAPOGSJVYW  IILPNUX         NSNLIJE         VGXMYWIF        OBWRUW         
DCKXQKRX        : DDFTUEMGMWBIF   IOOEPLCPJD      MSTGEQKXM      
WKDIKGXWBMXP    : LTYSLLJW       
HTIHCDS         : NNPBTQXO        NLBGEJBHNJ      BKGBEXRVTFFGT  
BYSNWMAQMLNWO   : BELUYG          LSLPPSVRWESFUCK JMPNQL          APFMSX         
JWVGALGQNNK     : OQXGG           ASCKR           BGTIGAD         HGDDOEWFPDJKR  
WMEQFHPXUOKVHW  : EXCXMJSOMTALBKO AOWKGYCIRPUIT   JRGP            VQUOFOOHLXMFK   INYA            LSGAMQUBRPHJQ   YJYAAIUPVVHXEV 
WVAUFWTNAFUSUID : KGOTJMCCLP      TPVLDOPBRE      IILPNUX        
GRYWWIOWGDKEM   : WJXBEJQQQSOFX   PQRGVWYIOUT     KUJGHYUHEKDDALQ TLOFWJE        
NJGNELMAAOF     : WCIXOUUMQR      WPKKARVQ       
HBDMWJEXIDHWB   : XVGEACCXCBXR    WHMSFIBJ        QBXNAG          DQNLLFSTMVQS   
CNROWFAD        : SYODUFUIIJF     DIQHKTUBXGVF    TNFNVLG         PHYHIUNY        OJVQQW          MLNVKQ         
FRJHRYN         : VGCPW           VGXMYWIF        FGDUWQMV        MQODCQNHLESYN  
GQRTNE          : KYIGIXKHBLJROC  PKNUIFDYGEMHTOU AUNMM           SDYYRAC        
MOGTMJJQ        : QBVQVRHLOQNAN   JRGP            LCELRRLNIAR     DMIOJHXPFILDRFG RRGJQCGAY      
BGTIGAD         : OBGSAPRE        HNDWVE          JWVGALGQNNK     DAHSWQSIN       CBUNOCO        
ROVJNLXWCRSRXSE : MKPFSLRCULGQPSM JBMJKCIPCRQWXX 
YAAIJSH         : XWQBUMQQUJ      QDXIYXJHJLGNJ  
BCSIEXXVNVHDJHA : HVIKSIYATLDOBO  NQSKSFLHC       NTHUOQNKPY      CJYBDWWN       
YSEXOKN         : HPVMLFAXI       IOOEPLCPJD      QATQVGQMKHWV    PQRGVWYIOUT     KQRFRCSKXGGD    JHXYLGQFLUQJK  
NNYWIGKKKFUOGSM : USGQSOHTVL      HSHLAXVEKVPFE   FLGSCTIBTQJG    NVQRPQDEQQTUPY 
RTYBDCPFU       : XLHHCYAWNHVB    DICCWXU         AUNMM           ACXIUBBCTPUOTU 
FLGSCTIBTQJG    : CCXNJUNNQBV     CJAKJJSBYCFO    NNYWIGKKKFUOGSM INYHYLMVKMTJBSJ
ULVLRRY         : IDMFQT          MAHOOGFQBHB    
JUPKBRCGOXL     : GOTNYLDBA       TWLJRGNM       
HGDDOEWFPDJKR   : EHLHFDS         ACXIUBBCTPUOTU  JWVGALGQNNK    
YJYAAIUPVVHXEV  : CIVGAG          GHXWEPQFTKU     YTSTW           WMEQFHPXUOKVHW  TTDKGFGPSRFO   
PYGVCJMIJUYO    : KXANVYKXNMD     URMSAAUHDTMGNEI XDCFLS          CUQGATBN       
LGLKSLMSV       : JBWNSMJVFXIDDY  IAOQDEJJHOBOE   OXHWQ           CBUNOCO        
KTGTU           : SYODUFUIIJF     RBQQ            TQIOF           QTVRVJNTMKYFKA 
RTDRC           : XJYXRCRRLCWE    GQUMKYBRESFLYU 
TLOFWJE         : YOWXHLIE        RBSNNPGFTCTVQ   GRYWWIOWGDKEM  
PRUCFN          : JVQQ            AMRJ            DEYGN           OUYIAJUHIOJ    
RILCSIJMDU      : TDUUTFDTH       MPJHVJWPWBX     MSTGEQKXM       YHBPGPLDKOVM   
WAYYCSM         : HSHBY           SWLFQAPOGSJVYW  PVJJRCHP        MPKENDKG       
XKDEYTWTXCIN    : OFMHFIKPSYUVMF  WVNUKVQJECB     RHHCMQQTHS      UQDBIEWWIY     
SBYMJIBMFILFHM  : DIYJD           GSCNGWMTQOIEHD  TFARHTSPHIIXII  EDFPOU          TWLJRGNM       
DACDMH          : HSHBY           LHSEJMVUDPQ     RNFEHIUSSIWCMY  HFONEEOWMSE     IOJDFTLJLAB    
LDHHBLPQHLUG    : RNJFQFFLCA      UHQUIE          ISNHYDXEWKC     MCSVRJFYF       YPEGPXTNC       QDXIYXJHJLGNJ  
GOBTVM          : EDUXO          
CVUMB           : IILPNUX         OTLCYBJLBQQGB   TWTJLFOGNI     
QFLAPWE         : LNGHISXJ        KSLEJAGRV       DTYI            GYHQQJP         CGILVHNNEBPO    JDPMEQWQDN     
EHIWBPIVWIEN    : PCYXEFMY        QPJOQFFTLWEQSL  DDTESXKOALNCVFD YWRESQPEIVT    
XKAIOWFB        : XIXDESCAOY      HFFPTJ          MKPNPCWDOUNUYY  XBELILBKJG      MSITMBS         VRPRKYCU        RNTQLOQ        
CTFNVUMARSKA    : PENQAFCBHPQYAF  NSNLIJE         UQDBIEWWIY      OXHWQ           CBUNOCO        
LSAJPKNF        : VQIDD           GLBC            IMXTIAHF        NQLMWOK         VWJXQIOLEODSC  
OPWYEVEHUIDAXAV : NCNDJLPECDBKINA BDGESF          XNQPITDDGCJ     XBELILBKJG      IOJDFTLJLAB    
APFMSX          : HERTY           WKSKLDFBVB      BYSNWMAQMLNWO   MLNVKQ         
LAJDLAIIQYHP    : OFLFCJMECDK     ELAJU          
EVNBGSBESYQVRXI : LAKDVVGXBEDHHF  JXKENUOML       NAWFOKLPV       YGGK           
XJVYUB          : HSOOMHLE        MSITMBS         INDPMURVCKNVY   MQODCQNHLESYN  
WJUNKCFSIDI     : MAFBJNVINIBJ    UYNDOQGO        CYGWSYGMSWQMUA 
JBLPUM          : KWPLMJRYCLXQOY  URCCRNBRHD      TMBPXVTUHANYV   HDWEQN          NHRXTLWNWJU    
QEHBQFKOEI      : VTWCLSFJTEXEDM  RORDLOTVBRATWP  XJYXRCRRLCWE    CYGWSYGMSWQMUA  IBIJYKIUBDCOPUH GQUMKYBRESFLYU 
QFCLVOQDJYH     : SWLFQAPOGSJVYW  UHALWNAKQK     
JSTWJ           : MTBODRKH        LGRVGJYIU       PGLUTUTIOK      QDXIYXJHJLGNJ   HGIYRPYTGPKYOYP NVQRPQDEQQTUPY 
JRJQY           : LEXGXDBQKIE     ISDQFSOQTDYVQ   PGLUTUTIOK      WKHVE           GLXEXEOUTI     
JHXYLGQFLUQJK   : HQGBOWL         NNPBTQXO        TYLRAMMS        MGHIL           YSEXOKN        
NTHUOQNKPY      : BCSIEXXVNVHDJHA
BRKTQWEXUDM     : XEWDXTRVQPW     RUHSPKC         NUSNFDUAAGMFBL  NCHHOYUWD       TGKJMPIB        DAGF            RHGPSS         
VRPRKYCU        : PDRMBPDGRE      KXANVYKXNMD     GYIPELGWXTRJBX  RBRYIBRXJKDSUY  XKAIOWFB       
XCJMUAWMYANQM   : TJIHLKPYXNEE    ACXIUBBCTPUOTU  XIEKFINGOAMXWX 
KKMKFRW         : VGWM            GYHQQJP        
NQYHEXJYLKDUYA  : GXKDMD          HUJOIQKUQE      KBSPSFWSMFEWBM  GLXEXEOUTI      TUWNORPLNTYRARC
WMWYANMKXWWJE   : CVUYVTWDCLAGR   RQSUTYSJPKWROIJ
INHCM           : AFQYHCQCAXAFC   QBXNAG          EPNBHRJIBCGGKQ 
INYHYLMVKMTJBSJ : FLGSCTIBTQJG   
GXOHWLQBFBPMFE  : VNDOCISUYAIFSI 
NRAUSNJRBVNKWG  : FOFMWE          WSUHUHDFIBH     QJDHRRRUCTTC   
BOTPVSDOUIQMUX  : IYQXYLC         QHCEAJU         WEQFPQVKVR      GXCWSAV        
WMLYJGNTAORNB   : YXUMHLDLYEGVUS  OFTUHKDDTDJVP  
VASL            : JKDIYMLSMU      JWUHTSGFCJLNFT 
KHNNWKWPWTN     : PPMABRQ         OTLCYBJLBQQGB  
QCDQMMGIMWABX   : GGGGWLDR        TBTISFUWUKAEFK 
YXMKUWSKL       : CWEKIAUYQYAGNE 
WKHVE           : VLJOKIHUVBHRA   HUJOIQKUQE      IBITTEUFD       OSNJKRIKYP      RHHCMQQTHS      JDPMEQWQDN      JRJQY          
NXARO           : ONHXMSQLTGF     YWLQB           LGRVGJYIU       CIDMVTPFBJBE   
EWWSTWVTR       : QMXBBUBCPX      MAFBJNVINIBJ    MKPFSLRCULGQPSM AIFACXGNSAIMKA  MSITMBS         RYXHI           MYUTWUAVIPPIW  
UEGRC           : ICSOVXFAQOGJVYF FXDXRINYXLYPCNO QHUMECNSB       TJIHLKPYXNEE    AROVNGDVQCGY    PHYHIUNY        DVCMQLVRSLIWUHX
EPSBAAWGAK      : MVLLJQASNIH     JBMJKCIPCRQWXX  MYFOYOOPHTTSDE  JRSSPJOI       
AEUOKRLENKAKC   : RUHSPKC         OFTUHKDDTDJVP   TMBPXVTUHANYV   NQSKSFLHC       FMSLCJJOHBK     JIENXP         
HJFYNG          : BRVVWISBNSXBURJ TQIOF           JXKENUOML       VYVSA           TBTISFUWUKAEFK 
DAGF            : BRKTQWEXUDM     BKDSNJLHDH     
FLCRSCWN        : EXCXMJSOMTALBKO KAQII           IVIEPYEGCKUYJB  VFXHXSFHT       RBNPQAIVBYX    
JIENXP          : NXTEOLPNOCRRDEM PMFBIUDRET      AEUOKRLENKAKC  
ITORFTQSBVV     : VIOPFFVBLYIXNTP WFYEYNM         OXHWQ           RCJWTEILF      
EDHJRKEKO       : UQCFNONRVADXOYY
AIKKOBJGRTBIMGD : OFLFCJMECDK     DMELTAPFE       WOHLTKKNFOPVVG  LGTEAF          HGIYRPYTGPKYOYP
CGEXJ           : GHXWEPQFTKU     TBLNVIGXNXSFWD  MLUCBBGMDGWJ   
EQUVDYI         : STXREGCDSJEE    LFWFRGRTPIIWOCX KUJGHYUHEKDDALQ PMFBIUDRET      ARCQWUTAWN      TWPNNACKFW      TNFNVLG         LRJFPXYSPTAEU  
CIDMVTPFBJBE    : XLHHCYAWNHVB    EOWO            IUNHDIWAESLB    AUNMM           NXARO           TWTJLFOGNI      PIWTKKMQJATJ   
NMXVOEAPPITGF   : UNAS            HSOOMHLE        YUJSKSFDDQEV    YMICMNLWAWLQU  
MEAHGK          : LAOA            CBWWED          UGJATGMIJ      
VGENLHXPLSDYQ   : QICISDSHHN     
PUBF            : ITUTRUO         APIXXC         
KBSPSFWSMFEWBM  : FILGWHESPIAYP   KAQII           FDDEPPYEMCNQ    XDRJA           IILPNUX         TYLRAMMS        UQCFNONRVADXOYY NQYHEXJYLKDUYA 
RBNPQAIVBYX     : PVISISJR        SXFFK           FLCRSCWN        RNTQLOQ         MLNVKQ         
VYYGJA          : DHABEQXFA      
CVFBQTGWTKKXCL  : MBDLGLHDFTW     TFARHTSPHIIXII  XLQDXEKMXA      QKJQBRGOXWRSY  
RENC            : DDFTUEMGMWBIF   PKNUIFDYGEMHTOU XJYXRCRRLCWE    YKIXETQS        DQNLLFSTMVQS   
QDXIYXJHJLGNJ   : MKPNPCWDOUNUYY  OKCECXGGPFIMMX  YAAIJSH         LDHHBLPQHLUG    JSTWJ          
OBIVXEG         : OFMHFIKPSYUVMF  PCYXEFMY        SSSANSXYNI     
EIVP            : VLNUJHILMT      JQWGLWYWMJUG    QTLBMIQ        
AGGBWJBH        : TXVYQMPOYIYPKS  GFEORLXDPWA     EBXPX           EGQJVF         
BSPLFXYOOQRYMQ  : NGIWUIL         GDCXJOFIOBBXFBI GPJOYVVY        VUBI            JRSSPJOI       
UYHFXYHXHNBFYF  : YFBTRY          QICISDSHHN     
HGIYRPYTGPKYOYP : FPMY            EMYMYSYRLKA     AMKJRKLRSBK     JSTWJ           AIKKOBJGRTBIMGD
VQBBODKPKX      : IBVNDTWS        GRGPLHKQM       CFNOQTWNH       RBLCIATGJXPT    WLJDDJSIQXPAJA 
RYXHI           : FLOWGMA         EWWSTWVTR      
PHYHIUNY        : VGCPW           YNYQHEEP        MLUCBBGMDGWJ    CNROWFAD        UEGRC           LBAVDTL         BKDSNJLHDH     
MPGCKCV         : BOMXVOTOK       UPIVMIGQ        SNXLR           ILIYBBLSRHAU    DCHVPSJWLDK    
DMQNEENXVMVF    : FILGWHESPIAYP   MEADRBRVYQINRMT IHOYELBTVPFAD   XNQPITDDGCJ     CHNCVAFNMK     
DWEFEPASOIHE    : RHIYTWPJXFQ     JRBSEMA         UMWETE          NSNLIJE        
MQTIF           : KRAHYEACXNR    
WXPCCFABUXGREEY : FXDXRINYXLYPCNO LFWFRGRTPIIWOCX
IOJDFTLJLAB     : XEWDXTRVQPW     XMSDSSWQPXUB    HTLGRGIJLPKNVDN DACDMH          OPWYEVEHUIDAXAV
IIIFG           : SWLFQAPOGSJVYW  OSCELF          OXHWQ           RCVMCMB         EGQJVF         
JJIJKDISWO      : IBVNDTWS        SQSD            ANRLJOFNR       CTOBNI          JBMJKCIPCRQWXX 
VXIMJNREBERBHBL : UCAPHWAQ        EUPOLSTSFSRFUR  VDCBOIYBLNGQN   ANRLJOFNR       LAKDVVGXBEDHHF 
LTVMDHUP        : BVILKRY         INQOOYTO        XRUMF           KTDQLHKCHEB     ILIYBBLSRHAU    TFARHTSPHIIXII 
AXNYOMXMWKXLD   : GXCWSAV        
OJVQQW          : JNHHDTHLM       XAYFHLETMX      KTDQLHKCHEB     CNROWFAD       
GLXEXEOUTI      : NGIWUIL         EBNWVJAUISW     JRJQY           NQYHEXJYLKDUYA 
TVVILT          : NOOET           UINCYCXAQDRCMLA JDGM            YMICMNLWAWLQU   RCVMCMB        
IHUT            : JVQQ            LNGHISXJ        XIXDESCAOY      TNFNVLG        
ALTVCMVIUHJYHN  : QOHSACBJWF      EMYMYSYRLKA     JXKENUOML       HKSHVHBP       
CJYBDWWN        : JODFHQ          TXVYQMPOYIYPKS  TBLNVIGXNXSFWD  JBMJKCIPCRQWXX  ESQQTDB         BCSIEXXVNVHDJHA
TKRBFNNFYJ      : UJKBHYKXLU      LPOPPEHDNGXCQIF KQBYQPSMR       VFNGCBLONK     
DVCMQLVRSLIWUHX : OFMHFIKPSYUVMF  NQSKSFLHC       UEGRC          
EWNNSXHTFW      : QOYPFUHC        OWVCVOVXITPRB  
NYSTCQVQJHMCA   : UMGPVRG         DMHNMJ         
MYUTWUAVIPPIW   : AUNMM           SFGEEYK         VEMT            EWWSTWVTR      
OWVCVOVXITPRB   : FHTM            PKEUDOXJ        AOWKGYCIRPUIT   GSRNKOUCTYDSNWG EWNNSXHTFW      FGWX           
VDFICACBXF      : HERTY           EAJUFXUJBAKAAAC UGJATGMIJ      
GUMPUYGR        : WIPHVFBXHNAVL   IAMMEUBIFHJATLW RONPOBBCXPBQNQ  MBMUUDINRLQUMGX LUWGGXISXJTCOF  RNFEHIUSSIWCMY  WMUR           
KNNGNVCFQFKMK   : GQKQJQITNBBEVPN
VOTAPRHOBDE     : UNYJXTBUXYUBAUR PBJPEJABKDGGVBU RRQRSLHMNN      QUQXOTADLLHY   
XFWPC           : AJTXRTYV        JDGM            NKVQBTWYGCFAJNA QBXNAG         
FPPSOTBF        : IWEYO           PKEUDOXJ        RMGXEPWFDMDBYS  WOHLTKKNFOPVVG  DCHVPSJWLDK     JWNLWULOJ      
LRJFPXYSPTAEU   : VBKQLEBT        QOYPFUHC        WMUR            NLBGEJBHNJ      EQUVDYI        
INDPMURVCKNVY   : XJVYUB         
YGGK            : MYOTLSTCBC      TYCB            EVNBGSBESYQVRXI
RRQRSLHMNN      : HXLRWBNRNGL     MPYTRJOQUP      JFVFTBTWSSCRX   VOTAPRHOBDE    
TYWYOJUJHWTUUUC : UCAPHWAQ        EETBUT          BUVTPHHHSKPVFM 
BKGBEXRVTFFGT   : JBWNSMJVFXIDDY  UJKBHYKXLU      SDKARLEEMACCGEH FMSLCJJOHBK     HTIHCDS        
SPUP            : UFXFELDPGJ      EVYGSP          ATIFIVW        
JCLULJ          : EOUDVYVNJYMARAQ DEYJEOTQ        OFMHFIKPSYUVMF  NUSNFDUAAGMFBL  HKSHVHBP        RCVMCMB        
HGJJDKWJOBKIAG  : SQSTLTXBTHOHNV  JJWJYSEMJJP     OSNJKRIKYP     
FMKBHAXAQ       : HBSQQI          HTWHVTAVPI     
EDFPOU          : QBVQVRHLOQNAN   FHTM            MLBNFBO         SBYMJIBMFILFHM 
UGJATGMIJ       : BTMMSJYLNSAO    PPMABRQ         MEAHGK          VDFICACBXF     
QJDHRRRUCTTC    : QIAVRYEPCIK     UWRWQMLN        NRAUSNJRBVNKWG 
EGQJVF          : HYBOSVSIEH      LOWI            XLHHCYAWNHVB    FXMQBBIEUM      AGGBWJBH        IIIFG          
TCPDFJLRTUOM    : PSXFMUELXTTNNTJ NHRXTLWNWJU    
TUWNORPLNTYRARC : LDKBKTIAXCHNJCB NQYHEXJYLKDUYA 
YKSDA           : JRGP            QHUMECNSB       CJAKJJSBYCFO   
ILJAFEQULMRIB   : IOOEPLCPJD      YMICMNLWAWLQU  
DSTQNUJPMNO     : SINKHCXODV      WKNGXNK        
AHRBFAM         : KXUYYAFHJ       FKDGNGYE       
BUVTPHHHSKPVFM  : HQGBOWL         INQOOYTO        UPIVMIGQ        OLJXBVJCDYB     ELAJU           TYWYOJUJHWTUUUC
UHALWNAKQK      : LXMEVXLOYC      LGRVGJYIU       QFCLVOQDJYH    
RPDGHGDDA       : GPWPNOV        
MJCFT           : LUWGGXISXJTCOF  IUGDEMPH        JMPNQL          VIOPFFVBLYIXNTP QTVRVJNTMKYFKA 
DAHSWQSIN       : BRVVWISBNSXBURJ LXMEVXLOYC      GHXWEPQFTKU     YKIXETQS        AMRJ            XLQDXEKMXA      BGTIGAD        
LBAVDTL         : XYXPSOF         VDCBOIYBLNGQN   PHYHIUNY        QQHSI          
CUQGATBN        : HDWEQN          PYGVCJMIJUYO    MLEUQL         
ESABYCKRY       : AMKJRKLRSBK     YQMBYKXNHGEIJVX LSGAMQUBRPHJQ   LHPXQYLJHMXXJY 
MKRVVSXTXTHHWD  : URMSAAUHDTMGNEI TMBPXVTUHANYV   HFONEEOWMSE    
DDTESXKOALNCVFD : TJIHLKPYXNEE    YUPAYIPGCMNYIP  YITIS           EHIWBPIVWIEN   
RNTQLOQ         : EOUDVYVNJYMARAQ VYHXXI          FDDEPPYEMCNQ    XKAIOWFB        RBNPQAIVBYX     CBUNOCO        
MLNVKQ          : NDEVQLWCIKUGCG  DDOUGV          DTYI            PMFBIUDRET      NSUDWDQY        CNROWFAD        APFMSX          RBNPQAIVBYX    
NVQRPQDEQQTUPY  : GIXDYAX         BRVVWISBNSXBURJ JWFTDOESJDPF    IFCMRK          NNPBTQXO        TPVLDOPBRE      NNYWIGKKKFUOGSM JSTWJ          
RSMLLBAFG       : FILGWHESPIAYP   RLPBV           VVDINPVKULLAN   YWRESQPEIVT    
QTLBMIQ         : MYOTLSTCBC      EIVP           
BKDSNJLHDH      : JODFHQ          KGQTCYE         WEQFPQVKVR      DAGF            PHYHIUNY       
EIQYWCLXEQFSJB  : FHJEXWTOXF      KXANVYKXNMD     FXMQBBIEUM      WFYEYNM         XLQDXEKMXA     
MQODCQNHLESYN   : VSXVESF         FLOWGMA         YORLMSTQUKV     FRJHRYN         XJVYUB         
GMCQDBOHMMLFTG  : GYIPELGWXTRJBX  RMWAGEAND      
VNDOCISUYAIFSI  : QOHSACBJWF      ISNHYDXEWKC     NXOP            GXOHWLQBFBPMFE 
QQHSI           : WPKKARVQ        JDGM            LBAVDTL         YKSKAAGHESOTF  
TWTJLFOGNI      : OBGSAPRE        MPLAFPTWNI      MKPNPCWDOUNUYY  CVUMB           CIDMVTPFBJBE   
BNSGWLDXN       : PSHLLQQNTFYJ    VFNGCBLONK      FGDUWQMV       
FGWX            : XYYRBHA         AMKJRKLRSBK     YHBPGPLDKOVM    OWVCVOVXITPRB  
NHRXTLWNWJU     : BVILKRY         FWODVLHBTAJHVGI MTRBOFENHI      JBLPUM          TCPDFJLRTUOM    JFPAGKJGDH     
PIWTKKMQJATJ    : LTYSLLJW        CIDMVTPFBJBE   
IOVHOUVVMVPATDX : MBMUUDINRLQUMGX WINBDHMYYYA     YUPAYIPGCMNYIP 
XMUHJ           : BDGESF          XRUMF           TBLNVIGXNXSFWD  NXOP           
TTDKGFGPSRFO    : JNHHDTHLM       HXLRWBNRNGL     YJYAAIUPVVHXEV 
TJWQVVIVPO      : UHQUIE          HKSHVHBP        CJAKJJSBYCFO    MWUSBEUOP       QKJQBRGOXWRSY   LSTUB          
UMGPVRG         : NYSTCQVQJHMCA  
MLEUQL          : BVILKRY         EOIJAYDXAWAUTP  VLNUJHILMT      CUQGATBN       
JFPAGKJGDH      : JWFTDOESJDPF    SDYYRAC         CIYINJFUTK      ISDQFSOQTDYVQ   NHRXTLWNWJU    
LFRA            : UHPKNSIHQPURDS  GPWPNOV        
MPKENDKG        : DCMSAVAIHMEDNIA IAOQDEJJHOBOE   CHMOQEOHEA      WAYYCSM        
VKMMX           : YXLNXWMNYPPXE   MKRXALMGJ      
XFNXMAJS        : SERGTAYVFGNWD   PGRDJI          CYGWSYGMSWQMUA  MLBNFBO         JBMJKCIPCRQWXX 
QUQXOTADLLHY    : VOTAPRHOBDE    
RHGPSS          : HXLRWBNRNGL     QIAVRYEPCIK     JCHJYV          BURKYCLPQJLG    GXCWSAV         BRKTQWEXUDM    
SRCYFALHJGMCBGA : VGWM           
CBUNOCO         : ITUTRUO         DMIOJHXPFILDRFG TFARHTSPHIIXII  BGTIGAD         LGLKSLMSV       CTFNVUMARSKA    RNTQLOQ        
TWLJRGNM        : HYCWSSMRNBW     QFUUIPUFFBS     MVWY            JUPKBRCGOXL     SBYMJIBMFILFHM 
PLGRY           : DMIOJHXPFILDRFG ENMVIYTSFHPTWCN YTSTW           YUPAYIPGCMNYIP  RAKUWYSQKUS    
DFDHIJHANKU     : WGABAJ          JRBSEMA        
YWRESQPEIVT     : ASQUHW          KEOFCWTSEAQ     EHIWBPIVWIEN    RSMLLBAFG      
WLJDDJSIQXPAJA  : LFWFRGRTPIIWOCX PBJPEJABKDGGVBU QYFRPF          VQBBODKPKX     
WKXAMWSSQ       : ASCKR           IVIEPYEGCKUYJB  MEADRBRVYQINRMT JCURVLOGGKPBAAE YHNYSGIBTMMNEE  YHLLHGFAPQWMASF
JWUHTSGFCJLNFT  : HYBOSVSIEH      WIPHVFBXHNAVL   CJUHHOS         MCGWMU          IFYF            WIJS            AFAO            VASL           
DMHNMJ          : KQBYQPSMR       NYSTCQVQJHMCA  
YHLLHGFAPQWMASF : QATQVGQMKHWV    XIXDESCAOY      SDYYRAC         KHRDAQT         WKXAMWSSQ      
YKSKAAGHESOTF   : OBGSAPRE        WPKKARVQ        EBNWVJAUISW     KUJGHYUHEKDDALQ DFSJGC          QQHSI          
