AWFVPYRSD       : CQKMIRQD        DDDYRAEYMUJYVAU AOPXGACRNNRKK   EPRDBTSFQKT     GFCWCHDSTJSQCAN
RTOPAOHYDAF     : MQAWQHAG        YIQACLUN        FRLRQM          VRBRJ          
LKLSGKSPFUOKS   : JUIK            CPNHXIGIOWYYXKR UDNGTUU        
KLXPOSLF        : BTIXLSBCX       QVFNE           RWGXGETJIMLJI   TRGSOLDA        BGCSTQYXNMNKED  ICQRRDJ        
LWRNCSUUGF      : NJGRACBXN       XVBPJSGG        BJPRMP          WIVXDODCX       RATJIJN         FLVDW          
YLTU            : KJVR            JGOQWEXHCCST   
APSMJAY         : VXRCRSHSSWHDT   WHIMAREBVEFGOEH PSORE           EYPEQX         
AONSATDMQ       : CFGFUBEMFU      RLABUICO        SRXFT           DJUYRRLFGS     
ASQUQWCAYPVTT   : AEIKLJGCMVOIHT  GRIJIVEJBUHOKO  QWQQRUIMEEHC   
LOLUQMTQ        : QKUOYRYJNQFDIF  DDIFGIJFPGXRBK  JPUBDMTQWSV    
IMCCRQUNS       : LBAVAGSNYA      WHHGOPQT        MKGPGKUK        CEJJWVSROQYEYRC GYNIGFGEFIMDDT 
EPGERIFIHYE     : QWJM            IYGMREEVDRPP    JWQFTGV         OIQHPHU        
KUSILICEKMQOQJ  : QMJSCKIOQVL     UKKVVG          DIGDBEEU        HPEIHNEOTGNM    QTIKDABDXSEGCK  WUTEYJI        
LYYEGPMKJVPT    : XSGAEETNYOOAEUL KARPVSNDO       OUEKOUU        
QAMDUI          : YCHHCRVRCVL     UMBTYSIMLMPYGR  WPDURFFBUH      GHLFJNWA        IEYUOPDN       
GQSNB           : CTCTVO          XXODOFKYIXRX    LBEPRCWIGKLRBLI VFCFWXYPC       VCOAE           HFBVJEPFF      
ERWP            : GSACHRGWHHDRT   WGVXOVR         GDSLTKAEBMKH    NEBLQ           DVCUYFXAVVEQ    DVVPUMTMJSIHJ  
KPAOVPCIBA      : GKDHWOODXASX    KHRNTEKP        EPGGPXOSCSYLVR  DIGDBEEU       
VFSVRXR         : SDVG            AOPXGACRNNRKK   YUTE            UTWJQARRFFQLDPJ
MASFNVMUOLKMYCO : MQWPIYHOXPFARSV KTASEQWNARATNC  AOPXGACRNNRKK  
AGRIIRKEY       : JUIK            WGVXOVR         VTJKFITHKJXGE   YUTHDA          ESFXTRAUMVTDCBU LXNBGSLDVYKRT  
CTCTVO          : GQSNB           CXFM           
PVMLK           : EDKKT           WGURCUKO        QEWEAY          NSVYUOTG       
CWURVYGLANGI    : MKNSNDDBKTHB    WRTICSETWB      IEYUOPDN       
XVCAYEVBB       : QMJSCKIOQVL     GRIJIVEJBUHOKO  EDGNVXKYIUJ     XQHSMLGKANX     ATYBPG         
RAJPOXBYAAVRXUB : RSETNEHNYIE     EUKLVSM         RJDKAATCMMU     HXFXANHTIRGTDL  GFCWCHDSTJSQCAN
WQRIOS          : HELKWPMCVY      QKWFGPGEUPRQKCH IYGMREEVDRPP    JVGHT           XGGA            KFOPIXJQIIKE   
SSDWOHAIBC      : VXRCRSHSSWHDT   AKKEOJIPDPP     VBTOCV          CEFRXSYLABUVVOE
RRSUSUWO        : JOSAFBAXJ       IVNLTWWUWK     
ULQGJHYRVRVOM   : TJYJE           GRLPQORKN       AKYCIDBMJSPHAGW SSQMSN         
NDIQNKUI        : YASBKWINYTIHFVD YCBLKH          RXUICVGRYY      CXFM            RJDKAATCMMU    
MDYHYXVO        : NRYQHVCUFDHIGSG IKFYWEPAHEURYQ 
KHBTOA          : DLRT            WQSEBMKKJDCKP   TEKIGTBFEJCYUL  NJKJ           
MTLDIMSLXJ      : CSHWVB          NHBKDB          UKSYHXEWDEC    
KFKQTORCN       : GIKURWIKCH      RTTNBTSQYLLA    JDQLR          
AEIKLJGCMVOIHT  : ASQUQWCAYPVTT   MLHYCCKGUA      JVGHT           IQMCGHJWTJJEPAP HIIMPBAYJBHHN   OUBI            VHPUPHKNDO     
WMFWYH          : LOCPIE          PADANBELT       AIMOG           TDNEXBPSNF     
GSACHRGWHHDRT   : ERWP            IXOWAUF         YYXHTTGHGTUT   
DDSRY           : LYORJACXIQK     KHMLSG          QQSCYXDRNGYOWA  AQWEPGXBRDAMT   BXKUMAOSHKJFGRU
BJDUIRAHSIQYDQ  : TDHBTRQ         KMAP            NKQIAIMOQAV     TPDYJGXXSICPISI QENQNLY        
MKKJTTMLQDQTVJU : YMPXOD          UNPCHWAHFASUC   SFVHTSPPLWYPEAF
MEKHOCJVVR      : KFOPIXJQIIKE    QCHBADOOXHHDXS 
WWFBJROSLKHY    : EDKKT           GHLFJNWA        GRCYQJKRBROMW  
MQUICQPOWAXOFHK : MGOBXMQCM       OKHTBVRWE       MSJXJPTOC       VTUTRRVNQADJE  
CAAYHEJASCL     : YOWHQGGY        VHBWNIJUACQU    MJKKSKFVR      
MLHYCCKGUA      : AEIKLJGCMVOIHT  CXQXEUYJNRRLJRU WHHGOPQT       
UDSJ            : TVOWQAV         VTJKFITHKJXGE   MQTDFTNHJQN     GMXRBPL         QSRGWLVHFQ     
CVLEVNEERNGMRR  : KYAFKIIGV       KFOPIXJQIIKE    EGMOGES         IAIMBV         
GDCGHESPC       : FRLRQM          XKVPQBMN       
KYAFKIIGV       : CVLEVNEERNGMRR  EMOUMFO         UWDQJSFPHDCPWUA SVWIASGCXOGCNK  RIUQNDMGWCFVKN 
FMSLGGRV        : EPGGPXOSCSYLVR  XXODOFKYIXRX    QENQNLY         KQOPR           UQBRJ           IBKNRJXXOELK   
JQHPSPYYKP      : RGCFMNX         SIDUSKVLHA      VSNUXE          YDSVJAJPVXMOARG DBVHOD         
GCCGI           : IYEYTLAGKEVGQW  IUSMMUQS        KXOPGGKNOALI   
RQTPFBEYMLHE    : OHNQSUXQWEFP    KMAP            TFECLJDAKRX     EHRLRJ         
IPASFSK         : GUDCTJEFMIGHRWD UBLRJOARXSAYFTN
RXWVEYXMHNGAJ   : HLINPAWPDXIMG  
GKDHWOODXASX    : KPAOVPCIBA      OTEGPYGVH       EGELKNVTEGTQBUG
YSHGLFFJLE      : UKKVVG          SANOKCB         NLNJOGOFECI     ERCIS          
YOWHQGGY        : CAAYHEJASCL     DLRT            BGCSTQYXNMNKED 
MGPDXSCAMCW     : RJCLGMXLQHP     EAFPVXXBHXSFQWV QQBSPAQYTNG     SJNHPK         
VEVJMBSXHCY     : CKUDOLJUBW      NTMC            IWUH            IPMWFDMJEUFNEH  NSVYUOTG       
AHRIPQCCARGANKA : EUKLVSM         QCHSKVTEYJPGGM 
MYPKFLVROOQX    : MCNRYTMU        ITFIO           FGANFCLUICUL   
RWVYOERHITHDC   : IHGQGLRRA       FOEYKCASJNTDH   LLUJPBPCNDAJKGG KGHFEGLVKVQHWS  ICQRRDJ        
QMJSCKIOQVL     : KUSILICEKMQOQJ  XVCAYEVBB       KVVUWSJL        VFCFWXYPC       VQQNSIPFERMTP   YUPGBKO        
MCBKVTHTUXBMG   : QBWDOYKGIEMXA   AEFRTEUKVBS     QLUWRWAJPKW     PDGTWYGB       
JPMLADY         : YBOFDO          PWQHKMWJLEQNO   UQCCPMJGFC      MJOVVNAI       
XBWIRNE         : QBWDOYKGIEMXA   RHEFS          
XSGAEETNYOOAEUL : LYYEGPMKJVPT    YEFKGRST        GXCAQIHVCXT     YYTFYAIH        TKSDIYOMAKPXPQ 
MYYME           : IGNNSNHADUFDMX  JQYSGGNP        IKTYBNCTFENFAD  XQHSMLGKANX    
BDBXLT          : GEGYCVBJXU      GDSLTKAEBMKH    QCHSKVTEYJPGGM 
SYLLHNRMH       : GIKURWIKCH      QRBJCEDALNGE    ALASCDHKALRYW   LUDHJQKMYOT     RVYAQG          FLVDW          
NYUNDRYSEART    : CIRDSHUMSE      RFCCHTUSWECRUU 
SUKVUXR         : FRXKAJLD        TFECLJDAKRX     NLNJOGOFECI     RJDKAATCMMU     EQCIJVCJTPXK    NJKJ            NKBLPP         
QRVF            : NMKXU           KKAUYYLKW       FRLRQM         
KYNTFBS         : GAJAEBUIOVVXFQ  NDDXIDTE        IVPLBDXKPWSAX  
QXVSQDULYCETMC  : VMNMEO          DAHOQ           BIGIIBA         JJSRYBFVMHNEQ   LBRKW          
LUYE            : PDGTWYGB        IUSMMUQS        VTUTRRVNQADJE   IKTYBNCTFENFAD 
WLPHL           : CKUDOLJUBW      TDNEXBPSNF      XMJASSJQQFIGVK  MBMLEQII       
CSHWVB          : MTLDIMSLXJ      IGNNSNHADUFDMX  UMWCRGIRTBTD   
TVOWQAV         : UDSJ            GXCAQIHVCXT     XAWUYVLCV      
GRIJIVEJBUHOKO  : ASQUQWCAYPVTT   XVCAYEVBB       YHFH            IYFVAJXIMPEUP  
QSTBQRCOLAFLS   : UWDQJSFPHDCPWUA IYGMREEVDRPP    PGCRIWBYSH      AABIOQP        
JMOC            : EMAVRTK        
AMTGWW          : EVCFUFVWREFYTFY
EMOUMFO         : KYAFKIIGV       NENJKXCXQKIUAO  AIMOG           LXNBGSLDVYKRT  
GHAKXO          : YDSVJAJPVXMOARG BPSLT          
DCENLSDPQFDN    : UMBTYSIMLMPYGR  BLVWQWDGCVVGJ   NUGCKSQSHXYLGXR PQMROSGFSYB     AGUF           
CKPI            : LYORJACXIQK     FIEXPUS         JDPCFOBYDXFL    USDYMJNGOUGLSN  XAWUYVLCV      
EDKKT           : PVMLK           WWFBJROSLKHY    JUIK            HKBL            INWQAUNKBW     
SDVG            : VFSVRXR         FAKB            NLNJOGOFECI     CPNHXIGIOWYYXKR
MQHOWUCSASJ     : KYXSL           VCETMKQHXYMJBF  UILHEJPFYI      IWKLMGQCKQFAJSI OIQHPHU        
XYUAK           : VVVKXUATP       TODIK           FABPRJKUUTOH    JJTLO           EYPEQX          IPODV          
KHRNTEKP        : KPAOVPCIBA      ANYDIVLFM       MGOBXMQCM       GGVUOTTR        ESTBQSDLMA      DVVPUMTMJSIHJ   KSKP           
NNFPAYWOVTS     : ANYDIVLFM       QUMATDNU        MIVJCLXWBJUH    TRGSOLDA       
ULBDLA          : SNUEUJ          DIGDBEEU        SFOOLIQKGEI     LXNJWP          DJMJJVTPC       KXQDRWWVVPGHHJ 
NMKXU           : QRVF            YNJIKOQVMD      PXBQPGGLAPVH    EQCIJVCJTPXK    NBGCXBICNOQ     UKSYHXEWDEC    
MQKYGKMTPE      : UPKEK          
ODMNXGESTFVGI   : QKWFGPGEUPRQKCH QCHBADOOXHHDXS  TDCHTUW        
TWISTN          : RTMUPGDUY       UTPKL          
LXGT            : FLUREI          UQCCPMJGFC      GQAPRG          CLKIEKAVTANJY   CGJUMRUAJ       PDGTWYGB        RATJIJN        
SQDAMRDAHBGMVA  : HPEIHNEOTGNM    LTPDDCXNVEUPQNB FJXPUSCOF      
TIEPDCBXVOFJOL  : UKKVVG          PQSQDBVNDPDMVUS POVYC           YBYOJXWEPH      HGKWCXBTFTJUFKH ACNJ           
AGUDGJWMJH      : RTMUPGDUY       IDKHDE          GRLPQORKN       HLINPAWPDXIMG   WHHGOPQT        QQBSPAQYTNG    
RTMUPGDUY       : TWISTN          AGUDGJWMJH      GBPRMLOYQYDXNVC YYXHTTGHGTUT   
YAGWQLJ         : QCHBADOOXHHDXS 
YNJIKOQVMD      : NMKXU           PWQHKMWJLEQNO   IWUH            GOXN           
VTAPGUHOBEP     : FTRNQYEREUEJMUO FGAXO           NLSTKFIHJAJUG   UKSYHXEWDEC     UKVFMILWICOPJC 
DPQDIEMQ        : FWHPSEXP        QEWEAY          YFGDKBBY       
CAOOPFKELS      : RKKYXSVUPEDWPYC NBPYNLDRMFUOV   ESFXTRAUMVTDCBU
FTRNQYEREUEJMUO : VTAPGUHOBEP     TDHBTRQ         JDBCDSV         QCHSKVTEYJPGGM  IVNLTWWUWK      UDNGTUU        
YBOFDO          : JPMLADY         HWJKKGTCRSORCDX GDSLTKAEBMKH    NBTFMIPIKM      ESFXTRAUMVTDCBU
RGCFMNX         : JQHPSPYYKP      LXSFPLFXQS      PLWNL           HCFORFKTR      
UTGKLIOFOJJAW   : RLABUICO        JEHYIONKXTOMVCG
PUGQJNWAIQJMVVC : UNHXXFDILGJR    PKRUTWBEIGTQGO  FYDFOJBGJQVPCH  UAEUBPXKA       AEFRTEUKVBS     PAHWCGJMLMW     JDBCDSV         KGHFEGLVKVQHWS 
PUGQJNWAIQJMVVC : EPRDBTSFQKT     JRRDCYHJRUM    
LYORJACXIQK     : DDSRY           CKPI            PTSGUGTX       
TJYJE           : ULQGJHYRVRVOM   DVHNYQQVXEB     PLWNL           XQHSMLGKANX    
APSYPDQYRMVTHJU : BBUKL           WHIMAREBVEFGOEH MQWPIYHOXPFARSV QLUWRWAJPKW    
DEYG            : IXNMDIIYKMCH    VTUTRRVNQADJE   VVCJDABFM      
HYRCSB          : FKSS            GKAWNEWAIVFUAF  GLOAELUACECOGB  GOXN           
CFGFUBEMFU      : AONSATDMQ       UDJNVRINAGO     EEPEDDOCVHOUHBL NKQIAIMOQAV     RSSJPYGBUJLAY  
WIKTRTOQYVQ     : BFYTMWLIPPGURHV ITJGI           QTBRPII         EHKTLTS         BGTYVTNHUGL    
BAHSCATDFBLKX   : DJUYRRLFGS      GFCWCHDSTJSQCAN
QKUOYRYJNQFDIF  : LOLUQMTQ        JDSXGIGQJOPB    NURJGXILDW      VTUTRRVNQADJE  
BMCDTUGW        : KFOPIXJQIIKE   
LCRAORPHCKVCEUN : GSQQPXYGGIDIHT  CVCOVWSBFD     
OTXWB           : USDYMJNGOUGLSN  ERCIS           OYGP            GFCWCHDSTJSQCAN
ANYDIVLFM       : KHRNTEKP        NNFPAYWOVTS     RUHDIP          BFYTMWLIPPGURHV YIQACLUN        IBKNRJXXOELK   
JGAAXRHCCEE     : FWHPSEXP        JSXTTGJN        RSEGUBXNDDNQG   YUPGBKO        
BSBP            : BAWXQSCQ        ILHXJBOEDUUTNY  MDMQAQXDMRN    
YMPXOD          : MKKJTTMLQDQTVJU LXSFPLFXQS      JHDBSPAF        RIUQNDMGWCFVKN 
SNUEUJ          : ULBDLA          HUQM            APBCIQBIJYCMFVJ SVWNLMMLIIC    
EPGGPXOSCSYLVR  : KPAOVPCIBA      FMSLGGRV        EWLGQNSPVHRP    SMYWJQ          CQKMIRQD        TSKOFKJLCKANW  
MGOBXMQCM       : MQUICQPOWAXOFHK KHRNTEKP        KMAP            JSVUQGGAKPQS    VVCJDABFM      
RHPNRWTJFBCG    : YIVKJWUBHQH     ACNJ            OXXFRPPK        LBRKW          
UKKVVG          : KUSILICEKMQOQJ  YSHGLFFJLE      TIEPDCBXVOFJOL  UUDREORFEAUVG  
LSWAWVON        : IPODV           KYWNC           OMSMXTBFYTHKXC 
BYRLQHFNCOVF    : KHMLSG          QWMA            IYFVAJXIMPEUP   JDQLR          
EWPOHML         : WGURCUKO        BBUKL           CDAQKNMCRWWFO   TCFWR           LBAVAGSNYA      NCDSPJKVEE     
DYLAB           : EBCL            CGJUMRUAJ       UDNGTUU        
XPXARWSFNAK     : WFGLYD          WUUFMHQABR      HIIMPBAYJBHHN   KNKXJWRCWBCDHV  NSVULPNCBAWDQOB
EBCL            : DYLAB           XCRGK          
GIKURWIKCH      : KFKQTORCN       SYLLHNRMH       NSVYUOTG       
DIGDBEEU        : KUSILICEKMQOQJ  KPAOVPCIBA      ULBDLA          JDSXGIGQJOPB    RXUICVGRYY      TWRXRFTSXEVJMHT VSHHCHBPUFJDR  
YASBKWINYTIHFVD : NDIQNKUI        JJTLO           YCBHCPTG       
UNHXXFDILGJR    : PUGQJNWAIQJMVVC WMACFTNM        YIQJTEWEVVJRTSR FSMNLYKSMCHG    GYNIGFGEFIMDDT 
EWLGQNSPVHRP    : EPGGPXOSCSYLVR  HCFORFKTR       LTPDDCXNVEUPQNB BMIMR          
YUNEUJSEHQ      : RENYMHJSXCNMA   WGVXOVR         NURJGXILDW      SJNHPK         
KYXSL           : MQHOWUCSASJ     QBOTEPHAY       ATIJKROCGJ     
GRPRYG          : GUDCTJEFMIGHRWD KYWM            YYTFYAIH        UQBRJ           PWYGMRPHRCJL   
RWDBQTTPQHUNQPS : INTAWSBOXDDRVU  TDCHTUW         MBMLEQII       
IDKHDE          : AGUDGJWMJH      RUHDIP          PVDEYG          GDWWAAV        
VMNMEO          : QXVSQDULYCETMC  QRBJCEDALNGE    IDFIRPFHDCWCEO  GSQQPXYGGIDIHT 
MGTPKKLED       : VKGGB           WJKFDHAMJPRKMEE MSJXJPTOC       NJYFIXO        
LXSFPLFXQS      : RGCFMNX         YMPXOD          LQUJGVRLVPYY    TWRXRFTSXEVJMHT
UWDQJSFPHDCPWUA : KYAFKIIGV       QSTBQRCOLAFLS   JPEVEEQNJ      
IGNNSNHADUFDMX  : MYYME           CSHWVB          WIVXDODCX       FDAXKCRGXAB     MBCTBCHKXPCG   
HWPAIII         : KVVUWSJL        RRPPAPRIJIHISL  CEFRXSYLABUVVOE
RLDIKAKWJRKWM   : RLABUICO        FIEXPUS         MACLCKHR        WGPCIUKNGLPHS  
GMDCTGOST       : CXQXEUYJNRRLJRU SDFVQUTGNYQRRI 
RLABUICO        : AONSATDMQ       UTGKLIOFOJJAW   RLDIKAKWJRKWM   RJCLGMXLQHP     HBJANYTOD      
HWJKKGTCRSORCDX : YBOFDO          GXCAQIHVCXT     JPEVEEQNJ       GLOAELUACECOGB 
WGURCUKO        : PVMLK           EWPOHML         SIDUSKVLHA      LOCPIE          UUDREORFEAUVG   CLTEJRLSGJBME  
NJGRACBXN       : LWRNCSUUGF      CVCOVWSBFD      VSHHCHBPUFJDR   FSMNLYKSMCHG    VCOAE           PKHESLWEBJSYF  
IUHM            : IWUH            RATYRMQDNFRGS  
DDIFGIJFPGXRBK  : LOLUQMTQ        JVGHT           VRBRJ          
VXRCRSHSSWHDT   : APSMJAY         SSDWOHAIBC      XDAHX           IWUH            JJSRYBFVMHNEQ  
PKRUTWBEIGTQGO  : PUGQJNWAIQJMVVC HLINPAWPDXIMG   WGPCIUKNGLPHS   QWDCRQAVMANL   
QWQQRUIMEEHC    : ASQUQWCAYPVTT   DJUYRRLFGS      SDFVQUTGNYQRRI 
KVCCHUWDTA      : JDSXGIGQJOPB    XWJEDIGYLS      FNQETOJFDPAP    CHQNYH          GRCYQJKRBROMW  
FIEXPUS         : CKPI            RLDIKAKWJRKWM   VVVKXUATP       CLTEJRLSGJBME  
RJCLGMXLQHP     : MGPDXSCAMCW     RLABUICO       
RNHVWESCAUK     : TPDYJGXXSICPISI JPEVEEQNJ       XMJASSJQQFIGVK  YUPGBKO        
EQGT            : MHNHWQDVLNKXBA  EPRDBTSFQKT     JDQLR           CRHEARTPWROMVD 
YEFKGRST        : XSGAEETNYOOAEUL OMKEREDXMWK     EEPEDDOCVHOUHBL CGJUMRUAJ       UQBRJ          
EMAVRTK         : JMOC            GYEYGPRUGUJS    PBGWOUVAH       BYSHADQRAHV     FJVOCDUXJYGGW   PDGTWYGB        SDFVQUTGNYQRRI 
QJFLMFHWPN      : HPGTEP         
VHBWNIJUACQU    : CAAYHEJASCL     RWEHQISVYQ      ECNJIRIOKT      HLXKPPWAKNUC    IYFVAJXIMPEUP   RCNQFN          OYGP           
DUFUORVHCBTOJD  : KJVR            AKKEOJIPDPP     UMVDT           LBRKW          
YQDWAGVNOFKRHBM : EAFELQKTFU      UEHLUYHGJ      
FJYAAQYIUCEJLJ  : DAHOQ           OUBI            UTWJQARRFFQLDPJ
MACLCKHR        : RLDIKAKWJRKWM   USDYMJNGOUGLSN  NKBLPP         
ODTY            : WFGLYD          MQAWQHAG        QUMATDNU        RIUQNDMGWCFVKN  TCFWR           NUGCKSQSHXYLGXR
GRLPQORKN       : ULQGJHYRVRVOM   AGUDGJWMJH      UCUPFT          OWUJ            QLUWRWAJPKW     KKBHHLTBFSE    
HPGTEP          : QJFLMFHWPN      FSMNLYKSMCHG    JDQLR          
SRXFT           : AONSATDMQ       FTWL            QQSCYXDRNGYOWA 
OMKEREDXMWK     : YEFKGRST        TPDYJGXXSICPISI EYPEQX         
QBWDOYKGIEMXA   : MCBKVTHTUXBMG   XBWIRNE         VCETMKQHXYMJBF  GHLFJNWA        DDDYRAEYMUJYVAU YITGIAGG        UQJC            IVNLTWWUWK     
SANOKCB         : YSHGLFFJLE      SKAEVNQFXDALIYD ILHXJBOEDUUTNY 
ISCNTR          : UDJNVRINAGO     YHFH            FGAXO           HISGECDOMTLAXE  BAIDFMWOQXJNP  
EVCFUFVWREFYTFY : AMTGWW          CFPC           
AYPPLTSHFMMSGEG : JPEVEEQNJ       VCOAE           QWDCRQAVMANL   
CKTARRWKV       : CNTMBYULAD     
JPLKRMLJCWEUHJJ : HELKWPMCVY      QRBJCEDALNGE    NDDXIDTE        VBTOCV          WJKFDHAMJPRKMEE
ERCLGEV         : LMVJ           
GORFBQJMGVWBKKK : INDO           
JQJSC           : OPYSHFEMAGSW    JGDDOKO         UAGHNATSL       LBAVAGSNYA     
OHNQSUXQWEFP    : RQTPFBEYMLHE    GSQQPXYGGIDIHT 
GGVUOTTR        : KHRNTEKP        DLRT            EBYYHM          UQBRJ           JOSAFBAXJ       QSRGWLVHFQ     
EFSQVDJYBBIO    : XXODOFKYIXRX    KTASEQWNARATNC  QCHBADOOXHHDXS 
DLRT            : KHBTOA          YOWHQGGY        GGVUOTTR        JQYSGGNP        UIPPKJSMSMHRRR  VTUTRRVNQADJE  
YCBLKH          : NDIQNKUI        IHBETIPOXUQYI  
GXCAQIHVCXT     : XSGAEETNYOOAEUL TVOWQAV         HWJKKGTCRSORCDX UTPKL           FAKB            BUEUGSIJEILONP  EDGNVXKYIUJ    
JUIK            : LKLSGKSPFUOKS   AGRIIRKEY       EDKKT           QKWFGPGEUPRQKCH IKFYWEPAHEURYQ  JDPCFOBYDXFL    VCOAE          
WFGLYD          : XPXARWSFNAK     ODTY            HCJN            AKKEOJIPDPP    
AFVLRF          : PQSQDBVNDPDMVUS FDTDIIOR        OCFFTLOULWD     DVHNYQQVXEB     KFRO           
XDXYVGITIGOPRL  : HELKWPMCVY      IYEGE           RKKYXSVUPEDWPYC TCFWR          
FRXKAJLD        : SUKVUXR         BYSHADQRAHV     PGCRIWBYSH      VKGGB          
MKEXDJTD        : LOCPIE          FYIGUN          HLXKPPWAKNUC   
RENYMHJSXCNMA   : YUNEUJSEHQ      LWCV           
EAFELQKTFU      : YQDWAGVNOFKRHBM WDECGBKG        INDO            QONCOMFXIMRYWW  PUFXOOGAMT      SCKJRKGDF      
GAJAEBUIOVVXFQ  : KYNTFBS         WJKFDHAMJPRKMEE
HELKWPMCVY      : WQRIOS          JPLKRMLJCWEUHJJ XDXYVGITIGOPRL  KROUHQKQHJSFJ   KYWM            EBYYHM         
GUDCTJEFMIGHRWD : IPASFSK         GRPRYG          UQBRJ           OUBI            JQHN           
VKGWSLI         : RWEHQISVYQ      VRBRJ           NCDSPJKVEE     
KARPVSNDO       : LYYEGPMKJVPT    RUHDIP          FQSKGTOHJXG     NHBKDB          TCFWR           LSHJDG          VUIDJYHBN      
HKBL            : EDKKT           KVVUWSJL       
PUYW            : VASXQAERWPYMWG  UTWJQARRFFQLDPJ
VCETMKQHXYMJBF  : MQHOWUCSASJ     QBWDOYKGIEMXA   SMYWJQ          YYTFYAIH        ICCOKHS         YPHWLCQFWOSP    GRCYQJKRBROMW  
XXODOFKYIXRX    : GQSNB           FMSLGGRV        EFSQVDJYBBIO    CTWACGEC        WIVXDODCX       KXQDRWWVVPGHHJ  IRFOESDHHF     
QWJM            : EPGERIFIHYE     SVWIASGCXOGCNK  CLTEJRLSGJBME   ILHXJBOEDUUTNY 
NJOYAVWCLID     : IPMWFDMJEUFNEH  TQQI           
JDSXGIGQJOPB    : QKUOYRYJNQFDIF  DIGDBEEU        KVCCHUWDTA     
KROUHQKQHJSFJ   : HELKWPMCVY      RATJIJN         KYWNC          
QRBJCEDALNGE    : SYLLHNRMH       VMNMEO          JPLKRMLJCWEUHJJ QKWFGPGEUPRQKCH XSRYLONNQCALS   NKQIAIMOQAV     IJBDMPYLUCLU    JSQXHPFQUD     
XVBPJSGG        : LWRNCSUUGF      IAUWTAMM        JWQFTGV        
WQSEBMKKJDCKP   : KHBTOA          RXUICVGRYY      AXEMOXPVSGFEY  
RUHDIP          : ANYDIVLFM       IDKHDE          KARPVSNDO       NTMC            IEYUOPDN        IRFOESDHHF     
HPEIHNEOTGNM    : KUSILICEKMQOQJ  SQDAMRDAHBGMVA  CLVNKLMKI      
SNQFACKFNALH    : NSVULPNCBAWDQOB WEOCIG          EYPEQX          RVYAQG         
UKFLTPDAALPECL  : SKAEVNQFXDALIYD OWUJ            MYAWK           ICCOKHS         IYFVAJXIMPEUP   VBCUEXYSACODGV  UDNGTUU        
PYPKOIRPKDUA    : GDSLTKAEBMKH    SIDUSKVLHA      NEBLQ           UAEUBPXKA       PWYGMRPHRCJL   
IHBETIPOXUQYI   : YCBLKH          AIMOG           YLMTURQIMSR     QWDCRQAVMANL   
FKSS            : HYRCSB          YUTHDA         
TKNJUGYGLVGQ    : QIFROWK         KSKP            LFEQAJDSCXACJXJ
QTIKDABDXSEGCK  : KUSILICEKMQOQJ  KKAUYYLKW      
UFWRSMBNUC      : RIUQNDMGWCFVKN  JDQLR          
GXDXETRPGWPKBP  : FYIUOKPOTHUOMED BYEQL           UEHLUYHGJ      
FWHPSEXP        : DPQDIEMQ        JGAAXRHCCEE     MKNSNDDBKTHB    SIDUSKVLHA     
QEWEAY          : PVMLK           DPQDIEMQ        PIFQCIXPY      
IYEGE           : XDXYVGITIGOPRL  CVCOVWSBFD      AEFRTEUKVBS     NUGCKSQSHXYLGXR VJJPIP         
BTIXLSBCX       : KLXPOSLF        NURJGXILDW      NENJKXCXQKIUAO 
BFYTMWLIPPGURHV : WIKTRTOQYVQ     ANYDIVLFM       KSOFOTLLWJY     VIXSBFGLUWNTM   VRBRJ           OUEKOUU        
HCJN            : WFGLYD          AXEMOXPVSGFEY   KUOHKHFVUUCDBX 
KHMLSG          : DDSRY           BYRLQHFNCOVF    MKNSNDDBKTHB    QWMA            NBPYNLDRMFUOV  
WGVXOVR         : ERWP            AGRIIRKEY       YUNEUJSEHQ      DGVNYJ          NKBLPP         
UDJNVRINAGO     : CFGFUBEMFU      ISCNTR          GJAGCJRD        AEFRTEUKVBS     KGHFEGLVKVQHWS  HXFXANHTIRGTDL 
KYWM            : GRPRYG          HELKWPMCVY      DVHNYQQVXEB     NYTEAYEN        UAOJFQUPSGFLND 
EBYYHM          : GGVUOTTR        HELKWPMCVY      CEJJWVSROQYEYRC WQQDSKOTUENGCN  UKVFMILWICOPJC  JJSRYBFVMHNEQ  
QKWFGPGEUPRQKCH : WQRIOS          ODMNXGESTFVGI   JUIK            QRBJCEDALNGE    QCLFPVDSYCERDYN
KVVUWSJL        : QMJSCKIOQVL     HWPAIII         HKBL            GCBDSPHVPXJIDO  TDNEXBPSNF      NLSTKFIHJAJUG  
KKAUYYLKW       : QRVF            QTIKDABDXSEGCK  PQSQDBVNDPDMVUS NEBLQ           NBTFMIPIKM      PAHWCGJMLMW    
SMYWJQ          : EPGGPXOSCSYLVR  VCETMKQHXYMJBF  XVMPC           IAUWTAMM        NGNUJAGOVLECSX  CEJJWVSROQYEYRC
BBUKL           : APSYPDQYRMVTHJU EWPOHML        
GJAGCJRD        : UDJNVRINAGO     QIFROWK         TODIK           QWDCRQAVMANL   
EEPEDDOCVHOUHBL : CFGFUBEMFU      YEFKGRST        GCBDSPHVPXJIDO  VIXSBFGLUWNTM   UQJC           
CNTMBYULAD      : CKTARRWKV       YIVKJWUBHQH     VRBRJ           SSQMSN         
LWTGCAXGFB      : RWRTFWFPFQTBRKY
IYEYTLAGKEVGQW  : GCCGI           BYEQL           HLXKPPWAKNUC   
OKHTBVRWE       : MQUICQPOWAXOFHK CQKMIRQD        RRPPAPRIJIHISL 
WDECGBKG        : EAFELQKTFU      TYWEFNEU       
KCRMIEREM       : GKAWNEWAIVFUAF  WPDURFFBUH      NUGCKSQSHXYLGXR CFPC           
ETYOEVPANMEJL   : CXQXEUYJNRRLJRU LFEQAJDSCXACJXJ
PQSQDBVNDPDMVUS : TIEPDCBXVOFJOL  AFVLRF          KKAUYYLKW       QQSCYXDRNGYOWA  XGGA           
FYDFOJBGJQVPCH  : PUGQJNWAIQJMVVC CKFXVUOWBHGEFB  IXOWAUF         BAWXQSCQ       
RXUICVGRYY      : NDIQNKUI        DIGDBEEU        WQSEBMKKJDCKP   HLINPAWPDXIMG  
NURJGXILDW      : QKUOYRYJNQFDIF  YUNEUJSEHQ      BTIXLSBCX       UUXPW          
GEGYCVBJXU      : BDBXLT          JPRBBUDAXJ      EQOOBTFGVXSBO   RCNQFN         
SFOOLIQKGEI     : ULBDLA          SGFQWBYY       
POVYC           : TIEPDCBXVOFJOL  KJVR            RTTNBTSQYLLA    WQQDSKOTUENGCN 
XWJEDIGYLS      : KVCCHUWDTA      WNAXGLCVLN      YCOWMIPCX       NMGWR           AKCWSEHHHE     
GDSLTKAEBMKH    : ERWP            BDBXLT          YBOFDO          PYPKOIRPKDUA   
LXNJWP          : ULBDLA          CPNHXIGIOWYYXKR JRRDCYHJRUM    
UMWCRGIRTBTD    : CSHWVB          SFVHTSPPLWYPEAF LSHJDG          IBKNRJXXOELK   
MQAWQHAG        : RTOPAOHYDAF     ODTY            TFECLJDAKRX     LQUJGVRLVPYY   
IDFIRPFHDCWCEO  : VMNMEO          XSRYLONNQCALS   FABPRJKUUTOH    VORLHNGAGTUTII 
PIFQCIXPY       : QEWEAY          SWJRGTEGMKJIQP  IYGMREEVDRPP    PPWPVSVJBFF     GLOAELUACECOGB  IPMWFDMJEUFNEH 
OSHPYCAEJIVYPG  : WMACFTNM        HIIMPBAYJBHHN   BPSLT          
TDHBTRQ         : BJDUIRAHSIQYDQ  FTRNQYEREUEJMUO BOECIICJOPHV    CRSMD          
YHFH            : GRIJIVEJBUHOKO  ISCNTR          XYPYVBHHES      VVVKXUATP       ENJMSFOQFWQHS   VCXPGDNEVIQRWA 
WHIMAREBVEFGOEH : APSMJAY         APSYPDQYRMVTHJU XAYHGPAGUBNY    FABPRJKUUTOH    YYTSOGCTYQ     
KMAP            : BJDUIRAHSIQYDQ  RQTPFBEYMLHE    MGOBXMQCM       TNMQPGHBWG      QNUBUFIBHXIKMDS RJDKAATCMMU     VJJPIP          FLVDW          
BJPRMP          : LWRNCSUUGF      FRLRQM         
SWJRGTEGMKJIQP  : PIFQCIXPY       DAHOQ           CHQNYH          QGPEVHOGVEI     VJVSOTYJ        WJCRQKBJ       
FTWL            : SRXFT          
LMVJ            : ERCLGEV         PSOIBWPKPVVIP   XQHSMLGKANX     QCHSKVTEYJPGGM 
FYIUOKPOTHUOMED : GXDXETRPGWPKBP  NBTFMIPIKM      EDGNVXKYIUJ    
NLQFDXYCKF      : IVPLBDXKPWSAX   YDSVJAJPVXMOARG VJJPIP         
YBYOJXWEPH      : TIEPDCBXVOFJOL  GHLFJNWA       
GCBDSPHVPXJIDO  : KVVUWSJL        EEPEDDOCVHOUHBL NSVULPNCBAWDQOB
FQSKGTOHJXG     : KARPVSNDO       QONCOMFXIMRYWW  NBTFMIPIKM     
CXQXEUYJNRRLJRU : MLHYCCKGUA      GMDCTGOST       ETYOEVPANMEJL   HPTRKQGWBRXL   
WMACFTNM        : UNHXXFDILGJR    OSHPYCAEJIVYPG  YPHGBVRP        WQQDSKOTUENGCN 
CTWACGEC        : XXODOFKYIXRX    PNNYRKENAJJPTX  WIVXDODCX       GNUDDPKMDVFYIKJ SECMG           RATYRMQDNFRGS  
CIRDSHUMSE      : NYUNDRYSEART    VKDFC          
PVDEYG          : IDKHDE          FERYCBATGONF    XGPMBCOHSKUW    EGMOGES        
SVWIASGCXOGCNK  : KYAFKIIGV       QWJM            WNAXGLCVLN      VVVKXUATP       DVVPUMTMJSIHJ   VUIDJYHBN      
HNGOJU          : HGKWCXBTFTJUFKH DVCUYFXAVVEQ    CRHEARTPWROMVD 
PBBOEGNMQIIPQIK : RSEGUBXNDDNQG   PUFXOOGAMT      VJVSOTYJ       
MKNSNDDBKTHB    : CWURVYGLANGI    FWHPSEXP        KHMLSG          XAYHGPAGUBNY    RIUQNDMGWCFVKN 
CKUDOLJUBW      : VEVJMBSXHCY     WLPHL          
JHDBSPAF        : YMPXOD          FNQETOJFDPAP    MPETVWGGQKS    
QBOTEPHAY       : KYXSL           HSDOVWDCY       ERKJTCMXDY      MSJXJPTOC       QTBRPII        
FDTDIIOR        : AFVLRF          JSVUQGGAKPQS    TCFWR           ATYBPG         
QQSCYXDRNGYOWA  : DDSRY           SRXFT           PQSQDBVNDPDMVUS OTEGPYGVH       TODIK           KJWMPJIQIXTJV  
SHWAHXJPBFSJPJ  : GYEYGPRUGUJS    ACQIFCHSNBRMXOW
UCUPFT          : GRLPQORKN       NDDXIDTE        NENJKXCXQKIUAO  HLINPAWPDXIMG   YLMTURQIMSR    
INDO            : GORFBQJMGVWBKKK EAFELQKTFU      TNMQPGHBWG     
UNPCHWAHFASUC   : MKKJTTMLQDQTVJU UILHEJPFYI      BPSLT          
PNNYRKENAJJPTX  : CTWACGEC        ACQIFCHSNBRMXOW
LNQY            : VKDFC           UAOJFQUPSGFLND  CSYKKEQECSMFQL  IEAQ            EGMOGES         MBMLEQII        CGSMXSG         UDNGTUU        
SIDUSKVLHA      : JQHPSPYYKP      WGURCUKO        PYPKOIRPKDUA    FWHPSEXP        OLCFQ          
WNAXGLCVLN      : XWJEDIGYLS      SVWIASGCXOGCNK  RSETNEHNYIE     NKQIAIMOQAV     KJWMPJIQIXTJV   PKHESLWEBJSYF   ACQIFCHSNBRMXOW
CKFXVUOWBHGEFB  : FYDFOJBGJQVPCH  ICCOKHS        
BMVBYUQASYNXU   : BJOAPHAANURMNT  PSORE           JSQXHPFQUD      IKTYBNCTFENFAD 
NDDXIDTE        : KYNTFBS         JPLKRMLJCWEUHJJ UCUPFT          VTJKFITHKJXGE  
TFECLJDAKRX     : RQTPFBEYMLHE    SUKVUXR         MQAWQHAG        WQCFRCWCRV     
RSETNEHNYIE     : RAJPOXBYAAVRXUB WNAXGLCVLN      PADANBELT       TEDEIHTXHKR     MYAWK          
MCNRYTMU        : MYPKFLVROOQX    BOECIICJOPHV    LLUJPBPCNDAJKGG
QWMA            : BYRLQHFNCOVF    KHMLSG          UAEUBPXKA       EAFPVXXBHXSFQWV IVNLTWWUWK     
OMROA           : FLUREI          EQCIJVCJTPXK    YPHWLCQFWOSP   
JEHYIONKXTOMVCG : UTGKLIOFOJJAW   IDJKILCSY       DVHNYQQVXEB    
XSRYLONNQCALS   : QRBJCEDALNGE    IDFIRPFHDCWCEO  FRLRQM          FMNCROS        
YCHHCRVRCVL     : QAMDUI          RWRTFWFPFQTBRKY
KJVR            : YLTU            DUFUORVHCBTOJD  POVYC           KGHFEGLVKVQHWS 
UMBTYSIMLMPYGR  : QAMDUI          DCENLSDPQFDN    UKSYHXEWDEC    
IYGMREEVDRPP    : EPGERIFIHYE     WQRIOS          QSTBQRCOLAFLS   PIFQCIXPY       CPNHXIGIOWYYXKR ENOXOTPGXRX     VCXPGDNEVIQRWA 
MHNHWQDVLNKXBA  : EQGT            CDAQKNMCRWWFO  
JSXTTGJN        : JGAAXRHCCEE     UAOJFQUPSGFLND  TCFWR          
NKQIAIMOQAV     : BJDUIRAHSIQYDQ  CFGFUBEMFU      QRBJCEDALNGE    WNAXGLCVLN      NHBKDB          MPETVWGGQKS     OSBTVFTFPMPILQQ
QCLFPVDSYCERDYN : QKWFGPGEUPRQKCH JSVUQGGAKPQS    OMSMXTBFYTHKXC 
ICWXOPGQYU      : AXEMOXPVSGFEY   EHKTLTS         TKSDIYOMAKPXPQ 
RWEHQISVYQ      : VHBWNIJUACQU    VKGWSLI         AKMQ            EHKTLTS         EGMOGES         WQQDSKOTUENGCN 
TPDYJGXXSICPISI : BJDUIRAHSIQYDQ  RNHVWESCAUK     OMKEREDXMWK     XVMPC           QEEFESJALVOSGY 
JJMRBKYKBJ      : PTSGUGTX        CLKIEKAVTANJY   NMGWR           GOXN           
WIVXDODCX       : LWRNCSUUGF      IGNNSNHADUFDMX  XXODOFKYIXRX    CTWACGEC        BTKFLBJTAXPWXW 
CXFM            : CTCTVO          NDIQNKUI        DJMJJVTPC       IWKLMGQCKQFAJSI CFPC            GFCWCHDSTJSQCAN
WUUFMHQABR      : XPXARWSFNAK     PDGTWYGB        RATJIJN         BPSLT           YPHWLCQFWOSP   
CENMJK          : GKAWNEWAIVFUAF  KSOFOTLLWJY     LDQGPFRTSOLK    GYNIGFGEFIMDDT  HFBVJEPFF      
GKAWNEWAIVFUAF  : HYRCSB          KCRMIEREM       CENMJK          TUAGGSHRBSE     FNQETOJFDPAP    YIQACLUN        DAHOQ           FABPRJKUUTOH   
VKDFC           : CIRDSHUMSE      LNQY            UTWJQARRFFQLDPJ
IVPLBDXKPWSAX   : KYNTFBS         NLQFDXYCKF      PPWPVSVJBFF     UILHEJPFYI     
QENQNLY         : BJDUIRAHSIQYDQ  FMSLGGRV        LLUJPBPCNDAJKGG RHEFS          
NEBLQ           : ERWP            PYPKOIRPKDUA    KKAUYYLKW       HDHJJQIX       
QUMATDNU        : NNFPAYWOVTS     ODTY            FERYCBATGONF    DDDYRAEYMUJYVAU KSFH           
NHBKDB          : MTLDIMSLXJ      KARPVSNDO       NKQIAIMOQAV     XAYHGPAGUBNY    RVYAQG         
UTPKL           : TWISTN          GXCAQIHVCXT    
XKPMQRXHYP      : QPQUXQDIDHDUHLF PDGTWYGB        YYTSOGCTYQ      DVVPUMTMJSIHJ   ESFXTRAUMVTDCBU
NRYQHVCUFDHIGSG : MDYHYXVO        RIUQNDMGWCFVKN  YPHWLCQFWOSP    UMVDT          
KQOPR           : FMSLGGRV        KTASEQWNARATNC  NBGCXBICNOQ    
FERYCBATGONF    : PVDEYG          QUMATDNU        CPNHXIGIOWYYXKR EAFPVXXBHXSFQWV
UBLRJOARXSAYFTN : IPASFSK         HOQNCY         
LOCPIE          : WMFWYH          WGURCUKO        MKEXDJTD       
JGOQWEXHCCST    : YLTU            MIVJCLXWBJUH    DVHNYQQVXEB     AOPXGACRNNRKK   TDCHTUW        
ITFIO           : MYPKFLVROOQX    QIFROWK         UWVIHFLVDI      LTPDDCXNVEUPQNB
JTCWQNNT        : FRLRQM          VKGGB          
XAYHGPAGUBNY    : WHIMAREBVEFGOEH MKNSNDDBKTHB    NHBKDB          LDQGPFRTSOLK   
GSQQPXYGGIDIHT  : LCRAORPHCKVCEUN VMNMEO          OHNQSUXQWEFP    FSMNLYKSMCHG    NJYFIXO         GFCWCHDSTJSQCAN
WPDURFFBUH      : QAMDUI          KCRMIEREM      
RIUQNDMGWCFVKN  : KYAFKIIGV       YMPXOD          ODTY            UFWRSMBNUC      MKNSNDDBKTHB    NRYQHVCUFDHIGSG OWFMLAMPVJVAQH  ATYBPG         
NYQKWQADLUISVFB : TMGAVSHG        NMGWR           IYFVAJXIMPEUP  
ALASCDHKALRYW   : SYLLHNRMH      
IKFYWEPAHEURYQ  : MDYHYXVO        JUIK            YUTHDA         
CVCOVWSBFD      : LCRAORPHCKVCEUN NJGRACBXN       IYEGE          
QVFNE           : KLXPOSLF        MKGPGKUK        GMXRBPL         NBPYNLDRMFUOV   ILHXJBOEDUUTNY 
BJOAPHAANURMNT  : BMVBYUQASYNXU   UIPPKJSMSMHRRR  QPCE           
JVGHT           : WQRIOS          AEIKLJGCMVOIHT  DDIFGIJFPGXRBK  HLINPAWPDXIMG  
LBEPRCWIGKLRBLI : GQSNB           TYWEFNEU        CHQNYH          QTBRPII         GNUDDPKMDVFYIKJ
MIVJCLXWBJUH    : NNFPAYWOVTS     JGOQWEXHCCST    VEPXVCMETEHXQD  JRRDCYHJRUM    
QIFROWK         : TKNJUGYGLVGQ    GJAGCJRD        ITFIO           RFCCHTUSWECRUU  EYPEQX         
TUAGGSHRBSE     : GKAWNEWAIVFUAF  PLWNL           NTMC           
QONCOMFXIMRYWW  : EAFELQKTFU      FQSKGTOHJXG     MQWPIYHOXPFARSV LBAVAGSNYA     
OTEGPYGVH       : GKDHWOODXASX    QQSCYXDRNGYOWA 
GYEYGPRUGUJS    : EMAVRTK         SHWAHXJPBFSJPJ  YVBYACXUJXU     MSJXJPTOC      
JDPCFOBYDXFL    : CKPI            JUIK            TYWEFNEU        LDVAYSG         KKBHHLTBFSE     ADAPLN         
EUKLVSM         : RAJPOXBYAAVRXUB AHRIPQCCARGANKA IUUIIYP         LTPDDCXNVEUPQNB EKSBWN          JRRDCYHJRUM    
RSSJPYGBUJLAY   : CFGFUBEMFU      IHGQGLRRA       UAOJFQUPSGFLND  ENJMSFOQFWQHS  
FNQETOJFDPAP    : KVCCHUWDTA      JHDBSPAF        GKAWNEWAIVFUAF  BYEQL           KSKP           
YIQACLUN        : RTOPAOHYDAF     ANYDIVLFM       GKAWNEWAIVFUAF  BAWXQSCQ       
UUDREORFEAUVG   : UKKVVG          WGURCUKO        TDNEXBPSNF      YYTSOGCTYQ      FLVDW          
MQWPIYHOXPFARSV : MASFNVMUOLKMYCO APSYPDQYRMVTHJU QONCOMFXIMRYWW  YPHGBVRP        AKMQ            EHKTLTS         IPODV           CCARTDXQ       
USDYMJNGOUGLSN  : CKPI            OTXWB           MACLCKHR        SOKEPRKYYPGNH   MJOVVNAI       
FGAXO           : VTAPGUHOBEP     ISCNTR          HIID           
FDAXKCRGXAB     : IGNNSNHADUFDMX  FLUREI          CLVNKLMKI       OPYSHFEMAGSW    GLOAELUACECOGB  HDHJJQIX        KFRO            VUIDJYHBN      
DAHOQ           : QXVSQDULYCETMC  FJYAAQYIUCEJLJ  SWJRGTEGMKJIQP  GKAWNEWAIVFUAF 
FLUREI          : LXGT            OMROA           FDAXKCRGXAB     VTJKFITHKJXGE   RFCCHTUSWECRUU  OXXFRPPK       
LQUJGVRLVPYY    : LXSFPLFXQS      MQAWQHAG        MVDYGNFQPC      HUQM            EGMOGES        
FYIGUN          : MKEXDJTD        IUUIIYP         PPWPVSVJBFF     CGSMXSG        
CDAQKNMCRWWFO   : EWPOHML         MHNHWQDVLNKXBA  KTASEQWNARATNC  YYTFYAIH        SGFQWBYY       
PWQHKMWJLEQNO   : JPMLADY         YNJIKOQVMD      PPWPVSVJBFF     SOKEPRKYYPGNH   IXNMDIIYKMCH   
IDJKILCSY       : JEHYIONKXTOMVCG
VSNUXE          : JQHPSPYYKP      LSHJDG          EXWSHUCIKGNHD  
PBGWOUVAH       : EMAVRTK         BIGIIBA         AABIOQP         TKSDIYOMAKPXPQ 
RWRTFWFPFQTBRKY : LWTGCAXGFB      YCHHCRVRCVL     AIMOG           XQHSMLGKANX    
BTKFLBJTAXPWXW  : WIVXDODCX       ACNJ           
RTTNBTSQYLLA    : KFKQTORCN       POVYC           CPNHXIGIOWYYXKR
XYPYVBHHES      : YHFH            PADANBELT       EGMOGES         HOQNCY          KKBHHLTBFSE    
ESTBQSDLMA      : KHRNTEKP        YJOIOQLTMSHO   
PTSGUGTX        : LYORJACXIQK     JJMRBKYKBJ      QTBRPII        
UYCTUFDFJVJOODR : VCOAE           MBCTBCHKXPCG    LBRKW          
VVVKXUATP       : XYUAK           FIEXPUS         YHFH            SVWIASGCXOGCNK  KUOHKHFVUUCDBX 
OWFMLAMPVJVAQH  : RIUQNDMGWCFVKN  EFWAV           JDBCDSV         CWUFXETQT       XAWUYVLCV      
AVNFQXD         : CRSMD           NBGCXBICNOQ    
TNMQPGHBWG      : KMAP            INDO            CGJUMRUAJ      
KTIYJE          : XGIOKPWF        IHGQGLRRA       RCMSAFPX        RWGXGETJIMLJI  
FGANFCLUICUL    : MYPKFLVROOQX    PADANBELT       RCNQFN         
OCFFTLOULWD     : AFVLRF          JSQXHPFQUD     
QNUBUFIBHXIKMDS : KMAP            GHLFJNWA        BXKUMAOSHKJFGRU PTIFTYT        
XGIOKPWF        : KTIYJE         
NCPLILEVI       : MOTUKB          GHLFJNWA        OLCFQ           KSKP           
QPQUXQDIDHDUHLF : XKPMQRXHYP      HGKWCXBTFTJUFKH
WUTEYJI         : KUSILICEKMQOQJ  KGHFEGLVKVQHWS  KFRO           
UQCCPMJGFC      : JPMLADY         LXGT            NLNJOGOFECI     NBTFMIPIKM      CCARTDXQ       
DVHNYQQVXEB     : TJYJE           AFVLRF          KYWM            JEHYIONKXTOMVCG JGOQWEXHCCST    NLNJOGOFECI     IBKNRJXXOELK    FESBJSCDDNPV   
BYSHADQRAHV     : EMAVRTK         FRXKAJLD        BLVWQWDGCVVGJ  
YJOIOQLTMSHO    : ESTBQSDLMA      AQWEPGXBRDAMT  
AKKEOJIPDPP     : SSDWOHAIBC      DUFUORVHCBTOJD  WFGLYD          RJDKAATCMMU    
IHGQGLRRA       : RWVYOERHITHDC   RSSJPYGBUJLAY   KTIYJE         
IQMCGHJWTJJEPAP : AEIKLJGCMVOIHT  CLTEJRLSGJBME   FJXPUSCOF      
PSOIBWPKPVVIP   : LMVJ            ATIJKROCGJ      CCARTDXQ        QEEFESJALVOSGY 
IXOWAUF         : GSACHRGWHHDRT   FYDFOJBGJQVPCH  YVBUCA         
TYWEFNEU        : WDECGBKG        LBEPRCWIGKLRBLI JDPCFOBYDXFL    VTJKFITHKJXGE   HCFORFKTR      
WQCFRCWCRV      : TFECLJDAKRX    
CLVNKLMKI       : HPEIHNEOTGNM    FDAXKCRGXAB     GLOAELUACECOGB  GHLFJNWA       
YDSVJAJPVXMOARG : JQHPSPYYKP      GHAKXO          NLQFDXYCKF      BGTYVTNHUGL    
PLWNL           : RGCFMNX         TJYJE           TUAGGSHRBSE     WGPCIUKNGLPHS  
YIQJTEWEVVJRTSR : UNHXXFDILGJR   
JPEVEEQNJ       : UWDQJSFPHDCPWUA HWJKKGTCRSORCDX RNHVWESCAUK     AYPPLTSHFMMSGEG LNWLAPBWPMMMQ  
YIVKJWUBHQH     : RHPNRWTJFBCG    CNTMBYULAD      XDAHX           XYGRQYYHBJTWL  
VFCFWXYPC       : GQSNB           QMJSCKIOQVL     HFBVJEPFF       ILHXJBOEDUUTNY 
HIIMPBAYJBHHN   : AEIKLJGCMVOIHT  XPXARWSFNAK     OSHPYCAEJIVYPG 
FJVOCDUXJYGGW   : EMAVRTK         AIMOG           VBCUEXYSACODGV  JRRDCYHJRUM    
XCRGK           : EBCL            SBPQOIY         PAHWCGJMLMW    
UAEUBPXKA       : PUGQJNWAIQJMVVC PYPKOIRPKDUA    QWMA           
EFWAV           : OWFMLAMPVJVAQH  SFVHTSPPLWYPEAF
GQAPRG          : LXGT            YCOWMIPCX       EGMOGES         YYXHTTGHGTUT    UKSYHXEWDEC    
OPYSHFEMAGSW    : JQJSC           FDAXKCRGXAB     YCBHCPTG       
IUUIIYP         : EUKLVSM         FYIGUN          JPRBBUDAXJ      AOPXGACRNNRKK  
CLKIEKAVTANJY   : LXGT            JJMRBKYKBJ     
TEKIGTBFEJCYUL  : KHBTOA          TWRXRFTSXEVJMHT FOEYKCASJNTDH   VJVSOTYJ       
MVDYGNFQPC      : LQUJGVRLVPYY    NYTEAYEN        AIMOG           IWKLMGQCKQFAJSI
PPWPVSVJBFF     : PIFQCIXPY       IVPLBDXKPWSAX   FYIGUN          PWQHKMWJLEQNO   KSOFOTLLWJY     TFKRJU         
KJNNK           : PGCRIWBYSH     
BLVWQWDGCVVGJ   : DCENLSDPQFDN    BYSHADQRAHV     EQOOBTFGVXSBO   LBRKW          
VIEUBCGEHL      : WOGLVSV        
UWVIHFLVDI      : ITFIO           HXFXANHTIRGTDL 
CLTEJRLSGJBME   : WGURCUKO        FIEXPUS         QWJM            IQMCGHJWTJJEPAP WJCRQKBJ        NJYFIXO         OMSMXTBFYTHKXC  XKVPQBMN       
RKKYXSVUPEDWPYC : CAOOPFKELS      XDXYVGITIGOPRL  BXKUMAOSHKJFGRU
NENJKXCXQKIUAO  : EMOUMFO         BTIXLSBCX       UCUPFT          TMGAVSHG        ERCIS          
RCMSAFPX        : KTIYJE          VSACSAAVYBY     EAFPVXXBHXSFQWV ESFXTRAUMVTDCBU
VBTOCV          : SSDWOHAIBC      JPLKRMLJCWEUHJJ VKGGB           TEDEIHTXHKR     WOGLVSV        
PADANBELT       : WMFWYH          RSETNEHNYIE     XYPYVBHHES      FGANFCLUICUL   
VQQNSIPFERMTP   : QMJSCKIOQVL     KSKP            UUXPW           GOXN           
RSEGUBXNDDNQG   : JGAAXRHCCEE     PBBOEGNMQIIPQIK GOXN           
FAKB            : SDVG            GXCAQIHVCXT     YCOWMIPCX       AOPXGACRNNRKK   RATYRMQDNFRGS  
CQKMIRQD        : AWFVPYRSD       EPGGPXOSCSYLVR  OKHTBVRWE       WJCRQKBJ       
KSOFOTLLWJY     : BFYTMWLIPPGURHV CENMJK          PPWPVSVJBFF     ICCOKHS        
MOTUKB          : NCPLILEVI       GTMSQM         
VEPXVCMETEHXQD  : MIVJCLXWBJUH    JSQXHPFQUD     
VTJKFITHKJXGE   : AGRIIRKEY       UDSJ            NDDXIDTE        FLUREI          TYWEFNEU        YUTHDA          QPCE           
HCFORFKTR       : RGCFMNX         EWLGQNSPVHRP    TYWEFNEU        GRCYQJKRBROMW   XQHSMLGKANX    
PXBQPGGLAPVH    : NMKXU           BIGIIBA        
SOKEPRKYYPGNH   : USDYMJNGOUGLSN  PWQHKMWJLEQNO   NBTFMIPIKM      YFGDKBBY        KYWNC          
AEFRTEUKVBS     : MCBKVTHTUXBMG   PUGQJNWAIQJMVVC IYEGE           UDJNVRINAGO     WJCRQKBJ        OXXFRPPK       
BIGIIBA         : QXVSQDULYCETMC  PBGWOUVAH       PXBQPGGLAPVH    LBRKW          
FRLRQM          : RTOPAOHYDAF     GDCGHESPC       QRVF            BJPRMP          XSRYLONNQCALS   JTCWQNNT        GLOAELUACECOGB  FMNCROS        
YDRMD           : PQMROSGFSYB     AKCWSEHHHE      NKBLPP         
TWRXRFTSXEVJMHT : DIGDBEEU        LXSFPLFXQS      TEKIGTBFEJCYUL  NYTEAYEN        SFVHTSPPLWYPEAF HFBVJEPFF      
JPUBDMTQWSV     : LOLUQMTQ        OWUJ            IJBDMPYLUCLU    VJVSOTYJ        EHKTLTS        
HYMBYECSLX      : EAFPVXXBHXSFQWV UXWCSWCPRD     
MCKVQTREDI      : HLXKPPWAKNUC    MBMLEQII       
GLOAELUACECOGB  : HYRCSB          HWJKKGTCRSORCDX PIFQCIXPY       FDAXKCRGXAB     CLVNKLMKI       FRLRQM          XYGRQYYHBJTWL  
ITJGI           : WIKTRTOQYVQ     LUDHJQKMYOT     LTPDDCXNVEUPQNB GDWWAAV        
LVTEPLL         : XVMPC          
TMEIDFMQCPSHR   : JGDDOKO         INTAWSBOXDDRVU 
PUFXOOGAMT      : EAFELQKTFU      PBBOEGNMQIIPQIK BAWXQSCQ       
GBPRMLOYQYDXNVC : RTMUPGDUY      
PJWYBRGY        : GTMSQM          NGNUJAGOVLECSX  CWUFXETQT       ACQIFCHSNBRMXOW
UILHEJPFYI      : MQHOWUCSASJ     UNPCHWAHFASUC   IVPLBDXKPWSAX   ACNJ            YVBUCA          HDUMDQG        
NYTEAYEN        : KYWM            MVDYGNFQPC      TWRXRFTSXEVJMHT HUQM            TDCHTUW        
GTMSQM          : MOTUKB          PJWYBRGY        GRCYQJKRBROMW  
JSVUQGGAKPQS    : MGOBXMQCM       FDTDIIOR        QCLFPVDSYCERDYN YFGDKBBY        PQMROSGFSYB     HISGECDOMTLAXE 
BOECIICJOPHV    : TDHBTRQ         MCNRYTMU        IPMWFDMJEUFNEH 
TODIK           : XYUAK           GJAGCJRD        QQSCYXDRNGYOWA  IAIMBV         
CGJUMRUAJ       : LXGT            DYLAB           YEFKGRST        TNMQPGHBWG     
UAOJFQUPSGFLND  : KYWM            LNQY            JSXTTGJN        RSSJPYGBUJLAY   ENOXOTPGXRX    
KTASEQWNARATNC  : MASFNVMUOLKMYCO EFSQVDJYBBIO    KQOPR           CDAQKNMCRWWFO  
BYEQL           : GXDXETRPGWPKBP  IYEYTLAGKEVGQW  FNQETOJFDPAP    CRSMD           TQQI           
JGDDOKO         : JQJSC           TMEIDFMQCPSHR   YVBYACXUJXU     VSACSAAVYBY    
NLNJOGOFECI     : YSHGLFFJLE      SUKVUXR         SDVG            UQCCPMJGFC      DVHNYQQVXEB     VBCUEXYSACODGV  EXWSHUCIKGNHD  
ECNJIRIOKT      : VHBWNIJUACQU    LUDHJQKMYOT    
TCFWR           : EWPOHML         ODTY            XDXYVGITIGOPRL  KARPVSNDO       FDTDIIOR        JSXTTGJN        EXWSHUCIKGNHD  
NUGCKSQSHXYLGXR : DCENLSDPQFDN    ODTY            IYEGE           KCRMIEREM       AKMQ            YVBUCA         
NBTFMIPIKM      : YBOFDO          KKAUYYLKW       FYIUOKPOTHUOMED FQSKGTOHJXG     UQCCPMJGFC      SOKEPRKYYPGNH   XGGA            VRBRJ          
NBTFMIPIKM      : CEJJWVSROQYEYRC
RJDKAATCMMU     : RAJPOXBYAAVRXUB NDIQNKUI        SUKVUXR         KMAP            AKKEOJIPDPP     NSVULPNCBAWDQOB
VSHHCHBPUFJDR   : DIGDBEEU        NJGRACBXN       HLXKPPWAKNUC   
UAGHNATSL       : JQJSC           FABPRJKUUTOH   
SFVHTSPPLWYPEAF : MKKJTTMLQDQTVJU UMWCRGIRTBTD    EFWAV           TWRXRFTSXEVJMHT IEAQ            XWKAL           QPCE           
FOEYKCASJNTDH   : RWVYOERHITHDC   TEKIGTBFEJCYUL  CHQNYH          QSRGWLVHFQ     
YCOWMIPCX       : XWJEDIGYLS      GQAPRG          FAKB            QCHBADOOXHHDXS 
YYTFYAIH        : XSGAEETNYOOAEUL GRPRYG          VCETMKQHXYMJBF  CDAQKNMCRWWFO  
PGCRIWBYSH      : QSTBQRCOLAFLS   FRXKAJLD        KJNNK           HSDOVWDCY       UXWCSWCPRD      ADAPLN         
AIMOG           : WMFWYH          EMOUMFO         IHBETIPOXUQYI   RWRTFWFPFQTBRKY FJVOCDUXJYGGW   MVDYGNFQPC      QLUWRWAJPKW     TEDEIHTXHKR    
YVBYACXUJXU     : GYEYGPRUGUJS    JGDDOKO         EYPEQX          VHPUPHKNDO     
HLINPAWPDXIMG   : RXWVEYXMHNGAJ   AGUDGJWMJH      PKRUTWBEIGTQGO  RXUICVGRYY      UCUPFT          JVGHT          
VSACSAAVYBY     : RCMSAFPX        JGDDOKO         YITGIAGG       
VIXSBFGLUWNTM   : BFYTMWLIPPGURHV EEPEDDOCVHOUHBL VRBRJ           LDVAYSG        
RWGXGETJIMLJI   : KLXPOSLF        KTIYJE          PKHESLWEBJSYF  
MJKKSKFVR       : CAAYHEJASCL     OQQV            MPTPNXLUR      
KNKXJWRCWBCDHV  : XPXARWSFNAK     BUCOOXKCPAESDBV
SKAEVNQFXDALIYD : SANOKCB         UKFLTPDAALPECL  HWKKOWNDPYEYO   KKBHHLTBFSE     HPTRKQGWBRXL    ATYBPG          VORLHNGAGTUTII 
LSHJDG          : KARPVSNDO       UMWCRGIRTBTD    VSNUXE          CHQNYH          YUPGBKO         ATCUVY         
HDHJJQIX        : NEBLQ           FDAXKCRGXAB     LWCV            BMIMR          
SBPQOIY         : XCRGK           GHLFJNWA        VJVSOTYJ        RHEFS           EGMOGES        
LBAVAGSNYA      : IMCCRQUNS       EWPOHML         JQJSC           QONCOMFXIMRYWW  WHHGOPQT       
EGELKNVTEGTQBUG : GKDHWOODXASX    CEJJWVSROQYEYRC
JPRBBUDAXJ      : GEGYCVBJXU      IUUIIYP         DVCUYFXAVVEQ    EKSBWN          HUQM            INWQAUNKBW      CEFRXSYLABUVVOE
LLUJPBPCNDAJKGG : RWVYOERHITHDC   MCNRYTMU        QENQNLY         SGSWKC         
HBJANYTOD       : RLABUICO        GHLFJNWA       
TDNEXBPSNF      : WMFWYH          WLPHL           KVVUWSJL        UUDREORFEAUVG  
DJMJJVTPC       : ULBDLA          CXFM            XGPMBCOHSKUW   
XGGA            : WQRIOS          PQSQDBVNDPDMVUS NBTFMIPIKM     
IWKLMGQCKQFAJSI : MQHOWUCSASJ     CXFM            MVDYGNFQPC     
WRTICSETWB      : CWURVYGLANGI   
DJUYRRLFGS      : AONSATDMQ       BAHSCATDFBLKX   QWQQRUIMEEHC    UIPPKJSMSMHRRR  XWKAL          
KFOPIXJQIIKE    : WQRIOS          MEKHOCJVVR      CVLEVNEERNGMRR  BMCDTUGW        UQBRJ           FLVDW          
OWUJ            : GRLPQORKN       UKFLTPDAALPECL  JPUBDMTQWSV     SSQMSN         
XDAHX           : VXRCRSHSSWHDT   YIVKJWUBHQH     ERCIS          
CPNHXIGIOWYYXKR : LKLSGKSPFUOKS   SDVG            LXNJWP          IYGMREEVDRPP    FERYCBATGONF    RTTNBTSQYLLA    FABPRJKUUTOH   
SCKJRKGDF       : EAFELQKTFU      VVCJDABFM      
GHLFJNWA        : QAMDUI          WWFBJROSLKHY    QBWDOYKGIEMXA   YBYOJXWEPH      QNUBUFIBHXIKMDS NCPLILEVI       CLVNKLMKI       SBPQOIY        
GHLFJNWA        : HBJANYTOD       TDCHTUW        
VKGGB           : MGTPKKLED       FRXKAJLD        JTCWQNNT        VBTOCV         
FABPRJKUUTOH    : XYUAK           IDFIRPFHDCWCEO  WHIMAREBVEFGOEH GKAWNEWAIVFUAF  UAGHNATSL       CPNHXIGIOWYYXKR OSBG           
TMGAVSHG        : NYQKWQADLUISVFB NENJKXCXQKIUAO 
HIID            : FGAXO           KUOHKHFVUUCDBX 
QLUWRWAJPKW     : MCBKVTHTUXBMG   APSYPDQYRMVTHJU GRLPQORKN       AIMOG           DBVHOD          GDWWAAV        
HSDOVWDCY       : QBOTEPHAY       PGCRIWBYSH      HGKWCXBTFTJUFKH MPTPNXLUR       YITGIAGG        IKTYBNCTFENFAD  LDVAYSG        
WHHGOPQT        : IMCCRQUNS       MLHYCCKGUA      AGUDGJWMJH      LBAVAGSNYA      JSQXHPFQUD      VVCJDABFM      
IFGHYFHLU       : JDBCDSV         MYAWK          
IJBDMPYLUCLU    : QRBJCEDALNGE    JPUBDMTQWSV     VASXQAERWPYMWG  ADAPLN         
UEHLUYHGJ       : YQDWAGVNOFKRHBM GXDXETRPGWPKBP  XVMPC           MQTDFTNHJQN     VJVSOTYJ        OIQHPHU        
OQQV            : MJKKSKFVR       DGVNYJ         
CRSMD           : TDHBTRQ         AVNFQXD         BYEQL           QTBRPII         TDCHTUW        
PSORE           : APSMJAY         BMVBYUQASYNXU   RRPPAPRIJIHISL 
TRGSOLDA        : KLXPOSLF        NNFPAYWOVTS     IKTYBNCTFENFAD 
CHQNYH          : KVCCHUWDTA      SWJRGTEGMKJIQP  LBEPRCWIGKLRBLI FOEYKCASJNTDH   LSHJDG         
PDGTWYGB        : MCBKVTHTUXBMG   LUYE            LXGT            EMAVRTK         WUUFMHQABR      XKPMQRXHYP      EQOOBTFGVXSBO  
XVMPC           : SMYWJQ          TPDYJGXXSICPISI LVTEPLL         UEHLUYHGJ      
LUDHJQKMYOT     : SYLLHNRMH       ITJGI           ECNJIRIOKT      IRFOESDHHF      UUXPW          
CSYKKEQECSMFQL  : LNQY            NMGWR           IXNMDIIYKMCH   
DDDYRAEYMUJYVAU : AWFVPYRSD       QBWDOYKGIEMXA   QUMATDNU        LWCV           
EQOOBTFGVXSBO   : GEGYCVBJXU      BLVWQWDGCVVGJ   PDGTWYGB        OUEKOUU        
ERKJTCMXDY      : QBOTEPHAY       RHEFS           CWUFXETQT       VEOHDA          LIHOVDDQ       
OXROSGSJUHLOMTM : GMMOBOAF       
MPETVWGGQKS     : JHDBSPAF        NKQIAIMOQAV     MKGPGKUK        UPKEK          
NTMC            : VEVJMBSXHCY     RUHDIP          TUAGGSHRBSE    
FSMNLYKSMCHG    : UNHXXFDILGJR    NJGRACBXN       HPGTEP          GSQQPXYGGIDIHT 
WUHCOFYWL       : ADAPLN         
HGKWCXBTFTJUFKH : TIEPDCBXVOFJOL  HNGOJU          QPQUXQDIDHDUHLF HSDOVWDCY      
WJKFDHAMJPRKMEE : MGTPKKLED       JPLKRMLJCWEUHJJ GAJAEBUIOVVXFQ  WQQDSKOTUENGCN 
MPTPNXLUR       : MJKKSKFVR       HSDOVWDCY      
PAHWCGJMLMW     : PUGQJNWAIQJMVVC KKAUYYLKW       XCRGK           GNUDDPKMDVFYIKJ OUBI           
BGCSTQYXNMNKED  : KLXPOSLF        YOWHQGGY        EHKTLTS         GMXRBPL        
RAERP           : OIQHPHU        
YPHGBVRP        : WMACFTNM        MQWPIYHOXPFARSV
EQCIJVCJTPXK    : SUKVUXR         NMKXU           OMROA           QSRGWLVHFQ     
ENOXOTPGXRX     : IYGMREEVDRPP    UAOJFQUPSGFLND 
XYGRQYYHBJTWL   : YIVKJWUBHQH     GLOAELUACECOGB  QSRGWLVHFQ     
TEDEIHTXHKR     : RSETNEHNYIE     VBTOCV          AIMOG          
RRPPAPRIJIHISL  : HWPAIII         OKHTBVRWE       PSORE          
MKGPGKUK        : IMCCRQUNS       QVFNE           MPETVWGGQKS     WGPCIUKNGLPHS   HISGECDOMTLAXE  JQHN           
EHRLRJ          : RQTPFBEYMLHE   
JDBCDSV         : FTRNQYEREUEJMUO PUGQJNWAIQJMVVC OWFMLAMPVJVAQH  IFGHYFHLU       QQBSPAQYTNG    
DGVNYJ          : WGVXOVR         OQQV           
LTPDDCXNVEUPQNB : SQDAMRDAHBGMVA  EWLGQNSPVHRP    ITFIO           EUKLVSM         ITJGI           BUEUGSIJEILONP  OMSMXTBFYTHKXC 
YFGDKBBY        : DPQDIEMQ        SOKEPRKYYPGNH   JSVUQGGAKPQS   
IWUH            : VEVJMBSXHCY     YNJIKOQVMD      IUHM            VXRCRSHSSWHDT   KYWNC          
DVCUYFXAVVEQ    : ERWP            HNGOJU          JPRBBUDAXJ      MQTDFTNHJQN    
WGPCIUKNGLPHS   : RLDIKAKWJRKWM   PKRUTWBEIGTQGO  PLWNL           MKGPGKUK        JDQLR           CRHEARTPWROMVD 
ENJMSFOQFWQHS   : YHFH            RSSJPYGBUJLAY   OQUKUACFMHDUGM  AABIOQP        
NLBNURRFMC      : VJVSOTYJ        UUXPW          
UPKEK           : MQKYGKMTPE      MPETVWGGQKS     NSVULPNCBAWDQOB UIPPKJSMSMHRRR  YVBUCA          UTWJQARRFFQLDPJ
IAUWTAMM        : XVBPJSGG        SMYWJQ          QEEFESJALVOSGY 
LDQGPFRTSOLK    : CENMJK          XAYHGPAGUBNY    WEOCIG          YLMTURQIMSR     EXWSHUCIKGNHD  
AOPXGACRNNRKK   : AWFVPYRSD       VFSVRXR         MASFNVMUOLKMYCO JGOQWEXHCCST    IUUIIYP         FAKB           
MYAWK           : UKFLTPDAALPECL  RSETNEHNYIE     IFGHYFHLU      
NSVULPNCBAWDQOB : XPXARWSFNAK     SNQFACKFNALH    GCBDSPHVPXJIDO  RJDKAATCMMU     UPKEK           KFRO            XWKAL          
QGPEVHOGVEI     : SWJRGTEGMKJIQP  JQHN           
BUCOOXKCPAESDBV : KNKXJWRCWBCDHV  JSQXHPFQUD     
RATJIJN         : LWRNCSUUGF      LXGT            KROUHQKQHJSFJ   WUUFMHQABR      XMJASSJQQFIGVK 
TFKRJU          : PPWPVSVJBFF    
MQTDFTNHJQN     : UDSJ            UEHLUYHGJ       DVCUYFXAVVEQ    NGNUJAGOVLECSX 
VRBRJ           : RTOPAOHYDAF     DDIFGIJFPGXRBK  VKGWSLI         BFYTMWLIPPGURHV CNTMBYULAD      NBTFMIPIKM      VIXSBFGLUWNTM   XGPMBCOHSKUW   
VRBRJ           : OQUKUACFMHDUGM 
MSJXJPTOC       : MQUICQPOWAXOFHK MGTPKKLED       QBOTEPHAY       GYEYGPRUGUJS    IBKNRJXXOELK    GFCWCHDSTJSQCAN
AXEMOXPVSGFEY   : WQSEBMKKJDCKP   HCJN            ICWXOPGQYU      AKCWSEHHHE      IVNLTWWUWK     
HWKKOWNDPYEYO   : SKAEVNQFXDALIYD NMGWR          
PQMROSGFSYB     : DCENLSDPQFDN    YDRMD           JSVUQGGAKPQS    CEJJWVSROQYEYRC
HISGECDOMTLAXE  : ISCNTR          JSVUQGGAKPQS    MKGPGKUK       
CFPC            : EVCFUFVWREFYTFY KCRMIEREM       CXFM           
GONVH           : BUEUGSIJEILONP 
DBVHOD          : JQHPSPYYKP      QLUWRWAJPKW    
JJTLO           : XYUAK           YASBKWINYTIHFVD RCNQFN         
AKYCIDBMJSPHAGW : ULQGJHYRVRVOM   AABIOQP         RATYRMQDNFRGS   VHPUPHKNDO     
QTBRPII         : WIKTRTOQYVQ     QBOTEPHAY       LBEPRCWIGKLRBLI PTSGUGTX        CRSMD           OQUKUACFMHDUGM 
BUEUGSIJEILONP  : GXCAQIHVCXT     LTPDDCXNVEUPQNB GONVH           NBGCXBICNOQ     BGTYVTNHUGL     FMNCROS        
YITGIAGG        : QBWDOYKGIEMXA   VSACSAAVYBY     HSDOVWDCY      
AKMQ            : RWEHQISVYQ      MQWPIYHOXPFARSV NUGCKSQSHXYLGXR WEOCIG         
VJVSOTYJ        : SWJRGTEGMKJIQP  PBBOEGNMQIIPQIK TEKIGTBFEJCYUL  JPUBDMTQWSV     SBPQOIY         UEHLUYHGJ       NLBNURRFMC     
IPMWFDMJEUFNEH  : VEVJMBSXHCY     NJOYAVWCLID     PIFQCIXPY       BOECIICJOPHV   
MBTYNKULWQ      : WJCRQKBJ       
NMGWR           : XWJEDIGYLS      JJMRBKYKBJ      NYQKWQADLUISVFB CSYKKEQECSMFQL  HWKKOWNDPYEYO   IEYUOPDN       
NGNUJAGOVLECSX  : SMYWJQ          PJWYBRGY        MQTDFTNHJQN    
TTOIHJVECBRRHQ  : NSVYUOTG        RCNQFN         
XGPMBCOHSKUW    : PVDEYG          DJMJJVTPC       VRBRJ           KKBHHLTBFSE    
OUEKOUU         : LYYEGPMKJVPT    BFYTMWLIPPGURHV EQOOBTFGVXSBO   KXQDRWWVVPGHHJ 
ERCIS           : YSHGLFFJLE      OTXWB           NENJKXCXQKIUAO  XDAHX          
ACNJ            : TIEPDCBXVOFJOL  RHPNRWTJFBCG    BTKFLBJTAXPWXW  UILHEJPFYI      CRHEARTPWROMVD 
VCOAE           : GQSNB           NJGRACBXN       AYPPLTSHFMMSGEG JUIK            UYCTUFDFJVJOODR BAWXQSCQ       
JWQFTGV         : EPGERIFIHYE     XVBPJSGG       
KGHFEGLVKVQHWS  : RWVYOERHITHDC   PUGQJNWAIQJMVVC UDJNVRINAGO     KJVR            WUTEYJI         WJCRQKBJ        SJNHPK          OSBG           
IUSMMUQS        : GCCGI           LUYE            INTAWSBOXDDRVU  GRCYQJKRBROMW   IAIMBV         
NJKJ            : KHBTOA          SUKVUXR        
ICCOKHS         : VCETMKQHXYMJBF  UKFLTPDAALPECL  CKFXVUOWBHGEFB  KSOFOTLLWJY     EHKTLTS        
UQBRJ           : FMSLGGRV        GRPRYG          YEFKGRST        GGVUOTTR        GUDCTJEFMIGHRWD KFOPIXJQIIKE   
QCHBADOOXHHDXS  : MEKHOCJVVR      ODMNXGESTFVGI   YAGWQLJ         EFSQVDJYBBIO    YCOWMIPCX      
HLXKPPWAKNUC    : VHBWNIJUACQU    MKEXDJTD        IYEYTLAGKEVGQW  MCKVQTREDI      VSHHCHBPUFJDR  
OLCFQ           : SIDUSKVLHA      NCPLILEVI      
JSQXHPFQUD      : QRBJCEDALNGE    BMVBYUQASYNXU   OCFFTLOULWD     VEPXVCMETEHXQD  WHHGOPQT        BUCOOXKCPAESDBV NBGCXBICNOQ    
LNWLAPBWPMMMQ   : JPEVEEQNJ      
CEJJWVSROQYEYRC : IMCCRQUNS       EBYYHM          SMYWJQ          NBTFMIPIKM      EGELKNVTEGTQBUG PQMROSGFSYB     JQYSGGNP        YYXHTTGHGTUT   
EPRDBTSFQKT     : AWFVPYRSD       PUGQJNWAIQJMVVC EQGT            AABIOQP         KKBHHLTBFSE    
XMJASSJQQFIGVK  : WLPHL           RNHVWESCAUK     RATJIJN         VUIDJYHBN      
WEOCIG          : SNQFACKFNALH    LDQGPFRTSOLK    AKMQ            INWQAUNKBW     
OIQHPHU         : EPGERIFIHYE     MQHOWUCSASJ     UEHLUYHGJ       RAERP          
NSVYUOTG        : PVMLK           VEVJMBSXHCY     GIKURWIKCH      TTOIHJVECBRRHQ  MJOVVNAI       
NLSTKFIHJAJUG   : VTAPGUHOBEP     KVVUWSJL        TQQI            SSQMSN         
JQYSGGNP        : MYYME           DLRT            CEJJWVSROQYEYRC
GNUDDPKMDVFYIKJ : CTWACGEC        LBEPRCWIGKLRBLI PAHWCGJMLMW     RCNQFN         
WJCRQKBJ        : SWJRGTEGMKJIQP  CLTEJRLSGJBME   CQKMIRQD        AEFRTEUKVBS     MBTYNKULWQ      KGHFEGLVKVQHWS 
TQQI            : NJOYAVWCLID     BYEQL           NLSTKFIHJAJUG  
OQUKUACFMHDUGM  : ENJMSFOQFWQHS   VRBRJ           QTBRPII         KYWNC          
RFCCHTUSWECRUU  : NYUNDRYSEART    QIFROWK         FLUREI          SJNHPK         
EKSBWN          : EUKLVSM         JPRBBUDAXJ      HOQNCY         
YUPGBKO         : QMJSCKIOQVL     JGAAXRHCCEE     RNHVWESCAUK     LSHJDG         
SGSWKC          : LLUJPBPCNDAJKGG LBRKW          
HUQM            : SNUEUJ          LQUJGVRLVPYY    NYTEAYEN        JPRBBUDAXJ     
KJWMPJIQIXTJV   : QQSCYXDRNGYOWA  WNAXGLCVLN      WOGLVSV        
PWYGMRPHRCJL    : GRPRYG          PYPKOIRPKDUA   
HEWJR           : GDWWAAV        
IEYUOPDN        : QAMDUI          CWURVYGLANGI    RUHDIP          NMGWR          
NJYFIXO         : MGTPKKLED       GSQQPXYGGIDIHT  CLTEJRLSGJBME  
SECMG           : CTWACGEC       
AQWEPGXBRDAMT   : DDSRY           YJOIOQLTMSHO   
RHEFS           : XBWIRNE         QENQNLY         SBPQOIY         ERKJTCMXDY     
NBGCXBICNOQ     : NMKXU           KQOPR           AVNFQXD         BUEUGSIJEILONP  JSQXHPFQUD     
INTAWSBOXDDRVU  : RWDBQTTPQHUNQPS TMEIDFMQCPSHR   IUSMMUQS        ITFANGVLNPQE   
CDWKQYQS        : UDNGTUU        
TDCHTUW         : ODMNXGESTFVGI   RWDBQTTPQHUNQPS JGOQWEXHCCST    NYTEAYEN        GHLFJNWA        CRSMD           YUTHDA         
KSFH            : QUMATDNU       
IXNMDIIYKMCH    : DEYG            PWQHKMWJLEQNO   CSYKKEQECSMFQL  APBCIQBIJYCMFVJ
UIPPKJSMSMHRRR  : DLRT            BJOAPHAANURMNT  DJUYRRLFGS      UPKEK          
YCBHCPTG        : YASBKWINYTIHFVD OPYSHFEMAGSW    SVWNLMMLIIC     HOQNCY         
EHKTLTS         : WIKTRTOQYVQ     ICWXOPGQYU      RWEHQISVYQ      MQWPIYHOXPFARSV JPUBDMTQWSV     BGCSTQYXNMNKED  ICCOKHS         APBCIQBIJYCMFVJ
FJXPUSCOF       : SQDAMRDAHBGMVA  IQMCGHJWTJJEPAP UTWJQARRFFQLDPJ
IYFVAJXIMPEUP   : GRIJIVEJBUHOKO  BYRLQHFNCOVF    VHBWNIJUACQU    UKFLTPDAALPECL  NYQKWQADLUISVFB
EAFPVXXBHXSFQWV : MGPDXSCAMCW     QWMA            FERYCBATGONF    RCMSAFPX        HYMBYECSLX      OLFVOCK        
IEAQ            : LNQY            SFVHTSPPLWYPEAF AABIOQP        
AABIOQP         : QSTBQRCOLAFLS   PBGWOUVAH       ENJMSFOQFWQHS   AKYCIDBMJSPHAGW EPRDBTSFQKT     IEAQ            YYXHTTGHGTUT    QQBSPAQYTNG    
AABIOQP         : HOQNCY         
GYNIGFGEFIMDDT  : IMCCRQUNS       UNHXXFDILGJR    CENMJK          ATYBPG         
BPSLT           : GHAKXO          OSHPYCAEJIVYPG  UNPCHWAHFASUC   WUUFMHQABR     
CWUFXETQT       : OWFMLAMPVJVAQH  PJWYBRGY        ERKJTCMXDY      XWKAL           SGFQWBYY       
YUTHDA          : AGRIIRKEY       FKSS            IKFYWEPAHEURYQ  VTJKFITHKJXGE   TDCHTUW         HFBVJEPFF       MBCTBCHKXPCG   
HFBVJEPFF       : GQSNB           CENMJK          VFCFWXYPC       TWRXRFTSXEVJMHT YUTHDA          UXWCSWCPRD     
ATCUVY          : LSHJDG         
BAWXQSCQ        : BSBP            FYDFOJBGJQVPCH  YIQACLUN        PUFXOOGAMT      VCOAE           PTIFTYT        
VASXQAERWPYMWG  : PUYW            IJBDMPYLUCLU   
XAWUYVLCV       : TVOWQAV         CKPI            OWFMLAMPVJVAQH 
APBCIQBIJYCMFVJ : SNUEUJ          IXNMDIIYKMCH    EHKTLTS        
UXWCSWCPRD      : HYMBYECSLX      PGCRIWBYSH      HFBVJEPFF       WRTQCGJTTIK     JRRDCYHJRUM    
EGMOGES         : CVLEVNEERNGMRR  PVDEYG          LNQY            RWEHQISVYQ      LQUJGVRLVPYY    XYPYVBHHES      GQAPRG          SBPQOIY        
MJOVVNAI        : JPMLADY         USDYMJNGOUGLSN  NSVYUOTG       
VTUTRRVNQADJE   : MQUICQPOWAXOFHK LUYE            DEYG            QKUOYRYJNQFDIF  DLRT            FMNCROS        
PKHESLWEBJSYF   : NJGRACBXN       WNAXGLCVLN      RWGXGETJIMLJI   CRHEARTPWROMVD 
YPHWLCQFWOSP    : VCETMKQHXYMJBF  OMROA           WUUFMHQABR      NRYQHVCUFDHIGSG RATYRMQDNFRGS  
YYTSOGCTYQ      : WHIMAREBVEFGOEH XKPMQRXHYP      UUDREORFEAUVG  
GRCYQJKRBROMW   : WWFBJROSLKHY    KVCCHUWDTA      VCETMKQHXYMJBF  HCFORFKTR       GTMSQM          IUSMMUQS       
SVWNLMMLIIC     : SNUEUJ          YCBHCPTG       
KXQDRWWVVPGHHJ  : ULBDLA          XXODOFKYIXRX    OUEKOUU        
YYXHTTGHGTUT    : GSACHRGWHHDRT   RTMUPGDUY       GQAPRG          CEJJWVSROQYEYRC AABIOQP        
DVVPUMTMJSIHJ   : ERWP            KHRNTEKP        SVWIASGCXOGCNK  XKPMQRXHYP     
QQBSPAQYTNG     : MGPDXSCAMCW     AGUDGJWMJH      JDBCDSV         AABIOQP         MDMQAQXDMRN    
VCXPGDNEVIQRWA  : YHFH            IYGMREEVDRPP    SSQMSN         
IKTYBNCTFENFAD  : MYYME           LUYE            BMVBYUQASYNXU   HSDOVWDCY       TRGSOLDA       
EYPEQX          : APSMJAY         XYUAK           OMKEREDXMWK     SNQFACKFNALH    QIFROWK         YVBYACXUJXU    
EDGNVXKYIUJ     : XVCAYEVBB       GXCAQIHVCXT     FYIUOKPOTHUOMED HDUMDQG         ILHXJBOEDUUTNY 
UKSYHXEWDEC     : MTLDIMSLXJ      NMKXU           VTAPGUHOBEP     UMBTYSIMLMPYGR  GQAPRG          IRFOESDHHF     
IBKNRJXXOELK    : FMSLGGRV        ANYDIVLFM       UMWCRGIRTBTD    DVHNYQQVXEB     MSJXJPTOC      
YLMTURQIMSR     : IHBETIPOXUQYI   UCUPFT          LDQGPFRTSOLK    UDNGTUU        
WQQDSKOTUENGCN  : EBYYHM          POVYC           WMACFTNM        RWEHQISVYQ      WJKFDHAMJPRKMEE
IAIMBV          : CVLEVNEERNGMRR  TODIK           IUSMMUQS       
WRTQCGJTTIK     : UXWCSWCPRD      GFCWCHDSTJSQCAN
LDVAYSG         : JDPCFOBYDXFL    VIXSBFGLUWNTM   HSDOVWDCY      
AKCWSEHHHE      : XWJEDIGYLS      YDRMD           AXEMOXPVSGFEY   IVNLTWWUWK     
HXFXANHTIRGTDL  : RAJPOXBYAAVRXUB UDJNVRINAGO     UWVIHFLVDI      VHPUPHKNDO     
GMMOBOAF        : OXROSGSJUHLOMTM UMVDT           VVCJDABFM       ILHXJBOEDUUTNY 
UMVDT           : DUFUORVHCBTOJD  NRYQHVCUFDHIGSG GMMOBOAF       
MBCTBCHKXPCG    : IGNNSNHADUFDMX  UYCTUFDFJVJOODR YUTHDA         
IRFOESDHHF      : XXODOFKYIXRX    RUHDIP          LUDHJQKMYOT     UKSYHXEWDEC    
VBCUEXYSACODGV  : UKFLTPDAALPECL  FJVOCDUXJYGGW   NLNJOGOFECI    
HOQNCY          : UBLRJOARXSAYFTN XYPYVBHHES      EKSBWN          YCBHCPTG        AABIOQP        
IPODV           : XYUAK           LSWAWVON        MQWPIYHOXPFARSV
MBMLEQII        : WLPHL           RWDBQTTPQHUNQPS LNQY            MCKVQTREDI     
JDQLR           : KFKQTORCN       BYRLQHFNCOVF    EQGT            HPGTEP          UFWRSMBNUC      WGPCIUKNGLPHS  
UQJC            : QBWDOYKGIEMXA   EEPEDDOCVHOUHBL OMSMXTBFYTHKXC  EXWSHUCIKGNHD  
CRHEARTPWROMVD  : EQGT            HNGOJU          WGPCIUKNGLPHS   ACNJ            PKHESLWEBJSYF  
ATIJKROCGJ      : KYXSL           PSOIBWPKPVVIP  
BAIDFMWOQXJNP   : ISCNTR          ILHXJBOEDUUTNY 
FESBJSCDDNPV    : DVHNYQQVXEB    
RCNQFN          : VHBWNIJUACQU    GEGYCVBJXU      FGANFCLUICUL    JJTLO           TTOIHJVECBRRHQ  GNUDDPKMDVFYIKJ
KUOHKHFVUUCDBX  : HCJN            VVVKXUATP       HIID           
KSKP            : KHRNTEKP        TKNJUGYGLVGQ    FNQETOJFDPAP    NCPLILEVI       VQQNSIPFERMTP  
AGUF            : DCENLSDPQFDN   
YUTE            : VFSVRXR        
WOGLVSV         : VIEUBCGEHL      VBTOCV          KJWMPJIQIXTJV  
OSBTVFTFPMPILQQ : NKQIAIMOQAV    
XQHSMLGKANX     : XVCAYEVBB       MYYME           TJYJE           LMVJ            RWRTFWFPFQTBRKY HCFORFKTR      
ITFANGVLNPQE    : INTAWSBOXDDRVU 
JOSAFBAXJ       : RRSUSUWO        GGVUOTTR       
LWCV            : RENYMHJSXCNMA   HDHJJQIX        DDDYRAEYMUJYVAU
RVYAQG          : SYLLHNRMH       SNQFACKFNALH    NHBKDB          UKVFMILWICOPJC 
GMXRBPL         : UDSJ            QVFNE           BGCSTQYXNMNKED 
UUXPW           : NURJGXILDW      VQQNSIPFERMTP   LUDHJQKMYOT     NLBNURRFMC     
QWDCRQAVMANL    : PKRUTWBEIGTQGO  AYPPLTSHFMMSGEG IHBETIPOXUQYI   GJAGCJRD       
QCHSKVTEYJPGGM  : AHRIPQCCARGANKA BDBXLT          FTRNQYEREUEJMUO LMVJ           
VJJPIP          : IYEGE           KMAP            NLQFDXYCKF     
BGTYVTNHUGL     : WIKTRTOQYVQ     YDSVJAJPVXMOARG BUEUGSIJEILONP 
YVBUCA          : IXOWAUF         UILHEJPFYI      NUGCKSQSHXYLGXR UPKEK          
SJNHPK          : MGPDXSCAMCW     YUNEUJSEHQ      KGHFEGLVKVQHWS  RFCCHTUSWECRUU 
CCARTDXQ        : MQWPIYHOXPFARSV UQCCPMJGFC      PSOIBWPKPVVIP  
TKSDIYOMAKPXPQ  : XSGAEETNYOOAEUL ICWXOPGQYU      PBGWOUVAH       HPTRKQGWBRXL   
ICQRRDJ         : KLXPOSLF        RWVYOERHITHDC   UDNGTUU        
FMNCROS         : XSRYLONNQCALS   FRLRQM          BUEUGSIJEILONP  VTUTRRVNQADJE  
KFRO            : AFVLRF          FDAXKCRGXAB     WUTEYJI         NSVULPNCBAWDQOB
SDFVQUTGNYQRRI  : GMDCTGOST       QWQQRUIMEEHC    EMAVRTK        
VUIDJYHBN       : KARPVSNDO       SVWIASGCXOGCNK  FDAXKCRGXAB     XMJASSJQQFIGVK 
BXKUMAOSHKJFGRU : DDSRY           QNUBUFIBHXIKMDS RKKYXSVUPEDWPYC NBPYNLDRMFUOV   TSKOFKJLCKANW  
INWQAUNKBW      : EDKKT           JPRBBUDAXJ      WEOCIG         
KYWNC           : LSWAWVON        KROUHQKQHJSFJ   SOKEPRKYYPGNH   IWUH            OQUKUACFMHDUGM 
XWKAL           : SFVHTSPPLWYPEAF DJUYRRLFGS      NSVULPNCBAWDQOB CWUFXETQT      
KXOPGGKNOALI    : GCCGI           PTIFTYT        
IVNLTWWUWK      : RRSUSUWO        FTRNQYEREUEJMUO QBWDOYKGIEMXA   QWMA            AXEMOXPVSGFEY   AKCWSEHHHE     
UKVFMILWICOPJC  : VTAPGUHOBEP     EBYYHM          RVYAQG          ACQIFCHSNBRMXOW
ACQIFCHSNBRMXOW : SHWAHXJPBFSJPJ  PNNYRKENAJJPTX  WNAXGLCVLN      PJWYBRGY        UKVFMILWICOPJC  GDWWAAV        
JJSRYBFVMHNEQ   : QXVSQDULYCETMC  VXRCRSHSSWHDT   EBYYHM         
JRRDCYHJRUM     : PUGQJNWAIQJMVVC LXNJWP          MIVJCLXWBJUH    EUKLVSM         FJVOCDUXJYGGW   UXWCSWCPRD     
KKBHHLTBFSE     : GRLPQORKN       JDPCFOBYDXFL    XYPYVBHHES      SKAEVNQFXDALIYD XGPMBCOHSKUW    EPRDBTSFQKT    
QSRGWLVHFQ      : UDSJ            GGVUOTTR        FOEYKCASJNTDH   EQCIJVCJTPXK    XYGRQYYHBJTWL  
HPTRKQGWBRXL    : CXQXEUYJNRRLJRU SKAEVNQFXDALIYD TKSDIYOMAKPXPQ 
LFEQAJDSCXACJXJ : TKNJUGYGLVGQ    ETYOEVPANMEJL  
OXXFRPPK        : RHPNRWTJFBCG    FLUREI          AEFRTEUKVBS     ATYBPG          BMIMR          
OMSMXTBFYTHKXC  : LSWAWVON        QCLFPVDSYCERDYN CLTEJRLSGJBME   LTPDDCXNVEUPQNB UQJC            CEFRXSYLABUVVOE GDWWAAV        
VEOHDA          : ERKJTCMXDY     
RATYRMQDNFRGS   : IUHM            CTWACGEC        FAKB            AKYCIDBMJSPHAGW YPHWLCQFWOSP   
ATYBPG          : XVCAYEVBB       FDTDIIOR        RIUQNDMGWCFVKN  SKAEVNQFXDALIYD GYNIGFGEFIMDDT  OXXFRPPK       
NKBLPP          : SUKVUXR         MACLCKHR        WGVXOVR         YDRMD          
SSQMSN          : ULQGJHYRVRVOM   CNTMBYULAD      OWUJ            NLSTKFIHJAJUG   VCXPGDNEVIQRWA  OSBG           
NCDSPJKVEE      : EWPOHML         VKGWSLI         VVCJDABFM      
ADAPLN          : JDPCFOBYDXFL    PGCRIWBYSH      IJBDMPYLUCLU    WUHCOFYWL      
VORLHNGAGTUTII  : IDFIRPFHDCWCEO  SKAEVNQFXDALIYD
NBPYNLDRMFUOV   : CAOOPFKELS      KHMLSG          QVFNE           BXKUMAOSHKJFGRU
CEFRXSYLABUVVOE : SSDWOHAIBC      HWPAIII         JPRBBUDAXJ      OMSMXTBFYTHKXC 
PTIFTYT         : QNUBUFIBHXIKMDS BAWXQSCQ        KXOPGGKNOALI   
SGFQWBYY        : SFOOLIQKGEI     CDAQKNMCRWWFO   CWUFXETQT      
ESFXTRAUMVTDCBU : AGRIIRKEY       CAOOPFKELS      YBOFDO          XKPMQRXHYP      RCMSAFPX       
LBRKW           : QXVSQDULYCETMC  RHPNRWTJFBCG    DUFUORVHCBTOJD  UYCTUFDFJVJOODR BLVWQWDGCVVGJ   BIGIIBA         SGSWKC          ILHXJBOEDUUTNY 
GDWWAAV         : IDKHDE          ITJGI           QLUWRWAJPKW     HEWJR           ACQIFCHSNBRMXOW OMSMXTBFYTHKXC 
HDUMDQG         : UILHEJPFYI      EDGNVXKYIUJ    
OUBI            : AEIKLJGCMVOIHT  FJYAAQYIUCEJLJ  GUDCTJEFMIGHRWD PAHWCGJMLMW    
FLVDW           : LWRNCSUUGF      SYLLHNRMH       KMAP            UUDREORFEAUVG   KFOPIXJQIIKE   
XKVPQBMN        : GDCGHESPC       CLTEJRLSGJBME  
OLFVOCK         : EAFPVXXBHXSFQWV EXWSHUCIKGNHD  
UTWJQARRFFQLDPJ : VFSVRXR         FJYAAQYIUCEJLJ  PUYW            VKDFC           UPKEK           FJXPUSCOF      
OYGP            : OTXWB           VHBWNIJUACQU   
VVCJDABFM       : DEYG            MGOBXMQCM       SCKJRKGDF       WHHGOPQT        GMMOBOAF        NCDSPJKVEE      OSBG           
CGSMXSG         : LNQY            FYIGUN         
BMIMR           : EWLGQNSPVHRP    HDHJJQIX        OXXFRPPK       
VHPUPHKNDO      : AEIKLJGCMVOIHT  YVBYACXUJXU     AKYCIDBMJSPHAGW HXFXANHTIRGTDL  MDMQAQXDMRN    
GOXN            : YNJIKOQVMD      HYRCSB          JJMRBKYKBJ      VQQNSIPFERMTP   RSEGUBXNDDNQG  
TSKOFKJLCKANW   : EPGGPXOSCSYLVR  BXKUMAOSHKJFGRU
OSBG            : FABPRJKUUTOH    KGHFEGLVKVQHWS  SSQMSN          VVCJDABFM      
QPCE            : BJOAPHAANURMNT  VTJKFITHKJXGE   SFVHTSPPLWYPEAF
QEEFESJALVOSGY  : TPDYJGXXSICPISI PSOIBWPKPVVIP   IAUWTAMM       
ILHXJBOEDUUTNY  : BSBP            SANOKCB         QWJM            QVFNE           VFCFWXYPC       EDGNVXKYIUJ     GMMOBOAF        BAIDFMWOQXJNP  
ILHXJBOEDUUTNY  : LBRKW          
JQHN            : GUDCTJEFMIGHRWD MKGPGKUK        QGPEVHOGVEI    
LIHOVDDQ        : ERKJTCMXDY     
EXWSHUCIKGNHD   : VSNUXE          NLNJOGOFECI     TCFWR           LDQGPFRTSOLK    UQJC            OLFVOCK        
UDNGTUU         : LKLSGKSPFUOKS   FTRNQYEREUEJMUO DYLAB           UKFLTPDAALPECL  LNQY            CDWKQYQS        YLMTURQIMSR     ICQRRDJ        
GFCWCHDSTJSQCAN : AWFVPYRSD       RAJPOXBYAAVRXUB BAHSCATDFBLKX   OTXWB           CXFM            GSQQPXYGGIDIHT  MSJXJPTOC       WRTQCGJTTIK    
LXNBGSLDVYKRT   : AGRIIRKEY       EMOUMFO        
MDMQAQXDMRN     : BSBP            QQBSPAQYTNG     VHPUPHKNDO     
