YPHFDUDRCGN     : BACCF           MDUNAYCXHOV     YONYDHTSVIOWQX 
OMPJPVYUFGAYTO  : XYJB            RUGSSUQLPYCCS   UYQLYKDJM      
YJPOIHXQKUVEWDT : QBCBTC          EHVGYDOJOWLS    CNFRFRJWJPTCE   IEGTVCQX        LGYG            OSLDGTRAGGHV    QYGLQIRWROTUQ  
TJUDY           : SAHHTVGUOXSMTBC EXOON           ODLOEGMQIFEVU   IPNSKIOUSOIRI   TUXIR          
FTBLTCG         : NKMJTDINUIQYOX  FDOFLQYAFA      TBCNBDOFA       CNCHD           UTTMSPULHK     
PHUH            : WLACDLQGPBGY    HFWSOXCTMJPJONY FDOFLQYAFA      FBEPQNJAWDPR    QMVQAKPFDHUHA  
FQVXCQUGPA      : XGFWYHKK        QGEOMYALGTMKYU  XISAT          
WTMUXLQFH       : IGOBJXXTVOSBKXN KOHDCRNH        WMDUNOOGUVTO    WMDEAOHUO      
SEUBPMIKWIRNGQR : NFIMKAKATPDEJLC XPDCJTPYVULCH   BMSULYVDLHBM    DPEYOFSW       
LBOLEOHQJHEAM   : YPGR            RMQXPJ         
TGROHHESTBBMQ   : LPEXRLPVW       ONJVRXXPJWGGY   YQRDRIJVLUJTLJ  OSSFIAY        
DJHOKYCQPJ      : FJUMKGOLJ       OPEAMQGEH       VGPARRPB       
BRNBGY          : KLXCCNIB        UROAW           KIPTYVBVEAVI   
OROWBSRVVSIODL  : NACTYRARQQVRLRT QMVQAKPFDHUHA  
NCKOEBEPKFJX    : RGGQOIFKH       LDTS            WMDEAOHUO       LCXMK          
SAHHTVGUOXSMTBC : TJUDY           OLFQNG          XDMMISBGGG     
OCOQ            : IGOBJXXTVOSBKXN OCKUUEQ         EXOON           GOWJXF          TBGWVW         
FWQJP           : QBXN            XJEBE           UODOH           BJTLAAHJU      
QBCBTC          : YJPOIHXQKUVEWDT LTCQDVED        QSBQEN          TSIFD          
CXFKTW          : QWSYJDBTDUMICXT DSIFBPIWSQVFFM 
OLFQNG          : SAHHTVGUOXSMTBC KJBOXECEKLA     AMOTOPWSWMPJOU 
SVYIBV          : MAOUSU          BMSULYVDLHBM    JPKYP           XWNAGIASYY      BBUTYBWBNF      GRYSR           MEPYSGWYLL     
NNFGPIKJMTNLB   : HPEWQQQEU       VQCSXNRWREJCAN  MEPYSGWYLL     
HXKVKROA        : MYSOFO          UFXTIYUNQWQV    SDFXKRSSAT      KSCTD           QSBQEN          HMIAUQKVOKGHM  
UUVVDA          : QSCCMXQNB       WQDDQRMOD       JDAOKHGIPYH     TPDHNTCR        QICB            TRRMURQ         AINOET         
FPIKXXUI        : KJBOXECEKLA     SCJCKXUYYBVGPG 
ICVVEWFE        : GMMEHNYE        PBHWK           LQQBIWDEKTIGBW  GKWAMRSDN      
BQBQTBNOAJ      : NFTUEVPH        VGYN            MNTEYSIQNETEJ   WPHTGE          LRUGVKOAMWLV   
CDCRL           : TDVXIPBPSV      EGAUECOSMEEDS   OWCVYBCX       
PLKBTUDRSJOX    : BACCF           XFQTNDJM        QCWE            YPWSR          
XYJB            : OMPJPVYUFGAYTO  BNKEXBJYDYXD    OJODDK          XSLEIBCWUQU     YONYDHTSVIOWQX 
DCHUCSRGWTXKIQW : DXMCPBSXTK      KJBOXECEKLA     LWFMXMOWDPROEPF CQYYRPM        
RSPWMIJBIABILE  : RIAWQUAQPRDBGJ  WRKYJ          
RGKMLDGRCASPK   : FNSAGTJT        JKGVXMICFDTTYX  XCDRPSNQ        NACTYRARQQVRLRT RYLJPO         
OGFH            : RIAWQUAQPRDBGJ  FFSYKQYSGBLAYB  PBXJCJXUAQ      CLIVGXXODXQBWE  DCJNHEUCLCEEUCW
ETJNWRPACCEFV   : DIXTTOCXFQYHDH  HIMXQM          AXAEJFIPCL     
RIAWQUAQPRDBGJ  : RSPWMIJBIABILE  OGFH            YLTESAENGJD     GBTYGOUIAAICS  
NKMJTDINUIQYOX  : FTBLTCG         TEKJU           HUAICDHTUPAICA 
BRFCOV          : DTGDW           DSFUGSEHTJOOK   LGYG            HUAICDHTUPAICA 
OMOIQROCAEMOPIR : WLGYKMLG        MNTEYSIQNETEJ   SLLXOWCDGQS     USYJBNQNPMHX   
YPGR            : LBOLEOHQJHEAM   HKXK            EBUSYY          ICSD            OPEAMQGEH       OBPCKMUA        CKRCXAMATMBGV  
WRKYJ           : RSPWMIJBIABILE  QIQYNGAGHQROE   TFWIFRHYY       DFLRKMPHNBTNW   LCGTBXR        
DXMCPBSXTK      : DCHUCSRGWTXKIQW EUDE            XSXDXENFHBSTF   UCJUXEQJIWGM    MNTEYSIQNETEJ   OOJWOTINUUTV   
YMTN            : MAOUSU          SWVQTDX         HIMXQM         
KYVIXNRRCOJM    : BTWEVGANHV      QLBKUA          QDFUIWACYUJI    DWCBBXFBWQ      PIBEBMDO       
SFUQRYIU        : HXAGJSEMMOFSR   VGYN            GSKQXKMEVEYGV  
HPEWQQQEU       : NNFGPIKJMTNLB   VMVPAIYEFXQH    SDTCUVDBTTXJKGD BOHXXNLNLU      WLOLVNAPXQKUM   AIMNLA         
DSODG           : DBORS           LGYG            UYJLXSMBLSICUJ  KOHPQS         
UIYE            : FNSAGTJT        WKGYSYFMQEIYHHN UEVSKJ          VQWQAEMC        LKTBIF         
PWDM            : WPACRVHOIQ      XHDIM           CXYCED          KJVFOJURECOLV   BOHXXNLNLU      HIMXQM          LBNCLS         
UMYRGIJLFACYFY  : WTDIVRICWMMIOQN XGORNLHB        EADRQXWYSCG     UODOH           NMFWHBDDQXS    
IRSMXDJJDOHUNK  : OQLBGFBVDFY     CWPKNPFJLHQBB   TNNFXLIH        KIPTYVBVEAVI    RGFFFT         
EHVGYDOJOWLS    : YJPOIHXQKUVEWDT NYCLVCVEKTXSPBH WKGYSYFMQEIYHHN EMOXIEBRQK      OWNCBIHR        PAKMMW          QXVGQ          
QSCCMXQNB       : UUVVDA          ARBBULCOK       OBPCKMUA        KGUBWBXBKNN     WVNKYEMKWYOPAN 
WEQGBFSJJAFR    : CHQERQYTIBY     SQNO            VIBEBYGLYE      GLQWPPDSSOSYHR  HNEYFIUTNNO    
KHMYGYUERPIVCG  : YWOGTFL         TEKJU           VNIIOQMYEVG     YLASYQGLOGJVNHB MJBEWQYNLBYO   
PKPOQGW         : SOOVQCHYYP     
LPEXRLPVW       : TGROHHESTBBMQ   RMQXPJ          HCXBYMYQPHS     KUNUISJIXMRU   
KXHLSNEI        : XAKQFBY         OJODDK          UODOH          
CNFRFRJWJPTCE   : YJPOIHXQKUVEWDT EMOXIEBRQK      OWNCBIHR        PTSFSG          NXSXTDO         XISAT           PRTJBIGWNUXD   
IEGTVCQX        : YJPOIHXQKUVEWDT BTWEVGANHV      NGEALNQM        HIMXQM         
RFBKTHVQ        : QIQYNGAGHQROE   YOYCYAUXDNHF    GRYSR           CMJMNUUDHSRMD  
LXEQQNPADKEJY   : NHFKXMND        EVGE            GQWABL          UJKLEOADAIVBURF
NFIMKAKATPDEJLC : SEUBPMIKWIRNGQR DULYH           CXYDRRRHCQHS    HIMXQM          TSIFD           OSSFIAY        
XPDCJTPYVULCH   : SEUBPMIKWIRNGQR BCDGICSOWHDLNX  NACTYRARQQVRLRT
QWSYJDBTDUMICXT : CXFKTW          ASPDHR          KPICRJFYKUTTSWT JWMSHIEHRLYRS   QHGGVGKTFLWF    GBTYGOUIAAICS   XPYIWMLAJRO    
BTWEVGANHV      : KYVIXNRRCOJM    IEGTVCQX        AMOTOPWSWMPJOU  OSKKRSKPNYU     QYGLQIRWROTUQ   OSSFIAY        
TXSEQ           : WHLPGYJ         OJODDK          BHBTXAYDVU      WNVYIYDI        HQGOSUH         KHLDBWGMFDAA    KDXUGJPRJRCTMLK
WPACRVHOIQ      : PWDM            IEUJBFIVSBUMA   EVGE            RXBMJBUC        WMCJUA          FIGPRBSODQRPHF  IXXRMCTT       
HKXK            : YPGR            EMOXIEBRQK      SSSAHPQLUN      BECMMQM         KMDFMEQM       
WQDDQRMOD       : UUVVDA          KOHDCRNH       
OVLFNKUN        : XJEBE           QSDRDFMMNIL    
OMUEULW         : FIICEPXG       
YWOGTFL         : KHMYGYUERPIVCG  FSCTB           FUMENCXVU      
XDMMISBGGG      : SAHHTVGUOXSMTBC GBLMPWYAJ       VKSNFBIIIGUABNC NSLXROIUTETOUNR GAFUNROVO      
TEKJU           : NKMJTDINUIQYOX  KHMYGYUERPIVCG  IGOBJXXTVOSBKXN FIICEPXG        IUYKHOQKWN     
EBUSYY          : YPGR            YKXHIGRCLEB     XRQXSSMPKVXORFD
VQCSXNRWREJCAN  : NNFGPIKJMTNLB   OPEAMQGEH       HPAGMLIDAIAQ    JWMSHIEHRLYRS  
ITGCASL         : MNTJ            YXNEUR          ANDGHV          WTDIVRICWMMIOQN ODLOEGMQIFEVU   DULYH           TRRMURQ         QXVGQ          
ITGCASL         : HIMXQM          OSLDGTRAGGHV    EEXYSEMICCGKJKN
SSYNNXO         : MYSOFO          XHDIM           KJBOXECEKLA     WMBQVGRGBMCV   
WHLPGYJ         : TXSEQ           JGIYBCVOMTJFWQ  KOHDCRNH       
SOOVQCHYYP      : PKPOQGW         FSYAJDIDJTJSU   NHFKXMND        FSCTB           GRYSR           QWEFOFQA       
BIPYBIYQXYIFVR  : GBLMPWYAJ      
NXSXDLOUHF      : DWCBBXFBWQ     
QGXG            : UWPBDIDNYSAOKF  DMJORTREN       VBISQYFF        CILDGQNCKFCG    AXAEJFIPCL     
ARBBULCOK       : QSCCMXQNB       KSCTD           ERDBDEWIP       LBGIGGQOA       LKTBIF         
WRAOLOPEOUPD    : YXNEUR          VBISQYFF        PIBEBMDO       
AKPSQPCERTHT    : IWAIBFU        
SVFFA           : FJUMKGOLJ       BECMMQM        
XBVLRLPGIHLY    : HAWAA           TDVXIPBPSV      DSFUGSEHTJOOK   IUKYELPUFGUD    AMDHTLHQHLL     GLQWPPDSSOSYHR  AAELJDRXBTGQKLN
XQDQGHUBDCWTXS  : VNIIOQMYEVG     NAYRQP         
DTGDW           : BRFCOV          GOWJXF          OWCAKRJSES      IBVJXKAJGNMXN  
OQNGWWQ         : IOIGNKDNGMKI    CMGOPWU         OQACFGXBAMV    
XAKQFBY         : KXHLSNEI        FDJJFWVY        QVDHTH         
WAPB            : WKGOQMHHUMRECV  FPLXQYVVCVA     UTTMSPULHK     
MYSOFO          : HXKVKROA        SSYNNXO         FNSAGTJT        GOWJXF          NMFWHBDDQXS     GJOUVW          DPEYOFSW       
KLXCCNIB        : BRNBGY          PAKMMW          TJIVWDBA       
BNKEXBJYDYXD    : XYJB            IEUJBFIVSBUMA   TXGRYVBVC       TYYSGHJB       
CDDBVTIMPT      : LWDU           
NVCBGFOIUB      : EXOON           EGAUECOSMEEDS   RRCNN           ALFXARH         KDXUGJPRJRCTMLK
UFXTIYUNQWQV    : HXKVKROA       
OQLBGFBVDFY     : IRSMXDJJDOHUNK  TIURGWBMKA      QLBKUA          MRWPNIQQTRFJL  
MNTJ            : ITGCASL         WLGYKMLG        NSFSPGNHTCPA    QGEOMYALGTMKYU  LCGTBXR         RGFFFT         
IEUJBFIVSBUMA   : WPACRVHOIQ      BNKEXBJYDYXD    UEVSKJ          GQWCEYD         USYJBNQNPMHX   
DSIFBPIWSQVFFM  : CXFKTW          HJODMBB         WPHTGE          KOHPQS          GKRV           
PEKTB           : RRCNN           JXNAWYC        
UGGSYKPNKNRDVY  : CWPKNPFJLHQBB   UCMQKESCWLDEHSF OBPCKMUA       
MJFHA           : RRLIEGL         BACCF           SWVQTDX         MCLTKGYULF      KMDFMEQM       
MIPOXTB         : ELESQIVH        OSSFIAY         GRPIQ          
UWPBDIDNYSAOKF  : QGXG            RGNWKIRA        KXISVOUDJKWAJM  HMIAUQKVOKGHM  
JLBVQJXU        : KJVFOJURECOLV   GWWHMGUARUMRKMO NQATOMLP       
GMMEHNYE        : ICVVEWFE        PAKMMW         
QIQYNGAGHQROE   : WRKYJ           RFBKTHVQ        JDAOKHGIPYH     QICB            NXSXTDO        
DFBTOA          : SWVQTDX         GSKQXKMEVEYGV  
NGEALNQM        : IEGTVCQX        RGNWKIRA        OUVBSCFGRWGQ    FBEPQNJAWDPR   
BDCT            : TXWCMXLM        UQRA            QVDHTH         
PBHWK           : ICVVEWFE        GDQRJOI         GXXLCSEMUQDE   
QYCVCKXYBXROE   : QVORVSOJVQM     FUKX           
RRLIEGL         : MJFHA           FJUMKGOLJ       YLASYQGLOGJVNHB NMFWHBDDQXS     WLRTWRIDGS     
IGOBJXXTVOSBKXN : WTMUXLQFH       OCOQ            TEKJU           VCNQ            QRGWLLKROCYFBDJ
YOIQEN          : OBTFOXRVCXV     UEVSKJ         
XHDIM           : PWDM            SSYNNXO         LBUFQRPJATLN   
TXWCMXLM        : BDCT            DTVFWVP        
HJODMBB         : DSIFBPIWSQVFFM  SWVQTDX         WQTCIBQY        GJOUVW         
MAOUSU          : SVYIBV          YMTN            VNIIOQMYEVG     CHQERQYTIBY     XWNAGIASYY      OSKKRSKPNYU     OENOUNVIE      
KUSQDHEAFB      : WKGOQMHHUMRECV  HNEYFIUTNNO    
UBSH            : CEECLKLA        OSKKRSKPNYU     KIPTYVBVEAVI   
ASPDHR          : QWSYJDBTDUMICXT ICSD           
JGIYBCVOMTJFWQ  : WHLPGYJ         XYMSDM          IOIGNKDNGMKI    LYLGQYMU       
YXNEUR          : ITGCASL         WRAOLOPEOUPD    LGYG           
FSYAJDIDJTJSU   : SOOVQCHYYP      WRBLLMRK        PCMK           
WRBLLMRK        : FSYAJDIDJTJSU   HXAGJSEMMOFSR   WKGOQMHHUMRECV  FSCTB           BWMDBIVTX       VIBEBYGLYE      CMJMNUUDHSRMD   CHPVNUBOLONQVKJ
EKERQBJN        : VNIIOQMYEVG     OQACFGXBAMV     JJNDTJUAEVIOPHQ
DMJORTREN       : QGXG            EXOON           HDAROCYBHYPSIXD IKNVFXETVWIE   
YJPVDT          : KJVFOJURECOLV   OQACFGXBAMV     JIBT            DCJNHEUCLCEEUCW
QGBB            : OWYGJNU         SLLXOWCDGQS    
FNSAGTJT        : RGKMLDGRCASPK   UIYE            MYSOFO          AKYR            XISAT           LKTBIF         
OJODDK          : XYJB            KXHLSNEI        TXSEQ           TDVXIPBPSV     
HXAGJSEMMOFSR   : SFUQRYIU        WRBLLMRK        VCNQ            WMDEAOHUO       JIBT            KDXUGJPRJRCTMLK
HAWAA           : XBVLRLPGIHLY    ELSFL           VOVP            MCLTKGYULF      QSBQEN          UCJUXEQJIWGM   
WLACDLQGPBGY    : PHUH            AKETESOVJPHRJJ  CLIVGXXODXQBWE  MWVCMYPNVO      CNUFBIBBVIFUGSF
IILB            : GXXLCSEMUQDE    RMVAMYWYCAI     DYDTYNINNL     
ANDGHV          : ITGCASL         DVQUTMLDKES     DBORS           VGYN           
QVORVSOJVQM     : QYCVCKXYBXROE   LYHCJNHHINYU    LKTBIF         
JVYMCB          : BHBTXAYDVU      YLASYQGLOGJVNHB XGFWYHKK       
KJBOXECEKLA     : OLFQNG          FPIKXXUI        DCHUCSRGWTXKIQW SSYNNXO        
DVQUTMLDKES     : ANDGHV          WMBQVGRGBMCV    TWRBTNXGPMJYI   WLRTWRIDGS      KDXUGJPRJRCTMLK
POVE            : OBTFOXRVCXV     MDUNAYCXHOV    
WTDIVRICWMMIOQN : UMYRGIJLFACYFY  ITGCASL         FPLXQYVVCVA     OWNCBIHR        PTSFSG         
JKGVXMICFDTTYX  : RGKMLDGRCASPK   PEMQCUWBTE      TAXXDWHPXLO    
XSRIQMQSLG      : JDAOKHGIPYH     FTCNFABCK       NSLXROIUTETOUNR HQGOSUH         LWDU           
VUXKIHU         : NHFKXMND        IUKYELPUFGUD    CLIVGXXODXQBWE  QCWE            IXXRMCTT        KOHPQS         
GVDOX           : QQHABE          LBNCLS          LCXMK          
RUGSSUQLPYCCS   : OMPJPVYUFGAYTO  GBLMPWYAJ       XRSEATLKHC      VMVPAIYEFXQH    XFQTNDJM       
NYCLVCVEKTXSPBH : EHVGYDOJOWLS    QHGGVGKTFLWF   
OCKUUEQ         : OCOQ            FIICEPXG        UTTMSPULHK      CNUFBIBBVIFUGSF
RGNWKIRA        : UWPBDIDNYSAOKF  NGEALNQM        FPLXQYVVCVA     UCMQKESCWLDEHSF FBEPQNJAWDPR   
WLGYKMLG        : OMOIQROCAEMOPIR MNTJ            DFLRKMPHNBTNW   OENOUNVIE      
EXOON           : TJUDY           OCOQ            NVCBGFOIUB      DMJORTREN       BACCF           UEVSKJ         
QBXN            : FWQJP           DCJNHEUCLCEEUCW
QCYYSVLBQLLPATO : LQQBIWDEKTIGBW  QEGVPMNUOS      FTCNFABCK       FUMENCXVU       WQOAWYAYIKTW   
GDQRJOI         : PBHWK           IPNSKIOUSOIRI   UTJAMEOHGXCA    TYYSGHJB        HIMXQM          YONYDHTSVIOWQX 
ELSFL           : HAWAA           CMGOPWU         FMJTWMIRJCUDPUM USYJBNQNPMHX    BJTLAAHJU      
ODLOEGMQIFEVU   : TJUDY           ITGCASL         SDFXKRSSAT      SMUMRWUKBOO     TDFWGXXCIELWB  
RMQXPJ          : LBOLEOHQJHEAM   LPEXRLPVW       QHCJROOYEVSQOEM
BACCF           : YPHFDUDRCGN     PLKBTUDRSJOX    MJFHA           EXOON           UCMQKESCWLDEHSF RMVAMYWYCAI    
UMAECFS         : EGAUECOSMEEDS   QRGWLLKROCYFBDJ
LYHCJNHHINYU    : QVORVSOJVQM     WMBQVGRGBMCV    YOYCYAUXDNHF    AINOET         
AMOTOPWSWMPJOU  : OLFQNG          BTWEVGANHV      FPLXQYVVCVA     TPDHNTCR       
VNIIOQMYEVG     : KHMYGYUERPIVCG  XQDQGHUBDCWTXS  MAOUSU          EKERQBJN        TAXXDWHPXLO     YPWSR          
KIMPIYEE        : CILDGQNCKFCG   
VBISQYFF        : QGXG            WRAOLOPEOUPD    UYQLYKDJM      
SCJCKXUYYBVGPG  : FPIKXXUI        XSXDXENFHBSTF   WLRTWRIDGS     
CXYCED          : PWDM            FJUMKGOLJ       UREKHOLM        QYHBYQRSSNBBE   MCLTKGYULF      BNLMCHLNA       JYEPSUBODV     
BHBTXAYDVU      : TXSEQ           JVYMCB          XWNAGIASYY      EEXYSEMICCGKJKN
HYRFTRFUPNMVE   : BNLMCHLNA       OBPCKMUA        KLVWLER         PRTJBIGWNUXD    OOVX           
TDVXIPBPSV      : CDCRL           XBVLRLPGIHLY    OJODDK          GVJNIYJNTYTHIP  WMCJUA          MRWPNIQQTRFJL  
SWVQTDX         : YMTN            MJFHA           DFBTOA          HJODMBB         OBTFOXRVCXV     WBROOEOOHFIXUU  HWUFHJMENLMLO  
XGORNLHB        : UMYRGIJLFACYFY  DOTW            CWPKNPFJLHQBB   TAXXDWHPXLO     QLBKUA          GBTYGOUIAAICS  
FFSYKQYSGBLAYB  : OGFH            QEGVPMNUOS      NYSDJAP         QSBQEN         
XYMSDM          : JGIYBCVOMTJFWQ  OTWJSATSVOJBO   TDFWGXXCIELWB  
DSFUGSEHTJOOK   : BRFCOV          XBVLRLPGIHLY   
FJUMKGOLJ       : DJHOKYCQPJ      SVFFA           RRLIEGL         CXYCED          GBTYGOUIAAICS  
KJVFOJURECOLV   : PWDM            JLBVQJXU        YJPVDT          GXXLCSEMUQDE    BWMDBIVTX       UCJUXEQJIWGM   
UREKHOLM        : CXYCED          PBXJCJXUAQ      TAXXDWHPXLO     LCGTBXR        
GBLMPWYAJ       : XDMMISBGGG      BIPYBIYQXYIFVR  RUGSSUQLPYCCS   CXYDRRRHCQHS   
XQYJOQOQHCMCWFG : GKWAMRSDN       HIMXQM          KUNUISJIXMRU   
OUVBSCFGRWGQ    : NGEALNQM        QGEOMYALGTMKYU  LTCQDVED        FJYAHIUODOKROW 
PBXJCJXUAQ      : OGFH            UREKHOLM        YKXHIGRCLEB     QRGWLLKROCYFBDJ
CEECLKLA        : UBSH            UTTMSPULHK      THVK            OOVX           
JDAOKHGIPYH     : UUVVDA          QIQYNGAGHQROE   XSRIQMQSLG      XFQTNDJM        MJBEWQYNLBYO   
CHQERQYTIBY     : WEQGBFSJJAFR    MAOUSU          GKRV            HWUFHJMENLMLO  
HDAROCYBHYPSIXD : DMJORTREN       RGGQOIFKH       FUKX           
WKGYSYFMQEIYHHN : UIYE            EHVGYDOJOWLS    HCXBYMYQPHS     GXXLCSEMUQDE    BWMDBIVTX       QMVQAKPFDHUHA  
KPICRJFYKUTTSWT : QWSYJDBTDUMICXT PEMQCUWBTE     
ICSD            : YPGR            ASPDHR          LBGIGGQOA       UTTMSPULHK      QYGLQIRWROTUQ  
XRSEATLKHC      : RUGSSUQLPYCCS   LCGTBXR         KOHPQS          DCWTXRKVOFU    
WMBQVGRGBMCV    : SSYNNXO         DVQUTMLDKES     LYHCJNHHINYU    LBGIGGQOA       MNTEYSIQNETEJ   LYLGQYMU        GRPIQ          
WNVYIYDI        : TXSEQ          
VMVPAIYEFXQH    : HPEWQQQEU       RUGSSUQLPYCCS   SDFXKRSSAT      KOHDCRNH       
ONJVRXXPJWGGY   : TGROHHESTBBMQ   OWNCBIHR        PAKMMW          OWCVYBCX       
HCXBYMYQPHS     : LPEXRLPVW       WKGYSYFMQEIYHHN PTSFSG          NMFWHBDDQXS     BJTLAAHJU      
OQNXIC          : PCMK            QRGWLLKROCYFBDJ
TXGRYVBVC       : BNKEXBJYDYXD    GXXLCSEMUQDE    YQAHQ           BNLMCHLNA       RMVAMYWYCAI     WBROOEOOHFIXUU 
UTPXTSYGTRVBM   : LFQKSKOLMVAVFFX CXYDRRRHCQHS    CNUFBIBBVIFUGSF
RGGQOIFKH       : NCKOEBEPKFJX    HDAROCYBHYPSIXD IKNVFXETVWIE    TWRBTNXGPMJYI   JXNAWYC         WMCJUA         
CILDGQNCKFCG    : QGXG            KIMPIYEE        TBGWVW          NACTYRARQQVRLRT
DOTW            : XGORNLHB        WKGOQMHHUMRECV  SVKSRTI         KUNUISJIXMRU   
WKGOQMHHUMRECV  : WAPB            KUSQDHEAFB      WRBLLMRK        DOTW            TFWIFRHYY       QRNU           
OBTFOXRVCXV     : YOIQEN          POVE            SWVQTDX        
OPEAMQGEH       : DJHOKYCQPJ      YPGR            VQCSXNRWREJCAN  KLVWLER         CNUFBIBBVIFUGSF
LQQBIWDEKTIGBW  : ICVVEWFE        QCYYSVLBQLLPATO
SVKSRTI         : DOTW            MJBEWQYNLBYO    KHLDBWGMFDAA    TSIFD           QCSW           
AKYR            : FNSAGTJT       
DBORS           : DSODG           ANDGHV          EGAUECOSMEEDS   ERDBDEWIP       UROAW           HEIK           
SDFXKRSSAT      : HXKVKROA        ODLOEGMQIFEVU   VMVPAIYEFXQH    VGPARRPB        IXXRMCTT       
IPNSKIOUSOIRI   : TJUDY           GDQRJOI         RXBMJBUC        YMKTQDYENRRQD   UTJAMEOHGXCA    KKHYJLWYKGXYTBI
VKSNFBIIIGUABNC : XDMMISBGGG      VNYAK           VIBEBYGLYE      USYJBNQNPMHX   
IKNVFXETVWIE    : DMJORTREN       RGGQOIFKH       GQWABL          FIGPRBSODQRPHF  OENOUNVIE      
RGPE            : KRYNVFBAEQMR    EEXYSEMICCGKJKN
DJENTMTP        : LFQKSKOLMVAVFFX WMDUNOOGUVTO    OTWJSATSVOJBO   YQRDRIJVLUJTLJ  KLVWLER        
XFQTNDJM        : PLKBTUDRSJOX    RUGSSUQLPYCCS   JDAOKHGIPYH     LTCQDVED        LCGTBXR        
JSCFQLJKFRAJTDU : PAKMMW          HQGOSUH         PNDLYUYXPGTXCE 
SQNO            : WEQGBFSJJAFR    EGAUECOSMEEDS   TBCNBDOFA       BBUTYBWBNF      GQWCEYD        
EMOXIEBRQK      : EHVGYDOJOWLS    CNFRFRJWJPTCE   HKXK            PEMQCUWBTE      ISXAIXXLYOMDNOX GQWABL         
KOHDCRNH        : WTMUXLQFH       WQDDQRMOD       WHLPGYJ         VMVPAIYEFXQH    FDJJFWVY       
NSFSPGNHTCPA    : MNTJ            CWPKNPFJLHQBB  
GXXLCSEMUQDE    : PBHWK           IILB            KJVFOJURECOLV   WKGYSYFMQEIYHHN TXGRYVBVC       LXDJMPPWNMCWWQ 
GVJNIYJNTYTHIP  : TDVXIPBPSV      MWIKYPSENTJFLB  XPYIWMLAJRO    
YQAHQ           : TXGRYVBVC       JUCEXXG        
SSSAHPQLUN      : HKXK            NYSDJAP        
QYHBYQRSSNBBE   : CXYCED          JIBT            MWVCMYPNVO      CHPVNUBOLONQVKJ
CWPKNPFJLHQBB   : IRSMXDJJDOHUNK  UGGSYKPNKNRDVY  XGORNLHB        NSFSPGNHTCPA   
VOVP            : HAWAA           JYEPSUBODV      OSKKRSKPNYU    
GSOY            : FDJJFWVY        STVNXKJHR       RYLJPO          SLLXOWCDGQS     DCWTXRKVOFU    
KRYNVFBAEQMR    : RGPE            WBROOEOOHFIXUU  OWCAKRJSES     
SDTCUVDBTTXJKGD : HPEWQQQEU      
FPLXQYVVCVA     : WAPB            WTDIVRICWMMIOQN RGNWKIRA        AMOTOPWSWMPJOU 
JUCEXXG         : YQAHQ           FTCNFABCK       YMKTQDYENRRQD   UTJAMEOHGXCA   
TMWQGWAS        : OWCVYBCX        OSKKRSKPNYU     GRPIQ          
FUKX            : QYCVCKXYBXROE   HDAROCYBHYPSIXD PNDLYUYXPGTXCE 
IOIGNKDNGMKI    : OQNGWWQ         JGIYBCVOMTJFWQ  PNDLYUYXPGTXCE  HWUFHJMENLMLO  
LGYG            : YJPOIHXQKUVEWDT BRFCOV          DSODG           YXNEUR          MJBEWQYNLBYO    TFWIFRHYY       KDXUGJPRJRCTMLK
NFTUEVPH        : BQBQTBNOAJ      HNEYFIUTNNO     YRSXSHOTXYK    
KSCTD           : HXKVKROA        ARBBULCOK       KXISVOUDJKWAJM 
CMGOPWU         : OQNGWWQ         ELSFL           OBPCKMUA        YOYCYAUXDNHF   
HFWSOXCTMJPJONY : PHUH            RXBMJBUC        RXFBGAWRPFENMXO MWIKYPSENTJFLB  GKRV           
RMSVGYRKLXBDUWH : VNYAK           UYJLXSMBLSICUJ 
EGAUECOSMEEDS   : CDCRL           NVCBGFOIUB      UMAECFS         DBORS           SQNO            YLASYQGLOGJVNHB CKOORVGHEAD    
BMSULYVDLHBM    : SEUBPMIKWIRNGQR SVYIBV          JXNAWYC         QSDRDFMMNIL     BJTLAAHJU      
YLTESAENGJD     : RIAWQUAQPRDBGJ  XGFWYHKK       
XJEBE           : FWQJP           OVLFNKUN        NYSDJAP         IUKYELPUFGUD    EADRQXWYSCG     QICB            FTCNFABCK       TWRBTNXGPMJYI  
XJEBE           : VGYN            UTTMSPULHK     
ERDBDEWIP       : ARBBULCOK       DBORS           SMUMRWUKBOO    
LFQKSKOLMVAVFFX : UTPXTSYGTRVBM   DJENTMTP        TYYSGHJB        VJVSB          
QEGVPMNUOS      : QCYYSVLBQLLPATO FFSYKQYSGBLAYB  YKXHIGRCLEB     QSBQEN          KOHPQS         
LDTS            : NCKOEBEPKFJX    LBUFQRPJATLN    GJOUVW          OBUIXHSRSUOW    MWIKYPSENTJFLB  VJVSB          
YLASYQGLOGJVNHB : KHMYGYUERPIVCG  RRLIEGL         JVYMCB          EGAUECOSMEEDS  
MJBEWQYNLBYO    : KHMYGYUERPIVCG  JDAOKHGIPYH     SVKSRTI         LGYG            MCLTKGYULF      XSXDXENFHBSTF  
TFWIFRHYY       : WRKYJ           WKGOQMHHUMRECV  LGYG            TRRMURQ         RYLJPO         
NHFKXMND        : LXEQQNPADKEJY   SOOVQCHYYP      VUXKIHU        
XGFWYHKK        : FQVXCQUGPA      JVYMCB          YLTESAENGJD     KIPTYVBVEAVI    LYLGQYMU        AAYACDMHOEKA   
LBGIGGQOA       : ARBBULCOK       ICSD            WMBQVGRGBMCV    TIURGWBMKA      PIBEBMDO       
NYSDJAP         : FFSYKQYSGBLAYB  SSSAHPQLUN      XJEBE           DCJNHEUCLCEEUCW
PEMQCUWBTE      : JKGVXMICFDTTYX  KPICRJFYKUTTSWT EMOXIEBRQK      OWYGJNU        
GOWJXF          : OCOQ            DTGDW           MYSOFO         
EVGE            : LXEQQNPADKEJY   WPACRVHOIQ      DCWTXRKVOFU    
VGPARRPB        : DJHOKYCQPJ      SDFXKRSSAT      LGTBYEH         TDFWGXXCIELWB   TIURGWBMKA      YPWSR           PIEMIHACD      
VNYAK           : VKSNFBIIIGUABNC RMSVGYRKLXBDUWH JPKYP           EADRQXWYSCG    
BECMMQM         : HKXK            SVFFA           DULYH           XCDRPSNQ        VFFNBLUIL      
QRNU            : WKGOQMHHUMRECV 
UCMQKESCWLDEHSF : UGGSYKPNKNRDVY  RGNWKIRA        BACCF           JVMNOW         
FDJJFWVY        : XAKQFBY         KOHDCRNH        GSOY            DTVFWVP        
TPDHNTCR        : UUVVDA          AMOTOPWSWMPJOU 
VCNQ            : IGOBJXXTVOSBKXN HXAGJSEMMOFSR   QHGGVGKTFLWF    MDUNAYCXHOV     FIGPRBSODQRPHF 
MCLTKGYULF      : MJFHA           HAWAA           CXYCED          MJBEWQYNLBYO   
WMDUNOOGUVTO    : WTMUXLQFH       DJENTMTP        LWFMXMOWDPROEPF
NAYRQP          : XQDQGHUBDCWTXS  CKRCXAMATMBGV   STVNXKJHR       LBNCLS         
DULYH           : NFIMKAKATPDEJLC ITGCASL         BECMMQM         EUDE           
BCDGICSOWHDLNX  : XPDCJTPYVULCH   XSLEIBCWUQU     NACTYRARQQVRLRT
JPKYP           : SVYIBV          VNYAK           OENOUNVIE      
QGEOMYALGTMKYU  : FQVXCQUGPA      MNTJ            OUVBSCFGRWGQ    QLBKUA         
BOHXXNLNLU      : HPEWQQQEU       PWDM            QRGWLLKROCYFBDJ SLLXOWCDGQS    
DIXTTOCXFQYHDH  : ETJNWRPACCEFV   WQTCIBQY        FIICEPXG        AAYACDMHOEKA   
RRCNN           : NVCBGFOIUB      PEKTB           WVNKYEMKWYOPAN 
EUDE            : DXMCPBSXTK      DULYH           RMVAMYWYCAI     HEIK            VJVSB          
OTWJSATSVOJBO   : XYMSDM          DJENTMTP        XRQXSSMPKVXORFD EEXYSEMICCGKJKN
RQXWXBPQFDEI    : TIURGWBMKA      YPWSR           QCSW           
BNLMCHLNA       : CXYCED          HYRFTRFUPNMVE   TXGRYVBVC       LKTBIF          BJTLAAHJU       CKOORVGHEAD    
IUKYELPUFGUD    : XBVLRLPGIHLY    VUXKIHU         XJEBE           TBCNBDOFA       NSLXROIUTETOUNR WVNKYEMKWYOPAN 
XSXDXENFHBSTF   : DXMCPBSXTK      SCJCKXUYYBVGPG  MJBEWQYNLBYO    IWAIBFU         BBUTYBWBNF      KGUBWBXBKNN    
FSCTB           : YWOGTFL         SOOVQCHYYP      WRBLLMRK        WLOLVNAPXQKUM  
EADRQXWYSCG     : UMYRGIJLFACYFY  XJEBE           VNYAK          
UEVSKJ          : UIYE            IEUJBFIVSBUMA   YOIQEN          EXOON           HQGOSUH         JJNDTJUAEVIOPHQ LCXMK          
SMUMRWUKBOO     : ODLOEGMQIFEVU   ERDBDEWIP       EDGQMDLNVAMH    LRUGVKOAMWLV   
UODOH           : FWQJP           UMYRGIJLFACYFY  KXHLSNEI        STVNXKJHR      
NJVQPMNWKHHTJA  : NMFWHBDDQXS     OOJWOTINUUTV   
HPAGMLIDAIAQ    : VQCSXNRWREJCAN  LGTBYEH         MDUNAYCXHOV     THVK            EDGQMDLNVAMH    DCJNHEUCLCEEUCW
OBPCKMUA        : YPGR            QSCCMXQNB       UGGSYKPNKNRDVY  HYRFTRFUPNMVE   CMGOPWU        
JWMSHIEHRLYRS   : QWSYJDBTDUMICXT VQCSXNRWREJCAN  BBUTYBWBNF      WEKV            HEIK           
FDOFLQYAFA      : FTBLTCG         PHUH            WQTCIBQY       
KMDFMEQM        : HKXK            MJFHA           AINOET         
LTCQDVED        : QBCBTC          OUVBSCFGRWGQ    XFQTNDJM       
WQTCIBQY        : HJODMBB         DIXTTOCXFQYHDH  FDOFLQYAFA      JXNAWYC         THVK           
QHCJROOYEVSQOEM : RMQXPJ          UROAW          
UROAW           : BRNBGY          DBORS           QHCJROOYEVSQOEM YKXHIGRCLEB    
YOYCYAUXDNHF    : RFBKTHVQ        LYHCJNHHINYU    CMGOPWU         GAFUNROVO       HUAICDHTUPAICA  NXSXTDO        
BWMDBIVTX       : WRBLLMRK        KJVFOJURECOLV   WKGYSYFMQEIYHHN ISXAIXXLYOMDNOX AAELJDRXBTGQKLN
ISXAIXXLYOMDNOX : EMOXIEBRQK      BWMDBIVTX       PCMK           
RMVAMYWYCAI     : IILB            BACCF           TXGRYVBVC       EUDE            OBUIXHSRSUOW    TUXIR           AIMNLA         
VIBEBYGLYE      : WEQGBFSJJAFR    WRBLLMRK        VKSNFBIIIGUABNC GWWHMGUARUMRKMO QHGGVGKTFLWF   
XSLEIBCWUQU     : XYJB            BCDGICSOWHDLNX  YKXHIGRCLEB     PNDLYUYXPGTXCE 
DTVFWVP         : TXWCMXLM        FDJJFWVY        QICB            YQRDRIJVLUJTLJ 
TAXXDWHPXLO     : JKGVXMICFDTTYX  VNIIOQMYEVG     XGORNLHB        UREKHOLM        XCDRPSNQ        CNCHD          
HBDREFOBYL      : AAELJDRXBTGQKLN QVDHTH         
EGUJ            : QMVQAKPFDHUHA   EDGQMDLNVAMH   
TBCNBDOFA       : FTBLTCG         SQNO            IUKYELPUFGUD    OWYGJNU         CNUFBIBBVIFUGSF
UYJLXSMBLSICUJ  : DSODG           RMSVGYRKLXBDUWH BBUTYBWBNF      GQWCEYD         KOHPQS         
VQWQAEMC        : UIYE            KKHYJLWYKGXYTBI
DFLRKMPHNBTNW   : WRKYJ           WLGYKMLG        WMDEAOHUO       KGUBWBXBKNN    
QICB            : UUVVDA          QIQYNGAGHQROE   XJEBE           DTVFWVP         XRQXSSMPKVXORFD GSKQXKMEVEYGV  
YNBWEAPEEDI     : FUMENCXVU       OWCAKRJSES      ALFXARH         FIGPRBSODQRPHF 
GQWABL          : LXEQQNPADKEJY   IKNVFXETVWIE    EMOXIEBRQK     
LBUFQRPJATLN    : XHDIM           LDTS           
YQRDRIJVLUJTLJ  : TGROHHESTBBMQ   DJENTMTP        DTVFWVP         QOTEGNDAXGGQSNN
OWNCBIHR        : EHVGYDOJOWLS    CNFRFRJWJPTCE   WTDIVRICWMMIOQN ONJVRXXPJWGGY   PTSFSG         
XCDRPSNQ        : RGKMLDGRCASPK   BECMMQM         TAXXDWHPXLO     LWFMXMOWDPROEPF
FTCNFABCK       : XSRIQMQSLG      QCYYSVLBQLLPATO JUCEXXG         XJEBE           IWAIBFU         HQGOSUH        
PTSFSG          : CNFRFRJWJPTCE   WTDIVRICWMMIOQN HCXBYMYQPHS     OWNCBIHR       
TRRMURQ         : UUVVDA          ITGCASL         TFWIFRHYY       IWAIBFU        
LGTBYEH         : VGPARRPB        HPAGMLIDAIAQ    QYGLQIRWROTUQ  
IWAIBFU         : AKPSQPCERTHT    XSXDXENFHBSTF   FTCNFABCK       TRRMURQ         CKRCXAMATMBGV  
UQRA            : BDCT            IXXRMCTT        FJYAHIUODOKROW 
AKETESOVJPHRJJ  : WLACDLQGPBGY   
NSLXROIUTETOUNR : XDMMISBGGG      XSRIQMQSLG      IUKYELPUFGUD    WBROOEOOHFIXUU  EEXYSEMICCGKJKN
PCMK            : FSYAJDIDJTJSU   OQNXIC          ISXAIXXLYOMDNOX
FBEPQNJAWDPR    : PHUH            NGEALNQM        RGNWKIRA        QXVGQ          
NMFWHBDDQXS     : UMYRGIJLFACYFY  MYSOFO          RRLIEGL         HCXBYMYQPHS     NJVQPMNWKHHTJA  LKTBIF          AAYACDMHOEKA   
GJOUVW          : MYSOFO          HJODMBB         LDTS            QQHABE         
WBROOEOOHFIXUU  : SWVQTDX         TXGRYVBVC       KRYNVFBAEQMR    NSLXROIUTETOUNR AIMNLA         
TDFWGXXCIELWB   : ODLOEGMQIFEVU   XYMSDM          VGPARRPB       
TBGWVW          : OCOQ            CILDGQNCKFCG   
AMDHTLHQHLL     : XBVLRLPGIHLY    OOJWOTINUUTV    OSLDGTRAGGHV   
TIURGWBMKA      : OQLBGFBVDFY     LBGIGGQOA       VGPARRPB        RQXWXBPQFDEI   
TWRBTNXGPMJYI   : DVQUTMLDKES     RGGQOIFKH       XJEBE           STVNXKJHR      
GAFUNROVO       : XDMMISBGGG      YOYCYAUXDNHF   
FMJTWMIRJCUDPUM : ELSFL          
KXISVOUDJKWAJM  : UWPBDIDNYSAOKF  KSCTD          
OBUIXHSRSUOW    : LDTS            RMVAMYWYCAI    
KLVWLER         : HYRFTRFUPNMVE   OPEAMQGEH       DJENTMTP        KDXUGJPRJRCTMLK
TNNFXLIH        : IRSMXDJJDOHUNK  JYEPSUBODV     
RXBMJBUC        : WPACRVHOIQ      IPNSKIOUSOIRI   HFWSOXCTMJPJONY ALFXARH        
PAKMMW          : EHVGYDOJOWLS    KLXCCNIB        GMMEHNYE        ONJVRXXPJWGGY   JSCFQLJKFRAJTDU RYLJPO         
JVMNOW          : UCMQKESCWLDEHSF LWDU            EEXYSEMICCGKJKN
CKRCXAMATMBGV   : YPGR            NAYRQP          IWAIBFU        
DYDTYNINNL      : IILB            WEKV            OSKKRSKPNYU     QWEFOFQA       
JXNAWYC         : PEKTB           RGGQOIFKH       BMSULYVDLHBM    WQTCIBQY        VFFNBLUIL      
SHISVIOIMVFT    : SLLXOWCDGQS    
GWWHMGUARUMRKMO : JLBVQJXU        VIBEBYGLYE      IXXRMCTT        PRTJBIGWNUXD   
RXFBGAWRPFENMXO : HFWSOXCTMJPJONY
WMCJUA          : WPACRVHOIQ      TDVXIPBPSV      RGGQOIFKH       QSBQEN          BBOULYEMUDSJXDL
OWYGJNU         : QGBB            PEMQCUWBTE      TBCNBDOFA      
HUAICDHTUPAICA  : NKMJTDINUIQYOX  BRFCOV          YOYCYAUXDNHF    GSKQXKMEVEYGV  
XWNAGIASYY      : SVYIBV          MAOUSU          BHBTXAYDVU      QSBQEN          EDGQMDLNVAMH    CKOORVGHEAD    
FIICEPXG        : OMUEULW         TEKJU           OCKUUEQ         DIXTTOCXFQYHDH  PIBEBMDO       
CLIVGXXODXQBWE  : OGFH            WLACDLQGPBGY    VUXKIHU        
DPEYOFSW        : SEUBPMIKWIRNGQR MYSOFO         
BBUTYBWBNF      : SVYIBV          SQNO            XSXDXENFHBSTF   JWMSHIEHRLYRS   UYJLXSMBLSICUJ 
VGYN            : BQBQTBNOAJ      SFUQRYIU        ANDGHV          XJEBE          
WEKV            : JWMSHIEHRLYRS   DYDTYNINNL      LWFMXMOWDPROEPF WVNKYEMKWYOPAN 
NACTYRARQQVRLRT : OROWBSRVVSIODL  RGKMLDGRCASPK   XPDCJTPYVULCH   CILDGQNCKFCG    BCDGICSOWHDLNX  BBOULYEMUDSJXDL OOJWOTINUUTV   
OWCVYBCX        : CDCRL           ONJVRXXPJWGGY   TMWQGWAS        UCJUXEQJIWGM   
NXSXTDO         : CNFRFRJWJPTCE   QIQYNGAGHQROE   YOYCYAUXDNHF    GKWAMRSDN       YRSXSHOTXYK    
GKWAMRSDN       : ICVVEWFE        XQYJOQOQHCMCWFG NXSXTDO        
QHGGVGKTFLWF    : QWSYJDBTDUMICXT NYCLVCVEKTXSPBH VCNQ            VIBEBYGLYE      HMIAUQKVOKGHM   CXYDRRRHCQHS   
MDUNAYCXHOV     : YPHFDUDRCGN     POVE            VCNQ            HPAGMLIDAIAQ   
CNCHD           : FTBLTCG         TAXXDWHPXLO     IXXRMCTT        RYLJPO         
YKXHIGRCLEB     : EBUSYY          PBXJCJXUAQ      QEGVPMNUOS      UROAW           XSLEIBCWUQU     HQGOSUH         AIMNLA         
GQWCEYD         : IEUJBFIVSBUMA   SQNO            UYJLXSMBLSICUJ 
WMWSVBGALLQK    : HNEYFIUTNNO     PIBEBMDO       
QRGWLLKROCYFBDJ : IGOBJXXTVOSBKXN UMAECFS         PBXJCJXUAQ      OQNXIC          BOHXXNLNLU     
GRYSR           : SVYIBV          RFBKTHVQ        SOOVQCHYYP      GKRV           
QSBQEN          : QBCBTC          HXKVKROA        HAWAA           FFSYKQYSGBLAYB  QEGVPMNUOS      WMCJUA          XWNAGIASYY      CNUFBIBBVIFUGSF
QLBKUA          : KYVIXNRRCOJM    OQLBGFBVDFY     XGORNLHB        QGEOMYALGTMKYU  MRWPNIQQTRFJL  
GLQWPPDSSOSYHR  : WEQGBFSJJAFR    XBVLRLPGIHLY    TYYSGHJB       
YMKTQDYENRRQD   : IPNSKIOUSOIRI   JUCEXXG         TJIVWDBA       
QCWE            : PLKBTUDRSJOX    VUXKIHU        
UTJAMEOHGXCA    : GDQRJOI         IPNSKIOUSOIRI   JUCEXXG         FJYAHIUODOKROW  USYJBNQNPMHX   
QNTHQSNGM       : ALFXARH         GSKQXKMEVEYGV  
YPWSR           : PLKBTUDRSJOX    VNIIOQMYEVG     VGPARRPB        RQXWXBPQFDEI    ELESQIVH       
WLRTWRIDGS      : RRLIEGL         DVQUTMLDKES     SCJCKXUYYBVGPG  KHLDBWGMFDAA    LWFMXMOWDPROEPF
FUMENCXVU       : YWOGTFL         QCYYSVLBQLLPATO YNBWEAPEEDI     XRQXSSMPKVXORFD VJVSB          
LCGTBXR         : WRKYJ           MNTJ            UREKHOLM        XRSEATLKHC      XFQTNDJM        CNUFBIBBVIFUGSF
QOTEGNDAXGGQSNN : YQRDRIJVLUJTLJ  ALFXARH         HEIK           
UCJUXEQJIWGM    : DXMCPBSXTK      HAWAA           KJVFOJURECOLV   OWCVYBCX        PIEMIHACD      
AINOET          : UUVVDA          LYHCJNHHINYU    KMDFMEQM        THVK           
TYYSGHJB        : BNKEXBJYDYXD    GDQRJOI         LFQKSKOLMVAVFFX GLQWPPDSSOSYHR  FIGPRBSODQRPHF 
XISAT           : FQVXCQUGPA      CNFRFRJWJPTCE   FNSAGTJT       
AAELJDRXBTGQKLN : XBVLRLPGIHLY    BWMDBIVTX       HBDREFOBYL     
HMIAUQKVOKGHM   : HXKVKROA        UWPBDIDNYSAOKF  QHGGVGKTFLWF   
WMDEAOHUO       : WTMUXLQFH       NCKOEBEPKFJX    HXAGJSEMMOFSR   DFLRKMPHNBTNW   TSIFD          
OWCAKRJSES      : DTGDW           KRYNVFBAEQMR    YNBWEAPEEDI    
ALFXARH         : NVCBGFOIUB      YNBWEAPEEDI     RXBMJBUC        QNTHQSNGM       QOTEGNDAXGGQSNN KGUBWBXBKNN     QQHABE         
ELESQIVH        : MIPOXTB         YPWSR          
QVDHTH          : XAKQFBY         BDCT            HBDREFOBYL      PIEMIHACD       USYJBNQNPMHX   
GBTYGOUIAAICS   : RIAWQUAQPRDBGJ  QWSYJDBTDUMICXT XGORNLHB        FJUMKGOLJ       WQOAWYAYIKTW    MEPYSGWYLL     
JYEPSUBODV      : CXYCED          VOVP            TNNFXLIH       
BBOULYEMUDSJXDL : WMCJUA          NACTYRARQQVRLRT KKHYJLWYKGXYTBI QCSW           
MNTEYSIQNETEJ   : BQBQTBNOAJ      OMOIQROCAEMOPIR DXMCPBSXTK      WMBQVGRGBMCV    LXDJMPPWNMCWWQ 
LKTBIF          : UIYE            ARBBULCOK       FNSAGTJT        QVORVSOJVQM     BNLMCHLNA       NMFWHBDDQXS     LBNCLS         
MRWPNIQQTRFJL   : OQLBGFBVDFY     TDVXIPBPSV      QLBKUA         
KGUBWBXBKNN     : QSCCMXQNB       XSXDXENFHBSTF   DFLRKMPHNBTNW   ALFXARH        
HQGOSUH         : TXSEQ           XSRIQMQSLG      JSCFQLJKFRAJTDU UEVSKJ          FTCNFABCK       YKXHIGRCLEB    
KWXDNTU         : PNDLYUYXPGTXCE 
FIGPRBSODQRPHF  : WPACRVHOIQ      IKNVFXETVWIE    VCNQ            YNBWEAPEEDI     TYYSGHJB        LWDU            CXYDRRRHCQHS    RYLJPO         
QXVGQ           : EHVGYDOJOWLS    ITGCASL         FBEPQNJAWDPR   
PIEMIHACD       : VGPARRPB        UCJUXEQJIWGM    QVDHTH         
HNEYFIUTNNO     : WEQGBFSJJAFR    KUSQDHEAFB      NFTUEVPH        WMWSVBGALLQK    VFFNBLUIL      
UTTMSPULHK      : FTBLTCG         WAPB            OCKUUEQ         CEECLKLA        ICSD            XJEBE           MWVCMYPNVO     
LWDU            : CDDBVTIMPT      XSRIQMQSLG      JVMNOW          FIGPRBSODQRPHF  UJKLEOADAIVBURF GKRV            CKOORVGHEAD    
IXXRMCTT        : WPACRVHOIQ      VUXKIHU         SDFXKRSSAT      UQRA            GWWHMGUARUMRKMO CNCHD          
OQACFGXBAMV     : OQNGWWQ         EKERQBJN        YJPVDT         
JIBT            : YJPVDT          HXAGJSEMMOFSR   QYHBYQRSSNBBE  
OSKKRSKPNYU     : BTWEVGANHV      MAOUSU          UBSH            VOVP            TMWQGWAS        DYDTYNINNL     
THVK            : CEECLKLA        HPAGMLIDAIAQ    WQTCIBQY        AINOET          LWFMXMOWDPROEPF
XRQXSSMPKVXORFD : EBUSYY          OTWJSATSVOJBO   QICB            FUMENCXVU       PRTJBIGWNUXD    XPYIWMLAJRO    
PNDLYUYXPGTXCE  : JSCFQLJKFRAJTDU FUKX            IOIGNKDNGMKI    XSLEIBCWUQU     KWXDNTU        
CXYDRRRHCQHS    : NFIMKAKATPDEJLC GBLMPWYAJ       UTPXTSYGTRVBM   QHGGVGKTFLWF    FIGPRBSODQRPHF 
MWVCMYPNVO      : WLACDLQGPBGY    QYHBYQRSSNBBE   UTTMSPULHK      RGFFFT         
MWIKYPSENTJFLB  : GVJNIYJNTYTHIP  HFWSOXCTMJPJONY LDTS           
PRTJBIGWNUXD    : CNFRFRJWJPTCE   HYRFTRFUPNMVE   GWWHMGUARUMRKMO XRQXSSMPKVXORFD UJKLEOADAIVBURF
TUXIR           : TJUDY           RMVAMYWYCAI    
STVNXKJHR       : GSOY            NAYRQP          UODOH           TWRBTNXGPMJYI  
KHLDBWGMFDAA    : TXSEQ           SVKSRTI         WLRTWRIDGS      LXDJMPPWNMCWWQ 
FJYAHIUODOKROW  : OUVBSCFGRWGQ    UQRA            UTJAMEOHGXCA    BJTLAAHJU      
XPYIWMLAJRO     : QWSYJDBTDUMICXT GVJNIYJNTYTHIP  XRQXSSMPKVXORFD DWCBBXFBWQ      CHPVNUBOLONQVKJ
WQOAWYAYIKTW    : QCYYSVLBQLLPATO GBTYGOUIAAICS  
KKHYJLWYKGXYTBI : IPNSKIOUSOIRI   VQWQAEMC        BBOULYEMUDSJXDL VFFNBLUIL      
RYLJPO          : RGKMLDGRCASPK   GSOY            TFWIFRHYY       PAKMMW          CNCHD           FIGPRBSODQRPHF 
QQHABE          : GVDOX           GJOUVW          ALFXARH        
OOJWOTINUUTV    : DXMCPBSXTK      NJVQPMNWKHHTJA  AMDHTLHQHLL     NACTYRARQQVRLRT KDXUGJPRJRCTMLK
QWEFOFQA        : SOOVQCHYYP      DYDTYNINNL     
HIMXQM          : ETJNWRPACCEFV   YMTN            PWDM            IEGTVCQX        NFIMKAKATPDEJLC ITGCASL         GDQRJOI         XQYJOQOQHCMCWFG
WLOLVNAPXQKUM   : HPEWQQQEU       FSCTB          
QDFUIWACYUJI    : KYVIXNRRCOJM   
IBVJXKAJGNMXN   : DTGDW          
KIPTYVBVEAVI    : BRNBGY          IRSMXDJJDOHUNK  UBSH            XGFWYHKK        MEPYSGWYLL     
TSIFD           : QBCBTC          NFIMKAKATPDEJLC SVKSRTI         WMDEAOHUO      
CMJMNUUDHSRMD   : RFBKTHVQ        WRBLLMRK       
DWCBBXFBWQ      : KYVIXNRRCOJM    NXSXDLOUHF      XPYIWMLAJRO     QYGLQIRWROTUQ  
SLLXOWCDGQS     : OMOIQROCAEMOPIR QGBB            GSOY            BOHXXNLNLU      SHISVIOIMVFT   
LYLGQYMU        : JGIYBCVOMTJFWQ  WMBQVGRGBMCV    XGFWYHKK       
LWFMXMOWDPROEPF : DCHUCSRGWTXKIQW WMDUNOOGUVTO    XCDRPSNQ        WEKV            WLRTWRIDGS      THVK           
UJKLEOADAIVBURF : LXEQQNPADKEJY   LWDU            PRTJBIGWNUXD   
QMVQAKPFDHUHA   : PHUH            OROWBSRVVSIODL  WKGYSYFMQEIYHHN EGUJ           
KUNUISJIXMRU    : LPEXRLPVW       XQYJOQOQHCMCWFG DOTW           
OOVX            : HYRFTRFUPNMVE   CEECLKLA       
IUYKHOQKWN      : TEKJU          
WPHTGE          : BQBQTBNOAJ      DSIFBPIWSQVFFM 
YONYDHTSVIOWQX  : YPHFDUDRCGN     XYJB            GDQRJOI        
PIBEBMDO        : KYVIXNRRCOJM    WRAOLOPEOUPD    LBGIGGQOA       FIICEPXG        WMWSVBGALLQK   
CHPVNUBOLONQVKJ : WRBLLMRK        QYHBYQRSSNBBE   XPYIWMLAJRO    
UYQLYKDJM       : OMPJPVYUFGAYTO  VBISQYFF       
LBNCLS          : PWDM            GVDOX           NAYRQP          LKTBIF         
CQYYRPM         : DCHUCSRGWTXKIQW BJTLAAHJU      
EDGQMDLNVAMH    : SMUMRWUKBOO     HPAGMLIDAIAQ    EGUJ            XWNAGIASYY     
WVNKYEMKWYOPAN  : QSCCMXQNB       RRCNN           IUKYELPUFGUD    WEKV           
QCSW            : SVKSRTI         RQXWXBPQFDEI    BBOULYEMUDSJXDL GKRV           
CNUFBIBBVIFUGSF : WLACDLQGPBGY    OCKUUEQ         UTPXTSYGTRVBM   OPEAMQGEH       TBCNBDOFA       QSBQEN          LCGTBXR         YRSXSHOTXYK    
CNUFBIBBVIFUGSF : VFFNBLUIL      
YRSXSHOTXYK     : NFTUEVPH        NXSXTDO         CNUFBIBBVIFUGSF
TJIVWDBA        : KLXCCNIB        YMKTQDYENRRQD  
DCJNHEUCLCEEUCW : OGFH            YJPVDT          QBXN            NYSDJAP         HPAGMLIDAIAQ   
QSDRDFMMNIL     : OVLFNKUN        BMSULYVDLHBM    OSSFIAY        
KOHPQS          : DSODG           DSIFBPIWSQVFFM  VUXKIHU         XRSEATLKHC      QEGVPMNUOS      UYJLXSMBLSICUJ 
AXAEJFIPCL      : ETJNWRPACCEFV   QGXG            MEPYSGWYLL     
HEIK            : DBORS           EUDE            JWMSHIEHRLYRS   QOTEGNDAXGGQSNN
OSLDGTRAGGHV    : YJPOIHXQKUVEWDT ITGCASL         AMDHTLHQHLL    
AAYACDMHOEKA    : XGFWYHKK        DIXTTOCXFQYHDH  NMFWHBDDQXS    
RGFFFT          : IRSMXDJJDOHUNK  MNTJ            MWVCMYPNVO     
QYGLQIRWROTUQ   : YJPOIHXQKUVEWDT BTWEVGANHV      ICSD            LGTBYEH         DWCBBXFBWQ      VFFNBLUIL      
USYJBNQNPMHX    : OMOIQROCAEMOPIR IEUJBFIVSBUMA   ELSFL           VKSNFBIIIGUABNC UTJAMEOHGXCA    QVDHTH         
OENOUNVIE       : MAOUSU          WLGYKMLG        IKNVFXETVWIE    JPKYP          
DCWTXRKVOFU     : XRSEATLKHC      GSOY            EVGE           
GKRV            : DSIFBPIWSQVFFM  CHQERQYTIBY     HFWSOXCTMJPJONY GRYSR           LWDU            QCSW           
EEXYSEMICCGKJKN : ITGCASL         BHBTXAYDVU      RGPE            OTWJSATSVOJBO   NSLXROIUTETOUNR JVMNOW          BJTLAAHJU      
JJNDTJUAEVIOPHQ : EKERQBJN        UEVSKJ         
LRUGVKOAMWLV    : BQBQTBNOAJ      SMUMRWUKBOO    
BJTLAAHJU       : FWQJP           ELSFL           HCXBYMYQPHS     BMSULYVDLHBM    BNLMCHLNA       FJYAHIUODOKROW  CQYYRPM         EEXYSEMICCGKJKN
OSSFIAY         : TGROHHESTBBMQ   NFIMKAKATPDEJLC BTWEVGANHV      MIPOXTB         QSDRDFMMNIL    
NQATOMLP        : JLBVQJXU       
KDXUGJPRJRCTMLK : TXSEQ           NVCBGFOIUB      HXAGJSEMMOFSR   DVQUTMLDKES     LGYG            KLVWLER         OOJWOTINUUTV   
GRPIQ           : MIPOXTB         WMBQVGRGBMCV    TMWQGWAS       
VJVSB           : LFQKSKOLMVAVFFX LDTS            EUDE            FUMENCXVU      
GSKQXKMEVEYGV   : SFUQRYIU        DFBTOA          QICB            HUAICDHTUPAICA  QNTHQSNGM       AIMNLA         
CKOORVGHEAD     : EGAUECOSMEEDS   BNLMCHLNA       XWNAGIASYY      LWDU           
LCXMK           : NCKOEBEPKFJX    GVDOX           UEVSKJ         
HWUFHJMENLMLO   : SWVQTDX         CHQERQYTIBY     IOIGNKDNGMKI   
VFFNBLUIL       : BECMMQM         JXNAWYC         HNEYFIUTNNO     KKHYJLWYKGXYTBI CNUFBIBBVIFUGSF QYGLQIRWROTUQ  
LXDJMPPWNMCWWQ  : GXXLCSEMUQDE    MNTEYSIQNETEJ   KHLDBWGMFDAA   
MEPYSGWYLL      : SVYIBV          NNFGPIKJMTNLB   GBTYGOUIAAICS   KIPTYVBVEAVI    AXAEJFIPCL     
AIMNLA          : HPEWQQQEU       RMVAMYWYCAI     WBROOEOOHFIXUU  YKXHIGRCLEB     GSKQXKMEVEYGV  
