KSPAPWBBOI      : WCFIILNWGMQJO   ENQYOM         
SOCQOABU        : LRVPQDQGCEGBPQ  HPMQBGDRMCXIBY  XAHLVFFJUGT     AIFA            TOGBKBUATGYS   
RNIXWKMSXEO     : QEEKD           RXSWLEMTYKRKC   IJXXBTPG       
YGLPDPST        : GUOXU           WCFIILNWGMQJO  
RMNWGCWHYOYM    : DDUDOGPAQCBWN   EHVPFXCAG      
WLKLEKQVVRCI    : QTBGUMSTFMOFEV  RGYJBILUWGHI    AYOGMATFWBL     NROXNJOUJL      YNHVPAOMPKNQCW 
IXACXU          : BPUWCNXEKDOPKN  OWKIF           EHVPFXCAG       LVPOODQYYJIOGR  QXDQENBF       
LRVPQDQGCEGBPQ  : SOCQOABU        QIWJWONNFFGA    UWXETYGBKDIR    OMOCYQOPFL     
WBGSXXUIGFGII   : LQEWGSWYTLU     SLCHTQJPWGSIPBT BFIALQBBQNTRD  
DXSWVKQYC       : GEQDWYMXSRPDAFH EYAHH          
DIFGXVTWYCPWBN  : WDHMLMULPBXSFUJ PENKPT          QDFX            PVPFY           IPJV           
JSNTBU          : KRPHPSW         UQLWNLFOIH      WFGQBI          FAJTN           IGFGRUT        
BPUWCNXEKDOPKN  : IXACXU          RDCDDBMDW      
GMNJDMMSUX      : VDKETOA         WDHMLMULPBXSFUJ KMTXTNPXHTDUPW  HXEBXJUDETRANKB JHJD           
KRPHPSW         : JSNTBU          WDHMLMULPBXSFUJ NRPWRVXQFUT     YBBDMDBDBDPEY  
SCBSIOWX        : SRRWVVGXFQBVPA  GQGWUHW         NDIOHENOHATQT   YSRX            CXKTEGJNYN      KHRT            GRXLXRHSVFGYPYM
JNWPAKBD        : JOHGDV          NROXNJOUJL      YMGJMRDPUV     
NVTNKHGAOX      : RYCEAG          PVQWQMJFBYJ     IGFGRUT         QXDQENBF       
ONNQRH          : FLLALDBXJL      GUOXU          
GGWOPKLFLXJQAYN : VKOYG           QDFX            AJPYM          
NABTCSTWHINX    : CFMKNMXSYNTJG   OWKIF           EEOU           
UWIBWYQHNXULHML : JPPTCJAVNXBM    WVFRAKNU        HRCAF           TUKUSYDBTWW     VLPNKYQWLDHQIN 
CIUC            : SIWKQVVTFIPEOW  FAJTN           PVPFY           ASQSKEHXUAYU   
QEEKD           : RNIXWKMSXEO     FKLVX           EVNADALYISOBI   AMCNBJ          JPPTCJAVNXBM    DTUSEQI         RLLCH          
UQLWNLFOIH      : JSNTBU          JGTANX          OMOCYQOPFL      IJXXBTPG       
RUGNIP          : YHQV            FAJTN           WVFRAKNU        HRCAF          
WYEHT           : NVYMGLDMXVAN    FMDEUOAMUH      RGYJBILUWGHI    SOFNXRWY       
SMOAARNULCSYP   : AFMXRSWA        LEKEK           OHITKNN         ISSTB           AYOGMATFWBL     JPPTCJAVNXBM   
QAHXREG         : XHQPOCMTXC      IJXXBTPG       
NYJMX           : DVXGEVSXPAMEI   GDBG            BIPTJAROS       XHQPOCMTXC      LCBC            YMGJMRDPUV     
TUAOHOOHJF      : NERBVCEAPSIF    WDHMLMULPBXSFUJ ISSTB           QPJUGFCLNAD    
UJAVYCMYMN      : OVOVIMQE        XUPFJBTFOJ      SIWKQVVTFIPEOW  RHLLXN         
QTBGUMSTFMOFEV  : WLKLEKQVVRCI    RYCEAG          GXIWHA          SOFNXRWY       
SGIANDJNBKPOJE  : DDUDOGPAQCBWN  
DVXGEVSXPAMEI   : NYJMX           OHITKNN         YRBATPTBXWFDHS  HRCAF          
CFMKNMXSYNTJG   : NABTCSTWHINX    QJCLXBMUITOAWRN PVQWQMJFBYJ     YNTU            DDCRSHKTGTEU    YNHVPAOMPKNQCW 
VKOYG           : GGWOPKLFLXJQAYN RDDLRHCXNXB     GTIOSXAGRVFVWH  NVFFIXPVOTSYEII
FLLALDBXJL      : ONNQRH          RXKNTWCJOSGFFAA XHQPOCMTXC      KLTKYUVRJW      RBDYPVAEIWGR   
LQEWGSWYTLU     : WBGSXXUIGFGII   NERBVCEAPSIF    NDIOHENOHATQT   YJDKKM         
TICEYDNOKBCM    : EVNADALYISOBI   DKKLKS          ASQSKEHXUAYU   
HPMQBGDRMCXIBY  : SOCQOABU        PENKPT          VMMMRPUNKT      NRPWRVXQFUT     LKMJMEFFBXTLFX  AMCNBJ          UQHX           
OWKIF           : IXACXU          NABTCSTWHINX    IJXXBTPG        DDCRSHKTGTEU   
NERBVCEAPSIF    : TUAOHOOHJF      LQEWGSWYTLU     WQELS           UQHX           
YHOEBBGCJKBOYXY : DDUDOGPAQCBWN   YSRX            SIWKQVVTFIPEOW  LVPOODQYYJIOGR 
DOVKGYGLDIDVQK  : XUPFJBTFOJ      HSOER           PVQWQMJFBYJ    
SRRWVVGXFQBVPA  : SCBSIOWX        JHJD           
AFMXRSWA        : SMOAARNULCSYP   XHQPOCMTXC      DKKLKS          RDCDDBMDW       FDESJL         
CJJAC           : VFUEQICEUMNNDH  AIFA           
GUOXU           : YGLPDPST        ONNQRH          RFUWMVTSYUB     JHJD           
VDKETOA         : GMNJDMMSUX      NGJEKOSFFX     
OVOVIMQE        : UJAVYCMYMN      FMDEUOAMUH      HRCAF           RSTNTBXQH      
QKOCWPFRVC      : CLVTQWBXLTXVJU  PHSDPKGJ        FDESJL          RBDYPVAEIWGR   
VYVSCIWVWW      : LEKEK           NDIOHENOHATQT  
NVYMGLDMXVAN    : WYEHT           XUPFJBTFOJ      HCJSJRFKU       RLLCH          
WFGQBI          : JSNTBU          YRBATPTBXWFDHS  JPPTCJAVNXBM    GRXLXRHSVFGYPYM
YKWTMIQLFQVTO   : GTIOSXAGRVFVWH  GRXLXRHSVFGYPYM
GWKLKLHMYGLGMC  : WDHMLMULPBXSFUJ XUPFJBTFOJ      AKIERNGRJTWHIP  EVNADALYISOBI   DDCRSHKTGTEU   
XFIIFDUNVISOE   : IGPRQFBHVSWEU   KLTKYUVRJW      CXKTEGJNYN     
DDUDOGPAQCBWN   : RMNWGCWHYOYM    SGIANDJNBKPOJE  YHOEBBGCJKBOYXY XEICFLF         IGFGRUT        
MRSMYBWEE       : EVNADALYISOBI   OQEF           
RDDLRHCXNXB     : VKOYG           YSRX            FDESJL         
GQGWUHW         : SCBSIOWX        UWXETYGBKDIR    FPSELTKTXPHDBK 
QJCLXBMUITOAWRN : CFMKNMXSYNTJG   AKIERNGRJTWHIP  EDNELMVOPRGJTE  JHJD            SLCHTQJPWGSIPBT VQTHUAC        
CQOPQRVYKCWHLV  : HSOER           PVQWQMJFBYJ     AKIERNGRJTWHIP  BIPTJAROS       KLTKYUVRJW      RSTNTBXQH      
EHVPFXCAG       : RMNWGCWHYOYM    IXACXU          BIPTJAROS       LVPOODQYYJIOGR  WCFIILNWGMQJO   MRJQPLNLOQY    
QIWJWONNFFGA    : LRVPQDQGCEGBPQ 
FMDEUOAMUH      : WYEHT           OVOVIMQE        AYOGMATFWBL    
KMJOORPIAM      : XUPFJBTFOJ      RHLLXN         
WDHMLMULPBXSFUJ : DIFGXVTWYCPWBN  GMNJDMMSUX      KRPHPSW         TUAOHOOHJF      GWKLKLHMYGLGMC  JHJD            GWPKKQV         KHRT           
WDHMLMULPBXSFUJ : RBDYPVAEIWGR   
IGPRQFBHVSWEU   : XFIIFDUNVISOE  
XUPFJBTFOJ      : UJAVYCMYMN      DOVKGYGLDIDVQK  NVYMGLDMXVAN    GWKLKLHMYGLGMC  KMJOORPIAM      XHQPOCMTXC     
PENKPT          : DIFGXVTWYCPWBN  HPMQBGDRMCXIBY  GDBG           
VMMMRPUNKT      : HPMQBGDRMCXIBY  GNILQUHEKEWO    GRXLXRHSVFGYPYM
GEQDWYMXSRPDAFH : DXSWVKQYC       NGJEKOSFFX      VLBHQKBABOT    
RXKNTWCJOSGFFAA : FLLALDBXJL      NRPWRVXQFUT     LKMJMEFFBXTLFX  HVESTTQGWG      GWPKKQV         XEICFLF        
HSOER           : DOVKGYGLDIDVQK  CQOPQRVYKCWHLV  ISSTB           HCJSJRFKU       XWNIRDSQ        IDIAYHXVORV    
CLVTQWBXLTXVJU  : QKOCWPFRVC      KLSISDOXSSLIRB  YNHVPAOMPKNQCW 
LEKEK           : SMOAARNULCSYP   VYVSCIWVWW      CXKTEGJNYN     
KMTXTNPXHTDUPW  : GMNJDMMSUX      XHQPOCMTXC      FAJTN           IJXXBTPG        TUKUSYDBTWW    
OYMAUMYEHUPLH   : VFUEQICEUMNNDH  UTDDNIFSYL     
XAHLVFFJUGT     : SOCQOABU        CSLFHJBBVJSYHE  DDCRSHKTGTEU    DKKLKS          WVFRAKNU       
JOHGDV          : JNWPAKBD        UQHX            NGJEKOSFFX     
RYCEAG          : NVTNKHGAOX      QTBGUMSTFMOFEV  EGPXY           RBDYPVAEIWGR   
UWXETYGBKDIR    : LRVPQDQGCEGBPQ  GQGWUHW         TPEDTMVEMIV     IHQOTGPH       
GXIWHA          : QTBGUMSTFMOFEV  KLTKYUVRJW      WQELS           LXDGQQMAUAQP   
QDFX            : DIFGXVTWYCPWBN  GGWOPKLFLXJQAYN KLTKYUVRJW      EOKDADOM        IDIAYHXVORV     MRJQPLNLOQY    
GDBG            : NYJMX           PENKPT          RFUWMVTSYUB     KHRT           
NDIOHENOHATQT   : SCBSIOWX        LQEWGSWYTLU     VYVSCIWVWW      AKIERNGRJTWHIP  YRBATPTBXWFDHS 
YSRX            : SCBSIOWX        YHOEBBGCJKBOYXY RDDLRHCXNXB     RFUWMVTSYUB     AJPYM           RSTNTBXQH      
RFUWMVTSYUB     : GUOXU           GDBG            YSRX            JGTANX          SOFNXRWY       
JGTANX          : UQLWNLFOIH      RFUWMVTSYUB     NMVTIVIILOQ     FKLVX           GTIOSXAGRVFVWH 
EGPXY           : RYCEAG          LKMJMEFFBXTLFX  YMBFSWOISOIYGGG
HXEBXJUDETRANKB : GMNJDMMSUX      YNTU            IDIAYHXVORV    
NMVTIVIILOQ     : JGTANX         
NRPWRVXQFUT     : KRPHPSW         HPMQBGDRMCXIBY  RXKNTWCJOSGFFAA YHQV           
OMOCYQOPFL      : LRVPQDQGCEGBPQ  UQLWNLFOIH     
NHTXVJP         : FAJTN           WVKJMXJPFAGT    WVFRAKNU        RLLCH           MRJQPLNLOQY     XTXJ           
YHQV            : RUGNIP          NRPWRVXQFUT     KLSISDOXSSLIRB 
PVQWQMJFBYJ     : NVTNKHGAOX      CFMKNMXSYNTJG   DOVKGYGLDIDVQK  CQOPQRVYKCWHLV 
RXSWLEMTYKRKC   : RNIXWKMSXEO     YNTU            CXKTEGJNYN      IHQOTGPH        YBBDMDBDBDPEY   SOFNXRWY        LXDGQQMAUAQP   
LKMJMEFFBXTLFX  : HPMQBGDRMCXIBY  RXKNTWCJOSGFFAA EGPXY           UTDDNIFSYL     
QDGQVFDCR       : IHQOTGPH        XEICFLF         YNHVPAOMPKNQCW 
DEQNHLB         : PWFRWJ          ENQYOM          GRXLXRHSVFGYPYM
AKIERNGRJTWHIP  : GWKLKLHMYGLGMC  QJCLXBMUITOAWRN CQOPQRVYKCWHLV  NDIOHENOHATQT   FAJTN           XEICFLF         FPSELTKTXPHDBK 
OHITKNN         : SMOAARNULCSYP   DVXGEVSXPAMEI   EDNELMVOPRGJTE  XHQPOCMTXC      EEOU            WMGG           
QREHY           : HCJSJRFKU       TUKUSYDBTWW    
ISSTB           : SMOAARNULCSYP   TUAOHOOHJF      HSOER           GNILQUHEKEWO   
NQHGB           : GTIOSXAGRVFVWH  IGFGRUT        
FKLVX           : QEEKD           JGTANX          LCBC            XEICFLF         NGJEKOSFFX      ENQYOM          YNHVPAOMPKNQCW 
DIVPVJBPEFWDW   : EOKDADOM       
YRBATPTBXWFDHS  : DVXGEVSXPAMEI   WFGQBI          NDIOHENOHATQT   UTDDNIFSYL     
HVESTTQGWG      : RXKNTWCJOSGFFAA FPPPFWEFLM      XWNIRDSQ        NROXNJOUJL     
EDNELMVOPRGJTE  : QJCLXBMUITOAWRN OHITKNN         RDCDDBMDW      
BIPTJAROS       : NYJMX           CQOPQRVYKCWHLV  EHVPFXCAG       SIWKQVVTFIPEOW  HCJSJRFKU      
KLSISDOXSSLIRB  : CLVTQWBXLTXVJU  YHQV            YNTU            PHSDPKGJ        IPJV           
JHJD            : GMNJDMMSUX      SRRWVVGXFQBVPA  GUOXU           QJCLXBMUITOAWRN WDHMLMULPBXSFUJ
RGYJBILUWGHI    : WLKLEKQVVRCI    WYEHT           CXKTEGJNYN      WMGG            VLPNKYQWLDHQIN 
CSLFHJBBVJSYHE  : XAHLVFFJUGT     WMGG           
SIWKQVVTFIPEOW  : CIUC            UJAVYCMYMN      YHOEBBGCJKBOYXY BIPTJAROS       AMCNBJ         
HCJSJRFKU       : NVYMGLDMXVAN    HSOER           QREHY           BIPTJAROS       IPJV           
TPEDTMVEMIV     : UWXETYGBKDIR    PWFRWJ          YMBFSWOISOIYGGG XWNIRDSQ        ENVOXL         
FPPPFWEFLM      : HVESTTQGWG      AYOGMATFWBL     WVKJMXJPFAGT   
XHQPOCMTXC      : QAHXREG         NYJMX           FLLALDBXJL      AFMXRSWA        XUPFJBTFOJ      KMTXTNPXHTDUPW  OHITKNN         QXDQENBF       
EVNADALYISOBI   : QEEKD           TICEYDNOKBCM    GWKLKLHMYGLGMC  MRSMYBWEE       AIFA           
AMCNBJ          : QEEKD           HPMQBGDRMCXIBY  SIWKQVVTFIPEOW 
LCBC            : NYJMX           FKLVX           VNDBGYHTSRPS   
PWFRWJ          : DEQNHLB         TPEDTMVEMIV    
KLTKYUVRJW      : FLLALDBXJL      XFIIFDUNVISOE   CQOPQRVYKCWHLV  GXIWHA          QDFX            PVPFY           RHLLXN          OQEF           
GWPKKQV         : WDHMLMULPBXSFUJ RXKNTWCJOSGFFAA QPJUGFCLNAD    
EYAHH           : DXSWVKQYC       IPJV           
EOKDADOM        : QDFX            DIVPVJBPEFWDW   VFUEQICEUMNNDH 
YNTU            : CFMKNMXSYNTJG   HXEBXJUDETRANKB RXSWLEMTYKRKC   KLSISDOXSSLIRB  GRXLXRHSVFGYPYM
GTIOSXAGRVFVWH  : VKOYG           YKWTMIQLFQVTO   JGTANX          NQHGB           OQEF           
FAJTN           : JSNTBU          CIUC            RUGNIP          KMTXTNPXHTDUPW  NHTXVJP         AKIERNGRJTWHIP 
WQELS           : NERBVCEAPSIF    GXIWHA          LXDGQQMAUAQP    EEOU           
YMBFSWOISOIYGGG : EGPXY           TPEDTMVEMIV     AJPYM          
GNILQUHEKEWO    : VMMMRPUNKT      ISSTB          
PVPFY           : DIFGXVTWYCPWBN  CIUC            KLTKYUVRJW      RDCDDBMDW      
XWNIRDSQ        : HSOER           HVESTTQGWG      TPEDTMVEMIV     SOFNXRWY       
AYOGMATFWBL     : WLKLEKQVVRCI    SMOAARNULCSYP   FMDEUOAMUH      FPPPFWEFLM      DKKLKS         
IJXXBTPG        : RNIXWKMSXEO     UQLWNLFOIH      QAHXREG         OWKIF           KMTXTNPXHTDUPW 
PHSDPKGJ        : QKOCWPFRVC      KLSISDOXSSLIRB  LXDGQQMAUAQP    ENQYOM         
SLCHTQJPWGSIPBT : WBGSXXUIGFGII   QJCLXBMUITOAWRN VNDBGYHTSRPS   
CXKTEGJNYN      : SCBSIOWX        XFIIFDUNVISOE   LEKEK           RXSWLEMTYKRKC   RGYJBILUWGHI    VLPNKYQWLDHQIN 
LVPOODQYYJIOGR  : IXACXU          YHOEBBGCJKBOYXY EHVPFXCAG      
RHLLXN          : UJAVYCMYMN      KMJOORPIAM      KLTKYUVRJW      VNDBGYHTSRPS    ENVOXL         
IHQOTGPH        : UWXETYGBKDIR    RXSWLEMTYKRKC   QDGQVFDCR      
DDCRSHKTGTEU    : CFMKNMXSYNTJG   OWKIF           GWKLKLHMYGLGMC  XAHLVFFJUGT     WVKJMXJPFAGT    DTUSEQI         ENVOXL          IPJV           
VFUEQICEUMNNDH  : CJJAC           OYMAUMYEHUPLH   EOKDADOM        DKKLKS         
UQHX            : HPMQBGDRMCXIBY  NERBVCEAPSIF    JOHGDV          AIFA            FDESJL          RBDYPVAEIWGR   
JPPTCJAVNXBM    : UWIBWYQHNXULHML QEEKD           SMOAARNULCSYP   WFGQBI         
VQTHUAC         : QJCLXBMUITOAWRN VLBHQKBABOT    
NROXNJOUJL      : WLKLEKQVVRCI    JNWPAKBD        HVESTTQGWG      YJDKKM         
YBBDMDBDBDPEY   : KRPHPSW         RXSWLEMTYKRKC   TUKUSYDBTWW     IGFGRUT        
AIFA            : SOCQOABU        CJJAC           EVNADALYISOBI   UQHX            WCFIILNWGMQJO  
OQEF            : MRSMYBWEE       KLTKYUVRJW      GTIOSXAGRVFVWH 
SOFNXRWY        : WYEHT           QTBGUMSTFMOFEV  RFUWMVTSYUB     RXSWLEMTYKRKC   XWNIRDSQ       
XEICFLF         : DDUDOGPAQCBWN   RXKNTWCJOSGFFAA QDGQVFDCR       AKIERNGRJTWHIP  FKLVX          
DKKLKS          : TICEYDNOKBCM    AFMXRSWA        XAHLVFFJUGT     AYOGMATFWBL     VFUEQICEUMNNDH  FPSELTKTXPHDBK  YJDKKM         
NGJEKOSFFX      : VDKETOA         GEQDWYMXSRPDAFH JOHGDV          FKLVX          
FPSELTKTXPHDBK  : GQGWUHW         AKIERNGRJTWHIP  DKKLKS          LXDGQQMAUAQP    AJPYM          
LXDGQQMAUAQP    : GXIWHA          RXSWLEMTYKRKC   WQELS           PHSDPKGJ        FPSELTKTXPHDBK  HRCAF          
VNDBGYHTSRPS    : LCBC            SLCHTQJPWGSIPBT RHLLXN          YNHVPAOMPKNQCW 
WVKJMXJPFAGT    : NHTXVJP         FPPPFWEFLM      DDCRSHKTGTEU   
DTUSEQI         : QEEKD           DDCRSHKTGTEU    TVTAKKLB       
TOGBKBUATGYS    : SOCQOABU       
KHRT            : SCBSIOWX        WDHMLMULPBXSFUJ GDBG           
WVFRAKNU        : UWIBWYQHNXULHML RUGNIP          XAHLVFFJUGT     NHTXVJP         TUKUSYDBTWW    
RLLCH           : QEEKD           NVYMGLDMXVAN    NHTXVJP         KKPOFQIOR      
KKPOFQIOR       : RLLCH           QPJUGFCLNAD    
IDIAYHXVORV     : HSOER           QDFX            HXEBXJUDETRANKB ASQSKEHXUAYU   
HRCAF           : UWIBWYQHNXULHML RUGNIP          DVXGEVSXPAMEI   OVOVIMQE        LXDGQQMAUAQP    FDESJL          AJPYM          
ENVOXL          : TPEDTMVEMIV     RHLLXN          DDCRSHKTGTEU    ASQSKEHXUAYU    AJPYM          
EEOU            : NABTCSTWHINX    OHITKNN         WQELS          
RDCDDBMDW       : BPUWCNXEKDOPKN  AFMXRSWA        EDNELMVOPRGJTE  PVPFY          
UTDDNIFSYL      : OYMAUMYEHUPLH   LKMJMEFFBXTLFX  YRBATPTBXWFDHS  WMGG           
WCFIILNWGMQJO   : KSPAPWBBOI      YGLPDPST        EHVPFXCAG       AIFA           
MRJQPLNLOQY     : EHVPFXCAG       QDFX            NHTXVJP         ASQSKEHXUAYU   
XTXJ            : NHTXVJP         YJDKKM         
WMGG            : OHITKNN         RGYJBILUWGHI    CSLFHJBBVJSYHE  UTDDNIFSYL     
TVTAKKLB        : DTUSEQI         RSTNTBXQH      
ASQSKEHXUAYU    : CIUC            TICEYDNOKBCM    IDIAYHXVORV     ENVOXL          MRJQPLNLOQY     IGFGRUT        
TUKUSYDBTWW     : UWIBWYQHNXULHML KMTXTNPXHTDUPW  QREHY           YBBDMDBDBDPEY   WVFRAKNU       
YJDKKM          : LQEWGSWYTLU     NROXNJOUJL      DKKLKS          XTXJ           
FDESJL          : AFMXRSWA        QKOCWPFRVC      RDDLRHCXNXB     UQHX            HRCAF          
ENQYOM          : KSPAPWBBOI      DEQNHLB         FKLVX           PHSDPKGJ       
AJPYM           : GGWOPKLFLXJQAYN YSRX            YMBFSWOISOIYGGG FPSELTKTXPHDBK  HRCAF           ENVOXL         
VLPNKYQWLDHQIN  : UWIBWYQHNXULHML RGYJBILUWGHI    CXKTEGJNYN     
RBDYPVAEIWGR    : FLLALDBXJL      QKOCWPFRVC      WDHMLMULPBXSFUJ RYCEAG          UQHX           
IGFGRUT         : JSNTBU          NVTNKHGAOX      DDUDOGPAQCBWN   NQHGB           YBBDMDBDBDPEY   ASQSKEHXUAYU   
VLBHQKBABOT     : GEQDWYMXSRPDAFH VQTHUAC        
RSTNTBXQH       : OVOVIMQE        CQOPQRVYKCWHLV  YSRX            TVTAKKLB       
GRXLXRHSVFGYPYM : SCBSIOWX        WFGQBI          YKWTMIQLFQVTO   VMMMRPUNKT      DEQNHLB         YNTU           
YNHVPAOMPKNQCW  : WLKLEKQVVRCI    CFMKNMXSYNTJG   CLVTQWBXLTXVJU  QDGQVFDCR       FKLVX           VNDBGYHTSRPS   
IPJV            : DIFGXVTWYCPWBN  KLSISDOXSSLIRB  HCJSJRFKU       EYAHH           DDCRSHKTGTEU   
BFIALQBBQNTRD   : WBGSXXUIGFGII  
NVFFIXPVOTSYEII : VKOYG          
YMGJMRDPUV      : JNWPAKBD        NYJMX          
QPJUGFCLNAD     : TUAOHOOHJF      GWPKKQV         KKPOFQIOR      
QXDQENBF        : IXACXU          NVTNKHGAOX      XHQPOCMTXC     
