IYBNM           : JRIFV           KYLLI           OHBAXOOFYCIBS   DANIINNC        SOIJICX         WBMXXKQICRF     ANJE           
NDKTEOODOCQBY   : QXNDS           AFXFOWAR        CDFOV           ISENYQSBNRFF    MAOJDNIPDOJHO  
ESEXSWHUU       : XFKODXRYB       DKSHXABY        JOWYBGWAJ      
XEGYTTYIWL      : YQGDJKMGED      FFQEFMXJMI      YCATBPFWPTIG    VJLN            PJKDFXPUMNNOO  
BATGRXWSWOWRVWL : GUCFPPM         OGLUK           VPQIGYOPRSJUKLU DJDWFGJRPUFA   
EGQMGWSGQOHBLTG : CDBTLRDFPI      LGCOGDOTLVHXQEA TJRKBTPABJFMV   HYXESRRHEHHFUKP FFFCDBMNIGHQCT  SREAKHFRM      
VCXNAVIYMHRKFF  : BNJNACMI        GUCFPPM         XYCSVORWYHMS    TBHFRASRCL      NIUBX          
LNYATXVC        : ULBGPFTEPTPHF   FRSISKLOHR      LOHNJSWL        GINVPUADLNW     GHWTST          NIUBX          
KKQYGYQCBOS     : LFNSA           QXGQVXWV        FTYLDFKG       
MBCCLV          : OGMUKULMDIONDD 
QBUEOVFL        : WEFJGOCSF      
BNJNACMI        : VCXNAVIYMHRKFF  AOOCRHQSVKNUY  
FNEUGHJJJL      : VEVYE           CDHGNKCNAVO    
GBLJXSBUXMOB    : XYBLJWCFMR      ANJE           
AOFEENHJBLGJS   : XYXIR           QMAINUAKVVNGWAE BIRK            IGTNT          
TDCOLFDUEVXB    : GONANOTNQVG     DXDDWCPDDLDUONR CGSIKUHJQT      HFXNT           ATLEOU          CXHRPVVAA      
MPWPSN          : SGKKNJUG        MAOJDNIPDOJHO  
YTKHEMSKVMD     : HJSGTE          KNUQYCUHMC     
RGJFNOCRKB      : FIKYVG          RVCHPXK         XYBLJWCFMR     
INLH            : GLDFKJL         FIKYVG          WTHQYCT         HWMVXKDKA       LLYUP          
GUCFPPM         : BATGRXWSWOWRVWL VCXNAVIYMHRKFF  VGLHIVI         ULBGPFTEPTPHF   PKSUIPD        
EGIAUM          : XYBLJWCFMR      QXJGLCULHBVC    CDHGNKCNAVO    
OUETISXDFBVNPJ  : VMLYMKNDR       JOWYBGWAJ       VJLN           
WPRC            : JHWYDQDHT      
JRIFV           : IYBNM           XYXIR           QXGQVXWV        HFXNT           VNYI            MRTXBYR        
QXNDS           : NDKTEOODOCQBY   PMCWRUDYHC     
XYXIR           : AOFEENHJBLGJS   JRIFV           RCBV            URLGMKTDMIUJ    GOUMKA         
LYXIOPTLNKGPGPJ : HJSGTE          RHONIBTSDMMGJ   LLYUP          
XFKODXRYB       : ESEXSWHUU       HTEOVHSBPGCG    QURHY           SOIJICX         FVUGI          
XYCSVORWYHMS    : VCXNAVIYMHRKFF  HYXESRRHEHHFUKP UAWBFTOM        FUANKFE        
CDBTLRDFPI      : EGQMGWSGQOHBLTG OGMUKULMDIONDD  GCHUQHJDW       DANIINNC        FVUGI          
GONANOTNQVG     : TDCOLFDUEVXB    LFNSA           ISENYQSBNRFF    PMCWRUDYHC      UNGG            VIHFVHWGCTWWA  
KYLLI           : IYBNM           AUVQXGFIJ      
FDFKFAYYD       : TINQAFXJRHYJLOP
QOTWFJYSBSIRO   : LXXHSNAMYAWJDGA JQUGQR          KNUQYCUHMC     
ICQUNBXUE       : ODNCDA          DKSHXABY        QYTPHMJAAXNRR   FFFCDBMNIGHQCT 
GLDFKJL         : INLH            HTEOVHSBPGCG    FNIMKMCGTWJMEL  NRVDXBOPACYF    VSDUQFFAHI      WLULKNNWSAYHKC 
AFXFOWAR        : NDKTEOODOCQBY   MJTALIOOC      
IJHASLSPYTP     : ISENYQSBNRFF    VJLN           
YSDK            : JPSUFSFANQBSF   TWPPLEHEVC     
KVKVY           : LOQSRSAKDM      GSNTCCEVHQGF    LPEEN          
DATTWV          : BHIFNHYON       ISENYQSBNRFF    FYPQUS          WRMRGXWVMBAUVUK FRSISKLOHR      UNGG           
REXB            : PAKSSKYDMJ      SREAKHFRM      
QMAINUAKVVNGWAE : AOFEENHJBLGJS   RVCHPXK         PDJRYRDOLYVGEY  WTHQYCT         WEFJGOCSF       QMDAWXRIN       FOQNEMBWUUOHSR  DIATYPRBJOXVPIQ
VEVYE           : FNEUGHJJJL      LSFQPMXB        MRTXBYR        
TDLIURGXYXKCIY  : GCHUQHJDW       PCQSITUW        JQUGQR          VNYI           
JLUHCDECILBOJAU : JPSUFSFANQBSF   QBWLTKSY        MJTALIOOC       PWTYLS          DCPGDPJARYXSBL 
VXKEVE          : LGCOGDOTLVHXQEA XHBPGCCWXVLJV   NLIV            RHONIBTSDMMGJ  
VGLHIVI         : GUCFPPM         FNPBAPB         JOWYBGWAJ       DLRKJJE         QNUVRKEVDNXUMX 
HTEOVHSBPGCG    : XFKODXRYB       GLDFKJL         PCQSITUW        YBGIASMT        FOQNEMBWUUOHSR 
EBOBCBHAIUVOGF  : OGMUKULMDIONDD  DKSHXABY        YBGIASMT        DCPGDPJARYXSBL 
FNIMKMCGTWJMEL  : GLDFKJL         WYPWVEGHBQTQK   TRJQSMXCSN      HYXESRRHEHHFUKP
TQWLTBO         : WYPWVEGHBQTQK   RGVBFYIRSUQFS   WAPENKF         AJQVT           NLIV           
BWYYNHFMMSUAFJ  : BHIFNHYON       FYPQUS          EEDMGDAYHQR    
MEDXSHKNEDKR    : KIKDNUVWTYCSK   UNGG           
LGCOGDOTLVHXQEA : EGQMGWSGQOHBLTG VXKEVE          RHONIBTSDMMGJ   KNUQYCUHMC      QNUVRKEVDNXUMX 
OGLUK           : BATGRXWSWOWRVWL MONRRAKYYKCA    NBECPTLSEWWTELB
NRVDXBOPACYF    : GLDFKJL         FEOQGFHLWD      JOWYBGWAJ       CXHRPVVAA      
FIKYVG          : RGJFNOCRKB      INLH            ULBGPFTEPTPHF   GCHUQHJDW       HXGRFEK         GLMOH           UUBLEIBNDMNJP   RBKUKS         
WYPWVEGHBQTQK   : FNIMKMCGTWJMEL  TQWLTBO         SBBQXA         
TJRKBTPABJFMV   : EGQMGWSGQOHBLTG HAPAT           EMTNJBVMYBSXFI  JHWYDQDHT      
IEPFDFFALLJ     : EMTNJBVMYBSXFI  JHIBBPDTVGDISJ  DIATYPRBJOXVPIQ
CDFOV           : NDKTEOODOCQBY   RVCHPXK         FDIOCIVAHSN     NBECPTLSEWWTELB
XPMCJCCNNKALRI  : XYBLJWCFMR      KMKPYYLDJYPRTV  AIMVIMPMMSSWU  
HOTPT           : FDIOCIVAHSN     HJSGTE          DXDDWCPDDLDUONR
BFFQJJVXFX      : EMTNJBVMYBSXFI  ITHFKU          FUANKFE        
ULBGPFTEPTPHF   : LNYATXVC        GUCFPPM         FIKYVG          MPDSDX          UUWUQN         
RVCHPXK         : RGJFNOCRKB      QMAINUAKVVNGWAE CDFOV           GCHUQHJDW       FOQNEMBWUUOHSR 
FDIOCIVAHSN     : CDFOV           HOTPT           QURHY           TWPPLEHEVC      LOHNJSWL       
CESXKISCSAKKVOT : DBTXRDJUAWPMTM  YSOLEOL         MPDSDX         
OGMUKULMDIONDD  : MBCCLV          CDBTLRDFPI      EBOBCBHAIUVOGF  RBKUKS         
HJSGTE          : YTKHEMSKVMD     LYXIOPTLNKGPGPJ HOTPT           RPERHVWXXOGX    VNYI            LPEEN          
XYBLJWCFMR      : GBLJXSBUXMOB    RGJFNOCRKB      EGIAUM          XPMCJCCNNKALRI  VMLYMKNDR       GHWTST         
YMVTXK          : PAKSSKYDMJ      ISENYQSBNRFF    DCPGDPJARYXSBL  QNUVRKEVDNXUMX 
IAOODRVOMCKQF   : TBHFRASRCL      PMCWRUDYHC      KERIAMUQI      
RGVBFYIRSUQFS   : TQWLTBO         MAOJDNIPDOJHO   BRUWMXISILI     WBMXXKQICRF    
FEOQGFHLWD      : NRVDXBOPACYF    QYTPHMJAAXNRR   IWRLNRMBICX    
KIKDNUVWTYCSK   : MEDXSHKNEDKR    BNRWKIWSN       FOQNEMBWUUOHSR  CDHGNKCNAVO     LFNLSJ         
LFNSA           : KKQYGYQCBOS     GONANOTNQVG     FNPBAPB         JHWYDQDHT       UUBLEIBNDMNJP  
AGRSMYAXWG      : EEDMGDAYHQR    
JOKOEIMDCOG     : AJQVT           JHWYDQDHT       FKJBRMUAF       PJKDFXPUMNNOO   BRUWMXISILI     WLJUOYUJOSY    
YDKESFG         : AUVQXGFIJ       JOWYBGWAJ       ROEVJMXXI      
FNPBAPB         : VGLHIVI         LFNSA           TBHFRASRCL      TQCKLKBGUYVVHDT AUVQXGFIJ      
OHBAXOOFYCIBS   : IYBNM           TRJQSMXCSN      YNJQTBFVXAQ     AIMVIMPMMSSWU  
ARVMXRREPYRGAUX : KERIAMUQI       BVXQKPBWUIV     SBBQXA         
VMLYMKNDR       : OUETISXDFBVNPJ  XYBLJWCFMR      BIRK            KAFVVVYCXPXJID 
HAPAT           : TJRKBTPABJFMV   APSLO           ODNCDA          TQCKLKBGUYVVHDT
RPERHVWXXOGX    : HJSGTE          BVXQKPBWUIV    
GCHUQHJDW       : CDBTLRDFPI      TDLIURGXYXKCIY  FIKYVG          RVCHPXK        
UKUWC           : NRQFMMUCIL      FQORURS         GSNTCCEVHQGF    DJDWFGJRPUFA    GHCVLQALLUCTPU 
QURHY           : XFKODXRYB       FDIOCIVAHSN     LXXHSNAMYAWJDGA
QXGQVXWV        : KKQYGYQCBOS     JRIFV           IYMCHSJ         PNGDMXREHSD    
DBTXRDJUAWPMTM  : CESXKISCSAKKVOT IRDACSOBMRUYNBP VSDUQFFAHI     
SGKKNJUG        : MPWPSN          WLULKNNWSAYHKC 
DXDDWCPDDLDUONR : TDCOLFDUEVXB    HOTPT           FKPMGBEEA      
KJCGXTY         : HFXNT           MPDSDX         
EMTNJBVMYBSXFI  : TJRKBTPABJFMV   IEPFDFFALLJ     BFFQJJVXFX      QYTPHMJAAXNRR   PMCWRUDYHC      LFNLSJ         
ITHFKU          : BFFQJJVXFX      NBECPTLSEWWTELB PKSUIPD        
BHIFNHYON       : DATTWV          BWYYNHFMMSUAFJ  WBMXXKQICRF    
BIRK            : AOFEENHJBLGJS   VMLYMKNDR       RCBV            PDJRYRDOLYVGEY  KMKPYYLDJYPRTV 
PAKSSKYDMJ      : REXB            YMVTXK          NRQFMMUCIL      YQGDJKMGED     
TRJQSMXCSN      : FNIMKMCGTWJMEL  OHBAXOOFYCIBS   GHWTST         
RCBV            : XYXIR           BIRK            YNJQTBFVXAQ     MJTALIOOC       GOUMKA          TINQAFXJRHYJLOP
JPSUFSFANQBSF   : YSDK            JLUHCDECILBOJAU
TBHFRASRCL      : VCXNAVIYMHRKFF  IAOODRVOMCKQF   FNPBAPB         NXMPKOLVTDTKTGQ IRDACSOBMRUYNBP
PDJRYRDOLYVGEY  : QMAINUAKVVNGWAE BIRK            XHBPGCCWXVLJV   FTYLDFKG        BLKRJBMJGXWDVN 
WAPENKF         : TQWLTBO         BNRWKIWSN      
PWVIQAVVSAIM    : UAWBFTOM        RHONIBTSDMMGJ   PJKDFXPUMNNOO  
APSLO           : HAPAT           LFNLSJ         
SVNPS           : ODNCDA          PCQSITUW        NBECPTLSEWWTELB HUTUKQTDEHCYXCI WBMXXKQICRF     SBBQXA         
HXGRFEK         : FIKYVG          TTDRPGRMN      
CUVERSWTDJUD    : VSDUQFFAHI      VJLN           
NRQFMMUCIL      : UKUWC           PAKSSKYDMJ      YQGDJKMGED      RHONIBTSDMMGJ  
ISENYQSBNRFF    : NDKTEOODOCQBY   GONANOTNQVG     IJHASLSPYTP     DATTWV          YMVTXK          QBWLTKSY        GLMOH           GOUMKA         
FYPQUS          : DATTWV          BWYYNHFMMSUAFJ  KNUQYCUHMC      GHCVLQALLUCTPU 
KMKPYYLDJYPRTV  : XPMCJCCNNKALRI  BIRK            EEDMGDAYHQR     ROEVJMXXI       RBKUKS         
SMDTAUCIH       : MRTXBYR        
HYXESRRHEHHFUKP : EGQMGWSGQOHBLTG XYCSVORWYHMS    FNIMKMCGTWJMEL  PMCWRUDYHC      LUNLOBWQ       
AJQVT           : TQWLTBO         JOKOEIMDCOG     HFXNT           KERIAMUQI       ISWOUEYW       
IAILUKTFTDE     : TWPPLEHEVC      FFFCDBMNIGHQCT  UUWUQN         
IYMCHSJ         : QXGQVXWV        PMCWRUDYHC     
XHBPGCCWXVLJV   : VXKEVE          PDJRYRDOLYVGEY  FQORURS         VPQIGYOPRSJUKLU LSFQPMXB        VSDUQFFAHI     
WTHQYCT         : INLH            QMAINUAKVVNGWAE KAFVVVYCXPXJID  RDWXEEIEJGCHIG  LFNLSJ         
WEFJGOCSF       : QBUEOVFL        QMAINUAKVVNGWAE TQCKLKBGUYVVHDT FKPMGBEEA      
CGSIKUHJQT      : TDCOLFDUEVXB    FFQEFMXJMI      WKCTPIENGFWLFU  ROEVJMXXI      
PQRJXKKCGPYNWK  : PNGDMXREHSD     FFFCDBMNIGHQCT  DHTOARLKBS     
LOQSRSAKDM      : KVKVY           MONRRAKYYKCA   
LXXHSNAMYAWJDGA : QOTWFJYSBSIRO   QURHY           YCATBPFWPTIG    HYHSTVRQFIKHNRC TINQAFXJRHYJLOP
TWPPLEHEVC      : YSDK            FDIOCIVAHSN     IAILUKTFTDE     IGTNT           VSDUQFFAHI     
IGTNT           : AOFEENHJBLGJS   TWPPLEHEVC      VPQIGYOPRSJUKLU VVNED           ATLEOU          UUBLEIBNDMNJP  
ODNCDA          : ICQUNBXUE       HAPAT           SVNPS           FVUGI           TTDRPGRMN      
DANIINNC        : IYBNM           CDBTLRDFPI      TQCKLKBGUYVVHDT
FTYLDFKG        : KKQYGYQCBOS     PDJRYRDOLYVGEY  VJLN           
SOIJICX         : IYBNM           XFKODXRYB       ATLEOU         
PCQSITUW        : TDLIURGXYXKCIY  HTEOVHSBPGCG    SVNPS           FKPMGBEEA       CDHGNKCNAVO    
DKSHXABY        : ESEXSWHUU       ICQUNBXUE       EBOBCBHAIUVOGF 
HFXNT           : TDCOLFDUEVXB    JRIFV           KJCGXTY         AJQVT           BRUWMXISILI    
EEDMGDAYHQR     : BWYYNHFMMSUAFJ  AGRSMYAXWG      KMKPYYLDJYPRTV 
MONRRAKYYKCA    : OGLUK           LOQSRSAKDM      URLGMKTDMIUJ    KOHCYABVBNV    
JHWYDQDHT       : WPRC            TJRKBTPABJFMV   LFNSA           JOKOEIMDCOG     JQUGQR          UUWUQN         
QYTPHMJAAXNRR   : ICQUNBXUE       FEOQGFHLWD      EMTNJBVMYBSXFI  FBNPNQKAOKGI    WLJUOYUJOSY    
FQORURS         : UKUWC           XHBPGCCWXVLJV  
YQGDJKMGED      : XEGYTTYIWL      PAKSSKYDMJ      NRQFMMUCIL     
YSOLEOL         : CESXKISCSAKKVOT FKPMGBEEA      
CGTSN           : LOHNJSWL        ISWOUEYW       
JHIBBPDTVGDISJ  : IEPFDFFALLJ     ATLEOU          KERIAMUQI      
WRMRGXWVMBAUVUK : DATTWV          SLWGBAF         GOUMKA         
FRSISKLOHR      : LNYATXVC        DATTWV          LPEEN          
PNGDMXREHSD     : QXGQVXWV        PQRJXKKCGPYNWK  YNJQTBFVXAQ     JQUGQR          TTDRPGRMN      
FFFCDBMNIGHQCT  : EGQMGWSGQOHBLTG ICQUNBXUE       IAILUKTFTDE     PQRJXKKCGPYNWK 
QBWLTKSY        : JLUHCDECILBOJAU ISENYQSBNRFF    KHKURLMB       
SREAKHFRM       : EGQMGWSGQOHBLTG REXB            JQUGQR          IRDACSOBMRUYNBP
VPQIGYOPRSJUKLU : BATGRXWSWOWRVWL XHBPGCCWXVLJV   IGTNT           DLRKJJE         KOHCYABVBNV    
FFQEFMXJMI      : XEGYTTYIWL      CGSIKUHJQT      LOHNJSWL       
UCGIXVBG        : MQMXFEKRYE      MJTALIOOC       PKSUIPD        
AXTTQEP         : UNGG            BLKRJBMJGXWDVN 
PMCWRUDYHC      : QXNDS           GONANOTNQVG     IAOODRVOMCKQF   EMTNJBVMYBSXFI  HYXESRRHEHHFUKP IYMCHSJ        
WKCTPIENGFWLFU  : CGSIKUHJQT      DHTOARLKBS      GOUMKA         
YNJQTBFVXAQ     : OHBAXOOFYCIBS   RCBV            PNGDMXREHSD     UAWBFTOM        MRTXBYR        
YBGIASMT        : HTEOVHSBPGCG    EBOBCBHAIUVOGF  HJLA            MRTXBYR        
UAWBFTOM        : XYCSVORWYHMS    PWVIQAVVSAIM    YNJQTBFVXAQ     LUNLOBWQ       
UNGG            : GONANOTNQVG     DATTWV          MEDXSHKNEDKR    AXTTQEP         MQMXFEKRYE      HUTUKQTDEHCYXCI
AIMVIMPMMSSWU   : XPMCJCCNNKALRI  OHBAXOOFYCIBS  
JQUGQR          : QOTWFJYSBSIRO   TDLIURGXYXKCIY  JHWYDQDHT       PNGDMXREHSD     SREAKHFRM      
VNYI            : JRIFV           TDLIURGXYXKCIY  HJSGTE          URLGMKTDMIUJ    HWMVXKDKA      
VVNED           : IGTNT           HWMVXKDKA      
MQMXFEKRYE      : UCGIXVBG        UNGG            KPPMLOL        
TQCKLKBGUYVVHDT : FNPBAPB         HAPAT           WEFJGOCSF       DANIINNC       
QXJGLCULHBVC    : EGIAUM          KNUQYCUHMC     
AUVQXGFIJ       : KYLLI           YDKESFG         FNPBAPB         MPDSDX          FBOWQAM        
FKJBRMUAF       : JOKOEIMDCOG     KNUQYCUHMC     
LOHNJSWL        : LNYATXVC        FDIOCIVAHSN     CGTSN           FFQEFMXJMI      NLIV            GSNTCCEVHQGF    FUANKFE        
BNRWKIWSN       : KIKDNUVWTYCSK   WAPENKF        
FBNPNQKAOKGI    : QYTPHMJAAXNRR   YCATBPFWPTIG   
URLGMKTDMIUJ    : XYXIR           MONRRAKYYKCA    VNYI            BLKRJBMJGXWDVN  PWTYLS         
GINVPUADLNW     : LNYATXVC        GHWTST         
NLIV            : VXKEVE          TQWLTBO         LOHNJSWL        HWMVXKDKA       RDWXEEIEJGCHIG  ROEVJMXXI      
GSNTCCEVHQGF    : KVKVY           UKUWC           LOHNJSWL       
BLKRJBMJGXWDVN  : PDJRYRDOLYVGEY  AXTTQEP         URLGMKTDMIUJ    NXMPKOLVTDTKTGQ AOOCRHQSVKNUY   DIATYPRBJOXVPIQ
GLMOH           : FIKYVG          ISENYQSBNRFF   
IJENHOGQTJRF    : HWMVXKDKA       DIATYPRBJOXVPIQ
JOWYBGWAJ       : ESEXSWHUU       OUETISXDFBVNPJ  VGLHIVI         NRVDXBOPACYF    YDKESFG        
NBECPTLSEWWTELB : OGLUK           CDFOV           ITHFKU          SVNPS          
FKPMGBEEA       : DXDDWCPDDLDUONR WEFJGOCSF       PCQSITUW        YSOLEOL         RDWXEEIEJGCHIG 
KAFVVVYCXPXJID  : VMLYMKNDR       WTHQYCT        
HWMVXKDKA       : INLH            VNYI            VVNED           NLIV            IJENHOGQTJRF    LSFQPMXB        KERIAMUQI      
RDWXEEIEJGCHIG  : WTHQYCT         NLIV            FKPMGBEEA      
XFSIK           : AOOCRHQSVKNUY  
RHONIBTSDMMGJ   : LYXIOPTLNKGPGPJ VXKEVE          LGCOGDOTLVHXQEA PWVIQAVVSAIM    NRQFMMUCIL      FVUGI          
KNUQYCUHMC      : YTKHEMSKVMD     QOTWFJYSBSIRO   LGCOGDOTLVHXQEA FYPQUS          QXJGLCULHBVC    FKJBRMUAF       DIATYPRBJOXVPIQ
KHKURLMB        : QBWLTKSY        KERIAMUQI      
DJDWFGJRPUFA    : BATGRXWSWOWRVWL UKUWC          
ATLEOU          : TDCOLFDUEVXB    IGTNT           SOIJICX         JHIBBPDTVGDISJ 
QMDAWXRIN       : QMAINUAKVVNGWAE TINQAFXJRHYJLOP
LSFQPMXB        : VEVYE           XHBPGCCWXVLJV   HWMVXKDKA      
NXMPKOLVTDTKTGQ : TBHFRASRCL      BLKRJBMJGXWDVN 
FOQNEMBWUUOHSR  : QMAINUAKVVNGWAE HTEOVHSBPGCG    RVCHPXK         KIKDNUVWTYCSK  
IRDACSOBMRUYNBP : DBTXRDJUAWPMTM  TBHFRASRCL      SREAKHFRM       HUTUKQTDEHCYXCI CDHGNKCNAVO    
GHCVLQALLUCTPU  : UKUWC           FYPQUS         
AOOCRHQSVKNUY   : BNJNACMI        BLKRJBMJGXWDVN  XFSIK           HJLA           
LLYUP           : INLH            LYXIOPTLNKGPGPJ ROEVJMXXI      
GHWTST          : LNYATXVC        XYBLJWCFMR      TRJQSMXCSN      GINVPUADLNW     FBOWQAM        
MJTALIOOC       : AFXFOWAR        JLUHCDECILBOJAU RCBV            UCGIXVBG        IWRLNRMBICX    
HUTUKQTDEHCYXCI : SVNPS           UNGG            IRDACSOBMRUYNBP
YCATBPFWPTIG    : XEGYTTYIWL      LXXHSNAMYAWJDGA FBNPNQKAOKGI    CDHGNKCNAVO    
KERIAMUQI       : IAOODRVOMCKQF   ARVMXRREPYRGAUX AJQVT           JHIBBPDTVGDISJ  HWMVXKDKA       KHKURLMB       
VSDUQFFAHI      : GLDFKJL         DBTXRDJUAWPMTM  CUVERSWTDJUD    XHBPGCCWXVLJV   TWPPLEHEVC     
DLRKJJE         : VGLHIVI         VPQIGYOPRSJUKLU
ROEVJMXXI       : YDKESFG         KMKPYYLDJYPRTV  CGSIKUHJQT      NLIV            LLYUP           QNUVRKEVDNXUMX  TINQAFXJRHYJLOP
HJLA            : YBGIASMT        AOOCRHQSVKNUY  
ISWOUEYW        : AJQVT           CGTSN          
MRTXBYR         : JRIFV           VEVYE           SMDTAUCIH       YNJQTBFVXAQ     YBGIASMT       
PWTYLS          : JLUHCDECILBOJAU URLGMKTDMIUJ   
VIHFVHWGCTWWA   : GONANOTNQVG    
VJLN            : XEGYTTYIWL      OUETISXDFBVNPJ  IJHASLSPYTP     CUVERSWTDJUD    FTYLDFKG       
LPEEN           : KVKVY           HJSGTE          FRSISKLOHR      MPDSDX          UUWUQN         
DHTOARLKBS      : PQRJXKKCGPYNWK  WKCTPIENGFWLFU  CDHGNKCNAVO    
KPPMLOL         : MQMXFEKRYE     
NIUBX           : VCXNAVIYMHRKFF  LNYATXVC        IWRLNRMBICX    
MPDSDX          : ULBGPFTEPTPHF   CESXKISCSAKKVOT KJCGXTY         AUVQXGFIJ       LPEEN          
LUNLOBWQ        : HYXESRRHEHHFUKP UAWBFTOM       
FBOWQAM         : AUVQXGFIJ       GHWTST         
MAOJDNIPDOJHO   : NDKTEOODOCQBY   MPWPSN          RGVBFYIRSUQFS  
SLWGBAF         : WRMRGXWVMBAUVUK WBMXXKQICRF    
WLULKNNWSAYHKC  : GLDFKJL         SGKKNJUG        GOUMKA         
UUBLEIBNDMNJP   : FIKYVG          LFNSA           IGTNT          
PJKDFXPUMNNOO   : XEGYTTYIWL      JOKOEIMDCOG     PWVIQAVVSAIM   
BRUWMXISILI     : RGVBFYIRSUQFS   JOKOEIMDCOG     HFXNT          
BVXQKPBWUIV     : ARVMXRREPYRGAUX RPERHVWXXOGX   
DIATYPRBJOXVPIQ : QMAINUAKVVNGWAE IEPFDFFALLJ     BLKRJBMJGXWDVN  IJENHOGQTJRF    KNUQYCUHMC     
WBMXXKQICRF     : IYBNM           RGVBFYIRSUQFS   BHIFNHYON       SVNPS           SLWGBAF        
CDHGNKCNAVO     : FNEUGHJJJL      EGIAUM          KIKDNUVWTYCSK   PCQSITUW        IRDACSOBMRUYNBP YCATBPFWPTIG    DHTOARLKBS     
KOHCYABVBNV     : MONRRAKYYKCA    VPQIGYOPRSJUKLU SBBQXA         
ANJE            : IYBNM           GBLJXSBUXMOB    HYHSTVRQFIKHNRC
RBKUKS          : FIKYVG          OGMUKULMDIONDD  KMKPYYLDJYPRTV  WLJUOYUJOSY    
UUWUQN          : ULBGPFTEPTPHF   IAILUKTFTDE     JHWYDQDHT       LPEEN          
DCPGDPJARYXSBL  : JLUHCDECILBOJAU EBOBCBHAIUVOGF  YMVTXK         
FVUGI           : XFKODXRYB       CDBTLRDFPI      ODNCDA          RHONIBTSDMMGJ  
SBBQXA          : WYPWVEGHBQTQK   ARVMXRREPYRGAUX SVNPS           KOHCYABVBNV    
QNUVRKEVDNXUMX  : VGLHIVI         LGCOGDOTLVHXQEA YMVTXK          ROEVJMXXI      
PKSUIPD         : GUCFPPM         ITHFKU          UCGIXVBG       
IWRLNRMBICX     : FEOQGFHLWD      MJTALIOOC       NIUBX          
WLJUOYUJOSY     : JOKOEIMDCOG     QYTPHMJAAXNRR   RBKUKS         
FUANKFE         : XYCSVORWYHMS    BFFQJJVXFX      LOHNJSWL       
CXHRPVVAA       : TDCOLFDUEVXB    NRVDXBOPACYF   
HYHSTVRQFIKHNRC : LXXHSNAMYAWJDGA ANJE           
GOUMKA          : XYXIR           RCBV            ISENYQSBNRFF    WRMRGXWVMBAUVUK WKCTPIENGFWLFU  WLULKNNWSAYHKC 
TTDRPGRMN       : HXGRFEK         ODNCDA          PNGDMXREHSD    
TINQAFXJRHYJLOP : FDFKFAYYD       RCBV            LXXHSNAMYAWJDGA QMDAWXRIN       ROEVJMXXI      
LFNLSJ          : KIKDNUVWTYCSK   EMTNJBVMYBSXFI  APSLO           WTHQYCT        
