IWJVGMQPGAY     : CMMRLROHVNANQ   QMTEBOFRSC      DAFBJ           SUHJWWGY        MVPVSBTBXKI    
JTJPHEJULQBTXKQ : IWQMJJEBGYESCU  CEVYFDEFCK      TUOSGRXFMVTY    RSINCOKNHUMUV  
EHQPEANMPED     : EGRT            GATANUSBMFLQUD  TYSPHXMBXGYOFL  WNHERPQKEE      OORHQHL        
ECUPX           : SQLGFRFD        BVYC           
GFLPCWIFQIPIN   : XKNMQFTWYXPDBBT CLGCHYADJGWJC   ERMCWEF         IBVQMDAAM       UKVCDYVJ       
PFMVHAJY        : FSQCIISHPDVVBQ  NIKBPIVACCUJLAF LDKGCOVR        WVWB            UKVCDYVJ        BAAFM           FTFBLMVAOLVWYRP
OWLSUDQYJXKBCH  : TOAR            VWDDSUNBMUK     NKWYAEL         PUJEKOGJNTO     YYJSQXAIOFCKG  
HBTXJKUBRHWYJI  : FYIFOQ          KKLGWQSJCYO     XNWT            EVTVIQ          HHXPXKS        
PWXBP           : ABYTNSJTH       VKELXNNM        QTITTM         
FIUQIHSKRGSSBS  : YJGTMRXJ        EMYHTKVEAFF     HBNPLBFHTE      RBPFBQWM       
LNFFWCG         : QBNLKQVGQEQNAKS JVHRPOV         SXHX            XDBYK          
LHVKGABBFLV     : IJQCRLKG        GRLHAEVYYGJAB   VFKGK           KXCAVDARXMR    
UGQFXX          : APLUHKGEQMVHFYO PJQENH          NUHOKL          COGSFHFG       
QBSUOI          : HPXDBSEVKLTY    QBNLKQVGQEQNAKS JEAOPFXL       
THEAPRKMDSOGTVR : GATANUSBMFLQUD  BVYC            MVPVSBTBXKI    
TMYNUYNWP       : QXSTLFLR        EULRBLVCGAH     BQLY            STUHNFTGKMVE   
SMFBMYJSBBL     : ERMCWEF         VAQOOSNIHPONP  
NOEEUY          : RERYQPBSRFFEY   LJTHPIM         GTTYMTX        
MTWCUKYTXV      : MVHMPNXNGIWWM   BOEDHAMIR       AASQMSO        
MOXRSMSEFT      : OFWQY           JNFXOCSMC       GCMWLYUSP       GFIWXHBKPU     
QIVHMACNDRJATEK : FVFXNWMRRVVVIN  XPYGPWS         JBLOHOSECW      BTYBGROQ       
XKOJ            : MBKIHKGORQIP    HRBSBOOKRHHPVGV TQCNINSIMSD     RVWDSSCV        KGLRXSR        
GJSYVLFEHKUPIDF : MTHNH           YCPMYGMJUFRK    VFKGK           YVINT          
HSMYDOSJYNIJFT  : GYSJHIEONXFLJ   ITLUPUWUGNOH    NEFY           
LEBM            : GJCS            LEAQOOHDXNEQ    XBRATPXC        NRED            WESEMQGK       
OTGVEEONJTYQON  : WHWFFQT         HUCQAHVWPSFU    OWDPW           JQMNLEYNGVAFRK 
TCNEDC          : WHULKIOLVKVL    EYVUCCUVTM      PUJEKOGJNTO     YADPRMQJF      
OHIYUOCJRQDA    : LEAQOOHDXNEQ    AWIMBJHAKHY    
JGFYPBA         : VWDDSUNBMUK     HJRTCK         
QNCKRROU        : HSYJHBMUPV      CGFEVWNGKMP     PYKYOTTFNNSYDM  CCDN           
DLDOKXD         : RHVJYCJFA       UVQPEDSXXBCBQMA BAQIJGXEKB     
JWFOXWYECAWE    : LFRH            SQTFLFKFTDDV    VLXTIPVARMJB    YUEIWJRJW       JIBHPD         
IWQMJJEBGYESCU  : JTJPHEJULQBTXKQ YCPMYGMJUFRK    IBUS           
DYUO            : NMDMW           NMFWV           PXBXCNQRJI     
CEVYFDEFCK      : JTJPHEJULQBTXKQ EYVUCCUVTM      GETUQMVEJRND    KOBSMLYXF      
KHCYQL          : OFLBHOWCFTUD    XNEEJIED        LFSMFSX        
RTEYOJVUMWRDVT  : RMIXVMT         FFKR            GRUOXSSGNISRSJ 
TVMY            : JVMGKRLDYVJMMES EPBOMWHSOSOE    YAXFYJLW        YYSOGDIVYMUWU  
UBMFNVHMOUSJR   : OQFFCVC         KPGQ            TVUEBLXPH       QWYEKWSIDWL    
KGGGDUEUYARGV   : TLMDITGD        RHLTCPTMN       EEQWNOERWVXKVS  NGRU            PJRO            EHBOYTPUYYGI    EINQELMJP      
VVPSYEANAKCOHU  : YPRDVECTNKU     VSGYFRUJLTFC    GFFQMTUOORHTP  
YSKIBRLWV       : HIEG           
VXDEVQCRIW      : OFWQY           LQBC            CJLW           
MXHO            : RQFMXCY        
LFRH            : JWFOXWYECAWE   
RCQCDIPAGYXGED  : UJFWCLMJY       ONKYVTLFGEDQR   BAQIJGXEKB     
WHWFFQT         : OTGVEEONJTYQON  GCMWLYUSP       NMDMW           CMOL           
XKNMQFTWYXPDBBT : GFLPCWIFQIPIN   RVYANBCH        DQUMCMPQY       UNERA           XJRCS          
HUCQAHVWPSFU    : OTGVEEONJTYQON  STUHNFTGKMVE    DAFBJ           JWVQQ           MNXNNBQDUFVG   
BAMMPYDUSCWS    : PCOI            FTPRQYEIMEVUPT  QXKL            JTWCGNRQN       MNXNNBQDUFVG   
AUSVB           : GKCXUVYW        PBPRJB         
RDVT            : TYSPHXMBXGYOFL  LDLELWRGDI      XBQNGRQGXEVRPJE
RQFMXCY         : MXHO            YMFRF           FSQCIISHPDVVBQ  LCDLG           WLSDXJGDIEI     RVYANBCH       
CMMRLROHVNANQ   : IWJVGMQPGAY     EAEQWMCKDB      TMTAQFLJWFMUVTD
JMXOGEM         : FJCKU           CHNDQXXAYFDGX   FFRHFPY         CNTIRC          GFIWXHBKPU     
RERYQPBSRFFEY   : NOEEUY          AHNIHMOWHH      JSHP            TKXQWRNU       
VNCREFIUCTHB    : OQUUXGRKQEXE    RIFQQORCHMVW    GNRYAQTHJS      HEENTYVFMWBGCMC
OFWQY           : MOXRSMSEFT      VXDEVQCRIW      HQGKJ           WGYFSRJIOHHLVVW XLAVOIHDR       DUDPPJMYIENJNR  OXGUIILEYSHYU   OPRWVLNFCWHIX  
OFWQY           : WPMMFUBGG      
KXVD            : JTTRXIVG        XSVG            DJTUGBUVVVGOIJ 
OUGVAF          : QOJYIIRD        RTIDDFKPBJKGD   GJBX           
XUTSYYDT        : JSHP            OPDLIERCEEU     OFIQBEWDT      
YEFJUMILLLWLJA  : HSGBHDF         AWIDJCU         DUVUTN         
YWSWWAOX        : CSMWHCAAYF      DFBVRWHKOSYKQV  DTETGLVWXCXFKR  BRNAU           HDQGILL        
LSUM            : QYTLASNPL       GYSJHIEONXFLJ   VLXTIPVARMJB   
OQUUXGRKQEXE    : VNCREFIUCTHB    BLXLPVUQK       DTETGLVWXCXFKR  HJRTCK          VSRGECQBI      
JNFXOCSMC       : MOXRSMSEFT      OHODHKVCTAMKIV  QGBD            SMWHJ          
DAOQSJ          : VCKUTUHA       
QAWNXVTPGMVHQB  : XMDWHR          QASYNMB         ELMTDHVDI      
EGRT            : EHQPEANMPED     GFBNKIDDSIM    
KINGLPUDKGJDIG  : WEWHFCQABBKF    EXUFROGDCJQGWOA QASYNMB        
GCMWLYUSP       : MOXRSMSEFT      WHWFFQT         XRFXVN          RUEBKT          LVQFJXHNV       SBCPIAVSXFWPKIM AOYQIPNSEN      TCDCHG         
GCMWLYUSP       : NVRLJJDP       
LVFFRQQA        : YCJNORXEKI      RIYLAABVWSEHSKS
WMVTRIADLIJCROQ : RSEAJWVFS       LUGPMKFWWAPOE   OKKC           
APLUHKGEQMVHFYO : UGQFXX          CSMWHCAAYF      ILNYDLEQTLXEJDI VWXIGJLG       
NMAFXCI         : WEWHFCQABBKF    XWREWN          IDCJD          
MTOEIFUKXJFHT   : TYSPHXMBXGYOFL  JMNMGGBQW       BBWX            YBIPJ          
NMDMW           : DYUO            WHWFFQT         YAMLHT          WLSDXJGDIEI    
LNOYAOEXQ       : MOHHSEYEVQGRMA  JBLOHOSECW     
KFIBKTIHEGQKQN  : XWREWN          OQFFCVC         HIXDEAYDRB      THQKATGEXF     
EAEQWMCKDB      : CMMRLROHVNANQ   TREEOGUUGIKI    MDVFVPQTIX      BPLECRFIABXWRB  RVYANBCH       
THNMVARHBCBM    : VATYR           LRNBOCSDQVJM    FXSJUVHYGC     
HSDRJSSO        : NLPEPFNCJMNBQRX HFCFM          
WHULKIOLVKVL    : TCNEDC          YLVAUBAW        CLDW            EKORHGMEC       UHAPRYIQ       
RMPBPT          : GYSJHIEONXFLJ   GBGFTMUQBX      LLXSOXIUOVKPC   BQVTHDU        
CGMXM           : WTAWEAA         WPMMFUBGG      
JHAAD           : DLSDXRAQJSU     BLSBIIMSS       VATYR           IFCLEMAGXKGKTF  OGOSXMUGT      
IYLSJCGF        : OJPWHYPOXKY     RFWBTNEKFEMDURX NIKBPIVACCUJLAF XBRATPXC       
CSMWHCAAYF      : YWSWWAOX        APLUHKGEQMVHFYO RWOYBKCL        SQTFLFKFTDDV    ADMNQWOQR       XFJRVLHHBAPNTU  KLORMH          BDWC           
FRCTXOCAOFAYGN  : SEAWFAVKFEEHXE  TOAR            NAKIPDIYOPYKC   LXFLHUIVYLJXY   MBWVFAMYX       IFGKJCEWVTLPB  
PRBWFF          : BQIJLSFOEXCF    QLWGNEVEB       TILMDCWABYHNL   XPOLGYU        
SEAWFAVKFEEHXE  : FRCTXOCAOFAYGN  HCOKGAGGR       OMJIA          
AHNIHMOWHH      : RERYQPBSRFFEY   BBWX            FOYCESCD       
KGWPYPUAOC      : SQLGFRFD        PBTPMVLHISW     ITLUPUWUGNOH    ONKYVTLFGEDQR  
NMHRSRPYPSG     : YMFRF           CKVLJJIEQJY     TPLLL          
BPSRMCBEMIB     : ELNOJP          NURCMWVTDWMIQJC VAQOOSNIHPONP  
HSYJHBMUPV      : QNCKRROU        XWREWN          SQRER           GFIWXHBKPU      NAONCDR        
KPHKIASN        : YGORDXESSEDKCPY BBWX            DWAWSI         
LGUA            : PNRXGBBX        HSGBHDF         SCWOJORAVTSUI   QWYEKWSIDWL    
WEWHFCQABBKF    : KINGLPUDKGJDIG  NMAFXCI         WQECYGFJDMWSB   LCDLG           LARSJ          
HUNWIEESMEN     : YCJNORXEKI      EKORHGMEC       OPDLIERCEEU     WHKTVV         
HYJEATDETK      : STIJEPPUNXUM    OAYTJXOB        EULRBLVCGAH     NJSGLOJKCHE     GNRYAQTHJS      LARSJ          
VEOYFYGWHE      : PCOI            ORBXPUGNNOQ     VBLAEUHLTM     
EMQKHDOU        : GNAJ            AWIDJCU         IMXBRLRD        VTWD           
XWREWN          : NMAFXCI         KFIBKTIHEGQKQN  HSYJHBMUPV      TLMDITGD        BPRM            QBNHK           HTSNEMJTEND     ELRLU          
DHURFBHHIGPFN   : GYNMAUOHTIIPDQ  SKENMS          BIGVQOUQSJQ     CHGNSGLN       
STIJEPPUNXUM    : HYJEATDETK      RRGUTGX         BAITRIYMVARVNH 
AJFKOPHJWJQ     : HGPJKBYBNQIU    QBYGT           CCBKATAI       
TYWAPSULCGQRX   : UXVDKIDYILU     WESEMQGK       
HXJTPLFXVWNFG   : DIVFGRPBIPUFCQN
QYTLASNPL       : LSUM            ALDULXHQX       HOSCECCLC      
CNQU            : CONHWSHRGUHGDVP AXCMIBGATKFUY   AEFIBHVPSUTG    MXLP           
PIPNRKGDPEBMRH  : NUOYARYPPHJK    DJIOGYTEONY    
GATANUSBMFLQUD  : EHQPEANMPED     THEAPRKMDSOGTVR CHNDQXXAYFDGX   COESFLSGFB     
DUUTIOGOSV      : JMKPIYATCREYR   VUBHHWQYFFFAWPX QCCCDKQE        AMOFOPRDRKRFLPN CBWAMLLXMAB    
TLMDITGD        : KGGGDUEUYARGV   XWREWN          IFEJ            KTGVGMSHSNCFJ  
TARX            : ENECSPLA        BAITRIYMVARVNH 
YJGTMRXJ        : FIUQIHSKRGSSBS  SQTFLFKFTDDV    UVXARVBLKBADLTA HJPEWNBIMRRLJRL QTITTM         
RSEAJWVFS       : WMVTRIADLIJCROQ OFOLMGJJLFGPJSR GSJDRO          PXLOLDGXYXPLFIA QTITTM         
TYSPHXMBXGYOFL  : EHQPEANMPED     RDVT            MTOEIFUKXJFHT   HJNOXBVBVSXC    RNOBMSMHMRIFGJX CJVARH          AWCWYG         
YANWKEQFIS      : YVQMSRMBNELMTH  BFCNCPWB        LQHPFYDERIY    
HPXDBSEVKLTY    : QBSUOI          FAKNQR          SKENMS          IJICUQPPTRGC    RQLPWLU        
TFQJKCGM        : TOAR            EVQDNI          UKVCDYVJ        MVPVSBTBXKI     YKLR           
VLOB            : AKNWUJWGVW      XBSGJBHHOOB     HDKSIHWXCNWSJW  CBWAMLLXMAB    
TJXLTPJWR       : NGRU            SHKKJFQCWWDU    CTOBQM          KQJKUILLEOEOK   WESEMQGK       
BPRM            : XWREWN          XYXDLN          PMYVUGFL       
QDGWTRJVYVBUKP  : SXHX            MEDVO           ATSEWYCSVVILK   FXSJUVHYGC      NLVEM          
PMINXCEJYXQCN   : CGFEVWNGKMP     IMXBRLRD       
OAYTJXOB        : HYJEATDETK      CWKPPYFNQ       KOBSMLYXF       HRBSBOOKRHHPVGV OGOSXMUGT       LFGOCOUAV       AKFEOXJMWIF     WHKTVV         
MCINXSGVISGW    : RPNGWVXJ        HJRTCK          SAWIH           MXLP           
IDCJD           : NMAFXCI         TCYMM           VATYR           ORKDED          LRNBOCSDQVJM   
LQBC            : VXDEVQCRIW      VLXTIPVARMJB    WWQIQCYOUUC     IMSIPLOYPV      UHOWOPAPWE      SXBHTAQK       
DWDB            : FQCJPLVOVYP     XNWT            BWMHRLKSAUC     SXBHTAQK        XDFCGUPQADBHK  
GNAJ            : EMQKHDOU        PRGJ            FAKNQR          JHOOG           OPRWVLNFCWHIX  
OJPWHYPOXKY     : IYLSJCGF        YCBUEFCAFBDGFAU JYIJDLJDXUQY   
MJGIWYLCSOYXSOF : EEQWNOERWVXKVS  WLLJMTHBRWXO    CKTATSLIUTA     MLQWKWA        
OQFFCVC         : UBMFNVHMOUSJR   KFIBKTIHEGQKQN  SBWLPPGSXE     
WTAWEAA         : CGMXM           FHLQOP          NJYXSCTL        NVRLJJDP        OWHGDHTF       
LICKHNMDFNBACG  : RPNGWVXJ        AVIUPY          PCPPDS          QJVMDVVMHLTEB   UFQUPLQ         DLWXEKV         FDDFFKA        
RWOYBKCL        : CSMWHCAAYF      LKGKPSIYTAP     TGOVOXAOLU      TXFNAANTEWSC    QTNJQOXRQH      OMDNUNSAXII    
XNGDPIYBQBOAQD  : BLSBIIMSS       PGARUPYU        WBNSMUJYESKJEVA FHWGILH         RBYR           
XRFXVN          : GCMWLYUSP       UHOWOPAPWE     
PNXPOK          : GYLO           
CTRQCW          : OHODHKVCTAMKIV  PGIXEKCQYQWU    RRIRYXQT        HSAQBKERB      
KVKDYYFSCJSV    : FHLQOP          LFCSWWGGRGC     CBWAMLLXMAB    
RUEBKT          : GCMWLYUSP       JYNIHJENJU      WFUXCXVBIG      CKTATSLIUTA    
CJLX            : IJUBNETYAIUB    XOFBAXJW        MAIJGQWWDH     
FQCJPLVOVYP     : DWDB            WLETAQ          LUGPMKFWWAPOE   FWUFE           FHGQOXGVUHL    
GKYREXIXSP      : USCUSCF         QGKFIKFKE       HEENTYVFMWBGCMC MGPV           
FJCKU           : JMXOGEM         HMCHJI          UJFWCLMJY      
IJUBNETYAIUB    : CJLX            FSNYEANNTH      QJVMDVVMHLTEB   WYFKL           MTYUU           IBVQMDAAM       WNIBACXGFU     
RHLTCPTMN       : KGGGDUEUYARGV   TOAR            LHCEXVMVBAWQV   JVHRPOV         VAQOOSNIHPONP  
CQVOSGL         : WGKXATLVV       XFDGPG          DADFMNMYOIYWETJ
RUDSJHMI        : HGXLKVN         OWDPW           DODGVTTVBJC     GIKG            BPREDE          AJWJAXK        
WGKXATLVV       : CQVOSGL         ANPBNOJCA      
PJQENH          : UGQFXX          UVXARVBLKBADLTA RSINCOKNHUMUV  
ECJSKBNNUYWJKIJ : YAMLHT          VRTV            KGLRXSR        
SJQO            : HXPMBHDAVJYF    IBUS           
PNXFYQMOA       : NMYABSFLRL     
TCYMM           : IDCJD           BKUFLONQG       NEWX            CMCVUV         
CCXCYJM         : PXGIONXXHCOMAUV KLORMH          MXLP           
SFCE            : GFBNKIDDSIM     BSPTPBGUEDA     YUEIWJRJW       PSPBC          
SYNIYTHP        : HQFTULKTAB      CJTHUNHMJFOFMPN VRFQQHWBRIBH    YGRXMQSVDOGK    GYLO           
WPVST           : BRNAU           GLTCO           JXYTBFPJQYAIRY 
HGXLKVN         : RUDSJHMI        KYSUREWGKHXM    RSSBKG         
GCUBHY          : GNSM            IBVQMDAAM       ICMKH          
ISHVBJRLB       : BLXLPVUQK       AEFIBHVPSUTG    VRFQQHWBRIBH   
KTVDNTM         : FSNYEANNTH      KJJL            OBXTDAH        
RXHQOVYQQ       : WWQIQCYOUUC     AXCMIBGATKFUY   YBTX           
BQIJLSFOEXCF    : PRBWFF          NYPTD           NJSGLOJKCHE     FJGMECII        GIKG            BIPMNQ         
MYWPPQEMIDVBRRA : CKTIICFH        ANTJMMITROTQ    GDDDCKQEMGBQDTT JYIJDLJDXUQY    CQRIEBM         EHBW           
LDLELWRGDI      : RDVT            YADPRMQJF       MXWWPLMSOOMDHXW
DLSDXRAQJSU     : JHAAD           SOBODVHENWPJWDE YUPRPXTWVICOJ  
EXUFROGDCJQGWOA : KINGLPUDKGJDIG  YUDRPM          RLNQSP          ATSEWYCSVVILK  
TJQYUJCSEDJN    : HYQWASH         QJVMDVVMHLTEB   NOBJNGEIIAVF    RCGXVKARNSESX   RSSBKG         
HMCHJI          : FJCKU           HGPJKBYBNQIU    ELMTDHVDI       TVUEBLXPH      
XOFBAXJW        : CJLX            XNWT            KLORMH          IBUS           
KDIT            : HHGLPBMV        MDVFVPQTIX     
HQGKJ           : OFWQY           MTHNH          
PVBNDNQMYBMW    : YSUYEN          YAMLHT          UVXTRDRQXEIV    IJDOHYBPMW      PJRO           
TARSKOHWSSSP    : FTXIXSELV       GMYWHIYGYKIHPVJ XNEEJIED        MAIJGQWWDH      NVADBTGEMQ      TVAXDVFHJSVO   
JVMUJCSMSVCLJ   : NKOD            XPYGPWS        
MXAE            : KAWXGNTRLXEP    HJNOXBVBVSXC    NNGOLLXGKJPRKSJ GWRE            OMDNUNSAXII    
BVPN            : JWVQQ           DISEREWLCURD   
YMFRF           : RQFMXCY         NMHRSRPYPSG     HQFTULKTAB      DLWXEKV         THQKATGEXF     
SQTFLFKFTDDV    : JWFOXWYECAWE    CSMWHCAAYF      YJGTMRXJ        IBVQBOHRASXIPOR KDSPLJQPHW     
OWDPW           : OTGVEEONJTYQON  RUDSJHMI        SIUGMUOSI       NAKIPDIYOPYKC   LXFLHUIVYLJXY   BISYFBVDDQJPK   RRHVO           SQRER          
OWDPW           : DJIOGYTEONY     ATSEWYCSVVILK  
KADCNPBCX       : YCBUEFCAFBDGFAU EULRBLVCGAH     LEAQOOHDXNEQ    DULXPA         
HUOX            : EMYHTKVEAFF     GNRYAQTHJS      YVQMSRMBNELMTH  OKVMKMB         RQOAOJ         
VMVGTRLWNAO     : YAMLHT          IATQMKNINWHGK   IBVQBOHRASXIPOR
FEMMQMR         : XWFGSQ          XSPFFU         
DIVFGRPBIPUFCQN : HXJTPLFXVWNFG   OIWJLU          HCOKGAGGR       IBVQMDAAM       ILFTDJFAUO     
LAVYCMM         : FHSXEBLSP      
SBWLPPGSXE      : OQFFCVC         GKIXX          
GYSJHIEONXFLJ   : HSMYDOSJYNIJFT  LSUM            RMPBPT          HIEG            UXDGCGBJQBN     EDEILPRTDXOHH  
JIJV            : SVXLMCAPA       OKWTPDQJT      
TOAR            : OWLSUDQYJXKBCH  FRCTXOCAOFAYGN  TFQJKCGM        RHLTCPTMN       FFKR            MQBUJ           LMCGIPGBLPEW   
QHIJHN          : MOVIENBHXU      GYLO            FHGQOXGVUHL    
NMFWV           : DYUO            AXULDY          EFANPDYIHEOCHH 
ENECSPLA        : TARX            AOYQIPNSEN     
VLXTIPVARMJB    : JWFOXWYECAWE    LSUM            LQBC            MTHNH           ABDTVXUGVDMM    XFSTTEYOAQDKQB  TGOVOXAOLU      CTNJXFXRHWXT   
VLXTIPVARMJB    : XDBYK          
SQLGFRFD        : ECUPX           KGWPYPUAOC      MBWVFAMYX       TQCNINSIMSD    
JQMNLEYNGVAFRK  : OTGVEEONJTYQON  OKYC            ITJRGTFEKM      VWXIGJLG        PJRO           
NKOD            : JVMUJCSMSVCLJ   VWXIGJLG        HCOKGAGGR       NNLSMMDCOHIRNSC
PCOI            : BAMMPYDUSCWS    VEOYFYGWHE      HFCFM           WFUXCXVBIG      YVINT           LFSMFSX        
WNHERPQKEE      : EHQPEANMPED     WLETAQ          CUCBQXVALCT     KYSUREWGKHXM   
JGMREOWXYTNLJQ  : HJPEWNBIMRRLJRL RSINCOKNHUMUV   KJJL            XSPFFU          KRPDOJHLPUU     USRC            BBBELXNNXAPYK  
BSXMHUAOCTHSH   : DFGAJDMPDFBJYFA BBBELXNNXAPYK  
WGYFSRJIOHHLVVW : OFWQY           UUUNYN          NLVEM          
DXGEKPBNGDJNVQ  : HTSNEMJTEND     JEPXFIITEEPLND  GIKG            XNSUWEOKATQK    FDDFFKA         VTWD           
VWDDSUNBMUK     : OWLSUDQYJXKBCH  JGFYPBA         QPMMRLYR        AQEOKRKGLS     
SIUGMUOSI       : OWDPW           JNKWGEUGDAP     BAITRIYMVARVNH  WTNEORLWSFTLTXG LIOTKLIPHOF    
TVKXHBV         : PRGJ            PGARUPYU        AFBPVLJ        
FTXIXSELV       : TARSKOHWSSSP    QMTEBOFRSC      WXUDBWTVKEBKC   HCOKGAGGR       RCGXVKARNSESX   LFSMFSX        
IJQCRLKG        : LHVKGABBFLV     IYPG            YYJSQXAIOFCKG  
YYOFTMPTWSRV    : CHNDQXXAYFDGX   NMYABSFLRL      LAJNE          
MVHMPNXNGIWWM   : MTWCUKYTXV      YPCKXRNQHWXQJP 
KWVSXVKDRYVLV   : OFLBHOWCFTUD   
FTPRQYEIMEVUPT  : BAMMPYDUSCWS   
CLGCHYADJGWJC   : GFLPCWIFQIPIN   QXSTLFLR        VUBHHWQYFFFAWPX WTNEORLWSFTLTXG
FSQCIISHPDVVBQ  : PFMVHAJY        RQFMXCY         WPHOHVLKXWWW    SXHX            MBWVFAMYX      
WMQIS           : IQHIHJUDWGPWO   SUHJWWGY        XNTNWHOWMNFMH   VGNTQHO        
QUWVEDTPHEXDWAL : HIEG            CPTBAKCIUDKAN  
UVXARVBLKBADLTA : YJGTMRXJ        PJQENH          PCLSOV          WFUXCXVBIG     
OWBUDWNMDNP     : QIWDE           XWFGSQ          BDEBWYFQRFVBBR 
NEJKA           : DIRCJMHMKCIWIJ  NBUFP          
MTHNH           : GJSYVLFEHKUPIDF HQGKJ           VLXTIPVARMJB    YCJNORXEKI      IMSIPLOYPV      DGYSLLKCV      
QIWDE           : OWBUDWNMDNP     FJGMECII        HRBSBOOKRHHPVGV
HUWKRCHF        : BQLY            UUBVNUX         ULIUXTYVJG      HOVNFINA       
NUHOKL          : UGQFXX          SSGCPODMDNGQ    NEFY           
UNJHJQXTL       : RSINCOKNHUMUV  
CKTIICFH        : MYWPPQEMIDVBRRA DJVWPKUHKXVV    CKVLJJIEQJY     TAYDXXKEH       GRUOXSSGNISRSJ 
WJWFXKA         : WKUTKEICXO      KKLGWQSJCYO    
BLSBIIMSS       : JHAAD           XNGDPIYBQBOAQD  QVIMSSXALQQBQBK NVADBTGEMQ     
QMQJQCEBMIGTWF  : YFMW            EVTVIQ          RTIDDFKPBJKGD   HHXPXKS         BBBELXNNXAPYK  
VKDGNLJYEKJPY   : WVWB            FAKNQR          AWDHGXIFSS      XSPFFU          KRPDOJHLPUU     JKTIEUPWGJVGRO 
KFUYX           : LBOKXTMUPIILTUI YCPMYGMJUFRK    KRPDOJHLPUU     NAONCDR        
PCLSOV          : UVXARVBLKBADLTA XWFGSQ          LGKCOUOHBXBXFKR CQRIEBM         KPGQ            LMCGIPGBLPEW   
KSGP            : PRGJ            SVXLMCAPA       CCBKATAI       
RTAHHKGNWRDWU   : GNUMBBGGKBGPC   QASYNMB         LQHPFYDERIY     FOYCESCD       
ERMCWEF         : GFLPCWIFQIPIN   SMFBMYJSBBL     GNMCAUJGD      
WVGXHAHWRBSRIAE : YUDRPM          VGTOLFRODR     
OCIRBDIFVUJUA   : KIYOFCUXRLE     HDKSIHWXCNWSJW  UVQPEDSXXBCBQMA JIQWOKWQE      
GYNMAUOHTIIPDQ  : DHURFBHHIGPFN   MGUPRADUWSJB    LFCSWWGGRGC     PJRO            TEOI           
HHGLPBMV        : KDIT            RHVJYCJFA       BSPTPBGUEDA     OORHQHL        
TREEOGUUGIKI    : EAEQWMCKDB      YFMW            HUYECSCSES      TMTAQFLJWFMUVTD TPLLL          
YPCKXRNQHWXQJP  : MVHMPNXNGIWWM   PGIXEKCQYQWU    BIPMNQ          FPDWERXFU      
XLBSFHW         : YLFEULTHYXG     PBTPMVLHISW     ICMKH          
OTRWFCFK        : GBGFTMUQBX      MGKRYXCWDOMP    VTWD            RBYR           
WOOWGE          : ILNYDLEQTLXEJDI OXGUIILEYSHYU   JIBHPD         
QBNHK           : XWREWN         
YLPCEUJDRAW     : UQDUDEYPLQ      YBXVPSC         EFANPDYIHEOCHH  YHPXDSRH       
YCMGPQDGH       : AWIMBJHAKHY     EINQELMJP      
NLPEPFNCJMNBQRX : HSDRJSSO        TQCNINSIMSD     EQKOIHRBQFXEYFY MOHHSEYEVQGRMA 
UQDUDEYPLQ      : YLPCEUJDRAW     COGSFHFG        LMLNEAK        
QXSTLFLR        : TMYNUYNWP       CLGCHYADJGWJC   TAMGBFIIA      
RFWBTNEKFEMDURX : IYLSJCGF        LKGKPSIYTAP     SHKKJFQCWWDU    BHLNFFWN        UHAPRYIQ        THYRVSIIHNOQDXT
WWQIQCYOUUC     : LQBC            RXHQOVYQQ       LVQFJXHNV       LMCGIPGBLPEW   
HVYYBYC         : AKNWUJWGVW      YBTX            KANDOLJLWTWBSRK YYJSQXAIOFCKG   MDOHO          
MGJTKVW         : KIYOFCUXRLE     PLXJSBP        
QUINUBXL        : BJROAFRSVUJHH   DJVWPKUHKXVV    YYJSQXAIOFCKG   LPRUA          
YCBUEFCAFBDGFAU : OJPWHYPOXKY     KADCNPBCX       CLDW            FFRHFPY        
LOXHMIAJR       : YCPMYGMJUFRK    HTSNEMJTEND     ANPBNOJCA       OORHQHL        
EULRBLVCGAH     : TMYNUYNWP       HYJEATDETK      KADCNPBCX       JKMYWKLKX      
CONHWSHRGUHGDVP : CNQU            CMCULXNASIMTV   IGIUQJCIL       MXWWPLMSOOMDHXW PWYGBKVHOEQQB  
FJTMGHGHUDJDF   : YFMW           
NIKBPIVACCUJLAF : PFMVHAJY        IYLSJCGF        DFBVRWHKOSYKQV  AIFEHEHCWBUKH   RSINCOKNHUMUV   BAAFM           VKELXNNM        BBTDUCQMNMNQMRN
NIKBPIVACCUJLAF : TKXQWRNU       
GNMCAUJGD       : ERMCWEF         RSHYXP          DPLNYYDKT       DGKTG          
JMKPIYATCREYR   : DUUTIOGOSV     
DPSQRATXNIC     : PTJVPGJDBJG     DCKAVVA         CJTHUNHMJFOFMPN JIQWOKWQE       KTCKJRIJIKVGHD 
EMYHTKVEAFF     : FIUQIHSKRGSSBS  HUOX            MBKIHKGORQIP    DJIOGYTEONY     SXBHTAQK       
BKUFLONQG       : TCYMM           VUUI            CNTIRC          YVINT          
IYJCYYNCRRQQYM  : LAHMYNJ         CQRIEBM         TKXQWRNU       
WQECYGFJDMWSB   : WEWHFCQABBKF    PTJVPGJDBJG     PRGJ            JVJDKMKEFGCQQJ  VJTJM           HVQIBVPBYTWD    ANPBNOJCA      
YLVAUBAW        : WHULKIOLVKVL    AWIMBJHAKHY     CNTIRC         
COGSFHFG        : UGQFXX          UQDUDEYPLQ      PRGJ            WYFKL           WHRIDYATHRNP   
XMJY            : OIWJLU          OPDLIERCEEU     FDDFFKA        
OKYC            : JQMNLEYNGVAFRK  YXJEJT          DPRMTKQUSSQS   
TFVVQRVOUVLJX   : GNUMBBGGKBGPC   PWYGBKVHOEQQB  
RSHYXP          : GNMCAUJGD       DAFBJ           TJFLSVAYEQMC    DJKANVV        
YDRXYG          : GPKBNIODOSBVB   MQBUJ           QTITTM         
XKQSRMQLHM      : ELRLU          
ELNOJP          : BPSRMCBEMIB     HMJEVEUOS      
FYIFOQ          : HBTXJKUBRHWYJI 
RIFQQORCHMVW    : VNCREFIUCTHB    NUOYARYPPHJK    STUHNFTGKMVE    KWTYJQFVCNVP   
HGPJKBYBNQIU    : AJFKOPHJWJQ     HMCHJI          OFLBHOWCFTUD    PNRXGBBX        AXULDY          QNQXKUQWLM     
SAHLFYTKSKBMO   : APBWUKESVLMO    IBUS           
YLFEULTHYXG     : XLBSFHW         SOBODVHENWPJWDE
NAKIPDIYOPYKC   : FRCTXOCAOFAYGN  OWDPW           CGFEVWNGKMP    
VDIKM           : GNRYAQTHJS      LCDLG           AKFEOXJMWIF    
XTNTGJDFHLFWLQ  : WVDKSBOBFWCRP   YTLRYVNLOLPKARB
EVQDNI          : TFQJKCGM        YADPRMQJF       PWBG           
XLAVOIHDR       : OFWQY           GMYWHIYGYKIHPVJ YMETKLFIPH     
XFDGPG          : CQVOSGL         HTSNEMJTEND     PUJEKOGJNTO     DLWXEKV        
YSUYEN          : PVBNDNQMYBMW    IFEJ            LMLNEAK         JOVWKHQPEUYPU  
KKYOAISXVTW     : TWLU            YJKFMGVUOQIUS  
EEQWNOERWVXKVS  : KGGGDUEUYARGV   MJGIWYLCSOYXSOF UXVDKIDYILU     OFLBHOWCFTUD    ORBXPUGNNOQ    
UXVDKIDYILU     : TYWAPSULCGQRX   EEQWNOERWVXKVS  PNRXGBBX        JCXCDPCUOKL    
HQFTULKTAB      : SYNIYTHP        YMFRF           VFJEHE          DKLVCTVVONVMQCR AXJAPYSOXYA    
RXWRKU          : BXAFMVTUKLFP    YBXVPSC         JKMYWKLKX      
SPLOTVWYVFK     : PGARUPYU        JMLWRXWOUOCKHRB AXJAPYSOXYA    
PTJVPGJDBJG     : DPSQRATXNIC     WQECYGFJDMWSB   MEIN            NJYXSCTL        QKMJYHBTQ       OPRWVLNFCWHIX  
DFBVRWHKOSYKQV  : YWSWWAOX        NIKBPIVACCUJLAF QYKLPHAJTRMBPHJ UVWNFQFK        XVITSGMDWHHBL  
MDVFVPQTIX      : EAEQWMCKDB      KDIT            VUBHHWQYFFFAWPX TAYDXXKEH       GWRE           
NYPTD           : BQIJLSFOEXCF    QBYGT           CBWAMLLXMAB    
YGORDXESSEDKCPY : KPHKIASN        CBWAMLLXMAB     VKELXNNM        BTYBGROQ        IYCEJNGREU     
LHCEXVMVBAWQV   : RHLTCPTMN       JGRENC         
KXJBROCVJUAPH   : TNPSBHQ         OHODHKVCTAMKIV  DPRMTKQUSSQS   
FHLQOP          : WTAWEAA         KVKDYYFSCJSV    AKNWUJWGVW     
ONLL            : EDEILPRTDXOHH   KWTYJQFVCNVP   
LKGKPSIYTAP     : RWOYBKCL        RFWBTNEKFEMDURX HFCFM          
VATYR           : THNMVARHBCBM    JHAAD           IDCJD           KAWXGNTRLXEP    KIYOFCUXRLE     DMHKDNHV        DYMQBPUMROOA    IHDFIOGTCMSA   
CWKPPYFNQ       : OAYTJXOB        STUHNFTGKMVE    VGTOLFRODR      DPLNYYDKT      
YCJNORXEKI      : LVFFRQQA        HUNWIEESMEN     MTHNH           BPREDE         
HIXDEAYDRB      : KFIBKTIHEGQKQN  PXGIONXXHCOMAUV LOVCENFXBWGMP   WNIBACXGFU      DISEREWLCURD   
QLWGNEVEB       : PRBWFF          IQHIHJUDWGPWO   SJXPBOJEYST     GFBNKIDDSIM     VSGYFRUJLTFC   
ILNYDLEQTLXEJDI : APLUHKGEQMVHFYO WOOWGE         
DODGVTTVBJC     : RUDSJHMI        HYQWASH         QFIDLQSFQM      KBTX            BAAFM          
NEWX            : TCYMM           CAYOBOGELNIHB   XFJRVLHHBAPNTU  RHNW           
KAWXGNTRLXEP    : MXAE            VATYR           PCPPDS          HJPEWNBIMRRLJRL QQIE           
PSATBXNUTQ      : GROBSGLAAK      AKFEOXJMWIF    
YSWFPVWDV       : YUDRPM          DTETGLVWXCXFKR  DXCM           
DCKAVVA         : DPSQRATXNIC     RLNQSP          BIPMNQ          NNLSMMDCOHIRNSC
NJSGLOJKCHE     : HYJEATDETK      BQIJLSFOEXCF    WPBYXSIAIBP     YVQMSRMBNELMTH  DSLKUEMNKHJ     AASQMSO        
OFOLMGJJLFGPJSR : RSEAJWVFS       NUOYARYPPHJK    LFFTVBDQMEGUOP  IIWLRNJVUD     
ORKDED          : IDCJD           YWILWREUK       BBBELXNNXAPYK  
PRXAWFH         : OXGUIILEYSHYU   AIQBYYAYFUI     HNPAORVTOXMD   
TOLF            : SVXLMCAPA       MEDRXDVE        DPLNYYDKT      
RPNGWVXJ        : MCINXSGVISGW    LICKHNMDFNBACG  CJTHUNHMJFOFMPN CMCULXNASIMTV   EHBOYTPUYYGI    CMCVUV         
PRGJ            : GNAJ            TVKXHBV         KSGP            WQECYGFJDMWSB   COGSFHFG        DAANXGTUOXVF    XWFGSQ         
JNKWGEUGDAP     : SIUGMUOSI       AWIMBJHAKHY    
VFJEHE          : HQFTULKTAB      KOBSMLYXF       YIOJXNSLORE    
WKUTKEICXO      : WJWFXKA         DJVWPKUHKXVV    YEKSRDAPMBSYG   PBPRJB          NOBJNGEIIAVF    TJFLSVAYEQMC   
DAANXGTUOXVF    : PRGJ            SJXPBOJEYST     RQKDUSXOVCWKFW  KRPDOJHLPUU     VFKGK          
RMIXVMT         : RTEYOJVUMWRDVT  GNSM            FGAAOUNK        ANPBNOJCA       KTGVGMSHSNCFJ  
YPMLT           : FAKNQR          XYGGVHEV        AJWJAXK        
NUOYARYPPHJK    : PIPNRKGDPEBMRH  RIFQQORCHMVW    OFOLMGJJLFGPJSR QMTEBOFRSC      POWMHVWBXPCNEGR JOVWKHQPEUYPU  
HIEG            : YSKIBRLWV       GYSJHIEONXFLJ   QUWVEDTPHEXDWAL TNJJWIOEVRKC    UJWHRDUIPJSO    VRTV           
SOBODVHENWPJWDE : DLSDXRAQJSU     YLFEULTHYXG     IQHIHJUDWGPWO   DGSWSS          CXNXLLVCW       XSVG            WTNEORLWSFTLTXG LIOTKLIPHOF    
CGFEVWNGKMP     : QNCKRROU        PMINXCEJYXQCN   NAKIPDIYOPYKC  
SVXLMCAPA       : JIJV            KSGP            TOLF            LOVCENFXBWGMP  
TNJJWIOEVRKC    : HIEG            ITVEAOVOSG      IMSIPLOYPV      PJTQ            OPRWVLNFCWHIX   RBPFBQWM       
HBNPLBFHTE      : FIUQIHSKRGSSBS  QJVMDVVMHLTEB   WTNEORLWSFTLTXG LPRUA          
IQHIHJUDWGPWO   : WMQIS           QLWGNEVEB       SOBODVHENWPJWDE BTPVNTKKP       SSIWXQAHMPBKJJ  DWPTSEVFMPIKM  
BLXLPVUQK       : OQUUXGRKQEXE    ISHVBJRLB       LWXLVUNKYWLTNWQ YYSOGDIVYMUWU  
FNSM            : WVWB            QXKL            HJPRYEKFRPAM    HXLAFCKWM      
YRRPCD          : CJLW            KBTX            YYJSQXAIOFCKG  
LXFLHUIVYLJXY   : FRCTXOCAOFAYGN  OWDPW           UFWUOF          WHKTVV         
VUUI            : BKUFLONQG       YBXVPSC        
AXCMIBGATKFUY   : CNQU            RXHQOVYQQ       DIRCJMHMKCIWIJ  QNQXKUQWLM      AJWJAXK        
AKNWUJWGVW      : VLOB            HVYYBYC         FHLQOP          SAWIH          
WUCRGKTEOIMS    : FLMTMYDVK       XWDXVKKKDBL     SKXS            YINOGFDIBELIV  
PMCUJDBMPQJ     : TXFNAANTEWSC    RBPFBQWM       
BISYFBVDDQJPK   : OWDPW           VMGGHGVDE       RLNQSP         
FVFXNWMRRVVVIN  : QIVHMACNDRJATEK YMKBRJFLBNQ     NKNRRBNT        NNLSMMDCOHIRNSC USRC           
UBPDTOLWNOBEASQ : IUCOK           DWPTSEVFMPIKM   SXBHTAQK        RQLPWLU         AFBPVLJ        
XMWXATKUO       : BIGVQOUQSJQ     AASQMSO         MOHHSEYEVQGRMA 
QMTEBOFRSC      : IWJVGMQPGAY     FTXIXSELV       NUOYARYPPHJK    RRGUTGX         AKFEOXJMWIF    
EYVUCCUVTM      : TCNEDC          CEVYFDEFCK     
IKULGHGUQYHLD   : PQWTPWNIIDF     HDQGILL        
CLDW            : WHULKIOLVKVL    YCBUEFCAFBDGFAU WYFKL           DISEREWLCURD   
LBOKXTMUPIILTUI : KFUYX           NAONCDR        
BQLY            : TMYNUYNWP       HUWKRCHF        ITLUPUWUGNOH    OPRWVLNFCWHIX   PWBG           
MGUPRADUWSJB    : GYNMAUOHTIIPDQ  EKORHGMEC      
TYGIUVTF        : DWPTSEVFMPIKM   IOCC            CKTATSLIUTA     GTTYMTX         HDQGILL        
NASSDJGCSSLQKD  : GJBX            HSAQBKERB      
QBNLKQVGQEQNAKS : LNFFWCG         QBSUOI          GNUMBBGGKBGPC   NQNJXR         
XSFQXQ          : XSVG            ABYTNSJTH       OKVMKMB         SKXS           
BJROAFRSVUJHH   : QUINUBXL        CMCULXNASIMTV   MAIJGQWWDH      NMYABSFLRL     
GNSM            : GCUBHY          RMIXVMT         UJFWCLMJY      
GNRYAQTHJS      : VNCREFIUCTHB    HYJEATDETK      HUOX            VDIKM          
JVJDKMKEFGCQQJ  : WQECYGFJDMWSB   IUDGBS          PGIXEKCQYQWU    OGOSXMUGT      
YAMLHT          : NMDMW           ECJSKBNNUYWJKIJ PVBNDNQMYBMW    VMVGTRLWNAO     KJJL           
YUDRPM          : EXUFROGDCJQGWOA WVGXHAHWRBSRIAE YSWFPVWDV       CJTHUNHMJFOFMPN GROBSGLAAK     
KKLGWQSJCYO     : HBTXJKUBRHWYJI  WJWFXKA         LDKGCOVR        FGTWFJREEX     
BIDLAENOS       : VSGYFRUJLTFC    SJKURP          ULUCKJ         
ITVEAOVOSG      : TNJJWIOEVRKC    DUDPPJMYIENJNR  AKFEOXJMWIF    
GMYWHIYGYKIHPVJ : TARSKOHWSSSP    XLAVOIHDR       WOCVXODMWYINRSI VGNTQHO        
JYNIHJENJU      : RUEBKT          QPMMRLYR        KBJPECG         UKVCDYVJ       
YPRDVECTNKU     : VVPSYEANAKCOHU 
LFFTVBDQMEGUOP  : OFOLMGJJLFGPJSR ITJRGTFEKM      GPQEYV          VGNTQHO        
CAYOBOGELNIHB   : NEWX            FHWGILH        
CXGKDAIGGBUMH   : HRBSBOOKRHHPVGV OFIQBEWDT       GYLO            CWBVFBAGHCLTHC  WPMMFUBGG       BBTDUCQMNMNQMRN
BWVGYWUANDGB    : TGIJCIGW        OORHQHL         TAFIEUCIUMKEK  
OIWJLU          : DIVFGRPBIPUFCQN XMJY            AKNCTHLOU      
XBSGJBHHOOB     : VLOB            LJTHPIM         SERIAMSE        EFANPDYIHEOCHH  IFGKJCEWVTLPB  
LWXLVUNKYWLTNWQ : BLXLPVUQK       RLNQSP          BXAFMVTUKLFP    NJYXSCTL       
IMSIPLOYPV      : LQBC            MTHNH           TNJJWIOEVRKC    EKORHGMEC       OFIQBEWDT       FOYCESCD       
GKIXX           : SBWLPPGSXE      RJBMMPCYJL      CQRIEBM         VSRGECQBI      
WLETAQ          : FQCJPLVOVYP     WNHERPQKEE      IBVQBOHRASXIPOR DJIOGYTEONY     FYSC            YXJEJT         
YCPMYGMJUFRK    : GJSYVLFEHKUPIDF IWQMJJEBGYESCU  KFUYX           LOXHMIAJR       PYKYOTTFNNSYDM 
GMLESRQDPPNOB   : MGPQ            GKCXUVYW        QMLQBKH         HLOCLMXHOGG    
LDKGCOVR        : PFMVHAJY        KKLGWQSJCYO     TQYUNXCGQKETNVW INFTEQK         BBWX            TDYHPHOOF      
FGAAOUNK        : RMIXVMT         MGPQ            ICMKH          
AVIUPY          : LICKHNMDFNBACG  CJLW            WPBYXSIAIBP     FEOCTROPAIM     WYFKL           BJHVTUEFVCXN   
FQOWUIIXSQDH    : GSJDRO          NJYXSCTL       
WXUDBWTVKEBKC   : FTXIXSELV       RVYANBCH        YUPRPXTWVICOJ   HEENTYVFMWBGCMC
GRLHAEVYYGJAB   : LHVKGABBFLV    
DIRCJMHMKCIWIJ  : NEJKA           AXCMIBGATKFUY   OMJIA           THQKATGEXF     
LVQFJXHNV       : GCMWLYUSP       WWQIQCYOUUC     MXLP           
PCPPDS          : LICKHNMDFNBACG  KAWXGNTRLXEP    GULEAXKKWCBVRL  OMJIA          
NKWYAEL         : OWLSUDQYJXKBCH  LJDSVQOKAVRGTW  RRHVO           JHOOG          
ITJRGTFEKM      : JQMNLEYNGVAFRK  LFFTVBDQMEGUOP  WLSDXJGDIEI     IFCLEMAGXKGKTF  JKTIEUPWGJVGRO  NEFY           
IUDGBS          : JVJDKMKEFGCQQJ  BSPTPBGUEDA     KTGVGMSHSNCFJ   WHRIDYATHRNP    BWLMNJAMJMXDCCR SKXS           
TILMDCWABYHNL   : PRBWFF          FSNYEANNTH     
JVHRPOV         : LNFFWCG         RHLTCPTMN       ULUCKJ         
CJLW            : VXDEVQCRIW      YRRPCD          AVIUPY          NURCMWVTDWMIQJC LQHPFYDERIY     DNGYOUSN       
SAID            : LJDSVQOKAVRGTW  IJICUQPPTRGC    WITQFJBECFW    
RRGUTGX         : STIJEPPUNXUM    QMTEBOFRSC      CLKBGBIMJEN    
FFKR            : RTEYOJVUMWRDVT  TOAR            UVRMQSYLBU      JAVHAG         
WPHOHVLKXWWW    : FSQCIISHPDVVBQ  GPQEYV          FMFOJDBC        MXWWPLMSOOMDHXW DGMCXABT        SSGCPODMDNGQ   
RXVUR           : AXULDY          KBJPECG         HCRQPLMSE       SBCPIAVSXFWPKIM
MBKIHKGORQIP    : XKOJ            EMYHTKVEAFF     DHSLXF         
XWFGSQ          : FEMMQMR         OWBUDWNMDNP     PCLSOV          PRGJ            DGMCXABT       
TNPSBHQ         : KXJBROCVJUAPH   TMPEJOPEGMBHLO  IFCLEMAGXKGKTF  LOVCENFXBWGMP   BJKRVDQU        AFBPVLJ        
FLMTMYDVK       : WUCRGKTEOIMS   
KCATTQTQV       : EKORHGMEC       YUEIWJRJW       DWPTSEVFMPIKM  
MOVIENBHXU      : QHIJHN          WPBYXSIAIBP    
DGSWSS          : SOBODVHENWPJWDE WESEMQGK        CHGNSGLN       
OFLBHOWCFTUD    : KHCYQL          KWVSXVKDRYVLV   HGPJKBYBNQIU    EEQWNOERWVXKVS  IIWLRNJVUD      UVQPEDSXXBCBQMA
JTTRXIVG        : KXVD            CHNDQXXAYFDGX   WPBYXSIAIBP     AVMXTQXBBPYV    UHAPRYIQ        BPREDE         
QOJYIIRD        : OUGVAF          MPKC            UVWNFQFK        UIUTAOVP        GQGWQH         
IIWLRNJVUD      : OFOLMGJJLFGPJSR OFLBHOWCFTUD    CMCULXNASIMTV   BWLMNJAMJMXDCCR AXJAPYSOXYA    
ABDTVXUGVDMM    : VLXTIPVARMJB    CHNDQXXAYFDGX  
XNAGHFTPNTDI    : MPXXIOYYRMX     LDWW            QKMJYHBTQ       MYGRQGU         YINOGFDIBELIV  
MEDRXDVE        : TOLF            FYSC            KWTYJQFVCNVP    OKKC           
TCUAXX          : UNERA           CHGNSGLN        DPRMTKQUSSQS   
MPKC            : QOJYIIRD        XDBYK          
SJXPBOJEYST     : QLWGNEVEB       DAANXGTUOXVF    UKVCDYVJ        SJQL            AKFEOXJMWIF    
XNEEJIED        : KHCYQL          TARSKOHWSSSP   
YFMW            : QMQJQCEBMIGTWF  TREEOGUUGIKI    FJTMGHGHUDJDF   IUXNTVEXLJB    
BOEDHAMIR       : MTWCUKYTXV      MGKRYXCWDOMP    THQKATGEXF      RRIRYXQT        GYLO            MXLP           
YBTX            : RXHQOVYQQ       HVYYBYC         LAHMYNJ         YBIPJ           CMOL           
NBUCHBNRFTEEYS  : IBVQBOHRASXIPOR KANDOLJLWTWBSRK YAXFYJLW        ELRLU          
TTTAWCALMRBL    : DKLVCTVVONVMQCR NQNJXR          XKORRPDFGWTOTCT MGPV           
VJTJM           : WQECYGFJDMWSB   FAKNQR          NJYXSCTL        GRKPHYFYSWL     TJFLSVAYEQMC   
NURCMWVTDWMIQJC : BPSRMCBEMIB     CJLW            BQEYQG          UHAPRYIQ       
GETUQMVEJRND    : CEVYFDEFCK      NKNRRBNT        AFBPVLJ        
BTPVNTKKP       : IQHIHJUDWGPWO   EXSLULVDXGR     WHRIDYATHRNP    CTNJXFXRHWXT   
PNRXGBBX        : LGUA            HGPJKBYBNQIU    UXVDKIDYILU     ADMNQWOQR      
HSGBHDF         : YEFJUMILLLWLJA  LGUA            WBNSMUJYESKJEVA FWUFE           ULUCKJ         
WVWB            : PFMVHAJY        VKDGNLJYEKJPY   FNSM           
STUHNFTGKMVE    : TMYNUYNWP       HUCQAHVWPSFU    RIFQQORCHMVW    CWKPPYFNQ       TUOSGRXFMVTY    BBWX            CMOL            TRDL           
CHNDQXXAYFDGX   : JMXOGEM         GATANUSBMFLQUD  YYOFTMPTWSRV    JTTRXIVG        ABDTVXUGVDMM   
CUCBQXVALCT     : WNHERPQKEE      KOBSMLYXF      
MGPQ            : GMLESRQDPPNOB   FGAAOUNK       
SXHX            : LNFFWCG         QDGWTRJVYVBUKP  FSQCIISHPDVVBQ  TAYDXXKEH       BTYBGROQ       
HVQIBVPBYTWD    : WQECYGFJDMWSB   VUXUTSAGYIOCOTG JBFV            LXGC           
PBTPMVLHISW     : KGWPYPUAOC      XLBSFHW         RVWDSSCV        JXYTBFPJQYAIRY  MGPV           
ORBXPUGNNOQ     : VEOYFYGWHE      EEQWNOERWVXKVS  UVWNFQFK        LMLNEAK         KYRKBWBGSPQEEU 
GSJDRO          : RSEAJWVFS       FQOWUIIXSQDH    APBWUKESVLMO    XKORRPDFGWTOTCT QKMJYHBTQ       DRNRAYGMIR      JBLOHOSECW      KXCAVDARXMR    
HPUWER          : NVPJCGSTDDF     LUGPMKFWWAPOE   DLWXEKV        
LCDLG           : RQFMXCY         WEWHFCQABBKF    VDIKM           JMNMGGBQW       DUEMUO         
FHSXEBLSP       : LAVYCMM         YAXFYJLW        GQGWQH         
DYXOCPDDWUXVY   : QGKFIKFKE       VBLAEUHLTM     
GNUMBBGGKBGPC   : RTAHHKGNWRDWU   TFVVQRVOUVLJX   QBNLKQVGQEQNAKS YAGG            KDSPLJQPHW      CMCVUV         
IUXNTVEXLJB     : YFMW            ALDULXHQX       VNHWWBYRFQPTFE 
GBGFTMUQBX      : RMPBPT          OTRWFCFK        MGFWXOYFQR     
IFEJ            : TLMDITGD        YSUYEN          TGIJCIGW        DXCM            TPLLL          
VMGGHGVDE       : BISYFBVDDQJPK   MGKRYXCWDOMP    TAAHQCS        
BPLECRFIABXWRB  : EAEQWMCKDB      IUCOK          
LJDSVQOKAVRGTW  : NKWYAEL         SAID           
UXDGCGBJQBN     : GYSJHIEONXFLJ   BAITRIYMVARVNH  QPMMRLYR       
XFSTTEYOAQDKQB  : VLXTIPVARMJB    IFGKJCEWVTLPB   HSAQBKERB      
WVDKSBOBFWCRP   : XTNTGJDFHLFWLQ  QFIDLQSFQM      YMGMDIESI       UKVCDYVJ        BTYBGROQ       
FJGMECII        : BQIJLSFOEXCF    QIWDE           GULEAXKKWCBVRL 
WLSDXJGDIEI     : RQFMXCY         NMDMW           ITJRGTFEKM      GKCXUVYW        PMYVUGFL        BAAFM          
YMKBRJFLBNQ     : FVFXNWMRRVVVIN  GROBSGLAAK      BRNAU          
TGOVOXAOLU      : RWOYBKCL        VLXTIPVARMJB    TCMBIVFRXFT     TPLLL           MGPV           
JEAOPFXL        : QBSUOI          BQVTHDU         HXLAFCKWM      
KXHEHPQ         : UIUTAOVP       
DJVWPKUHKXVV    : CKTIICFH        QUINUBXL        WKUTKEICXO      IOFPGHSXBBDEG   GULEAXKKWCBVRL 
PGARUPYU        : XNGDPIYBQBOAQD  TVKXHBV         SPLOTVWYVFK     IOFPGHSXBBDEG  
GFBNKIDDSIM     : EGRT            SFCE            QLWGNEVEB       UVQPEDSXXBCBQMA
HFCFM           : HSDRJSSO        PCOI            LKGKPSIYTAP     RENFMRD         PLXJSBP         EINQELMJP      
DKLVCTVVONVMQCR : HQFTULKTAB      TTTAWCALMRBL    RQKDUSXOVCWKFW  FHGQOXGVUHL     VBLAEUHLTM     
RECXJXGYMOE     : THQKATGEXF     
VSGYFRUJLTFC    : VVPSYEANAKCOHU  QLWGNEVEB       BIDLAENOS       GKCXUVYW        VTIPSEWHDX     
BOYFJSXPVXCTEB  : TCMBIVFRXFT     WFUXCXVBIG      XPOLGYU         TAFIEUCIUMKEK  
UHAQAIRH        : NGRU            DSLKUEMNKHJ     OKKC           
NQNJXR          : QBNLKQVGQEQNAKS TTTAWCALMRBL    APBWUKESVLMO    UIOR            QTNJQOXRQH     
CJTHUNHMJFOFMPN : SYNIYTHP        DPSQRATXNIC     RPNGWVXJ        YUDRPM          AWIDJCU         ONKYVTLFGEDQR  
WPBYXSIAIBP     : NJSGLOJKCHE     AVIUPY          MOVIENBHXU      JTTRXIVG        GQGWQH         
AKNCTHLOU       : OIWJLU          MPXXIOYYRMX     ILFTDJFAUO     
DGYSLLKCV       : MTHNH          
TWLU            : KKYOAISXVTW     JOHYEBTMFQQF    AXJAPYSOXYA    
UUBVNUX         : HUWKRCHF        QASYNMB         OORHQHL         HSAQBKERB      
IATQMKNINWHGK   : VMVGTRLWNAO     JSHP            AGIKJBD        
TMPEJOPEGMBHLO  : TNPSBHQ        
JMNMGGBQW       : MTOEIFUKXJFHT   LCDLG           HNPAORVTOXMD   
HTSNEMJTEND     : XWREWN          DXGEKPBNGDJNVQ  LOXHMIAJR       XFDGPG          EINQELMJP      
GJCS            : LEBM            LFSMFSX        
LEAQOOHDXNEQ    : LEBM            OHIYUOCJRQDA    KADCNPBCX       UJFWCLMJY       TSKCH          
PXGIONXXHCOMAUV : CCXCYJM         HIXDEAYDRB      VRFQQHWBRIBH    KRSFILHHK       FXSJUVHYGC     
NGRU            : KGGGDUEUYARGV   TJXLTPJWR       UHAQAIRH       
LLXSOXIUOVKPC   : RMPBPT          XLQR            TKINTWULFCED    TVUEBLXPH       RTDULCKRJJOWP  
GPQEYV          : LFFTVBDQMEGUOP  WPHOHVLKXWWW    NNLSMMDCOHIRNSC LIOTKLIPHOF    
NVPJCGSTDDF     : HPUWER          UHOWOPAPWE      QFDBRERVBHEI    MYUAJD         
DAFBJ           : IWJVGMQPGAY     HUCQAHVWPSFU    RSHYXP          RRIRYXQT       
SHKKJFQCWWDU    : TJXLTPJWR       RFWBTNEKFEMDURX EHBW           
RQKDUSXOVCWKFW  : DAANXGTUOXVF    DKLVCTVVONVMQCR KRPDOJHLPUU    
JGRENC          : LHCEXVMVBAWQV   KRPDOJHLPUU    
AIFEHEHCWBUKH   : NIKBPIVACCUJLAF SJKURP          JORROXKIXGPCVPJ TAFIEUCIUMKEK  
DFGAJDMPDFBJYFA : BSXMHUAOCTHSH   LFCSWWGGRGC     YMGMDIESI       IDIBT           WOCVXODMWYINRSI
TCMBIVFRXFT     : TGOVOXAOLU      BOYFJSXPVXCTEB  DULXPA          LRNBOCSDQVJM    FTFBLMVAOLVWYRP
PBMSISUSYKK     : UJFWCLMJY       NOBJNGEIIAVF    CTNJXFXRHWXT   
RLNQSP          : EXUFROGDCJQGWOA DCKAVVA         BISYFBVDDQJPK   LWXLVUNKYWLTNWQ YAXFYJLW       
ORJPCHW         : RTCBO           QQIE            MXLP           
FEOCTROPAIM     : AVIUPY          THQKATGEXF      RRIRYXQT        HPOFOYLXIPQUF   JBLOHOSECW      IYCEJNGREU     
JYFL            : RRHVO           YJXOWPLXWOISW   CWBVFBAGHCLTHC 
QYKLPHAJTRMBPHJ : DFBVRWHKOSYKQV  EFANPDYIHEOCHH  VRFQQHWBRIBH   
XLQR            : LLXSOXIUOVKPC   MPXXIOYYRMX     ALYWKDDYUVMKK   IOCC            VKELXNNM       
ITLUPUWUGNOH    : HSMYDOSJYNIJFT  KGWPYPUAOC      BQLY            XSPFFU         
AWIDJCU         : YEFJUMILLLWLJA  EMQKHDOU        CJTHUNHMJFOFMPN SCWOJORAVTSUI  
FMFOJDBC        : WPHOHVLKXWWW    GEEBUYFUDMXLI  
EKORHGMEC       : WHULKIOLVKVL    HUNWIEESMEN     MGUPRADUWSJB    IMSIPLOYPV      KCATTQTQV       YGRXMQSVDOGK   
USCUSCF         : GKYREXIXSP      BWEWBOUBS       QKMJYHBTQ       CAWXFVGXVT     
LJTHPIM         : NOEEUY          XBSGJBHHOOB     KOBSMLYXF       PXLOLDGXYXPLFIA DJKANVV        
RRHVO           : OWDPW           NKWYAEL         JYFL            SKENMS          RVYANBCH        DLWXEKV        
GFFQMTUOORHTP   : VVPSYEANAKCOHU  EXSLULVDXGR    
VUBHHWQYFFFAWPX : DUUTIOGOSV      CLGCHYADJGWJC   MDVFVPQTIX      PWBG           
DHSLXF          : MBKIHKGORQIP    AXULDY          MYGRQGU         MDOHO          
UVWNFQFK        : DFBVRWHKOSYKQV  QOJYIIRD        ORBXPUGNNOQ     JIBHPD         
ANTJMMITROTQ    : MYWPPQEMIDVBRRA COESFLSGFB      POWMHVWBXPCNEGR MGFWXOYFQR      ALOJEGX         XNSUWEOKATQK   
UGJCYWAHD       : JGERBBTBQLEEBN  CFJVDNQUIYEUOFS
FAKNQR          : HPXDBSEVKLTY    GNAJ            VKDGNLJYEKJPY   YPMLT           VJTJM           YYSOGDIVYMUWU  
FSNYEANNTH      : IJUBNETYAIUB    KTVDNTM         TILMDCWABYHNL   FQKPWHNBYRTEFON EXSLULVDXGR    
QXKL            : BAMMPYDUSCWS    FNSM            PUJEKOGJNTO    
VNFTPOYM        : INFTEQK         MEDVO           FWUFE           FXSJUVHYGC      LPRUA          
BAITRIYMVARVNH  : STIJEPPUNXUM    TARX            SIUGMUOSI       UXDGCGBJQBN     PGIXEKCQYQWU    RTUGL           UNERA           KTCKJRIJIKVGHD 
ULIUXTYVJG      : HUWKRCHF       
YVQMSRMBNELMTH  : YANWKEQFIS      HUOX            NJSGLOJKCHE     RBJPITXCBFUOUX  QAKLSSASOOSIF  
LFCSWWGGRGC     : KVKDYYFSCJSV    GYNMAUOHTIIPDQ  DFGAJDMPDFBJYFA MAIJGQWWDH     
CMCULXNASIMTV   : CONHWSHRGUHGDVP RPNGWVXJ        BJROAFRSVUJHH   IIWLRNJVUD     
HJNOXBVBVSXC    : TYSPHXMBXGYOFL  MXAE            DNGYOUSN       
SKENMS          : DHURFBHHIGPFN   HPXDBSEVKLTY    RRHVO           KBJPECG         EINQELMJP      
JEPXFIITEEPLND  : DXGEKPBNGDJNVQ  VWXIGJLG        AWDHGXIFSS      BVYC            BQVTHDU        
MGXPCTPGU       : GFJPOMG         ARMUXIELGAFSSAT YBIPJ           MGFWXOYFQR      YYSOGDIVYMUWU   DMHKDNHV        KGLRXSR        
QBYGT           : AJFKOPHJWJQ     NYPTD           XFJRVLHHBAPNTU 
RBJPITXCBFUOUX  : YVQMSRMBNELMTH  NBUFP           JTWCGNRQN       XVITSGMDWHHBL  
JHRYJNP         : WOCVXODMWYINRSI
LAHMYNJ         : IYJCYYNCRRQQYM  YBTX            DXCM           
GKCXUVYW        : AUSVB           GMLESRQDPPNOB   WLSDXJGDIEI     VSGYFRUJLTFC    JSVJNVTG        YJXOWPLXWOISW  
GROBSGLAAK      : PSATBXNUTQ      YUDRPM          YMKBRJFLBNQ     YMGMDIESI      
QCCCDKQE        : DUUTIOGOSV      CJVARH          TAAHQCS        
AWIMBJHAKHY     : OHIYUOCJRQDA    YCMGPQDGH       YLVAUBAW        JNKWGEUGDAP     LXGC           
BNTVVFXYSKPUORA : BDEBWYFQRFVBBR  BHLNFFWN        ELRLU           BWLMNJAMJMXDCCR
IFCLEMAGXKGKTF  : JHAAD           ITJRGTFEKM      TNPSBHQ         BYVY            GJBX           
UVXTRDRQXEIV    : PVBNDNQMYBMW    FGTWFJREEX      TNADGWCBUCKSM   CFJVDNQUIYEUOFS CLKBGBIMJEN     DADFMNMYOIYWETJ IHDFIOGTCMSA   
AXULDY          : NMFWV           HGPJKBYBNQIU    RXVUR           DHSLXF          OFIQBEWDT      
KOBSMLYXF       : CEVYFDEFCK      OAYTJXOB        VFJEHE          CUCBQXVALCT     LJTHPIM        
BDEBWYFQRFVBBR  : OWBUDWNMDNP     BNTVVFXYSKPUORA BSPTPBGUEDA     SJKURP          XWDXVKKKDBL     HCRQPLMSE      
AMOFOPRDRKRFLPN : DUUTIOGOSV      VGTOLFRODR     
TQYUNXCGQKETNVW : LDKGCOVR        TKINTWULFCED    PMYVUGFL       
LOVCENFXBWGMP   : HIXDEAYDRB      SVXLMCAPA       TNPSBHQ         XMDWHR          WUJMLLYMCUGIJV 
JLKLIAJN        : LQHPFYDERIY    
CXNXLLVCW       : SOBODVHENWPJWDE
XBQNGRQGXEVRPJE : RDVT            RJBMMPCYJL     
RENFMRD         : HFCFM           BDXFCQN         LGKCOUOHBXBXFKR FDDFFKA         OKKC           
QPMMRLYR        : VWDDSUNBMUK     JYNIHJENJU      UXDGCGBJQBN     QGKFIKFKE      
RHVJYCJFA       : DLDOKXD         HHGLPBMV        DTETGLVWXCXFKR  BQVTHDU         VSRGECQBI      
UJFWCLMJY       : RCQCDIPAGYXGED  FJCKU           GNSM            LEAQOOHDXNEQ    PBMSISUSYKK     AASQMSO         EINQELMJP      
NBUFP           : NEJKA           RBJPITXCBFUOUX  NNGOLLXGKJPRKSJ LPRUA          
YEKSRDAPMBSYG   : WKUTKEICXO      QFIDLQSFQM      MTYUU           VCKUTUHA       
AEFIBHVPSUTG    : CNQU            ISHVBJRLB       BVYC            HCRQPLMSE       YUPRPXTWVICOJ   GQGWQH          BGCTAIH        
RNOBMSMHMRIFGJX : TYSPHXMBXGYOFL  DYOJJAIQSQ     
SSIWXQAHMPBKJJ  : IQHIHJUDWGPWO   CQRIEBM         RBPFBQWM        VSRGECQBI      
BXAFMVTUKLFP    : RXWRKU          LWXLVUNKYWLTNWQ AXJAPYSOXYA    
QPXJJGGJYGT     : KRPDOJHLPUU    
VWXIGJLG        : APLUHKGEQMVHFYO JQMNLEYNGVAFRK  NKOD            JEPXFIITEEPLND  JBFV            CWBVFBAGHCLTHC  EINQELMJP      
QVIMSSXALQQBQBK : BLSBIIMSS       RTCBO           MEIN            IBUS           
JWVQQ           : HUCQAHVWPSFU    BVPN            QMLQBKH         YYSOGDIVYMUWU   BPREDE         
ONKYVTLFGEDQR   : RCQCDIPAGYXGED  KGWPYPUAOC      CJTHUNHMJFOFMPN TPLLL           GQGWQH         
MPXXIOYYRMX     : XNAGHFTPNTDI    AKNCTHLOU       XLQR            AJWJAXK        
JTWCGNRQN       : BAMMPYDUSCWS    RBJPITXCBFUOUX  PGIXEKCQYQWU    XSPFFU          CCDN            AXJAPYSOXYA    
MBWVFAMYX       : FRCTXOCAOFAYGN  SQLGFRFD        FSQCIISHPDVVBQ 
RVYANBCH        : XKNMQFTWYXPDBBT RQFMXCY         EAEQWMCKDB      WXUDBWTVKEBKC   RRHVO           LRNBOCSDQVJM    OKKC           
ALYWKDDYUVMKK   : XLQR            EPBOMWHSOSOE   
IGUKVWLW        : CCDN           
HYQWASH         : TJQYUJCSEDJN    DODGVTTVBJC     POBAM           CPTBAKCIUDKAN  
TUOSGRXFMVTY    : JTJPHEJULQBTXKQ STUHNFTGKMVE    MGKRYXCWDOMP    TMTAQFLJWFMUVTD
HJPEWNBIMRRLJRL : YJGTMRXJ        JGMREOWXYTNLJQ  KAWXGNTRLXEP    QAKLSSASOOSIF   YGRXMQSVDOGK    HOFBLIFKAVXIUU 
YBXVPSC         : YLPCEUJDRAW     RXWRKU          VUUI            TQCNINSIMSD     QGBD            WTNEORLWSFTLTXG
QJVMDVVMHLTEB   : LICKHNMDFNBACG  IJUBNETYAIUB    TJQYUJCSEDJN    HBNPLBFHTE     
MNPFAYWL        : MAKTUIYS        JCXCDPCUOKL     EDEILPRTDXOHH   YXJEJT         
XPETFWYN        : VFKGK           BYVY           
IJDOHYBPMW      : PVBNDNQMYBMW   
PUJEKOGJNTO     : OWLSUDQYJXKBCH  TCNEDC          XFDGPG          QXKL            KQJKUILLEOEOK   QFUEHCJT       
JSHP            : RERYQPBSRFFEY   XUTSYYDT        IATQMKNINWHGK   OFIQBEWDT       XNTNWHOWMNFMH   VSRGECQBI      
GFJPOMG         : MGXPCTPGU       LUGPMKFWWAPOE   MVPVSBTBXKI    
OHODHKVCTAMKIV  : JNFXOCSMC       CTRQCW          KXJBROCVJUAPH   IGIUQJCIL      
CKNMGVEYCJITAWA : JKMYWKLKX       RWSMCSRBVNIWPO 
NKNRRBNT        : FVFXNWMRRVVVIN  GETUQMVEJRND    JOVWKHQPEUYPU  
PGIXEKCQYQWU    : CTRQCW          YPCKXRNQHWXQJP  JVJDKMKEFGCQQJ  BAITRIYMVARVNH  JTWCGNRQN       DISEREWLCURD   
XYGGVHEV        : YPMLT           OORHQHL         FTFBLMVAOLVWYRP
RIYLAABVWSEHSKS : LVFFRQQA        KQJKUILLEOEOK   VTIPSEWHDX     
CTOBQM          : TJXLTPJWR      
RSINCOKNHUMUV   : JTJPHEJULQBTXKQ PJQENH          JGMREOWXYTNLJQ  UNJHJQXTL       NIKBPIVACCUJLAF DUEMUO         
YTLRYVNLOLPKARB : XTNTGJDFHLFWLQ  XYXDLN          JXYTBFPJQYAIRY  WHKTVV         
TSKCH           : LEAQOOHDXNEQ    RVWDSSCV       
RTCBO           : ORJPCHW         QVIMSSXALQQBQBK UIUTAOVP        CNTIRC         
XMDWHR          : QAWNXVTPGMVHQB  LOVCENFXBWGMP   TKINTWULFCED    VRTV            IBUS           
INFTEQK         : LDKGCOVR        VNFTPOYM        MYUAJD          HOSCECCLC      
SERIAMSE        : XBSGJBHHOOB    
HXPMBHDAVJYF    : SJQO            MDOHO           PSPBC          
QNQXKUQWLM      : HGPJKBYBNQIU    AXCMIBGATKFUY   ARMUXIELGAFSSAT
DUDPPJMYIENJNR  : OFWQY           ITVEAOVOSG      YUEIWJRJW      
KBJPECG         : JYNIHJENJU      RXVUR           SKENMS          NNGOLLXGKJPRKSJ
BSPTPBGUEDA     : SFCE            HHGLPBMV        IUDGBS          BDEBWYFQRFVBBR  MAKTUIYS        JHOOG          
SJKURP          : BIDLAENOS       AIFEHEHCWBUKH   BDEBWYFQRFVBBR  JOHYEBTMFQQF    WESEMQGK       
EFANPDYIHEOCHH  : NMFWV           YLPCEUJDRAW     XBSGJBHHOOB     QYKLPHAJTRMBPHJ ILFTDJFAUO     
BYUITBLVXHFKCA  : YADPRMQJF       HLOCLMXHOGG     OWHGDHTF       
MEIN            : PTJVPGJDBJG     QVIMSSXALQQBQBK
XSVG            : KXVD            SOBODVHENWPJWDE XSFQXQ          BAAFM          
AWDHGXIFSS      : VKDGNLJYEKJPY   JEPXFIITEEPLND  RRIRYXQT       
UFWUOF          : LXFLHUIVYLJXY   DTETGLVWXCXFKR  MKQTHIES        DADFMNMYOIYWETJ RBYR           
QFIDLQSFQM      : DODGVTTVBJC     WVDKSBOBFWCRP   YEKSRDAPMBSYG   GAUNFUENIVP    
APBWUKESVLMO    : SAHLFYTKSKBMO   GSJDRO          NQNJXR          JMLWRXWOUOCKHRB DPLNYYDKT      
JVMGKRLDYVJMMES : TVMY            IDIBT          
SVGIAFEKLYGX    : JCXCDPCUOKL    
XNWT            : HBTXJKUBRHWYJI  DWDB            XOFBAXJW        DXCM           
DHURMVNVJD      : KYSUREWGKHXM    ULUCKJ         
CJVARH          : TYSPHXMBXGYOFL  QCCCDKQE        WYUUWJXKG      
WLLJMTHBRWXO    : MJGIWYLCSOYXSOF PQWTPWNIIDF     KXCAVDARXMR    
EVTVIQ          : HBTXJKUBRHWYJI  QMQJQCEBMIGTWF  SUHJWWGY        SSGCPODMDNGQ    MOHHSEYEVQGRMA  TAFIEUCIUMKEK  
HCOKGAGGR       : SEAWFAVKFEEHXE  DIVFGRPBIPUFCQN NKOD            FTXIXSELV       WFUXCXVBIG      HXLAFCKWM      
HRBSBOOKRHHPVGV : XKOJ            OAYTJXOB        QIWDE           CXGKDAIGGBUMH  
DTETGLVWXCXFKR  : YWSWWAOX        OQUUXGRKQEXE    YSWFPVWDV       RHVJYCJFA       UFWUOF          BOIIVDXIRYY     LIOTKLIPHOF    
RJBMMPCYJL      : GKIXX           XBQNGRQGXEVRPJE ILFTDJFAUO      MLQWKWA         DRNRAYGMIR     
YHPXDSRH        : YLPCEUJDRAW    
AVMXTQXBBPYV    : JTTRXIVG        BGCTAIH        
AIORK           : LUGPMKFWWAPOE   ALDULXHQX       XDFCGUPQADBHK  
BVYC            : ECUPX           THEAPRKMDSOGTVR JEPXFIITEEPLND  AEFIBHVPSUTG    VNHWWBYRFQPTFE  DISEREWLCURD   
QAKLSSASOOSIF   : YVQMSRMBNELMTH  HJPEWNBIMRRLJRL SKXS            DPRMTKQUSSQS   
KJJL            : KTVDNTM         JGMREOWXYTNLJQ  YAMLHT          JOHYEBTMFQQF    DUVUTN          SMWHJ           AQEOKRKGLS     
LLNA            : DPLNYYDKT       ELRLU           AXJAPYSOXYA    
BQEYQG          : NURCMWVTDWMIQJC XSPFFU          EQKOIHRBQFXEYFY
HJRTCK          : JGFYPBA         OQUUXGRKQEXE    MCINXSGVISGW    CCDN           
WBNSMUJYESKJEVA : XNGDPIYBQBOAQD  HSGBHDF         WYUUWJXKG      
BDXFCQN         : RENFMRD         PJRO            HSAQBKERB      
BWEWBOUBS       : USCUSCF         CCBKATAI       
TFEFEIB         : DPXFEHNCMML     JAVHAG          LQHPFYDERIY    
UHOWOPAPWE      : LQBC            XRFXVN          NVPJCGSTDDF     WTMMABAMYI      NVRLJJDP       
KQJKUILLEOEOK   : TJXLTPJWR       PUJEKOGJNTO     RIYLAABVWSEHSKS LGKCOUOHBXBXFKR AGIKJBD        
SQRER           : HSYJHBMUPV      OWDPW           RHNW           
BBWX            : MTOEIFUKXJFHT   AHNIHMOWHH      KPHKIASN        LDKGCOVR        STUHNFTGKMVE    CKTATSLIUTA    
MAIJGQWWDH      : CJLX            TARSKOHWSSSP    BJROAFRSVUJHH   LFCSWWGGRGC     HDKSIHWXCNWSJW  POWMHVWBXPCNEGR BBTDUCQMNMNQMRN
LUGPMKFWWAPOE   : WMVTRIADLIJCROQ FQCJPLVOVYP     HPUWER          GFJPOMG         AIORK           MNXNNBQDUFVG   
AHLWHCMHMXQDWNG : DLWXEKV         DYOJJAIQSQ     
IUCOK           : UBPDTOLWNOBEASQ BPLECRFIABXWRB 
BRNAU           : YWSWWAOX        WPVST           YMKBRJFLBNQ    
PBPRJB          : AUSVB           WKUTKEICXO      CAWXFVGXVT     
QFDBRERVBHEI    : NVPJCGSTDDF     YBIPJ           SUHJWWGY        USRC           
YMGMDIESI       : WVDKSBOBFWCRP   DFGAJDMPDFBJYFA GROBSGLAAK      CMCVUV         
YADPRMQJF       : TCNEDC          LDLELWRGDI      EVQDNI          BYUITBLVXHFKCA  KRSFILHHK       SXBHTAQK       
OGOSXMUGT       : JHAAD           OAYTJXOB        JVJDKMKEFGCQQJ  ABYTNSJTH       GPKBNIODOSBVB   BPREDE          EHBW           
XSPFFU          : FEMMQMR         JGMREOWXYTNLJQ  VKDGNLJYEKJPY   ITLUPUWUGNOH    JTWCGNRQN       BQEYQG         
MNXNNBQDUFVG    : HUCQAHVWPSFU    BAMMPYDUSCWS    LUGPMKFWWAPOE   RCGXVKARNSESX   TAYDXXKEH      
UVRMQSYLBU      : FFKR            PLXJSBP         CKTATSLIUTA     GRUOXSSGNISRSJ 
BOIIVDXIRYY     : DTETGLVWXCXFKR  LMCGIPGBLPEW   
ARMUXIELGAFSSAT : MGXPCTPGU       QNQXKUQWLM     
DPXFEHNCMML     : TFEFEIB         TXFNAANTEWSC   
LMLNEAK         : UQDUDEYPLQ      YSUYEN          ORBXPUGNNOQ    
JORROXKIXGPCVPJ : AIFEHEHCWBUKH   EPBOMWHSOSOE   
WYFKL           : IJUBNETYAIUB    COGSFHFG        CLDW            AVIUPY          XNTNWHOWMNFMH  
QYFFOLFAQQO     : MGKRYXCWDOMP    HJPRYEKFRPAM   
IGIUQJCIL       : CONHWSHRGUHGDVP OHODHKVCTAMKIV 
XWDXVKKKDBL     : WUCRGKTEOIMS    BDEBWYFQRFVBBR  VQTGSMWFXFIVHB  HDQGILL        
IBVQBOHRASXIPOR : SQTFLFKFTDDV    VMVGTRLWNAO     WLETAQ          NBUCHBNRFTEEYS  GTTYMTX         BWLMNJAMJMXDCCR
WFUXCXVBIG      : RUEBKT          PCOI            UVXARVBLKBADLTA BOYFJSXPVXCTEB  HCOKGAGGR       JMLWRXWOUOCKHRB VRFQQHWBRIBH   
NJYXSCTL        : WTAWEAA         PTJVPGJDBJG     LWXLVUNKYWLTNWQ FQOWUIIXSQDH    VJTJM           YWILWREUK      
JSVJNVTG        : GKCXUVYW        SJQL            BFCNCPWB       
MAKTUIYS        : MNPFAYWL        BSPTPBGUEDA     BQVTHDU        
ADMNQWOQR       : CSMWHCAAYF      PNRXGBBX        MTYUU           VFKGK           RBPFBQWM       
LDWW            : XNAGHFTPNTDI    DWAWSI          WYUUWJXKG      
UIOR            : NQNJXR          DUEMUO         
UFQUPLQ         : LICKHNMDFNBACG  KYRKBWBGSPQEEU  THQKATGEXF     
KLHMPUA         : BJKRVDQU        JGERBBTBQLEEBN 
TQCNINSIMSD     : XKOJ            SQLGFRFD        NLPEPFNCJMNBQRX YBXVPSC         FDDFFKA        
HUYECSCSES      : TREEOGUUGIKI    ILFTDJFAUO     
QGBD            : JNFXOCSMC       YBXVPSC         YAGG            MGPV           
XFJRVLHHBAPNTU  : CSMWHCAAYF      NEWX            QBYGT           HLOCLMXHOGG     WHRIDYATHRNP   
DSLKUEMNKHJ     : NJSGLOJKCHE     UHAQAIRH        IFGKJCEWVTLPB  
NNGOLLXGKJPRKSJ : MXAE            NBUFP           KBJPECG         YMETKLFIPH     
MGKRYXCWDOMP    : OTRWFCFK        BOEDHAMIR       VMGGHGVDE       TUOSGRXFMVTY    QYFFOLFAQQO     DULXPA          DYMQBPUMROOA   
WTMMABAMYI      : UHOWOPAPWE      GQGWQH         
KYSUREWGKHXM    : HGXLKVN         WNHERPQKEE      DHURMVNVJD      VQTGSMWFXFIVHB 
BJKRVDQU        : TNPSBHQ         KLHMPUA         VUXUTSAGYIOCOTG MYUAJD         
FHWGILH         : XNGDPIYBQBOAQD  CAYOBOGELNIHB   ATSEWYCSVVILK  
KRPDOJHLPUU     : JGMREOWXYTNLJQ  VKDGNLJYEKJPY   KFUYX           DAANXGTUOXVF    RQKDUSXOVCWKFW  JGRENC          QPXJJGGJYGT    
HCRQPLMSE       : RXVUR           BDEBWYFQRFVBBR  AEFIBHVPSUTG   
PJRO            : KGGGDUEUYARGV   PVBNDNQMYBMW    JQMNLEYNGVAFRK  GYNMAUOHTIIPDQ  BDXFCQN        
ABYTNSJTH       : PWXBP           XSFQXQ          OGOSXMUGT       DUEMUO          XNSUWEOKATQK    GWRE            AIQBYYAYFUI     HNPAORVTOXMD   
DULXPA          : KADCNPBCX       TCMBIVFRXFT     MGKRYXCWDOMP    NORSHP         
UTXKIN          : XJRCS           QGSPONB        
MXWWPLMSOOMDHXW : LDLELWRGDI      CONHWSHRGUHGDVP WPHOHVLKXWWW   
TAMGBFIIA       : QXSTLFLR       
JMLWRXWOUOCKHRB : SPLOTVWYVFK     APBWUKESVLMO    WFUXCXVBIG      GWRE           
UIUTAOVP        : QOJYIIRD        KXHEHPQ         RTCBO           IYPG            HGPMSCDOD      
YUEIWJRJW       : JWFOXWYECAWE    SFCE            KCATTQTQV       DUDPPJMYIENJNR  QQIE            QWYEKWSIDWL     MGPV           
DWPTSEVFMPIKM   : IQHIHJUDWGPWO   UBPDTOLWNOBEASQ TYGIUVTF        KCATTQTQV      
FGTWFJREEX      : KKLGWQSJCYO     UVXTRDRQXEIV    BWLMNJAMJMXDCCR AWCWYG         
DJIOGYTEONY     : PIPNRKGDPEBMRH  OWDPW           EMYHTKVEAFF     WLETAQ          QSYTCJIJJCPA   
LGKCOUOHBXBXFKR : PCLSOV          RENFMRD         KQJKUILLEOEOK   MQBUJ           WPHMDVMF       
QSYTCJIJJCPA    : DJIOGYTEONY    
OXGUIILEYSHYU   : OFWQY           WOOWGE          PRXAWFH         NOBJNGEIIAVF   
EHBOYTPUYYGI    : KGGGDUEUYARGV   RPNGWVXJ        PQWTPWNIIDF    
KANDOLJLWTWBSRK : HVYYBYC         NBUCHBNRFTEEYS  KPGQ           
MTYUU           : IJUBNETYAIUB    YEKSRDAPMBSYG   ADMNQWOQR       CBWAMLLXMAB     BDWC           
VRFQQHWBRIBH    : SYNIYTHP        ISHVBJRLB       PXGIONXXHCOMAUV QYKLPHAJTRMBPHJ WFUXCXVBIG     
RVWDSSCV        : XKOJ            PBTPMVLHISW     TSKCH           DPLNYYDKT       LFSMFSX        
TGIJCIGW        : BWVGYWUANDGB    IFEJ            KTGVGMSHSNCFJ   DJTUGBUVVVGOIJ 
COESFLSGFB      : GATANUSBMFLQUD  ANTJMMITROTQ    KIYOFCUXRLE    
NOBJNGEIIAVF    : TJQYUJCSEDJN    WKUTKEICXO      PBMSISUSYKK     OXGUIILEYSHYU   AASQMSO        
FQKPWHNBYRTEFON : FSNYEANNTH      DJKANVV         KPGQ           
PWYGBKVHOEQQB   : CONHWSHRGUHGDVP TFVVQRVOUVLJX  
YIOJXNSLORE     : VFJEHE          XNTNWHOWMNFMH  
YJXOWPLXWOISW   : JYFL            GKCXUVYW        WOCVXODMWYINRSI XIELXH          YUPRPXTWVICOJ   LFGOCOUAV       MVPVSBTBXKI    
ANPBNOJCA       : WGKXATLVV       LOXHMIAJR       WQECYGFJDMWSB   RMIXVMT         FPDWERXFU       WPMMFUBGG      
RTUGL           : BAITRIYMVARVNH 
QMLQBKH         : GMLESRQDPPNOB   JWVQQ           ALDULXHQX      
JGERBBTBQLEEBN  : UGJCYWAHD       KLHMPUA         FFWDH           MLQWKWA        
DWAWSI          : KPHKIASN        LDWW            TDYHPHOOF       SSGCPODMDNGQ   
TAAHQCS         : VMGGHGVDE       QCCCDKQE        UJWHRDUIPJSO    SJQL           
RCGXVKARNSESX   : TJQYUJCSEDJN    FTXIXSELV       MNXNNBQDUFVG    CWBVFBAGHCLTHC 
GIKG            : RUDSJHMI        BQIJLSFOEXCF    DXGEKPBNGDJNVQ  PSPBC          
KBTX            : DODGVTTVBJC     YRRPCD          HMJEVEUOS       BAQIJGXEKB     
TXFNAANTEWSC    : RWOYBKCL        PMCUJDBMPQJ     DPXFEHNCMML    
UUUNYN          : WGYFSRJIOHHLVVW XIELXH          FYSC            ELRLU          
GWYSFKD         : MYUAJD          PLXJSBP         XDFCGUPQADBHK  
GDDDCKQEMGBQDTT : MYWPPQEMIDVBRRA
QQIE            : KAWXGNTRLXEP    ORJPCHW         YUEIWJRJW       SJQL            GTTYMTX         TRDL           
VUXUTSAGYIOCOTG : HVQIBVPBYTWD    BJKRVDQU        VNHWWBYRFQPTFE 
KLORMH          : CSMWHCAAYF      CCXCYJM         XOFBAXJW        BFMDDGWHPA     
IDIBT           : DFGAJDMPDFBJYFA JVMGKRLDYVJMMES KTGVGMSHSNCFJ  
HLOCLMXHOGG     : GMLESRQDPPNOB   BYUITBLVXHFKCA  XFJRVLHHBAPNTU 
XKORRPDFGWTOTCT : TTTAWCALMRBL    GSJDRO          GRKPHYFYSWL     VTIPSEWHDX      RTDULCKRJJOWP  
DQUMCMPQY       : XKNMQFTWYXPDBBT PMYVUGFL       
XPYGPWS         : QIVHMACNDRJATEK JVMUJCSMSVCLJ   IOCC            VKELXNNM       
OKWTPDQJT       : JIJV            PMYVUGFL        GULEAXKKWCBVRL 
NORSHP          : DULXPA          BIGVQOUQSJQ     EQKOIHRBQFXEYFY
JCXCDPCUOKL     : UXVDKIDYILU     MNPFAYWL        SVGIAFEKLYGX    WPHMDVMF       
EPBOMWHSOSOE    : TVMY            ALYWKDDYUVMKK   JORROXKIXGPCVPJ
DXCM            : YSWFPVWDV       IFEJ            LAHMYNJ         XNWT            PLXJSBP        
KYRKBWBGSPQEEU  : ORBXPUGNNOQ     UFQUPLQ        
HMJEVEUOS       : ELNOJP          KBTX            THYRVSIIHNOQDXT
XYXDLN          : BPRM            YTLRYVNLOLPKARB WHRIDYATHRNP    RQLPWLU        
KIYOFCUXRLE     : OCIRBDIFVUJUA   MGJTKVW         VATYR           COESFLSGFB     
JBFV            : HVQIBVPBYTWD    VWXIGJLG        DGKTG           TCDCHG         
KRSFILHHK       : PXGIONXXHCOMAUV YADPRMQJF       TVAXDVFHJSVO   
MYUAJD          : NVPJCGSTDDF     INFTEQK         BJKRVDQU        GWYSFKD         JBLOHOSECW     
ALDULXHQX       : QYTLASNPL       IUXNTVEXLJB     AIORK           QMLQBKH         NEFY           
TEOI            : GYNMAUOHTIIPDQ 
IBVQMDAAM       : GFLPCWIFQIPIN   IJUBNETYAIUB    GCUBHY          DIVFGRPBIPUFCQN GTTYMTX        
BIPMNQ          : BQIJLSFOEXCF    YPCKXRNQHWXQJP  DCKAVVA         IMXBRLRD       
YWILWREUK       : ORKDED          NJYXSCTL        HPOFOYLXIPQUF  
YBIPJ           : MTOEIFUKXJFHT   YBTX            MGXPCTPGU       QFDBRERVBHEI    KWTYJQFVCNVP   
OBXTDAH         : KTVDNTM         KDSPLJQPHW      NLVEM          
BRGQFYEHXMUUHBS : YKLR            BBTDUCQMNMNQMRN
BTTJKDUBG       : IOFPGHSXBBDEG   RKSEF          
UKVCDYVJ        : GFLPCWIFQIPIN   PFMVHAJY        TFQJKCGM        JYNIHJENJU      SJXPBOJEYST     WVDKSBOBFWCRP   WOCVXODMWYINRSI BAAFM          
CKVLJJIEQJY     : NMHRSRPYPSG     CKTIICFH       
KTGVGMSHSNCFJ   : TLMDITGD        RMIXVMT         IUDGBS          TGIJCIGW        IDIBT          
ILFTDJFAUO      : DIVFGRPBIPUFCQN AKNCTHLOU       EFANPDYIHEOCHH  RJBMMPCYJL      HUYECSCSES     
DUEMUO          : LCDLG           RSINCOKNHUMUV   UIOR            ABYTNSJTH      
OVWUI           : PLXJSBP         PXLOLDGXYXPLFIA
EDEILPRTDXOHH   : GYSJHIEONXFLJ   ONLL            MNPFAYWL       
HDKSIHWXCNWSJW  : VLOB            OCIRBDIFVUJUA   MAIJGQWWDH      IJICUQPPTRGC   
TMTAQFLJWFMUVTD : CMMRLROHVNANQ   TREEOGUUGIKI    TUOSGRXFMVTY    SKXS           
BIGVQOUQSJQ     : DHURFBHHIGPFN   XMWXATKUO       NORSHP          VAQOOSNIHPONP   KTCKJRIJIKVGHD 
UNERA           : XKNMQFTWYXPDBBT TCUAXX          BAITRIYMVARVNH 
RTIDDFKPBJKGD   : OUGVAF          QMQJQCEBMIGTWF  DJKANVV         GEEBUYFUDMXLI  
QKMJYHBTQ       : PTJVPGJDBJG     XNAGHFTPNTDI    GSJDRO          USCUSCF         XIELXH         
IOFPGHSXBBDEG   : DJVWPKUHKXVV    PGARUPYU        BTTJKDUBG      
UJWHRDUIPJSO    : HIEG            TAAHQCS         QASYNMB         POBAM          
TKINTWULFCED    : LLXSOXIUOVKPC   TQYUNXCGQKETNVW XMDWHR         
FGILWFXV        : QGKFIKFKE       WOCVXODMWYINRSI
PYKYOTTFNNSYDM  : QNCKRROU        YCPMYGMJUFRK    GEEBUYFUDMXLI  
XAEAEHGJQRW     : RQOAOJ          LIOTKLIPHOF    
WUJMLLYMCUGIJV  : LOVCENFXBWGMP   LEXLTJRFJKO    
IYPG            : IJQCRLKG        UIUTAOVP        CBWAMLLXMAB     ELMTDHVDI      
PMYVUGFL        : BPRM            WLSDXJGDIEI     TQYUNXCGQKETNVW DQUMCMPQY       OKWTPDQJT       PXBXCNQRJI      AOYQIPNSEN     
CBWAMLLXMAB     : DUUTIOGOSV      VLOB            KVKDYYFSCJSV    NYPTD           YGORDXESSEDKCPY MTYUU           IYPG           
GLTCO           : WPVST           QASYNMB         YKLR           
DGMCXABT        : WPHOHVLKXWWW    XWFGSQ          XNTNWHOWMNFMH   BFMDDGWHPA     
JYIJDLJDXUQY    : OJPWHYPOXKY     MYWPPQEMIDVBRRA IOCC           
QASYNMB         : QAWNXVTPGMVHQB  KINGLPUDKGJDIG  RTAHHKGNWRDWU   UUBVNUX         UJWHRDUIPJSO    GLTCO           YINOGFDIBELIV  
QGKFIKFKE       : GKYREXIXSP      DYXOCPDDWUXVY   QPMMRLYR        FGILWFXV        GYLO           
VFKGK           : LHVKGABBFLV     GJSYVLFEHKUPIDF DAANXGTUOXVF    XPETFWYN        ADMNQWOQR      
POWMHVWBXPCNEGR : NUOYARYPPHJK    ANTJMMITROTQ    MAIJGQWWDH      XBRATPXC       
MEDVO           : QDGWTRJVYVBUKP  VNFTPOYM        VQTGSMWFXFIVHB  OWHGDHTF       
GULEAXKKWCBVRL  : PCPPDS          FJGMECII        DJVWPKUHKXVV    OKWTPDQJT      
OORHQHL         : EHQPEANMPED     HHGLPBMV        LOXHMIAJR       BWVGYWUANDGB    UUBVNUX         XYGGVHEV        LFSMFSX        
YJKFMGVUOQIUS   : KKYOAISXVTW     XDFCGUPQADBHK  
IFGKJCEWVTLPB   : FRCTXOCAOFAYGN  XBSGJBHHOOB     XFSTTEYOAQDKQB  DSLKUEMNKHJ    
WOCVXODMWYINRSI : GMYWHIYGYKIHPVJ DFGAJDMPDFBJYFA JHRYJNP         YJXOWPLXWOISW   UKVCDYVJ        FGILWFXV       
CQRIEBM         : MYWPPQEMIDVBRRA PCLSOV          IYJCYYNCRRQQYM  GKIXX           SSIWXQAHMPBKJJ 
XIELXH          : YJXOWPLXWOISW   UUUNYN          QKMJYHBTQ       FPDWERXFU      
WYUUWJXKG       : CJVARH          WBNSMUJYESKJEVA LDWW            WHRIDYATHRNP    SXBHTAQK        LPRUA          
UVQPEDSXXBCBQMA : DLDOKXD         OCIRBDIFVUJUA   OFLBHOWCFTUD    GFBNKIDDSIM     DPLNYYDKT      
TNADGWCBUCKSM   : UVXTRDRQXEIV    VHXJEPFYR      
SJQL            : SJXPBOJEYST     JSVJNVTG        TAAHQCS         QQIE            JHOOG          
VRTV            : ECJSKBNNUYWJKIJ HIEG            XMDWHR          JKMYWKLKX       TPLLL          
VAQOOSNIHPONP   : SMFBMYJSBBL     BPSRMCBEMIB     RHLTCPTMN       BIGVQOUQSJQ    
RKSEF           : BTTJKDUBG      
AASQMSO         : MTWCUKYTXV      NJSGLOJKCHE     XMWXATKUO       UJFWCLMJY       NOBJNGEIIAVF    BPREDE          NVRLJJDP       
OKVMKMB         : HUOX            XSFQXQ         
GRKPHYFYSWL     : VJTJM           XKORRPDFGWTOTCT WWXSH           VSRGECQBI      
ERVETOU         : WNIBACXGFU     
JKMYWKLKX       : EULRBLVCGAH     RXWRKU          CKNMGVEYCJITAWA VRTV            THQKATGEXF      JOVWKHQPEUYPU   KPGQ            WNIBACXGFU     
MGFWXOYFQR      : GBGFTMUQBX      ANTJMMITROTQ    MGXPCTPGU       FFRHFPY         JIBHPD         
CFJVDNQUIYEUOFS : UGJCYWAHD       UVXTRDRQXEIV    QTNJQOXRQH     
TDYHPHOOF       : LDKGCOVR        DWAWSI          YVINT          
PLXJSBP         : MGJTKVW         HFCFM           UVRMQSYLBU      GWYSFKD         DXCM            OVWUI          
YUPRPXTWVICOJ   : DLSDXRAQJSU     WXUDBWTVKEBKC   AEFIBHVPSUTG    YJXOWPLXWOISW  
TJFLSVAYEQMC    : RSHYXP          WKUTKEICXO      VJTJM          
FFRHFPY         : JMXOGEM         YCBUEFCAFBDGFAU MGFWXOYFQR     
FYSC            : WLETAQ          MEDRXDVE        UUUNYN         
BHLNFFWN        : RFWBTNEKFEMDURX BNTVVFXYSKPUORA DPRMTKQUSSQS   
PJTQ            : TNJJWIOEVRKC    WESEMQGK       
MFSMMXH         : CLKBGBIMJEN    
FWUFE           : FQCJPLVOVYP     HSGBHDF         VNFTPOYM        WITQFJBECFW    
XJRCS           : XKNMQFTWYXPDBBT UTXKIN         
PXLOLDGXYXPLFIA : RSEAJWVFS       LJTHPIM         OVWUI           BWMHRLKSAUC     GWRE           
JHOOG           : GNAJ            NKWYAEL         BSPTPBGUEDA     SJQL           
VNHWWBYRFQPTFE  : IUXNTVEXLJB     BVYC            VUXUTSAGYIOCOTG NVADBTGEMQ      IJICUQPPTRGC    VGNTQHO        
LEXLTJRFJKO     : WUJMLLYMCUGIJV  BDWC            YSTK           
BFCNCPWB        : YANWKEQFIS      JSVJNVTG       
YAGG            : GNUMBBGGKBGPC   QGBD           
YAXFYJLW        : TVMY            NBUCHBNRFTEEYS  FHSXEBLSP       RLNQSP         
HGPMSCDOD       : UIUTAOVP        MVPVSBTBXKI    
QTNJQOXRQH      : RWOYBKCL        NQNJXR          CFJVDNQUIYEUOFS TCDCHG          WWXSH           RBYR           
JIBHPD          : JWFOXWYECAWE    WOOWGE          UVWNFQFK        MGFWXOYFQR     
BAQIJGXEKB      : DLDOKXD         RCQCDIPAGYXGED  KBTX           
OMJIA           : SEAWFAVKFEEHXE  DIRCJMHMKCIWIJ  PCPPDS         
BQVTHDU         : RMPBPT          JEAOPFXL        JEPXFIITEEPLND  RHVJYCJFA       MAKTUIYS        SKXS            AJWJAXK        
NVADBTGEMQ      : TARSKOHWSSSP    BLSBIIMSS       VNHWWBYRFQPTFE  KDSPLJQPHW     
VQTGSMWFXFIVHB  : XWDXVKKKDBL     KYSUREWGKHXM    MEDVO          
DLWXEKV         : LICKHNMDFNBACG  YMFRF           XFDGPG          HPUWER          RRHVO           AHLWHCMHMXQDWNG
PXBXCNQRJI      : DYUO            PMYVUGFL        JAVHAG          CMOL           
SBCPIAVSXFWPKIM : GCMWLYUSP       RXVUR          
MYGRQGU         : XNAGHFTPNTDI    DHSLXF         
IJICUQPPTRGC    : HPXDBSEVKLTY    SAID            HDKSIHWXCNWSJW  VNHWWBYRFQPTFE 
EXSLULVDXGR     : BTPVNTKKP       GFFQMTUOORHTP   FSNYEANNTH     
MKQTHIES        : UFWUOF          DPLNYYDKT      
JOHYEBTMFQQF    : TWLU            SJKURP          KJJL           
CAWXFVGXVT      : USCUSCF         PBPRJB          BTYBGROQ        THYRVSIIHNOQDXT
OPRWVLNFCWHIX   : OFWQY           GNAJ            PTJVPGJDBJG     TNJJWIOEVRKC    BQLY           
VGTOLFRODR      : WVGXHAHWRBSRIAE CWKPPYFNQ       AMOFOPRDRKRFLPN
BYVY            : IFCLEMAGXKGKTF  XPETFWYN        KPGQ           
GPKBNIODOSBVB   : YDRXYG          OGOSXMUGT       DUNCTMTL        GRUOXSSGNISRSJ 
YYJSQXAIOFCKG   : OWLSUDQYJXKBCH  IJQCRLKG        HVYYBYC         QUINUBXL        YRRPCD          TAYDXXKEH       NEFY           
HHXPXKS         : HBTXJKUBRHWYJI  QMQJQCEBMIGTWF 
THQKATGEXF      : KFIBKTIHEGQKQN  YMFRF           DIRCJMHMKCIWIJ  BOEDHAMIR       RECXJXGYMOE     FEOCTROPAIM     UFQUPLQ         JKMYWKLKX      
THQKATGEXF      : OFIQBEWDT      
JAVHAG          : FFKR            TFEFEIB         PXBXCNQRJI      BWMHRLKSAUC    
IJHOOQYPIYAEM   : AOYQIPNSEN      HJPRYEKFRPAM   
LFGOCOUAV       : OAYTJXOB        YJXOWPLXWOISW   OPDLIERCEEU     BDWC           
JXYTBFPJQYAIRY  : WPVST           PBTPMVLHISW     YTLRYVNLOLPKARB JIQWOKWQE       TVUEBLXPH      
BAAFM           : PFMVHAJY        NIKBPIVACCUJLAF DODGVTTVBJC     WLSDXJGDIEI     XSVG            UKVCDYVJ       
SUHJWWGY        : IWJVGMQPGAY     WMQIS           EVTVIQ          QFDBRERVBHEI   
JKTIEUPWGJVGRO  : VKDGNLJYEKJPY   ITJRGTFEKM     
RRIRYXQT        : CTRQCW          BOEDHAMIR       DAFBJ           FEOCTROPAIM     AWDHGXIFSS     
YGRXMQSVDOGK    : SYNIYTHP        EKORHGMEC       HJPEWNBIMRRLJRL MOHHSEYEVQGRMA  BBTDUCQMNMNQMRN KWTYJQFVCNVP   
WHRIDYATHRNP    : COGSFHFG        IUDGBS          BTPVNTKKP       XFJRVLHHBAPNTU  XYXDLN          WYUUWJXKG      
OPDLIERCEEU     : XUTSYYDT        HUNWIEESMEN     XMJY            LFGOCOUAV      
DYOJJAIQSQ      : RNOBMSMHMRIFGJX AHLWHCMHMXQDWNG PSPBC           LFSMFSX         RTDULCKRJJOWP  
RSSBKG          : HGXLKVN         TJQYUJCSEDJN    MVPVSBTBXKI     CEREOBDW        EINQELMJP      
YXJEJT          : OKYC            WLETAQ          MNPFAYWL        OWHGDHTF       
BWMHRLKSAUC     : DWDB            PXLOLDGXYXPLFIA JAVHAG         
DUVUTN          : YEFJUMILLLWLJA  KJJL            HPOFOYLXIPQUF  
MQBUJ           : TOAR            YDRXYG          LGKCOUOHBXBXFKR WTNEORLWSFTLTXG
SSGCPODMDNGQ    : NUHOKL          WPHOHVLKXWWW    EVTVIQ          DWAWSI          MVPVSBTBXKI    
ATSEWYCSVVILK   : QDGWTRJVYVBUKP  EXUFROGDCJQGWOA OWDPW           FHWGILH        
OFIQBEWDT       : XUTSYYDT        CXGKDAIGGBUMH   IMSIPLOYPV      AXULDY          JSHP            THQKATGEXF     
JIQWOKWQE       : OCIRBDIFVUJUA   DPSQRATXNIC     JXYTBFPJQYAIRY  DISEREWLCURD   
XBRATPXC        : LEBM            IYLSJCGF        POWMHVWBXPCNEGR BJHVTUEFVCXN   
KDSPLJQPHW      : SQTFLFKFTDDV    GNUMBBGGKBGPC   OBXTDAH         NVADBTGEMQ      SAWIH          
WITQFJBECFW     : SAID            FWUFE           AKFEOXJMWIF     WESEMQGK        HNPAORVTOXMD   
IOCC            : TYGIUVTF        XLQR            XPYGPWS         JYIJDLJDXUQY   
AGIKJBD         : IATQMKNINWHGK   KQJKUILLEOEOK   POBAM          
MVPVSBTBXKI     : IWJVGMQPGAY     THEAPRKMDSOGTVR TFQJKCGM        GFJPOMG         YJXOWPLXWOISW   HGPMSCDOD       RSSBKG          SSGCPODMDNGQ   
NNLSMMDCOHIRNSC : NKOD            DCKAVVA         FVFXNWMRRVVVIN  GPQEYV          RQLPWLU        
VHXJEPFYR       : TNADGWCBUCKSM   GWRE           
DPLNYYDKT       : GNMCAUJGD       CWKPPYFNQ       TOLF            APBWUKESVLMO    LLNA            RVWDSSCV        UVQPEDSXXBCBQMA MKQTHIES       
YYSOGDIVYMUWU   : TVMY            BLXLPVUQK       FAKNQR          MGXPCTPGU       JWVQQ          
GYLO            : PNXPOK          SYNIYTHP        QHIJHN          CXGKDAIGGBUMH   BOEDHAMIR       QGKFIKFKE       DMHKDNHV       
FPDWERXFU       : YPCKXRNQHWXQJP  ANPBNOJCA       XIELXH         
CLKBGBIMJEN     : RRGUTGX         UVXTRDRQXEIV    MFSMMXH        
CKTATSLIUTA     : MJGIWYLCSOYXSOF RUEBKT          TYGIUVTF        BBWX            UVRMQSYLBU      YKLR           
QGSPONB         : UTXKIN          IMXBRLRD        TVAXDVFHJSVO   
CNTIRC          : JMXOGEM         BKUFLONQG       YLVAUBAW        RTCBO          
DJKANVV         : RSHYXP          LJTHPIM         FQKPWHNBYRTEFON RTIDDFKPBJKGD  
POBAM           : HYQWASH         UJWHRDUIPJSO    AGIKJBD        
ALOJEGX         : ANTJMMITROTQ    ICMKH          
JOVWKHQPEUYPU   : YSUYEN          NUOYARYPPHJK    NKNRRBNT        JKMYWKLKX       GEEBUYFUDMXLI   HDQGILL        
NRED            : LEBM           
FFWDH           : JGERBBTBQLEEBN  CWBVFBAGHCLTHC 
RQOAOJ          : HUOX            XAEAEHGJQRW     NVRLJJDP       
FHGQOXGVUHL     : FQCJPLVOVYP     QHIJHN          DKLVCTVVONVMQCR
VBLAEUHLTM      : VEOYFYGWHE      DYXOCPDDWUXVY   DKLVCTVVONVMQCR
DGKTG           : GNMCAUJGD       JBFV            GEEBUYFUDMXLI  
DPHNYACYG       : EINQELMJP      
TPLLL           : NMHRSRPYPSG     TREEOGUUGIKI    IFEJ            TGOVOXAOLU      ONKYVTLFGEDQR   VRTV            TVAXDVFHJSVO   
XNSUWEOKATQK    : DXGEKPBNGDJNVQ  ANTJMMITROTQ    ABYTNSJTH      
XNTNWHOWMNFMH   : WMQIS           JSHP            WYFKL           YIOJXNSLORE     DGMCXABT       
YVINT           : GJSYVLFEHKUPIDF PCOI            BKUFLONQG       TDYHPHOOF       TCDCHG         
HOVNFINA        : HUWKRCHF        HOSCECCLC      
AOYQIPNSEN      : GCMWLYUSP       ENECSPLA        PMYVUGFL        IJHOOQYPIYAEM  
USRC            : JGMREOWXYTNLJQ  FVFXNWMRRVVVIN  QFDBRERVBHEI    HXLAFCKWM      
SXBHTAQK        : LQBC            DWDB            EMYHTKVEAFF     UBPDTOLWNOBEASQ YADPRMQJF       WYUUWJXKG       IYCEJNGREU     
GQGWQH          : QOJYIIRD        FHSXEBLSP       WPBYXSIAIBP     AEFIBHVPSUTG    ONKYVTLFGEDQR   WTMMABAMYI      WWXSH           DNGYOUSN       
HJPRYEKFRPAM    : FNSM            QYFFOLFAQQO     IJHOOQYPIYAEM  
FDDFFKA         : LICKHNMDFNBACG  DXGEKPBNGDJNVQ  XMJY            RENFMRD         TQCNINSIMSD    
DMHKDNHV        : VATYR           MGXPCTPGU       GYLO            BDWC           
GFIWXHBKPU      : MOXRSMSEFT      JMXOGEM         HSYJHBMUPV     
RHNW            : NEWX            SQRER          
QFUEHCJT        : PUJEKOGJNTO    
TAYDXXKEH       : CKTIICFH        MDVFVPQTIX      SXHX            MNXNNBQDUFVG    YYJSQXAIOFCKG   RBPFBQWM       
EQKOIHRBQFXEYFY : NLPEPFNCJMNBQRX BQEYQG          NORSHP         
MDOHO           : HVYYBYC         DHSLXF          HXPMBHDAVJYF    TKXQWRNU       
HPOFOYLXIPQUF   : FEOCTROPAIM     YWILWREUK       DUVUTN         
CWBVFBAGHCLTHC  : CXGKDAIGGBUMH   JYFL            VWXIGJLG        RCGXVKARNSESX   FFWDH          
WPMMFUBGG       : OFWQY           CGMXM           CXGKDAIGGBUMH   ANPBNOJCA       PQWTPWNIIDF    
RWSMCSRBVNIWPO  : CKNMGVEYCJITAWA HNPAORVTOXMD   
TCDCHG          : GCMWLYUSP       JBFV            QTNJQOXRQH      YVINT          
WTNEORLWSFTLTXG : SIUGMUOSI       CLGCHYADJGWJC   SOBODVHENWPJWDE HBNPLBFHTE      YBXVPSC         MQBUJ          
CCBKATAI        : AJFKOPHJWJQ     KSGP            BWEWBOUBS      
ELRLU           : XWREWN          XKQSRMQLHM      NBUCHBNRFTEEYS  BNTVVFXYSKPUORA LLNA            UUUNYN         
LQHPFYDERIY     : YANWKEQFIS      RTAHHKGNWRDWU   CJLW            JLKLIAJN        TFEFEIB        
DYMQBPUMROOA    : VATYR           MGKRYXCWDOMP    AJWJAXK         KXCAVDARXMR    
SMWHJ           : JNFXOCSMC       KJJL            AWCWYG         
SAWIH           : MCINXSGVISGW    AKNWUJWGVW      KDSPLJQPHW     
MLQWKWA         : MJGIWYLCSOYXSOF RJBMMPCYJL      JGERBBTBQLEEBN 
LRNBOCSDQVJM    : THNMVARHBCBM    IDCJD           TCMBIVFRXFT     RVYANBCH       
GTTYMTX         : NOEEUY          TYGIUVTF        IBVQBOHRASXIPOR QQIE            IBVQMDAAM      
BWLMNJAMJMXDCCR : IUDGBS          IIWLRNJVUD      BNTVVFXYSKPUORA IBVQBOHRASXIPOR FGTWFJREEX     
WWXSH           : GRKPHYFYSWL     QTNJQOXRQH      GQGWQH         
DNGYOUSN        : CJLW            HJNOXBVBVSXC    GQGWQH         
VKELXNNM        : PWXBP           NIKBPIVACCUJLAF YGORDXESSEDKCPY XLQR            XPYGPWS        
AKFEOXJMWIF     : OAYTJXOB        VDIKM           PSATBXNUTQ      QMTEBOFRSC      ITVEAOVOSG      SJXPBOJEYST     WITQFJBECFW    
ULUCKJ          : BIDLAENOS       JVHRPOV         HSGBHDF         DHURMVNVJD     
GWRE            : MXAE            MDVFVPQTIX      ABYTNSJTH       JMLWRXWOUOCKHRB PXLOLDGXYXPLFIA VHXJEPFYR      
WPHMDVMF        : LGKCOUOHBXBXFKR JCXCDPCUOKL    
SKXS            : WUCRGKTEOIMS    XSFQXQ          IUDGBS          QAKLSSASOOSIF   TMTAQFLJWFMUVTD BQVTHDU        
KPGQ            : UBMFNVHMOUSJR   PCLSOV          KANDOLJLWTWBSRK FQKPWHNBYRTEFON JKMYWKLKX       BYVY           
CEREOBDW        : RSSBKG         
VCKUTUHA        : DAOQSJ          YEKSRDAPMBSYG  
UHAPRYIQ        : WHULKIOLVKVL    RFWBTNEKFEMDURX JTTRXIVG        NURCMWVTDWMIQJC
AWCWYG          : TYSPHXMBXGYOFL  FGTWFJREEX      SMWHJ          
FXSJUVHYGC      : THNMVARHBCBM    QDGWTRJVYVBUKP  PXGIONXXHCOMAUV VNFTPOYM        BPREDE         
DJTUGBUVVVGOIJ  : KXVD            TGIJCIGW       
KGLRXSR         : XKOJ            ECJSKBNNUYWJKIJ MGXPCTPGU      
CMOL            : WHWFFQT         YBTX            STUHNFTGKMVE    PXBXCNQRJI     
WNIBACXGFU      : IJUBNETYAIUB    HIXDEAYDRB      ERVETOU         JKMYWKLKX      
DRNRAYGMIR      : GSJDRO          RJBMMPCYJL     
IMXBRLRD        : EMQKHDOU        PMINXCEJYXQCN   BIPMNQ          QGSPONB        
QTITTM          : PWXBP           YJGTMRXJ        RSEAJWVFS       YDRXYG         
CTNJXFXRHWXT    : VLXTIPVARMJB    BTPVNTKKP       PBMSISUSYKK    
RBPFBQWM        : FIUQIHSKRGSSBS  TNJJWIOEVRKC    PMCUJDBMPQJ     SSIWXQAHMPBKJJ  ADMNQWOQR       TAYDXXKEH      
CMCVUV          : TCYMM           RPNGWVXJ        GNUMBBGGKBGPC   YMGMDIESI      
HOSCECCLC       : QYTLASNPL       INFTEQK         HOVNFINA        LXGC           
SCWOJORAVTSUI   : LGUA            AWIDJCU         HXLAFCKWM      
XVITSGMDWHHBL   : DFBVRWHKOSYKQV  RBJPITXCBFUOUX  NLVEM          
MOHHSEYEVQGRMA  : LNOYAOEXQ       NLPEPFNCJMNBQRX XMWXATKUO       EVTVIQ          YGRXMQSVDOGK   
VGNTQHO         : WMQIS           GMYWHIYGYKIHPVJ LFFTVBDQMEGUOP  VNHWWBYRFQPTFE  PQWTPWNIIDF    
VTWD            : EMQKHDOU        DXGEKPBNGDJNVQ  OTRWFCFK       
XPOLGYU         : PRBWFF          BOYFJSXPVXCTEB  BFMDDGWHPA     
FTFBLMVAOLVWYRP : PFMVHAJY        TCMBIVFRXFT     XYGGVHEV       
HOFBLIFKAVXIUU  : HJPEWNBIMRRLJRL
BPREDE          : RUDSJHMI        YCJNORXEKI      JTTRXIVG        JWVQQ           OGOSXMUGT       AASQMSO         FXSJUVHYGC     
DUNCTMTL        : GPKBNIODOSBVB  
DADFMNMYOIYWETJ : CQVOSGL         UVXTRDRQXEIV    UFWUOF         
JBLOHOSECW      : QIVHMACNDRJATEK LNOYAOEXQ       GSJDRO          FEOCTROPAIM     MYUAJD         
RQLPWLU         : HPXDBSEVKLTY    UBPDTOLWNOBEASQ XYXDLN          NNLSMMDCOHIRNSC MGPV           
AIQBYYAYFUI     : PRXAWFH         ABYTNSJTH       WHKTVV         
GJBX            : OUGVAF          NASSDJGCSSLQKD  IFCLEMAGXKGKTF 
PQWTPWNIIDF     : IKULGHGUQYHLD   WLLJMTHBRWXO    EHBOYTPUYYGI    WPMMFUBGG       VGNTQHO        
AJWJAXK         : RUDSJHMI        YPMLT           AXCMIBGATKFUY   MPXXIOYYRMX     BQVTHDU         DYMQBPUMROOA   
BJHVTUEFVCXN    : AVIUPY          XBRATPXC       
WHKTVV          : HUNWIEESMEN     OAYTJXOB        LXFLHUIVYLJXY   YTLRYVNLOLPKARB AIQBYYAYFUI    
BBBELXNNXAPYK   : JGMREOWXYTNLJQ  BSXMHUAOCTHSH   QMQJQCEBMIGTWF  ORKDED         
WESEMQGK        : LEBM            TYWAPSULCGQRX   TJXLTPJWR       DGSWSS          SJKURP          PJTQ            WITQFJBECFW    
EINQELMJP       : KGGGDUEUYARGV   YCMGPQDGH       HFCFM           HTSNEMJTEND     SKENMS          UJFWCLMJY       VWXIGJLG        RSSBKG         
EINQELMJP       : DPHNYACYG      
KTCKJRIJIKVGHD  : DPSQRATXNIC     BAITRIYMVARVNH  BIGVQOUQSJQ    
LPRUA           : QUINUBXL        HBNPLBFHTE      VNFTPOYM        NBUFP           WYUUWJXKG       TKXQWRNU       
YKLR            : TFQJKCGM        BRGQFYEHXMUUHBS GLTCO           CKTATSLIUTA    
AFBPVLJ         : TVKXHBV         UBPDTOLWNOBEASQ TNPSBHQ         GETUQMVEJRND   
VSRGECQBI       : OQUUXGRKQEXE    GKIXX           RHVJYCJFA       SSIWXQAHMPBKJJ  JSHP            GRKPHYFYSWL    
ELMTDHVDI       : QAWNXVTPGMVHQB  HMCHJI          IYPG           
RBYR            : XNGDPIYBQBOAQD  OTRWFCFK        UFWUOF          QTNJQOXRQH     
CHGNSGLN        : DHURFBHHIGPFN   DGSWSS          TCUAXX         
TRDL            : STUHNFTGKMVE    QQIE           
NMYABSFLRL      : PNXFYQMOA       YYOFTMPTWSRV    BJROAFRSVUJHH  
BDWC            : CSMWHCAAYF      MTYUU           LEXLTJRFJKO     LFGOCOUAV       DMHKDNHV       
HEENTYVFMWBGCMC : VNCREFIUCTHB    GKYREXIXSP      WXUDBWTVKEBKC  
BBTDUCQMNMNQMRN : NIKBPIVACCUJLAF CXGKDAIGGBUMH   MAIJGQWWDH      BRGQFYEHXMUUHBS YGRXMQSVDOGK   
VTIPSEWHDX      : VSGYFRUJLTFC    RIYLAABVWSEHSKS XKORRPDFGWTOTCT
HNPAORVTOXMD    : PRXAWFH         JMNMGGBQW       ABYTNSJTH       WITQFJBECFW     RWSMCSRBVNIWPO 
AQEOKRKGLS      : VWDDSUNBMUK     KJJL           
GAUNFUENIVP     : QFIDLQSFQM     
NLVEM           : QDGWTRJVYVBUKP  WGYFSRJIOHHLVVW OBXTDAH         XVITSGMDWHHBL  
HXLAFCKWM       : FNSM            JEAOPFXL        HCOKGAGGR       USRC            SCWOJORAVTSUI  
LIOTKLIPHOF     : SIUGMUOSI       SOBODVHENWPJWDE GPQEYV          DTETGLVWXCXFKR  XAEAEHGJQRW    
KWTYJQFVCNVP    : RIFQQORCHMVW    ONLL            MEDRXDVE        YBIPJ           YGRXMQSVDOGK    XDBYK          
BTYBGROQ        : QIVHMACNDRJATEK YGORDXESSEDKCPY SXHX            WVDKSBOBFWCRP   CAWXFVGXVT     
IBUS            : IWQMJJEBGYESCU  SJQO            XOFBAXJW        SAHLFYTKSKBMO   QVIMSSXALQQBQBK XMDWHR          NKMFGEIIAP     
EHBW            : MYWPPQEMIDVBRRA SHKKJFQCWWDU    OGOSXMUGT      
YSTK            : LEXLTJRFJKO    
YINOGFDIBELIV   : WUCRGKTEOIMS    XNAGHFTPNTDI    QASYNMB        
BFMDDGWHPA      : KLORMH          DGMCXABT        XPOLGYU        
IYCEJNGREU      : YGORDXESSEDKCPY FEOCTROPAIM     SXBHTAQK       
LAJNE           : YYOFTMPTWSRV   
XDBYK           : LNFFWCG         VLXTIPVARMJB    MPKC            KWTYJQFVCNVP   
CPTBAKCIUDKAN   : QUWVEDTPHEXDWAL HYQWASH        
IHDFIOGTCMSA    : VATYR           UVXTRDRQXEIV   
TAFIEUCIUMKEK   : BWVGYWUANDGB    BOYFJSXPVXCTEB  AIFEHEHCWBUKH   EVTVIQ         
OMDNUNSAXII     : RWOYBKCL        MXAE           
MXLP            : CNQU            MCINXSGVISGW    CCXCYJM         LVQFJXHNV       BOEDHAMIR       ORJPCHW        
GRUOXSSGNISRSJ  : RTEYOJVUMWRDVT  CKTIICFH        UVRMQSYLBU      GPKBNIODOSBVB  
FOYCESCD        : AHNIHMOWHH      RTAHHKGNWRDWU   IMSIPLOYPV     
NVRLJJDP        : GCMWLYUSP       WTAWEAA         UHOWOPAPWE      AASQMSO         RQOAOJ         
BGCTAIH         : AEFIBHVPSUTG    AVMXTQXBBPYV   
CCDN            : QNCKRROU        JTWCGNRQN       IGUKVWLW        HJRTCK         
ICMKH           : GCUBHY          XLBSFHW         FGAAOUNK        ALOJEGX        
OKKC            : WMVTRIADLIJCROQ MEDRXDVE        UHAQAIRH        RENFMRD         RVYANBCH       
DPRMTKQUSSQS    : OKYC            KXJBROCVJUAPH   TCUAXX          QAKLSSASOOSIF   BHLNFFWN       
XDFCGUPQADBHK   : DWDB            AIORK           GWYSFKD         YJKFMGVUOQIUS  
TVUEBLXPH       : UBMFNVHMOUSJR   HMCHJI          LLXSOXIUOVKPC   JXYTBFPJQYAIRY 
GEEBUYFUDMXLI   : FMFOJDBC        RTIDDFKPBJKGD   PYKYOTTFNNSYDM  JOVWKHQPEUYPU   DGKTG          
DISEREWLCURD    : BVPN            HIXDEAYDRB      CLDW            PGIXEKCQYQWU    BVYC            JIQWOKWQE      
PSPBC           : SFCE            HXPMBHDAVJYF    GIKG            DYOJJAIQSQ     
HDQGILL         : YWSWWAOX        IKULGHGUQYHLD   TYGIUVTF        XWDXVKKKDBL     JOVWKHQPEUYPU  
LXGC            : HVQIBVPBYTWD    AWIMBJHAKHY     HOSCECCLC      
OWHGDHTF        : WTAWEAA         BYUITBLVXHFKCA  MEDVO           YXJEJT         
NKMFGEIIAP      : IBUS           
QWYEKWSIDWL     : UBMFNVHMOUSJR   LGUA            YUEIWJRJW      
TVAXDVFHJSVO    : TARSKOHWSSSP    KRSFILHHK       QGSPONB         TPLLL          
AXJAPYSOXYA     : HQFTULKTAB      SPLOTVWYVFK     IIWLRNJVUD      TWLU            BXAFMVTUKLFP    JTWCGNRQN       LLNA           
TKXQWRNU        : RERYQPBSRFFEY   NIKBPIVACCUJLAF IYJCYYNCRRQQYM  MDOHO           LPRUA          
LARSJ           : WEWHFCQABBKF    HYJEATDETK     
LFSMFSX         : KHCYQL          PCOI            FTXIXSELV       GJCS            RVWDSSCV        OORHQHL         DYOJJAIQSQ     
KXCAVDARXMR     : LHVKGABBFLV     GSJDRO          WLLJMTHBRWXO    DYMQBPUMROOA   
LMCGIPGBLPEW    : TOAR            PCLSOV          WWQIQCYOUUC     BOIIVDXIRYY    
YMETKLFIPH      : XLAVOIHDR       NNGOLLXGKJPRKSJ
THYRVSIIHNOQDXT : RFWBTNEKFEMDURX HMJEVEUOS       CAWXFVGXVT      PWBG           
NAONCDR         : HSYJHBMUPV      KFUYX           LBOKXTMUPIILTUI
NEFY            : HSMYDOSJYNIJFT  NUHOKL          ITJRGTFEKM      ALDULXHQX       YYJSQXAIOFCKG  
MGPV            : GKYREXIXSP      TTTAWCALMRBL    PBTPMVLHISW     TGOVOXAOLU      QGBD            YUEIWJRJW       RQLPWLU        
HSAQBKERB       : CTRQCW          NASSDJGCSSLQKD  XFSTTEYOAQDKQB  UUBVNUX         BDXFCQN        
PWBG            : EVQDNI          BQLY            VUBHHWQYFFFAWPX THYRVSIIHNOQDXT
RTDULCKRJJOWP   : LLXSOXIUOVKPC   XKORRPDFGWTOTCT DYOJJAIQSQ     
