KMPIKLSCDKXFS   : IQDIG           DCJJWGACRJWEUXN CYVPQEXJHWREP   DDFITFX        
QARXTBUPWOLUDH  : QCEKCMDGWJFY    QIJPBNLOCU      HVHFEOFPMBGWPS  FFQQXRQ        
FAMTQVG         : VSMWVQWNW       BCSKRAENKGWWTV  MUOENRXF        CHSQ            YSKUAYPXYMGMEMH UCRFRYQOEEVD    FFQQXRQ         YUTTQYKKKFEWKFU
QJKCJR          : IVBA            WCDTDWNCSKJL    ACIGQOU        
BJXTHTWEMTSXQ   : VIFKBHJWXCDXNKV EDPUU          
IQDIG           : KMPIKLSCDKXFS   OTVCDWS         PIJYHDWQS      
YEGGUPQ         : SDVDKJXR        APXHVQ          NCWMHUOLSU     
BIWERWACSWI     : IBJNLKHOB       QARXFAVLWE      TDNFPGNHEVWK    PMVQO          
QCEKCMDGWJFY    : QARXTBUPWOLUDH  GPXMJXBOQQ      YDVU            QPTRO           AQSRMS          TFHIRQVIRBGDGIS HVHFEOFPMBGWPS  PGHJITTS       
NFNDV           : MPTWYQHTATTTS   IKXBD           ENYUYVLWCODKDA  CADOFIRUNSLF    FNTTPCJIB       TDNFPGNHEVWK    AOVDRDKFQEPI    QITSIPORYW     
NFNDV           : RBLGOQYJXIWKTS 
GELLYILB        : YEOODKNAVMCKSMP QVJKBHRUXJIAR   FDFNAPJSNVDKVI 
LJJENN          : HVSWIGVF        RWFW           
QCSYAEGYUUG     : PJCGKL          OQNVVACODFGI    YRPGFRJUADQVAJ 
ACWHIJUJT       : XKLVLOYEYIPB    QYDOB           OTVCDWS         NCYRPVDXICC    
KXTWIYMVNFBG    : YEOODKNAVMCKSMP TGALR           QFXHRNRM       
BLNCIKIQ        : SLSJJGIO        DRPBSITPB       WYIFN           HVWUNWVDY       AOVDRDKFQEPI    SXGWYJUKMOPXCL 
MPTWYQHTATTTS   : NFNDV           FRUMNUJIRCMKI   GJDPYFENVIKOSIL YDVU            MKTWQERSGUPQFXQ NCWMHUOLSU     
SGBHN           : CLJPUCDQ        NMUTSLCVNYCMMUM
NUFBKJJUTCHIS   : MQPG            GNXMVAL         TGALR           DWIETIRAGNII    IUEQCBPMCTTHSCV
FRUMNUJIRCMKI   : MPTWYQHTATTTS   CFBOJONNMXJGM   ONAGSPRATPS     IAEDCOKT        PMVQO           YUTTQYKKKFEWKFU
RYTIT           : SDVDKJXR        BYRTGOMYVK      KTYLITJUPUGYSSH IYWHUCMLHJR    
JEKTBGVKOQOWJML : FXQYPTUYOK      WHVVGOPGYGGAU   OMLEYCUSPU      QYDOB           TFHIRQVIRBGDGIS SJOEYDVAC       ERXALSCMNO     
JUJBXYMIOGHJ    : VSMWVQWNW       GLQBGFOUBKYF    TDNFPGNHEVWK   
BKYHXUKGSVXK    : DCJJWGACRJWEUXN EPXUUKPIHA      MUCKFRUOTRUXJPU
UVBGWLCHO       : WNVMVMQYXC      YRPGFRJUADQVAJ 
GDIWKQGBTTAE    : DJHMMDM         WHVVGOPGYGGAU   HPWBY           VPDKLGRHDSHMSU 
WOCSMADAUBD     : QCNDTITRAVBMPI  VBIV            FHSGHAMJJGMJBX  DLWK            OEGMERVRCBFH    BHSAIDQUIXE     GPWRS          
XOGFGINJSLTLT   : ALGTDFCGXEW     IBJNLKHOB      
GPXMJXBOQQ      : QCEKCMDGWJFY    THSFAECMY       ONBJQO          AOVDRDKFQEPI    BVCOER          FDFNAPJSNVDKVI 
VSMWVQWNW       : FAMTQVG         JUJBXYMIOGHJ    JEPJPIVGXEEHRX  DDFITFX        
THSFAECMY       : GPXMJXBOQQ      DWIETIRAGNII    OFJRNWK         CUEICDODV      
UQXHBXKPQBGM    : TGALR          
SLSJJGIO        : BLNCIKIQ        WYIFN           JTOTDEUU        FFQQXRQ        
RHHSOJ          : MUMG            BRDNUFJBGYWMQY  FHSGHAMJJGMJBX  XQIYA          
PJCGKL          : QCSYAEGYUUG     HNAKUHYHHYQKAWA SWVUFSF         BNPLWFQVHDHSFEC TKAJOBCGXHGI   
IVBA            : QJKCJR          BVQS            EYMVFRYIJRLILR  VAYSVTTK        JEPJPIVGXEEHRX 
IOVDDONMWX      : HRHJXVQREDDDO   CADOFIRUNSLF   
BQKJLYUSOF      : PCOWLXMHQNUQ    BAIOGRI         LRFI            ANYSLELBX      
VRKHCGJEIRTHU   : BIACSL          JIVADCVQARVRID  DFGIREQGV      
XKLVLOYEYIPB    : ACWHIJUJT       FXQYPTUYOK      GSHJHIRENDRQGYV EKNHBOSDRNPTGD 
KPNJNFTVH       : LRFI            KTYLITJUPUGYSSH NMUTSLCVNYCMMUM
HMLYISVHQJS     : EQYARPLRRWI     GNXMVAL         TGALR           NJIHPBRSC       WUQMUUANICLW   
UHOYIYOJ        : MACXHR          OQNVVACODFGI    TLKNMRB         MYMIIVLA        WCPTA           QVIXBRQFKBG    
BCSKRAENKGWWTV  : FAMTQVG         QAOFEVVM        HRHJXVQREDDDO   AQSRNAAGVKFYAY  WHXGFFAOWWX     EKNHBOSDRNPTGD  BNPLWFQVHDHSFEC
MUMG            : RHHSOJ          CCCWHKFADDKUF  
HUYO            : DFGIREQGV      
AYLOJQR         : DQCMKMMG        SDVDKJXR        PMVQO          
MCFOI           : WJBREKM         JGRUWSWFQHLYVW  AEWCVKX         SKVSECDAKEJEGTJ
YOSVJPDXM       : CADOFIRUNSLF    IYWHUCMLHJR    
EQYARPLRRWI     : HMLYISVHQJS     LBUXJW          QGMMRWEKH       GNULYO          BOCITQNLFQRE    UYLJFFQKIWYKO  
QAOFEVVM        : BCSKRAENKGWWTV  AMBLK           SAJKJHBJ        TDNFPGNHEVWK    JTOTDEUU       
VBLTMDALPTRIV   : DBTIKTRVNSLSUK  EGVAKILKDJL     MCFGNCPRW       JGLKFNFKSFBK    XNBBWBOJRKLYEG  RUAXHL          QVIXBRQFKBG     RBLGOQYJXIWKTS 
ALGTDFCGXEW     : XOGFGINJSLTLT   LRFI            BNPLWFQVHDHSFEC
ITCUNAXYTNE     : YLAA            VPDKLGRHDSHMSU 
BVQS            : IVBA            QIJPBNLOCU     
MNGATAGBCOCGMH  : CGWIN           GMAKHQMHX      
ILLVLMXIACEBYW  : DJHMMDM         BYRFE           DBTIKTRVNSLSUK  YRPGFRJUADQVAJ 
DJHMMDM         : GDIWKQGBTTAE    ILLVLMXIACEBYW  EBPKNYWADLSKDC  KQOCSRKB       
HRHJXVQREDDDO   : IOVDDONMWX      BCSKRAENKGWWTV  XLLBKYEXIV      GFXLXVN        
BYRFE           : ILLVLMXIACEBYW  XIGTEGVU        PDNWJLRUQVPYILR PTBDD           BHFNLAXHBBENRTV
EBPKNYWADLSKDC  : DJHMMDM         HHVEA           WINPDSUNAEDAIV  WJUJLJWLGAVBYY  VVUR           
EYMVFRYIJRLILR  : IVBA            YEOODKNAVMCKSMP DLPX            SUUQH           QOIHCKX         SCGF           
HVSWIGVF        : LJJENN          KCWKMTSOCGNQYV  VNWCHIV         CYVPQEXJHWREP   LSMNOIXJLT     
BRDNUFJBGYWMQY  : RHHSOJ          TLKNMRB         BIACSL          HVHFEOFPMBGWPS 
ASJLEBALYS      : OSKXBOGJJNVSYN  MYMIIVLA        MRBWO           VPDKLGRHDSHMSU  GFXLXVN        
IBJNLKHOB       : BIWERWACSWI     XOGFGINJSLTLT   ENYUYVLWCODKDA 
WKGD            : CYVPQEXJHWREP   TFHIRQVIRBGDGIS
ERDDPDXBOCC     : MUCKFRUOTRUXJPU SXGWYJUKMOPXCL 
QBMBJ           : WHVVGOPGYGGAU   JTOTDEUU        LWEPT           XHOHBRPXQDJV   
MACXHR          : UHOYIYOJ        YLAA            NFBGQJYUOOWJP   MUOENRXF        ISUHW           PGHJITTS       
OQNVVACODFGI    : QCSYAEGYUUG     UHOYIYOJ        TLKNMRB         QNCNUATCIUSFTQD DKJSGRV         GQAVOXMMGM     
HAHL            : DKJSGRV         FFQQXRQ        
XMECYUOYXOIR    : QVBUAMG         GHJUWKGQPPUXUT 
XIGTEGVU        : BYRFE           QCNDTITRAVBMPI  FIHUMJYGBPXC    SNFQ           
DBTIKTRVNSLSUK  : VBLTMDALPTRIV   ILLVLMXIACEBYW  AMBLK           GVVGEREMIVTI    DGERKM          LRFI            TDNFPGNHEVWK   
LJPDTHU         : OFJRNWK         JSTLFAVLGPV    
PDNWJLRUQVPYILR : BYRFE           HUOLMT          AQSRMS         
AKQUHDMUOD      : AFUHEER         GCALTCCXKDTUVK  FRSTOUKKY       SGXVSJDDESOBAGU
IKXBD           : NFNDV           QURBBSCAGLHCX   JEPJPIVGXEEHRX  DPOSUJ          ILWBG           YUTTQYKKKFEWKFU
QCNDTITRAVBMPI  : WOCSMADAUBD     XIGTEGVU        XEISSYSDQ       OAEBPVBTIKJ    
CBLLEXGUBJDOHG  : DQNJFMMKJ       VPHJEB          XLLBKYEXIV      DDFITFX        
IXVVDPHYK       : DQCMKMMG        DRPBSITPB       VGHAWMKQKXJVGA  VLBUJ          
WNVMVMQYXC      : UVBGWLCHO       PYUQJ           VAYSVTTK        RYOJUJRB       
YLAA            : ITCUNAXYTNE     MACXHR          DQNJFMMKJ       ODGJRWCLNMQ     ROXFKO          YWTVI           PGHJITTS       
DQCMKMMG        : AYLOJQR         IXVVDPHYK       QFUWUXVKRWQUC   DHFYGMKYPQEENI  YUTTQYKKKFEWKFU
PYUQJ           : WNVMVMQYXC      XHOHBRPXQDJV   
OWDDU           : CFBOJONNMXJGM   DGERKM          WHXGFFAOWWX     ONBJQO          ONYIRDJCIF      AKANNXWAKS      SJOEYDVAC       NMLTLNPXNUG    
UVQWBPIB        : SWVUFSF         LQXY            DIEJOACSG       LWTFPOHH       
FGJHUVWHDIW     : QURBBSCAGLHCX   PSXTJ          
DQNJFMMKJ       : CBLLEXGUBJDOHG  YLAA            AQSRNAAGVKFYAY  BAIOGRI         FWNUMBCVGW     
FFVFG           : LNUTTPYIXWE     QARXFAVLWE      SUUQH           KJEI            KTYLITJUPUGYSSH
PJFVRQDNPCUSKUW : XLLBKYEXIV      QNCACRPQRBXE    JIVADCVQARVRID 
LMASYODITJPPQX  : PCOWLXMHQNUQ    BIACSL          HVHFEOFPMBGWPS 
GHNCBEIOVKK     : BHFNLAXHBBENRTV
XHNPSA          : YAWQXJU         VBIV            SLISBCNCSAFWE   SJUXB           JNGAXGCBIFVI   
NBHQLBCBTUY     : DRPBSITPB       UDLLDAHDLTPQR   TDNFPGNHEVWK    BOCITQNLFQRE   
CIMGKTO         : IUEQCBPMCTTHSCV TFHIRQVIRBGDGIS
PCNHCUWRPXKDBTW : PMVQO           JSTLFAVLGPV    
UYQQUSSYBFFNB   : QYDOB           BUFJMBHXLJPU   
PTBDD           : BYRFE           JJSFOVV         RDHNCAMH       
YAWQXJU         : XHNPSA          NFBGQJYUOOWJP   LQXY            NUHSFLJRBY     
DRPBSITPB       : BLNCIKIQ        IXVVDPHYK       NBHQLBCBTUY     QVBUAMG         WCPTA           FVXYCT          FFQQXRQ        
QFUWUXVKRWQUC   : DQCMKMMG        VAYSVTTK        MRBWO           YRPGFRJUADQVAJ 
VBIV            : WOCSMADAUBD     XHNPSA          CJSBASISAJAK    MQPG            OFJRNWK        
FXQYPTUYOK      : JEKTBGVKOQOWJML XKLVLOYEYIPB    YUTTQYKKKFEWKFU
DEJXBFYYRQXIO   : SWVUFSF         BIACSL          QPTRO          
AMBLK           : QAOFEVVM        DBTIKTRVNSLSUK  GKCCDNFXOPXVYFW GQAVOXMMGM      GNULYO          JSTLFAVLGPV    
SLISBCNCSAFWE   : XHNPSA          NVMPGGPAGUCCG   AQSRNAAGVKFYAY  MSHCGILYXCIUIB 
WHVVGOPGYGGAU   : JEKTBGVKOQOWJML GDIWKQGBTTAE    QBMBJ           MKWHEDGVEWGT    WCPTA           ACIGQOU         WUQMUUANICLW   
NFBGQJYUOOWJP   : MACXHR          YAWQXJU         HFUMAWYY        QVJKBHRUXJIAR   NCWMHUOLSU     
GVVGEREMIVTI    : DBTIKTRVNSLSUK  LRFI            PIJYHDWQS      
CKYOXFS         : SDVDKJXR        TDNFPGNHEVWK    ONYIRDJCIF      KTYLITJUPUGYSSH
XEISSYSDQ       : QCNDTITRAVBMPI  EPXUUKPIHA      ACIGQOU         NMLTLNPXNUG    
LNUTTPYIXWE     : FFVFG           VNWCHIV         LQXY            IYWHUCMLHJR    
CJSBASISAJAK    : VBIV            KJEI           
SJUXB           : XHNPSA         
MQPG            : NUFBKJJUTCHIS   VBIV            QOKFAESG        OEGMERVRCBFH    DFGIREQGV       XRMDOLT        
FHSGHAMJJGMJBX  : WOCSMADAUBD     RHHSOJ          CUEICDODV      
BHFNLAXHBBENRTV : BYRFE           GHNCBEIOVKK     OMLEYCUSPU      LRFI           
CGWIN           : MNGATAGBCOCGMH  TLXQTNETFCQ     UDLLDAHDLTPQR   EDPUU          
WYIFN           : BLNCIKIQ        SLSJJGIO       
HNAKUHYHHYQKAWA : PJCGKL          TJTHBSO         QFXHRNRM        PMVQO           IWBDAB         
SWVUFSF         : PJCGKL          UVQWBPIB        DEJXBFYYRQXIO   QOKFAESG        FTYQESSQEMCB    GPWRS          
SDVDKJXR        : YEGGUPQ         RYTIT           AYLOJQR         CKYOXFS         GQAVOXMMGM      WUQMUUANICLW    VLBUJ          
AFUHEER         : AKQUHDMUOD      ODGJRWCLNMQ     QNCNUATCIUSFTQD KTYLITJUPUGYSSH CVOJYLDTRVFQ   
WCDTDWNCSKJL    : QJKCJR          SUUQH           DGERKM          FWNUMBCVGW      SGXVSJDDESOBAGU
EGVAKILKDJL     : VBLTMDALPTRIV   DWIETIRAGNII    KQOCSRKB        SKVSECDAKEJEGTJ
HUOLMT          : PDNWJLRUQVPYILR SUUQH           VIFKBHJWXCDXNKV NMLTLNPXNUG     YUTTQYKKKFEWKFU
RWFW            : LJJENN          YPLKTNESNFLMB   ROXFKO         
SYOEICWOJUOV    : BYGWPB          SJOEYDVAC      
CGIOT           : LRFI            CYVPQEXJHWREP   PSXTJ          
VPHJEB          : CBLLEXGUBJDOHG  WCPTA          
VAYSVTTK        : IVBA            WNVMVMQYXC      QFUWUXVKRWQUC   OMLEYCUSPU      APXHVQ         
ENYUYVLWCODKDA  : NFNDV           IBJNLKHOB       QVBUAMG         REJVFRJOVHYWJHN
YPLKTNESNFLMB   : RWFW            DLPX            XLLBKYEXIV      ONAGSPRATPS     TDNFPGNHEVWK    DLWK           
YEOODKNAVMCKSMP : GELLYILB        KXTWIYMVNFBG    EYMVFRYIJRLILR  HFUMAWYY        IUEQCBPMCTTHSCV
QOKFAESG        : MQPG            SWVUFSF         BHSAIDQUIXE    
INLWQVWUKLYWCB  : CFBOJONNMXJGM   QVLKNFKVCLF     XRMDOLT        
ODGJRWCLNMQ     : YLAA            AFUHEER        
TLXQTNETFCQ     : CGWIN           HPWBY           FTYQESSQEMCB    RDHNCAMH       
NEBMG           : CHSQ            VBQOOEJM        JGRUWSWFQHLYVW 
IXHPH           : XJANKBLLSU      GNULYO         
OMLEYCUSPU      : JEKTBGVKOQOWJML BHFNLAXHBBENRTV VAYSVTTK        HHVEA           AQSRNAAGVKFYAY  EHTYTGATYSOM    BRFDAOQCOU      GHJUWKGQPPUXUT 
OMLEYCUSPU      : BVCOER         
JJSFOVV         : PTBDD           LBUXJW          ONAGSPRATPS     PIJYHDWQS      
LBUXJW          : EQYARPLRRWI     JJSFOVV         IYWHUCMLHJR    
HFYR            : ONAGSPRATPS     WJBREKM         JSTLFAVLGPV    
NEURFYOYOKNAT   : VIFKBHJWXCDXNKV DRLNU           EDPUU          
GKCCDNFXOPXVYFW : AMBLK           VGHAWMKQKXJVGA  ONAGSPRATPS     CYVPQEXJHWREP   TDNFPGNHEVWK    CCCWHKFADDKUF  
MKWHEDGVEWGT    : WHVVGOPGYGGAU   CADOFIRUNSLF    FFQQXRQ        
CADOFIRUNSLF    : NFNDV           IOVDDONMWX      YOSVJPDXM       MKWHEDGVEWGT    BAIOGRI         BVCOER         
HHVEA           : EBPKNYWADLSKDC  OMLEYCUSPU      HVWUNWVDY       GJDPYFENVIKOSIL AKANNXWAKS     
QARXFAVLWE      : BIWERWACSWI     FFVFG           DLPX            LGHFUDUEDY      NCYRPVDXICC    
VGHAWMKQKXJVGA  : IXVVDPHYK       GKCCDNFXOPXVYFW GNULYO         
NVMPGGPAGUCCG   : SLISBCNCSAFWE   ISUHW           DGERKM          BAIOGRI         DIEJOACSG       RDHNCAMH       
GNXMVAL         : NUFBKJJUTCHIS   HMLYISVHQJS     IAEDCOKT        PIJYHDWQS      
KCWKMTSOCGNQYV  : HVSWIGVF        CUEICDODV      
QYDOB           : ACWHIJUJT       JEKTBGVKOQOWJML UYQQUSSYBFFNB   NCYRPVDXICC     GMAKHQMHX      
UDLLDAHDLTPQR   : NBHQLBCBTUY     CGWIN           OAEBPVBTIKJ     QVLKNFKVCLF     GMAKHQMHX      
FNTTPCJIB       : NFNDV           EHTYTGATYSOM    WUQMUUANICLW   
GSHJHIRENDRQGYV : XKLVLOYEYIPB    BIACSL          BRFDAOQCOU     
TLKNMRB         : UHOYIYOJ        BRDNUFJBGYWMQY  OQNVVACODFGI    SCGF           
OSKXBOGJJNVSYN  : ASJLEBALYS      CYVPQEXJHWREP   QNCNUATCIUSFTQD JNGAXGCBIFVI   
MSPGYQCVMOGCD   : WJUJLJWLGAVBYY  EWSPEKEOKPNCFWK ERXALSCMNO     
DLPX            : EYMVFRYIJRLILR  YPLKTNESNFLMB   QARXFAVLWE      PIJYHDWQS      
PCOWLXMHQNUQ    : BQKJLYUSOF      LMASYODITJPPQX  ACIGQOU         STNN           
QIJPBNLOCU      : QARXTBUPWOLUDH  BVQS            JEPJPIVGXEEHRX  JSTLFAVLGPV    
HVWUNWVDY       : BLNCIKIQ        HHVEA           YWTVI          
CLJPUCDQ        : SGBHN           WINPDSUNAEDAIV  IWBDAB         
GJDPYFENVIKOSIL : MPTWYQHTATTTS   HHVEA           LSMNOIXJLT      FWNUMBCVGW      PGHJITTS       
XLLBKYEXIV      : HRHJXVQREDDDO   CBLLEXGUBJDOHG  PJFVRQDNPCUSKUW YPLKTNESNFLMB   WJUJLJWLGAVBYY  RYOJUJRB       
MYMIIVLA        : UHOYIYOJ        ASJLEBALYS      SCGF            FVXYCT          UYLJFFQKIWYKO  
QGMMRWEKH       : EQYARPLRRWI     QNCACRPQRBXE    FVXYCT         
CFBOJONNMXJGM   : FRUMNUJIRCMKI   OWDDU           INLWQVWUKLYWCB  LSMNOIXJLT      FVXYCT         
SUUQH           : EYMVFRYIJRLILR  FFVFG           WCDTDWNCSKJL    HUOLMT          FOGBAVGXLP     
OAEBPVBTIKJ     : QCNDTITRAVBMPI  UDLLDAHDLTPQR   WINPDSUNAEDAIV 
QNCACRPQRBXE    : PJFVRQDNPCUSKUW QGMMRWEKH      
SAJKJHBJ        : QAOFEVVM        MUOENRXF        QURBBSCAGLHCX  
CYKFSU          : BYGWPB          QVJKBHRUXJIAR   YSKUAYPXYMGMEMH QVIXBRQFKBG     DDFITFX         ILWBG          
FIHUMJYGBPXC    : XIGTEGVU        DGERKM          PFVAJLLCUHIU    IYWHUCMLHJR    
FPLH            : EPXUUKPIHA      YWTVI           HVHFEOFPMBGWPS 
XQIYA           : RHHSOJ          YSKUAYPXYMGMEMH KWVDC          
DCJJWGACRJWEUXN : KMPIKLSCDKXFS   BKYHXUKGSVXK    CHSQ            SJOEYDVAC      
ONAGSPRATPS     : FRUMNUJIRCMKI   YPLKTNESNFLMB   JJSFOVV         HFYR            GKCCDNFXOPXVYFW GCALTCCXKDTUVK  DIEJOACSG       QVIXBRQFKBG    
ONAGSPRATPS     : OMGIKQC         JIVADCVQARVRID 
QVBUAMG         : XMECYUOYXOIR    DRPBSITPB       ENYUYVLWCODKDA  FVXYCT          NMLTLNPXNUG    
TGALR           : KXTWIYMVNFBG    NUFBKJJUTCHIS   UQXHBXKPQBGM    HMLYISVHQJS     PTMGFFDSBMY    
ROXFKO          : YLAA            RWFW            REJVFRJOVHYWJHN MRBWO           GCALTCCXKDTUVK  NCYRPVDXICC     GFXLXVN        
MUOENRXF        : FAMTQVG         MACXHR          SAJKJHBJ        QURBBSCAGLHCX   MSHCGILYXCIUIB 
DWIETIRAGNII    : NUFBKJJUTCHIS   THSFAECMY       EGVAKILKDJL     DGERKM          WHXGFFAOWWX     BQEGY           SGXVSJDDESOBAGU
CHSQ            : FAMTQVG         NEBMG           DCJJWGACRJWEUXN OFJRNWK        
YDVU            : QCEKCMDGWJFY    MPTWYQHTATTTS   ANYSLELBX       TKAJOBCGXHGI   
TJTHBSO         : HNAKUHYHHYQKAWA REJVFRJOVHYWJHN JGRUWSWFQHLYVW  SGXVSJDDESOBAGU
VNWCHIV         : HVSWIGVF        LNUTTPYIXWE     HFUMAWYY       
OJRWKTGGMQH     : MRBWO           OTVCDWS         RKYRIGE         WUQMUUANICLW    LWTFPOHH       
MCFGNCPRW       : VBLTMDALPTRIV   XHOHBRPXQDJV    ERXALSCMNO     
ISUHW           : MACXHR          NVMPGGPAGUCCG  
PTMGFFDSBMY     : TGALR           TKAJOBCGXHGI    JGRUWSWFQHLYVW 
DGERKM          : DBTIKTRVNSLSUK  OWDDU           WCDTDWNCSKJL    NVMPGGPAGUCCG   FIHUMJYGBPXC    DWIETIRAGNII   
AQSRNAAGVKFYAY  : BCSKRAENKGWWTV  DQNJFMMKJ       SLISBCNCSAFWE   OMLEYCUSPU     
HFUMAWYY        : NFBGQJYUOOWJP   YEOODKNAVMCKSMP VNWCHIV         FVXYCT          AEWCVKX        
EHTYTGATYSOM    : OMLEYCUSPU      FNTTPCJIB      
QURBBSCAGLHCX   : IKXBD           FGJHUVWHDIW     SAJKJHBJ        MUOENRXF       
BAIOGRI         : BQKJLYUSOF      DQNJFMMKJ       CADOFIRUNSLF    NVMPGGPAGUCCG   YWTVI           XRMDOLT        
LRFI            : BQKJLYUSOF      KPNJNFTVH       ALGTDFCGXEW     DBTIKTRVNSLSUK  GVVGEREMIVTI    BHFNLAXHBBENRTV CGIOT           WINPDSUNAEDAIV 
LRFI            : JIVADCVQARVRID 
BYGWPB          : SYOEICWOJUOV    CYKFSU          OTVCDWS         EWSPEKEOKPNCFWK
REJVFRJOVHYWJHN : ENYUYVLWCODKDA  ROXFKO          TJTHBSO         JNGAXGCBIFVI   
CYVPQEXJHWREP   : KMPIKLSCDKXFS   HVSWIGVF        WKGD            CGIOT           GKCCDNFXOPXVYFW OSKXBOGJJNVSYN  QVLKNFKVCLF    
WHXGFFAOWWX     : BCSKRAENKGWWTV  OWDDU           DWIETIRAGNII    WFRMPCOC        PECEVEU         OGMY            KQOCSRKB       
VIFKBHJWXCDXNKV : BJXTHTWEMTSXQ   HUOLMT          NEURFYOYOKNAT  
QNCNUATCIUSFTQD : OQNVVACODFGI    AFUHEER         OSKXBOGJJNVSYN  MRBWO          
BIACSL          : VRKHCGJEIRTHU   BRDNUFJBGYWMQY  LMASYODITJPPQX  DEJXBFYYRQXIO   GSHJHIRENDRQGYV CNDWNMPISONKIN  NCYRPVDXICC    
SNFQ            : XIGTEGVU        DBGENNT         DFGIREQGV       HRVTGSGTI      
QOIHCKX         : EYMVFRYIJRLILR 
MRBWO           : ASJLEBALYS      QFUWUXVKRWQUC   ROXFKO          OJRWKTGGMQH     QNCNUATCIUSFTQD AKANNXWAKS     
EKNHBOSDRNPTGD  : XKLVLOYEYIPB    BCSKRAENKGWWTV  NUHSFLJRBY     
WFRMPCOC        : WHXGFFAOWWX     IYWHUCMLHJR    
QPTRO           : QCEKCMDGWJFY    DEJXBFYYRQXIO   SKVSECDAKEJEGTJ
OTVCDWS         : IQDIG           ACWHIJUJT       OJRWKTGGMQH     BYGWPB          AEWCVKX         DFGIREQGV      
DKJSGRV         : OQNVVACODFGI    HAHL            FRSTOUKKY      
PECEVEU         : WHXGFFAOWWX     LSMNOIXJLT      LWEPT          
GLQBGFOUBKYF    : JUJBXYMIOGHJ    AHFFHP          RDHNCAMH       
TDNFPGNHEVWK    : BIWERWACSWI     NFNDV           JUJBXYMIOGHJ    QAOFEVVM        DBTIKTRVNSLSUK  NBHQLBCBTUY     CKYOXFS         YPLKTNESNFLMB  
TDNFPGNHEVWK    : GKCCDNFXOPXVYFW
DHFYGMKYPQEENI  : DQCMKMMG        XNBBWBOJRKLYEG 
ONBJQO          : GPXMJXBOQQ      OWDDU           GQAVOXMMGM      BOCITQNLFQRE   
IUEQCBPMCTTHSCV : NUFBKJJUTCHIS   CIMGKTO         YEOODKNAVMCKSMP
DLWK            : WOCSMADAUBD     YPLKTNESNFLMB   BOCITQNLFQRE   
MSHCGILYXCIUIB  : SLISBCNCSAFWE   MUOENRXF        NJIHPBRSC      
LSMNOIXJLT      : HVSWIGVF        GJDPYFENVIKOSIL CFBOJONNMXJGM   PECEVEU         RUAXHL          BVCOER         
OGMY            : WHXGFFAOWWX    
BRFDAOQCOU      : OMLEYCUSPU      GSHJHIRENDRQGYV JEPJPIVGXEEHRX  VBQOOEJM        RUAXHL         
JEPJPIVGXEEHRX  : VSMWVQWNW       IVBA            IKXBD           QIJPBNLOCU      BRFDAOQCOU      STNN           
JGLKFNFKSFBK    : VBLTMDALPTRIV   JTOTDEUU        KWVDC           PSXTJ          
PFVAJLLCUHIU    : FIHUMJYGBPXC    LWTFPOHH       
OEGMERVRCBFH    : WOCSMADAUBD     MQPG            NCWMHUOLSU     
BNPLWFQVHDHSFEC : PJCGKL          BCSKRAENKGWWTV  ALGTDFCGXEW     HPWBY          
BQEGY           : DWIETIRAGNII    WUQMUUANICLW    UCRFRYQOEEVD   
KQOCSRKB        : DJHMMDM         EGVAKILKDJL     WHXGFFAOWWX     KJEI            FOGBAVGXLP     
LQXY            : UVQWBPIB        YAWQXJU         LNUTTPYIXWE     YRPGFRJUADQVAJ 
DRLNU           : NEURFYOYOKNAT   SVIHIHFUY      
GCALTCCXKDTUVK  : AKQUHDMUOD      ONAGSPRATPS     ROXFKO         
OFJRNWK         : THSFAECMY       LJPDTHU         VBIV            CHSQ            RBLGOQYJXIWKTS 
VBQOOEJM        : NEBMG           BRFDAOQCOU      ACIGQOU         DPOSUJ          TKAJOBCGXHGI    UYLJFFQKIWYKO  
ONYIRDJCIF      : OWDDU           CKYOXFS         AOVDRDKFQEPI    IYWHUCMLHJR    
EPXUUKPIHA      : BKYHXUKGSVXK    XEISSYSDQ       FPLH           
EDPUU           : BJXTHTWEMTSXQ   CGWIN           NEURFYOYOKNAT   QVLKNFKVCLF    
GHJUWKGQPPUXUT  : XMECYUOYXOIR    OMLEYCUSPU      XJANKBLLSU     
MUCKFRUOTRUXJPU : BKYHXUKGSVXK    ERDDPDXBOCC     IAEDCOKT        CNDWNMPISONKIN  DBGENNT        
WCPTA           : UHOYIYOJ        DRPBSITPB       WHVVGOPGYGGAU   VPHJEB         
AQSRMS          : QCEKCMDGWJFY    PDNWJLRUQVPYILR NCWMHUOLSU      BVCOER         
IAEDCOKT        : FRUMNUJIRCMKI   GNXMVAL         MUCKFRUOTRUXJPU KJEI            DDFITFX         NMUTSLCVNYCMMUM
CNDWNMPISONKIN  : BIACSL          MUCKFRUOTRUXJPU
LGHFUDUEDY      : QARXFAVLWE      FWNUMBCVGW     
HPWBY           : GDIWKQGBTTAE    TLXQTNETFCQ     BNPLWFQVHDHSFEC ANYSLELBX       SXGWYJUKMOPXCL 
QFXHRNRM        : KXTWIYMVNFBG    HNAKUHYHHYQKAWA WJBREKM         FOGBAVGXLP     
FWNUMBCVGW      : DQNJFMMKJ       WCDTDWNCSKJL    GJDPYFENVIKOSIL LGHFUDUEDY      XNBBWBOJRKLYEG  SKVSECDAKEJEGTJ PSXTJ          
DBGENNT         : SNFQ            MUCKFRUOTRUXJPU DIEJOACSG      
QVJKBHRUXJIAR   : GELLYILB        NFBGQJYUOOWJP   CYKFSU          GMAKHQMHX      
PMVQO           : BIWERWACSWI     FRUMNUJIRCMKI   AYLOJQR         PCNHCUWRPXKDBTW HNAKUHYHHYQKAWA
AOVDRDKFQEPI    : NFNDV           BLNCIKIQ        GPXMJXBOQQ      ONYIRDJCIF      YWTVI          
BUFJMBHXLJPU    : UYQQUSSYBFFNB   SXGWYJUKMOPXCL  HVHFEOFPMBGWPS 
FRSTOUKKY       : AKQUHDMUOD      DKJSGRV         BHSAIDQUIXE     FOGBAVGXLP     
NJIHPBRSC       : HMLYISVHQJS     MSHCGILYXCIUIB 
XNBBWBOJRKLYEG  : VBLTMDALPTRIV   DHFYGMKYPQEENI  FWNUMBCVGW      GMAKHQMHX       FFQQXRQ        
SCGF            : EYMVFRYIJRLILR  TLKNMRB         MYMIIVLA        MKTWQERSGUPQFXQ STNN           
JTOTDEUU        : SLSJJGIO        QAOFEVVM        QBMBJ           JGLKFNFKSFBK    CUEICDODV       OMGIKQC         UYLJFFQKIWYKO  
XJANKBLLSU      : IXHPH           GHJUWKGQPPUXUT 
DIEJOACSG       : UVQWBPIB        NVMPGGPAGUCCG   ONAGSPRATPS     DBGENNT        
VPDKLGRHDSHMSU  : GDIWKQGBTTAE    ITCUNAXYTNE     ASJLEBALYS      ILWBG           ERXALSCMNO     
WINPDSUNAEDAIV  : EBPKNYWADLSKDC  CLJPUCDQ        OAEBPVBTIKJ     LRFI           
RUAXHL          : VBLTMDALPTRIV   LSMNOIXJLT      BRFDAOQCOU     
YSKUAYPXYMGMEMH : FAMTQVG         CYKFSU          XQIYA           SKVSECDAKEJEGTJ
AHFFHP          : GLQBGFOUBKYF    LWEPT          
RKYRIGE         : OJRWKTGGMQH     NMUTSLCVNYCMMUM
IWBDAB          : HNAKUHYHHYQKAWA CLJPUCDQ        ERXALSCMNO     
ACIGQOU         : QJKCJR          WHVVGOPGYGGAU   XEISSYSDQ       PCOWLXMHQNUQ    VBQOOEJM        RDHNCAMH       
QVIXBRQFKBG     : UHOYIYOJ        VBLTMDALPTRIV   CYKFSU          ONAGSPRATPS    
JNGAXGCBIFVI    : XHNPSA          OSKXBOGJJNVSYN  REJVFRJOVHYWJHN
GQAVOXMMGM      : OQNVVACODFGI    AMBLK           SDVDKJXR        ONBJQO         
BDVLECNPRWQPFSS : MKTWQERSGUPQFXQ
APXHVQ          : YEGGUPQ         VAYSVTTK        PSXTJ          
TFHIRQVIRBGDGIS : QCEKCMDGWJFY    JEKTBGVKOQOWJML WKGD            CIMGKTO         AEWCVKX        
DPOSUJ          : IKXBD           VBQOOEJM        CCCWHKFADDKUF  
KJEI            : FFVFG           CJSBASISAJAK    KQOCSRKB        IAEDCOKT       
CCCWHKFADDKUF   : MUMG            GKCCDNFXOPXVYFW DPOSUJ         
ANYSLELBX       : BQKJLYUSOF      YDVU            HPWBY           FVXYCT         
MKTWQERSGUPQFXQ : MPTWYQHTATTTS   SCGF            BDVLECNPRWQPFSS UCRFRYQOEEVD   
DDFITFX         : KMPIKLSCDKXFS   VSMWVQWNW       CBLLEXGUBJDOHG  CYKFSU          IAEDCOKT       
AKANNXWAKS      : OWDDU           HHVEA           MRBWO          
BYRTGOMYVK      : RYTIT           STNN           
GNULYO          : EQYARPLRRWI     AMBLK           IXHPH           VGHAWMKQKXJVGA 
WJUJLJWLGAVBYY  : EBPKNYWADLSKDC  MSPGYQCVMOGCD   XLLBKYEXIV     
SVIHIHFUY       : DRLNU           OMGIKQC        
KTYLITJUPUGYSSH : RYTIT           KPNJNFTVH       FFVFG           CKYOXFS         AFUHEER         VLBUJ           GMAKHQMHX      
QITSIPORYW      : NFNDV           JSTLFAVLGPV    
FTYQESSQEMCB    : SWVUFSF         TLXQTNETFCQ    
WJBREKM         : MCFOI           HFYR            QFXHRNRM        RBLGOQYJXIWKTS 
SJOEYDVAC       : JEKTBGVKOQOWJML OWDDU           SYOEICWOJUOV    DCJJWGACRJWEUXN PGHJITTS       
FVXYCT          : DRPBSITPB       MYMIIVLA        QGMMRWEKH       CFBOJONNMXJGM   QVBUAMG         HFUMAWYY        ANYSLELBX       TKAJOBCGXHGI   
SXGWYJUKMOPXCL  : BLNCIKIQ        ERDDPDXBOCC     HPWBY           BUFJMBHXLJPU   
NCWMHUOLSU      : YEGGUPQ         MPTWYQHTATTTS   NFBGQJYUOOWJP   OEGMERVRCBFH    AQSRMS         
QVLKNFKVCLF     : INLWQVWUKLYWCB  UDLLDAHDLTPQR   CYVPQEXJHWREP   EDPUU           NUHSFLJRBY      GPWRS          
WUQMUUANICLW    : HMLYISVHQJS     WHVVGOPGYGGAU   SDVDKJXR        FNTTPCJIB       OJRWKTGGMQH     BQEGY          
ILWBG           : IKXBD           CYKFSU          VPDKLGRHDSHMSU  STNN            PSXTJ          
UCRFRYQOEEVD    : FAMTQVG         BQEGY           MKTWQERSGUPQFXQ
STNN            : PCOWLXMHQNUQ    JEPJPIVGXEEHRX  SCGF            BYRTGOMYVK      ILWBG          
NCYRPVDXICC     : ACWHIJUJT       QARXFAVLWE      QYDOB           ROXFKO          BIACSL         
KWVDC           : XQIYA           JGLKFNFKSFBK   
CUEICDODV       : THSFAECMY       FHSGHAMJJGMJBX  KCWKMTSOCGNQYV  JTOTDEUU        FDFNAPJSNVDKVI 
TKAJOBCGXHGI    : PJCGKL          YDVU            PTMGFFDSBMY     VBQOOEJM        FVXYCT          BVCOER         
IYWHUCMLHJR     : RYTIT           YOSVJPDXM       LNUTTPYIXWE     LBUXJW          FIHUMJYGBPXC    WFRMPCOC        ONYIRDJCIF     
LWEPT           : QBMBJ           PECEVEU         AHFFHP          LWTFPOHH       
JGRUWSWFQHLYVW  : MCFOI           NEBMG           TJTHBSO         PTMGFFDSBMY    
SGXVSJDDESOBAGU : AKQUHDMUOD      WCDTDWNCSKJL    DWIETIRAGNII    TJTHBSO        
RDHNCAMH        : PTBDD           TLXQTNETFCQ     NVMPGGPAGUCCG   GLQBGFOUBKYF    ACIGQOU        
VVUR            : EBPKNYWADLSKDC  DFGIREQGV       CVOJYLDTRVFQ    NMUTSLCVNYCMMUM
VLBUJ           : IXVVDPHYK       SDVDKJXR        KTYLITJUPUGYSSH
GMAKHQMHX       : MNGATAGBCOCGMH  QYDOB           UDLLDAHDLTPQR   QVJKBHRUXJIAR   XNBBWBOJRKLYEG  KTYLITJUPUGYSSH RBLGOQYJXIWKTS 
YRPGFRJUADQVAJ  : QCSYAEGYUUG     UVBGWLCHO       ILLVLMXIACEBYW  QFUWUXVKRWQUC   LQXY           
YWTVI           : YLAA            HVWUNWVDY       FPLH            BAIOGRI         AOVDRDKFQEPI   
EWSPEKEOKPNCFWK : MSPGYQCVMOGCD   BYGWPB          XRMDOLT        
GFXLXVN         : HRHJXVQREDDDO   ASJLEBALYS      ROXFKO         
OMGIKQC         : ONAGSPRATPS     JTOTDEUU        SVIHIHFUY      
NUHSFLJRBY      : YAWQXJU         EKNHBOSDRNPTGD  QVLKNFKVCLF    
HVHFEOFPMBGWPS  : QARXTBUPWOLUDH  QCEKCMDGWJFY    BRDNUFJBGYWMQY  LMASYODITJPPQX  FPLH            BUFJMBHXLJPU   
AEWCVKX         : MCFOI           HFUMAWYY        OTVCDWS         TFHIRQVIRBGDGIS GPWRS          
FFQQXRQ         : QARXTBUPWOLUDH  FAMTQVG         SLSJJGIO        HAHL            DRPBSITPB       MKWHEDGVEWGT    XNBBWBOJRKLYEG 
BOCITQNLFQRE    : EQYARPLRRWI     NBHQLBCBTUY     ONBJQO          DLWK           
NMLTLNPXNUG     : OWDDU           XEISSYSDQ       HUOLMT          QVBUAMG         PIJYHDWQS      
LWTFPOHH        : UVQWBPIB        OJRWKTGGMQH     PFVAJLLCUHIU    LWEPT           XHOHBRPXQDJV   
RBLGOQYJXIWKTS  : NFNDV           VBLTMDALPTRIV   OFJRNWK         WJBREKM         GMAKHQMHX      
JIVADCVQARVRID  : VRKHCGJEIRTHU   PJFVRQDNPCUSKUW ONAGSPRATPS     LRFI           
BVCOER          : GPXMJXBOQQ      OMLEYCUSPU      CADOFIRUNSLF    LSMNOIXJLT      AQSRMS          TKAJOBCGXHGI   
FDFNAPJSNVDKVI  : GELLYILB        GPXMJXBOQQ      CUEICDODV       HRVTGSGTI      
RYOJUJRB        : WNVMVMQYXC      XLLBKYEXIV     
UYLJFFQKIWYKO   : EQYARPLRRWI     MYMIIVLA        VBQOOEJM        JTOTDEUU       
DFGIREQGV       : VRKHCGJEIRTHU   HUYO            MQPG            SNFQ            OTVCDWS         VVUR           
XHOHBRPXQDJV    : QBMBJ           PYUQJ           MCFGNCPRW       LWTFPOHH       
BHSAIDQUIXE     : WOCSMADAUBD     QOKFAESG        FRSTOUKKY      
PIJYHDWQS       : IQDIG           GVVGEREMIVTI    JJSFOVV         GNXMVAL         DLPX            NMLTLNPXNUG    
SKVSECDAKEJEGTJ : MCFOI           EGVAKILKDJL     QPTRO           FWNUMBCVGW      YSKUAYPXYMGMEMH
PSXTJ           : FGJHUVWHDIW     CGIOT           JGLKFNFKSFBK    FWNUMBCVGW      APXHVQ          ILWBG          
CVOJYLDTRVFQ    : AFUHEER         VVUR           
JSTLFAVLGPV     : LJPDTHU         PCNHCUWRPXKDBTW AMBLK           HFYR            QIJPBNLOCU      QITSIPORYW     
FOGBAVGXLP      : SUUQH           KQOCSRKB        QFXHRNRM        FRSTOUKKY      
YUTTQYKKKFEWKFU : FAMTQVG         FRUMNUJIRCMKI   IKXBD           DQCMKMMG        FXQYPTUYOK      HUOLMT         
NMUTSLCVNYCMMUM : SGBHN           KPNJNFTVH       IAEDCOKT        RKYRIGE         VVUR           
PGHJITTS        : QCEKCMDGWJFY    MACXHR          YLAA            GJDPYFENVIKOSIL SJOEYDVAC       GPWRS          
XRMDOLT         : MQPG            INLWQVWUKLYWCB  BAIOGRI         EWSPEKEOKPNCFWK
GPWRS           : WOCSMADAUBD     SWVUFSF         QVLKNFKVCLF     AEWCVKX         PGHJITTS       
HRVTGSGTI       : SNFQ            FDFNAPJSNVDKVI 
ERXALSCMNO      : JEKTBGVKOQOWJML MSPGYQCVMOGCD   MCFGNCPRW       VPDKLGRHDSHMSU  IWBDAB         
