YHDTCPKWDWFLDRF : GPQAO           VGSWXQMNKRPLSXU NKWGQENOCVFMELV OUNBIXLFF       WPYFGBVD       
UVNL            : MMQEJLS         DXGYEQIOOHJALC  VNPRLFB        
HPWNQ           : AWDH            TLTUL          
QXPAXYDRBUE     : WUEAIOWOQ       UWWYPJQSLAQY    CDNHYLSDNAACEO  QFLOVHVIAIY    
XBEM            : USOUP           AHSARWHORRMH    KTFBHP          QURIJCMXEYEXS   AMXW           
XRYUPOIAWBYMRKG : MFFFQATUXNU     RVNIL          
DGOCLIEHMFHO    : CLNSL           LLQDTFFSUOG    
TUJNWEELPGIQF   : BUPH            PTMKWUOSQF      USGU            HQRADDYARC      MHKUIG         
IRCBWKRCXAIH    : JVOMDI          GQNS           
NPEYJYIXV       : YRLTUIOFQLHS    GXINJLDMOUH     WFGVLLMOP      
EIEKSW          : UCDEUO          ODOOWCNWM       EVKVR          
OGLSJJFCLECTN   : WYDSWOXUJBLYX   CBBRNWN         MFFFQATUXNU    
HDVINVSLRHRCOC  : IXYSUXQLNRMH    HTSLTMCYPOEHJC  TWVCCFYWSWE     EULIO           DVWDJB          IMTFQXAUXIFKUC 
LVMTHIGSNIET    : MAJOTIU         DJPRWI          FXLYIVLFBFD    
AIFHNBRBWKORSG  : XGJTYUNNYOGN    LGRBREXCB       ETKBOV          RBGBAVE         UNBGEIEOO      
JKPWGFTQNAJDKQA : TTVMEHVBD       FYYWJK         
QKCB            : SNGQQREG        FREHKNMQSF      LKWXR           WMSHRVIQOYMOM  
ESADEQUYXPKIHH  : TBIODS          CQUTAIYK        FSWMYC          SQHVMKFPVLIL   
MDICFT          : UDGFJD          GMLOLVMHNWWCQL  LLQDTFFSUOG     LKUSQ           MOJHYSLENWC    
PKIPCSR         : LESWMGCUSVU     PJNKIALBX       LXKEOGTNHS      BRQRH           BPJRRPCAD       AISUTLPHKGXAK  
QXXS            : SCJVVO          XSOHTYMKUKWYDMW VLKYV           ERDALC          CYXBLNEJPLMAAI 
EKYDIQNS        : QHIYVWHIEKLUWHM
XMNDWSJRYBEHQ   : NYTAFYRUW       UTRIFGHNVD      SJQGNYOWXAXBKED YSBSRHHDG      
CLNSL           : DGOCLIEHMFHO    HUWQ            VERXRLPUGTQH    UHJNQFIGEPGYTJ 
OPQYPWJ         : SSDTAQUKFCPYC   YKQGFB         
MEHKRXQQ        : AHXSWHCNNQM     LEMOWOWYPXYC    SXEOLAJWKJTMKXJ EWEW           
CKRDP           : ITVBHCUI        CBBRNWN         OPNOC           WHBNLBWBXW     
WXDK            : PTMKWUOSQF      BAEDIDBJBH     
XVDMO           : SUOBTSI        
LESWMGCUSVU     : PKIPCSR         TPRGO           YTLUHLIJFHWC    BNKESRTAURT     RTDFBMYAHEFDJAN
MLLXDRPGQN      : QMQL            BDKGTCN         NMIJCO          ULDUNNGJCIVJRU  SNTBDAULCIH    
BEHY            : FNJIFLPD        ICQBNUOLYKQVAS  AVTWOMY         YJYDVUONKJSU   
UNEITW          : LPWEK           LAVHTNBBUA      VJNDO          
HDKEYGYIUMW     : FTAGH           LSLATW          DCVJ            FIVLFWHGKBFMEWK GRXQTOCLIRPJ    UNGWDU          CQXM           
RQKXH           : YCCWDJUMJTVSYMK AYCWGRORF      
HKDQJ           : FDWFQKQ         THFMRIFW        TQXDNANGUBPCE   IRQQ           
NARWTO          : OCKXLQAJUSINTFS JYDJEGXGWW      KVHGSH          XHCFCTQJCEFUHO  BKHAJTUSLQBFICT
BUPH            : TUJNWEELPGIQF   RWED            RJXL            YVLWXLRWVRRM   
XIEUUDQOTBMB    : IQJUDHGAQ       NBFQIRDQYXB     EUCHBLHOMSRR    CWRQAKEUOCC     SGLKINFFEJX     BPJRRPCAD      
VLIPXVD         : DNLGAW          MAJIOXHTOIYLV   BIJXR           RDOTKPXFLAUWWG  QWHSF          
NARCH           : TPDLBF         
WYDSWOXUJBLYX   : OGLSJJFCLECTN   TVNTUPUGNRKIBFV JFDAWGA         BMNLNSVEXTMPN   SDJRQRYDVFDI   
NBPMPXCN        : GVQFOFCP        DPAREJQQCF     
FNJIFLPD        : BEHY            WJDHYBSDINQM    DPHEW           QBSGITPCXSUIIGT DCVITWFDT      
PJGOX           : YBGG            JYVVHYC         FKLFJCKTLQNSFIC
JJIUKIIBJANYAPM : WUXUBXM         GDYIWNV         DQLHGUCECPMMDW  BTIBUS         
WAFFISVNGLWNAW  : BXOSOYUNWQUMU   TTMPVURWGMCXYKN IQSY            QYIIAG          UIGDEOEQG       DOPWMBJXEQWDK  
MHEHTMRUW       : QNYQCRCNR       UNHYKKTSJ       HSVEGVXNJMRPE   GUPJY           MTQOPB          UHJNQFIGEPGYTJ 
IVTA            : NXACGYLJNSRJ    AJWITMNC        RTKTJJ         
RXNWDV          : MLQKPRERWLUYL   OUNBIXLFF       SBHBFDEBAKJ     OPUQDUFBQ       SFALPBQF       
YKYMJOPJLCQPLKF : LCCHLNP         RDTRBSNCRWBPKJ 
ICXQ            : GXINJLDMOUH     XOKLVQEBFQR     AXAVXUYW        RDOVGDMAKRVLVEH ARCADBK        
URLM            : GELDHRHDL       FTAGH           BYJSLNBEP       UQBMANABQF      YYSYIDRPSIVA    VBUJFQFKBBNYNGD UBTDBHCUJULIXJX RFOOPWILJXBB   
AMSXFUKG        : WBLLI           PUGLIKGOJL      BQRDHGJBDGI    
WXWGJBWBNJGRRIR : DXGYEQIOOHJALC  SJUGTPLDJEWLI   NPAKANULXXHL   
LODWEUYQ        : MQRAB           BCHWNHFYX       VSEEHADWCFPEFDL VNCCDFQPRGNDJVD
XXKIGSFGRNP     : HNFIWKUUFS      AGSLSFUYU       HVHLOIECXYI    
MRJWXBQJUEUMJ   : MTCNG           GCBUYWFDTRI     NJRN           
QETJU           : EVQTSOBTIKP     VHNRDDTQ        UMSKMQE         CQQNWYIWDYQJVT 
JFCPAKWUX       : HBMMSQAMIWJDO   IAOREWTHRWPHPDI UNNOPWQGGVOAOF  ADPHBBGMWSR     GXYHKBBQVTPNBU 
QLIAKJ          : UAYHQKFTXQGHDV  USNCMFTTTKRGMO  BDRXYA          NEPL            YJYEAOVBIMOBXWH
DSXIPMRJD       : RVCURWJXKVGO    ERYVTVWQ        CHMUPVYGJIOFNV 
FMTYXBEO        : NNMXSPOB        BUYWK           OUNBIXLFF       HVHLOIECXYI    
QNYQCRCNR       : MHEHTMRUW       NPRSTWPCN       RGNQQ          
WUUPUDHKWS      : CSMKEI          OHLBNDCQRUPSBWN MYQNYQKRCEILBCD SCHR           
VYDR            : WNPJ            KVHGSH          BHWFLTIAYABIYEF SWGNEKOPXOUWIY 
BTERA           : IEGLH           ONWNRAWPEHWAFKY RVNIL           IAOREWTHRWPHPDI CDNHYLSDNAACEO  QFLOVHVIAIY    
HBMMSQAMIWJDO   : JFCPAKWUX       PHHREANXNDYWYF  QDNKVM          QDQROTREAUFHKY  WTJMXCR         EFOJYEIWBGHDIE  GKLX           
GVQFOFCP        : NBPMPXCN        ICQBNUOLYKQVAS  HNFIWKUUFS      FHACATFXVLV    
VQNR            : MFBOBWCLWAYQ    JPCGFTJJJKFU    NDFVNTJXGOFSCHD FFHYEQIFLWVF    DOPWMBJXEQWDK  
GRSNSH          : OEVUJP          URYMMF          RJMIHPE         OGPHLMYUSXTS    YBYVNIQIURSSY   VJDSMFQCX      
NXACGYLJNSRJ    : IVTA            YELDKDOX        SGERDILCJGIFYF  VAKPCSPJQ       VWRTDWXXQ      
XBSCQDAHRSFAK   : UVOCGHTGAHMH   
PGFSVFSYOSMXI   : NBFQIRDQYXB     CHMUPVYGJIOFNV  ONIGYEHID      
SSTSTMW         : UNPODOKG        PNHKS           OUNBIXLFF       LAVHTNBBUA      OBLRLWHCMHEYAK 
SWUKPAM         : AHXSWHCNNQM     BPFRWYFUSUTDO   RKFSM           RWED            XURYJGYSOP      EULIO           VXLLJ          
ACLHWJMSIDNXEVF : LEJMMADGVIEWI   OGPHLMYUSXTS    GCBUYWFDTRI    
OYPKMOV         : LNBQD           RVNIL           NWEYJCKJBEIGR   AIOMEVC        
LSRCSGHUKS      : RVQJOG          CFTTYACTVN     
ICQBNUOLYKQVAS  : BEHY            GVQFOFCP        NAJCPMWKU       FSEFBBMF        VDXXXXY         AFSBCA         
KFCIMPDETXKBSUV : SXHKGHYMCFJGX   SIGQGD         
DBMEQJ          : JRNQXER         SXEOLAJWKJTMKXJ
EIGUGGPVSUXE    : QOHNDKVMLEEDVU  TVRVDBP         LNBQD           BNVOAFYMYFPCV  
PJNKIALBX       : PKIPCSR         FYYWJK          KVBIGCUWLJBU    AHKDY          
WBLLI           : AMSXFUKG        GYMGSKUO        TLTUL           BBEUQS         
UDGFJD          : MDICFT          XFMYKO          BDKGTCN         OPNOC           IOPT            TKTX            BTIBUS         
RTHNQHTBWDO     : MEOPNPPLUYBO    SNIDFXOAYL      MCVBYV         
LRVPP           : VHNRDDTQ        FCJBDYSQKST     PJVGL           MXIJQ           DNOR            MHKUIG         
MQRAB           : LODWEUYQ        MYWTDJKTHMGY    WUHROOFYGF     
WHCCSHPNDWDUGW  : JGFFSPSCNKAN    YNGHCROEA       HMXOLHPLDJ      FREHKNMQSF     
DCMNQELGTRUNLU  : ODUWKYRBDTO    
JTXNV           : TTVMEHVBD       VBUJFQFKBBNYNGD MOYCQYF         OPUQDUFBQ      
UNHYKKTSJ       : MHEHTMRUW       OFTIKBCJJUNOPG  EAFYTNVIHRFAOE  FQQR            MHCSUYUMAJ      TPDLBF         
VLEL            : QAROBCSHHELTU   BXBAR           EURDUYHC        YPBCRWK         JEDOKGUIUGFEU   YSWDAXSFKO     
LWIF            : XGJTYUNNYOGN    YBBVXELEUBWNS   YEXFDYGTBBR    
DUEA            : HGHWCO          DJVIOJMHRYLM    GQDLJPAISXCQJV  PJVGL           MXIJQ           USIS            KICQ            HWQYF          
NTMBRGYFNXRATK  : ONWNRAWPEHWAFKY JVOMDI          WYXE            ILGGTPWQ        RHYJJBO        
NJVRUADUJLNOG   : DOVULAPALUIUPNB MAJOTIU         HNFIWKUUFS      FFFJMHTHPFPK    VNPRLFB         QHIYVWHIEKLUWHM
PUGLIKGOJL      : AMSXFUKG        RSTDJYXRGSO     OYLRSHVXENSOLB  FPPOBQQNSLFDT   VKDD           
JGFFSPSCNKAN    : WHCCSHPNDWDUGW  BYJSLNBEP       BOKURXC        
WYEKQMFIIOTQ    : VCLRC           BRNXLTKYNH      CFRY            KGSASMACKPTBXIX
CFKQKTWQY       : WBBGVE          LRNBSRWKS       LUNRINKBPS      MUVKEVJFUUQEL   EYJQBHRDDA     
ITUVGWLW        : EFNCBSNEYSIQH   WVWJXVVQQSN    
LDGEQMM         : UGTQ            GYMGSKUO        UUHHNCUJB      
BIRCLYM         : AQMVNSMKSNGNA   BRNXLTKYNH      TNEDGOONWMTQKCQ
KIBDJSLDPJ      : DJPRWI          HYMCBGB         DTJNDWGXXFCFL  
MUJIIM          : DJVIOJMHRYLM    FTYW            ITVAIOEI        BLTSOIMCXM      CYXBLNEJPLMAAI  LGSJKCQNC      
MFEBGH          : PMSCWC          WSFJDFDCPNEW    LVONMGD         SNFQPS          JTVOG           MKRTN          
AJXAVAKEDPNVDS  : PWYSG           RBMQWJW         QDMYM           MEVUPQOTCBK     MENRPUISHQILH  
MCBHLMSYEF      : LONEIEL        
KHNRTNB         : SSDTAQUKFCPYC   QGOWDVNOMMBUS   DVPHDERCKCYMK   QNCTSCKVD      
NYTAFYRUW       : XMNDWSJRYBEHQ  
NLHPP           : MIBTTRD         MUUQULKHR       EXARNNISGYOJLH  TRDCUESVGQENP  
CCKDIPJSYY      : VUKYMTHS        SVNGDA         
UNPODOKG        : SSTSTMW        
JXQH            : VHNRDDTQ        BODMYGVJBEMYDIJ OCKXLQAJUSINTFS MLUGVCVYK      
ESDTIUXMFD      : KXYJTV          UDWYGSVOWJM     SFAU            ATQKDH         
XNPYMCUCRLIIWQE : CQQNWYIWDYQJVT  AHKDY          
QUPMYJQVT       : VYDIKTDVTMELM   MTQOPB          SOFSTSU         RLRFYUGYWRW    
VHVAEVP         : GXIHUX          PJVGL           VSEEHADWCFPEFDL GPLRWFNO       
UEYRJTG         : HQRADDYARC      RHIY           
EDKJ            : VALRWBDRV       BPTHHSVYCGCJ    HWDPVHLUGYWLFG 
BGCOI           : YTLUHLIJFHWC    EIIH           
HGHWCO          : DUEA            IQJUDHGAQ       OHCUEHDDQ      
EVQTSOBTIKP     : QETJU           RVVHQOGDDLG     GNHMNGEQTFXYA   IPPWUQEN        NFFGEVMLUDLJLVW EWEW            OGKUWD         
EURQG           : JIPAA           RPQUPVXE        FXYUYX          UBQHHG          UUMELA          OMJTGGTE        MPMNHNMJH       EJJFRG         
EURQG           : XYTYDKVGWEIHD  
RMIIWVRDDPI     : CYRKSQPJ        NBTX            UNGWDU         
MMQEJLS         : UVNL            SOUFQHWOUUTDV   UYYVKXKJIQ     
HBWXSDUKTD      : WWAQQURATE     
LRYWPU          : RDTRBSNCRWBPKJ  WOSVNTEQCVE     NYRPSSLRHTNO   
SBGBVTQOACAU    : UQMHMC          GFHU            CXJWMBNWRY      KNOSHADLSRNDP  
HXLHQOEEIHUVAW  : FXKQESYXKG      XUJRGYUAJXVWWF  YYSYIDRPSIVA    JALLS          
PTMKWUOSQF      : TUJNWEELPGIQF   WXDK            VTBJYLPMG      
QHJLXTKJD       : KIFMLHCGW       FTSLGKICMLPEUA  KBRGSQWRFFVLJCF
AIHKP           : NGEPFRAVEMNRV   RSLMPPWPY      
IPCE            : UOVUFA          QVSSBNMUGSU     BAOXAVGHVJT     PPYTW           UNBGEIEOO      
XQUVLJ          : YCWUQYDRLEYDIU  MFIPHWUS        BBDHYDGSFH      TGWUPCIXLWSCSO 
FQBVAMKXIWH     : WLDQDYKHAIOHSNU JSJRNYQ         QRNMR           MKRTN          
AJWITMNC        : IVTA            SCJVVO          VEBBLFYFVRMU    FPPOBQQNSLFDT  
RIOPBJNNSFU     : FKQLVB          SCHR            JCPHDI          FXHG           
IQJUDHGAQ       : XIEUUDQOTBMB    HGHWCO          DPAREJQQCF      REHB            HMYCHAX         JIMBHUTEKMRW   
BARJVEYBLQ      : QAEJQJNYUXWBV   ITVAIOEI       
BGLKW           : SKBGMWVQCND     FIVLFWHGKBFMEWK MCVANXCRXIMMA   OBLRLWHCMHEYAK 
GEVRMOEJSNPS    : AFTFR           GKJFI           URYMMF          USNCMFTTTKRGMO  BMAHFSBFPT      FOPAAKYRB      
KVHCFEJ         : EOMURXI         BVEHQ           QVQHTEWWLQQV    BBEUQS         
HUWQ            : CLNSL           OHTNWRNWKSDSKV  EOMURXI         SLENPJOSX       OOWBKRPVECA    
GELDHRHDL       : URLM            NPAGSEQNLD      BPJRRPCAD       WHBNLBWBXW      EWEW           
SPFNEVILGFSLMYU : BRHPKVOIMO      SGERDILCJGIFYF  NYRPSSLRHTNO    IGCPFV          PPYTW          
GPQAO           : YHDTCPKWDWFLDRF RIWUYXXM        YWOVYIT        
GACOTJTFFM      : HTSLTMCYPOEHJC  KUWKGIS         XUYUIUNOQUSFPA  ERDALC         
LCCHLNP         : YKYMJOPJLCQPLKF YBGG            IJHUVBYYPMKR    ULDUNNGJCIVJRU  UKKSERC        
GBDIXWQQQ       : QAEJQJNYUXWBV   NNJKDFMNB      
FPAHSODCII      : QDNKVM          TRDCUESVGQENP   WUHROOFYGF      EOLCQYBO        CRVSLWTLJQUH    CDLJOFUJEXWFW  
XGVAKFLXUEHYKP  : SCJVVO          YNGHCROEA       BWKDHQLMS       ADBRAMMEJ       IDOIRK         
JIPAA           : EURQG           VJWWLCUQ        UWTOXBXBYDDN   
QAEJQJNYUXWBV   : BARJVEYBLQ      GBDIXWQQQ       KSVTPVBCWLBY    JVOMDI          UTRIFGHNVD     
OBNMYUVAFNYOWPP : GJVYSKBSD       VGSWXQMNKRPLSXU
MIBTTRD         : NLHPP           UXCONTRYKRMI    MDAMOWOBBXAH   
SXISCESQGI      : VTPCJW          HTXIWBRS        NKWGQENOCVFMELV ONIGYEHID      
FDCF            : QSUIGD          GWRIUPTJE       XMODHYJGVRFS   
RGXOVPNL        : QSUIGD          IEKQIVRLUMCIHY  YUYCNIDD        VPMRSQGCFTQQSG  YGMBKGLTUFUB    UKUXHI         
OFTIKBCJJUNOPG  : UNHYKKTSJ       VXLLJ           FNFTIC         
XLCEPJMI        : URXDKDYFYVEAOOT MCKQTKM         KNOSHADLSRNDP  
MYOEPAEG        : SNJTADGYSJUBMYW GUYCTBYLAP      ASCURW          SWXNJWJUHRFJWF  TINWLBFRN       NWGWLKIAQ       AHKDY          
XPRCTDLOQCG     : BNVOAFYMYFPCV   LGAQMP          VLQOWWDGUH      HPUXDRBKUDNBEL 
YELDKDOX        : NXACGYLJNSRJ    EIWSXUIIKOBXJR  FSWMYC          KPIK           
HMPVTFXXLFY     : AGURDPYSJM      LEJMMADGVIEWI   VBUJFQFKBBNYNGD
WBUBOLTRRTSYHYJ : GQDLJPAISXCQJV  BDKGTCN         LOLWRY          RKHTFCOD        SNIDFXOAYL      ULYXBOY        
NJBUY           : NYWWXEGBCRNUU   LMJSRKP         MVLEIK          MOJHYSLENWC    
SSXSQJ          : TYRSEUKQVPBGW   UDYYRCWN        USOUP           KQKLPNHS        VGSWXQMNKRPLSXU
PNXSKB          : GWUJTF          NYYNIHKEDWKNV   QIVW            VWSKEMDKTJF     ILQAYJYIWESOTSF
WWAQQURATE      : HBWXSDUKTD      OUJXHF          QJUHUPXDYBK     UUHHNCUJB       BTPW           
IPQFOJBHHTB     : QDQROTREAUFHKY  TYRSEUKQVPBGW   MOGFETPYDQOM    GQNS           
USGU            : TUJNWEELPGIQF   UWWYPJQSLAQY    SNWHIMMWS       CWTABDQDFN     
RVWQUWJMTEOOIC  : ITSLJRWHSJT     QSOMKHMGSVR     MTCQUMAL       
XSGPEHW         : MCKJ            VPMRSQGCFTQQSG  UNNOPWQGGVOAOF  IGVIEESTFNJRX  
EAFYTNVIHRFAOE  : UNHYKKTSJ       QCLRLSMSPMCDNPP NPOMEEUIXF      NRWEBIJQWEXJ    TVRVDBP         CVUCUAV         SCFHE          
BXOSOYUNWQUMU   : WAFFISVNGLWNAW  YBMQXBDFSCYV    BMNLNSVEXTMPN   VQKLMTVFS      
MJIOQJKEFSOYAOO : HNISBGSFCVQMDFG MOKLGTUPLBMSCNQ RXMFQWKLEBJKWP 
BRHPKVOIMO      : SPFNEVILGFSLMYU CIFXGLHFNIX     ACNSEXATOMDU    AFSBCA         
HDVNRFWHXIRFQN  : QROOCH          HNHBSID        
PNKGW           : IAOREWTHRWPHPDI QNCTSCKVD      
BECNATVMKWV     : LMJSRKP         SNWHIMMWS      
TKGBJPCRHH      : UGTQ            TVRVDBP         JSJRNYQ         TTVMEHVBD       BIJXR           TVGRJGYKPBVYFCK
UDBLNJIA        : OLHSLCJM        SJQGNYOWXAXBKED YPBCRWK         FTSLGKICMLPEUA 
MFBOBWCLWAYQ    : VQNR            RBMQWJW         BLTSOIMCXM      GKLX            ADMHPHLJARARMAE BXYUE          
HTVWVOFF        : BIKBDCI        
CICPYOAYBMGCE   : WUMFMR          FWQGAUO        
CISYIU          : ADBRAMMEJ       AISUTLPHKGXAK   DCVITWFDT       HPBJG          
VCLRC           : WYEKQMFIIOTQ    BDKGTCN         NTTKRUP         WAJVPFAUQ      
IJRKNBOECDE     : BYJSLNBEP       SGLKINFFEJX     LMAGYDGYPVEYWO 
HTKJXRNGNMQIEO  : DINMNSPWLPAY    VUKNTYE         KLGX           
SHQFRAWEOATU    : PMSCWC          RKHTFCOD        PBJAXHU        
YBGG            : PJGOX           LCCHLNP         MOKLGTUPLBMSCNQ LMRJKJARP       BRQRH           QHLNEVVHCKNTRLQ
QSUIGD          : FDCF            RGXOVPNL        MVKJB           TQJYQSGTYDIHVYQ LNBQD           LUNRINKBPS      KLGX            BBDHYDGSFH     
QSUIGD          : UHJNQFIGEPGYTJ 
VUGAJVUSMANNXRE : EYQTKDJ         HMMBADKAUODI    DTLUMIG        
NBDNCJVACQ      : DIJWUQJYRDSFWE  RXOF            WSFJDFDCPNEW    RRKGKIYND      
KXYJTV          : ESDTIUXMFD      FITESISDHLMGJE  VOUHUDF        
VHNRDDTQ        : QETJU           LRVPP           JXQH            HUQRWNSSSPLL   
RIWUYXXM        : GPQAO           VAKPCSPJQ       NCFQMICFR       GIUACNSEWBDVXO  XHJGDVOCEKPV    NWEYJCKJBEIGR   PRIIUBP         YDMT           
RIWUYXXM        : QHIYVWHIEKLUWHM
JKCNCXXAYJVWE   : HQBAGCBBN       SQHPC           IHOSQ          
GRLJU           : HTSLTMCYPOEHJC  SUFYRVYWKBBBJ  
CNAN            : UXCONTRYKRMI    FSPVF           XLWJ            RQXUKHJVOAACUIM BDRXYA          TGTRLFFL        JRIJYYI        
WMMWBPI         : OEVGKIW         GXIHUX          AHSARWHORRMH    XOUCD           PSUIARPIA       BIFPQRGLWYO    
TVNTUPUGNRKIBFV : WYDSWOXUJBLYX   LYYJXUU         QSOMKHMGSVR     VTIUOEF         JAYDW          
CEPSHDHER       : RIBUMWH         OWHKHKSOX       ATQKDH          QDMYM          
CSMKEI          : WUUPUDHKWS      HWNXJAF         ULYXBOY         XJROITC        
SDEKX           : JCPHDI          FGMUYDEYJMMIX   MIFRGCMPJDUFOV 
YSAHTHDILIXE    : SOFSTSU         INQADG          FXHG            BIFPQRGLWYO     QWHSF          
DOVULAPALUIUPNB : NJVRUADUJLNOG   JRBEH           ORPUENVCBD      BGKTQOS        
MNYHNIDWMLJWMP  : YJYWB           VTBJYLPMG      
PEMNRNDRBA      : BNRLLADML       BTNY            LSLATW          ECYCF           LFPSNT          QBSGITPCXSUIIGT
VPQWSFMTM       : VNEIGSLWU       IFST            FKSKLESJUEESDWG MENRPUISHQILH  
DPAREJQQCF      : NBPMPXCN        IQJUDHGAQ       PROQRVOWOEXARFB IJLGKLIKWHX     SGNO            YSWDAXSFKO     
ITVBHCUI        : CKRDP           IHOSQ           BNKESRTAURT     WDASRGTK       
AGURDPYSJM      : HMPVTFXXLFY     FCPMUBHT        ESXNMDJFQRQ    
OEVGKIW         : WMMWBPI         NIBRKDAJCAONFTW VVEUNVPIJH      CFRY            HAESVAM         RYDXGFBLHKQS    IMTFQXAUXIFKUC  PVKLIKKDTLQCEFR
MEKUYIXGMVRRV   : JYDJEGXGWW      EJJFRG          GXYHKBBQVTPNBU 
MPEEPWNE        : UGTQ            BXBAR           TPRGO          
FKQLVB          : RIOPBJNNSFU     MEMBLVDYBJAA    HSEU           
WNPJ            : VYDR            ALCDKMMKUC     
OUJXHF          : WWAQQURATE      PJSKGNY         GXCIHDXR       
YERNTVRLUIP     : UXJHILLT        GWNMCWKKVVFOUP 
NBHYYK          : GHUTSHFYYJRDJVG BXWKDEPA        HYDHR          
VYDIKTDVTMELM   : QUPMYJQVT       VLQOWWDGUH      CWTABDQDFN      SDAJFHEIMGGSVY 
EACC            : MLYPIPI         PXWUVICCVKEHQ   OLQDHMEGJ       KWNGNDPXVBRII  
QXDGNQJWRIIFHJ  : KVWEXJQCUVPAJ   KVPEWAYCQCI     JDYXAMYKMLR     YWJQSWW        
RVCURWJXKVGO    : DSXIPMRJD       RIBUMWH         RVVHQOGDDLG    
LTTCTYKJR       : POJAXOQHJERO    BTFAUFOAOHRQDF 
HJFROODWGYCD    : VWSKEMDKTJF    
BNRLLADML       : PEMNRNDRBA      PNOVNQJJ       
IPQHBAYX        : KVWEXJQCUVPAJ   EFNCBSNEYSIQH   WYJFQH          BSBSEVCC       
JFDAWGA         : WYDSWOXUJBLYX   QGOWDVNOMMBUS   GPEPBOVILL      OIWSYT          XJROITC        
FCJBDYSQKST     : LRVPP           TVRVDBP         LPCEEBXTBOHUTL  KWNGNDPXVBRII   IDOIRK         
HQGWJQAMPAXBICE : BHDPD           RTRDAHKMF      
IEKQIVRLUMCIHY  : RGXOVPNL        JALLS           AFSBCA         
QROOCH          : HDVNRFWHXIRFQN  SSDTAQUKFCPYC   YHIWJCXBUXL     OOWBKRPVECA    
QAROBCSHHELTU   : VLEL            UGTQ            LGRBREXCB       MVLVRJNOMRGHOS  NJOHRDEJMKFFFY  XJSL           
QOHNDKVMLEEDVU  : EIGUGGPVSUXE    QJWPEDKJ        FIVLFWHGKBFMEWK VOQMIHQVRIMDFE 
DNXDFPHHIOQ     : QWXDHGC         VGWBIVUMT       FDGHLNQMJBM     PBJAXHU         TTBJRANDPLU    
BNJU            : SXEOLAJWKJTMKXJ WFEQCLLMDOOLDE 
AFTFR           : GEVRMOEJSNPS    NBFQIRDQYXB     BQRDHGJBDGI     OHLBNDCQRUPSBWN WWHCUBTE        EVCGXUNNDAM     GIIPOSEXYWTAWVI NQTWKANUVTCAMT 
AFTFR           : OPUQDUFBQ      
UDWYGSVOWJM     : ESDTIUXMFD      TCVHPGCTDSJWLGW ADLAA           TDNDFU          TBAJRPLFDEQPN   MUVKEVJFUUQEL   SUOBTSI        
REHB            : IQJUDHGAQ       USNCMFTTTKRGMO  RJCEDS          ODOOWCNWM      
WUEAIOWOQ       : QXPAXYDRBUE     BIKHAIXUMDBTUH  QJUHUPXDYBK     KSVPPPKMESYBP  
KYTDTY          : YNGHCROEA       SDAJFHEIMGGSVY  LSUTT          
UGTQ            : LDGEQMM         TKGBJPCRHH      MPEEPWNE        QAROBCSHHELTU   HCENL          
SCJVVO          : QXXS            AJWITMNC        XGVAKFLXUEHYKP  AQMVNSMKSNGNA   UNBGEIEOO       HCENL          
XECUIEDYC       : ETHBN           GHGYWMLVLJSI    ARCADBK        
SGERDILCJGIFYF  : NXACGYLJNSRJ    SPFNEVILGFSLMYU XLWJ            MCVANXCRXIMMA  
DPWAECAKHUS     : DJVIOJMHRYLM    QSOMKHMGSVR     SNIDFXOAYL      XGPVAKQYXHAI   
AUPT            : MCSJYNHIDQLW    FBTTHTV         ODOG            ODYFSRJUM       WDMHRQTFS       FITESISDHLMGJE  OTPRTGURSCP    
WXFAGSERBNACSB  : CPKGN           YNGHCROEA       SUFYRVYWKBBBJ  
IXHO            : SDSPTO          QAKHOQK         VTPCJW          XGKLSDHYWWXFU   SJQGNYOWXAXBKED XGPVAKQYXHAI    IMTFQXAUXIFKUC 
JBJEUXEP        : JSJRNYQ         CDNHYLSDNAACEO  VAARYHXSQPV    
XFMYKO          : UDGFJD          XTSWDYFCRXDHYS  EXNJ            GIIPOSEXYWTAWVI
FTAGH           : HDKEYGYIUMW     URLM            SYKUY          
ICDPNBXEFHGPOB  : NXUSRD          SNGQQREG        QCEHBVONU       VOUHUDF        
SSDTAQUKFCPYC   : OPQYPWJ         KHNRTNB         QROOCH          CQUTAIYK        HFWIVEDPRIXJQK  TRSLUVMCCEHSDCO VOQMIHQVRIMDFE  CEGIMXRJ       
SSDTAQUKFCPYC   : CTKXHVOE        XSKA           
IEGLH           : BTERA          
YKVDSEJISMXNHBJ : ETWMFSH         OLGR           
RETAJLYLJKSRVC  : TINWLBFRN       BAEDIDBJBH      OIWSYT          TRTFBVWVEDONAVK
WPMA            : KHQVILUKBEP     WWQBNJ          UYYVKXKJIQ      ORPUENVCBD     
QMQL            : MLLXDRPGQN      CBNWW           GHGYWMLVLJSI    IYUBEY          RDNFIXHOQYCNYAB
QCLRLSMSPMCDNPP : EAFYTNVIHRFAOE  JVIFLMTXYKDHUSK XDUFJPKATYF    
KHVNXSF         : GWRIUPTJE       GXINJLDMOUH     CTKXHVOE        MLUGVCVYK      
VNEIGSLWU       : VPQWSFMTM       LCBT            SNTBDAULCIH     QWHSF           VAARYHXSQPV     IDOIRK         
QISDDI          : GGYABQCDGQKG    GUPJY           KVPEWAYCQCI    
FLGXBG          : NIBRKDAJCAONFTW XATVLUWSRHRSFD  BEYLLYD         FYHATJQUCTEDFUI
LDXJXDWTQEEYWQV : PVXQQFG         DULBBFWHVBXLRJ  MYKEI          
NPAGSEQNLD      : GELDHRHDL       NUGLXWSSV       YHDDXIYFVY      PXWUVICCVKEHQ   HCENL          
LGCUTHSEGYD     : MFFFQATUXNU     EDETVPEMCPCCEQK VAGGKGPTDWJXU   LKWXR          
PHHREANXNDYWYF  : HBMMSQAMIWJDO   OPNOC           NCFQMICFR       ODOOWCNWM       DRHCPHCKT       YJYDVUONKJSU    BBEUQS         
MSSIFCMCVUWC    : SQXPWRKC        TQJYQSGTYDIHVYQ GDRQGDSGUVKNVXH
VGFOPO          : RFDPLMOEEUK     EPDDYMAUKTEPJWA UQBMANABQF      DTJNDWGXXFCFL   XTKLBBILOON    
UOVUFA          : IPCE           
CBBRNWN         : OGLSJJFCLECTN   CKRDP           FKLFJCKTLQNSFIC QNPAVDNCKAGQ   
CPKGN           : WXFAGSERBNACSB  PMWPPILDCTSNXK  IGXQYWXAKLCJNCJ
DQKAYQQ         : WNGTHAQBGXHHUT  RMADFAXKC      
HWLWSHEUD       : YBMQXBDFSCYV    YCWUQYDRLEYDIU  VLKYV           SIIAWAYEWK     
XHCNGPLKHWQVE   : EKUX            QNDLOWWJELTQQB  HDSS            DOPWMBJXEQWDK  
OPVPIOGPL       : JTEDMLJA        FBSE            QIVW           
OHCUEHDDQ       : HGHWCO          PKIORMTRSV      XFJQOAHGG       VLKYV           SGNJHHAM        TRTFBVWVEDONAVK CRVSLWTLJQUH   
QWXDHGC         : DNXDFPHHIOQ     SOFSTSU         MFFYMJNJX      
EIWSXUIIKOBXJR  : YELDKDOX        LFPSNT          UCSWRYWDJEKEDCO SBXLIFWER      
NNMXSPOB        : FMTYXBEO        JPCGFTJJJKFU    ETKBOV          DULBBFWHVBXLRJ 
OANXGRYMBXFBSP  : ETHBN           LFPSNT          AVTWOMY         XOSFKQMNMCLM    PLPI           
DENEQFJ         : SNJTADGYSJUBMYW OLQDHMEGJ       UPJWMPCPQ       YEXFDYGTBBR    
UXCONTRYKRMI    : MIBTTRD         CNAN            MUWTCWS         BHDPD           OUNBIXLFF      
FJMIHT          : AVDSM           SSSA            QCEHBVONU       CTBWC          
DJVIOJMHRYLM    : DUEA            MUJIIM          DPWAECAKHUS     WJWS            ETHBN           SGLKINFFEJX     DSTWLFBTLC     
QDNKVM          : HBMMSQAMIWJDO   FPAHSODCII      UAUD            TRDCUESVGQENP   WUHROOFYGF      PVKLIKKDTLQCEFR
NBFQIRDQYXB     : XIEUUDQOTBMB    PGFSVFSYOSMXI   AFTFR           PKIORMTRSV     
HWNXJAF         : CSMKEI          GAJUGJGSKDTH    QBSGITPCXSUIIGT KKJLENFMXYCAY  
BTNY            : PEMNRNDRBA      HQRADDYARC      DJAJIQ         
TMYPBVFCBVNS    : FHACATFXVLV     ICHSTWH         LXIOPBFHTXXDVG  QNPAVDNCKAGQ   
EUCHBLHOMSRR    : XIEUUDQOTBMB    VUKNTYE         SIUC            PTXLVYPRWD     
SNJTADGYSJUBMYW : MYOEPAEG        DENEQFJ         VAARYHXSQPV    
TBIODS          : ESADEQUYXPKIHH  PTWVIVIL        ADLAA           POJAXOQHJERO   
PCHCUBVOWMAQOE  : JEDOKGUIUGFEU  
OYJLAXMAAHBJXHC : VHDAAE          VBUJFQFKBBNYNGD
YEYDBCYPYNPQDVQ : GXIHUX         
VAFXBUXBC       : SLYYIQYGRT      MLQKPRERWLUYL   YDYVNC         
MAJOTIU         : LVMTHIGSNIET    NJVRUADUJLNOG   ITSLJRWHSJT     TPEJKTJKRJQAKSR YWBHRWVQTWN     UQMHMC          RJQSLXQ         GWXRAGNXRAHTCO 
LVWMNWBGP       : XTSWDYFCRXDHYS  IYKPHNEG        RDSRWGUY       
EIAAI           : WMSHRVIQOYMOM  
BJCYNEBAH       : DLHXULIIXIBUR   GUPJY           IYKPHNEG        RJQSLXQ         IKFVAP         
RBWOXK          : VDXTXISKCAE     DFDXRQQHWHHSHM  FFYUIHS         EPIMWNMPSPVRJP  RVDTBLUGTPOBIT  VQKLMTVFS       VANVME          HAESVAM        
RBWOXK          : DCVITWFDT      
UXBTB           : YMFBEOWKDXUHM   NYYNIHKEDWKNV   DLHXULIIXIBUR   MECUAY         
JHOR            : CFWFNPMQNEFQLLF MNLLBHFKXTXPC   TREGOIAPJWK    
QDQROTREAUFHKY  : HBMMSQAMIWJDO   IPQFOJBHHTB     YUYCNIDD        RKFSM           GBOLSTQGKJEFUPH
HNISBGSFCVQMDFG : MJIOQJKEFSOYAOO XSHIHM         
WLDQDYKHAIOHSNU : FQBVAMKXIWH     GUYCTBYLAP      YBVAIXWUUI     
CFWFNPMQNEFQLLF : JHOR            EEYCIJHBHCNVVMC GHUTSHFYYJRDJVG
ALCDKMMKUC      : WNPJ           
NPRSTWPCN       : QNYQCRCNR       ODOG            MECUAY          THNFAHDECBTPH   PRIIUBP        
OEVUJP          : GRSNSH          OOXXRNN         RDQBLKV         IYKPHNEG        NWTKNXY         QVQHTEWWLQQV   
WWRW            : FECWKKVE       
TCVHPGCTDSJWLGW : UDWYGSVOWJM     XUYUIUNOQUSFPA  LONEIEL        
IKLYOKWXA       : NUGLXWSSV      
UWXUISWE        : BDKGTCN         UUMELA          VALRWBDRV       RTKTJJ         
OMEIQYUNKBKOL   : AKTIHFKHIFF     JYDJEGXGWW      FYHATJQUCTEDFUI EKLAOMNLIETD    SWGNEKOPXOUWIY 
CKLMJJMNHMMCU   : LXKEOGTNHS      LQRVJQETC       SCHR            SJQGNYOWXAXBKED
BYJSLNBEP       : URLM            JGFFSPSCNKAN    IJRKNBOECDE     OLQDHMEGJ       RTDFBMYAHEFDJAN QJVIAEJUGXQSDA 
UAYHQKFTXQGHDV  : QLIAKJ         
KIMOFTRGDKRSOY  : LQRVJQETC       HBXJUBL         WSJAAKONKTAH    FYHATJQUCTEDFUI
MTLMBCYGVYAFJDD : VECAWI          BIJXR           MEVUPQOTCBK    
PNTGSNXY        : SXHKGHYMCFJGX   MDAMOWOBBXAH    YYSYIDRPSIVA    TBYXPNBJOCAJN   XSESUJKLDHW    
LSLATW          : HDKEYGYIUMW     PEMNRNDRBA      XTUUIDXII      
NIBRKDAJCAONFTW : OEVGKIW         FLGXBG          OPJJRHAASUUVU   DLQRMEANV       OYJFMCATE      
HQBAGCBBN       : JKCNCXXAYJVWE   PJVGL           ONWNRAWPEHWAFKY VGWBIVUMT       NUTSMSHWEI      PSUIARPIA       BLTSOIMCXM     
NPOMEEUIXF      : EAFYTNVIHRFAOE  PTWVIVIL        KNOSHADLSRNDP  
BQRDHGJBDGI     : AMSXFUKG        AFTFR           DQIUOR          QOJPPBPODRW     IGVIEESTFNJRX   ITVAIOEI       
KIFMLHCGW       : QHJLXTKJD       VJWWLCUQ        LFPSNT          WPYFGBVD       
WJXDEIELXHDQ    : TTMPVURWGMCXYKN VUKYMTHS        BPFRWYFUSUTDO   QBWDCOTCLJUWUMH
KWVMCD          : DXCNVPVTY       LEMOWOWYPXYC   
YNGHCROEA       : WHCCSHPNDWDUGW  XGVAKFLXUEHYKP  KYTDTY          WXFAGSERBNACSB  KTFBHP          XSVN            PNOVNQJJ       
AYWAFBJJ        : XOKLVQEBFQR     KSVTPVBCWLBY    NEJAXFFQDRRDM   FKSRXQ         
HQRADDYARC      : TUJNWEELPGIQF   UEYRJTG         BTNY            JGNCXX         
ODUWKYRBDTO     : DCMNQELGTRUNLU  RFAKEIDAMAQFYF  XXKXHHTQ        NFFGEVMLUDLJLVW MXQIOWLGIQYEVT 
TLFB            : ILGGTPWQ        ARCADBK        
OMCYFVYIBBKSDP  : ONWNRAWPEHWAFKY PNHKS           FPPOBQQNSLFDT  
IMJVL           : YBBVXELEUBWNS   JFEU           
WQVMVRACSPS     : SKBGMWVQCND     XJSL            AODTBFAJIEC    
TTMPVURWGMCXYKN : WAFFISVNGLWNAW  WJXDEIELXHDQ    GYIYXTTYI       OOWBKRPVECA     BBTVEDUP        YGMBKGLTUFUB    CWNQSHEKN      
GYMGSKUO        : WBLLI           LDGEQMM        
USWKMEGGQWEOQB  : NUGLXWSSV       HOFKNC          SNFQPS         
FDWFQKQ         : HKDQJ           SMTDYAXIX      
MFFFQATUXNU     : XRYUPOIAWBYMRKG OGLSJJFCLECTN   LGCUTHSEGYD     OYGAHR         
CYRKSQPJ        : RMIIWVRDDPI     YRLTUIOFQLHS    GUPJY           AEQT           
QGOWDVNOMMBUS   : KHNRTNB         JFDAWGA         LGAQMP         
LUCGURBGT       : XMPGYXBV        TGWUPCIXLWSCSO  RXMFQWKLEBJKWP 
AHXSWHCNNQM     : MEHKRXQQ        SWUKPAM         ERYVTVWQ        WEVNADO         DOMGHETATIWJ    TSMABDVP        OAWQBDO        
NAJCPMWKU       : ICQBNUOLYKQVAS  GUWWWKWMMBF    
FARDRU          : DINMNSPWLPAY    SRMVIBIKYQJ     FYYWJK          LEJMMADGVIEWI   VSJXYPKTXY     
OALVXESFGIUY    : ETWMFSH         NYXEBNAQW       TAOJMIJOSXFPWRP
OOXXRNN         : OEVUJP          MACSYVASUQB     TBAJRPLFDEQPN  
XICGIVLDQWRRKNR : WYXEYEUJKJI     BSBSEVCC       
IXYSUXQLNRMH    : HDVINVSLRHRCOC  LMJSRKP         XXKXHHTQ       
AXGIAO          : BGUAHXXF        SIUC           
XAWPYOJJEBAO    : NJOHRDEJMKFFFY  GUQI           
YJYWB           : MNYHNIDWMLJWMP 
MUWTCWS         : UXCONTRYKRMI    SMTDYAXIX       BFGLM           ENSFFHJUJQUU   
GUYCTBYLAP      : MYOEPAEG        WLDQDYKHAIOHSNU BQPMQOMTPFNXYBP CDNHYLSDNAACEO 
JVALKEMVDKW     : YAQXQALSLOQ     OPUQDUFBQ      
YRLTUIOFQLHS    : NPEYJYIXV       CYRKSQPJ        FVDRPBLK        CVXEGTESLGNCSE  NSHBADOKLQ      BGKTQOS        
ITSLJRWHSJT     : RVWQUWJMTEOOIC  MAJOTIU         QBSGITPCXSUIIGT
VQAINPIIBEFKSM  : AMXW            QJUHUPXDYBK    
ETWMFSH         : YKVDSEJISMXNHBJ OALVXESFGIUY    QCEHBVONU       SCFHE          
FCPMUBHT        : AGURDPYSJM      MHONX           LEJMMADGVIEWI   LMAGYDGYPVEYWO 
XVKNLUVNYDATQ   : EULIO          
BMCPRVYMBBDP    : VTDRBMKWSQU     IXAPTIEQXMPDHSQ
GWRIUPTJE       : FDCF            KHVNXSF         EHSOTUFPWBRPC   WDMHRQTFS       FYHATJQUCTEDFUI UUHHNCUJB      
HTSLTMCYPOEHJC  : HDVINVSLRHRCOC  GACOTJTFFM      GRLJU           TYRSEUKQVPBGW   GKJFI           ODYFSRJUM      
VFIBUJ          : AGSLSFUYU       GPLRWFNO       
SDSPTO          : IXHO           
XGJTYUNNYOGN    : AIFHNBRBWKORSG  LWIF            WNGTHAQBGXHHUT  HSEU            BGKTQOS         CMAMOAKRFRWIJG 
NYWWXEGBCRNUU   : NJBUY           GGYABQCDGQKG    PIBO            OAWQBDO        
MOXO            : EXNJ            XKBUIGVKKY      XXKXHHTQ        TGTRLFFL        HDWTDRNDRL     
GXIHUX          : VHVAEVP         WMMWBPI         YEYDBCYPYNPQDVQ FKSKLESJUEESDWG
TPEJKTJKRJQAKSR : MAJOTIU         FYYWJK          UPJWMPCPQ       NHULIGCOOR      TVGRJGYKPBVYFCK
PMIDEIR         : GNWOMWCFF      
PRGWMGUGVBP     : VTPCJW          EJJFRG          CYQCKWMBY      
VBVPKMPX        : GWUJTF          SVNGDA          RJXL            SFBBLN         
JYVVHYC         : PJGOX           PSLBANVWAHAUGED OLHSLCJM        SIUC           
SXHKGHYMCFJGX   : KFCIMPDETXKBSUV PNTGSNXY        PMWPPILDCTSNXK 
EYQTKDJ         : VUGAJVUSMANNXRE VAXWIVLLCA      GIIPOSEXYWTAWVI PVKLIKKDTLQCEFR XMODHYJGVRFS    TNEDGOONWMTQKCQ
JSJIQSJV        : BGUAHXXF        WAJVPFAUQ       DXOKUFEKBL     
DTUPACPOGW      : MFIPHWUS        SGLKINFFEJX     VANVME         
MUUQULKHR       : NLHPP           YVNITYTHPJKUKW  ARHLLEDRPHSL    MPMNHNMJH      
RDQBLKV         : OEVUJP          MOYCQYF         BBEUQS         
GGYABQCDGQKG    : QISDDI          NYWWXEGBCRNUU   SJKT           
YBMQXBDFSCYV    : BXOSOYUNWQUMU   HWLWSHEUD       LGRBREXCB       MVLVRJNOMRGHOS  KXCHODXIPTLU    KLGX            HDSS           
CIFXGLHFNIX     : BRHPKVOIMO      SWXNJWJUHRFJWF  RWVBUUDUNY      UVTPVBFXGWWJJDQ SDAJFHEIMGGSVY  HLRSAYEFGVA    
OHLBNDCQRUPSBWN : WUUPUDHKWS      AFTFR           XFJQOAHGG       HQXPV           VEBHIGRINVBQJMF
WKXYUEABPHIE    : EXNJ            TSEKOURLBQKN    FHLVXXJX        VJDSMFQCX      
GXINJLDMOUH     : NPEYJYIXV       ICXQ            KHVNXSF         BDRXYA         
MCKJ            : XSGPEHW         VALRWBDRV      
PIBO            : NYWWXEGBCRNUU   MLQKPRERWLUYL   EQIIAJHWHPRUJX 
VUKYMTHS        : CCKDIPJSYY      WJXDEIELXHDQ    LUNRINKBPS      QJVIAEJUGXQSDA  JAYDW          
NRWEBIJQWEXJ    : EAFYTNVIHRFAOE  DPCXPCIOLNJ    
AVDSM           : FJMIHT          XKBUIGVKKY      EMXBX          
VDXTXISKCAE     : RBWOXK          PVRWWDF         MHKUIG         
QVNWYVGPVNN     : RHIY            KFILB          
GQDLJPAISXCQJV  : DUEA            WBUBOLTRRTSYHYJ OPJJRHAASUUVU   SVNGDA         
LXKEOGTNHS      : PKIPCSR         CKLMJJMNHMMCU   CKUDNLLMSQ      EOLYVN         
XOKLVQEBFQR     : ICXQ            AYWAFBJJ        YVNITYTHPJKUKW  BYQILAPTCTBPBA  PXWUVICCVKEHQ   GGPYOPIHBFCJ   
YMFBEOWKDXUHM   : UXBTB          
CBKUXILIW       : TGWUPCIXLWSCSO  YBYVNIQIURSSY   VNPRLFB        
BDKGTCN         : MLLXDRPGQN      UDGFJD          WBUBOLTRRTSYHYJ VCLRC           UWXUISWE       
PTWVIVIL        : TBIODS          NPOMEEUIXF      BVEHQ           DCVITWFDT      
DVJI            : RLEOGWEKMJHI    IYSCOUKDHQBKAAV
KUWKGIS         : GACOTJTFFM      AJLPFYI         FFHYEQIFLWVF    MUVKEVJFUUQEL   UGPXNRCDGH      AIWEDLAVRROF   
TVIE            : FBTTHTV         VHDAAE          BPTX           
DJQXBMWWVTHJPMH : UPRBBPA         WOGG            TTLRJGOFL      
UHLREVXO        : GMMTILMCMP      SDJRQRYDVFDI   
DINMNSPWLPAY    : HTKJXRNGNMQIEO  FARDRU          MVKJB           RXMFQWKLEBJKWP 
WWJGIY          : MACSYVASUQB     MOGFETPYDQOM    VGWBIVUMT       BHDPD           WMMIOQPJXEHMY   RYDXGFBLHKQS    KWAVNAX        
QYPAMHFLGVCJF   : LOLWRY          DLQRMEANV       NWTKNXY         SNTBDAULCIH    
VUKNTYE         : HTKJXRNGNMQIEO  EUCHBLHOMSRR    VTDRBMKWSQU     XFJQOAHGG      
XTSWDYFCRXDHYS  : XFMYKO          LVWMNWBGP       EUGABV          UIGDEOEQG       SGORSAKVAY     
EEYCIJHBHCNVVMC : CFWFNPMQNEFQLLF WTJMXCR         WDASRGTK        NSHBADOKLQ      NKVYXGYIG      
MVKJB           : QSUIGD          DINMNSPWLPAY    UMSKMQE         KRWQYGFJ        BBTVEDUP       
RFDPLMOEEUK     : VGFOPO          RBXJGOUWMABSBAM EPIMWNMPSPVRJP  TCHPPPIHKVLICK  VUXIAT          GCTJQOEEC       GFRVJGN        
XSOHTYMKUKWYDMW : QXXS           
XXAPF           : RJMIHPE         FTYW            CXOBW          
IQSY            : WAFFISVNGLWNAW 
WWHCUBTE        : AFTFR          
SQHPC           : JKCNCXXAYJVWE   BIYURFBQFDFAHF 
OHTNWRNWKSDSKV  : HUWQ            ANFYKIFHRYO     ODQUHNJUKPHT    GCBUYWFDTRI     TSEKOURLBQKN   
HUQRWNSSSPLL    : VHNRDDTQ        OUCFMOYEIUDWBPX GYIYXTTYI      
BPFRWYFUSUTDO   : SWUKPAM         WJXDEIELXHDQ    DOMGHETATIWJ    VGSWXQMNKRPLSXU
XBSSKNLCNAUI    : TDNDFU          VSEEHADWCFPEFDL RSTDJYXRGSO     HCENL           WXXPASVOFHBR   
NUGLXWSSV       : NPAGSEQNLD      IKLYOKWXA       USWKMEGGQWEOQB  FSEFBBMF        LGUYEIFACLGQUJ  KMVSLLLKECCGP   CVAVUIFCKXMXUDB
AQMVNSMKSNGNA   : BIRCLYM         SCJVVO          NGHYFHQXA       OIUEFEPQCSRYM  
ADLAA           : UDWYGSVOWJM     TBIODS          DJAJIQ          IDWFAMEN        YSWDAXSFKO     
UPRBBPA         : DJQXBMWWVTHJPMH JILXMW          ADBRAMMEJ      
IWPJ            : PJVGL           RVNIL          
DFDXRQQHWHHSHM  : RBWOXK          VAXWIVLLCA      QDMYM          
JPCGFTJJJKFU    : VQNR            NNMXSPOB        ARHLLEDRPHSL    MTCNG           NPAKANULXXHL   
VEBBLFYFVRMU    : AJWITMNC        XYSHOFO         WSFJDFDCPNEW    GBXVOJVTJCWFM  
VNILURDWA       : HMYCHAX         GDRQGDSGUVKNVXH
SMTDYAXIX       : FDWFQKQ         MUWTCWS         WFGVLLMOP       QAKHOQK         DIJWUQJYRDSFWE  OMJTGGTE       
JYPQX           : BXBAR           HQXPV           XCIG           
OPJJRHAASUUVU   : NIBRKDAJCAONFTW GQDLJPAISXCQJV  TQJYQSGTYDIHVYQ STTDGLDBUVH     VGSWXQMNKRPLSXU NEYRUKSQXQ      QBSGITPCXSUIIGT
HNHBSID         : HDVNRFWHXIRFQN  FGKWI           KQKLPNHS        OYEF            VTBJYLPMG      
QBWDCOTCLJUWUMH : WJXDEIELXHDQ    PBJAXHU         QNPAVDNCKAGQ   
MCSJYNHIDQLW    : AUPT            YHDDXIYFVY      EDETVPEMCPCCEQK GUQI            CXOBW          
RPQUPVXE        : EURQG           UHJNQFIGEPGYTJ 
ASCURW          : MYOEPAEG        GISWIILMYBCQ    OCKXLQAJUSINTFS
YUYCNIDD        : RGXOVPNL        QDQROTREAUFHKY  BICIOLDIFLQGMC  FDGHLNQMJBM     TRSLUVMCCEHSDCO EULIO           LDIXSICHEQUCPL  FVMJUJMOWRGIC  
NGHYFHQXA       : AQMVNSMKSNGNA   NXVAFKSMVGSU   
NWMTNOO         : MEOPNPPLUYBO    TYQXGTFNTPJ    
KHQVILUKBEP     : WPMA            RHYJJBO         TLTUL          
TDNDFU          : UDWYGSVOWJM     XBSSKNLCNAUI    RVNIL          
VSLKIIYDXORR    : SWDSWQGNIEAB    SNWHIMMWS       TWVCCFYWSWE     YJYEAOVBIMOBXWH
BIWKWSWXWNFS    : VPMRSQGCFTQQSG  FBSE           
SWXNJWJUHRFJWF  : MYOEPAEG        CIFXGLHFNIX    
PWYSG           : AJXAVAKEDPNVDS  RBUK            GMMTILMCMP      EMXBX           WYJFQH          MPMNHNMJH       CQXM           
DDOBDNQIJJDG    : VFTMXKYRDFKHRU  AKTIHFKHIFF     VSEEHADWCFPEFDL
TPFDN           : MLQKPRERWLUYL   VLKYV           PVXQQFG         OJSOIJBE        LONEIEL        
WUXUBXM         : JJIUKIIBJANYAPM RSAICCBTI       SHAABD          VBUJFQFKBBNYNGD XURYJGYSOP      WFEQCLLMDOOLDE 
WFGVLLMOP       : NPEYJYIXV       SMTDYAXIX       UCSWRYWDJEKEDCO
FXKQESYXKG      : HXLHQOEEIHUVAW  LGUYEIFACLGQUJ  SJQGNYOWXAXBKED
AXAVXUYW        : ICXQ            GMLOLVMHNWWCQL  KPIK            WSJAAKONKTAH    HWDPVHLUGYWLFG  OTIGRIYD       
YVNITYTHPJKUKW  : MUUQULKHR       XOKLVQEBFQR     RJMIHPE         TPDLBF         
OPNOC           : CKRDP           UDGFJD          PHHREANXNDYWYF  TMJADK          YWOVYIT         BBDHYDGSFH      BIFPQRGLWYO    
RDTRBSNCRWBPKJ  : YKYMJOPJLCQPLKF LRYWPU         
LGRBREXCB       : AIFHNBRBWKORSG  QAROBCSHHELTU   YBMQXBDFSCYV    AHKDY          
SQAHUVBXSTBLJD  : CQUTAIYK        QDMYM          
GHUTSHFYYJRDJVG : NBHYYK          CFWFNPMQNEFQLLF RTDFBMYAHEFDJAN SGNO            ABCIYINMIMG    
RWVBUUDUNY      : CIFXGLHFNIX     LPFSOTA         CMAMOAKRFRWIJG 
BICIOLDIFLQGMC  : YUYCNIDD        BQPMQOMTPFNXYBP QJVIAEJUGXQSDA 
SLYYIQYGRT      : VAFXBUXBC       CHMUPVYGJIOFNV  VJNDO          
WOSVNTEQCVE     : LRYWPU          HWQYF          
GJVYSKBSD       : OBNMYUVAFNYOWPP UMSKMQE         PLPI           
RFAKEIDAMAQFYF  : ODUWKYRBDTO     MDAMOWOBBXAH    MLUXQMG        
DXGYEQIOOHJALC  : UVNL            WXWGJBWBNJGRRIR ABGEMPRV        FREHKNMQSF      DTJNDWGXXFCFL   IXDTRRSYTIJXH  
BWKDHQLMS       : XGVAKFLXUEHYKP  BLVJN           VWRTDWXXQ      
PKIORMTRSV      : OHCUEHDDQ       NBFQIRDQYXB     GYIYXTTYI       AJLPFYI         TBYXPNBJOCAJN   RDNFIXHOQYCNYAB
MEMBLVDYBJAA    : FKQLVB          UKYNKAFAF       DRHCPHCKT      
DJPRWI          : LVMTHIGSNIET    KIBDJSLDPJ      FFFJMHTHPFPK    NHUXA          
OUCFMOYEIUDWBPX : HUQRWNSSSPLL    UCSWRYWDJEKEDCO XGPVAKQYXHAI    OTPRTGURSCP    
MEOPNPPLUYBO    : RTHNQHTBWDO     NWMTNOO         LFPSNT         
MJOHLTUBTBL     : UMEEMWLUMO      NMEKNHKJVO     
GISWIILMYBCQ    : ASCURW          BFNHYRDJQSEHL   MLQKPRERWLUYL  
OMRRDSE         : VJWWLCUQ        UIGDEOEQG      
HMYCHAX         : IQJUDHGAQ       VNILURDWA       SIGQGD          XMPGYXBV        XOSFKQMNMCLM   
LQRVJQETC       : CKLMJJMNHMMCU   KIMOFTRGDKRSOY  JDYXAMYKMLR     RTKTJJ         
VFTMXKYRDFKHRU  : DDOBDNQIJJDG    YHWODGNECNPFH   BXWKDEPA        MUVKEVJFUUQEL   OICIWTBGDKDREO 
SWDSWQGNIEAB    : VSLKIIYDXORR    BAEDIDBJBH      JFEU            DVWDJB         
VDDRKYFKKGC     : HFWIVEDPRIXJQK  AWNKHBRMHCMCM  
LPWEK           : UNEITW          GRXQTOCLIRPJ    EULIO           YSBSRHHDG      
WJWS            : DJVIOJMHRYLM    IHNMJIKSFDDOVJR RHYJJBO         SJKT           
NBTX            : RMIIWVRDDPI     IHNMJIKSFDDOVJR VJUR           
TYRSEUKQVPBGW   : SSXSQJ          IPQFOJBHHTB     HTSLTMCYPOEHJC  EFNCBSNEYSIQH   BQPMQOMTPFNXYBP
VIXVOIP         : NJOHRDEJMKFFFY  RHYJJBO         DVJQASQJSBJYUB  LSUTT          
TMJADK          : OPNOC           PJVGL           XUJRGYUAJXVWWF  BPTHHSVYCGCJ   
DSSFKLLHVDE     : WOGG            ODYFSRJUM      
GMLOLVMHNWWCQL  : MDICFT          AXAVXUYW        OLQDHMEGJ       MHONX           YEXFDYGTBBR    
SQXPWRKC        : MSSIFCMCVUWC    JBKMMLYUWHAQLST STTDGLDBUVH     ATQKDH          OIWSYT         
VPMRSQGCFTQQSG  : RGXOVPNL        XSGPEHW         BIWKWSWXWNFS    TTVMEHVBD       NMOH            UKUXHI          PVRWWDF         JDBYYSQTALNSPFS
VPMRSQGCFTQQSG  : MENRPUISHQILH  
GDYIWNV         : JJIUKIIBJANYAPM TWVCCFYWSWE     IFST           
ETHBN           : XECUIEDYC       OANXGRYMBXFBSP  DJVIOJMHRYLM    UKYNKAFAF       BAEDIDBJBH      MTQOPB         
FSPVF           : CNAN            MLYPIPI         TKTX           
QVSSBNMUGSU     : IPCE           
XUYUIUNOQUSFPA  : GACOTJTFFM      TCVHPGCTDSJWLGW MORIYJPUMU      OBLRLWHCMHEYAK 
FVDRPBLK        : YRLTUIOFQLHS    FSWMYC          GIUACNSEWBDVXO  WQRXBYMUHVORU   IXYXMDGSQCVN   
YWBHRWVQTWN     : MAJOTIU         TWVCCFYWSWE     CSGIQOO         OTIGRIYD        IMTFQXAUXIFKUC  CPUWOVNTLXNHNO 
RBUK            : PWYSG           RXOF            KKJLENFMXYCAY  
PROQRVOWOEXARFB : DPAREJQQCF      SIGQGD          YVLWXLRWVRRM   
GKJFI           : GEVRMOEJSNPS    HTSLTMCYPOEHJC  LCBT            IBBKECWSYVT     EOLCQYBO        LSUTT          
BFNHYRDJQSEHL   : GISWIILMYBCQ    NTTKRUP         DVBHCLGSN      
FBTTHTV         : AUPT            TVIE            UAUD            JALLS           SBHBFDEBAKJ     LKWXR          
BYQILAPTCTBPBA  : XOKLVQEBFQR     KQKLPNHS        NWGWLKIAQ       MCVBYV          TPDLBF         
GMAAQHNMNQGJBDI : UBPWNMRECBBIJU  IPPWUQEN        BIFPQRGLWYO     AIWEDLAVRROF   
EHSOTUFPWBRPC   : GWRIUPTJE       TINWLBFRN       YBYVNIQIURSSY   OYGAHR          UVOCGHTGAHMH   
YJGALWJBKWSS    : LPELOLFIGLSWI   HYKEFACOLWXNVJ 
TVRVDBP         : EIGUGGPVSUXE    EAFYTNVIHRFAOE  TKGBJPCRHH      FCJBDYSQKST     NTTKRUP         DNLGAW          KKBKISFPNJXDXGD
UKYNKAFAF       : MEMBLVDYBJAA    ETHBN           BLTSOIMCXM      EOLYVN          PTXLVYPRWD     
YOGBCDND        : FHRYUECVFU      JYASJMYQNLA    
MVLVRJNOMRGHOS  : QAROBCSHHELTU   YBMQXBDFSCYV    BPJRRPCAD      
CDJJFOJHFRKJW   : CQUTAIYK        KVPEWAYCQCI     MTCQUMAL        EPGT            MBABBKJPAEN     TDAL            MCVANXCRXIMMA  
MNLLBHFKXTXPC   : JHOR            CFRY            TNRQEWFVHE      DLQRMEANV       XGKLSDHYWWXFU   IXDTRRSYTIJXH  
EXNJ            : XFMYKO          MOXO            WKXYUEABPHIE    CQRPHKYIPKDHXJ 
WSJNCQSVDCTC    : DULBBFWHVBXLRJ  GNWOMWCFF       IYSCOUKDHQBKAAV
HNFIWKUUFS      : XXKIGSFGRNP     GVQFOFCP        NJVRUADUJLNOG   FTSLGKICMLPEUA 
JATHODLNV       : UWWYPJQSLAQY    EIIH            UKUXHI          BTFAUFOAOHRQDF 
CBNWW           : QMQL            MJXYKJVSSBEDK   IFPYDSPYEK      KVHGSH          GWNMCWKKVVFOUP  VVCRHPW        
CQUTAIYK        : ESADEQUYXPKIHH  SSDTAQUKFCPYC   SQAHUVBXSTBLJD  CDJJFOJHFRKJW   GCTJQOEEC      
LIFSBS          : AIYIUDSQM       ADPHBBGMWSR    
EOMURXI         : KVHCFEJ         HUWQ            LWVN            CWTABDQDFN      AIYIUDSQM      
UMSKMQE         : QETJU           MVKJB           GJVYSKBSD       MOGFETPYDQOM    AQDAFVTRTCUCO   DULBBFWHVBXLRJ  MGITPOWMEB     
JBKMMLYUWHAQLST : SQXPWRKC        ILGGTPWQ        LSWAIKND       
JIMBHUTEKMRW    : IQJUDHGAQ       QDMYM          
XNPBXE          : HOFKNC          APFIXRMTP       GFRVJGN        
JDIGLJYYEUOO    : SIGQGD          NVMDKHNH        UETVSPHBO      
BRNXLTKYNH      : WYEKQMFIIOTQ    BIRCLYM         BBDHYDGSFH     
LWVN            : EOMURXI         BBDHYDGSFH      OLQLJOWH        FXHG            FHLVXXJX       
ABGEMPRV        : DXGYEQIOOHJALC  YRICL           CORAJAOOFUVW   
QAKHOQK         : IXHO            SMTDYAXIX      
EKUX            : XHCNGPLKHWQVE   UUMELA          XYTYDKVGWEIHD  
TMFBADYPAATHGG  : XJKGKYDI        RJXL            DPCXPCIOLNJ    
ACNSEXATOMDU    : BRHPKVOIMO      QVQYQWMFDE     
XTUUIDXII       : LSLATW          YBVAIXWUUI      PBNMMNULCIXG   
BIYURFBQFDFAHF  : SQHPC           ONWNRAWPEHWAFKY
DWOIROJNLEVOEH  : LMJSRKP         UXJHILLT        KKLFBK         
BIKBDCI         : HTVWVOFF        UVTPVBFXGWWJJDQ YCCWDJUMJTVSYMK VSJXYPKTXY      JTVOG          
TQJYQSGTYDIHVYQ : QSUIGD          MSSIFCMCVUWC    OPJJRHAASUUVU   SFAYRXXSI       TGTRLFFL        BIFPQRGLWYO     QIVW           
LWICBPCFAOGDQQJ : NYXEBNAQW       OLQLJOWH        MCVANXCRXIMMA  
HUNYPUSOXDW     : XUJRGYUAJXVWWF  NGEPFRAVEMNRV   TLBRDC         
DPGONQSOGUTILC  : JRBEH           UIGDEOEQG      
DTWRDTGCJB      : FGMUYDEYJMMIX   TRTFBVWVEDONAVK
YBBVXELEUBWNS   : LWIF            IMJVL          
LOLWRY          : WBUBOLTRRTSYHYJ QYPAMHFLGVCJF   IDWFAMEN        BGAPDKVIFI     
NXUSRD          : ICDPNBXEFHGPOB 
BGUAHXXF        : AXGIAO          JSJIQSJV        TRDCUESVGQENP   UXJHILLT       
MLYPIPI         : EACC            FSPVF           SRFESWAR        ESXNMDJFQRQ     RRKGKIYND       BBEUQS         
BXBAR           : VLEL            MPEEPWNE        JYPQX          
FHACATFXVLV     : GVQFOFCP        TMYPBVFCBVNS    MCKQTKM         MYQNYQKRCEILBCD TFMKJJMFYOY    
STYBWNMXDX      : AKTIHFKHIFF     AQDAFVTRTCUCO   SGORSAKVAY      PLPI           
MLQKPRERWLUYL   : RXNWDV          VAFXBUXBC       PIBO            TPFDN           GISWIILMYBCQ    MACSYVASUQB     DQIUOR         
GMMTILMCMP      : UHLREVXO        PWYSG           KXCHODXIPTLU    NGEPFRAVEMNRV   TRSLUVMCCEHSDCO GOKHGISNMNWS    OIWSYT         
AFADDPRQH       : IAOREWTHRWPHPDI PSHDFDW         KVPEWAYCQCI     BXWKDEPA        UQMHMC          MLUGVCVYK      
GYIYXTTYI       : TTMPVURWGMCXYKN HUQRWNSSSPLL    PKIORMTRSV      SHAABD         
HWXBF           : BMNLNSVEXTMPN   RXOF            GXOFETLKBYYS   
PJVGL           : LRVPP           DUEA            VHVAEVP         HQBAGCBBN       IWPJ            TMJADK          HMMDQ           CVUCUAV        
PJVGL           : BDRXYA          LXIOPBFHTXXDVG 
LNBQD           : OYPKMOV         EIGUGGPVSUXE    QSUIGD          VGSWXQMNKRPLSXU FBSE            DSTWLFBTLC     
HMXOLHPLDJ      : WHCCSHPNDWDUGW  GDRQGDSGUVKNVXH MPMNHNMJH       BMROCBXDWL     
NTTKRUP         : VCLRC           BFNHYRDJQSEHL   TVRVDBP         THFVLEXQ        MLUGVCVYK      
LCBT            : VNEIGSLWU       GKJFI           BXSTYHPK        WUHROOFYGF     
YHDDXIYFVY      : NPAGSEQNLD      MCSJYNHIDQLW    AKTIHFKHIFF     HPXIEBL         JRIJYYI        
JILXMW          : UPRBBPA         LPFSOTA         MAJIOXHTOIYLV   WEFNEQGYAEXFS  
ARHLLEDRPHSL    : MUUQULKHR       JPCGFTJJJKFU    UPCSLXQXVNLYHOE VNCCDFQPRGNDJVD
USCX            : VAKPCSPJQ       HPXIEBL         AHSARWHORRMH    KVPEWAYCQCI    
LYYJXUU         : TVNTUPUGNRKIBFV WYVWTRYTIKS     FOPAAKYRB      
HSVEGVXNJMRPE   : MHEHTMRUW       HOFKNC         
WYVWTRYTIKS     : LYYJXUU         FUKUYTPCVBTM    SGLKINFFEJX     CJXMSOTPX       ENSFFHJUJQUU   
VTDRBMKWSQU     : BMCPRVYMBBDP    VUKNTYE         FGKWI           YYSYIDRPSIVA    UVOCGHTGAHMH    MKRTN          
GHGYWMLVLJSI    : XECUIEDYC       QMQL            TTLRJGOFL       CHMUPVYGJIOFNV 
SEMFATCTY       : FSEFBBMF        AIOMEVC        
WNGTHAQBGXHHUT  : DQKAYQQ         XGJTYUNNYOGN    VLKYV           QHTKIYHTLRIAUC  TRTFBVWVEDONAVK QWHSF          
THFMRIFW        : HKDQJ           FBSE            IGNX           
NYRPSSLRHTNO    : LRYWPU          SPFNEVILGFSLMYU UAUD            CSGIQOO         POJAXOQHJERO   
EPDDYMAUKTEPJWA : VGFOPO          XSVN            QNCTSCKVD       UNBGEIEOO       SDAJFHEIMGGSVY  JEDOKGUIUGFEU  
VVEUNVPIJH      : OEVGKIW         RALGRAACDIOAGI  HPXIEBL         TSMABDVP        CVUCUAV         WEFNEQGYAEXFS   UETVSPHBO      
EUGABV          : XTSWDYFCRXDHYS  GBOLSTQGKJEFUPH
GWUJTF          : PNXSKB          VBVPKMPX        WJOND           EYJQBHRDDA      IFST           
YWOVYIT         : GPQAO           OPNOC           RXOF            UTRIFGHNVD      JFEU           
MOKLGTUPLBMSCNQ : MJIOQJKEFSOYAOO YBGG            HSEU            EIIH           
WOGG            : DJQXBMWWVTHJPMH DSSFKLLHVDE     JRUDIJESF       LSPTACAPWGPI    BIKHAIXUMDBTUH 
NNJKDFMNB       : GBDIXWQQQ       IOPT            QSOMKHMGSVR     CORAJAOOFUVW    DWCMC          
APULXQHNCIAUMQM : SLENPJOSX       LEJMMADGVIEWI  
NDFVNTJXGOFSCHD : VQNR            JVIFLMTXYKDHUSK NJRN            MVLEIK         
YAQXQALSLOQ     : JVALKEMVDKW     RUFJUP          QFLOVHVIAIY    
FFYUIHS         : RBWOXK          OMJTGGTE       
DCVJ            : HDKEYGYIUMW     YGIRBPTM        BFGLM           ODOOWCNWM       MYKEI           UTDIAHA         ULYXBOY         RMADFAXKC      
CFVJKBIKUIBWWV  : TPRGO           YTLUHLIJFHWC    NWGWLKIAQ       SAUEO           TAOJMIJOSXFPWRP
LMJSRKP         : NJBUY           BECNATVMKWV     IXYSUXQLNRMH    DWOIROJNLEVOEH  CSGIQOO        
RIBUMWH         : CEPSHDHER       RVCURWJXKVGO    SIIAWAYEWK      RVQJOG         
BODMYGVJBEMYDIJ : JXQH            WYJFQH         
XUJRGYUAJXVWWF  : HXLHQOEEIHUVAW  TMJADK          HUNYPUSOXDW     SJQGNYOWXAXBKED SCFHE           IXYXMDGSQCVN   
YTILUPJGS       : OWHKHKSOX       TGWUPCIXLWSCSO 
STTDGLDBUVH     : OPJJRHAASUUVU   SQXPWRKC        URYMMF          UFAKYJS         QCEHBVONU      
SIGQGD          : KFCIMPDETXKBSUV HMYCHAX         PROQRVOWOEXARFB JDIGLJYYEUOO    EFOJYEIWBGHDIE  VJUR           
NJOHRDEJMKFFFY  : QAROBCSHHELTU   XAWPYOJJEBAO    VIXVOIP        
IHNMJIKSFDDOVJR : WJWS            NBTX            JTEDMLJA       
WBBGVE          : CFKQKTWQY       PBNMMNULCIXG   
FSWMYC          : ESADEQUYXPKIHH  YELDKDOX        FVDRPBLK        MPMNHNMJH       YKQGFB         
BNVOAFYMYFPCV   : EIGUGGPVSUXE    XPRCTDLOQCG     SFBBLN         
ONWNRAWPEHWAFKY : BTERA           NTMBRGYFNXRATK  HQBAGCBBN       OMCYFVYIBBKSDP  BIYURFBQFDFAHF  QNDLOWWJELTQQB  CTBWC          
YCWUQYDRLEYDIU  : XQUVLJ          HWLWSHEUD       NXNTMVCDDC      EOLYVN         
WJOND           : GWUJTF          TTLRJGOFL       LMRJKJARP       DQIUOR          ESXNMDJFQRQ     FOPAAKYRB       SWGNEKOPXOUWIY 
KSVTPVBCWLBY    : QAEJQJNYUXWBV   AYWAFBJJ        IQRGGFIOTMNF    YGMBKGLTUFUB    BTFAUFOAOHRQDF 
YRICL           : ABGEMPRV       
ILXQGOQRFE      : TPRGO           KTFBHP          NUTSMSHWEI      SNFQPS          XJROITC        
UQPSKIQMKNXMOG  : EKLAOMNLIETD    XOSFKQMNMCLM   
IOPT            : UDGFJD          NNJKDFMNB       PVKLIKKDTLQCEFR
XFJQOAHGG       : OHCUEHDDQ       OHLBNDCQRUPSBWN VUKNTYE        
EDETVPEMCPCCEQK : LGCUTHSEGYD     MCSJYNHIDQLW   
BCHWNHFYX       : LODWEUYQ        IQRGGFIOTMNF    PAITFTBGJWXJFA 
YIAHVEKBBGQFU   : JDYXAMYKMLR     AIYIUDSQM      
UWWYPJQSLAQY    : QXPAXYDRBUE     USGU            JATHODLNV       RKHTFCOD        MOJUETVEMLW     NEYRUKSQXQ     
VAKPCSPJQ       : NXACGYLJNSRJ    RIWUYXXM        USCX            MQCS            JEDOKGUIUGFEU  
URXDKDYFYVEAOOT : XLCEPJMI        XXKXHHTQ        XSVN            ANKIJCXIOELHW   BBTVEDUP       
CVXEGTESLGNCSE  : YRLTUIOFQLHS    JAYDW          
NYYQJC          : BAEDIDBJBH      OYLRSHVXENSOLB  SCFR           
RDOVGDMAKRVLVEH : ICXQ            LGAQMP          SRMVIBIKYQJ     ANKIJCXIOELHW   LDIXSICHEQUCPL  QFLOVHVIAIY    
WTJMXCR         : HBMMSQAMIWJDO   EEYCIJHBHCNVVMC HYMCBGB        
RSAICCBTI       : WUXUBXM         AEPORIKEGHJESA  DULBBFWHVBXLRJ 
SOUFQHWOUUTDV   : MMQEJLS        
YHIWJCXBUXL     : QROOCH          NCFQMICFR       PVKLIKKDTLQCEFR
CMRKEMB         : AHKDY          
TTLRJGOFL       : DJQXBMWWVTHJPMH GHGYWMLVLJSI    WJOND           FFHYEQIFLWVF    KNAHXP          RJXL            YROEBHRDDQI    
AKTIHFKHIFF     : OMEIQYUNKBKOL   DDOBDNQIJJDG    STYBWNMXDX      YHDDXIYFVY      VSEEHADWCFPEFDL SVNGDA          BAOXAVGHVJT     HTRAR          
DIJWUQJYRDSFWE  : NBDNCJVACQ      SMTDYAXIX       VJWWLCUQ       
MJXYKJVSSBEDK   : CBNWW           MTCQUMAL       
IHOSQ           : JKCNCXXAYJVWE   ITVBHCUI        VWSKEMDKTJF    
QJWPEDKJ        : QOHNDKVMLEEDVU  THFVLEXQ        GOKHGISNMNWS    ARUF           
PXOYWQLIM       : VERXRLPUGTQH    PVKLIKKDTLQCEFR
DNLGAW          : VLIPXVD         TVRVDBP         FBPECCE         BMAHFSBFPT      JGNCXX         
HMMBADKAUODI    : VUGAJVUSMANNXRE XNPQ            UFAKYJS        
FXYUYX          : EURQG           USIS            SHEBEJOXYYAVB   UPJWMPCPQ      
LGAQMP          : XPRCTDLOQCG     QGOWDVNOMMBUS   RDOVGDMAKRVLVEH KKJLENFMXYCAY   QKLWNC         
UQBMANABQF      : URLM            VGFOPO          IGXQYWXAKLCJNCJ ADPHBBGMWSR     QVQYQWMFDE     
SDFXLGDLGAKE    : DTLUMIG         RFOOPWILJXBB    VKDD           
XNPQ            : HMMBADKAUODI    SVLXLCR         LUNRINKBPS      MLUGVCVYK      
GUWWWKWMMBF     : NAJCPMWKU       GSQRHCKM        IXDTRRSYTIJXH  
PXWUVICCVKEHQ   : EACC            NPAGSEQNLD      XOKLVQEBFQR     TFMKJJMFYOY    
FGKWI           : HNHBSID         VTDRBMKWSQU     NYYNIHKEDWKNV   PDKTYPLT        VSJXYPKTXY      XDUFJPKATYF    
RGNQQ           : QNYQCRCNR       HBXJUBL         SHEBEJOXYYAVB   KWNGNDPXVBRII  
EFOJYEIWBGHDIE  : HBMMSQAMIWJDO   SIGQGD          LLQDTFFSUOG     EMXBX          
PNHKS           : SSTSTMW         OMCYFVYIBBKSDP  QRNMR          
URYMMF          : GRSNSH          GEVRMOEJSNPS    STTDGLDBUVH     SJKT           
DVPHDERCKCYMK   : KHNRTNB         AHSARWHORRMH    QOJPPBPODRW     JYASJMYQNLA     RLRFYUGYWRW     SSQXNMVBTYWHD   DPCXPCIOLNJ    
RVNIL           : XRYUPOIAWBYMRKG BTERA           OYPKMOV         IWPJ            TDNDFU          JUSCLGYMQYSP    NBQQVHAIRC     
RVVHQOGDDLG     : EVQTSOBTIKP     RVCURWJXKVGO    BTPW           
JVOMDI          : IRCBWKRCXAIH    NTMBRGYFNXRATK  QAEJQJNYUXWBV   XGPVAKQYXHAI    KKJLENFMXYCAY  
PMSCWC          : MFEBGH          SHQFRAWEOATU    UXJHILLT        CTKXHVOE       
SRFESWAR        : MLYPIPI         QFLOVHVIAIY    
TINWLBFRN       : MYOEPAEG        RETAJLYLJKSRVC  EHSOTUFPWBRPC   FVXJDYHUOEOMSF 
ICHSTWH         : TMYPBVFCBVNS    SSSA            DTLUMIG        
CFRY            : WYEKQMFIIOTQ    OEVGKIW         MNLLBHFKXTXPC   HMMDQ          
KEFFD           : TBYXPNBJOCAJN   AYCWGRORF      
WJDHYBSDINQM    : FNJIFLPD        EXARNNISGYOJLH  XSHIHM          PDKTYPLT        IJOSPTUSIHRG   
UVTPVBFXGWWJJDQ : CIFXGLHFNIX     BIKBDCI         FREHKNMQSF      LIWA            MBABBKJPAEN    
IAOREWTHRWPHPDI : JFCPAKWUX       BTERA           PNKGW           AFADDPRQH       SUFYRVYWKBBBJ   QHTKIYHTLRIAUC  WCDFFDPHRH     
YCCWDJUMJTVSYMK : RQKXH           BIKBDCI         TQXDNANGUBPCE   PVRWWDF        
MACSYVASUQB     : OOXXRNN         WWJGIY          MLQKPRERWLUYL  
VJWWLCUQ        : JIPAA           KIFMLHCGW       OMRRDSE         DIJWUQJYRDSFWE  IFST           
RFUMDQNR        : UDYYRCWN        MIFRGCMPJDUFOV 
VHDAAE          : OYJLAXMAAHBJXHC TVIE            QYIIAG         
BXSTYHPK        : LCBT            XSCBXXQG        VDXXXXY        
MXIJQ           : LRVPP           DUEA            JRIJYYI        
CWRQAKEUOCC     : XIEUUDQOTBMB    UMEEMWLUMO      BSBSEVCC       
ECYCF           : PEMNRNDRBA      AVTWOMY        
WYXE            : NTMBRGYFNXRATK  WJSMRQKOKMRYV  
ILGGTPWQ        : NTMBRGYFNXRATK  TLFB            JBKMMLYUWHAQLST USIS            PMWPPILDCTSNXK  WPYFGBVD       
VLKYV           : QXXS            HWLWSHEUD       OHCUEHDDQ       TPFDN           WNGTHAQBGXHHUT  ITVAIOEI        HPBJG          
TKTX            : UDGFJD          FSPVF          
BAEDIDBJBH      : WXDK            RETAJLYLJKSRVC  SWDSWQGNIEAB    ETHBN           NYYQJC         
JSJRNYQ         : FQBVAMKXIWH     TKGBJPCRHH      JBJEUXEP        MCKQTKM         CEGIMXRJ        NXVAFKSMVGSU   
TPRGO           : LESWMGCUSVU     MPEEPWNE        CFVJKBIKUIBWWV  ILXQGOQRFE      TYQXGTFNTPJ     MGITPOWMEB     
XKBUIGVKKY      : MOXO            AVDSM           KXWLPQY         AWNKHBRMHCMCM   OBLRLWHCMHEYAK 
NCFQMICFR       : RIWUYXXM        PHHREANXNDYWYF  YHIWJCXBUXL     FHRYUECVFU     
USNCMFTTTKRGMO  : QLIAKJ          GEVRMOEJSNPS    REHB            XDUFJPKATYF     RXUTHJE         KFILB          
SKBGMWVQCND     : BGLKW           WQVMVRACSPS     OLQDHMEGJ       FVMJUJMOWRGIC   WCDFFDPHRH     
RLEOGWEKMJHI    : DVJI            SVLXLCR         OMJTGGTE       
RALGRAACDIOAGI  : VVEUNVPIJH      SGNO           
VLQOWWDGUH      : XPRCTDLOQCG     VYDIKTDVTMELM   TBAJRPLFDEQPN   LNSVS          
HQXPV           : OHLBNDCQRUPSBWN JYPQX           KIBEP           OLQLJOWH        MOJUETVEMLW     HDSS            NWEYJCKJBEIGR   JDBYYSQTALNSPFS
RHYJJBO         : NTMBRGYFNXRATK  KHQVILUKBEP     WJWS            VIXVOIP         FAYMWTHIOF      QRNMR          
LFPSNT          : PEMNRNDRBA      EIWSXUIIKOBXJR  OANXGRYMBXFBSP  KIFMLHCGW       MEOPNPPLUYBO   
ANFYKIFHRYO     : OHTNWRNWKSDSKV  USIS            OMJTGGTE       
YGIRBPTM        : DCVJ            JAYDW          
UBQHHG          : EURQG           SCFHE          
UCSWRYWDJEKEDCO : EIWSXUIIKOBXJR  WFGVLLMOP       OUCFMOYEIUDWBPX TWVCCFYWSWE     HPUXDRBKUDNBEL  JSYDLYYYXW     
KXWLPQY         : XKBUIGVKKY      MYWTDJKTHMGY    AGSLSFUYU       WCDFFDPHRH     
OCKXLQAJUSINTFS : NARWTO          JXQH            ASCURW          NJRN            SJKT            QDMYM           MLUGVCVYK      
MFIPHWUS        : XQUVLJ          DTUPACPOGW      SGNJHHAM        BNKESRTAURT     JFCOWMUV        SIIAWAYEWK      CWNQSHEKN      
SGNJHHAM        : OHCUEHDDQ       MFIPHWUS        KTFBHP         
XXKXHHTQ        : ODUWKYRBDTO     IXYSUXQLNRMH    MOXO            URXDKDYFYVEAOOT WAJVPFAUQ      
NXNTMVCDDC      : YCWUQYDRLEYDIU  ERII           
XYSHOFO         : VEBBLFYFVRMU    JRIJYYI         VNPRLFB        
FBPECCE         : DNLGAW          OJSOIJBE       
KXCHODXIPTLU    : YBMQXBDFSCYV    GMMTILMCMP      SWGNEKOPXOUWIY 
PVXQQFG         : LDXJXDWTQEEYWQV TPFDN           HVKTETBAWUITGX  OMJTGGTE       
VECAWI          : MTLMBCYGVYAFJDD ODOG            KVHGSH         
BMNLNSVEXTMPN   : WYDSWOXUJBLYX   BXOSOYUNWQUMU   HWXBF           WQRXBYMUHVORU   UETVSPHBO       CPUWOVNTLXNHNO  IDWFAMEN       
LMRJKJARP       : YBGG            WJOND           RXOF            RWED            XOSFKQMNMCLM   
OVBQ            : YYSYIDRPSIVA    HVKTETBAWUITGX  WSMBPXIGDSJGJIT TCHPPPIHKVLICK  SIUC           
LSWAIKND        : JBKMMLYUWHAQLST FECWKKVE        BPTX           
TBAJRPLFDEQPN   : UDWYGSVOWJM     OOXXRNN         VLQOWWDGUH      SNTBDAULCIH     XOSFKQMNMCLM    EIPBLSIIYVDHWCJ
IFPYDSPYEK      : CBNWW           UGYIXTGXTKYXI  
FUKUYTPCVBTM    : WYVWTRYTIKS     BTIBUS          GCTJQOEEC      
BRQRH           : PKIPCSR         YBGG            SNOHDQYWMNQQCA  GDRQGDSGUVKNVXH ADPHBBGMWSR    
LRNBSRWKS       : CFKQKTWQY       KNOSHADLSRNDP  
USIS            : DUEA            FXYUYX          ILGGTPWQ        ANFYKIFHRYO     GXCIHDXR        PJPSJSRPYFYSBBC
ERYVTVWQ        : DSXIPMRJD       AHXSWHCNNQM     DTLUMIG        
JTEDMLJA        : OPVPIOGPL       IHNMJIKSFDDOVJR TVGRJGYKPBVYFCK
ADBRAMMEJ       : XGVAKFLXUEHYKP  CISYIU          UPRBBPA         ATBAF           NWGWLKIAQ       PAITFTBGJWXJFA 
MCKQTKM         : XLCEPJMI        FHACATFXVLV     JSJRNYQ        
IJHUVBYYPMKR    : LCCHLNP         YSBSRHHDG       EYJQBHRDDA      VSJXYPKTXY      HNKGGMCEPE     
KVWEXJQCUVPAJ   : QXDGNQJWRIIFHJ  IPQHBAYX       
TTVMEHVBD       : JKPWGFTQNAJDKQA JTXNV           TKGBJPCRHH      VPMRSQGCFTQQSG  OQOGMVBPYJK     NQTWKANUVTCAMT 
AEPORIKEGHJESA  : RSAICCBTI       JCPHDI          BHWFLTIAYABIYEF
NYYNIHKEDWKNV   : PNXSKB          UXBTB           FGKWI           GPEPBOVILL     
SVLXLCR         : XNPQ            RLEOGWEKMJHI    QBSGITPCXSUIIGT PVRWWDF        
MVETHJM         : GNHMNGEQTFXYA   RBXJGOUWMABSBAM VDXXXXY         KWNGNDPXVBRII   WGXLSQYIAM      PRIIUBP        
SDJRQRYDVFDI    : WYDSWOXUJBLYX   UHLREVXO       
YTLUHLIJFHWC    : LESWMGCUSVU     BGCOI           CFVJKBIKUIBWWV  VNPRLFB        
SJUGTPLDJEWLI   : WXWGJBWBNJGRRIR KPIK            VJDSMFQCX       TFMKJJMFYOY    
QNDLOWWJELTQQB  : XHCNGPLKHWQVE   ONWNRAWPEHWAFKY LEJMMADGVIEWI   FVXJDYHUOEOMSF 
UNIFKQBBCFMHC   : SNOHDQYWMNQQCA  GAJUGJGSKDTH    SDYLWUQIUOAB    NJRN            JSYDLYYYXW      PTXLVYPRWD     
RXOF            : NBDNCJVACQ      RBUK            HWXBF           YWOVYIT         LMRJKJARP       RSHIHUMRKWE     SJKT           
ATBAF           : ADBRAMMEJ       YBVAIXWUUI      MVLEIK         
NYXEBNAQW       : OALVXESFGIUY    LWICBPCFAOGDQQJ IFTCPQPRYTCGIS  MENRPUISHQILH   AIWEDLAVRROF   
BNKESRTAURT     : LESWMGCUSVU     ITVBHCUI        MFIPHWUS        RBMQWJW         CDLJOFUJEXWFW  
HBXJUBL         : KIMOFTRGDKRSOY  RGNQQ           AQDAFVTRTCUCO   ODOOWCNWM      
JYDJEGXGWW      : NARWTO          MEKUYIXGMVRRV   OMEIQYUNKBKOL   SJQGNYOWXAXBKED
BMAHFSBFPT      : GEVRMOEJSNPS    DNLGAW          IJOSPTUSIHRG    IYSCOUKDHQBKAAV YJYDVUONKJSU   
MDAMOWOBBXAH    : MIBTTRD         PNTGSNXY        RFAKEIDAMAQFYF  MYKEI          
GNHMNGEQTFXYA   : EVQTSOBTIKP     MVETHJM         XCIG           
HPXIEBL         : YHDDXIYFVY      USCX            VVEUNVPIJH      THILG          
RKFSM           : SWUKPAM         QDQROTREAUFHKY  QPHVVTXJ        OGPHLMYUSXTS    NUTSMSHWEI     
VTPCJW          : SXISCESQGI      IXHO            PRGWMGUGVBP     VSJXYPKTXY     
WEVNADO         : AHXSWHCNNQM     HSEU            IGXQYWXAKLCJNCJ VWRTDWXXQ      
DQIUOR          : BQRDHGJBDGI     MLQKPRERWLUYL   WJOND           MQCS           
RDQJNXFCEBXTD   : KKBKISFPNJXDXGD
SUFYRVYWKBBBJ   : GRLJU           WXFAGSERBNACSB  IAOREWTHRWPHPDI KLGX            TDAL           
RBXJGOUWMABSBAM : RFDPLMOEEUK     MVETHJM         XHCFCTQJCEFUHO 
IGCPFV          : SPFNEVILGFSLMYU UCDEUO          BEYLLYD        
HTXIWBRS        : SXISCESQGI      LEMOWOWYPXYC    MHCSUYUMAJ     
VSEEHADWCFPEFDL : LODWEUYQ        VHVAEVP         XBSSKNLCNAUI    DDOBDNQIJJDG    AKTIHFKHIFF     MJDRVAPLCSOHL   SCFHE           CQXM           
LPFSOTA         : RWVBUUDUNY      JILXMW          LGUYEIFACLGQUJ  GNWOMWCFF       BLTSOIMCXM      OIWSYT         
RKHTFCOD        : WBUBOLTRRTSYHYJ SHQFRAWEOATU    UWWYPJQSLAQY    UGYIXTGXTKYXI  
THFVLEXQ        : NTTKRUP         QJWPEDKJ        XSHIHM         
EXARNNISGYOJLH  : NLHPP           WJDHYBSDINQM    VAGGKGPTDWJXU  
UDYYRCWN        : SSXSQJ          RFUMDQNR        XSVN            DXCNVPVTY      
DJAJIQ          : BTNY            ADLAA           FTSLGKICMLPEUA 
MOGFETPYDQOM    : IPQFOJBHHTB     WWJGIY          UMSKMQE         VTIUOEF        
VGWBIVUMT       : DNXDFPHHIOQ     HQBAGCBBN       WWJGIY          OEPAHXJJBEIXMO 
YYSYIDRPSIVA    : URLM            HXLHQOEEIHUVAW  PNTGSNXY        VTDRBMKWSQU     OVBQ            HWDPVHLUGYWLFG  HNKGGMCEPE     
SRMVIBIKYQJ     : FARDRU          RDOVGDMAKRVLVEH BIJXR          
YHWODGNECNPFH   : VFTMXKYRDFKHRU  CSGIQOO        
AQDAFVTRTCUCO   : UMSKMQE         STYBWNMXDX      HBXJUBL        
VAXWIVLLCA      : EYQTKDJ         DFDXRQQHWHHSHM  NEJAXFFQDRRDM  
EPIMWNMPSPVRJP  : RBWOXK          RFDPLMOEEUK     GWNMCWKKVVFOUP 
OLQDHMEGJ       : EACC            DENEQFJ         BYJSLNBEP       GMLOLVMHNWWCQL  SKBGMWVQCND     KLGX            PDKTYPLT        HCENL          
EVCGXUNNDAM     : AFTFR           TSMABDVP        YEUVWNCEDHNXNI  LKUSQ          
ODOG            : AUPT            NPRSTWPCN       VECAWI          XATVLUWSRHRSFD  UTDIAHA        
GSQRHCKM        : GUWWWKWMMBF     BBTVEDUP       
WSUHHYFMHDH     : YSBSRHHDG      
SNWHIMMWS       : USGU            BECNATVMKWV     VSLKIIYDXORR    NWWKMFBSUYQYQBJ KVHGSH          BPTX            GWNMCWKKVVFOUP  RXUTHJE        
DLHXULIIXIBUR   : BJCYNEBAH       UXBTB          
TWVCCFYWSWE     : HDVINVSLRHRCOC  VSLKIIYDXORR    GDYIWNV         YWBHRWVQTWN     UCSWRYWDJEKEDCO RMADFAXKC      
JRBEH           : DOVULAPALUIUPNB DPGONQSOGUTILC  USOUP           XJKGKYDI       
SOFNBPVYAAWRLQO : UCDEUO          UNBGEIEOO       SAUEO          
USOUP           : XBEM            SSXSQJ          JRBEH           RQXUKHJVOAACUIM CDNHYLSDNAACEO 
TUODOPJVYCLG    : VAGGKGPTDWJXU   NHULIGCOOR      FVMJUJMOWRGIC  
MYQNYQKRCEILBCD : WUUPUDHKWS      FHACATFXVLV    
TNRQEWFVHE      : MNLLBHFKXTXPC   TCHPPPIHKVLICK  KVHGSH         
LPCEEBXTBOHUTL  : FCJBDYSQKST     GWNMCWKKVVFOUP 
HOFKNC          : USWKMEGGQWEOQB  XNPBXE          HSVEGVXNJMRPE   VUXIAT          XGQXFAI        
FSEFBBMF        : ICQBNUOLYKQVAS  NUGLXWSSV       SEMFATCTY       YJYDVUONKJSU   
AWDH            : HPWNQ           AHKDY           GIIPOSEXYWTAWVI
HFWIVEDPRIXJQK  : SSDTAQUKFCPYC   VDDRKYFKKGC    
SLENPJOSX       : HUWQ            APULXQHNCIAUMQM MORIYJPUMU     
TYQXGTFNTPJ     : NWMTNOO         TPRGO           BIJXR          
UAUD            : QDNKVM          FBTTHTV         NYRPSSLRHTNO    BLTSOIMCXM      YPBCRWK        
ETKBOV          : AIFHNBRBWKORSG  NNMXSPOB       
DOTRJTO         : KVBIGCUWLJBU    VAARYHXSQPV    
SHEBEJOXYYAVB   : FXYUYX          RGNQQ           IYKPHNEG        IDOIRK         
YDYVNC          : VAFXBUXBC       PMDIFSTTPQ      CRVSLWTLJQUH   
MMPDGKOAYUVGYY  : CHMUPVYGJIOFNV  DCVITWFDT      
KQKLPNHS        : SSXSQJ          HNHBSID         BYQILAPTCTBPBA  BDFRHWDNSNBLU   PNVWEKO        
JVIFLMTXYKDHUSK : QCLRLSMSPMCDNPP NDFVNTJXGOFSCHD TSEKOURLBQKN   
NGEPFRAVEMNRV   : AIHKP           HUNYPUSOXDW     GMMTILMCMP      QCEHBVONU       QFLOVHVIAIY     UHJNQFIGEPGYTJ 
BFGLM           : MUWTCWS         DCVJ            BDRXYA         
AHSARWHORRMH    : XBEM            WMMWBPI         USCX            DVPHDERCKCYMK  
QYIIAG          : WAFFISVNGLWNAW  VHDAAE          KGSASMACKPTBXIX
OWHKHKSOX       : CEPSHDHER       YTILUPJGS       UHJNQFIGEPGYTJ 
HYMCBGB         : KIBDJSLDPJ      WTJMXCR         FREHKNMQSF      UGPXNRCDGH     
WSFJDFDCPNEW    : MFEBGH          NBDNCJVACQ      VEBBLFYFVRMU    SXGLFININPBKVW  FQELCN          ABCIYINMIMG    
SVNGDA          : CCKDIPJSYY      VBVPKMPX        GQDLJPAISXCQJV  AKTIHFKHIFF     DOPWMBJXEQWDK   BGAPDKVIFI     
RBGBAVE         : AIFHNBRBWKORSG  DNOR            PLPI           
EFNCBSNEYSIQH   : ITUVGWLW        IPQHBAYX        TYRSEUKQVPBGW   XWXGKMASNKKL    RXUTHJE         BGAPDKVIFI     
NMIJCO          : MLLXDRPGQN      JFCOWMUV        MAJIOXHTOIYLV   ENSFFHJUJQUU    LXIOPBFHTXXDVG  OGKUWD         
DPHEW           : FNJIFLPD        YEUVWNCEDHNXNI 
GUPJY           : MHEHTMRUW       QISDDI          BJCYNEBAH       CYRKSQPJ       
WDASRGTK        : ITVBHCUI        EEYCIJHBHCNVVMC NMEKNHKJVO     
KTFBHP          : XBEM            YNGHCROEA       ILXQGOQRFE      SGNJHHAM        IRQQ            DVWDJB          QDMYM          
JFCOWMUV        : MFIPHWUS        NMIJCO          DTJNDWGXXFCFL   CQRPHKYIPKDHXJ  FXLYIVLFBFD     PKVQGAOIDSTF   
BQPMQOMTPFNXYBP : GUYCTBYLAP      BICIOLDIFLQGMC  TYRSEUKQVPBGW   YKMYFKJWCIRSM  
UUMELA          : EURQG           UWXUISWE        EKUX           
SCHR            : WUUPUDHKWS      RIOPBJNNSFU     CKLMJJMNHMMCU  
DOMGHETATIWJ    : AHXSWHCNNQM     BPFRWYFUSUTDO   VSJXYPKTXY      HDSS            ADPHBBGMWSR    
MHONX           : FCPMUBHT        GMLOLVMHNWWCQL  VXLLJ          
LUNRINKBPS      : CFKQKTWQY       QSUIGD          VUKYMTHS        XNPQ            IQRGGFIOTMNF    XOUCD           SDYLWUQIUOAB   
HVKTETBAWUITGX  : PVXQQFG         OVBQ            WYJFQH         
PMWPPILDCTSNXK  : CPKGN           SXHKGHYMCFJGX   ILGGTPWQ        RJCEDS          MFFYMJNJX      
TREGOIAPJWK     : JHOR            OPUQDUFBQ       PTXLVYPRWD     
SSSA            : FJMIHT          ICHSTWH         WSSDF          
FYYWJK          : JKPWGFTQNAJDKQA PJNKIALBX       FARDRU          TPEJKTJKRJQAKSR HMMDQ           RDNLBEAMW      
LGUYEIFACLGQUJ  : NUGLXWSSV       FXKQESYXKG      LPFSOTA        
GIUACNSEWBDVXO  : RIWUYXXM        FVDRPBLK        NIKVNTBFUK      LAVHTNBBUA      THILG           VERXRLPUGTQH   
BAOXAVGHVJT     : IPCE            AKTIHFKHIFF     PSLBANVWAHAUGED JYASJMYQNLA     DRHCPHCKT       SBHBFDEBAKJ    
CQQNWYIWDYQJVT  : QETJU           XNPYMCUCRLIIWQE SOFSTSU         MOJUETVEMLW     VJUR            LONEIEL        
TRDCUESVGQENP   : NLHPP           FPAHSODCII      QDNKVM          BGUAHXXF        NWTKNXY         SSQXNMVBTYWHD   GUQI           
JUSCLGYMQYSP    : RVNIL           NWGWLKIAQ      
CNJR            : SXGLFININPBKVW  HYDHR           ADPHBBGMWSR    
DULBBFWHVBXLRJ  : LDXJXDWTQEEYWQV NNMXSPOB        WSJNCQSVDCTC    UMSKMQE         RSAICCBTI       PWTCBNQHHM     
KMVSLLLKECCGP   : NUGLXWSSV       UGYIXTGXTKYXI   JFEU            KVHGSH         
XATVLUWSRHRSFD  : FLGXBG          ODOG            VGSWXQMNKRPLSXU
OOWBKRPVECA     : HUWQ            QROOCH          TTMPVURWGMCXYKN WKLUK          
FJXUJXOFMJFF    : XSVN            IBBKECWSYVT     VEBHIGRINVBQJMF MJDRVAPLCSOHL  
MYWTDJKTHMGY    : MQRAB           KXWLPQY         CYXBLNEJPLMAAI 
FDGHLNQMJBM     : DNXDFPHHIOQ     YUYCNIDD        VLAK            IYSCOUKDHQBKAAV PVRWWDF        
IYKPHNEG        : LVWMNWBGP       BJCYNEBAH       OEVUJP          SHEBEJOXYYAVB   WJSMRQKOKMRYV  
XLWJ            : CNAN            SGERDILCJGIFYF  EMXBX           WKLUK          
GXOFETLKBYYS    : HWXBF           LVONMGD         BMROCBXDWL     
KVBIGCUWLJBU    : PJNKIALBX       DOTRJTO        
CGUNQB          : GFHU            YEDDOWRHLW      YEXFDYGTBBR    
FHRYUECVFU      : YOGBCDND        NCFQMICFR       SGIMB           UBTDBHCUJULIXJX
PSLBANVWAHAUGED : JYVVHYC         BAOXAVGHVJT     VVCRHPW         UHJNQFIGEPGYTJ 
RTDFBMYAHEFDJAN : LESWMGCUSVU     BYJSLNBEP       GHUTSHFYYJRDJVG SUOBTSI        
VYDVP           : FKSRXQ          BTFAUFOAOHRQDF 
UPJWMPCPQ       : DENEQFJ         TPEJKTJKRJQAKSR FXYUYX          UBPWNMRECBBIJU 
MTCNG           : MRJWXBQJUEUMJ   JPCGFTJJJKFU    UNNOPWQGGVOAOF  CKUDNLLMSQ     
QPHVVTXJ        : RKFSM           TLBRDC          DSTWLFBTLC      VWSKEMDKTJF    
TLBRDC          : HUNYPUSOXDW     QPHVVTXJ        XWEABQJSAU      PVKLIKKDTLQCEFR
SNOHDQYWMNQQCA  : BRQRH           UNIFKQBBCFMHC   VXLLJ          
UPCSLXQXVNLYHOE : ARHLLEDRPHSL    FKSRXQ         
JRNQXER         : DBMEQJ          FQELCN         
SGLKINFFEJX     : XIEUUDQOTBMB    IJRKNBOECDE     DJVIOJMHRYLM    DTUPACPOGW      WYVWTRYTIKS     VOQMIHQVRIMDFE  KGSASMACKPTBXIX
IQRGGFIOTMNF    : KSVTPVBCWLBY    BCHWNHFYX       LUNRINKBPS      MFFYMJNJX       UWTOXBXBYDDN   
BVEHQ           : KVHCFEJ         PTWVIVIL       
AWNKHBRMHCMCM   : VDDRKYFKKGC     XKBUIGVKKY      LKUSQ          
TSMABDVP        : AHXSWHCNNQM     VVEUNVPIJH      EVCGXUNNDAM     UBPWNMRECBBIJU  KKBKISFPNJXDXGD
CWTABDQDFN      : USGU            VYDIKTDVTMELM   EOMURXI         NKVYXGYIG      
QURIJCMXEYEXS   : XBEM           
AVTWOMY         : BEHY            OANXGRYMBXFBSP  ECYCF           YEXFDYGTBBR     AWSIBNGSMPNTC  
GBOLSTQGKJEFUPH : QDQROTREAUFHKY  EUGABV          UCOMUEVCPTQAW   VLAK            QIUKJRSMBJVFRUY VFEXUTU        
OLHSLCJM        : UDBLNJIA        JYVVHYC         RQXUKHJVOAACUIM WKLUK           CXOBW          
DLQRMEANV       : NIBRKDAJCAONFTW QYPAMHFLGVCJF   MNLLBHFKXTXPC   JRIJYYI        
GPEPBOVILL      : JFDAWGA         NYYNIHKEDWKNV   KPIK           
UCDEUO          : EIEKSW          IGCPFV          SOFNBPVYAAWRLQO OAWQBDO         MHCSUYUMAJ     
GDJLOC          : QDENEIOM        IDWFAMEN        HNKGGMCEPE     
BHDPD           : HQGWJQAMPAXBICE UXCONTRYKRMI    WWJGIY          FKHEQHMUG      
XSVN            : YNGHCROEA       EPDDYMAUKTEPJWA URXDKDYFYVEAOOT UDYYRCWN        FJXUJXOFMJFF    KPIK           
KLGX            : HTKJXRNGNMQIEO  QSUIGD          YBMQXBDFSCYV    SUFYRVYWKBBBJ   OLQDHMEGJ       JYASJMYQNLA     RJXL            RTKTJJ         
KLGX            : PVJHNVPBOPNOF  
XSCBXXQG        : BXSTYHPK        MLUKUMQIVO      PSHDFDW         ERII            MJDRVAPLCSOHL   HCIDHUJFRYWH   
TRSLUVMCCEHSDCO : SSDTAQUKFCPYC   YUYCNIDD        GMMTILMCMP      ANKIJCXIOELHW   OICIWTBGDKDREO 
BBDHYDGSFH      : XQUVLJ          QSUIGD          OPNOC           BRNXLTKYNH      LWVN           
FAYMWTHIOF      : RHYJJBO         LIWA            CVUCUAV         ONIGYEHID      
SHAABD          : WUXUBXM         GYIYXTTYI       RLRFYUGYWRW    
RVDTBLUGTPOBIT  : RBWOXK          GAJUGJGSKDTH    SFAYRXXSI       XJKGKYDI       
KIBEP           : HQXPV           RIMKACLGCA      MLUKUMQIVO      FPPOBQQNSLFDT  
SXGLFININPBKVW  : WSFJDFDCPNEW    CNJR            SXEOLAJWKJTMKXJ FECWKKVE       
JRUDIJESF       : WOGG            UCOMUEVCPTQAW  
DQLHGUCECPMMDW  : JJIUKIIBJANYAPM IGXQYWXAKLCJNCJ VUXIAT          CEGIMXRJ       
VALRWBDRV       : EDKJ            UWXUISWE        MCKJ            IPPWUQEN        PJSKGNY         CDLJOFUJEXWFW  
CHMUPVYGJIOFNV  : DSXIPMRJD       PGFSVFSYOSMXI   SLYYIQYGRT      GHGYWMLVLJSI    MMPDGKOAYUVGYY  YEXFDYGTBBR     YDMT           
FIVLFWHGKBFMEWK : HDKEYGYIUMW     BGLKW           QOHNDKVMLEEDVU  ERII            KKBKISFPNJXDXGD DWCMC          
BUYWK           : FMTYXBEO        WHBNLBWBXW      DRHCPHCKT       NEYRUKSQXQ     
XSHIHM          : HNISBGSFCVQMDFG WJDHYBSDINQM    THFVLEXQ        IXAQCDVQPH      DSTWLFBTLC     
DXCNVPVTY       : KWVMCD          UDYYRCWN        YOJCPIISRR     
GAJUGJGSKDTH    : HWNXJAF         UNIFKQBBCFMHC   RVDTBLUGTPOBIT 
RHIY            : UEYRJTG         QVNWYVGPVNN     OGPHLMYUSXTS   
PNOVNQJJ        : BNRLLADML       YNGHCROEA       MGGHGJJYIPQ     PVRWWDF        
FFFJMHTHPFPK    : NJVRUADUJLNOG   DJPRWI          BSBSEVCC       
UFAKYJS         : STTDGLDBUVH     HMMBADKAUODI    PFNXC           OLGR            CHTUFDVPUXUKA  
AJLPFYI         : KUWKGIS         PKIORMTRSV      PJSKGNY         FGMUYDEYJMMIX  
KRWQYGFJ        : MVKJB          
OYJFMCATE       : NIBRKDAJCAONFTW JGNCXX          HDWTDRNDRL      QNPAVDNCKAGQ   
SNGQQREG        : QKCB            ICDPNBXEFHGPOB  NWTKNXY         TDAL           
FQQR            : UNHYKKTSJ       QRNMR          
NIKVNTBFUK      : GIUACNSEWBDVXO  IXDTRRSYTIJXH  
HMMDQ           : PJVGL           CFRY            FYYWJK          CXJWMBNWRY      JRIJYYI         KKBKISFPNJXDXGD SJKT           
VHJOXBUEBCUTUGJ : XHJGDVOCEKPV   
QHTKIYHTLRIAUC  : WNGTHAQBGXHHUT  IAOREWTHRWPHPDI JSYDLYYYXW     
RJMIHPE         : GRSNSH          XXAPF           YVNITYTHPJKUKW  RDNFIXHOQYCNYAB
SGIMB           : FHRYUECVFU      RDNLBEAMW       NWEYJCKJBEIGR   IYSCOUKDHQBKAAV YKQGFB         
XHJGDVOCEKPV    : RIWUYXXM        VHJOXBUEBCUTUGJ IXDTRRSYTIJXH   PVRWWDF        
RQXUKHJVOAACUIM : CNAN            USOUP           OLHSLCJM       
MGITPOWMEB      : UMSKMQE         TPRGO          
QSOMKHMGSVR     : RVWQUWJMTEOOIC  TVNTUPUGNRKIBFV DPWAECAKHUS     NNJKDFMNB       LLQDTFFSUOG    
MTQOPB          : MHEHTMRUW       QUPMYJQVT       ETHBN           DOPWMBJXEQWDK   VFMW           
ANKIJCXIOELHW   : URXDKDYFYVEAOOT RDOVGDMAKRVLVEH TRSLUVMCCEHSDCO
XMPGYXBV        : LUCGURBGT       HMYCHAX         SAUEO           VFEXUTU         SWGNEKOPXOUWIY 
RIMKACLGCA      : KIBEP           PMDIFSTTPQ      XGQXFAI        
MLUKUMQIVO      : XSCBXXQG        KIBEP           GBXVOJVTJCWFM   MIFRGCMPJDUFOV 
UBFDCDE         : MHCSUYUMAJ      OIWSYT         
UXJHILLT        : YERNTVRLUIP     DWOIROJNLEVOEH  BGUAHXXF        PMSCWC          TGTRLFFL        VSJXYPKTXY     
NVMDKHNH        : JDIGLJYYEUOO    LEJMMADGVIEWI   CVAVUIFCKXMXUDB
HPUXDRBKUDNBEL  : XPRCTDLOQCG     UCSWRYWDJEKEDCO YEUVWNCEDHNXNI 
PSHDFDW         : AFADDPRQH       XSCBXXQG        DXOKUFEKBL      BIKHAIXUMDBTUH 
CJXMSOTPX       : WYVWTRYTIKS    
KVPEWAYCQCI     : QXDGNQJWRIIFHJ  QISDDI          CDJJFOJHFRKJW   AFADDPRQH       USCX           
BXWKDEPA        : NBHYYK          VFTMXKYRDFKHRU  AFADDPRQH      
RJCEDS          : REHB            PMWPPILDCTSNXK  XSESUJKLDHW     ILQAYJYIWESOTSF
UQMHMC          : SBGBVTQOACAU    MAJOTIU         AFADDPRQH       WEFNEQGYAEXFS   DXOKUFEKBL     
LEMOWOWYPXYC    : MEHKRXQQ        KWVMCD          HTXIWBRS        FECWKKVE       
FREHKNMQSF      : QKCB            WHCCSHPNDWDUGW  DXGYEQIOOHJALC  UVTPVBFXGWWJJDQ HYMCBGB         GUQI           
NWGWLKIAQ       : MYOEPAEG        BYQILAPTCTBPBA  CFVJKBIKUIBWWV  ADBRAMMEJ       JUSCLGYMQYSP    MGGHGJJYIPQ     VTIUOEF         LGSJKCQNC      
QOJPPBPODRW     : BQRDHGJBDGI     DVPHDERCKCYMK  
XGKLSDHYWWXFU   : IXHO            MNLLBHFKXTXPC   LSPTACAPWGPI    EVKVR          
RDNLBEAMW       : FYYWJK          SGIMB          
OMJTGGTE        : EURQG           SMTDYAXIX       FFYUIHS         RLEOGWEKMJHI    ANFYKIFHRYO     PVXQQFG         JDYXAMYKMLR     RYDXGFBLHKQS   
EQIIAJHWHPRUJX  : PIBO            ARCADBK         CHTUFDVPUXUKA   JUKNQUNAREEVA   BMROCBXDWL     
UBPWNMRECBBIJU  : GMAAQHNMNQGJBDI UPJWMPCPQ       TSMABDVP        UBTDBHCUJULIXJX
VAGGKGPTDWJXU   : LGCUTHSEGYD     EXARNNISGYOJLH  TUODOPJVYCLG   
VGSWXQMNKRPLSXU : YHDTCPKWDWFLDRF OBNMYUVAFNYOWPP SSXSQJ          BPFRWYFUSUTDO   OPJJRHAASUUVU   LNBQD           XATVLUWSRHRSFD  ENSFFHJUJQUU   
VGSWXQMNKRPLSXU : IKFVAP         
LSPTACAPWGPI    : WOGG            XGKLSDHYWWXFU   SBXLIFWER      
MECUAY          : UXBTB           NPRSTWPCN       MQCS            VNCCDFQPRGNDJVD
SNIDFXOAYL      : RTHNQHTBWDO     WBUBOLTRRTSYHYJ DPWAECAKHUS     WSSDF           GFRVJGN         VFMW           
MGGHGJJYIPQ     : PNOVNQJJ        NWGWLKIAQ       SDAJFHEIMGGSVY  BKHAJTUSLQBFICT
VDXXXXY         : ICQBNUOLYKQVAS  BXSTYHPK        MVETHJM         UYYVKXKJIQ      GEKRFOOPPJIS    LONEIEL        
QNCTSCKVD       : KHNRTNB         PNKGW           EPDDYMAUKTEPJWA FWQGAUO        
MQCS            : VAKPCSPJQ       DQIUOR          MECUAY          IPPWUQEN        FTYW            BMROCBXDWL      SGORSAKVAY     
LEJMMADGVIEWI   : ACLHWJMSIDNXEVF HMPVTFXXLFY     FARDRU          FCPMUBHT        APULXQHNCIAUMQM QNDLOWWJELTQQB  NVMDKHNH        FTSLGKICMLPEUA 
VBUJFQFKBBNYNGD : URLM            JTXNV           HMPVTFXXLFY     OYJLAXMAAHBJXHC WUXUBXM         TAOJMIJOSXFPWRP
GQNS            : IRCBWKRCXAIH    IPQFOJBHHTB    
CSGIQOO         : YWBHRWVQTWN     NYRPSSLRHTNO    LMJSRKP         YHWODGNECNPFH   NBQQVHAIRC      PNVWEKO        
WSMBPXIGDSJGJIT : OVBQ           
ODYFSRJUM       : AUPT            HTSLTMCYPOEHJC  DSSFKLLHVDE     TBYXPNBJOCAJN  
GFHU            : SBGBVTQOACAU    CGUNQB          DXOKUFEKBL      XDUFJPKATYF    
GOKHGISNMNWS    : GMMTILMCMP      QJWPEDKJ        VWRTDWXXQ      
IPPWUQEN        : EVQTSOBTIKP     GMAAQHNMNQGJBDI VALRWBDRV       MQCS            JALLS           DRHCPHCKT      
NKWGQENOCVFMELV : YHDTCPKWDWFLDRF SXISCESQGI      GCTJQOEEC       EVKVR          
YKMYFKJWCIRSM   : BQPMQOMTPFNXYBP MBABBKJPAEN     GBXVOJVTJCWFM  
FBSE            : OPVPIOGPL       BIWKWSWXWNFS    LNBQD           THFMRIFW        FVMJUJMOWRGIC  
LIWA            : UVTPVBFXGWWJJDQ FAYMWTHIOF      APFIXRMTP       RSTDJYXRGSO     QIUKJRSMBJVFRUY
SFAYRXXSI       : TQJYQSGTYDIHVYQ RVDTBLUGTPOBIT  ENSFFHJUJQUU    NGIRIJSRELLQTVY
TQXDNANGUBPCE   : HKDQJ           YCCWDJUMJTVSYMK GKLX           
GNWOMWCFF       : PMIDEIR         WSJNCQSVDCTC    LPFSOTA         KKBKISFPNJXDXGD SWGNEKOPXOUWIY 
HYDHR           : NBHYYK          CNJR            CYXBLNEJPLMAAI  JEDOKGUIUGFEU  
SOFSTSU         : QUPMYJQVT       YSAHTHDILIXE    QWXDHGC         CQQNWYIWDYQJVT  RBMQWJW         CXJWMBNWRY      OIUEFEPQCSRYM  
BPJRRPCAD       : PKIPCSR         XIEUUDQOTBMB    GELDHRHDL       MVLVRJNOMRGHOS  LSUTT          
PPYTW           : IPCE            SPFNEVILGFSLMYU FXLYIVLFBFD    
YEDDOWRHLW      : CGUNQB          EPGT           
GRXQTOCLIRPJ    : HDKEYGYIUMW     LPWEK           YWJQSWW         MCVANXCRXIMMA  
RBMQWJW         : AJXAVAKEDPNVDS  MFBOBWCLWAYQ    BNKESRTAURT     SOFSTSU         CORAJAOOFUVW   
QCEHBVONU       : ICDPNBXEFHGPOB  FJMIHT          ETWMFSH         STTDGLDBUVH     NGEPFRAVEMNRV   OUNBIXLFF       UGYIXTGXTKYXI   JEDOKGUIUGFEU  
VOQMIHQVRIMDFE  : QOHNDKVMLEEDVU  SSDTAQUKFCPYC   SGLKINFFEJX     GPLRWFNO       
RWED            : BUPH            SWUKPAM         LMRJKJARP      
FVXJDYHUOEOMSF  : TINWLBFRN       QNDLOWWJELTQQB  ULYXBOY        
CORAJAOOFUVW    : ABGEMPRV        NNJKDFMNB       RBMQWJW         XJSL            NFFGEVMLUDLJLVW NWEYJCKJBEIGR  
CDNHYLSDNAACEO  : QXPAXYDRBUE     BTERA           JBJEUXEP        GUYCTBYLAP      USOUP          
WWQBNJ          : WPMA            UVOCGHTGAHMH    BOKURXC        
WJSMRQKOKMRYV   : WYXE            IYKPHNEG        UETVSPHBO      
MOYCQYF         : JTXNV           RDQBLKV        
NWTKNXY         : OEVUJP          QYPAMHFLGVCJF   TRDCUESVGQENP   SNGQQREG        SQHVMKFPVLIL    IGVIEESTFNJRX  
CXJWMBNWRY      : SBGBVTQOACAU    HMMDQ           SOFSTSU        
MAJIOXHTOIYLV   : VLIPXVD         JILXMW          NMIJCO          KKBKISFPNJXDXGD
IJLGKLIKWHX     : DPAREJQQCF      UVTNT           FNFTIC         
XURYJGYSOP      : SWUKPAM         WUXUBXM         HAESVAM        
XJKGKYDI        : TMFBADYPAATHGG  JRBEH           RVDTBLUGTPOBIT 
OUNBIXLFF       : YHDTCPKWDWFLDRF RXNWDV          FMTYXBEO        SSTSTMW         UXCONTRYKRMI    QCEHBVONU      
FFHYEQIFLWVF    : VQNR            KUWKGIS         TTLRJGOFL       FTSLGKICMLPEUA 
HSEU            : FKQLVB          XGJTYUNNYOGN    MOKLGTUPLBMSCNQ WEVNADO         ATQKDH         
JDYXAMYKMLR     : QXDGNQJWRIIFHJ  LQRVJQETC       YIAHVEKBBGQFU   OMJTGGTE        HYGNKYYSOS     
WYXEYEUJKJI     : XICGIVLDQWRRKNR IJOSPTUSIHRG    LNSVS           BMROCBXDWL      UWTOXBXBYDDN   
OGPHLMYUSXTS    : GRSNSH          ACLHWJMSIDNXEVF RKFSM           RHIY            VEBHIGRINVBQJMF
UGYIXTGXTKYXI   : IFPYDSPYEK      RKHTFCOD        KMVSLLLKECCGP   QCEHBVONU      
IRQQ            : HKDQJ           KTFBHP          IGVIEESTFNJRX   UNGWDU          ABCIYINMIMG    
XJSL            : QAROBCSHHELTU   WQVMVRACSPS     CORAJAOOFUVW   
RGOSCKHXQH      : QBSGITPCXSUIIGT EHHQVJKBCMARPKI HUMKDAYGA       OGKUWD         
ODOOWCNWM       : EIEKSW          REHB            PHHREANXNDYWYF  DCVJ            HBXJUBL         UVTNT           DOPWMBJXEQWDK  
GGPYOPIHBFCJ    : XOKLVQEBFQR     NWWKMFBSUYQYQBJ ADMHPHLJARARMAE
UMEEMWLUMO      : MJOHLTUBTBL     CWRQAKEUOCC     PDKTYPLT        CPUWOVNTLXNHNO 
DNOR            : LRVPP           RBGBAVE         XTKLBBILOON    
BPTHHSVYCGCJ    : EDKJ            TMJADK         
MFFYMJNJX       : QWXDHGC         PMWPPILDCTSNXK  IQRGGFIOTMNF    ADPHBBGMWSR     LMAGYDGYPVEYWO 
XOUCD           : WMMWBPI         LUNRINKBPS      GRIPDBHON      
VQKLMTVFS       : BXOSOYUNWQUMU   RBWOXK         
JYASJMYQNLA     : YOGBCDND        DVPHDERCKCYMK   BAOXAVGHVJT     KLGX            HYKEFACOLWXNVJ 
WAJVPFAUQ       : VCLRC           JSJIQSJV        XXKXHHTQ        PFNXC           XGQXFAI        
NEJAXFFQDRRDM   : AYWAFBJJ        VAXWIVLLCA      YWJQSWW         PBJAXHU        
RLRFYUGYWRW     : QUPMYJQVT       DVPHDERCKCYMK   SHAABD          RSLMPPWPY      
YWJQSWW         : QXDGNQJWRIIFHJ  GRXQTOCLIRPJ    NEJAXFFQDRRDM   QHIYVWHIEKLUWHM
WUMFMR          : CICPYOAYBMGCE   QVQHTEWWLQQV    LGSJKCQNC       ONIGYEHID      
EULIO           : HDVINVSLRHRCOC  SWUKPAM         XVKNLUVNYDATQ   YUYCNIDD        LPWEK          
CTBWC           : FJMIHT          ONWNRAWPEHWAFKY BSBSEVCC       
WVWJXVVQQSN     : ITUVGWLW        YOJCPIISRR      RSTDJYXRGSO     LONEIEL        
SIIAWAYEWK      : HWLWSHEUD       RIBUMWH         MFIPHWUS       
NMOH            : VPMRSQGCFTQQSG  OIWSYT         
OLQLJOWH        : LWVN            LWICBPCFAOGDQQJ HQXPV          
SXEOLAJWKJTMKXJ : MEHKRXQQ        DBMEQJ          BNJU            SXGLFININPBKVW  YYJLJOESSTBUGW  VVCRHPW         GFRVJGN        
MYKEI           : LDXJXDWTQEEYWQV DCVJ            MDAMOWOBBXAH   
UTRIFGHNVD      : XMNDWSJRYBEHQ   QAEJQJNYUXWBV   YWOVYIT         RTRDAHKMF      
ARCADBK         : ICXQ            XECUIEDYC       TLFB            EQIIAJHWHPRUJX  MIFRGCMPJDUFOV  HCIDHUJFRYWH   
UYYVKXKJIQ      : MMQEJLS         WPMA            VDXXXXY         AYCWGRORF       BKHAJTUSLQBFICT
LLNEVS          : IFST            PVRWWDF        
EIIH            : BGCOI           JATHODLNV       MOKLGTUPLBMSCNQ KICQ           
IBBKECWSYVT     : GKJFI           FJXUJXOFMJFF    VEBHIGRINVBQJMF DOPWMBJXEQWDK   ABCIYINMIMG    
GRIPDBHON       : XOUCD           DXOKUFEKBL      MLUXQMG        
SJQGNYOWXAXBKED : XMNDWSJRYBEHQ   UDBLNJIA        IXHO            CKLMJJMNHMMCU   FXKQESYXKG      XUJRGYUAJXVWWF  JYDJEGXGWW      AIOMEVC        
WFEQCLLMDOOLDE  : BNJU            WUXUBXM         DSTWLFBTLC      VNPRLFB        
WPYFGBVD        : YHDTCPKWDWFLDRF KIFMLHCGW       ILGGTPWQ        HPBJG           XJROITC        
VEBHIGRINVBQJMF : OHLBNDCQRUPSBWN FJXUJXOFMJFF    OGPHLMYUSXTS    IBBKECWSYVT    
DVBHCLGSN       : BFNHYRDJQSEHL   CVUCUAV         SNTBDAULCIH     ATQKDH          ERADKR         
YOJCPIISRR      : DXCNVPVTY       WVWJXVVQQSN     OTIGRIYD       
JCPHDI          : RIOPBJNNSFU     SDEKX           AEPORIKEGHJESA  DPCXPCIOLNJ    
SQHVMKFPVLIL    : ESADEQUYXPKIHH  NWTKNXY         KNAHXP         
JALLS           : HXLHQOEEIHUVAW  IEKQIVRLUMCIHY  FBTTHTV         IPPWUQEN        OICIWTBGDKDREO 
UNNOPWQGGVOAOF  : JFCPAKWUX       XSGPEHW         MTCNG          
NUTSMSHWEI      : HQBAGCBBN       ILXQGOQRFE      RKFSM           EURDUYHC        SCFR           
HTRAR           : AKTIHFKHIFF    
NFFGEVMLUDLJLVW : EVQTSOBTIKP     ODUWKYRBDTO     CORAJAOOFUVW   
PSUIARPIA       : WMMWBPI         HQBAGCBBN       GUQI           
FTYW            : MUJIIM          XXAPF           MQCS            OQOGMVBPYJK     UUHHNCUJB      
ODQUHNJUKPHT    : OHTNWRNWKSDSKV  IGVIEESTFNJRX   UIGDEOEQG      
DTLUMIG         : VUGAJVUSMANNXRE SDFXLGDLGAKE    ICHSTWH         ERYVTVWQ        DXOKUFEKBL     
CVUCUAV         : EAFYTNVIHRFAOE  PJVGL           VVEUNVPIJH      FAYMWTHIOF      DVBHCLGSN       RYDXGFBLHKQS    SHERY          
AHKDY           : PJNKIALBX       XNPYMCUCRLIIWQE MYOEPAEG        LGRBREXCB       CMRKEMB         AWDH           
MORIYJPUMU      : XUYUIUNOQUSFPA  SLENPJOSX       BDFRHWDNSNBLU   JTVOG          
APFIXRMTP       : XNPBXE          LIWA            RMADFAXKC      
QRNMR           : FQBVAMKXIWH     PNHKS           RHYJJBO         FQQR            ERDALC          THNFAHDECBTPH  
XWXGKMASNKKL    : EFNCBSNEYSIQH   GCTJQOEEC       XWEABQJSAU     
FECWKKVE        : WWRW            LSWAIKND        SXGLFININPBKVW  LEMOWOWYPXYC   
RVQJOG          : LSRCSGHUKS      RIBUMWH         AMXW            AODTBFAJIEC    
IGVIEESTFNJRX   : XSGPEHW         BQRDHGJBDGI     NWTKNXY         IRQQ            ODQUHNJUKPHT   
SFAU            : ESDTIUXMFD      PDKTYPLT        YBYVNIQIURSSY   FQELCN         
KICQ            : DUEA            EIIH            NBQQVHAIRC     
UNBGEIEOO       : AIFHNBRBWKORSG  IPCE            SCJVVO          EPDDYMAUKTEPJWA SOFNBPVYAAWRLQO CQRPHKYIPKDHXJ  BSBSEVCC       
WUHROOFYGF      : MQRAB           FPAHSODCII      QDNKVM          LCBT            LKUSQ          
AMXW            : XBEM            VQAINPIIBEFKSM  RVQJOG          NPAKANULXXHL    CDLJOFUJEXWFW  
IFTCPQPRYTCGIS  : NYXEBNAQW       YYJLJOESSTBUGW  BLTSOIMCXM      EOLYVN         
INQADG          : YSAHTHDILIXE    PBJAXHU        
EOLCQYBO        : FPAHSODCII      GKJFI           PRIIUBP        
LVONMGD         : MFEBGH          GXOFETLKBYYS    DVWDJB          XDUFJPKATYF     IXDTRRSYTIJXH  
HYGNKYYSOS      : JDYXAMYKMLR     SFBBLN         
TBYXPNBJOCAJN   : PNTGSNXY        PKIORMTRSV      KEFFD           ODYFSRJUM      
XCIG            : JYPQX           GNHMNGEQTFXYA  
MOJUETVEMLW     : UWWYPJQSLAQY    HQXPV           CQQNWYIWDYQJVT 
FXHG            : RIOPBJNNSFU     YSAHTHDILIXE    LWVN            HVHLOIECXYI    
WHBNLBWBXW      : CKRDP           GELDHRHDL       BUYWK           TVGRJGYKPBVYFCK
IGNX            : THFMRIFW        QIVW            ADPHBBGMWSR    
YSBSRHHDG       : XMNDWSJRYBEHQ   LPWEK           IJHUVBYYPMKR    WSUHHYFMHDH    
IGXQYWXAKLCJNCJ : CPKGN           UQBMANABQF      WEVNADO         DQLHGUCECPMMDW 
KPIK            : YELDKDOX        AXAVXUYW        SJUGTPLDJEWLI   GPEPBOVILL      XSVN            UWTOXBXBYDDN   
JGNCXX          : HQRADDYARC      DNLGAW          OYJFMCATE      
BEYLLYD         : FLGXBG          IGCPFV         
WDMHRQTFS       : AUPT            GWRIUPTJE       OAWQBDO         XSESUJKLDHW    
AGSLSFUYU       : XXKIGSFGRNP     VFIBUJ          KXWLPQY         NWWKMFBSUYQYQBJ
WSJAAKONKTAH    : KIMOFTRGDKRSOY  AXAVXUYW        IXAPTIEQXMPDHSQ
OQOGMVBPYJK     : TTVMEHVBD       FTYW            QVQHTEWWLQQV    OAWQBDO        
DRHCPHCKT       : PHHREANXNDYWYF  MEMBLVDYBJAA    BAOXAVGHVJT     BUYWK           IPPWUQEN       
KGSASMACKPTBXIX : WYEKQMFIIOTQ    QYIIAG          SGLKINFFEJX     YROEBHRDDQI     RRKGKIYND      
YYJLJOESSTBUGW  : SXEOLAJWKJTMKXJ IFTCPQPRYTCGIS  AISUTLPHKGXAK  
RDSRWGUY        : LVWMNWBGP       VNCCDFQPRGNDJVD NGIRIJSRELLQTVY
MUVKEVJFUUQEL   : CFKQKTWQY       UDWYGSVOWJM     KUWKGIS         VFTMXKYRDFKHRU  PKVQGAOIDSTF   
AFSBCA          : ICQBNUOLYKQVAS  BRHPKVOIMO      IEKQIVRLUMCIHY  PVKLIKKDTLQCEFR
ERDALC          : QXXS            GACOTJTFFM      QRNMR          
GCBUYWFDTRI     : MRJWXBQJUEUMJ   ACLHWJMSIDNXEVF OHTNWRNWKSDSKV 
MCVBYV          : RTHNQHTBWDO     BYQILAPTCTBPBA 
SYKUY           : FTAGH           SGNO           
OEPAHXJJBEIXMO  : VGWBIVUMT       QJUHUPXDYBK     NPAKANULXXHL   
EYJQBHRDDA      : CFKQKTWQY       GWUJTF          IJHUVBYYPMKR    FKHEQHMUG      
ENSFFHJUJQUU    : MUWTCWS         WYVWTRYTIKS     NMIJCO          VGSWXQMNKRPLSXU SFAYRXXSI      
VANVME          : RBWOXK          DTUPACPOGW      LGSJKCQNC      
SDAJFHEIMGGSVY  : VYDIKTDVTMELM   KYTDTY          CIFXGLHFNIX     EPDDYMAUKTEPJWA MGGHGJJYIPQ    
BIJXR           : VLIPXVD         TKGBJPCRHH      MTLMBCYGVYAFJDD SRMVIBIKYQJ     TYQXGTFNTPJ    
SNFQPS          : MFEBGH          USWKMEGGQWEOQB  ILXQGOQRFE      ERADKR         
EWEW            : MEHKRXQQ        EVQTSOBTIKP     GELDHRHDL      
GIIPOSEXYWTAWVI : AFTFR           XFMYKO          EYQTKDJ         AWDH            OJSOIJBE       
TCHPPPIHKVLICK  : RFDPLMOEEUK     OVBQ            TNRQEWFVHE     
ITVAIOEI        : MUJIIM          BARJVEYBLQ      BQRDHGJBDGI     VLKYV          
BDRXYA          : QLIAKJ          CNAN            GXINJLDMOUH     PJVGL           BFGLM          
UCOMUEVCPTQAW   : GBOLSTQGKJEFUPH JRUDIJESF       UUHHNCUJB      
NHULIGCOOR      : TPEJKTJKRJQAKSR TUODOPJVYCLG    GEKRFOOPPJIS    SSQXNMVBTYWHD  
RJQSLXQ         : MAJOTIU         BJCYNEBAH      
PDKTYPLT        : FGKWI           WJDHYBSDINQM    OLQDHMEGJ       UMEEMWLUMO      SFAU            QBSGITPCXSUIIGT
NSHBADOKLQ      : YRLTUIOFQLHS    EEYCIJHBHCNVVMC PVKLIKKDTLQCEFR
AISUTLPHKGXAK   : PKIPCSR         CISYIU          YYJLJOESSTBUGW 
VLAK            : FDGHLNQMJBM     GBOLSTQGKJEFUPH
IXAQCDVQPH      : XSHIHM          XWEABQJSAU      PVRWWDF        
PJSKGNY         : OUJXHF          VALRWBDRV       AJLPFYI        
ULDUNNGJCIVJRU  : MLLXDRPGQN      LCCHLNP        
KWNGNDPXVBRII   : EACC            FCJBDYSQKST     RGNQQ           MVETHJM        
JFEU            : IMJVL           SWDSWQGNIEAB    YWOVYIT         KMVSLLLKECCGP   XTKLBBILOON     CYQCKWMBY      
AIYIUDSQM       : LIFSBS          EOMURXI         YIAHVEKBBGQFU  
NWWKMFBSUYQYQBJ : SNWHIMMWS       GGPYOPIHBFCJ    AGSLSFUYU       MKRTN          
LOFGYFR         : TSEKOURLBQKN    CQXM            SHERY          
PMDIFSTTPQ      : YDYVNC          RIMKACLGCA      GWNMCWKKVVFOUP  KNAHXP          PVKLIKKDTLQCEFR
FYHATJQUCTEDFUI : FLGXBG          OMEIQYUNKBKOL   KIMOFTRGDKRSOY  GWRIUPTJE       FKSKLESJUEESDWG
UNGWDU          : HDKEYGYIUMW     RMIIWVRDDPI     IRQQ            OYLRSHVXENSOLB  KNAHXP          NSPC           
LAVHTNBBUA      : UNEITW          SSTSTMW         GIUACNSEWBDVXO  ORPUENVCBD      NPAKANULXXHL   
UVTNT           : IJLGKLIKWHX     ODOOWCNWM       WMMIOQPJXEHMY   IJOSPTUSIHRG    SUOBTSI        
IXAPTIEQXMPDHSQ : BMCPRVYMBBDP    WSJAAKONKTAH    CQXM            ILQAYJYIWESOTSF
OYEF            : HNHBSID         FHLVXXJX        UWTOXBXBYDDN   
HAESVAM         : OEVGKIW         RBWOXK          XURYJGYSOP     
TLTUL           : HPWNQ           WBLLI           KHQVILUKBEP     QVQHTEWWLQQV    BLTSOIMCXM      THILG           IXDTRRSYTIJXH  
QVQHTEWWLQQV    : KVHCFEJ         OEVUJP          WUMFMR          OQOGMVBPYJK     TLTUL          
RDOTKPXFLAUWWG  : VLIPXVD         FGMUYDEYJMMIX  
TSEKOURLBQKN    : WKXYUEABPHIE    OHTNWRNWKSDSKV  JVIFLMTXYKDHUSK LOFGYFR        
BLTSOIMCXM      : MUJIIM          MFBOBWCLWAYQ    HQBAGCBBN       UKYNKAFAF       LPFSOTA         UAUD            IFTCPQPRYTCGIS  TLTUL          
LPELOLFIGLSWI   : YJGALWJBKWSS    GUQI           
IKFVAP          : BJCYNEBAH       VGSWXQMNKRPLSXU NSPC            GXYHKBBQVTPNBU 
LLQDTFFSUOG     : DGOCLIEHMFHO    MDICFT          EFOJYEIWBGHDIE  QSOMKHMGSVR     QWHSF          
VTBJYLPMG       : PTMKWUOSQF      MNYHNIDWMLJWMP  HNHBSID         PWTCBNQHHM     
VUXIAT          : RFDPLMOEEUK     HOFKNC          DQLHGUCECPMMDW 
RSTDJYXRGSO     : PUGLIKGOJL      XBSSKNLCNAUI    LIWA            WVWJXVVQQSN     QIVW           
BBTVEDUP        : TTMPVURWGMCXYKN MVKJB           URXDKDYFYVEAOOT GSQRHCKM        NQTWKANUVTCAMT 
KVHGSH          : NARWTO          VYDR            CBNWW           VECAWI          SNWHIMMWS       TNRQEWFVHE      KMVSLLLKECCGP  
SDYLWUQIUOAB    : UNIFKQBBCFMHC   LUNRINKBPS      PBNMMNULCIXG   
OYLRSHVXENSOLB  : PUGLIKGOJL      NYYQJC          UNGWDU          QDENEIOM       
EKLAOMNLIETD    : OMEIQYUNKBKOL   UQPSKIQMKNXMOG 
WEFNEQGYAEXFS   : JILXMW          VVEUNVPIJH      UQMHMC         
TGTRLFFL        : CNAN            MOXO            TQJYQSGTYDIHVYQ UXJHILLT        IXYXMDGSQCVN   
SBHBFDEBAKJ     : RXNWDV          FBTTHTV         BAOXAVGHVJT     PBNMMNULCIXG   
OAWQBDO         : AHXSWHCNNQM     NYWWXEGBCRNUU   UCDEUO          WDMHRQTFS       OQOGMVBPYJK     WXXPASVOFHBR   
XHCFCTQJCEFUHO  : NARWTO          RBXJGOUWMABSBAM
MTCQUMAL        : RVWQUWJMTEOOIC  CDJJFOJHFRKJW   MJXYKJVSSBEDK  
CKUDNLLMSQ      : LXKEOGTNHS      MTCNG           IJOSPTUSIHRG   
WMMIOQPJXEHMY   : WWJGIY          UVTNT           NGIRIJSRELLQTVY
DVWDJB          : HDVINVSLRHRCOC  SWDSWQGNIEAB    KTFBHP          LVONMGD        
VXLLJ           : SWUKPAM         OFTIKBCJJUNOPG  MHONX           SNOHDQYWMNQQCA  GUQI           
AEQT            : CYRKSQPJ        KBRGSQWRFFVLJCF
FGMUYDEYJMMIX   : SDEKX           DTWRDTGCJB      AJLPFYI         RDOTKPXFLAUWWG 
GWXRAGNXRAHTCO  : MAJOTIU         SUOBTSI         NGIRIJSRELLQTVY
WSSDF           : SSSA            SNIDFXOAYL      SIUC            VKDD           
FITESISDHLMGJE  : KXYJTV          AUPT           
RUFJUP          : YAQXQALSLOQ     HNKGGMCEPE     
YEUVWNCEDHNXNI  : EVCGXUNNDAM     DPHEW           HPUXDRBKUDNBEL  CWNQSHEKN      
HLRSAYEFGVA     : CIFXGLHFNIX     DXOKUFEKBL     
HWDPVHLUGYWLFG  : EDKJ            AXAVXUYW        YYSYIDRPSIVA    PWTCBNQHHM      SFALPBQF       
DTJNDWGXXFCFL   : KIBDJSLDPJ      VGFOPO          DXGYEQIOOHJALC  JFCOWMUV       
HYKEFACOLWXNVJ  : YJGALWJBKWSS    JYASJMYQNLA     BGAPDKVIFI     
EMXBX           : AVDSM           PWYSG           EFOJYEIWBGHDIE  XLWJ           
EURDUYHC        : VLEL            NUTSMSHWEI     
IJOSPTUSIHRG    : WJDHYBSDINQM    BMAHFSBFPT      WYXEYEUJKJI     UVTNT           CKUDNLLMSQ      NMEKNHKJVO     
ORPUENVCBD      : DOVULAPALUIUPNB WPMA            LAVHTNBBUA      JSYDLYYYXW     
TGWUPCIXLWSCSO  : XQUVLJ          LUCGURBGT       CBKUXILIW       YTILUPJGS      
DXOKUFEKBL      : JSJIQSJV        PSHDFDW         UQMHMC          GFHU            GRIPDBHON       DTLUMIG         HLRSAYEFGVA    
YPBCRWK         : VLEL            UDBLNJIA        UAUD            SFALPBQF       
UBTDBHCUJULIXJX : URLM            FHRYUECVFU      UBPWNMRECBBIJU 
GDRQGDSGUVKNVXH : MSSIFCMCVUWC    VNILURDWA       HMXOLHPLDJ      BRQRH           KBRGSQWRFFVLJCF
YBVAIXWUUI      : WLDQDYKHAIOHSNU XTUUIDXII       ATBAF           NEYRUKSQXQ     
UTDIAHA         : DCVJ            ODOG            WKLUK           HUMKDAYGA      
PFNXC           : UFAKYJS         WAJVPFAUQ      
JRIJYYI         : CNAN            YHDDXIYFVY      MXIJQ           XYSHOFO         DLQRMEANV       HMMDQ           QJUHUPXDYBK     WGXLSQYIAM     
WKLUK           : OOWBKRPVECA     XLWJ            OLHSLCJM        UTDIAHA         LXIOPBFHTXXDVG 
RSLMPPWPY       : AIHKP           RLRFYUGYWRW    
LOEYNJL         : GXYHKBBQVTPNBU 
BTIBUS          : JJIUKIIBJANYAPM UDGFJD          FUKUYTPCVBTM    LKUSQ          
RFOOPWILJXBB    : URLM            SDFXLGDLGAKE   
SAUEO           : CFVJKBIKUIBWWV  SOFNBPVYAAWRLQO XMPGYXBV        MEVUPQOTCBK    
GEKRFOOPPJIS    : VDXXXXY         NHULIGCOOR     
OIUEFEPQCSRYM   : AQMVNSMKSNGNA   SOFSTSU         DEIHYPVPAGCGK   DAJFKP         
VSJXYPKTXY      : FARDRU          BIKBDCI         FGKWI           IJHUVBYYPMKR    VTPCJW          DOMGHETATIWJ    UXJHILLT       
NQTWKANUVTCAMT  : AFTFR           TTVMEHVBD       BBTVEDUP        YJYEAOVBIMOBXWH XTKLBBILOON    
FNFTIC          : OFTIKBCJJUNOPG  IJLGKLIKWHX     NMEKNHKJVO      EIPBLSIIYVDHWCJ
TAOJMIJOSXFPWRP : OALVXESFGIUY    CFVJKBIKUIBWWV  VBUJFQFKBBNYNGD
OLGR            : YKVDSEJISMXNHBJ UFAKYJS        
SNTBDAULCIH     : MLLXDRPGQN      VNEIGSLWU       QYPAMHFLGVCJF   TBAJRPLFDEQPN   DVBHCLGSN      
ATQKDH          : ESDTIUXMFD      CEPSHDHER       SQXPWRKC        HSEU            DVBHCLGSN      
BPTX            : TVIE            LSWAIKND        SNWHIMMWS       MIFRGCMPJDUFOV  BTFAUFOAOHRQDF 
LKWXR           : QKCB            LGCUTHSEGYD     FBTTHTV        
NMEKNHKJVO      : MJOHLTUBTBL     WDASRGTK        IJOSPTUSIHRG    FNFTIC         
DSTWLFBTLC      : DJVIOJMHRYLM    LNBQD           QPHVVTXJ        XSHIHM          WFEQCLLMDOOLDE 
HDSS            : XHCNGPLKHWQVE   YBMQXBDFSCYV    HQXPV           DOMGHETATIWJ   
RSHIHUMRKWE     : RXOF           
SSQXNMVBTYWHD   : DVPHDERCKCYMK   TRDCUESVGQENP   NHULIGCOOR     
OICIWTBGDKDREO  : VFTMXKYRDFKHRU  TRSLUVMCCEHSDCO JALLS          
KKLFBK          : DWOIROJNLEVOEH 
QIUKJRSMBJVFRUY : GBOLSTQGKJEFUPH LIWA            SUOBTSI         QKLWNC          YSWDAXSFKO     
DEIHYPVPAGCGK   : OIUEFEPQCSRYM   IYUBEY          RTKTJJ          UUHHNCUJB       SFALPBQF       
YBYVNIQIURSSY   : GRSNSH          CBKUXILIW       EHSOTUFPWBRPC   SFAU            JAYDW          
PAITFTBGJWXJFA  : BCHWNHFYX       ADBRAMMEJ      
PQRSPP          : TRTFBVWVEDONAVK XTKLBBILOON     VKDD           
XGPVAKQYXHAI    : DPWAECAKHUS     IXHO            OUCFMOYEIUDWBPX JVOMDI         
HCENL           : UGTQ            SCJVVO          NPAGSEQNLD      XBSSKNLCNAUI    OLQDHMEGJ       MXQIOWLGIQYEVT 
LXIOPBFHTXXDVG  : TMYPBVFCBVNS    PJVGL           NMIJCO          WKLUK           BTFAUFOAOHRQDF 
THILG           : HPXIEBL         GIUACNSEWBDVXO  TLTUL          
UGPXNRCDGH      : KUWKGIS         HYMCBGB         GFRVJGN        
EPGT            : CDJJFOJHFRKJW   YEDDOWRHLW     
NEPL            : QLIAKJ         
UKKSERC         : LCCHLNP         XJROITC        
BIKHAIXUMDBTUH  : WUEAIOWOQ       WOGG            PSHDFDW         AODTBFAJIEC    
BDFRHWDNSNBLU   : KQKLPNHS        MORIYJPUMU      EVKVR          
NKVYXGYIG       : EEYCIJHBHCNVVMC CWTABDQDFN      QIVW            EVKVR          
VJUR            : NBTX            SIGQGD          CQQNWYIWDYQJVT 
CEGIMXRJ        : SSDTAQUKFCPYC   JSJRNYQ         DQLHGUCECPMMDW 
GCTJQOEEC       : RFDPLMOEEUK     CQUTAIYK        FUKUYTPCVBTM    NKWGQENOCVFMELV XWXGKMASNKKL   
DAJFKP          : OIUEFEPQCSRYM   WGXLSQYIAM      JDBYYSQTALNSPFS
IYUBEY          : QMQL            DEIHYPVPAGCGK  
NJRN            : MRJWXBQJUEUMJ   NDFVNTJXGOFSCHD OCKXLQAJUSINTFS UNIFKQBBCFMHC   UKUXHI          FKSKLESJUEESDWG KFILB          
ERII            : NXNTMVCDDC      XSCBXXQG        FIVLFWHGKBFMEWK SJKT           
RYDXGFBLHKQS    : OEVGKIW         WWJGIY          OMJTGGTE        CVUCUAV         BKHAJTUSLQBFICT
QDENEIOM        : GDJLOC          OYLRSHVXENSOLB 
YGMBKGLTUFUB    : RGXOVPNL        TTMPVURWGMCXYKN KSVTPVBCWLBY    DOPWMBJXEQWDK  
BIFPQRGLWYO     : WMMWBPI         YSAHTHDILIXE    OPNOC           GMAAQHNMNQGJBDI TQJYQSGTYDIHVYQ JAYDW          
MVLEIK          : NJBUY           NDFVNTJXGOFSCHD ATBAF           NHUXA          
OYGAHR          : MFFFQATUXNU     EHSOTUFPWBRPC   TDAL           
FWQGAUO         : CICPYOAYBMGCE   QNCTSCKVD       QIVW           
MHCSUYUMAJ      : UNHYKKTSJ       HTXIWBRS        UCDEUO          UBFDCDE        
LNSVS           : VLQOWWDGUH      WYXEYEUJKJI    
WYJFQH          : IPQHBAYX        PWYSG           BODMYGVJBEMYDIJ HVKTETBAWUITGX  EJJFRG          JDBYYSQTALNSPFS
NBQQVHAIRC      : RVNIL           CSGIQOO         KICQ            CVAVUIFCKXMXUDB
MBABBKJPAEN     : CDJJFOJHFRKJW   UVTPVBFXGWWJJDQ YKMYFKJWCIRSM   TTBJRANDPLU    
MLUXQMG         : RFAKEIDAMAQFYF  GRIPDBHON       EVKVR          
CHTUFDVPUXUKA   : UFAKYJS         EQIIAJHWHPRUJX  MKRTN           BGAPDKVIFI     
LDIXSICHEQUCPL  : YUYCNIDD        RDOVGDMAKRVLVEH
XOSFKQMNMCLM    : OANXGRYMBXFBSP  HMYCHAX         UQPSKIQMKNXMOG  LMRJKJARP       TBAJRPLFDEQPN   KNAHXP          FTSLGKICMLPEUA 
VOUHUDF         : KXYJTV          ICDPNBXEFHGPOB  SCFR           
OIWSYT          : JFDAWGA         RETAJLYLJKSRVC  SQXPWRKC        GMMTILMCMP      LPFSOTA         UBFDCDE         NMOH            IXYXMDGSQCVN   
OIWSYT          : WMSHRVIQOYMOM  
QFLOVHVIAIY     : QXPAXYDRBUE     BTERA           YAQXQALSLOQ     RDOVGDMAKRVLVEH SRFESWAR        NGEPFRAVEMNRV  
KKBKISFPNJXDXGD : TVRVDBP         RDQJNXFCEBXTD   TSMABDVP        FIVLFWHGKBFMEWK HMMDQ           GNWOMWCFF       MAJIOXHTOIYLV  
HWQYF           : DUEA            WOSVNTEQCVE    
PBNMMNULCIXG    : XTUUIDXII       WBBGVE          SDYLWUQIUOAB    SBHBFDEBAKJ    
GBXVOJVTJCWFM   : VEBBLFYFVRMU    MLUKUMQIVO      YKMYFKJWCIRSM  
VNCCDFQPRGNDJVD : LODWEUYQ        ARHLLEDRPHSL    MECUAY          RDSRWGUY       
OJSOIJBE        : TPFDN           FBPECCE         GIIPOSEXYWTAWVI
MJDRVAPLCSOHL   : VSEEHADWCFPEFDL FJXUJXOFMJFF    XSCBXXQG        ESXNMDJFQRQ    
ARUF            : QJWPEDKJ       
QJUHUPXDYBK     : WWAQQURATE      WUEAIOWOQ       VQAINPIIBEFKSM  OEPAHXJJBEIXMO  JRIJYYI         CYQCKWMBY      
OTIGRIYD        : AXAVXUYW        YWBHRWVQTWN     YOJCPIISRR     
TRTFBVWVEDONAVK : RETAJLYLJKSRVC  OHCUEHDDQ       DTWRDTGCJB      WNGTHAQBGXHHUT  PQRSPP         
WQRXBYMUHVORU   : FVDRPBLK        BMNLNSVEXTMPN  
EOLYVN          : LXKEOGTNHS      UKYNKAFAF       YCWUQYDRLEYDIU  IFTCPQPRYTCGIS  SHERY          
ULYXBOY         : WBUBOLTRRTSYHYJ CSMKEI          DCVJ            FVXJDYHUOEOMSF 
CRVSLWTLJQUH    : FPAHSODCII      OHCUEHDDQ       YDYVNC          DVJQASQJSBJYUB 
NEYRUKSQXQ      : OPJJRHAASUUVU   UWWYPJQSLAQY    BUYWK           YBVAIXWUUI     
MPMNHNMJH       : EURQG           MUUQULKHR       PWYSG           HMXOLHPLDJ      FSWMYC          QJVIAEJUGXQSDA  VVCRHPW         WMSHRVIQOYMOM  
CTKXHVOE        : SSDTAQUKFCPYC   KHVNXSF         PMSCWC          HVHLOIECXYI    
VTIUOEF         : TVNTUPUGNRKIBFV MOGFETPYDQOM    NWGWLKIAQ       RMADFAXKC      
WGXLSQYIAM      : MVETHJM         JRIJYYI         DAJFKP         
JUKNQUNAREEVA   : EQIIAJHWHPRUJX 
GWNMCWKKVVFOUP  : YERNTVRLUIP     CBNWW           EPIMWNMPSPVRJP  SNWHIMMWS       LPCEEBXTBOHUTL  PMDIFSTTPQ      BGKTQOS         YSWDAXSFKO     
KNAHXP          : TTLRJGOFL       SQHVMKFPVLIL    PMDIFSTTPQ      UNGWDU          XOSFKQMNMCLM    SHERY          
TDAL            : CDJJFOJHFRKJW   SUFYRVYWKBBBJ   SNGQQREG        OYGAHR          PVJHNVPBOPNOF  
EJJFRG          : EURQG           MEKUYIXGMVRRV   PRGWMGUGVBP     WYJFQH         
FKSRXQ          : AYWAFBJJ        VYDVP           UPCSLXQXVNLYHOE KSVPPPKMESYBP  
FHLVXXJX        : WKXYUEABPHIE    LWVN            OYEF           
JPFD            : NSPC           
FQELCN          : WSFJDFDCPNEW    JRNQXER         SFAU           
UVOCGHTGAHMH    : XBSCQDAHRSFAK   EHSOTUFPWBRPC   VTDRBMKWSQU     WWQBNJ         
IFST            : VPQWSFMTM       GDYIWNV         GWUJTF          VJWWLCUQ        LLNEVS         
XDUFJPKATYF     : QCLRLSMSPMCDNPP FGKWI           USNCMFTTTKRGMO  GFHU            LVONMGD         VVCRHPW         BHWFLTIAYABIYEF
SCFHE           : EAFYTNVIHRFAOE  ETWMFSH         XUJRGYUAJXVWWF  UBQHHG          VSEEHADWCFPEFDL
RXUTHJE         : USNCMFTTTKRGMO  SNWHIMMWS       EFNCBSNEYSIQH  
RJXL            : BUPH            VBVPKMPX        TMFBADYPAATHGG  TTLRJGOFL       KLGX           
YROEBHRDDQI     : TTLRJGOFL       KGSASMACKPTBXIX UUHHNCUJB       BBEUQS         
LKUSQ           : MDICFT          EVCGXUNNDAM     AWNKHBRMHCMCM   WUHROOFYGF      BTIBUS         
MOJHYSLENWC     : MDICFT          NJBUY          
QBSGITPCXSUIIGT : FNJIFLPD        PEMNRNDRBA      HWNXJAF         ITSLJRWHSJT     OPJJRHAASUUVU   SVLXLCR         RGOSCKHXQH      PDKTYPLT       
BMROCBXDWL      : HMXOLHPLDJ      GXOFETLKBYYS    EQIIAJHWHPRUJX  MQCS            WYXEYEUJKJI    
KKJLENFMXYCAY   : HWNXJAF         RBUK            LGAQMP          JVOMDI         
UIGDEOEQG       : WAFFISVNGLWNAW  XTSWDYFCRXDHYS  OMRRDSE         DPGONQSOGUTILC  ODQUHNJUKPHT    AODTBFAJIEC    
UKUXHI          : RGXOVPNL        VPMRSQGCFTQQSG  JATHODLNV       NJRN           
RTRDAHKMF       : HQGWJQAMPAXBICE UTRIFGHNVD      NWEYJCKJBEIGR  
QHLNEVVHCKNTRLQ : YBGG           
GPLRWFNO        : VHVAEVP         VFIBUJ          VOQMIHQVRIMDFE  MCVANXCRXIMMA  
NXVAFKSMVGSU    : NGHYFHQXA       JSJRNYQ        
CWNQSHEKN       : TTMPVURWGMCXYKN MFIPHWUS        YEUVWNCEDHNXNI 
AYCWGRORF       : RQKXH           KEFFD           UYYVKXKJIQ      CDLJOFUJEXWFW  
NHUXA           : DJPRWI          MVLEIK         
VJDSMFQCX       : GRSNSH          WKXYUEABPHIE    SJUGTPLDJEWLI   QJVIAEJUGXQSDA 
MCVANXCRXIMMA   : BGLKW           SGERDILCJGIFYF  CDJJFOJHFRKJW   LWICBPCFAOGDQQJ GRXQTOCLIRPJ    GPLRWFNO        YVLWXLRWVRRM    KWAVNAX        
DPCXPCIOLNJ     : NRWEBIJQWEXJ    TMFBADYPAATHGG  DVPHDERCKCYMK   JCPHDI          MLUGVCVYK      
SCFR            : NYYQJC          NUTSMSHWEI      VOUHUDF         TNEDGOONWMTQKCQ
RTKTJJ          : IVTA            UWXUISWE        LQRVJQETC       KLGX            DEIHYPVPAGCGK  
EHHQVJKBCMARPKI : RGOSCKHXQH     
XSESUJKLDHW     : PNTGSNXY        RJCEDS          WDMHRQTFS       SGORSAKVAY     
QIVW            : PNXSKB          OPVPIOGPL       TQJYQSGTYDIHVYQ IGNX            RSTDJYXRGSO     NKVYXGYIG       FWQGAUO         IXYXMDGSQCVN   
QIVW            : CPUWOVNTLXNHNO 
FPPOBQQNSLFDT   : PUGLIKGOJL      AJWITMNC        OMCYFVYIBBKSDP  KIBEP           SGNO           
DOPWMBJXEQWDK   : WAFFISVNGLWNAW  VQNR            XHCNGPLKHWQVE   SVNGDA          MTQOPB          ODOOWCNWM       IBBKECWSYVT     YGMBKGLTUFUB   
YJYEAOVBIMOBXWH : QLIAKJ          VSLKIIYDXORR    NQTWKANUVTCAMT  HVHLOIECXYI     OGKUWD         
GKLX            : HBMMSQAMIWJDO   MFBOBWCLWAYQ    TQXDNANGUBPCE  
XYTYDKVGWEIHD   : EURQG           EKUX           
HUMKDAYGA       : RGOSCKHXQH      UTDIAHA         TVGRJGYKPBVYFCK
NWEYJCKJBEIGR   : OYPKMOV         RIWUYXXM        HQXPV           SGIMB           CORAJAOOFUVW    RTRDAHKMF       VNPRLFB        
POJAXOQHJERO    : LTTCTYKJR       TBIODS          NYRPSSLRHTNO   
TVGRJGYKPBVYFCK : TKGBJPCRHH      TPEJKTJKRJQAKSR JTEDMLJA        WHBNLBWBXW      HUMKDAYGA      
TPDLBF          : NARCH           UNHYKKTSJ       YVNITYTHPJKUKW  BYQILAPTCTBPBA 
PWTCBNQHHM      : DULBBFWHVBXLRJ  VTBJYLPMG       HWDPVHLUGYWLFG 
CYXBLNEJPLMAAI  : QXXS            MUJIIM          MYWTDJKTHMGY    HYDHR           MENRPUISHQILH  
FTSLGKICMLPEUA  : QHJLXTKJD       UDBLNJIA        HNFIWKUUFS      DJAJIQ          LEJMMADGVIEWI   FFHYEQIFLWVF    XOSFKQMNMCLM   
MCTLFGBJRS      : ESXNMDJFQRQ    
ESXNMDJFQRQ     : AGURDPYSJM      MLYPIPI         WJOND           MJDRVAPLCSOHL   MCTLFGBJRS     
TFMKJJMFYOY     : FHACATFXVLV     PXWUVICCVKEHQ   SJUGTPLDJEWLI   VKDD           
THNFAHDECBTPH   : NPRSTWPCN       QRNMR           PRIIUBP        
WXXPASVOFHBR    : XBSSKNLCNAUI    OAWQBDO        
AIOMEVC         : OYPKMOV         SEMFATCTY       SJQGNYOWXAXBKED
VJNDO           : UNEITW          SLYYIQYGRT     
YEXFDYGTBBR     : LWIF            DENEQFJ         GMLOLVMHNWWCQL  CGUNQB          AVTWOMY         CHMUPVYGJIOFNV  IXDTRRSYTIJXH  
IYSCOUKDHQBKAAV : DVJI            WSJNCQSVDCTC    BMAHFSBFPT      FDGHLNQMJBM     SGIMB           BTPW           
FKHEQHMUG       : BHDPD           EYJQBHRDDA      JEDOKGUIUGFEU  
QJVIAEJUGXQSDA  : BYJSLNBEP       VUKYMTHS        BICIOLDIFLQGMC  MPMNHNMJH       VJDSMFQCX      
FKLFJCKTLQNSFIC : PJGOX           CBBRNWN         VVCRHPW        
BLVJN           : BWKDHQLMS       YVLWXLRWVRRM   
SJKT            : GGYABQCDGQKG    WJWS            URYMMF          OCKXLQAJUSINTFS RXOF            HMMDQ           ERII            OTPRTGURSCP    
DWCMC           : NNJKDFMNB       FIVLFWHGKBFMEWK
YJYDVUONKJSU    : BEHY            PHHREANXNDYWYF  BMAHFSBFPT      FSEFBBMF       
VVCRHPW         : CBNWW           PSLBANVWAHAUGED SXEOLAJWKJTMKXJ MPMNHNMJH       XDUFJPKATYF     FKLFJCKTLQNSFIC
BHWFLTIAYABIYEF : VYDR            AEPORIKEGHJESA  XDUFJPKATYF    
UUHHNCUJB       : LDGEQMM         WWAQQURATE      GWRIUPTJE       FTYW            UCOMUEVCPTQAW   DEIHYPVPAGCGK   YROEBHRDDQI    
EIPBLSIIYVDHWCJ : TBAJRPLFDEQPN   FNFTIC         
MIFRGCMPJDUFOV  : SDEKX           RFUMDQNR        MLUKUMQIVO      ARCADBK         BPTX           
UETVSPHBO       : JDIGLJYYEUOO    VVEUNVPIJH      BMNLNSVEXTMPN   WJSMRQKOKMRYV  
GXCIHDXR        : OUJXHF          USIS           
RXMFQWKLEBJKWP  : MJIOQJKEFSOYAOO LUCGURBGT       DINMNSPWLPAY   
SIUC            : EUCHBLHOMSRR    AXGIAO          JYVVHYC         OVBQ            WSSDF          
LGSJKCQNC       : MUJIIM          NWGWLKIAQ       WUMFMR          VANVME         
XTKLBBILOON     : VGFOPO          DNOR            JFEU            NQTWKANUVTCAMT  PQRSPP         
YKQGFB          : OPQYPWJ         FSWMYC          SGIMB          
KNOSHADLSRNDP   : SBGBVTQOACAU    XLCEPJMI        NPOMEEUIXF      LRNBSRWKS      
OBLRLWHCMHEYAK  : SSTSTMW         BGLKW           XUYUIUNOQUSFPA  XKBUIGVKKY     
CQRPHKYIPKDHXJ  : EXNJ            JFCOWMUV        UNBGEIEOO      
IXDTRRSYTIJXH   : DXGYEQIOOHJALC  MNLLBHFKXTXPC   GUWWWKWMMBF     NIKVNTBFUK      XHJGDVOCEKPV    LVONMGD         TLTUL           YEXFDYGTBBR    
IXDTRRSYTIJXH   : LMAGYDGYPVEYWO 
LONEIEL         : MCBHLMSYEF      TCVHPGCTDSJWLGW TPFDN           CQQNWYIWDYQJVT  VDXXXXY         WVWJXVVQQSN    
DVJQASQJSBJYUB  : VIXVOIP         CRVSLWTLJQUH   
QDMYM           : AJXAVAKEDPNVDS  CEPSHDHER       DFDXRQQHWHHSHM  SQAHUVBXSTBLJD  JIMBHUTEKMRW    OCKXLQAJUSINTFS KTFBHP         
IXYXMDGSQCVN    : FVDRPBLK        XUJRGYUAJXVWWF  TGTRLFFL        OIWSYT          QIVW           
ONIGYEHID       : PGFSVFSYOSMXI   SXISCESQGI      FAYMWTHIOF      WUMFMR         
JTVOG           : MFEBGH          BIKBDCI         MORIYJPUMU      HDWTDRNDRL      EVKVR          
BTFAUFOAOHRQDF  : LTTCTYKJR       JATHODLNV       KSVTPVBCWLBY    VYDVP           BPTX            LXIOPBFHTXXDVG  FOPAAKYRB      
SUOBTSI         : XVDMO           UDWYGSVOWJM     RTDFBMYAHEFDJAN UVTNT           GWXRAGNXRAHTCO  QIUKJRSMBJVFRUY
VNPRLFB         : UVNL            NJVRUADUJLNOG   CBKUXILIW       XYSHOFO         YTLUHLIJFHWC    WFEQCLLMDOOLDE  NWEYJCKJBEIGR  
GUQI            : XAWPYOJJEBAO    MCSJYNHIDQLW    TRDCUESVGQENP   FREHKNMQSF      PSUIARPIA       LPELOLFIGLSWI   VXLLJ          
VWSKEMDKTJF     : PNXSKB          HJFROODWGYCD    IHOSQ           QPHVVTXJ       
BGKTQOS         : DOVULAPALUIUPNB YRLTUIOFQLHS    XGJTYUNNYOGN    GWNMCWKKVVFOUP 
FKSKLESJUEESDWG : VPQWSFMTM       GXIHUX          FYHATJQUCTEDFUI NJRN           
MLUGVCVYK       : JXQH            KHVNXSF         AFADDPRQH       NTTKRUP         XNPQ            OCKXLQAJUSINTFS DPCXPCIOLNJ     VFMW           
SBXLIFWER       : EIWSXUIIKOBXJR  LSPTACAPWGPI    AODTBFAJIEC     CDLJOFUJEXWFW  
IMTFQXAUXIFKUC  : HDVINVSLRHRCOC  OEVGKIW         IXHO            YWBHRWVQTWN    
SGORSAKVAY      : XTSWDYFCRXDHYS  STYBWNMXDX      MQCS            XSESUJKLDHW     MENRPUISHQILH  
FXLYIVLFBFD     : LVMTHIGSNIET    JFCOWMUV        PPYTW          
ADMHPHLJARARMAE : MFBOBWCLWAYQ    GGPYOPIHBFCJ   
ADPHBBGMWSR     : JFCPAKWUX       LIFSBS          UQBMANABQF      BRQRH           DOMGHETATIWJ    CNJR            MFFYMJNJX       IGNX           
XWEABQJSAU      : TLBRDC          XWXGKMASNKKL    IXAQCDVQPH     
AODTBFAJIEC     : WQVMVRACSPS     RVQJOG          BIKHAIXUMDBTUH  UIGDEOEQG       SBXLIFWER      
HDWTDRNDRL      : MOXO            OYJFMCATE       JTVOG           HCIDHUJFRYWH    IDWFAMEN        VFEXUTU        
RMADFAXKC       : DQKAYQQ         DCVJ            TWVCCFYWSWE     APFIXRMTP       VTIUOEF         SHERY          
PVRWWDF         : VDXTXISKCAE     VPMRSQGCFTQQSG  YCCWDJUMJTVSYMK SVLXLCR         FDGHLNQMJBM     PNOVNQJJ        XHJGDVOCEKPV    LLNEVS         
PVRWWDF         : IXAQCDVQPH     
FVMJUJMOWRGIC   : YUYCNIDD        SKBGMWVQCND     TUODOPJVYCLG    FBSE            WCDFFDPHRH     
WCDFFDPHRH      : IAOREWTHRWPHPDI SKBGMWVQCND     KXWLPQY         FVMJUJMOWRGIC  
JEDOKGUIUGFEU   : VLEL            PCHCUBVOWMAQOE  EPDDYMAUKTEPJWA VAKPCSPJQ       HYDHR           QCEHBVONU       FKHEQHMUG      
CMAMOAKRFRWIJG  : XGJTYUNNYOGN    RWVBUUDUNY     
QKLWNC          : LGAQMP          QIUKJRSMBJVFRUY
VWRTDWXXQ       : NXACGYLJNSRJ    BWKDHQLMS       WEVNADO         GOKHGISNMNWS   
NSPC            : UNGWDU          IKFVAP          JPFD           
CVAVUIFCKXMXUDB : NUGLXWSSV       NVMDKHNH        NBQQVHAIRC     
BXYUE           : MFBOBWCLWAYQ   
VERXRLPUGTQH    : CLNSL           PXOYWQLIM       GIUACNSEWBDVXO 
OPUQDUFBQ       : RXNWDV          JTXNV           AFTFR           JVALKEMVDKW     TREGOIAPJWK    
CXOBW           : XXAPF           MCSJYNHIDQLW    OLHSLCJM        BOKURXC        
HVHLOIECXYI     : XXKIGSFGRNP     FMTYXBEO        FXHG            CTKXHVOE        YJYEAOVBIMOBXWH
RRKGKIYND       : NBDNCJVACQ      MLYPIPI         KGSASMACKPTBXIX
OTPRTGURSCP     : AUPT            OUCFMOYEIUDWBPX SJKT           
NGIRIJSRELLQTVY : SFAYRXXSI       RDSRWGUY        WMMIOQPJXEHMY   GWXRAGNXRAHTCO 
JDBYYSQTALNSPFS : VPMRSQGCFTQQSG  HQXPV           DAJFKP          WYJFQH         
MEVUPQOTCBK     : AJXAVAKEDPNVDS  MTLMBCYGVYAFJDD SAUEO          
WMSHRVIQOYMOM   : QKCB            EIAAI           OIWSYT          MPMNHNMJH      
HCIDHUJFRYWH    : XSCBXXQG        ARCADBK         HDWTDRNDRL      VAARYHXSQPV    
BKHAJTUSLQBFICT : NARWTO          MGGHGJJYIPQ     UYYVKXKJIQ      RYDXGFBLHKQS   
QWHSF           : VLIPXVD         YSAHTHDILIXE    VNEIGSLWU       WNGTHAQBGXHHUT  LLQDTFFSUOG    
DCVITWFDT       : FNJIFLPD        CISYIU          RBWOXK          PTWVIVIL        MMPDGKOAYUVGYY 
PBJAXHU         : SHQFRAWEOATU    DNXDFPHHIOQ     QBWDCOTCLJUWUMH NEJAXFFQDRRDM   INQADG         
AWSIBNGSMPNTC   : AVTWOMY        
VAARYHXSQPV     : JBJEUXEP        VNEIGSLWU       SNJTADGYSJUBMYW DOTRJTO         HCIDHUJFRYWH   
PVKLIKKDTLQCEFR : OEVGKIW         QDNKVM          EYQTKDJ         IOPT            YHIWJCXBUXL     PXOYWQLIM       TLBRDC          AFSBCA         
PVKLIKKDTLQCEFR : NSHBADOKLQ      PMDIFSTTPQ     
YVLWXLRWVRRM    : BUPH            PROQRVOWOEXARFB MCVANXCRXIMMA   BLVJN          
NPAKANULXXHL    : WXWGJBWBNJGRRIR JPCGFTJJJKFU    AMXW            OEPAHXJJBEIXMO  LAVHTNBBUA     
JSYDLYYYXW      : UCSWRYWDJEKEDCO UNIFKQBBCFMHC   QHTKIYHTLRIAUC  ORPUENVCBD     
PVJHNVPBOPNOF   : KLGX            TDAL           
CDLJOFUJEXWFW   : FPAHSODCII      BNKESRTAURT     VALRWBDRV       AMXW            AYCWGRORF       SBXLIFWER      
EVKVR           : EIEKSW          XGKLSDHYWWXFU   NKWGQENOCVFMELV BDFRHWDNSNBLU   NKVYXGYIG       MLUXQMG         JTVOG          
GFRVJGN         : RFDPLMOEEUK     XNPBXE          SNIDFXOAYL      SXEOLAJWKJTMKXJ UGPXNRCDGH     
XSKA            : SSDTAQUKFCPYC  
XMODHYJGVRFS    : FDCF            EYQTKDJ        
CFTTYACTVN      : LSRCSGHUKS     
LMAGYDGYPVEYWO  : IJRKNBOECDE     FCPMUBHT        MFFYMJNJX       IXDTRRSYTIJXH  
SGNO            : DPAREJQQCF      GHUTSHFYYJRDJVG RALGRAACDIOAGI  SYKUY           FPPOBQQNSLFDT  
PTXLVYPRWD      : EUCHBLHOMSRR    UKYNKAFAF       UNIFKQBBCFMHC   TREGOIAPJWK    
LSUTT           : KYTDTY          VIXVOIP         GKJFI           BPJRRPCAD       CPUWOVNTLXNHNO 
BTPW            : WWAQQURATE      RVVHQOGDDLG     IYSCOUKDHQBKAAV
QVQYQWMFDE      : ACNSEXATOMDU    UQBMANABQF     
ERADKR          : DVBHCLGSN       SNFQPS         
PLPI            : OANXGRYMBXFBSP  GJVYSKBSD       STYBWNMXDX      RBGBAVE        
KFILB           : QVNWYVGPVNN     USNCMFTTTKRGMO  NJRN            UWTOXBXBYDDN   
KBRGSQWRFFVLJCF : QHJLXTKJD       AEQT            GDRQGDSGUVKNVXH
HPBJG           : CISYIU          VLKYV           WPYFGBVD       
CQXM            : HDKEYGYIUMW     PWYSG           VSEEHADWCFPEFDL LOFGYFR         IXAPTIEQXMPDHSQ
GXYHKBBQVTPNBU  : JFCPAKWUX       MEKUYIXGMVRRV   IKFVAP          LOEYNJL        
MENRPUISHQILH   : AJXAVAKEDPNVDS  VPQWSFMTM       VPMRSQGCFTQQSG  NYXEBNAQW       CYXBLNEJPLMAAI  SGORSAKVAY     
XGQXFAI         : HOFKNC          RIMKACLGCA      WAJVPFAUQ      
BBEUQS          : WBLLI           KVHCFEJ         PHHREANXNDYWYF  RDQBLKV         MLYPIPI         YROEBHRDDQI    
OGKUWD          : EVQTSOBTIKP     NMIJCO          RGOSCKHXQH      YJYEAOVBIMOBXWH
TNEDGOONWMTQKCQ : BIRCLYM         EYQTKDJ         SCFR           
KSVPPPKMESYBP   : WUEAIOWOQ       FKSRXQ         
MKRTN           : MFEBGH          FQBVAMKXIWH     VTDRBMKWSQU     NWWKMFBSUYQYQBJ CHTUFDVPUXUKA  
IDOIRK          : XGVAKFLXUEHYKP  FCJBDYSQKST     VNEIGSLWU       SHEBEJOXYYAVB  
FOPAAKYRB       : GEVRMOEJSNPS    LYYJXUU         WJOND           BTFAUFOAOHRQDF 
CPUWOVNTLXNHNO  : YWBHRWVQTWN     BMNLNSVEXTMPN   UMEEMWLUMO      QIVW            LSUTT          
SFALPBQF        : RXNWDV          HWDPVHLUGYWLFG  YPBCRWK         DEIHYPVPAGCGK  
SHERY           : CVUCUAV         LOFGYFR         EOLYVN          KNAHXP          RMADFAXKC      
IDWFAMEN        : ADLAA           LOLWRY          BMNLNSVEXTMPN   GDJLOC          HDWTDRNDRL     
PNVWEKO         : KQKLPNHS        CSGIQOO        
PRIIUBP         : RIWUYXXM        NPRSTWPCN       MVETHJM         EOLCQYBO        THNFAHDECBTPH  
UWTOXBXBYDDN    : JIPAA           IQRGGFIOTMNF    WYXEYEUJKJI     KPIK            OYEF            KFILB          
TTBJRANDPLU     : DNXDFPHHIOQ     MBABBKJPAEN    
VFEXUTU         : GBOLSTQGKJEFUPH XMPGYXBV        HDWTDRNDRL     
PJPSJSRPYFYSBBC : USIS           
BSBSEVCC        : IPQHBAYX        XICGIVLDQWRRKNR CWRQAKEUOCC     FFFJMHTHPFPK    CTBWC           UNBGEIEOO      
JAYDW           : TVNTUPUGNRKIBFV VUKYMTHS        CVXEGTESLGNCSE  YGIRBPTM        YBYVNIQIURSSY   BIFPQRGLWYO    
UHJNQFIGEPGYTJ  : CLNSL           MHEHTMRUW       QSUIGD          RPQUPVXE        NGEPFRAVEMNRV   OWHKHKSOX       PSLBANVWAHAUGED
PKVQGAOIDSTF    : JFCOWMUV        MUVKEVJFUUQEL  
YDMT            : RIWUYXXM        CHMUPVYGJIOFNV 
VKDD            : PUGLIKGOJL      SDFXLGDLGAKE    WSSDF           PQRSPP          TFMKJJMFYOY    
MHKUIG          : TUJNWEELPGIQF   LRVPP           VDXTXISKCAE    
MXQIOWLGIQYEVT  : ODUWKYRBDTO     HCENL          
BGAPDKVIFI      : LOLWRY          SVNGDA          EFNCBSNEYSIQH   HYKEFACOLWXNVJ  CHTUFDVPUXUKA  
SFBBLN          : VBVPKMPX        BNVOAFYMYFPCV   HYGNKYYSOS     
CYQCKWMBY       : PRGWMGUGVBP     JFEU            QJUHUPXDYBK    
YSWDAXSFKO      : VLEL            DPAREJQQCF      ADLAA           QIUKJRSMBJVFRUY GWNMCWKKVVFOUP 
SWGNEKOPXOUWIY  : VYDR            OMEIQYUNKBKOL   WJOND           KXCHODXIPTLU    XMPGYXBV        GNWOMWCFF      
HNKGGMCEPE      : IJHUVBYYPMKR    YYSYIDRPSIVA    GDJLOC          RUFJUP         
ILQAYJYIWESOTSF : PNXSKB          RJCEDS          IXAPTIEQXMPDHSQ
QNPAVDNCKAGQ    : CBBRNWN         TMYPBVFCBVNS    QBWDCOTCLJUWUMH OYJFMCATE      
KWAVNAX         : WWJGIY          MCVANXCRXIMMA  
AIWEDLAVRROF    : KUWKGIS         GMAAQHNMNQGJBDI NYXEBNAQW      
RDNFIXHOQYCNYAB : QMQL            PKIORMTRSV      RJMIHPE        
ABCIYINMIMG     : GHUTSHFYYJRDJVG WSFJDFDCPNEW    IRQQ            IBBKECWSYVT    
BOKURXC         : JGFFSPSCNKAN    WWQBNJ          CXOBW          
XJROITC         : CSMKEI          JFDAWGA         ILXQGOQRFE      WPYFGBVD        UKKSERC        
VFMW            : MTQOPB          SNIDFXOAYL      MLUGVCVYK      
QHIYVWHIEKLUWHM : EKYDIQNS        NJVRUADUJLNOG   RIWUYXXM        YWJQSWW        
