QGHTBASSGTFJF   : UQMDVHXJUFOAC   XLHYFDF         KHKO           
BXLKI           : DPWOTYO         KCHLLJTUO       XXEHKXBCQ      
QVCM            : APSCPKNNOUGJ    MHREYEVRW       HSBV            EOUBDHOHLEYHWX  RPIAXJBOEXSPH  
EDHJGCDNLWOORJ  : CJTUNN          IQLW            DGLNKTGHCSKVM   DGTBDESX       
NOGSWJT         : WIQIPEXGWTJAHX  LOYT            WPDWDNFB        SASHXGMSJJEDRIA RNLEIXRKEWC     HJVTUVNPMKM     WSQEVESGUOL    
TCMMBQYBWFI     : LKQJMHIFIOGEQK  VNCLXSQPL       WIQIPEXGWTJAHX  GQEBVXNXGXVRXB  IMGLUQJGG      
LNMYYLPNDYKSQTN : UBWI            VPJWJDFUMLB     YFPUMGWK       
DHVAKKML        : EUTQ            JMSFPDAFYWGO    HFMU           
OMYTW           : EYETJXXTHCKR    WCCTI           IAJDXKWCMOTOCTC BDDRJHGEOBVOMV  HDPKAWXXK      
HKUJMIYANBNGRHT : HVJSOVHQFLBDIV  VUHNIYHONORVH   FNYDBOV        
KCDKOQ          : KPAQJRPKORIUXU  JPSVJJE         UFJISFNESLCKEA  JCNP           
ATQOSKNDTY      : FFKGMGV         OHNDU          
DLIFNV          : OKREIHCOHWDXM   CIBJC           UBTQJRUNURNIVI  EKPPAHBWQNUCQ   GCYOAGELCGCS   
BCAKWHVBKIP     : EGDSUEAPFUMRF   CVQYQTLCMCS     SULQSV          DEYEBFM        
KRXBISNVWIUYN   : HWVIMEWEJTIGK  
ISWGBAJ         : CVVINJIQF       YLAUTEAPYQRGMOX EIAFWFKBUOR     DXCOI           WOSJFFSBEBEJRR  UBXBTEYR        JNMORCIMOXY    
LIIJLVT         : WOSJFFSBEBEJRR  MAYFDJIQDO     
BFUYGDSUYRDWQ   : TJHC            LHOFC           MMKXVMGWCHKHW   VIHASCEWKM      HTRTELV        
HBMGINH         : YHHJMFC         HKDTTRXBQQ      TQYYMU         
RUCCENAXQCF     : POIPWJGSY       DOEWBCADJKADQ   CVQYQTLCMCS     CQSVHTWLATLRV   VICYVMNHDYS    
BMOVHP          : POXWMBKXEFX     HXTRQDJCJ       YEXFDUK        
MOHDWIRFSGMMA   : IHHKRCEK       
OCPEDQUFVIII    : CCDFVTSPIDIMCM  VOFDFDRTDCARB   UQPJNJ          SEYLTEOATR      HTRTELV        
FPPUE           : FYQGFGORL       PMHTOMDAPIQOL   FAJY            YLAUTEAPYQRGMOX ETVGKR          ONHCOMXWHPJUGP  SWRGWBRACJ     
EIFNCLIIAVIKKN  : IVDYOHAXMXU     DKQB            HKVDG           NVSLHVQSFRG     JJVANTTXEXAHA   PTVAGFFXNQKHPYS IWKGTGMDXDI    
RQQMXPXGXULQ    : NJHCYND         LEWCOPHO        RDDISFWMH       JGCYT          
JUTNFYDIK       : HFJGC           WJQXXBB         BYXSSTSW        OEQPCFYK       
SLICXUR         : SODWHKPNLQGUDG  EJSAW          
OKREIHCOHWDXM   : DLIFNV          UTSCGODR        PGHMVX          FYDWHMSJ        MAYFDJIQDO      DTEHBXFTIOMU   
TGEBHK          : FRRTWYSCBIQQB   IOJQVHHMYK      CKJQTEYEUYNE    MNYMLPT         HCNDCX         
SWDGHH          : UGVYG           FPBF           
EYETJXXTHCKR    : OMYTW           OSNF            CNXQSKRLP       YXMFFKQHJ      
PPNELVLNE       : MWIBDRWWHJBQ    FFMBLSMD        IIUIHCO        
YYSCFCJLIKR     : NLDEAGF         HBUWSTXYO       EKRGGPRVXOJG    GAKOIQ         
VSCPCEBT        : KBMAA           OBBAGIHKSG      GMHPNBMUUV      QSDLSTCXYTALVL 
SMVXASLPWH      : FWNAMMXKKFE     SVBFBUP         YJOY           
XCRFEESOOKTLFVB : BKYLVEQQAS      VQBXSJLWRC     
DEGLXUHXVCJ     : TUHPEE          JCNFGLMRT       YPCMSVLVHVOTM   URVB           
BQBYU           : DOYOMAHQRR      JNYLCQEAGSUQ   
EYAWNOK         : PQLL            UFJISFNESLCKEA  OBLESQAFDTKLX   NVPIQGOVM      
ARGEC           : HWOBANHKSVR     OBONVWLHABJ     CBEJDALJGNCT   
IJYIEGICLTO     : ICHFI           KHKO            LGOV           
KRMHNQGNQWFBGFS : HVJSOVHQFLBDIV  WVGCEQSFAGRSE   XEDMCTTBMFGD    HCGUYGFW        OVNYS           XTKXD           OJIWNMDWCH     
LVCWHBHNKQQV    : EMFRIEAPFAH     IQLW            QXFVWTHNFYJB    SWNBQWVGAB      XTKXD           JBGIABQDREB    
HIXYWFPQOFHNKI  : VXSXONAGXNVP    QJMOGK          FSXUYPFV       
SDLEBNBKPJYCC   : VXSXONAGXNVP    WQBPHK          BIRBAUGBKVQQ   
XMYIKXGSPWHV    : MEIIGIM         DLIRKPWVXYBA    DSNRAPGOP       RCMJWHMBKU      MVKUP           VUFCJSIE       
UGOQYTE         : JKMSSMFWKHMY    RKHAIAO         OBLESQAFDTKLX   VEOAHXGNRHQV    UENCVUMDQWTKXNW
VUHIMSHOW       : SHJT            UUWRTFWP        BCKGYAR        
MKXUWYDPOAYK    : ARMOWFFJHYFAFX  SYWTTNEVMTVWML 
TTWNSTRYRM      : REFSFJJI        DBMLKKOMSTIGXX 
AYEIPCJCOK      : HWQDGHIFSL      MUMNMPQTUDW     DNIPJRB         UQPJNJ          HWWKWQGROAQHB   BNKKREHA        MBQHVVUSLEGEGNI
NLDEAGF         : YYSCFCJLIKR     XXEHKXBCQ      
MAHMPCGJE       : VKXPOC          DLCNRJLFHYRPXKS YAUESQJPK      
WNXXTIOXSSMFUD  : HWCSIFGPUB     
YJQFOGTQPGGUMQ  : QQJD            SWBTEC          AYVQWAM         HJSJPFQWRDU     RGRV            LIASQC          FORU            XMRDRSCAUDYKS  
MPOLPITGHOC     : MFYMMAWFLPQV    KGWFNOVD       
TWBKV           : WBQM            VACSPJOFHEJ    
EDAMXQFEAAT     : CJTUNN          PFBXOLJNRQWU    GIQILTELSPUFS   TAKUTK          YSEMH          
YGINTAXQ        : MMKDB           KLGKYXWHLIEMSD  GRIXF           PBVOAVUL       
HFJGC           : JUTNFYDIK       MRQGARTUJKRUQH  BYXSSTSW        KATW            UQCTO           RDGSSKEIAYSFIB  LGOCFAGTUAJEFSU ITDUAXGCCCKM   
HOFSUIUI        : CJTUNN          PMFNJUYHYJGLLVL KNOOFVM         AITFUFLPRNLGNS 
LNNNPJGOPQ      : QXRGMFMEWKA     FFXPEO          VROPJ           WJBHFGHWMRRNDYS PVOXBWQQQTSA   
KRCBYKIKQM      : YQJWDY          HKKEPNWK        TSWXF          
ACXSWJNHPCWFP   : LOYBOPXGFNFXIN  FYDWHMSJ        PTVAGFFXNQKHPYS
OYDHPHTH        : GCEEMV          RJSFBMXQKGFO    HFHDXVNG       
WIYFSRSMRWMLVV  : WPRJUIQY        SFWROVOGL       DHYQI          
GODFTVULUXSKIMS : VAOEPUEOTOI     RANE            RJFIGWD         EFGHLFLNMAS     EGERLE          LIMHBI         
JDVQWNL         : PYDEBMK         JABCLPNCNULA    DMQRBNHFPMG     KNGDM           GRFASCMSPHKWA  
FIASFW          : KRHVWJ          HUSMFN          YYNHRNFM        VCKGKCSWPQF     RFIQRJWPV      
NLASHVNU        : BEIQJYLLCS      XXSBCUUHL       TJUC           
MNEWCYTLCPFBDQ  : KHMCSETDUNLSL   IQHT            UIGMX           NXTERPMIBAG     YELFTDPNYCL     NWOID          
ICPCJOYWAYP     : IVLKLTYKU       UPKVKTC         UJXEKXECQPWD   
XEFQSUW         : FFUOBMKFVKLAB   IYQUOLMBCP      AJMO            TSLBBBHRFDUBIU  CQCDAIGAPA     
XXJLDBSEEKVMMLQ : BPRBRHWUXJGKHK  WDBPUAGHQWXHKPH JFRSKDAXPI      EEOXFWFWECE    
APSCPKNNOUGJ    : QVCM            FYDWHMSJ        RFIQRJWPV      
EYQEKCHLVMRIIF  : KOPTTUPXKTJM    LVNOYVGNQMUEXC  HSPRAAHTEDPSFFI BVWXCQDJK       DTSTQ          
VXSXONAGXNVP    : HIXYWFPQOFHNKI  SDLEBNBKPJYCC   XKGVWMXDYNFOBA  ABLNXFTIG      
CYCIYSNLWUAUJR  : NFXCKQQYBVB     XQAJBUUCIV     
TYARX           : RKHAIAO         VUHNIYHONORVH  
POIPWJGSY       : RUCCENAXQCF     WVIJPJP         HYCY            CPNDQH          KKOCVWP        
WXTIYOVNLSNH    : UDOKR           RQQQWQWWE       XPEOM          
FMBF            : QXFVWTHNFYJB    WMLFXPEOQ       HWPEYSHO       
TFKJTVCQFILE    : CXMAPDR         ESMVAOQFBJULVSN
IEVQGKOTXKHFP   : VNCLXSQPL       GQWVTTNHNYAYWLM DASVLCKFWED    
SQTIMBUWWQB     : DOEWBCADJKADQ   MVLJM           EPLC           
VJBCNKJL        : FLIPMCN         DWPYOQVGNMRJLQI BYXSSTSW        UUWRTFWP       
PXUJVFS         : UYJRLKHVSEW     ARMOWFFJHYFAFX  VPOYU           RACFDKLG        RNLEIXRKEWC     MORHEUF        
WHYP            : UVDMUYHQQTCHB   QVUPBT         
HDFCCDV         : OBMKVRN         GSRGYU          MSQO           
SROUWCHGNMV     : APKQTBKCICBPJXI TIOUJLNJFYDY    PVOXBWQQQTSA    BHBUP          
HHJO            : XKFXUI          UJLDROD         PJCUAEVPFRIBP   IFGRMMP         XXSBCUUHL       RQDUJ          
NNJMEN          : HDRMAU          GDKAJ           CVOLABYT       
JVBL            : LWHE            UAOQTORTI       IPMJ           
WQVQ            : MIIVUHGYPFLVS   MUEURAJXN       TGGMMDUGLNI     QEXYSQJBTEARN  
SNJA            : RRBGAPRLTVMXL  
YNRMWYVMBMALBGB : BKYLVEQQAS      EFYSYRQCCS     
PWBDAA          : IXXBCH          IQLQJHXR        HJBI            BRPLVUETVCVSCMM PUTP            KJRNLG         
WQBPHK          : SDLEBNBKPJYCC   BIMP            UJBI            HQVHCFMDBKEFBH  LWWVLIRV        SDGNVJXBISKVPO 
BJITXFUUTW      : JTJODHMQOOLQE   EEFNNA          YQJWDY          UWYALAJHVO      VICYVMNHDYS    
WIKFJ           : RTXTE           EGYU            YVYEJNLIQBICN   VKODGXENLYVFY  
VJNB            : NRAQBYHGTKQI    FXBLLGI         EXHPKYKBGVRWGE  QUCTQBXEYXMQ    GTTKUO          HYTVL           WDLDK          
NVIHYBOKTRVCN   : PAMTGWSKRW      GDKAJ           WKFIIW         
JJREGB          : SDWFOWFUF       GUJUXMWF        IRITHSP         EFGHLFLNMAS    
QNICYGLOKX      : HTGHJPIUPGPEG   SHIDYKC         NSKMEYSKAXN     RBAUPPG        
IIMHJDTDUQ      : UBFXMR          DLCNRJLFHYRPXKS JCHM            IRITHSP         BCKGYAR         LXBIWHCO       
LNRWFXFI        : COGNPAXAMF      XAEUMJGT        WKFIIW         
VVNAWUO         : OBBAGIHKSG      RDSCPNSSCJKNMQC JNMORCIMOXY     FYDOWLKLAYXJW   GETODAL        
HMRPWEW         : SNDTE           VEHAVDTTVQH     GXIIKTS         GAGMMQV        
HTKEKURXMOFKTN  : KLGKYXWHLIEMSD  QSAQSCIYWHH    
RJBSHXHVHVNWSTW : FJPCIY          SVTTT           AIYCOXOJVTVSSFK HJWMUBD         CETVCWYXBTMB    XJDX           
DQNJD           : DOYOMAHQRR      AHDWCJXVYEJ     BMLHQ           JKUPYLISNG     
CBWQIJNVWFH     : PBVRUOLV        PGJVAOKDFKV     RSKYDJVUJ       FADPWKGKH      
AQBHMIDAIWT     : MKMOPA          EQKSEXVMFTWUMB  STIFWSOCEBW     NKVUHBYYHEAAFT  RHVJSRQHO       ESMVAOQFBJULVSN
YWXO            : AOPIIGLHQ       KXNSVHQXGKPPNY  TSJSXLWUTEI     BJRANALV       
BWLE            : PFPQLFNHINFAX   HCBKA           OTRNYMDQGDXEQKH
EMFRIEAPFAH     : LVCWHBHNKQQV    QYFBVKUVJNINK   JUIJUYPRBE      HSPRAAHTEDPSFFI MHABEMBHWTRS   
IVSNWDMSIO      : CWMOTFQFUCQO    YQYNEXDNQWVP    NSKMEYSKAXN     ETVWHYXIGRNLM   KKCQI          
IDCJDNNYRCF     : PLUIPXWMLTAJHG  CTVPFQVGDPKRR   IQRWPWYLE      
KJMDQMMBWIUNHXC : FWERJOEOHT      EMGATFLQMATO    CTJFTDPVIHTDWJS FOXKCSDWLQGEU   JVLYMSOPOWP    
JQVTUXEXNT      : UBFXMR          MHTXCCR         OVHBJSII       
FWERJOEOHT      : KJMDQMMBWIUNHXC UTSCGODR        FTNARFBWACN     ADNIXUWDHX     
JSMGGTGJWRC     : QFAFILIAMAJW    ANMLJGDQUXNFFSE
MWSQWGMYOLDIV   : MPOETDVCYEWFUJ  ACWWMGFNOCE     SJEGNJBWIBJMOAR PBYTBXND       
NKCJONCBTLUAWU  : HRUX            HLLQWLEQAULXAA  TRVXAOGWYM      WAXWM           OPVGM          
YPHYLAX         : TRVXAOGWYM      RBYUMOSLABIX   
MWIBDRWWHJBQ    : PPNELVLNE       GPUVX           FYQGFGORL       RPJOPQW         TVTAR           YYOB            CJGCLHMBQB      CRORGSWIIQEK   
OUBKIY          : VMLYBOVBJQBVNXQ XFJCYDDO        LTEVDICBX       WISASVDQLMMR   
HTGHJPIUPGPEG   : QNICYGLOKX      CKDC            HCLYCYSIMJ     
FJPCIY          : RJBSHXHVHVNWSTW TPBWBQRYAPQBC   JRCHXBNWFRD     WSCI            RFIQRJWPV      
KPMYNQMXPXG     : JERFYR          BLSKIOE        
GPUVX           : MWIBDRWWHJBQ    MRDGPJGXGEFSKL  CUQCVFRVOAMV    UENCVUMDQWTKXNW
NGIR            : NRAQBYHGTKQI    UTWG            BPCJPIVJUH     
IXXBCH          : PWBDAA          NIADJFWGV       HLLQWLEQAULXAA  BEXAGQJDTJM     OWREOOISISGOJ   FIET            ODBPOCWNK       GVKG           
QTSGSIWHGMFMVN  : CPFXCWJRFBENU   KXNSVHQXGKPPNY  KMYQCIUTLGLTCWQ OEQPCFYK        OXDHFPBFPT     
SLCLYJVRXHRY    : NVYHPRMATX      FSXUYPFV        BSMXFUDSXDL    
TGKLAF          : VPHSNY          MTRYMIJJIEVDUF  UMYXFK          VMILPSCGMTTNJ  
UNODWDKJ        : BEXAGQJDTJM     AHDWCJXVYEJ     CHIDBOCDNIIBKR  LYOHCHH        
BOTOQGQ         : PNOJVEKUWWUTA   CRVSA           XERWMVXYEPOIVHJ ORCJXOHYQSPM    MHABEMBHWTRS   
CIBJC           : DLIFNV          UQPKOHY         NRMLCMN         GRFASCMSPHKWA  
TVIHHKM         : UHYQKSL         KCHLLJTUO      
HDRMAU          : NNJMEN          UUCSQIGUCNXO    YFBCVNFCRSTW    UQMLGWEVYK      HMXFJFF        
LVDAQRRWITBS    : PQLL            OEMANBXYYWTSN   VPJWJDFUMLB     DYHEHCL         OCLCI           OYOFQBUXBXXUUTE
NWYHTJQDV       : NFXCKQQYBVB     PPIPBOYIUGGJRV  PPVRB           GULINFLRMJWHHLD QURLPTB         CMMYRDCUYWQ    
FGJWULS         : FUQBIXU         HJSJPFQWRDU    
WOAXHURE        : PVCU            TYOUC           DLIRKPWVXYBA    OOMHUVHYLU     
NIYLVVMFRWWVUDB : ARFBNAKVBNI     LJANXJABA       CXUUPMXVUT      UNBVRVAMYKAEX  
OAWAUTW         : WVIJPJP         LJWCUS          URVB            LUWHFBLO       
UUTPOYUDH       : RVCHAEEOOEAEGJ  QQJD            GVXRHOOCMYYLJF  CALGQGPIHC      KKDOAHPYUMYQB   WYSTPPODCF     
OFUBKMAH        : KYPGHCGKEEJKXHY YXLADJH         TSLBBBHRFDUBIU  IRPWQRTVFBU     JXPUKYTBM       FMTBHBJSSB      SDGNVJXBISKVPO 
VMLYBOVBJQBVNXQ : OUBKIY          VRQJJPJFIPUFQ   FUQBIXU         UMYXFK          ORIPVJITVDGQUSU
NRAQBYHGTKQI    : VJNB            NGIR            JGCYT           PUTP           
BTJNFKRT        : QIARXFCNSU      WXKJNDF         EIAFWFKBUOR     EGERLE         
UGAVCPUSUKKUBNT : IUOGQPA         PPIPBOYIUGGJRV  ICXEOCMOE       YXMFFKQHJ       PUTP           
TNUNWIO         : QSWCRSGT        IVJNACTHUVLUBRR
TEXFVUOTBQP     : SSQCU          
GMYBYLXACSMVII  : OOIMUKQNFYNL    EQKSEXVMFTWUMB  BTBKFDLIH       SFNBO           FTVJF           ICSQRPDBCR      GREQSYO        
HSAAPFBWDX      : EKFYYWOOLJMEIJE XBMPDMF         GENAHGSGE       WKFIIW         
WBEPGMEHPEVNG   : GPLRWATQGPVBDI 
GTVREGBWGEONFL  : QYFBVKUVJNINK   YAEK            WNCIHENBVWMLDGC SASHXGMSJJEDRIA NNBD            YLLBGOIUY      
FYQGFGORL       : FPPUE           MWIBDRWWHJBQ    BXMYUXOTHUTEDS  YXMFFKQHJ      
HRUX            : NKCJONCBTLUAWU  XAMSI           YUFFDKS         XCAIPPMQGTGCG  
SGROXXWAXGEM    : APKQTBKCICBPJXI SDWFOWFUF       UWBBMSJGWBY    
LBLQAFYILNCYKMQ : LTCXBYSIGCMVL   VVXHVJOUOU      BKYLVEQQAS      XJDX           
KPAQJRPKORIUXU  : KCDKOQ          IEGUWBOGPCYTIE  FNNOSUCBLOF     UGRBMGMXA       KBMAA          
LVFCYKBJWQLXCXP : TWNLOMVFXMMVUJ  MONPDODMW       IEWC            PLOYXSSOCJHQYWQ LAESIIP         QXILFSTUMS     
KHMCSETDUNLSL   : MNEWCYTLCPFBDQ  PSUMYOBEMI      WMHCJSQPLPKVMWK
KWHPBIBERAUGX   : FUPXSQFTLV      AKDWVM          HASJ            VRKBTGMO        CFLLUPLW       
GPLRWATQGPVBDI  : WBEPGMEHPEVNG   VVXHVJOUOU      ULJRXU          HQPA           
OTGNBYQK        : IQUFO           NIADJFWGV       BIFW            YSMJXYH         TSWXF          
WCCTI           : OMYTW           PMHANPGXFRRX    UTWG            RBWDAKXDPMPEJM  LDNY           
VRQJJPJFIPUFQ   : VMLYBOVBJQBVNXQ IUXJDHFKNTPEYBJ
PNOJVEKUWWUTA   : BOTOQGQ         YAUESQJPK       XAOKLRUFTU      TQYYMU         
NKCLE           : QYFBVKUVJNINK   KATW            EJSAW          
UNKESVT         : IALAQLYSPYMG    ONQGEOWD        WSCI           
DNNSDCE         : RGKOVG          HKYK            FLQM            TNBKODMWOSTOXY  OPRMCDYVELSR    AVJNVKRDKYRX    UQMLGWEVYK      ASBEEA         
IQUFO           : OTGNBYQK        LJWCUS          DHYQI           GHUT            EVDAQAVESJQFYGV RVSKHPJBVM     
YQTPDVBIQ       : JUXPOTGYPQS     RQRPH           RKHAIAO         XPEOM           FLJNYWNV       
VBDRWAHCP       : EDFOHPXT        BDLSINKSUBDCE   AXAOVCJC       
UUABTLSQQ       : XNKKXJASHKKH    ACWWMGFNOCE     UJXEKXECQPWD   
LSAFIDBLNRKMUQ  : YNWJAHT         GXIIKTS         EVDAQAVESJQFYGV
UQNWIJSDMVY     : PDYBSIKXRBHXTRN QONMRHAESREBDI  EEMXH           AOWRPBN        
OQOXEJAJRGKGT   : CALGQGPIHC      PHXGUPUJAQQGHM  CLAAQQCVXHXNF   WSCI            SIKFPHGEJRHFY  
QGYJMTCBRK      : UQGUREITO       CCFME           DRMRFOFSMLY     VRKBTGMO       
MNYIPYAGQAKA    : IQRWPWYLE       BMYTOMIRI      
VUHGBDMTKL      : TUNDFJIFJII     UKXBLDNUCRQER   EWRKRQSTSNWR    VCKGKCSWPQF    
WGGAARNMHMWWOWF : OEHXNNNOJ       JEJKIQOULHRCAPU UDUNYJWHHUN     JMOHHMILWFIB   
ARFBNAKVBNI     : NIYLVVMFRWWVUDB WOWENKGAYE      QWEECNBC        NRICWIGGXYQUW   RYOXVTPOK      
AWCADKAFCPRMD   : IQRWPWYLE       KRQGIMVLBOXLANR EBLKS          
LTORYQ          : WSUHTWIEJKAXE   UDVLWNHFYULM    QLGOCLNMHD      CMGDPDNCW       BWRCUVRXF       GVKG           
ERAHE           : UDOKR           IOJQVHHMYK      KBVBQMDECNRFWYO FRBCYACDRJAOW   QKJPAF         
KTJIWGMWLXYQC   : TYHXRXCSLJIWWQ  YSFRIKTH       
KQUBDORWPIIVCK  : FLREAMWNULUNEP  XAUXOTAGKTT     EFYSYRQCCS      CVOLABYT       
ILQDUY          : NBFM            LDNY            MPWRIPVMNFAXHP  RFQOUOCAOYYJUO  SEUVLQQB       
DOYOMAHQRR      : BQBYU           DQNJD           JRTMC           PRXDAYKERQHTPS  JUXPOTGYPQS     XKGVWMXDYNFOBA  OPMCRWCIHG      KHKO           
OSNF            : EYETJXXTHCKR    UEXIK           ENWHFEEGQWSBG   MLCDUIXWMCNN    KDIEPRYNQGKQ   
KUVURBIWJVNOQNQ : BLSPQTKENNX     HBUWSTXYO       PCOU            FBEBSTRVBXFDP   IPPPSCGABQSNNV  RJNQ           
CRMQU           : KRVBCPYRKQISMQ  HJVTUVNPMKM    
HMLREGF         : MFEMJNPJGHTD    PASURTTLU      
VPHSNY          : TGKLAF          WCUEYBHB        KSAIMOVBT       BEIQJYLLCS      ATFJEDVJJFX     SWRGWBRACJ     
XVFTKWKA        : KWGYABDTSPP     NTOPBR          GRRQSXWTEJPQFPM IRPWQRTVFBU    
IEGUWBOGPCYTIE  : KPAQJRPKORIUXU  QURLPTB         XIEYM           UWBBMSJGWBY    
FWNAMMXKKFE     : SMVXASLPWH      FYDWHMSJ        JNMORCIMOXY     QULIJVMX       
CQYQYDYTC       : HIWNOPNBD       BKAAAPGUWIGEBR  KVXJE          
KJTMI           : PREC            BPAGAUIBGQBO    UENCVUMDQWTKXNW ITDUAXGCCCKM   
WOWENKGAYE      : ARFBNAKVBNI     HSBV            NHSDRDMUPKVYUH 
LKQJMHIFIOGEQK  : TCMMBQYBWFI     NYDYJX          NQWNSYEAGAL     YOBVJLK        
CFBM            : QWEECNBC        FRBCYACDRJAOW   QRDEXTGFU       JSHYFFRFHJKJF  
BCSFRFMUES      : BIMP            ABXSVMSLRQMEIR  QOGXNNLEMOLUGAH UHMBJOXQII      DMQRBNHFPMG     GJYSQTOLG      
PDYBSIKXRBHXTRN : UQNWIJSDMVY     WIKLTLMVHVHWAI 
WQJSRNNA        : FCDNO           UYND            HLODMJJYS      
SODWHKPNLQGUDG  : SLICXUR         DDGDBPRLMVIX    WCKAG           JCNP            EEBMCY         
GNOBGCAFVJB     : UFHCCPX         BTRHJJEGTXIDBF  WOGHAWDG        EJSAW          
AOPIIGLHQ       : YWXO            USPCLYUN        SIWVL           JFOPYHBIR      
WEKQKHTQXDHMEPR : XNMKGUIHEXMJWYW XKPU            HIPRIDWWA       PIMBNYIESX     
UNPVFRLXAV      : FWNQOSXDLPRW    DWPYOQVGNMRJLQI
NDUMDY          : DJEOK           OGSNYYMJGRBBVOB
TLIPFGSMUYCMD   : CGQUT           JRCHXBNWFRD    
CVVINJIQF       : ISWGBAJ         WVGCEQSFAGRSE   CJWLAOX         JSAYEKDOEMSDDR  QOCVASEKIVV     DFYRM           PQEHJKE         ETCVKJDTTJO    
EKKSN           : BMDSBTJRQVFWY   VEOAHXGNRHQV    ITLSMDLGNQKY   
RJXACFIWTGWXS   : KLVYPINTPJK     WXDBNSNWBJGX    CQNB            DTSTQ           PUTP           
WXXUIOGQFLFJY   : HCPWXQUQFB      HQPA            WFWAENYNFTIETBG
DOEWBCADJKADQ   : RUCCENAXQCF     SQTIMBUWWQB     EGDSUEAPFUMRF   TDSFMJ          CETVCWYXBTMB    UQGUREITO      
BMCAMCVU        : JSTKGVB         BKYLVEQQAS     
CNXQSKRLP       : EYETJXXTHCKR    HOARETGGLLEN    JTIFMWJAMRPL    HKDTTRXBQQ     
PMHTOMDAPIQOL   : FPPUE           WWPF            NULNEFJL        MQMRVOSHFRMBCTR
SLRXJMQ         : EWEDCJ          EODSGSWMR       FBFAELADJLUJV  
CPFXCWJRFBENU   : QTSGSIWHGMFMVN  EEFNNA          GBBNML          NQEBXUSBWBEVUAX
AAVRIOHTU       : ALLBUWHKVQ      KLVYPINTPJK     PASURTTLU      
HOARETGGLLEN    : CNXQSKRLP       TPBWBQRYAPQBC   VKMNDWQKQJSLXKL
PFPQLFNHINFAX   : BWLE            XSSKSQCKJCCY   
JRTMC           : DOYOMAHQRR      KARCH           PUDKHYKK       
OTMKA           : EDFOHPXT        RQPGJMPH        QPTTCCDI        SUXPDCYVMJIQM  
VNCLXSQPL       : TCMMBQYBWFI     IEVQGKOTXKHFP  
VAOEPUEOTOI     : GODFTVULUXSKIMS LOVGJXSGPHPDJQT NHSDRDMUPKVYUH 
DKXTENFGJBTNPTI : UPLGQPIOHYFNN   RBWDAKXDPMPEJM 
MUNIW           : LXMNUECUHDGHR   WNCIHENBVWMLDGC JNUUPS         
OMAUDTLMJOWHL   : XUKTOJGHPBM     DOFFW           XLHYFDF        
UQKGT           : GVXRHOOCMYYLJF  MIIVUHGYPFLVS   PLOYXSSOCJHQYWQ NRKLMNJUUH     
UJDFSRCIAY      : KGYMQFDJKBJFHK  JEFWTFAJEC      VHYMPASDNPHP    CIVMHDPCMMYAVDM
QONMRHAESREBDI  : UQNWIJSDMVY     EHKNTTWMQ       BPQBJSSWNWUNKOT
TUHPEE          : DEGLXUHXVCJ     YDXFQPDWBCPKTYA OMAYTEHVF       HAALFMJY       
KJUCMDF         : UJNFRWSKWMLE    VXJBG           TGQQYGENNDIO    ENHM           
PVCFKUNLBI      : JVCSNEANFNKMIO  VAVAJV          VFFWBBQBHAVDFN  FDYRWDOCFHDCNVN
FLIPMCN         : VJBCNKJL        UFFHBNJOQCCRUU  LXCKXNQ         XDKJQCHFMOLLDI 
RTXTE           : WIKFJ           PMHANPGXFRRX    GMTFH           FKFQR          
OJXS            : QSKXIOXSQF      NOKWNRTXBXLHCK  FLREAMWNULUNEP  TWPDTCY        
MKMOPA          : AQBHMIDAIWT     SLKWXBTMUDBLKCN AYVQWAM         WVLK            UHMW           
FNNOSUCBLOF     : KPAQJRPKORIUXU  AVCMSDYSLNFBK   KYPGHCGKEEJKXHY
IYUITCUK        : VHXVA           FVIUBJPIXPY    
SFCFR           : PRXDAYKERQHTPS  EIOBY           USPCLYUN        SQQBMKP         DEYEBFM        
WIQIPEXGWTJAHX  : NOGSWJT         TCMMBQYBWFI     WBAGPY         
KJFFRBJMNU      : NOKWNRTXBXLHCK  RIDG           
TWNLOMVFXMMVUJ  : LVFCYKBJWQLXCXP ITSHAIQBVGVKR   XFJCYDDO        EAKJJVDNKGHJXO  GFCQYAVXSNJTWDL
EKBF            : SVPOONRIWUBWJAP MWDJOJEKJMS     NHSDRDMUPKVYUH  MYFCUETREIL    
LOYT            : NOGSWJT         IGIFMC          DDGDBPRLMVIX    LCBOPJAGMEPPWUK NVSLHVQSFRG     EOUNL           VICYVMNHDYS     UHDJOJUACB     
CDVQYGMX        : JFEVEPCJCVN     SAMQ            JXPUKYTBM       OMLOMGOAYWCXL  
AOJWWHLJFGUX    : FALBJL          HIHSGNSOF       BNFGXVFGXOE    
HYSANHBHPEKNU   : UIVORQHQVEPJUP  OICYWF          ADNIXUWDHX      RRUUNVNE       
THMQHBAG        : VITVGEQKKIFG    QEXYSQJBTEARN  
JTJODHMQOOLQE   : BJITXFUUTW      QQVP            VRIYWMHNVWLPL   YYHJIFKXRMTOOA  WFSSJLPAR       NNNPPNLTVJGYY  
SLKWXBTMUDBLKCN : MKMOPA          GGRIYHGRTNP     SNQGSXK         YOAAXNJBVB      ABLNXFTIG      
FWNQOSXDLPRW    : UNPVFRLXAV      REFSFJJI        WBAGPY         
XRBLDAMETYBWAP  : BIBBHDGIF       WVHASVEXG       VJLJL           AHQVQUPBIX      MODBDMXD        BQLGNNFEBYC    
EFEJFT          : STOQTWMESD      YEDFHNSK        LXCKXNQ         GPBBS          
TPBWBQRYAPQBC   : FJPCIY          HOARETGGLLEN    IGIFMC          QXKLWJHSW       LTEVDICBX      
EOCXPGXRVIX     : HQPA            DBMLKKOMSTIGXX 
OIIKLCAOAC      : KIISFWGNWSGHY  
RDIJVLNUPEYO    : QRHBFT          AULDA           NBTJCDVP       
FMLDWKHLUPV     : YDXFQPDWBCPKTYA FLQM            MBUVKCSRMV      EHAVXRKHT       SVSCXGHUEUOOH   MHABEMBHWTRS   
SYYUDHOGP       : CNTVYUCQAUMBEVD DPTVGYSHF       ASBEEA          MORHEUF        
CCOYRSYINEUB    : BOTCPILWAMA     RJSFBMXQKGFO    ULRFYQXWW       IGNTXQMBKCN    
RNRFKHC         : IMTLGLNMQDVGUVG UPIGGIEYQYQ     LGDRKQHPBVI     KHKO            VCKGKCSWPQF    
CBUYECNMUOQW    : KRQGIMVLBOXLANR GREQSYO         DCQGGKLSRRJHSG  NWJADGKL       
QQVP            : JTJODHMQOOLQE   MHTXCCR         NUFALRDKBDJPB   UHDJOJUACB     
LVUNGPDAUOKYJM  : PJCUAEVPFRIBP   BLHOSBEAO      
GOIJ            : EGDSUEAPFUMRF   BXMYUXOTHUTEDS  SGOUYQNNTCVWCK  VTIPSGXYG       PQEHJKE        
UEQODVFTSWTG    : PRINLH          PGTXQEHXDP      YCAMWUOXBFNYDF  OYOFQBUXBXXUUTE
RVCHAEEOOEAEGJ  : UUTPOYUDH       BRGAWRQJXB      EMBEA           RBSBTPJYDLQHVFU MYXUH          
PSUMYOBEMI      : KHMCSETDUNLSL   EWEDCJ          IAJDXKWCMOTOCTC LXCKXNQ         WIKLTLMVHVHWAI 
FFUOBMKFVKLAB   : XEFQSUW         PMHANPGXFRRX    XDIAUGHBVVOF   
EEFNNA          : BJITXFUUTW      CPFXCWJRFBENU   OTIJPVJ         GCNQX           DTSTQ           SSKKTOGJPEXA   
IURHLVLYELGKGUN : FUMMAGYGKBBDD   COLKTABBTYWKJK 
GUOSGRUJVYOLO   : UKXBLDNUCRQER   AAVRKAL         IVFNMWLCA      
QWMLEAHR        : SGOEGNSJWUJ     SWKQCUQMGCBDX  
LFIXMFLHNIWHRQ  : XMIHHXATHE      SFMPFDED        LGDRKQHPBVI    
BMDSBTJRQVFWY   : EKKSN           LCBOPJAGMEPPWUK CGFUJKHYQMIQ   
OAYTIWIQLQ      : RJVYCIKQBGL     RQQQWQWWE       KLPSGTWEP       KADFBGKTKUXTTPN
VPLNGPP         : FCKP            LPEAFY         
UIVORQHQVEPJUP  : HYSANHBHPEKNU   YMMPSARNQFFVQ   WMLFXPEOQ       OAYIKFGNFQCVBV  NVPIQGOVM       XAWWNFWOQGDI   
RBJAT           : BLSPQTKENNX     TWPDTCY        
QXRGMFMEWKA     : LNNNPJGOPQ      QFAFILIAMAJW    VRKBTGMO       
GQAWYSVD        : EDFOHPXT        MYVVOKXQISMSOYG LAOMENNIS       SDGNVJXBISKVPO 
HYARSDBSWYK     : DGJRNAXCQGI     SEIRTWBNATVBSP  USDQTTYJP       DYVENBDISKT     OBONVWLHABJ     WFSSJLPAR      
QSKXIOXSQF      : OJXS            KXXYAKX         RJUXWIJNDBKC    YMAKA          
KFBLAWOKEPNV    : OEHXNNNOJ      
QYEQX           : WBQM            UXXHCDK         AFAHOKTBF       OSPSUXJ        
QQJD            : YJQFOGTQPGGUMQ  UUTPOYUDH       SHIDYKC         UDVLWNHFYULM    EXHPKYKBGVRWGE  LQTPLVHAO       QKBUUWG         UIFFY          
TTNOLSSXB       : WXXMSKSGX       RQDUJ           SEUVLQQB       
JBSAOWQCU       : THQBBIXIL       LJWCUS          FLSKJKVE        QQLAK          
UVFNUVELIHDE    : TMMMFUTO        KNGPTHGAGTO     NNMVPY         
SVPOONRIWUBWJAP : EKBF            EAQRFRAGLCB    
WTHSYUNXACIJ    : MPMC            TJFFF           YVYEJNLIQBICN  
OLBKDPYQHJPCMNO : EWEDCJ          LLVYJ           JERFYR          GMTFH           GSQKB          
FAJY            : FPPUE           ICXEOCMOE       OWPTCMVFFYOI    RLGHGWO         DRMRFOFSMLY    
FBFUBHW         : UIGMX           UGVYG           ASUKSX         
QFAFILIAMAJW    : JSMGGTGJWRC     QXRGMFMEWKA     FRUOKVKSRUKNNE  DLTXSXFPU       HCPWXQUQFB      QDGCFAULHHE     EDHAQWYSUBMU   
NJHCYND         : RQQMXPXGXULQ    MVIVBQRNEKGDWO  SYXSKM         
OMPPRLSYKEQPF   : HVMXAITI        AUMBJHEJMSJFFP  ILSNBOQPIBDOVD  OMAYTEHVF       KIQM            DMQRBNHFPMG     JUTJV           KDIEPRYNQGKQ   
OMPPRLSYKEQPF   : HAALFMJY        EDHAQWYSUBMU   
ASGAHIJEB       : EANNLPA         JRBHHQFWFRWVN   WINSUOVWBFI    
QIARXFCNSU      : BTJNFKRT        WUUU            WAHKIUEEXV      IMWP           
KGYMQFDJKBJFHK  : UJDFSRCIAY      RQDUJ           PSUHPXVGOTNBBBK
SVTTT           : RJBSHXHVHVNWSTW HLCQBOJTX       DUFBSONIVDPTX   EAKJJVDNKGHJXO  JPASDYMHAQYTMHU RFUNBHNGDGPOX   NASHGVND       
EWEDCJ          : SLRXJMQ         PSUMYOBEMI      OLBKDPYQHJPCMNO BFJMCROHQQLPN   CRORGSWIIQEK    UMYPYUOPSCIRFAJ
UEXIK           : OSNF            QXFVWTHNFYJB    RQQQWQWWE       IOJQVHHMYK      ACWWMGFNOCE     JCNP            ITDUAXGCCCKM   
UBFXMR          : IIMHJDTDUQ      JQVTUXEXNT      GHPHWPFTKXAX   
WXKJNDF         : BTJNFKRT        ACORNDOPOW      FIEDSPYTBTPNOX 
WCUEYBHB        : VPHSNY          KUVMPXPOMXOS    IYQUOLMBCP      AJLBYRBWMJ     
AYOAHYACDHCPYDO : GVXRHOOCMYYLJF  DACPPWYE        AEBOK           JMSFPDAFYWGO   
PAMTGWSKRW      : NVIHYBOKTRVCN   KBMAA          
SGOEGNSJWUJ     : QWMLEAHR        VUHNIYHONORVH   BPQBJSSWNWUNKOT
XQDPRIFRYHGUPD  : TIYEWKOWQP      FLREAMWNULUNEP 
AUNLQVBUFQPOO   : DNCDHWPHMQKTS   KXNSVHQXGKPPNY  SCARSTAHIXMU    WWPF            GSUDWMVLO       IQOKTXSCQLUC   
APKQTBKCICBPJXI : SROUWCHGNMV     SGROXXWAXGEM    OCNUKXBPWUUW    HWWKWQGROAQHB   QKBUUWG         ENDO            OHNDU           AITFUFLPRNLGNS 
OIKEWBAAXFQPVHD : VACFFACLVC      ABXSVMSLRQMEIR  SBFEMUR        
XNORQ           : YFFMF          
VYEARNXADMKPSH  : KXCU            GMHPNBMUUV      RFIQRJWPV      
THQBBIXIL       : JBSAOWQCU       JUXPOTGYPQS     CMPLOW          CBEJDALJGNCT    MORHEUF        
IALAQLYSPYMG    : UNKESVT         JPHNBPKYDLGVRV  QOCVASEKIVV     RHVJSRQHO      
OLOYBHJTDSMF    : CRVSA           USDQTTYJP       PKDY            YUFFDKS         BDJGFQRQLKCKTFC
UFFHBNJOQCCRUU  : FLIPMCN         FUQBIXU         FORU            JPDIELYIGAJ    
JBRXOGAPQ       : JVCSNEANFNKMIO  RLXNFVTFXDFRORU RBSBTPJYDLQHVFU RJEMTYQQ        RHVJSRQHO      
LTCXBYSIGCMVL   : LBLQAFYILNCYKMQ ORPCGVYJUJJSMS  PQVHNMAQVXFF    JBIKVUW         GMNEMYUMOVN     MVKUP           YCAMWUOXBFNYDF  FEAJMVKMEW     
MOEGLYY         : GVXLMAJ         JWSWVYKTKSSR    MHABEMBHWTRS   
CRVSA           : BOTOQGQ         OLOYBHJTDSMF    KPHNFBSLQD      PPIPBOYIUGGJRV  BRGAWRQJXB      RJSFBMXQKGFO   
IQHT            : MNEWCYTLCPFBDQ  KRVBCPYRKQISMQ  ALAWMJLXUTNB   
MTONOATRMPFNFV  : CKPXAQI         WAHKIUEEXV      CAINHMKIPJUG    WOGHAWDG        SNQGSXK        
LKULGYFERFB     : UTWG            TNVOREYOMH      IVSMLDJXSTSYA   JMBNXT          VRKBTGMO        BRDQE          
YKXMW           : VROPJ           NIYGAKDRHNJHG   KKOCVWP        
DKJDEBP         : TVNGCAAIGPAEN   RCMJWHMBKU      MVLJM          
IGEH            : FTNARFBWACN    
PRXDAYKERQHTPS  : DOYOMAHQRR      SFCFR           YPCMSVLVHVOTM   ASUKSX          KUVMPXPOMXOS    MPWRIPVMNFAXHP 
EPMJDVPHYFGKNKR : TRVXAOGWYM      QJEG            PVOXBWQQQTSA    LQACJKJBKCB    
DJQGLR          : DDGDBPRLMVIX    EOUIYISJPIG     HFHDXVNG       
RJKAGC          : XUBFTOVFUMHG    MBWSWYUUQFUE   
BIMP            : WQBPHK          BCSFRFMUES      LGOV           
PMHANPGXFRRX    : WCCTI           RTXTE           FFUOBMKFVKLAB   OBNSTIBFO       IHDSS           CQSWXXCITFCOQU  LNCYXS          CGFUJKHYQMIQ   
BQFOJWHUJJDNEEV : UBTQJRUNURNIVI  MFYMMAWFLPQV    DSNRAPGOP       UNJMRBFCKIR    
WQJLXJYPRAVLRVI : TUQLGW          AFXJN           XJBRXHEMMKJVFJ 
NOKWNRTXBXLHCK  : OJXS            KJFFRBJMNU     
BBKMY           : MSVPFWKUNKF     AMSY            UDCXYTEKQ      
MRLMPXGLG       : NDHCAIIFJOYIAGV UMMHRHNBJJB     PJCYWRTY       
YWNXLHSJL       : RBSBTPJYDLQHVFU
WSUHTWIEJKAXE   : LTORYQ          KSHDNRQTRUGILF  IHPWRXJXL      
MTOTFWVFUL      : CTJFTDPVIHTDWJS DXCOI           VSETVAIAHIJLQ  
GVXRHOOCMYYLJF  : UUTPOYUDH       UQKGT           AYOAHYACDHCPYDO HACPB           LWHE            DYHEHCL         DNIPJRB         QABNBVPTVNHYRF 
GVXRHOOCMYYLJF  : PBVOAVUL        NASHGVND       
TGVAWKTLEAIDHF  : KOPTTUPXKTJM    ULUCWWVB        IXYGN           EVCUBV         
MLMNFVEUY       : KVQPE           STOQTWMESD      AYNSOIXGMQICXV 
VACFFACLVC      : OIKEWBAAXFQPVHD FALBJL          QJIOKLVIGLAQD   ABBW           
GWVNYHQGM       : CHTUVNQRREWU    OGSNYYMJGRBBVOB HIETHVTCMJWQUQW
UBWI            : LNMYYLPNDYKSQTN NVSLHVQSFRG     QWHHDVT         NRKGMESEXVH     IRPWQRTVFBU    
SNDTE           : HMRPWEW         RPJOPQW        
TJHC            : BFUYGDSUYRDWQ   KWGYABDTSPP     UJNFRWSKWMLE    ORCJXOHYQSPM    IVJNACTHUVLUBRR HVXIYJ          USTIHJEXIQY    
JPHNBPKYDLGVRV  : IALAQLYSPYMG    DNIPJRB         DXTTU           RLGHGWO         RVSKHPJBVM     
PWFXFALLWSKSETU : POXWMBKXEFX     YGUPDTVADPS     FBFAELADJLUJV   CIYRRH          RLGNT           MNGAUCHO       
DLWTMMGLSSUQMQ  : ACORNDOPOW      UJXEKXECQPWD   
CPEBWFO         : QKVHMENFFPS    
CJTUNN          : EDHJGCDNLWOORJ  EDAMXQFEAAT     HOFSUIUI        NWJADGKL       
DTEANSP         : EXFQBAYAEY      BNDAYLXTEA     
EIOBY           : SFCFR           STIFWSOCEBW     JNMORCIMOXY     VKODGXENLYVFY  
RYEJDHHKWPOI    : ETVGKR          DLIRKPWVXYBA    KARCH          
MYCF            : HVXIYJ         
VLDL            : IJUNJKEDRWK     WBAGPY          GKQG            KIISFWGNWSGHY   NWOID          
SHIDYKC         : QNICYGLOKX      QQJD            BUUOMN          RGKOVG          DDCCMSEJUCC     HASJ           
EDFOHPXT        : VBDRWAHCP       OTMKA           GQAWYSVD        SEIRTWBNATVBSP  PCECLQAX       
NJWAXVCDB       : NKSQLOQJ        YAEK            LOYBOPXGFNFXIN  ERJLIKICKE      AJDRA           CFLLUPLW       
QENUYWF         : OBMKVRN         DMMBCBWALAUXBWM
VRIYWMHNVWLPL   : JTJODHMQOOLQE   TVNGCAAIGPAEN   JBEXISTTCG      SUWUREEUADJC    YSFRIKTH       
BIBBHDGIF       : XRBLDAMETYBWAP  BUUOMN          SOWJRXTVHSNNE  
OSRPSXTOPCOOQVC : TYIWRPJODLYS    GNCRW           YYHKCHVQJAWRI  
UPFGRGQ         : FFKGMGV         HPCFTSPDQFXBCMN
IAYO            : QXAIPWNYBNBPVHH JUTJV           ADNIXUWDHX      PUDKHYKK       
EOYAGQSEMJURA   : IJUNJKEDRWK     GALNYV          WJJMNIQXINBFHY  BYMFOCG        
IXOVSEBBXJS     : HACPB           DMTUSSRYIXA     SWRGWBRACJ     
TUQLGW          : WQJLXJYPRAVLRVI LENF            BQLGNNFEBYC     AHUDJVB         QLFSG          
FWGYRN          : FCDNO           ITADHEONJIA    
CKDC            : HTGHJPIUPGPEG   AXDHSTI         CMPLOW          HLCQBOJTX       BQYCIJGIG       HCPWXQUQFB      CJGJX           RJNQ           
OBMKVRN         : HDFCCDV         QENUYWF         DKQB            FEKATT          GTTKUO          AMOSAIPYKUKN    JMOHHMILWFIB    IGNTXQMBKCN    
PYSJ            : COLKTABBTYWKJK 
NCHTAJ          : FBEBSTRVBXFDP   WITNPWD         RDDISFWMH       EETSQEDDKWVBE  
YRBRFMTRS       : HVMXAITI        YGUPDTVADPS     KGWFNOVD        LEDGBTDX       
OHBBTXUJXN      : ESVJXQPAROBLF   NBFM            TQOGPDOQIERPG   LHBGQLK         UQPKOHY        
QWEECNBC        : ARFBNAKVBNI     CFBM            INCVSOL        
DBTE            : VCWQRLAJ        JMBNXT          AITFUFLPRNLGNS 
BSOT            : XGMGESFHGSOPJLY GYTXVUAO        SEYLTEOATR      AKDWVM         
NKSQLOQJ        : NJWAXVCDB       UIGMX           SJQKWYD         GAKOIQ         
OYHHXN          : RNRRRDQVQOKHQ   QKVHMENFFPS    
AEPCFUEYYY      : DURSXRANYW      KDCYUPN         PUTP            XWIMLRDLSAP     MXAUENVMTVYD   
TQWGGHBWUQOE    : RMKQSLDP        WITNPWD         SHOLFFFCKYWQSS 
FFXPEO          : LNNNPJGOPQ      VLFVEEJJFOYXN   KQTCTLKMBWGSHA  LDFHNARLUYTV   
ESVJXQPAROBLF   : OHBBTXUJXN      EHWUYG          QLFSG          
TLHVLCOCJDJOEYS : PQGOWFCEUFFNMII DAKTWCY         IQRWPWYLE       AVDUAGKKO      
FALBJL          : AOJWWHLJFGUX    VACFFACLVC      ILSNBOQPIBDOVD  IHPWRXJXL      
YNLPQXXQRL      : UGYY            IVSMLDJXSTSYA  
PYDEBMK         : JDVQWNL         NTOPBR          UJLDROD         BDDRJHGEOBVOMV  TNBKODMWOSTOXY 
DOMYHSBUV       : JGCYT           XAOKLRUFTU      VUHNIYHONORVH  
IQLW            : EDHJGCDNLWOORJ  LVCWHBHNKQQV    HIHSGNSOF       BQYCIJGIG       BHBUP          
DNCDHWPHMQKTS   : AUNLQVBUFQPOO   IMTLGLNMQDVGUVG NBFM            DVTO            SUVRJTIXXNEYKJ 
EGDSUEAPFUMRF   : BCAKWHVBKIP     DOEWBCADJKADQ   GOIJ            XAMSI           DACPPWYE        DDCCMSEJUCC     HJNXDEWACVYJW  
FCHISKMAJEHVUUP : TAQF            CCRHLCCQSIJGK   GPBBS          
TTXYOTDOLKLXCR  : OFYSJEOFXENBOCF MYFCUETREIL     CUMMMRE         TJUC           
HVJSOVHQFLBDIV  : HKUJMIYANBNGRHT KRMHNQGNQWFBGFS
BPRBRHWUXJGKHK  : XXJLDBSEEKVMMLQ SVBFBUP         EHAVXRKHT       SSQCU          
LSAWLR          : JRVPCYW         VBDGV           FCDNO           TAKUTK          PMRBDNN         DLKNKNJJOJW    
SIAGJFQHBTXTVP  : AEEYONWPVLPQJAU XAWWNFWOQGDI   
SMBCUNKGR       : HXTRQDJCJ       EXSIPEMRHJN     UNJMRBFCKIR    
BUUOMN          : SHIDYKC         BIBBHDGIF       JGCYT           CAPEHGGCSFVVMJ  OJIWNMDWCH     
WPRJUIQY        : WIYFSRSMRWMLVV  KXNSVHQXGKPPNY  DAKTWCY         JNOVMOWYGUGT   
QUBIXTVYWS      : YOTCGQXOSWR    
JBJHEECSSRE     : KRHVWJ          HIHSGNSOF       SUVRJTIXXNEYKJ 
HVCEHSD         : IEIEHNRFLAEYP   FLSKJKVE        HOUKQAGXPEP     GAKOIQ         
KXNSVHQXGKPPNY  : YWXO            QTSGSIWHGMFMVN  AUNLQVBUFQPOO   WPRJUIQY        ITVICFSMXBXMDCV TQCVQWJPRU     
SGBNYSSRCOT     : ORPCGVYJUJJSMS  DIRCOFOHU       DHTQCSULAXRMKK  EHWUYG          VUFCJSIE       
XNKKXJASHKKH    : UUABTLSQQ       JUXPOTGYPQS     RNRRRDQVQOKHQ   QLFSG          
WWJKWIDDMREHM   : FVDCMENOA       SCARSTAHIXMU    XJBRXHEMMKJVFJ 
KBQRC           : TJFFF           CQLGMYRPUL     
COGNPAXAMF      : LNRWFXFI        FPBF            MPMC            GSVUHGQMVM      JMVAQS          OAYIKFGNFQCVBV  ITDUAXGCCCKM    UIFFY          
JFEVEPCJCVN     : CDVQYGMX        AVCMSDYSLNFBK   JMOHHMILWFIB    GMHPNBMUUV      EKMFICBB       
IMTLGLNMQDVGUVG : RNRFKHC         DNCDHWPHMQKTS   RDKCHRJ         KBMAA           AYNSOIXGMQICXV 
KOPTTUPXKTJM    : EYQEKCHLVMRIIF  TGVAWKTLEAIDHF  CNLYDEPEVIWYXYF RWIXLICKBILDNW  PPQYVQNOBHDJCR  PVQXQAQPHS      NRICWIGGXYQUW  
WXXMSKSGX       : TTNOLSSXB       LJWCUS          GSVUHGQMVM      BBCICWYM       
YDDIXYOUJDLFWG  : TAKUTK          ICXEOCMOE       YYHKCHVQJAWRI   ELIUWXFXC       BTMFW          
WQRIFIGDIUXSNF  : UYJRLKHVSEW     BFRVOAGHIVAA    OSIAW           JNMORCIMOXY     HIETHVTCMJWQUQW JKUPYLISNG     
UGYY            : YNLPQXXQRL      XLHYFDF         SASHXGMSJJEDRIA UJBPCFKDFLAKA   PQNUDQCSCPFNP  
XAEUMJGT        : LNRWFXFI        RPCSRYUGRFK     PJYAFT          DRMRFOFSMLY    
OTIHMRMWX       : JYTPAGUMDUER    JPSVJJE         CVQYQTLCMCS     VICYWJFSXTOIAY 
FUQBIXU         : FGJWULS         VMLYBOVBJQBVNXQ UFFHBNJOQCCRUU  JYPYVGFSUMNG    ILSNBOQPIBDOVD  GVIOXOQIULPIWY 
FVGVTJCPXMXR    : UIGMX           HJWMUBD         CHFOLIUAXFTF    LUGQT          
NMGUBX          : VQRYOTPYACPNUU  KATW            VGSICMFR        SKBB            XWIMLRDLSAP    
AXDHSTI         : CKDC            BIFW            EXSIPEMRHJN     YFFMF          
UFHCCPX         : GNOBGCAFVJB     IVDYOHAXMXU     IPLMXTDXQARGHF  WDBPUAGHQWXHKPH QPUCQDKWWYLPWHN IRITHSP         XDKJQCHFMOLLDI 
YDPW            : UMYXFK          BIFW            RIDG            IOPITHYQWTVLR   FCNGCRLJMQSRVT  NRICWIGGXYQUW   HCLYCYSIMJ     
ORPCGVYJUJJSMS  : LTCXBYSIGCMVL   SGBNYSSRCOT     LQFAUJ          FAEJW          
JEPEJYGNPGOO    : XTBGP           NVSLHVQSFRG     YYHKCHVQJAWRI  
EODSGSWMR       : SLRXJMQ         OWREOOISISGOJ   WJJMNIQXINBFHY  QDGCFAULHHE     HIPRIDWWA       YFFMF          
XMIHHXATHE      : LFIXMFLHNIWHRQ  RGKOVG          VQRYOTPYACPNUU  YYOB           
NQLVGBCUS       : JSVGDDQNXAEAHLF YYNHRNFM       
AHTUPPUEJ       : UOOPWWIWWRPSSHO KODTOPGYVLAA    EJVEKM         
CXELFCNCLU      : DWPYOQVGNMRJLQI GVBAHCVLCPCC    GBQLWBBJVSUFIIQ
YLAUTEAPYQRGMOX : ISWGBAJ         FPPUE           WUUU            UKPKRDDJPQ      ONQGEOWD       
JCNFGLMRT       : DEGLXUHXVCJ     OEMANBXYYWTSN   TSWXF           EMBEA           SSKKTOGJPEXA   
FVDCMENOA       : WWJKWIDDMREHM   BXMYUXOTHUTEDS  FXOSPUDQMCIJ    JERFYR         
SCARSTAHIXMU    : AUNLQVBUFQPOO   WWJKWIDDMREHM   QEEYC           QLGOCLNMHD      QDGCFAULHHE     VCWQRLAJ        YGCIMJL        
ACKOQEI         : FUMMAGYGKBBDD   BJYBCYVKQSG     TIMYQHTS       
MENOQRFF        : STJOWHWBY       DNIPJRB         MORHEUF        
PBVRUOLV        : CBWQIJNVWFH    
VVLQBLVLCMQ     : GDKAJ           KJPOEWSHIECCC   QFLDXR          AYNSOIXGMQICXV 
UDOKR           : WXTIYOVNLSNH    ERAHE           MFYMMAWFLPQV    WDBPUAGHQWXHKPH SWRGWBRACJ     
DWPYOQVGNMRJLQI : VJBCNKJL        UNPVFRLXAV      CXELFCNCLU      RPJOPQW         LOLQU           HYTVL           BYMFOCG         JBIKVUW        
HJLFWN          : EEBMCY         
NYPSPBNAGMRFCKB : CJGCLHMBQB      NDGACXGHVHGM    EDFVHVSAMFJFDJ 
XQFICVQC        : HFWOHMWGNJ      TMMMFUTO        KKDOAHPYUMYQB  
CNLYDEPEVIWYXYF : KOPTTUPXKTJM    DXKFAGKMANNU    TVTAR           RIDG            YNAXWAFTRC      FBANX          
QNRBQ           : JLDJHHBW        WWCWWQELAFIPBPS
YHHJMFC         : HBMGINH         RDKCHRJ         PREC            KJUYGOXUWHEGNC  JSTKGVB         OBUEIBJB       
LEEYEJFTOB      : STPRWKJAEDIKX   RHEKLESGBJDURJ 
NBFM            : ILQDUY          OHBBTXUJXN      DNCDHWPHMQKTS   XTBGP           RYLVTIDIMQF     TVCLWM         
SFVKGNMH        : LXMNUECUHDGHR   UGRBMGMXA       WBQM           
WRHEVXPBCO      : LHOFC           NNNUIMEMLW      JVCSNEANFNKMIO  OYSPKXFCVJ      BPQBJSSWNWUNKOT
OTBDXHSYM       : KURFBRPFLBSI    DDCCMSEJUCC     RQSHCE          DTEHBXFTIOMU   
HHMERURHCOGV    : FLWUIGCSO       OOSCGLABVD      DOFFW           JSAYEKDOEMSDDR 
KSWDTCTDQ       : YNMYLORTAERRSN  TSJIDXQP        DGTBDESX       
GVONOPDXWMK     : TDSFMJ          BOTCPILWAMA     AJMO            QWLSWBQ        
HFWOHMWGNJ      : XQFICVQC        PRINLH          RGRV            QWCYJDGQ       
KMUOJXFAEDOTTE  : PUDKOMIWL       EKVUR           DVANYAPNSNKUU  
RDKCHRJ         : IMTLGLNMQDVGUVG YHHJMFC         HXTRQDJCJ      
ITSHAIQBVGVKR   : TWNLOMVFXMMVUJ  VKXPOC          KQHYJPKUBOV    
SRAVI           : BWRKA           IEMQ            VGSICMFR       
QOTIRGNBAYKI    : CEBENOH         LEYNEV          TCLNJILU       
FRUOKVKSRUKNNE  : QFAFILIAMAJW   
MMKDB           : YGINTAXQ        KURFBRPFLBSI    MBWSWYUUQFUE    BDLSINKSUBDCE   AORSX          
NVMDYM          : RAIK            GGRIYHGRTNP     AVDUAGKKO      
JUXPOTGYPQS     : YQTPDVBIQ       DOYOMAHQRR      THQBBIXIL       XNKKXJASHKKH   
NFXCKQQYBVB     : CYCIYSNLWUAUJR  NWYHTJQDV       OGTDURC        
JYTPAGUMDUER    : OTIHMRMWX       DGJRNAXCQGI     GIQILTELSPUFS   XIEYM          
KSHDNRQTRUGILF  : WSUHTWIEJKAXE   VMNONWH         RDGSSKEIAYSFIB  VCUBC          
HISTJO          : VPXNDXHXYWU     BQLGNNFEBYC    
KWGYABDTSPP     : XVFTKWKA        TJHC            DEYEBFM         JBGIABQDREB    
UDVLWNHFYULM    : LTORYQ          QQJD            STOQTWMESD      HGNXQVRNPYSTF   PHMDGESESUQEYGH
TIYEWKOWQP      : XQDPRIFRYHGUPD  JFVWETCR        RANE            DKQB            GWIYUJLW       
TUTOMJQHOMSODC  : COVDKTGEJ       KMEHDP          QJWVUXAFSC      WKFIIW         
EXFQBAYAEY      : DTEANSP         WDBPUAGHQWXHKPH
UVDMUYHQQTCHB   : WHYP            TQYYMU          GSGWNVJTFJC     XUBA           
WVGAYAEWI       : MBKHGPLLGASXRGR OUVI           
AIYCOXOJVTVSSFK : RJBSHXHVHVNWSTW OBLESQAFDTKLX   LIMHBI         
YOTCGQXOSWR     : QUBIXTVYWS      EVEJISDYXYBWHIH AYMVVBHLRRPSPVR IOJQVHHMYK      SBFEMUR         VGSICMFR        QIHGW           JSHYFFRFHJKJF  
VAVXIUAWU       : NXTERPMIBAG     FYDOWLKLAYXJW  
ISIG            : IEIEHNRFLAEYP   LWHE            RQSHCE          OBONVWLHABJ     BPQBJSSWNWUNKOT PQNUDQCSCPFNP  
ENYPMN          : HYCY            KKGRIBXJG       UMKKEYRTS      
QWCONUOFVMF     : KJKY            VHYMPASDNPHP    GQBC            QOCVASEKIVV     XIEYM          
LPPLONDYG       : DGJRNAXCQGI     BIFW            HCGUYGFW        FIET            LXBIWHCO       
FURSVKHMV       : HACPB           QBERJEBBTTNXW   WAXWM          
JYPYVGFSUMNG    : FUQBIXU         MEIIGIM         ULTSWHSGP       WSCI            BTMFW          
DURSXRANYW      : AEPCFUEYYY      FFMBLSMD        EAQRFRAGLCB     DAEIAJY         QLFSG          
UTSCGODR        : OKREIHCOHWDXM   FWERJOEOHT      MHREYEVRW       QXHHILC         MJADPAK        
UQMDVHXJUFOAC   : QGHTBASSGTFJF   WITNPWD         XBMPDMF         XNNVSC          BBYXSJRLEMG     JFROIQ          IMEQEAIBAV     
TCAVPCSXWMQ     : JEFWTFAJEC      TFEKVHL         OCLO            SREUIDVS       
UIGMX           : MNEWCYTLCPFBDQ  FBFUBHW         NKSQLOQJ        FVGVTJCPXMXR    EHWUYG         
EMGATFLQMATO    : KJMDQMMBWIUNHXC
PQLL            : EYAWNOK         LVDAQRRWITBS    KIXDNQ         
PGHMVX          : OKREIHCOHWDXM   HDBQNY          AXAOVCJC       
QIYEHDIVLKSQ    : WRRIUUYK        GBEPQARHVKU     QFLDXR         
JFYFVKUMYIV     : RTSCTKEB        YFFMF          
PDELDW          : EXHPKYKBGVRWGE  OTSRY           FLOBCICSFSRF    RHEKLESGBJDURJ  WOQGV           XUBA           
MVIVBQRNEKGDWO  : NJHCYND         HGDJHP         
CKPXAQI         : MTONOATRMPFNFV  LQCHTCBPKHO    
FXBLLGI         : VJNB            OBNSTIBFO       RNRRRDQVQOKHQ  
UHYQKSL         : TVIHHKM         DFKCT           EEOXFWFWECE    
WVHASVEXG       : XRBLDAMETYBWAP  CKRK            IGNTXQMBKCN    
XGMGESFHGSOPJLY : BSOT            IVLKLTYKU       GHUT            KIQM            SYXSKM          PUDKHYKK       
DJEOK           : NDUMDY          SXHRLOS         OYLXNVNAJTD     PUBLD          
MRDGPJGXGEFSKL  : GPUVX           HLLQWLEQAULXAA  UEVTFAX        
PTUJKM          : KLVYPINTPJK    
VLGB            : OGGHRG          CQSVHTWLATLRV   VCKNEUYIAAUDYTH FADPWKGKH      
KPHNFBSLQD      : CRVSA           DFKCT           DGLNKTGHCSKVM  
RJVYCIKQBGL     : OAYTIWIQLQ      XPOVEYXORQGF    KATW            KIBVXXSXTVPWB   HWWKWQGROAQHB   UENCVUMDQWTKXNW BMYTOMIRI       NRMLCMN        
RJVYCIKQBGL     : GVIOXOQIULPIWY 
SXHRLOS         : DJEOK           WUUU            ICSQUTGH        WHVIQH          VWFICCUL        FRBCYACDRJAOW   QDGCFAULHHE    
BLSPQTKENNX     : KUVURBIWJVNOQNQ RBJAT           DXKFAGKMANNU   
WVGCEQSFAGRSE   : KRMHNQGNQWFBGFS CVVINJIQF       PJCUAEVPFRIBP   AITFUFLPRNLGNS  GREQSYO        
MRQGARTUJKRUQH  : HFJGC           QXKLWJHSW       SWKQCUQMGCBDX   PIMBNYIESX      OVYJMJK         VYJUOPKNF       DVITXGT        
OOIMUKQNFYNL    : GMYBYLXACSMVII  GVXLMAJ         ABXSVMSLRQMEIR  JMVAQS         
JPSVJJE         : KCDKOQ          OTIHMRMWX       IIUIHCO         TYIWRPJODLYS    WOSJFFSBEBEJRR  FQYXMUYWNPRQ   
EXHPKYKBGVRWGE  : VJNB            QQJD            PDELDW          DXKFAGKMANNU    IPMG           
QXFVWTHNFYJB    : LVCWHBHNKQQV    FMBF            UEXIK           IVDYOHAXMXU     BTBKFDLIH      
UGVYG           : SWDGHH          FBFUBHW         VHXVA           GDKAJ          
PREC            : KJTMI           YHHJMFC         IVDYOHAXMXU     RJSFBMXQKGFO    HSPRAAHTEDPSFFI WTHLFKQS       
MAPJGTBY        : BEIQJYLLCS      CEBENOH         RPIAXJBOEXSPH  
HWQDGHIFSL      : AYEIPCJCOK      KVQPE           WFSSJLPAR      
NTOPBR          : XVFTKWKA        PYDEBMK         YAEK            JRNPPLTFKQFM    ATMILEDWBBWM    UMMHRHNBJJB    
UYJRLKHVSEW     : PXUJVFS         WQRIFIGDIUXSNF  GVXLMAJ         DYKLGOEDMWXGC  
AGPRLWBVETKW    : TOLXYW          FSLXIVSDSSDCXH 
ENWHFEEGQWSBG   : OSNF            QICFGHCSRJUQYX  YGUPDTVADPS     ACWWMGFNOCE     KKTDIJTSD      
VMNONWH         : KSHDNRQTRUGILF  KXXYAKX         YFBCVNFCRSTW    JFRSKDAXPI      QBFCME          NBFWD           PUDKHYKK       
IGIFMC          : LOYT            TPBWBQRYAPQBC  
LLVYJ           : OLBKDPYQHJPCMNO TSJIDXQP        TYWPWNHCUHV    
HPKNGJGJSW      : HCBKA           NIADJFWGV       TFEKVHL        
FLWUIGCSO       : HHMERURHCOGV    XPOVEYXORQGF    TPDRSFESITGBA   YEHWWEVYQVSM    WWCWWQELAFIPBPS DGICGQULTX     
ACORNDOPOW      : WXKJNDF         DLWTMMGLSSUQMQ  FQEMYV          FIEDSPYTBTPNOX 
EHKNTTWMQ       : QONMRHAESREBDI  RDDISFWMH       FIEDSPYTBTPNOX  AAKAS           NJSCGYASDWA     GRNUXJRVFKKT   
TEFPMLTIBHI     : MSQO           
XDUBTKPQH       : GAKE            FWJDMP          MBKHGPLLGASXRGR PRUCETJLFOUQY   GENAHGSGE       XPEOM          
XUKTOJGHPBM     : OMAUDTLMJOWHL   RWIXLICKBILDNW  PVOXBWQQQTSA   
SBIM            : UPLGQPIOHYFNN   HCTJYHR        
LTUQS           : VKMNDWQKQJSLXKL LSOOBHHE        USDQTTYJP      
MTRYMIJJIEVDUF  : TGKLAF          PGJVAOKDFKV     RFMQ            SUXPDCYVMJIQM  
CWMOTFQFUCQO    : IVSNWDMSIO      RNKCUQQDAYY     LWUPKM          BDPIUWCHIDHL    SIKFPHGEJRHFY  
KJUYGOXUWHEGNC  : YHHJMFC         MIIVUHGYPFLVS   JVHVCDF         IXYGN           PMRBDNN         EYUQKMEXUHATVF 
IJUNJKEDRWK     : VLDL            EOYAGQSEMJURA   IHHKRCEK        BRDQE          
AEEYONWPVLPQJAU : SIAGJFQHBTXTVP  BJYBCYVKQSG     AAVRKAL         BYMFOCG         YKWEYFOSLAF    
NYDYJX          : LKQJMHIFIOGEQK  RHWKHLHDFONL    QXSPIPCDIUAD    GAKOIQ          RBAUPPG         CIUMDPNBV      
SKSXDQJPSP      : OICYWF          AKDWVM         
RGKOVG          : DNNSDCE         SHIDYKC         XMIHHXATHE      SIJKLVEHJCQGQKS NQNFCGMDL       TGQQYGENNDIO   
LXMNUECUHDGHR   : MUNIW           SFVKGNMH        KSAIMOVBT       GVXLMAJ         MMKXVMGWCHKHW   UHMBJOXQII     
UMYXFK          : TGKLAF          VMLYBOVBJQBVNXQ YDPW           
XAMSI           : HRUX            EGDSUEAPFUMRF   CJBRMLJEICVEY   XQAJBUUCIV      WFWAENYNFTIETBG
JEDMSDBGY       : IVXILTFWKCG     QIDHTSGRLPABCO  ERJLIKICKE      GWFSWM          DEYEBFM         WYMQSW         
KVQPE           : MLMNFVEUY       HWQDGHIFSL      WJJMNIQXINBFHY  JWTEVJCRFTI    
JFVWETCR        : TIYEWKOWQP      AWSUIVKKQ       JERFYR         
DTVXDUJHBWCEAL  : KJKY            HCPWXQUQFB      JVLYMSOPOWP     WIKLTLMVHVHWAI 
IVDYOHAXMXU     : EIFNCLIIAVIKKN  UFHCCPX         QXFVWTHNFYJB    PREC            PUBLD          
RANE            : GODFTVULUXSKIMS TIYEWKOWQP      IVSMLDJXSTSYA   HPCFTSPDQFXBCMN
HCBKA           : BWLE            HPKNGJGJSW      KLCKKWFY        DMMBCBWALAUXBWM OCMXF          
UBLYFMK         : EHAVXRKHT       TNBJETHCDLKSR   PDCARVV         YOAAXNJBVB      USTIHJEXIQY    
WJQXXBB         : JUTNFYDIK       XEDMCTTBMFGD    VQRYOTPYACPNUU  ABMEH          
PYRLRTYXWJ      : VTGNERFAJ       NVYHPRMATX      AQNEQOKMGSNEV   RYOXVTPOK      
AVCMSDYSLNFBK   : FNNOSUCBLOF     JFEVEPCJCVN     YAEK            WWCDJA          GCNQX           APCTLNNMG      
TIOUJLNJFYDY    : SROUWCHGNMV     ESWBKIGGN       WFWAENYNFTIETBG
DXKFAGKMANNU    : CNLYDEPEVIWYXYF BLSPQTKENNX     EXHPKYKBGVRWGE  UJBPCFKDFLAKA  
DACPPWYE        : AYOAHYACDHCPYDO EGDSUEAPFUMRF   GWIYUJLW       
KRHVWJ          : FIASFW          JBJHEECSSRE     MVTQNENNG       PUDKOMIWL       OSIAW          
XKGVWMXDYNFOBA  : VXSXONAGXNVP    DOYOMAHQRR      AYVQWAM         XRWOCGG         IGPHGESDWQOIPR  PJYAFT          GSWVVSOMFCRI   
HBUWSTXYO       : YYSCFCJLIKR     KUVURBIWJVNOQNQ AMSY            GWKGOTLW        TJQS            XTKXD          
RXHQJLRT        : TFEKVHL         LNCYXS         
PQGOWFCEUFFNMII : TLHVLCOCJDJOEYS MSVPFWKUNKF     OGGHRG          UWYLEGROXBVYV  
DFKCT           : UHYQKSL         KPHNFBSLQD      PXLIMGAMMI      XPMFRN          LPEAFY         
VTGNERFAJ       : PYRLRTYXWJ      KRQGIMVLBOXLANR FSREMXTV       
TSJSXLWUTEI     : YWXO            IGPFS           SPQDGGTYIMUNXVM LQACJKJBKCB    
OTSRY           : PDELDW          MMKXVMGWCHKHW   BRXXA          
UUCSQIGUCNXO    : HDRMAU          BDDRJHGEOBVOMV  JLDJHHBW        OCLO           
RHWKHLHDFONL    : NYDYJX          DTJG            UEUCR           CGQUT           EDELI          
HHVINSDRLUDURF  : MBWSWYUUQFUE   
PTVJDTTL        : MBKHGPLLGASXRGR GWKGOTLW        RNRRRDQVQOKHQ   PJCYWRTY       
EQKSEXVMFTWUMB  : AQBHMIDAIWT     GMYBYLXACSMVII  EHAVXRKHT      
BXQVRXGKUDTXY   : GVRAQUHSKYEGXTE HSPRAAHTEDPSFFI
LEWCOPHO        : RQQMXPXGXULQ    SMLYGF          OBONVWLHABJ    
VUISR           : LENF            CQSVHTWLATLRV   OCLO            MYXUH          
VHXVA           : IYUITCUK        UGVYG           DHYQI           GENAHGSGE       DYVENBDISKT     RRIYSTTNNXBVCRA
QYFBVKUVJNINK   : EMFRIEAPFAH     GTVREGBWGEONFL  NKCLE           LLLPSTCYAQING   WBQM           
ECTSQRPBNKALRB  : XKPU            VADXHXMFYMSCO   UPUWFLKVMOCDK   JRIDOH          YOAAXNJBVB     
SWBTEC          : YJQFOGTQPGGUMQ  LWHE            TAKUTK         
OYLXNVNAJTD     : DJEOK           OFYSJEOFXENBOCF UMMHRHNBJJB    
NVXFYLPY        : CKIYRPILIPEW    INVBGGCLAICGXV  ENHM           
IAJDXKWCMOTOCTC : OMYTW           PSUMYOBEMI      HSPRAAHTEDPSFFI MERQOFWJN       IETX            ASBEEA         
IEIEHNRFLAEYP   : HVCEHSD         ISIG            WYMQSW         
YAEK            : GTVREGBWGEONFL  NJWAXVCDB       NTOPBR          AVCMSDYSLNFBK   DXWJTKKMNT      MUEURAJXN       TVNGCAAIGPAEN  
EVEJISDYXYBWHIH : YOTCGQXOSWR     MMDSNFPGG       SHOLFFFCKYWQSS 
RWIXLICKBILDNW  : KOPTTUPXKTJM    XUKTOJGHPBM     CBTXLEROBEK     UWJYKKUIBDQYD  
TUNDFJIFJII     : VUHGBDMTKL      CXMAPDR         WVLK           
RQPGJMPH        : OTMKA           AQYD            PRUCETJLFOUQY   TVNGCAAIGPAEN  
ALLBUWHKVQ      : AAVRIOHTU      
SGKYRUEBDMJXEY  : STOQTWMESD      BSYDWYRMNHNM    GFCQYAVXSNJTWDL KKTDIJTSD       MLCPDLKAPUI    
POXWMBKXEFX     : BMOVHP          PWFXFALLWSKSETU QLGOCLNMHD      WCKAG           WFSSJLPAR      
PVCU            : WOAXHURE        WVIJPJP         SYXSKM         
LHOFC           : BFUYGDSUYRDWQ   WRHEVXPBCO      LSOOBHHE        IHHKRCEK       
HIHSGNSOF       : AOJWWHLJFGUX    IQLW            JBJHEECSSRE     TJUC           
PCVQ            : SVSCXGHUEUOOH   IVSMLDJXSTSYA   SKBB           
WUUU            : QIARXFCNSU      YLAUTEAPYQRGMOX SXHRLOS         AQYD            RYOXVTPOK      
LSLIKY          : YUFJ            WFMCCTXT        LAOMENNIS      
BFRVOAGHIVAA    : WQRIFIGDIUXSNF  SWNBQWVGAB     
JPGIGVFDRCMFU   : XYOXJLIVAVROGTJ HCPWXQUQFB      UAOQTORTI       DNLNYCSHSRKNQF  WOGHAWDG        CMIILQYX       
NIADJFWGV       : IXXBCH          OTGNBYQK        HPKNGJGJSW      ATFJEDVJJFX     BXSLCUAQUYMCHKH LPEAFY         
MEIIGIM         : XMYIKXGSPWHV    JYPYVGFSUMNG    RNKCUQQDAYY     RALWJGVRLURQY   IRPWQRTVFBU    
XTBGP           : JEPEJYGNPGOO    NBFM            PYQLBULOVBTPLS  JBIKVUW         GAKVY          
KJKY            : QWCONUOFVMF     DTVXDUJHBWCEAL  AKDWTTUF        NNNPPNLTVJGYY  
HACPB           : GVXRHOOCMYYLJF  IXOVSEBBXJS     FURSVKHMV       VUONYUIX        VUHNIYHONORVH  
AIFGF           : JLAADIMW        PYONMSTS       
UJNFRWSKWMLE    : KJUCMDF         TJHC            OBONVWLHABJ     SNQGSXK        
TQOGPDOQIERPG   : OHBBTXUJXN      IFGRMMP         QULIJVMX       
WMHCJSQPLPKVMWK : KHMCSETDUNLSL   UAKWIBAKIPPEDQ  NBFWD           RJEMTYQQ       
DGJRNAXCQGI     : HYARSDBSWYK     JYTPAGUMDUER    LPPLONDYG       QJHKWGNIP      
XPOVEYXORQGF    : RJVYCIKQBGL     FLWUIGCSO       FRRTWYSCBIQQB   NKFUIEGOYLG     XQAJBUUCIV     
QEVPQOS         : THUFYKJMFXODTJF BNDAYLXTEA     
YNMYLORTAERRSN  : KSWDTCTDQ       YQYNEXDNQWVP    OEMANBXYYWTSN   NHSDRDMUPKVYUH  WOQGV           DGICGQULTX     
TMMMFUTO        : UVFNUVELIHDE    XQFICVQC        NQWNSYEAGAL     IMGLUQJGG       NUFALRDKBDJPB  
XKDOYWOX        : LGXS            FKFQR          
BYXSSTSW        : JUTNFYDIK       HFJGC           VJBCNKJL        MMDHCKIFVIB     WDLDK          
KSAIMOVBT       : VPHSNY          LXMNUECUHDGHR   FTNARFBWACN     VSETVAIAHIJLQ   VQHTACJO        WINSUOVWBFI     GRRQSXWTEJPQFPM
XKFXUI          : HHJO            CQSWXXCITFCOQU  FYDOWLKLAYXJW  
WHEWVHYVARPURCF : VICYVMNHDYS     CIUMDPNBV       OYOFQBUXBXXUUTE
CQYQODM         : JSTKGVB        
BXMYUXOTHUTEDS  : FYQGFGORL       GOIJ            FVDCMENOA       SGOUYQNNTCVWCK 
DKQB            : EIFNCLIIAVIKKN  OBMKVRN         TIYEWKOWQP      JLFORCBGBWTUCSL WDLDK           EBQE           
SGOUYQNNTCVWCK  : GOIJ            BXMYUXOTHUTEDS  VLPFV           IHDSS          
AIPTQMPUPI      : BVWXCQDJK       RYOXVTPOK      
VTLWX           : YXMFFKQHJ       IBEAKIO        
FPBF            : SWDGHH          COGNPAXAMF      XLHYFDF        
QUCTQBXEYXMQ    : VJNB            LWHE            TSWXF           KDCYUPN         CMMYRDCUYWQ     LLNUQY         
FEKATT          : OBMKVRN         YEXFDUK        
RPJOPQW         : MWIBDRWWHJBQ    SNDTE           DWPYOQVGNMRJLQI QEEYC           BRXXA           TJBIKDJJGU     
TENLYPHS        : MBCINKLMEU      BPCJPIVJUH      WWPF           
FWSGLJBRPN      : TTWEGDY         TNBJETHCDLKSR  
MHREYEVRW       : QVCM            UTSCGODR        INVBGGCLAICGXV 
YQYNEXDNQWVP    : IVSNWDMSIO      YNMYLORTAERRSN  KJPOEWSHIECCC  
CCDFVTSPIDIMCM  : OCPEDQUFVIII    BBCICWYM       
VLFVEEJJFOYXN   : FFXPEO          BWRKA           YMMPSARNQFFVQ   SMLYGF         
OFYSJEOFXENBOCF : TTXYOTDOLKLXCR  OYLXNVNAJTD     PUBLD          
PCOU            : KUVURBIWJVNOQNQ RGRV            JNUUPS          IEMQ            EHJRD           BVWXCQDJK      
TAHF            : BIFW            PKDY            SWNBQWVGAB     
XEDMCTTBMFGD    : KRMHNQGNQWFBGFS WJQXXBB         PJCYWRTY       
EIAFWFKBUOR     : ISWGBAJ         BTJNFKRT        HXTRQDJCJ       HCTJYHR         WYMQSW         
MLRVSY          : CUQCVFRVOAMV    SVBFBUP         XERWMVXYEPOIVHJ MVLJM           RVSKHPJBVM     
XFJCYDDO        : OUBKIY          TWNLOMVFXMMVUJ 
JRVPCYW         : LSAWLR          XBVMJSVWC       PGJVAOKDFKV     CXUUPMXVUT     
EKFYYWOOLJMEIJE : HSAAPFBWDX      BTBKFDLIH       WFMCCTXT        HCTJYHR         DASVLCKFWED     JSHYFFRFHJKJF   GETODAL        
UGRBMGMXA       : KPAQJRPKORIUXU  SFVKGNMH        UEVTFAX        
ODJLHNXMOXJGOWP : TFJWMRGIGDJRX   SQQBMKP         NDGACXGHVHGM    IHNNJGURTI     
CALGQGPIHC      : UUTPOYUDH       OQOXEJAJRGKGT   HSBV            CBGIHVMUXLTFNF  HWWKWQGROAQHB  
TAQF            : FCHISKMAJEHVUUP GJJXIEIYMEND    RBMWTSRR        JLFORCBGBWTUCSL GVKG           
VOFDFDRTDCARB   : OCPEDQUFVIII    XUBFTOVFUMHG    DMQRBNHFPMG    
TDSFMJ          : DOEWBCADJKADQ   GVONOPDXWMK     NFCIOHEJIRGXCL 
ETVGKR          : FPPUE           RYEJDHHKWPOI    BTBKFDLIH       XRWOCGG         QSWCRSGT        QXSPIPCDIUAD   
DYAAOF          : GPVP            JWTEVJCRFTI    
VKXPOC          : MAHMPCGJE       ITSHAIQBVGVKR   LOLQU           QGTBFNJNHRMPX   NRKLMNJUUH      WWPF           
GDKAJ           : NNJMEN          NVIHYBOKTRVCN   VVLQBLVLCMQ     UGVYG           VPPKCRDAPKH    
HVMXAITI        : OMPPRLSYKEQPF   YRBRFMTRS       EEBMCY          AUXBMMMXSXAPE  
NQWNSYEAGAL     : LKQJMHIFIOGEQK  TMMMFUTO        QEEYC           QJIOKLVIGLAQD   KNGPTHGAGTO     JRNPPLTFKQFM   
RAIK            : NVMDYM          XRWOCGG         FSLXIVSDSSDCXH  JJBNQMUHMDSFGC  BRDQE           GSQKB          
MVLV            : RYLVTIDIMQF     COVUYTQHYITUQ   MDDSFJK         RLXNFVTFXDFRORU SIWVL           VWYWLDRGO      
STOQTWMESD      : EFEJFT          MLMNFVEUY       UDVLWNHFYULM    SGKYRUEBDMJXEY 
RQQQWQWWE       : WXTIYOVNLSNH    OAYTIWIQLQ      UEXIK          
OEMANBXYYWTSN   : LVDAQRRWITBS    JCNFGLMRT       YNMYLORTAERRSN  VIHASCEWKM      OOMHUVHYLU     
ONCSGFQAXJQUAPT : AWSUIVKKQ       GKTNHDWNV       UTWG            UPLGQPIOHYFNN  
VJLJL           : XRBLDAMETYBWAP  EKVUR           YJOY            GSGWNVJTFJC    
KLCKKWFY        : HCBKA           JSVGDDQNXAEAHLF AMFSHIRVG      
UOOPWWIWWRPSSHO : AHTUPPUEJ       VIKFFTOL        KXCU            HCNDCX          WKFIIW         
EANNLPA         : ASGAHIJEB      
RMKQSLDP        : TQWGGHBWUQOE    WDLDK          
SFWROVOGL       : WIYFSRSMRWMLVV 
BSYDWYRMNHNM    : SGKYRUEBDMJXEY  NSJRMIUL        NGSCT           HVXIYJ         
AWSUIVKKQ       : JFVWETCR        ONCSGFQAXJQUAPT IUBISPSUBPWX   
JIHF            : ATFJEDVJJFX     LQACJKJBKCB    
NSJRMIUL        : BSYDWYRMNHNM    LSOOBHHE       
MYVVOKXQISMSOYG : GQAWYSVD        PGJVAOKDFKV     ATMILEDWBBWM    APCTLNNMG      
PPQYVQNOBHDJCR  : KOPTTUPXKTJM    CMPLOW          UNJMRBFCKIR     JUSNTYEOMEUJA   JXPUKYTBM      
RQRPH           : YQTPDVBIQ       POERFC          ARVXHXWVD       CIYRRH          VCUBC          
PXLIMGAMMI      : DFKCT           MUMNMPQTUDW     YGCBN          
FBEBSTRVBXFDP   : KUVURBIWJVNOQNQ NCHTAJ          KAPICY          PBYTBXND       
WITNPWD         : NCHTAJ          TQWGGHBWUQOE    UQMDVHXJUFOAC   DLTXSXFPU       FRBCYACDRJAOW   QGKWYGQRQ      
KODTOPGYVLAA    : AHTUPPUEJ       AMNVYIDF        LEDGBTDX       
STJOWHWBY       : MENOQRFF        WOELFGOQNQFB    RHEKLESGBJDURJ  CIVMHDPCMMYAVDM
AHUNYST         : TYOUC           BVVOBNMTAYOM    PIMBNYIESX     
FIRYYJI         : QOGXNNLEMOLUGAH VEOAHXGNRHQV    UKPKRDDJPQ      FSXUYPFV        JCTY           
IVXILTFWKCG     : JEDMSDBGY       APXCNKRAP       ITVICFSMXBXMDCV FSXUYPFV        JBGIABQDREB    
FFKGMGV         : ATQOSKNDTY      UPFGRGQ         IUGNGE          LAOMENNIS      
BPAGAUIBGQBO    : KJTMI           EAIDGR          TJBIKDJJGU      YSFRIKTH       
CAAVFWGJDQP     : TSJIDXQP        BNKKREHA       
DXWJTKKMNT      : YAEK            ONHCOMXWHPJUGP  WIKLTLMVHVHWAI  QLFSG          
ICSQUTGH        : SXHRLOS         RCKQJALLDXHA    CJGCLHMBQB      BLSKIOE        
GKTNHDWNV       : ONCSGFQAXJQUAPT BAFUYGBWSA     
XYOXJLIVAVROGTJ : JPGIGVFDRCMFU   FXOSPUDQMCIJ    RJILQFGNYDSVSXC YLLAG           NULNEFJL       
QEEYC           : SCARSTAHIXMU    RPJOPQW         NQWNSYEAGAL     EUTQ            XHERLXHUBKY    
JWCSCYIXQHW     : KVCUW           RNKCUQQDAYY     XKDWC           ONQGEOWD       
HGSPFSOWIUT     : MAYFDJIQDO     
UKXBLDNUCRQER   : VUHGBDMTKL      GUOSGRUJVYOLO   IQLQJHXR        NQEBXUSBWBEVUAX
CKIYRPILIPEW    : NVXFYLPY        RDSCPNSSCJKNMQC QLFSG          
OTIJPVJ         : EEFNNA          QJIOKLVIGLAQD   DLKNKNJJOJW    
HOJFQBVWU       : QULIJVMX        WPEBMG          RFQOUOCAOYYJUO 
YFGBAXLLIBRFPJC : QJIOKLVIGLAQD   PQVHNMAQVXFF    REFSFJJI       
UTWG            : NGIR            WCCTI           LKULGYFERFB     ONCSGFQAXJQUAPT EEOXFWFWECE     RJILQFGNYDSVSXC UMKKEYRTS       SSKKTOGJPEXA   
UTWG            : NWOID          
GVXLMAJ         : MOEGLYY         OOIMUKQNFYNL    UYJRLKHVSEW     LXMNUECUHDGHR   MQKOXCE         MNYMLPT         WHKJMUSRLHSVY  
UJLDROD         : HHJO            PYDEBMK         TWPDTCY         BXSLCUAQUYMCHKH
AQYD            : RQPGJMPH        WUUU            AMNVYIDF        UPIGGIEYQYQ     BLSKIOE         UIFFY          
GTTKUO          : VJNB            OBMKVRN         WEFSJNBKVIAS    OWFTSKROY       HDBQNY         
TVTAR           : MWIBDRWWHJBQ    CNLYDEPEVIWYXYF YSMJXYH         SJEGNJBWIBJMOAR
OGTXSP          : LLXP            VCKNEUYIAAUDYTH OXDHFPBFPT     
HSBV            : QVCM            WOWENKGAYE      CALGQGPIHC      OBBAGIHKSG      LTEVDICBX      
TYOUC           : WOAXHURE        AHUNYST         WWCDJA          GSVUHGQMVM     
DVTO            : DNCDHWPHMQKTS   TQYYMU         
IUOGQPA         : UGAVCPUSUKKUBNT SXFOYHSV        PTBLTJLESWRJ   
EJFEEUO         : VPJWJDFUMLB     XWIMLRDLSAP    
PRINLH          : UEQODVFTSWTG    HFWOHMWGNJ      UTAOEKPBKPVK    AUMBJHEJMSJFFP  UJXEKXECQPWD   
GLCK            : MPOETDVCYEWFUJ  EGVHSXLTQV     
VBDGV           : LSAWLR          JSVGDDQNXAEAHLF PVOXBWQQQTSA    RBYUMOSLABIX   
PPIPBOYIUGGJRV  : NWYHTJQDV       UGAVCPUSUKKUBNT CRVSA           PWJFRHKETBIDHX 
CMPLOW          : THQBBIXIL       CKDC            PPQYVQNOBHDJCR  WTQKSGJVICD     XAOKLRUFTU      XAWWNFWOQGDI   
QJIOKLVIGLAQD   : VACFFACLVC      NQWNSYEAGAL     OTIJPVJ         YFGBAXLLIBRFPJC MMDHCKIFVIB    
FFMBLSMD        : PPNELVLNE       DURSXRANYW      MONPDODMW      
QIDHTSGRLPABCO  : JEDMSDBGY       FCDNO           JTIFMWJAMRPL    IFNQXLLQRR      CVOLABYT        IQOKTXSCQLUC    NWOID          
MUMNMPQTUDW     : AYEIPCJCOK      PXLIMGAMMI      QVUPBT          MERQOFWJN       AFAHOKTBF      
VKMNDWQKQJSLXKL : HOARETGGLLEN    LTUQS           HYTVL           URVB            TGQQYGENNDIO    QXAIPWNYBNBPVHH CATUSG         
MCAA            : CXMAPDR         FLSKJKVE        RHVJSRQHO      
MPMC            : WTHSYUNXACIJ    COGNPAXAMF     
GAKE            : XDUBTKPQH       RJSFBMXQKGFO    JMBNXT          SREUIDVS       
GQWVTTNHNYAYWLM : IEVQGKOTXKHFP   RMPSVFOCORXMGOL XTNIO           VFFWBBQBHAVDFN 
APXCNKRAP       : IVXILTFWKCG     RJFIGWD         BXPELMNUKFG     TKNTTOFBDUCKYMF SRDVVNB        
IPLMXTDXQARGHF  : UFHCCPX        
JEFWTFAJEC      : UJDFSRCIAY      TCAVPCSXWMQ     RRBGAPRLTVMXL   MYSN           
QWBGXJVJYWDEUV  : FQEMYV          OGTDURC         OWFN           
OCNUKXBPWUUW    : APKQTBKCICBPJXI BMLHQ           EMBEA          
BAFUYGBWSA      : GKTNHDWNV       CPDOSYBHEVUKNBQ RESYOTBADM      NLHSQSNYXRIKMAJ
RYLVTIDIMQF     : NBFM            MVLV            VITVGEQKKIFG    AMNVYIDF        HMXFJFF         VWYWLDRGO       GSQKB          
QJMOGK          : HIXYWFPQOFHNKI  NVYHPRMATX     
NNNUIMEMLW      : WRHEVXPBCO      WOELFGOQNQFB    NRKLMNJUUH     
TQLGOHQRRDJ     : NDUNBUPIOH      RKHAIAO         XAUXOTAGKTT     EXLBCXAPDXVS    HCLYCYSIMJ     
BCJPQRCDFQQBY   : EKRGGPRVXOJG    HWPEYSHO        PGUFM          
FLREAMWNULUNEP  : KQUBDORWPIIVCK  OJXS            XQDPRIFRYHGUPD  TPDRSFESITGBA   SSQCU          
PPVRB           : NWYHTJQDV       BXPELMNUKFG     PHXGUPUJAQQGHM  KKDOAHPYUMYQB   YKWEYFOSLAF     OLSJ           
LSOOBHHE        : LTUQS           LHOFC           NSJRMIUL        EBFTHBENUITXNXA
PLUIPXWMLTAJHG  : IDCJDNNYRCF     GIQILTELSPUFS   AITFUFLPRNLGNS  CWHRWARR        XJBRXHEMMKJVFJ  NNMVPY         
CVQYQTLCMCS     : BCAKWHVBKIP     RUCCENAXQCF     OTIHMRMWX       YSMJXYH        
KATTSFQBWOAJD   : MONPDODMW       JCWYIHAPLLEUYOE IRUS            GVIOXOQIULPIWY 
MMDSNFPGG       : EVEJISDYXYBWHIH RYOXVTPOK      
ARMOWFFJHYFAFX  : MKXUWYDPOAYK    PXUJVFS         CBTXLEROBEK     LLLPSTCYAQING   JCTY            HCLYCYSIMJ     
CPDOSYBHEVUKNBQ : BAFUYGBWSA      UQPKOHY         PQEHJKE        
DLIRKPWVXYBA    : XMYIKXGSPWHV    WOAXHURE        RYEJDHHKWPOI    JVHVCDF         OKOOPPNPAE      JSHYFFRFHJKJF  
BEIQJYLLCS      : NLASHVNU        VPHSNY          MAPJGTBY        NHSDRDMUPKVYUH  NQEBXUSBWBEVUAX SJQKWYD         FAEJW          
YPCMSVLVHVOTM   : DEGLXUHXVCJ     PRXDAYKERQHTPS  JERFYR          KJOBBBHPFATEWD 
PMMSMSTSCNFDYQ  : UQGUREITO       VKODGXENLYVFY  
SIJKLVEHJCQGQKS : RGKOVG          ABXSVMSLRQMEIR  IVFNMWLCA      
CHTUVNQRREWU    : GWVNYHQGM       YYHJIFKXRMTOOA  KOJRTFHGA      
PFBXOLJNRQWU    : EDAMXQFEAAT     GALNYV          PGTXQEHXDP      JPASDYMHAQYTMHU
DLTXSXFPU       : QFAFILIAMAJW    WITNPWD         TSJIDXQP        HPTPWANLWSMMXH 
DMTUSSRYIXA     : IXOVSEBBXJS     EAQRFRAGLCB     OTYONOAN        ALAWMJLXUTNB   
OOSCGLABVD      : HHMERURHCOGV    HIWNOPNBD       VROPJ          
RCKQJALLDXHA    : ICSQUTGH        NCKTTPSN        HWCSIFGPUB      DXSGEHHSV      
ASUKSX          : FBFUBHW         PRXDAYKERQHTPS  DSNRAPGOP       BDPIUWCHIDHL   
HMMKSXKWVPOOTY  : VWFICCUL        KMYQCIUTLGLTCWQ JINVFWG        
EAQRFRAGLCB     : SVPOONRIWUBWJAP DURSXRANYW      DMTUSSRYIXA    
PTGJBSVNOVAN    : QCHMBOQDHJJY   
QCHMBOQDHJJY    : PTGJBSVNOVAN    LDFHNARLUYTV    IUBISPSUBPWX    GRFASCMSPHKWA   IDCTK          
RMPSVFOCORXMGOL : GQWVTTNHNYAYWLM BFJMCROHQQLPN   PFUYWOK        
CEBENOH         : QOTIRGNBAYKI    MAPJGTBY        AEPFPJLVSMETII 
HLLQWLEQAULXAA  : NKCJONCBTLUAWU  IXXBCH          MRDGPJGXGEFSKL  IGNTXQMBKCN     BDJGFQRQLKCKTFC
RRBGAPRLTVMXL   : SNJA            JEFWTFAJEC      HIWNOPNBD       VUMMWDIFUOR     JFRSKDAXPI     
HPLSCCRPJIPET   : XGGTDJKPUPKOC   MHFSEXVKYRJKJCD
GVRAQUHSKYEGXTE : BXQVRXGKUDTXY   WEFSJNBKVIAS    JUHMXJCRFRNEPBB CPNDQH         
WNCIHENBVWMLDGC : GTVREGBWGEONFL  MUNIW           WBBGDMSQTOQXSLL YYHJIFKXRMTOOA 
FVMVQVODUVJSPP  : MYXUH          
OEHXNNNOJ       : WGGAARNMHMWWOWF KFBLAWOKEPNV    BRGAWRQJXB      XKNYHGVGDQYJOE  NUXUPLSRJX     
BWRKA           : SRAVI           VLFVEEJJFOYXN   FLQM           
PVRNPPESLADG    : LOYBOPXGFNFXIN  SEIRTWBNATVBSP  YNWJAHT         LGOV           
UNHYUHMK        : GHPHWPFTKXAX    LIMHBI         
CTJFTDPVIHTDWJS : KJMDQMMBWIUNHXC MTOTFWVFUL      XBMPDMF         SJBXKYGYVPOL    GPVP            RHVJSRQHO       DEYRQNQQXSKSJ  
DGEIP           : MQWIVSNU        JVLYMSOPOWP     CVMEW           XDKJQCHFMOLLDI 
DDGDBPRLMVIX    : SODWHKPNLQGUDG  LOYT            DJQGLR          TQVAXMKYL       AYHX           
CBTXLEROBEK     : RWIXLICKBILDNW  ARMOWFFJHYFAFX  KARCH           QSDLSTCXYTALVL  OMLOMGOAYWCXL  
HQKRIJUMPAN     : ULTSWHSGP       YUFFDKS         EFYSYRQCCS      OLSJ           
UBTQJRUNURNIVI  : DLIFNV          BQFOJWHUJJDNEEV FYDOWLKLAYXJW   CUMMMRE        
YMKFVDRPMBMYSNO : RALWJGVRLURQY   SUVRJTIXXNEYKJ  NVPIQGOVM       EOUNL          
KRVBCPYRKQISMQ  : CRMQU           IQHT            LCOJLYDKCJ      JCNP            INVBGGCLAICGXV 
NFFUB           : JBNHRWSTEEGQA   EJSAW           RUJGBCKBL       WDLDK           DGICGQULTX     
MSVPFWKUNKF     : BBKMY           PQGOWFCEUFFNMII TTWEGDY         TJFFF           NRHIRTNDBQPDA  
GJJXIEIYMEND    : TAQF            BRPLVUETVCVSCMM
BIFW            : OTGNBYQK        AXDHSTI         YDPW            LPPLONDYG       TAHF            XAPSISJWQM     
QLGOCLNMHD      : LTORYQ          SCARSTAHIXMU    POXWMBKXEFX     PUTP            NBTJCDVP       
MIIVUHGYPFLVS   : WQVQ            UQKGT           KJUYGOXUWHEGNC  UHNP            JFRSKDAXPI      CMIILQYX       
XUBFTOVFUMHG    : RJKAGC          VOFDFDRTDCARB   HKYK            OXDAQHQXVXUIJ   ABBW           
WPDWDNFB        : NOGSWJT         TWWCNHETOOVHG   OHNDU          
MIJFPWDJNB      : IGPFS          
QICFGHCSRJUQYX  : ENWHFEEGQWSBG   PDCARVV         IQOKTXSCQLUC    RVSKHPJBVM     
EOUIYISJPIG     : DJQGLR          KGWFNOVD        DSMNIORSLTXYJO  SJQKWYD        
TWWCNHETOOVHG   : WPDWDNFB        VSBQYSYJWYIUPHU
FWJDMP          : XDUBTKPQH       BPCJPIVJUH      MSQO            CQCDAIGAPA      YLLBGOIUY       XQAJBUUCIV     
HXTRQDJCJ       : BMOVHP          SMBCUNKGR       RDKCHRJ         EIAFWFKBUOR     JSTKGVB         BKAAAPGUWIGEBR  XAWWNFWOQGDI    EHWUYG         
VICYWJFSXTOIAY  : OTIHMRMWX       EYITEX          MMKXVMGWCHKHW  
YISN            : TCLNJILU        LGOV           
NVYHPRMATX      : SLCLYJVRXHRY    PYRLRTYXWJ      QJMOGK          GSGWNVJTFJC    
SHJT            : VUHIMSHOW       KFENMYWLKNJB   
SYWTTNEVMTVWML  : MKXUWYDPOAYK    BJRANALV        LLXP            AORSX          
CJWLAOX         : CVVINJIQF       EVCUBV          NUXUPLSRJX     
LWHE            : JVBL            GVXRHOOCMYYLJF  ISIG            SWBTEC          QUCTQBXEYXMQ    FEPVOI          XWXJRWJQYAEDN   MNYMLPT        
QXKLWJHSW       : TPBWBQRYAPQBC   MRQGARTUJKRUQH  AJDRA          
PMFNJUYHYJGLLVL : HOFSUIUI        FYDWHMSJ        GSVUHGQMVM      MOUTPOJNYEWHWC  IVJNACTHUVLUBRR AAUKWSJIFUCJIU 
HIWNOPNBD       : CQYQYDYTC       OOSCGLABVD      RRBGAPRLTVMXL   DHYQI           LXCKXNQ        
KLGKYXWHLIEMSD  : YGINTAXQ        HTKEKURXMOFKTN  MPOETDVCYEWFUJ  ULTSWHSGP       PTVAGFFXNQKHPYS EVDAQAVESJQFYGV
YQJWDY          : KRCBYKIKQM      BJITXFUUTW      JERFYR         
NXTFNHGTURFD    : YHXNKCSYAXM     FRBCYACDRJAOW   CXMAPDR         YYFA            PFUYWOK        
GBBNML          : CPFXCWJRFBENU   YFPUMGWK        MSQO            QEXYSQJBTEARN  
BEXAGQJDTJM     : IXXBCH          UNODWDKJ       
HGNXQVRNPYSTF   : UDVLWNHFYULM   
WVIJPJP         : POIPWJGSY       OAWAUTW         PVCU            BXEFWYRAQOUDM   HFHDXVNG        GNSMBGM        
JVHVCDF         : KJUYGOXUWHEGNC  DLIRKPWVXYBA    GRNUXJRVFKKT   
LOYBOPXGFNFXIN  : ACXSWJNHPCWFP   NJWAXVCDB       PVRNPPESLADG    XTNIO          
HLCQBOJTX       : SVTTT           CKDC            NQNFCGMDL      
DTJG            : RHWKHLHDFONL    ALAWMJLXUTNB   
CUQCVFRVOAMV    : GPUVX           MLRVSY          DNIPJRB         JNOVMOWYGUGT    RLGNT          
ULUCWWVB        : TGVAWKTLEAIDHF  UQGUREITO      
FUMMAGYGKBBDD   : IURHLVLYELGKGUN ACKOQEI         QABNBVPTVNHYRF  SXFOYHSV        BNKKREHA       
KXXYAKX         : QSKXIOXSQF      VMNONWH         GGRIYHGRTNP     WGSFPCFHFB     
HJUMHU          : NDUNBUPIOH      IHPWRXJXL       YYFA            NUFALRDKBDJPB  
IGPFS           : TSJSXLWUTEI     MIJFPWDJNB      MWDJOJEKJMS     QSWCRSGT        EPBCA          
FCDNO           : WQJSRNNA        FWGYRN          LSAWLR          QIDHTSGRLPABCO 
RRMRCMREMDCNML  : MVKUP          
YUFJ            : LSLIKY          CCRHLCCQSIJGK   RNLEIXRKEWC     APCTLNNMG       ENDO            FORU            IOUGVKCVHTHCN  
MBKHGPLLGASXRGR : WVGAYAEWI       XDUBTKPQH       PTVJDTTL        QPTTCCDI        YOBVJLK         RLGNT           TUITWYI         YQDNP          
UJBI            : WQBPHK          VKHFORBN        BSMUUY          WKFIIW         
DXCOI           : ISWGBAJ         MTOTFWVFUL      ESSFYTBKXBWYI   VCUBC          
MONPDODMW       : LVFCYKBJWQLXCXP FFMBLSMD        KATTSFQBWOAJD   LOVGJXSGPHPDJQT TNBKODMWOSTOXY  VWYWLDRGO       RFQOUOCAOYYJUO 
BJYBCYVKQSG     : ACKOQEI         AEEYONWPVLPQJAU EAKJJVDNKGHJXO  QSAQSCIYWHH     PMRBDNN         AOWRPBN         JVTW           
VQRYOTPYACPNUU  : NMGUBX          XMIHHXATHE      WJQXXBB         GULINFLRMJWHHLD SUVRJTIXXNEYKJ  BIMTPXDIA      
XICSLNUMPTKD    : EDXVUFWJHI     
FLOBCICSFSRF    : PDELDW          XNMKGUIHEXMJWYW JWTEVJCRFTI    
KURFBRPFLBSI    : OTBDXHSYM       MMKDB           KIXDNQ         
LCBOPJAGMEPPWUK : LOYT            BMDSBTJRQVFWY  
AHDWCJXVYEJ     : DQNJD           UNODWDKJ        GDOPEBLC       
WRRIUUYK        : QIYEHDIVLKSQ    JBNHRWSTEEGQA   YEXFDUK         HCLQEHNSOHQ     IQOKTXSCQLUC   
BTRHJJEGTXIDBF  : GNOBGCAFVJB     MLCDUIXWMCNN    JXPUKYTBM       JPDIELYIGAJ    
MFEMJNPJGHTD    : HMLREGF         KNGPTHGAGTO     RLGHGWO         GVIOXOQIULPIWY 
VPJWJDFUMLB     : LNMYYLPNDYKSQTN LVDAQRRWITBS    EJFEEUO         MHFSEXVKYRJKJCD GWIYUJLW        BIMTPXDIA      
LLLPSTCYAQING   : QYFBVKUVJNINK   ARMOWFFJHYFAFX  SDWFOWFUF       UMWGBWIW        PHMDGESESUQEYGH IGBPR          
VPOYU           : PXUJVFS         IXYGN           RQPOGCH         XTNIO           TRPQVCOYP      
RGJBLOWXDAG     : QJEG            NGSCT           MPWRIPVMNFAXHP  CMMYRDCUYWQ     MYDG            LAWSSDNYY      
ORGHNJGNAPE     : ABXSVMSLRQMEIR  ULTSWHSGP       CJGCLHMBQB     
JCYAE           : LOLQU           ERJLIKICKE      XDKJQCHFMOLLDI 
KVCUW           : JWCSCYIXQHW     LEYNEV          SOWJRXTVHSNNE   WTHLFKQS       
LVNOYVGNQMUEXC  : EYQEKCHLVMRIIF  BQYCIJGIG       DXOWHEJYVN     
BTBKFDLIH       : GMYBYLXACSMVII  QXFVWTHNFYJB    EKFYYWOOLJMEIJE ETVGKR          LGXS            XAUXOTAGKTT     UWBBMSJGWBY    
SFMPFDED        : LFIXMFLHNIWHRQ  PJCUAEVPFRIBP  
UCPDRGSNMQR     : YELFTDPNYCL     XPEOM           RPIAXJBOEXSPH  
RNKCUQQDAYY     : CWMOTFQFUCQO    MEIIGIM         JWCSCYIXQHW     GRIXF           TDJVWFYWB       BRXXA          
LOLQU           : DWPYOQVGNMRJLQI VKXPOC          JCYAE           RVMVVVLWJJU     JWTEVJCRFTI    
KQTCTLKMBWGSHA  : FFXPEO          EDELI           XHWYJ           MAYFDJIQDO     
TFEKVHL         : TCAVPCSXWMQ     HPKNGJGJSW      RXHQJLRT        JPIYENI         OJIWNMDWCH     
GRIXF           : YGINTAXQ        RNKCUQQDAYY     NNNPPNLTVJGYY  
SVML            : GQBC            UQGUREITO       AKDWVM         
OICYWF          : HYSANHBHPEKNU   SKSXDQJPSP      HGDJHP          EEAMKDCN        HPCFTSPDQFXBCMN
DYHEHCL         : LVDAQRRWITBS    GVXRHOOCMYYLJF  EOUBDHOHLEYHWX  WGSFPCFHFB      DTEHBXFTIOMU   
MHTXCCR         : JQVTUXEXNT      QQVP            JCHM            QWLSWBQ         AULDA          
AYMVVBHLRRPSPVR : YOTCGQXOSWR     JCOSILIIEYOYMK  BYMFOCG         OFCJDLX         JWTEVJCRFTI    
WBBGDMSQTOQXSLL : WNCIHENBVWMLDGC ARVXHXWVD      
KAPICY          : FBEBSTRVBXFDP   YOBVJLK         EWRKRQSTSNWR   
VROPJ           : LNNNPJGOPQ      YKXMW           OOSCGLABVD      UQCTO           YEXFDUK        
JEJKIQOULHRCAPU : WGGAARNMHMWWOWF AORSX           YKWEYFOSLAF    
BQYCIJGIG       : CKDC            IQLW            LVNOYVGNQMUEXC  STPRWKJAEDIKX  
CVTLIDRUOAN     : JMOHHMILWFIB   
XBMPDMF         : HSAAPFBWDX      UQMDVHXJUFOAC   CTJFTDPVIHTDWJS
BJRANALV        : YWXO            SYWTTNEVMTVWML  TSLBBBHRFDUBIU 
SAMQ            : CDVQYGMX        HXGFBFRWP      
ABXSVMSLRQMEIR  : BCSFRFMUES      OIKEWBAAXFQPVHD OOIMUKQNFYNL    SIJKLVEHJCQGQKS ORGHNJGNAPE     TVRXXKNYUPK     OSIAW          
QSSCMUPOGNAB    : LJWCUS          ENHM            SNQGSXK         GAKOIQ         
ORIPVJITVDGQUSU : VMLYBOVBJQBVNXQ FRBCYACDRJAOW   LAJWQAPRB      
LOVGJXSGPHPDJQT : VAOEPUEOTOI     MONPDODMW       SGRCKAYGKO      YSRPMHIMYMEEX   VIHY           
LCOJLYDKCJ      : KRVBCPYRKQISMQ  GLXYXJBSAD      MFYMMAWFLPQV    CJBACO          OOJT            NNMVPY         
YDXFQPDWBCPKTYA : TUHPEE          FMLDWKHLUPV     GVBAHCVLCPCC    AFAHOKTBF       TDYSTGEVLOOM   
JSTKGVB         : BMCAMCVU        YHHJMFC         CQYQODM         HXTRQDJCJ       EXLBCXAPDXVS    YSRPMHIMYMEEX  
KATW            : HFJGC           NKCLE           NMGUBX          RJVYCIKQBGL     CXMAPDR         DLFQXRK        
DAEIAJY         : DURSXRANYW      UYHCKOKHHAKUYH  YGUPDTVADPS     YYHKCHVQJAWRI  
MVTQNENNG       : KRHVWJ         
YYHJIFKXRMTOOA  : JTJODHMQOOLQE   CHTUVNQRREWU    WNCIHENBVWMLDGC MORHEUF        
UIRE            : BRDQE           MORHEUF        
JTIFMWJAMRPL    : CNXQSKRLP       QIDHTSGRLPABCO  JLDJHHBW        FBFAELADJLUJV  
WWCDJA          : AVCMSDYSLNFBK   TYOUC           FSLXIVSDSSDCXH  SJBXKYGYVPOL   
VUMMWDIFUOR     : RRBGAPRLTVMXL   TRVXAOGWYM      KCRXFMKAHL      EFHXDM          QBFCME         
KBMAA           : VSCPCEBT        KPAQJRPKORIUXU  PAMTGWSKRW      IMTLGLNMQDVGUVG
AMOSAIPYKUKN    : OBMKVRN         MPCHBTEMVN      TDJVWFYWB       EWXXEFGUFJC     XDKJQCHFMOLLDI 
GKFUHIFOGWHNHK  : MYDG            NBTJCDVP       
HKYK            : DNNSDCE         XUBFTOVFUMHG    IVFNMWLCA       MSQO           
QDBBUAMQKCLSOQ  : HMXFJFF         AULDA           CFLLUPLW        CATUSG         
XBVMJSVWC       : JRVPCYW         TVNGCAAIGPAEN   LHBGQLK         QWCYJDGQ       
AMSY            : BBKMY           HBUWSTXYO       BXEFWYRAQOUDM   FLJNYWNV       
RPCSRYUGRFK     : XAEUMJGT        PQVHNMAQVXFF    JBNHRWSTEEGQA   JMOHHMILWFIB   
AYVQWAM         : YJQFOGTQPGGUMQ  MKMOPA          XKGVWMXDYNFOBA  SEIRTWBNATVBSP  XKPU            JCWYIHAPLLEUYOE
JHIJLOJXIIWCY   : KKBMW           HJVTUVNPMKM     USTIHJEXIQY     PSUHPXVGOTNBBBK
VSBQYSYJWYIUPHU : TWWCNHETOOVHG   IIUIHCO         UMWGBWIW        CMIILQYX        YSFRIKTH        QKVHMENFFPS    
SFNBO           : GMYBYLXACSMVII  WMLFXPEOQ       LTEVDICBX       KXKUBTESEJWJ    NUXUPLSRJX      URXLTDQAC      
SAXDIV          : WDBPUAGHQWXHKPH HKDTTRXBQQ      MQKOXCE         KMASAQFBIW      DVMPEQUMGK     
JWDCXWDRVOQWY   : SJVYMWUY        BRDQE           HHUFJJWONI     
PGJVAOKDFKV     : CBWQIJNVWFH     MTRYMIJJIEVDUF  JRVPCYW         MYVVOKXQISMSOYG RLXNFVTFXDFRORU
KYPGHCGKEEJKXHY : OFUBKMAH        FNNOSUCBLOF     BDDRJHGEOBVOMV  HSPRAAHTEDPSFFI BNKKREHA       
FYDWHMSJ        : OKREIHCOHWDXM   ACXSWJNHPCWFP   APSCPKNNOUGJ    FWNAMMXKKFE     PMFNJUYHYJGLLVL GPVP           
DNIPJRB         : AYEIPCJCOK      GVXRHOOCMYYLJF  JPHNBPKYDLGVRV  MENOQRFF        CUQCVFRVOAMV    FUPXSQFTLV      FIEDSPYTBTPNOX  RQSHCE         
DNIPJRB         : DBMLKKOMSTIGXX  JPDIELYIGAJ     TRPSIA         
HJSJPFQWRDU     : YJQFOGTQPGGUMQ  FGJWULS        
CMGDPDNCW       : LTORYQ          LGOCFAGTUAJEFSU GVIOXOQIULPIWY 
FCKP            : VPLNGPP         EGYU            GSGWNVJTFJC     RJEMTYQQ        WFWAENYNFTIETBG
WHVIQH          : SXHRLOS         CHFOLIUAXFTF    BIRBAUGBKVQQ    VPPKCRDAPKH     DLFQXRK         BGNXUSCNKTVDQE 
DAKTWCY         : TLHVLCOCJDJOEYS WPRJUIQY        DYHMCFLTQU     
CBGIHVMUXLTFNF  : CALGQGPIHC      UIBYCOQUWCHSPI 
GCEEMV          : OYDHPHTH        DWIGQQHUR       WEFSJNBKVIAS    AKDWTTUF        XQNWBOM        
PYMCUL          : AORSX           NNNPPNLTVJGYY  
TFJWMRGIGDJRX   : ODJLHNXMOXJGOWP ABLNXFTIG      
IDMOHSVVOILPWP  : STPRWKJAEDIKX   FSREMXTV       
IUGNGE          : FFKGMGV         NYDKVLGVFECXPO  AKDWTTUF        XIEYM          
BMLHQ           : DQNJD           OCNUKXBPWUUW    QSWCRSGT        UDSO            KDCYUPN         CCFME          
COLKTABBTYWKJK  : IURHLVLYELGKGUN PYSJ            NCKTTPSN        EDHAQWYSUBMU   
GCNQX           : EEFNNA          AVCMSDYSLNFBK   FOXKCSDWLQGEU   OCLCI           NNMVPY         
HGDJHP          : MVIVBQRNEKGDWO  OICYWF          GALNYV          BSMUUY          PGUFM          
RGRV            : YJQFOGTQPGGUMQ  HFWOHMWGNJ      PCOU            BDLSINKSUBDCE   DXOWHEJYVN     
GIQILTELSPUFS   : EDAMXQFEAAT     JYTPAGUMDUER    PLUIPXWMLTAJHG  OSPSUXJ        
IIUIHCO         : PPNELVLNE       JPSVJJE         VSBQYSYJWYIUPHU OVNYS           LELHTHQGBQVAK  
MWDJOJEKJMS     : EKBF            IGPFS           YUFFDKS        
UEUCR           : RHWKHLHDFONL   
TNVOREYOMH      : LKULGYFERFB     FIET            FEAJMVKMEW     
BRGAWRQJXB      : RVCHAEEOOEAEGJ  CRVSA           OEHXNNNOJ       NXTERPMIBAG    
KVSIDPKUIEK     : KMASAQFBIW      JCHM           
SEIRTWBNATVBSP  : HYARSDBSWYK     EDFOHPXT        PVRNPPESLADG    AYVQWAM         ATFJEDVJJFX     VACSPJOFHEJ     DEYRQNQQXSKSJ  
COVUYTQHYITUQ   : MVLV            GNRVAOXGIKRBPT  CXUUPMXVUT      YRGGMVYRWXMR    XWIMLRDLSAP    
HUSMFN          : FIASFW          OWREOOISISGOJ   CKVDNFAQYIVFBSJ
COVDKTGEJ       : TUTOMJQHOMSODC  HWVIMEWEJTIGK   SHQAEEFYJKH     JINVFWG        
GXVEAQUHPD      : AAVRKAL         HWPEYSHO        CIYRRH          EBFTHBENUITXNXA
MUEURAJXN       : WQVQ            YAEK            SHOLFFFCKYWQSS  OWFN            MBQHVVUSLEGEGNI ITLSMDLGNQKY   
AEPFPJLVSMETII  : CEBENOH         JSHYFFRFHJKJF  
BDDRJHGEOBVOMV  : OMYTW           PYDEBMK         UUCSQIGUCNXO    KYPGHCGKEEJKXHY
EYITEX          : VICYWJFSXTOIAY  MBWSWYUUQFUE    UNBVRVAMYKAEX  
SVBFBUP         : SMVXASLPWH      BPRBRHWUXJGKHK  MLRVSY          ORCJXOHYQSPM    DVANYAPNSNKUU  
ORPTJYERDSTB    : IRUS            VCKGKCSWPQF    
GALNYV          : EOYAGQSEMJURA   PFBXOLJNRQWU    HGDJHP          OYSPKXFCVJ     
FUPXSQFTLV      : KWHPBIBERAUGX   DNIPJRB         JRCHXBNWFRD     PHMDGESESUQEYGH
CNTVYUCQAUMBEVD : SYYUDHOGP       SXFOYHSV        DPWOTYO         YYHKCHVQJAWRI   VGSICMFR        ABLNXFTIG      
JCOSILIIEYOYMK  : AYMVVBHLRRPSPVR NXTERPMIBAG     UWBBMSJGWBY    
QABNBVPTVNHYRF  : GVXRHOOCMYYLJF  FUMMAGYGKBBDD   QXILFSTUMS      TRPSIA         
KQHYJPKUBOV     : ITSHAIQBVGVKR   GBEPQARHVKU     SKBB           
PJCUAEVPFRIBP   : HHJO            LVUNGPDAUOKYJM  WVGCEQSFAGRSE   SFMPFDED        RVSKHPJBVM     
IPPPSCGABQSNNV  : KUVURBIWJVNOQNQ MIWSMQKLMLIECYC THKSCSTA        UEMFDN          UHDJOJUACB     
JNUUPS          : MUNIW           PCOU            DYKLGOEDMWXGC   NDHCAIIFJOYIAGV WFMVCGJ        
VOPDJXEBVPQ     : EFHXDM          OXDAQHQXVXUIJ   PVOXBWQQQTSA    LJBC            LLXP            IMEQEAIBAV     
FLQM            : DNNSDCE         FMLDWKHLUPV     BWRKA           RDGSSKEIAYSFIB 
UFJISFNESLCKEA  : KCDKOQ          EYAWNOK         MPYGHGD         CWHRWARR        KJRNLG         
UPLGQPIOHYFNN   : DKXTENFGJBTNPTI SBIM            ONCSGFQAXJQUAPT UBXBTEYR        LQCHTCBPKHO     YSFRIKTH       
CCRHLCCQSIJGK   : FCHISKMAJEHVUUP YUFJ            JKMSSMFWKHMY    EOUBDHOHLEYHWX  UQMLGWEVYK     
KMEHDP          : TUTOMJQHOMSODC  KLPSGTWEP       EJVEKM         
VHYMPASDNPHP    : UJDFSRCIAY      QWCONUOFVMF     QDGCFAULHHE     KIXDNQ         
OBNSTIBFO       : PMHANPGXFRRX    FXBLLGI         EKVUR           JOBKUDXEUFQ     GVIOXOQIULPIWY 
BBBFJGUACFBRU   : HIGVFTK         RVSKHPJBVM     
KARCH           : JRTMC           RYEJDHHKWPOI    CBTXLEROBEK     WBAGPY          HWPEYSHO       
NXLBQH          : OKOOPPNPAE      RBMWTSRR        UBXBTEYR        HFHDXVNG       
TNBKODMWOSTOXY  : DNNSDCE         PYDEBMK         MONPDODMW       KCRXFMKAHL      JNOVMOWYGUGT    PQTOUR         
RTSCTKEB        : JFYFVKUMYIV     PLOYXSSOCJHQYWQ MXAUENVMTVYD    XUBA           
TYIWRPJODLYS    : OSRPSXTOPCOOQVC JPSVJJE         QBFCME          WHKJMUSRLHSVY   DXSGEHHSV      
NRFJLTJLLBFGDCR : LGXS            OFCJDLX        
DOFFW           : OMAUDTLMJOWHL   HHMERURHCOGV    DGLNKTGHCSKVM   DSMNIORSLTXYJO  MBQHVVUSLEGEGNI AJLBYRBWMJ     
YMMPSARNQFFVQ   : UIVORQHQVEPJUP  VLFVEEJJFOYXN  
RACFDKLG        : PXUJVFS         UQMLGWEVYK      DTSTQ          
FRRTWYSCBIQQB   : TGEBHK          XPOVEYXORQGF    GVKG            GPBBS          
IOJQVHHMYK      : TGEBHK          ERAHE           UEXIK           YOTCGQXOSWR     BATPIU         
GNCRW           : OSRPSXTOPCOOQVC UDUNYJWHHUN     QGTBFNJNHRMPX   FLJNYWNV       
XOITOIPSJ       : KVOIDV          QRHBFT          XBJHVQUYCLW     CKRK           
JABCLPNCNULA    : JDVQWNL         HYCY            HWWKWQGROAQHB   NKVUHBYYHEAAFT  BKFQNYK         ACXXBSFGQD      IHNNJGURTI     
VTCKVVHMTXX     : XBJHVQUYCLW     XTKXD           IDCTK           NASHGVND       
OGGHRG          : VLGB            PQGOWFCEUFFNMII WRAHE          
THUFYKJMFXODTJF : QEVPQOS         BDLSINKSUBDCE   ETVWHYXIGRNLM   OHNDU          
HCPWXQUQFB      : WXXUIOGQFLFJY   QFAFILIAMAJW    CKDC            DTVXDUJHBWCEAL  JPGIGVFDRCMFU  
PUDKOMIWL       : KMUOJXFAEDOTTE  KRHVWJ         
IXYGN           : TGVAWKTLEAIDHF  KJUYGOXUWHEGNC  VPOYU           GJYSQTOLG      
DYKLGOEDMWXGC   : UYJRLKHVSEW     JNUUPS          HDPKAWXXK       VXJBG          
FTVJF           : GMYBYLXACSMVII  EVCUBV         
XNMKGUIHEXMJWYW : WEKQKHTQXDHMEPR FLOBCICSFSRF    DGLNKTGHCSKVM  
NDHCAIIFJOYIAGV : MRLMPXGLG       JNUUPS          IRUS           
VIKFFTOL        : UOOPWWIWWRPSSHO NGSCT           SWNBQWVGAB     
BWRCUVRXF       : LTORYQ          WPEBMG          XHERLXHUBKY    
BNFGXVFGXOE     : AOJWWHLJFGUX    HWVIMEWEJTIGK   ASBEEA         
KOJRTFHGA       : CHTUVNQRREWU    EEAMKDCN        HFMU           
FTNARFBWACN     : FWERJOEOHT      IGEH            KSAIMOVBT      
KNGPTHGAGTO     : UVFNUVELIHDE    NQWNSYEAGAL     MFEMJNPJGHTD    BGNXUSCNKTVDQE 
LIASQC          : YJQFOGTQPGGUMQ  BXSLCUAQUYMCHKH JPHM           
WVRY            : UPKVKTC         ETCVKJDTTJO    
WCKAG           : SODWHKPNLQGUDG  POXWMBKXEFX     GQEBVXNXGXVRXB 
IQLQJHXR        : PWBDAA          UKXBLDNUCRQER   IPMG           
GLXYXJBSAD      : LCOJLYDKCJ      TDJVWFYWB       RVMVVVLWJJU    
YYOB            : MWIBDRWWHJBQ    XMIHHXATHE      SHQAEEFYJKH     EPBCA          
MFYMMAWFLPQV    : MPOLPITGHOC     BQFOJWHUJJDNEEV UDOKR           LCOJLYDKCJ      QPUCQDKWWYLPWHN DIRCOFOHU       CQLGMYRPUL      MMDHCKIFVIB    
JFUUEVUNWOPANR  : JSVGDDQNXAEAHLF ESSFYTBKXBWYI   UEQLWGKW        XDIAUGHBVVOF    ALAWMJLXUTNB   
DSNRAPGOP       : XMYIKXGSPWHV    BQFOJWHUJJDNEEV ASUKSX          SGRCKAYGKO      GQEBVXNXGXVRXB 
UDUNYJWHHUN     : WGGAARNMHMWWOWF GNCRW           BTMFW          
RDDISFWMH       : RQQMXPXGXULQ    NCHTAJ          EHKNTTWMQ       FTFKDQWMEG     
HWVIMEWEJTIGK   : KRXBISNVWIUYN   COVDKTGEJ       BNFGXVFGXOE     BBYXSJRLEMG     EHWUYG          RLGHGWO         JVTW            GAKVY          
SHQAEEFYJKH     : COVDKTGEJ       YYOB           
SGRCKAYGKO      : LOVGJXSGPHPDJQT DSNRAPGOP      
JSVGDDQNXAEAHLF : NQLVGBCUS       KLCKKWFY        VBDGV           JFUUEVUNWOPANR  LAWSSDNYY      
USPCLYUN        : AOPIIGLHQ       SFCFR           SJVYMWUY        AFAHOKTBF       NDGACXGHVHGM    XTKXD          
WOSJFFSBEBEJRR  : ISWGBAJ         LIIJLVT         JPSVJJE         JMSFPDAFYWGO    CKVDNFAQYIVFBSJ JPIYENI        
UYHCKOKHHAKUYH  : DAEIAJY         KXKUBTESEJWJ    OEQPCFYK        AYYJDCWX        XCAIPPMQGTGCG  
LGCEPHLKK       : CJGCLHMBQB     
MPYGHGD         : UFJISFNESLCKEA  UNBVRVAMYKAEX  
NHSDRDMUPKVYUH  : WOWENKGAYE      VAOEPUEOTOI     EKBF            YNMYLORTAERRSN  BEIQJYLLCS      NWMBBKENPVDPICN
YNWJAHT         : LSAFIDBLNRKMUQ  PVRNPPESLADG    DDCCMSEJUCC    
VLPFV           : SGOUYQNNTCVWCK  MQWIVSNU       
IEMQ            : SRAVI           PCOU            TJBIKDJJGU      NWMBBKENPVDPICN
RIDG            : KJFFRBJMNU      YDPW            CNLYDEPEVIWYXYF WGSFPCFHFB      FSREMXTV       
UQCTO           : HFJGC           VROPJ           HDPKAWXXK       PBLUEOIIXHPJT  
YNAXWAFTRC      : CNLYDEPEVIWYXYF
HJBI            : PWBDAA          NQPOTOG         KVXJE           OOMHUVHYLU      GSGWNVJTFJC    
GWKGOTLW        : HBUWSTXYO       PTVJDTTL        IHDSS           GUJUXMWF        GAKVY          
GQBC            : QWCONUOFVMF     SVML            LGXS            JBEXISTTCG      IMWP           
NDUNBUPIOH      : TQLGOHQRRDJ     HJUMHU          YJOY           
TRVXAOGWYM      : NKCJONCBTLUAWU  YPHYLAX         EPMJDVPHYFGKNKR VUMMWDIFUOR     AEBOK           CKRK            FHQXSPE        
UAKWIBAKIPPEDQ  : WMHCJSQPLPKVMWK VUFCJSIE        MMDHCKIFVIB    
UYND            : WQJSRNNA        THKSCSTA        MBQHVVUSLEGEGNI
JUIJUYPRBE      : EMFRIEAPFAH     KGWFNOVD        AOWRPBN        
XERWMVXYEPOIVHJ : BOTOQGQ         MLRVSY          UXXHCDK        
HYTVL           : VJNB            DWPYOQVGNMRJLQI VKMNDWQKQJSLXKL KREA           
GULINFLRMJWHHLD : NWYHTJQDV       VQRYOTPYACPNUU  OBUEIBJB        FSREMXTV        VIHY           
LJWCUS          : OAWAUTW         IQUFO           JBSAOWQCU       WXXMSKSGX       QSSCMUPOGNAB    FOXKCSDWLQGEU   FHQXSPE        
EKRGGPRVXOJG    : YYSCFCJLIKR     BCJPQRCDFQQBY   JSAYEKDOEMSDDR  PGUFM          
PRUCETJLFOUQY   : XDUBTKPQH       RQPGJMPH        CJBRMLJEICVEY  
TVNGCAAIGPAEN   : DKJDEBP         VRIYWMHNVWLPL   YAEK            RQPGJMPH        XBVMJSVWC       SEUVLQQB       
OWREOOISISGOJ   : IXXBCH          EODSGSWMR       HUSMFN          INVBGGCLAICGXV 
HKVDG           : EIFNCLIIAVIKKN  IQRWPWYLE      
JJLJRTBUY       : MDDSFJK         MSQO            NAEEFHSTREIGW  
MPOETDVCYEWFUJ  : MWSQWGMYOLDIV   GLCK            KLGKYXWHLIEMSD  VITVGEQKKIFG    RDGSSKEIAYSFIB  ICSQRPDBCR     
FTFKDQWMEG      : RDDISFWMH       BSMUUY          KNOOFVM         CQSWXXCITFCOQU 
XKDWC           : JWCSCYIXQHW    
MQWIVSNU        : DGEIP           VLPFV          
MBUVKCSRMV      : FMLDWKHLUPV     DHTQCSULAXRMKK  YYHKCHVQJAWRI  
JKMSSMFWKHMY    : UGOQYTE         CCRHLCCQSIJGK  
JKTEXREKSBJFD   : ONHCOMXWHPJUGP  GWFSWM          MKLWHNVUGLGGT  
WRAHE           : OGGHRG          JVCSNEANFNKMIO 
VWFICCUL        : SXHRLOS         HMMKSXKWVPOOTY  WMLFXPEOQ       PIMBNYIESX     
WJBHFGHWMRRNDYS : LNNNPJGOPQ      BYMFOCG         EDXVUFWJHI      RFIQRJWPV      
VKHFORBN        : UJBI            YYHKCHVQJAWRI   HWCSIFGPUB      RHVJSRQHO      
MPCHBTEMVN      : AMOSAIPYKUKN    QXAIPWNYBNBPVHH BLSKIOE        
EUTQ            : DHVAKKML        QEEYC          
OGSNYYMJGRBBVOB : NDUMDY          GWVNYHQGM       RDSCPNSSCJKNMQC NLHSQSNYXRIKMAJ EBQE           
HDPKAWXXK       : OMYTW           DYKLGOEDMWXGC   UQCTO           IHDSS           GRNUXJRVFKKT    HFMU           
CGQUT           : TLIPFGSMUYCMD   RHWKHLHDFONL    YXLADJH         KMASAQFBIW      MMDHCKIFVIB    
BOTCPILWAMA     : CCOYRSYINEUB    GVONOPDXWMK    
EDELI           : RHWKHLHDFONL    KQTCTLKMBWGSHA  YQDNP          
VITVGEQKKIFG    : THMQHBAG        RYLVTIDIMQF     MPOETDVCYEWFUJ  VTIPSGXYG      
IVLKLTYKU       : ICPCJOYWAYP     XGMGESFHGSOPJLY BFJMCROHQQLPN   QJEG            ESWBKIGGN      
MSRPADY         : UQSNBOSKKJOEG   GVBAHCVLCPCC    BDPIUWCHIDHL   
AHQVQUPBIX      : XRBLDAMETYBWAP  PBVOAVUL        SJQKWYD        
OPRMCDYVELSR    : DNNSDCE         GSVUHGQMVM      NRICWIGGXYQUW  
OKOOPPNPAE      : DLIRKPWVXYBA    NXLBQH          LNCYXS          ENHM            WSCI           
QBERJEBBTTNXW   : FURSVKHMV       WLIAO           MNYMLPT        
WDBPUAGHQWXHKPH : XXJLDBSEEKVMMLQ UFHCCPX         UDOKR           EXFQBAYAEY      SAXDIV         
EXSIPEMRHJN     : SMBCUNKGR       AXDHSTI        
HKKEPNWK        : KRCBYKIKQM      VEHAVDTTVQH     XXSBCUUHL      
DUFBSONIVDPTX   : SVTTT           SIKFPHGEJRHFY  
LENF            : TUQLGW          VUISR          
WSKGFWNULKIYP   : INDQHHPV        MVKUP          
GSVUHGQMVM      : COGNPAXAMF      WXXMSKSGX       TYOUC           PMFNJUYHYJGLLVL OPRMCDYVELSR   
WBQM            : TWBKV           QYEQX           SFVKGNMH        QYFBVKUVJNINK   ULJRXU          PDCARVV        
DLCNRJLFHYRPXKS : MAHMPCGJE       IIMHJDTDUQ      CBNPNESYAEP     PIMBNYIESX     
FQEMYV          : ACORNDOPOW      QWBGXJVJYWDEUV  VCKGKCSWPQF    
XKPU            : WEKQKHTQXDHMEPR ECTSQRPBNKALRB  AYVQWAM         TIMYQHTS       
HJWMUBD         : RJBSHXHVHVNWSTW FVGVTJCPXMXR    WIKLTLMVHVHWAI 
MOUTPOJNYEWHWC  : PMFNJUYHYJGLLVL WFMCCTXT       
WAXWM           : NKCJONCBTLUAWU  FURSVKHMV       FLSKJKVE        VEOAHXGNRHQV   
RBWDAKXDPMPEJM  : WCCTI           DKXTENFGJBTNPTI LQTPLVHAO      
YXLADJH         : OFUBKMAH        CGQUT           TQYYMU         
LEYNEV          : QOTIRGNBAYKI    KVCUW           DVITXGT        
TPDRSFESITGBA   : FLWUIGCSO       FLREAMWNULUNEP  IHDSS           WMLFXPEOQ       PYONMSTS       
NVSLHVQSFRG     : EIFNCLIIAVIKKN  LOYT            UBWI            JEPEJYGNPGOO    WXBRHQSR        URXLTDQAC      
STPRWKJAEDIKX   : LEEYEJFTOB      BQYCIJGIG       IDMOHSVVOILPWP  JVLYMSOPOWP     HCLQEHNSOHQ    
GGRIYHGRTNP     : SLKWXBTMUDBLKCN NVMDYM          KXXYAKX         XBNYUYARN       JJVANTTXEXAHA   MHABEMBHWTRS   
JVEPFAMXRJKB    : JRBHHQFWFRWVN   BPQBJSSWNWUNKOT
QGTBFNJNHRMPX   : VKXPOC          GNCRW          
JNWVYSBPBDEBUN  : XNNVSC          QXHHILC         EDXVUFWJHI     
XBEHXHOLQCUK    : BDLSINKSUBDCE   DFYRM           BDPIUWCHIDHL   
KIBVXXSXTVPWB   : RJVYCIKQBGL     NTVQGWHQDOGLQ   ULRFYQXWW       NRICWIGGXYQUW  
AVJNVKRDKYRX    : DNNSDCE         SUVRJTIXXNEYKJ  QJHKWGNIP       LXBIWHCO        OPVGM          
UTAOEKPBKPVK    : PRINLH          YEXFDUK        
TAKUTK          : EDAMXQFEAAT     LSAWLR          YDDIXYOUJDLFWG  SWBTEC          FKEJTQWDXBVKOP 
FXOSPUDQMCIJ    : FVDCMENOA       XYOXJLIVAVROGTJ DNLNYCSHSRKNQF  URVB            SSQCU           FXMFSRFGYH     
KXCU            : VYEARNXADMKPSH  UOOPWWIWWRPSSHO OBBAGIHKSG      OPMCRWCIHG     
FIEDSPYTBTPNOX  : WXKJNDF         ACORNDOPOW      EHKNTTWMQ       DNIPJRB         YGUPDTVADPS     KLVYPINTPJK     XTNIO           XCAIPPMQGTGCG  
GQEBVXNXGXVRXB  : TCMMBQYBWFI     WCKAG           DSNRAPGOP       SKBB            FSREMXTV        OPVGM          
MIWSMQKLMLIECYC : IPPPSCGABQSNNV  XAUXOTAGKTT     MLCPDLKAPUI     OLBAASHKN      
FSWGPUUPCUOT    : LEDGBTDX        ULRFYQXWW       MBQHVVUSLEGEGNI SSQCU           HPTPWANLWSMMXH 
RKHAIAO         : UGOQYTE         TYARX           YQTPDVBIQ       TQLGOHQRRDJ     GMNEMYUMOVN    
LDNY            : WCCTI           ILQDUY          GXIIKTS         NVPIQGOVM      
RBMWTSRR        : TAQF            NXLBQH          DMQRBNHFPMG     FHQXSPE         YXOKKPSBAQCS   
JMVAQS          : COGNPAXAMF      OOIMUKQNFYNL   
MMKXVMGWCHKHW   : BFUYGDSUYRDWQ   LXMNUECUHDGHR   OTSRY           VICYWJFSXTOIAY  OGOTCWQ        
UQPJNJ          : OCPEDQUFVIII    AYEIPCJCOK      XNNVSC          PCECLQAX        EFGHLFLNMAS    
GBEPQARHVKU     : QIYEHDIVLKSQ    KQHYJPKUBOV     NBFWD           VWYWLDRGO       EJVEKM         
USGIBFMIPTHCQXR : JNYLCQEAGSUQ    JUHMXJCRFRNEPBB
MDDSFJK         : MVLV            JJLJRTBUY       GRRQSXWTEJPQFPM WYMQSW         
LDFHNARLUYTV    : FFXPEO          QCHMBOQDHJJY   
IEWC            : LVFCYKBJWQLXCXP FBFAELADJLUJV  
BSMUUY          : UJBI            HGDJHP          FTFKDQWMEG      OOJT           
ATFJEDVJJFX     : VPHSNY          NIADJFWGV       JIHF            SEIRTWBNATVBSP  JRNPPLTFKQFM   
XLHYFDF         : QGHTBASSGTFJF   OMAUDTLMJOWHL   UGYY            FPBF            HVXIYJ         
KCRXFMKAHL      : VUMMWDIFUOR     TNBKODMWOSTOXY  CKVDNFAQYIVFBSJ
IFGRMMP         : HHJO            TQOGPDOQIERPG   JUHMXJCRFRNEPBB
VVXHVJOUOU      : LBLQAFYILNCYKMQ GPLRWATQGPVBDI  TQYYMU          RBSBTPJYDLQHVFU
EFHXDM          : VUMMWDIFUOR     VOPDJXEBVPQ    
QPUCQDKWWYLPWHN : UFHCCPX         MFYMMAWFLPQV   
RJFIGWD         : GODFTVULUXSKIMS APXCNKRAP       EAKJJVDNKGHJXO  DLKNKNJJOJW    
DIRCOFOHU       : SGBNYSSRCOT     MFYMMAWFLPQV   
JNOVMOWYGUGT    : WPRJUIQY        CUQCVFRVOAMV    TNBKODMWOSTOXY  CLAAQQCVXHXNF   ASBEEA          MQMRVOSHFRMBCTR
AFXJN           : WQJLXJYPRAVLRVI XJDX            OVNYS          
OXDAQHQXVXUIJ   : XUBFTOVFUMHG    VOPDJXEBVPQ     XAVDMOWCCGPU   
YGUPDTVADPS     : PWFXFALLWSKSETU YRBRFMTRS       ENWHFEEGQWSBG   DAEIAJY         FIEDSPYTBTPNOX  AHUDJVB         QURLPTB         SSQCU          
YGUPDTVADPS     : BDJGFQRQLKCKTFC
WTQKSGJVICD     : CMPLOW          NJGKH           EEOXFWFWECE    
ACWWMGFNOCE     : MWSQWGMYOLDIV   UUABTLSQQ       UEXIK           ENWHFEEGQWSBG   BHBUP           OYOFQBUXBXXUUTE
YAUESQJPK       : MAHMPCGJE       PNOJVEKUWWUTA   ULRFYQXWW       TJUC           
BFJMCROHQQLPN   : EWEDCJ          RMPSVFOCORXMGOL IVLKLTYKU       LGDRKQHPBVI    
VUONYUIX        : HACPB           CQNB            JINVFWG        
FEPVOI          : LWHE            TYHXRXCSLJIWWQ  ICXEOCMOE       CPNDQH         
PLOYXSSOCJHQYWQ : LVFCYKBJWQLXCXP UQKGT           RTSCTKEB        UHNP            ACBAX           LEDGBTDX        PGUFM          
THKSCSTA        : IPPPSCGABQSNNV  UYND            RCMJWHMBKU      RHEKLESGBJDURJ  BMYTOMIRI       SCCCOBAQA      
XRWOCGG         : XKGVWMXDYNFOBA  ETVGKR          RAIK            VQBXSJLWRC     
UHNP            : MIIVUHGYPFLVS   PLOYXSSOCJHQYWQ SOWJRXTVHSNNE   KJPOEWSHIECCC  
ERJLIKICKE      : NJWAXVCDB       JEDMSDBGY       JCYAE           VJKGDQILKRXMKFG
UAOQTORTI       : JVBL            JPGIGVFDRCMFU   HYCY            CQSVHTWLATLRV   NRMLCMN        
LLWRYRAPJCTCOI  : FBANX           CQSVHTWLATLRV   HIPRIDWWA      
YSMJXYH         : OTGNBYQK        TVTAR           CVQYQTLCMCS     WISASVDQLMMR    QULIJVMX        OBJNQPQF        IQOKTXSCQLUC   
NXTERPMIBAG     : MNEWCYTLCPFBDQ  VAVXIUAWU       BRGAWRQJXB      JCOSILIIEYOYMK  FOXKCSDWLQGEU  
AAVRKAL         : GUOSGRUJVYOLO   AEEYONWPVLPQJAU GXVEAQUHPD      GSGWNVJTFJC     IUXJDHFKNTPEYBJ RFIQRJWPV      
OTYONOAN        : DMTUSSRYIXA    
JLDJHHBW        : QNRBQ           UUCSQIGUCNXO    JTIFMWJAMRPL    IDCTK          
MBWSWYUUQFUE    : RJKAGC          MMKDB           HHVINSDRLUDURF  EYITEX          EKMFICBB       
KBVBQMDECNRFWYO : ERAHE           EHAVXRKHT       AKSQEPJERUI    
XKNYHGVGDQYJOE  : OEHXNNNOJ       CKRK            DCQGGKLSRRJHSG 
YFBCVNFCRSTW    : HDRMAU          VMNONWH         QVUPBT          PUBLD          
ULTSWHSGP       : JYPYVGFSUMNG    HQKRIJUMPAN     KLGKYXWHLIEMSD  ORGHNJGNAPE    
NSKMEYSKAXN     : QNICYGLOKX      IVSNWDMSIO      ICHFI           OUVI            CJBACO         
VEHAVDTTVQH     : HMRPWEW         HKKEPNWK        UWYALAJHVO      MYFCUETREIL     JBNHRWSTEEGQA  
KGWFNOVD        : MPOLPITGHOC     YRBRFMTRS       EOUIYISJPIG     JUIJUYPRBE      DHCFYGSQTNP    
IPMJ            : JVBL            PCECLQAX       
WJJMNIQXINBFHY  : EOYAGQSEMJURA   EODSGSWMR       KVQPE           EKMFICBB       
QOGXNNLEMOLUGAH : BCSFRFMUES      FIRYYJI        
YSEMH           : EDAMXQFEAAT    
DHYQI           : WIYFSRSMRWMLVV  IQUFO           VHXVA           HIWNOPNBD       HQVHCFMDBKEFBH  JCWYIHAPLLEUYOE
AJDRA           : NJWAXVCDB       QXKLWJHSW       GQFMXCIYKLJMTVK JFROIQ         
RNAFRMTFJCGQ    : WOQGV           BDPIUWCHIDHL    MHABEMBHWTRS   
HKDTTRXBQQ      : HBMGINH         CNXQSKRLP       SAXDIV         
XTUBNUMFKOK     : KVOIDV          JLAADIMW        JUTJV          
DGLNKTGHCSKVM   : EDHJGCDNLWOORJ  KPHNFBSLQD      DOFFW           XNMKGUIHEXMJWYW
VPXNDXHXYWU     : HISTJO          EETSQEDDKWVBE   MYXUH          
CHFOLIUAXFTF    : FVGVTJCPXMXR    WHVIQH          TRPSIA         
VACSPJOFHEJ     : TWBKV           SEIRTWBNATVBSP  JCHM            MVKUP          
NJGKH           : WTQKSGJVICD     DMMBCBWALAUXBWM SDJE           
MODBDMXD        : XRBLDAMETYBWAP  PJYAFT          TRPSIA         
GYTXVUAO        : BSOT            UDSO            UKPKRDDJPQ     
JFRSKDAXPI      : XXJLDBSEEKVMMLQ VMNONWH         RRBGAPRLTVMXL   MIIVUHGYPFLVS  
YHXNKCSYAXM     : NXTFNHGTURFD    IOPITHYQWTVLR   NBFWD           HVXIYJ         
XGGTDJKPUPKOC   : HPLSCCRPJIPET   CAINHMKIPJUG    BHBUP          
QBFCME          : VMNONWH         VUMMWDIFUOR     TYIWRPJODLYS   
KUVMPXPOMXOS    : WCUEYBHB        PRXDAYKERQHTPS  LJBC            XCAIPPMQGTGCG  
IYQUOLMBCP      : XEFQSUW         WCUEYBHB       
TSWXF           : KRCBYKIKQM      OTGNBYQK        JCNFGLMRT       QUCTQBXEYXMQ    WXBRHQSR        IQOKTXSCQLUC   
JRBHHQFWFRWVN   : ASGAHIJEB       JVEPFAMXRJKB    ATMILEDWBBWM   
EOUBDHOHLEYHWX  : QVCM            DYHEHCL         CCRHLCCQSIJGK   NYDKVLGVFECXPO 
EEOXFWFWECE     : XXJLDBSEEKVMMLQ UHYQKSL         UTWG            WTQKSGJVICD     MQKOXCE         IOKTID          HCNDCX          JLWAKCTSQKRVLC 
EEOXFWFWECE     : SPDLPVXIHU     
ABMEH           : WJQXXBB         CVMEW          
CJGJX           : CKDC           
UEMFDN          : IPPPSCGABQSNNV  QOCVASEKIVV     PDCARVV         GJYSQTOLG      
JRCHXBNWFRD     : FJPCIY          TLIPFGSMUYCMD   FUPXSQFTLV      OPMCRWCIHG     
RESYOTBADM      : BAFUYGBWSA      CKRK            HTRTELV        
QJEG            : EPMJDVPHYFGKNKR RGJBLOWXDAG     IVLKLTYKU       DASVLCKFWED    
JVCSNEANFNKMIO  : PVCFKUNLBI      JBRXOGAPQ       WRHEVXPBCO      WRAHE           NRKLMNJUUH     
AUMBJHEJMSJFFP  : OMPPRLSYKEQPF   PRINLH          SWNBQWVGAB      JUTJV           PWJFRHKETBIDHX 
TYHXRXCSLJIWWQ  : KTJIWGMWLXYQC   FEPVOI          MLCDUIXWMCNN    DVITXGT        
STIFWSOCEBW     : AQBHMIDAIWT     EIOBY           RFIQRJWPV      
HCGUYGFW        : KRMHNQGNQWFBGFS LPPLONDYG       MBDYKHLPIG     
DCSONENMWBFQ    : QEXYSQJBTEARN  
LQFAUJ          : ORPCGVYJUJJSMS  HIETHVTCMJWQUQW
RALWJGVRLURQY   : MEIIGIM         YMKFVDRPMBMYSNO YFPUMGWK        DRMRFOFSMLY    
GNRVAOXGIKRBPT  : COVUYTQHYITUQ   FHQXSPE         GBQLWBBJVSUFIIQ
BXPELMNUKFG     : APXCNKRAP       PPVRB           HJNXDEWACVYJW  
WAHKIUEEXV      : QIARXFCNSU      MTONOATRMPFNFV  LWUPKM          DTSTQ           NWJADGKL       
EEMXH           : UQNWIJSDMVY     JWSWVYKTKSSR    SUWUREEUADJC   
RDGSSKEIAYSFIB  : HFJGC           KSHDNRQTRUGILF  FLQM            MPOETDVCYEWFUJ  DYHMCFLTQU     
KLPSGTWEP       : OAYTIWIQLQ      KMEHDP          MMDHCKIFVIB     RBYUMOSLABIX   
KVOIDV          : XOITOIPSJ       XTUBNUMFKOK     SXFOYHSV        CKVDNFAQYIVFBSJ
ICXEOCMOE       : UGAVCPUSUKKUBNT FAJY            YDDIXYOUJDLFWG  FEPVOI         
TOLXYW          : AGPRLWBVETKW    XNNVSC          LLXP            IUBISPSUBPWX    IUXJDHFKNTPEYBJ
RFMQ            : MTRYMIJJIEVDUF  KVXJE           EEBMCY          VYJUOPKNF      
ESWBKIGGN       : TIOUJLNJFYDY    IVLKLTYKU       WMLFXPEOQ      
KLVYPINTPJK     : RJXACFIWTGWXS   AAVRIOHTU       PTUJKM          FIEDSPYTBTPNOX  DYHMCFLTQU      OOMHUVHYLU     
JLAADIMW        : AIFGF           XTUBNUMFKOK     DPHNSOKLBMKSUA  NFCIOHEJIRGXCL 
QPTTCCDI        : OTMKA           MBKHGPLLGASXRGR
USDQTTYJP       : HYARSDBSWYK     OLOYBHJTDSMF    LTUQS           ITDUAXGCCCKM   
SDWFOWFUF       : JJREGB          SGROXXWAXGEM    LLLPSTCYAQING   MBDYKHLPIG      QSOVUVYYHYCSNYE
RCMJWHMBKU      : XMYIKXGSPWHV    DKJDEBP         THKSCSTA        OWPTCMVFFYOI    CKJQTEYEUYNE    ITLSMDLGNQKY   
FQYXMUYWNPRQ    : JPSVJJE         NAEEFHSTREIGW   GMNEMYUMOVN    
WFMCCTXT        : LSLIKY          EKFYYWOOLJMEIJE MOUTPOJNYEWHWC 
LGXS            : XKDOYWOX        BTBKFDLIH       NRFJLTJLLBFGDCR GQBC            JNYLCQEAGSUQ    ULHDMJUJVG      HAALFMJY       
YFPUMGWK        : LNMYYLPNDYKSQTN GBBNML          RALWJGVRLURQY   CETVCWYXBTMB    NDGACXGHVHGM   
RJSFBMXQKGFO    : OYDHPHTH        CCOYRSYINEUB    CRVSA           PREC            GAKE            BTMFW          
BNDAYLXTEA      : DTEANSP         QEVPQOS        
TWPDTCY         : OJXS            RBJAT           UJLDROD         VUFCJSIE       
NTVQGWHQDOGLQ   : KIBVXXSXTVPWB   UPIGGIEYQYQ     WMLFXPEOQ       VEOAHXGNRHQV   
QSWCRSGT        : TNUNWIO         ETVGKR          IGPFS           BMLHQ           QSAQSCIYWHH    
BQLGNNFEBYC     : XRBLDAMETYBWAP  TUQLGW          HISTJO          YYFA            SWKQCUQMGCBDX   OLSJ           
HYCY            : POIPWJGSY       ENYPMN          JABCLPNCNULA    UAOQTORTI      
SHOLFFFCKYWQSS  : TQWGGHBWUQOE    EVEJISDYXYBWHIH MUEURAJXN       JBEXISTTCG      KADFBGKTKUXTTPN EWRKRQSTSNWR   
JGCYT           : RQQMXPXGXULQ    NRAQBYHGTKQI    DOMYHSBUV       BUUOMN         
DWIGQQHUR       : GCEEMV          XNNVSC          YLLAG           ESSFYTBKXBWYI  
OBBAGIHKSG      : VSCPCEBT        VVNAWUO         HSBV            KXCU            QKJPAF          JJBNQMUHMDSFGC  YOBVJLK        
MBCINKLMEU      : TENLYPHS        UUWRTFWP        JBEXISTTCG      JMBNXT          JCTY           
DGBVYIRQ        : SASHXGMSJJEDRIA
ITVICFSMXBXMDCV : KXNSVHQXGKPPNY  IVXILTFWKCG    
MHFSEXVKYRJKJCD : HPLSCCRPJIPET   VPJWJDFUMLB     UMWGBWIW        RBYUMOSLABIX    ERLAYA         
VADXHXMFYMSCO   : ECTSQRPBNKALRB  WVLK            KKBMW          
UBXBTEYR        : ISWGBAJ         UPLGQPIOHYFNN   NXLBQH         
BKYLVEQQAS      : XCRFEESOOKTLFVB YNRMWYVMBMALBGB LBLQAFYILNCYKMQ BMCAMCVU        MBDYKHLPIG     
BATPIU          : IOJQVHHMYK      AAUKWSJIFUCJIU 
DXTTU           : JPHNBPKYDLGVRV  PMRBDNN        
TVRXXKNYUPK     : ABXSVMSLRQMEIR  AQNEQOKMGSNEV   ALAWMJLXUTNB   
TDJVWFYWB       : RNKCUQQDAYY     AMOSAIPYKUKN    GLXYXJBSAD      INDQHHPV       
HWWKWQGROAQHB   : AYEIPCJCOK      APKQTBKCICBPJXI RJVYCIKQBGL     CALGQGPIHC      JABCLPNCNULA   
RQPOGCH         : VPOYU           HFHDXVNG        LUWHFBLO        SDJE           
FRBCYACDRJAOW   : ERAHE           CFBM            SXHRLOS         WITNPWD         NXTFNHGTURFD    ORIPVJITVDGQUSU WXMITSVLKYBSFSH
GDSUG           : FKEJTQWDXBVKOP 
EHAVXRKHT       : FMLDWKHLUPV     BPRBRHWUXJGKHK  UBLYFMK         EQKSEXVMFTWUMB  KBVBQMDECNRFWYO QWHHDVT        
LAOMENNIS       : GQAWYSVD        LSLIKY          FFKGMGV         UPIGGIEYQYQ     GETODAL        
UUWRTFWP        : VUHIMSHOW       VJBCNKJL        MBCINKLMEU      UWYALAJHVO      CUAKLDLKI      
DYHMCFLTQU      : DAKTWCY         RDGSSKEIAYSFIB  KLVYPINTPJK     HYXH           
NGSCT           : BSYDWYRMNHNM    RGJBLOWXDAG     VIKFFTOL        LWUPKM          BULXL          
RJILQFGNYDSVSXC : XYOXJLIVAVROGTJ UTWG            UXXHCDK         XXEHKXBCQ      
FOXKCSDWLQGEU   : KJMDQMMBWIUNHXC GCNQX           LJWCUS          NXTERPMIBAG    
DNLNYCSHSRKNQF  : JPGIGVFDRCMFU   FXOSPUDQMCIJ    HQGASHWKWDKBGMJ VCUBC          
SASHXGMSJJEDRIA : NOGSWJT         GTVREGBWGEONFL  UGYY            DGBVYIRQ        XSSKSQCKJCCY    GMTAAQBPDQEF   
ONHCOMXWHPJUGP  : FPPUE           DXWJTKKMNT      JKTEXREKSBJFD   IMEQEAIBAV     
BPCJPIVJUH      : NGIR            TENLYPHS        FWJDMP          KDCYUPN         SDGNVJXBISKVPO 
ACBAX           : PLOYXSSOCJHQYWQ
OGTDURC         : NFXCKQQYBVB     QWBGXJVJYWDEUV  TJQS            FEQGF          
KMYQCIUTLGLTCWQ : QTSGSIWHGMFMVN  HMMKSXKWVPOOTY  JFOPYHBIR      
NQPOTOG         : HJBI            ATMILEDWBBWM    UKPKRDDJPQ     
WAPRUSVFHU      : FCNGCRLJMQSRVT  UPKVKTC         LBPEIO         
JESFRYQNDOFREX  : UEQLWGKW       
URVB            : DEGLXUHXVCJ     OAWAUTW         VKMNDWQKQJSLXKL FXOSPUDQMCIJ    GSWVVSOMFCRI   
UDSO            : BMLHQ           GYTXVUAO        LNHHCSKLQGH    
NKFUIEGOYLG     : XPOVEYXORQGF    QKBUUWG         UWYLEGROXBVYV   PFUYWOK        
EVCUBV          : TGVAWKTLEAIDHF  CJWLAOX         FTVJF           TYWPWNHCUHV     HPTPWANLWSMMXH 
CETVCWYXBTMB    : RJBSHXHVHVNWSTW DOEWBCADJKADQ   YFPUMGWK        BMYTOMIRI      
XJEINK          : BVVOBNMTAYOM    ATMILEDWBBWM    IRUS           
OXFNC           : VRKBTGMO        PWJFRHKETBIDHX 
SXFOYHSV        : IUOGQPA         FUMMAGYGKBBDD   CNTVYUCQAUMBEVD KVOIDV          VFFWBBQBHAVDFN  BBCICWYM       
VSETVAIAHIJLQ   : MTOTFWVFUL      KSAIMOVBT       HHHQFIFCEEY     CKVDNFAQYIVFBSJ YVYEJNLIQBICN   CVMEW           PBYTBXND       
XNNVSC          : UQMDVHXJUFOAC   JNWVYSBPBDEBUN  UQPJNJ          TOLXYW          DWIGQQHUR       EOUNL          
UWYALAJHVO      : BJITXFUUTW      VEHAVDTTVQH     UUWRTFWP        GAGMMQV        
PTBLTJLESWRJ    : IUOGQPA         VYJUOPKNF      
QAKMUONPNMRBN   : PQTOUR          AORSX           NWJADGKL       
ILSNBOQPIBDOVD  : OMPPRLSYKEQPF   FALBJL          FUQBIXU         MVKUP           OVNYS           MKLWHNVUGLGGT  
HYXH            : DYHMCFLTQU      YMAKA          
KDCYUPN         : AEPCFUEYYY      QUCTQBXEYXMQ    BMLHQ           BPCJPIVJUH     
RDSCPNSSCJKNMQC : VVNAWUO         CKIYRPILIPEW    OGSNYYMJGRBBVOB QGLQQT          HAWFUPRQWEXN   
TJQS            : HBUWSTXYO       OGTDURC         RVMVVVLWJJU     GNAG            QCRDLRGKQXIAGJ  ETCVKJDTTJO    
AHUDJVB         : TUQLGW          YGUPDTVADPS     NKVUHBYYHEAAFT  EATGNTBER      
LQTPLVHAO       : QQJD            RBWDAKXDPMPEJM  QSDLSTCXYTALVL 
CBNPNESYAEP     : DLCNRJLFHYRPXKS RJUXWIJNDBKC   
ORCJXOHYQSPM    : BOTOQGQ         TJHC            SVBFBUP         CQLGMYRPUL     
BIRBAUGBKVQQ    : SDLEBNBKPJYCC   WHVIQH          APCTLNNMG       OBONVWLHABJ     MLCDUIXWMCNN   
PQVHNMAQVXFF    : LTCXBYSIGCMVL   YFGBAXLLIBRFPJC RPCSRYUGRFK     EGERLE          EGVHSXLTQV     
XAOKLRUFTU      : PNOJVEKUWWUTA   DOMYHSBUV       CMPLOW          WISASVDQLMMR    QSOVUVYYHYCSNYE KQRPEWAAP      
CXMAPDR         : TFKJTVCQFILE    TUNDFJIFJII     MCAA            NXTFNHGTURFD    KATW            YYFA            JUTJV           LXBIWHCO       
VPPKCRDAPKH     : GDKAJ           WHVIQH          WLIAO          
IHDSS           : PMHANPGXFRRX    SGOUYQNNTCVWCK  GWKGOTLW        HDPKAWXXK       TPDRSFESITGBA  
PYQLBULOVBTPLS  : XTBGP           WHKJMUSRLHSVY  
BDLSINKSUBDCE   : VBDRWAHCP       MMKDB           RGRV            THUFYKJMFXODTJF XBEHXHOLQCUK    QEXYSQJBTEARN  
XBNYUYARN       : GGRIYHGRTNP     RPIAXJBOEXSPH  
NQNFCGMDL       : RGKOVG          HLCQBOJTX       KIJECAEOPJJI    NNNPPNLTVJGYY  
XTNIO           : GQWVTTNHNYAYWLM LOYBOPXGFNFXIN  VPOYU           FIEDSPYTBTPNOX 
JRNPPLTFKQFM    : NTOPBR          NQWNSYEAGAL     ATFJEDVJJFX     NRKLMNJUUH     
SEYLTEOATR      : OCPEDQUFVIII    BSOT           
TSJIDXQP        : KSWDTCTDQ       LLVYJ           CAAVFWGJDQP     DLTXSXFPU       QSAQSCIYWHH     LWWVLIRV       
EHJRD           : PCOU            AAKAS          
CTVPFQVGDPKRR   : IDCJDNNYRCF     KKTDIJTSD       FLJNYWNV       
LHBGQLK         : OHBBTXUJXN      XBVMJSVWC       QKBUUWG         AULDA          
EAKJJVDNKGHJXO  : TWNLOMVFXMMVUJ  SVTTT           BJYBCYVKQSG     RJFIGWD         QKVHMENFFPS    
VUHNIYHONORVH   : HKUJMIYANBNGRHT TYARX           SGOEGNSJWUJ     DOMYHSBUV       HACPB           FORU           
GXIIKTS         : HMRPWEW         LSAFIDBLNRKMUQ  LDNY            FITSASJ         JCTY           
WGSFPCFHFB      : KXXYAKX         DYHEHCL         RIDG            LUWHFBLO        UHDJOJUACB     
MQKOXCE         : GVXLMAJ         SAXDIV          EEOXFWFWECE     HQPA            GVBAHCVLCPCC    AMFSHIRVG      
VAVAJV          : PVCFKUNLBI      OWFN           
TGGMMDUGLNI     : WQVQ           
UPUWFLKVMOCDK   : ECTSQRPBNKALRB  LSFHPHHFTKQSB   JKXSLJEGRFM    
AMNVYIDF        : KODTOPGYVLAA    AQYD            RYLVTIDIMQF     ITDUAXGCCCKM    CPNDQH         
RJUXWIJNDBKC    : QSKXIOXSQF      CBNPNESYAEP     CKRK            DTSTQ          
WOELFGOQNQFB    : STJOWHWBY       NNNUIMEMLW      HQGASHWKWDKBGMJ AYNSOIXGMQICXV 
FLSKJKVE        : JBSAOWQCU       HVCEHSD         MCAA            WAXWM           NUFALRDKBDJPB  
SOWJRXTVHSNNE   : BIBBHDGIF       KVCUW           UHNP           
WVLK            : MKMOPA          TUNDFJIFJII     VADXHXMFYMSCO   EKVUR           SREUIDVS       
TLCYXULJIINVDCS : OOJT           
VQHTACJO        : KSAIMOVBT      
DLFQXRK         : KATW            WHVIQH          CBEJDALJGNCT   
ULJRXU          : GPLRWATQGPVBDI  WBQM           
IKXL            : LWWVLIRV        OYOFQBUXBXXUUTE
QBKKKHKM        : PBEUCQSQAVLRHQ  BLSKIOE        
BVVOBNMTAYOM    : AHUNYST         XJEINK          NFYJUTSCNGDPCX 
IMGLUQJGG       : TCMMBQYBWFI     TMMMFUTO        MYSN            LQACJKJBKCB     MKLWHNVUGLGGT  
HSPRAAHTEDPSFFI : EYQEKCHLVMRIIF  EMFRIEAPFAH     PREC            BXQVRXGKUDTXY   IAJDXKWCMOTOCTC KYPGHCGKEEJKXHY QXILFSTUMS      PJCYWRTY       
IHPWRXJXL       : WSUHTWIEJKAXE   FALBJL          HJUMHU         
PVOXBWQQQTSA    : LNNNPJGOPQ      SROUWCHGNMV     EPMJDVPHYFGKNKR XUKTOJGHPBM     VBDGV           VOPDJXEBVPQ     HPTPWANLWSMMXH 
WEFSJNBKVIAS    : GTTKUO          GVRAQUHSKYEGXTE GCEEMV          MBDYKHLPIG     
AEBOK           : AYOAHYACDHCPYDO TRVXAOGWYM      KRQGIMVLBOXLANR RRIYSTTNNXBVCRA
MYSN            : JEFWTFAJEC      IMGLUQJGG       BGNXUSCNKTVDQE 
JERFYR          : KPMYNQMXPXG     OLBKDPYQHJPCMNO FVDCMENOA       JFVWETCR        YPCMSVLVHVOTM   YQJWDY         
WXBRHQSR        : NVSLHVQSFRG     TSWXF          
DTHFWNILADXB    : OMAYTEHVF       IFNQXLLQRR      ABBW           
NCKTTPSN        : RCKQJALLDXHA    COLKTABBTYWKJK  UMKKEYRTS       RVSKHPJBVM      NWJADGKL       
RMOJVFEQTHKDPJQ : WISASVDQLMMR    OCLO            FAEJW          
UQGUREITO       : QGYJMTCBRK      DOEWBCADJKADQ   PMMSMSTSCNFDYQ  ULUCWWVB        SVML           
PHXGUPUJAQQGHM  : OQOXEJAJRGKGT   PPVRB           FMTBHBJSSB      GJQRJA         
UPIGGIEYQYQ     : RNRFKHC         AQYD            NTVQGWHQDOGLQ   LAOMENNIS       XAUXOTAGKTT     OPMCRWCIHG     
KNOOFVM         : HOFSUIUI        FTFKDQWMEG      LJANXJABA       MLCDUIXWMCNN   
QDGCFAULHHE     : QFAFILIAMAJW    EODSGSWMR       SCARSTAHIXMU    SXHRLOS         VHYMPASDNPHP    PJCYWRTY       
WMLFXPEOQ       : FMBF            UIVORQHQVEPJUP  SFNBO           VWFICCUL        TPDRSFESITGBA   ESWBKIGGN       NTVQGWHQDOGLQ   CVMEW          
WMLFXPEOQ       : MKLWHNVUGLGGT  
OBLESQAFDTKLX   : EYAWNOK         UGOQYTE         AIYCOXOJVTVSSFK QCRDLRGKQXIAGJ 
LTEVDICBX       : OUBKIY          TPBWBQRYAPQBC   HSBV            SFNBO           NIYGAKDRHNJHG  
IVFNMWLCA       : GUOSGRUJVYOLO   SIJKLVEHJCQGQKS HKYK            QKVHMENFFPS    
GSRGYU          : HDFCCDV         FORU            TJUC           
LJBC            : VOPDJXEBVPQ     KUVMPXPOMXOS    YLLAG          
WISASVDQLMMR    : OUBKIY          YSMJXYH         XAOKLRUFTU      RMOJVFEQTHKDPJQ SUXPDCYVMJIQM   WXDBNSNWBJGX    CQNB           
AQNEQOKMGSNEV   : PYRLRTYXWJ      TVRXXKNYUPK    
NYDKVLGVFECXPO  : IUGNGE          EOUBDHOHLEYHWX  SEUVLQQB       
HQPA            : GPLRWATQGPVBDI  WXXUIOGQFLFJY   EOCXPGXRVIX     MQKOXCE         OTRNYMDQGDXEQKH
TTWEGDY         : FWSGLJBRPN      MSVPFWKUNKF     QXHHILC         SIWVL           WIKLTLMVHVHWAI 
JWSWVYKTKSSR    : MOEGLYY         EEMXH           QXSPIPCDIUAD   
UQMLGWEVYK      : HDRMAU          DNNSDCE         CCRHLCCQSIJGK   RACFDKLG        IHHKRCEK       
SJVYMWUY        : JWDCXWDRVOQWY   USPCLYUN        MBDYKHLPIG     
QXSPIPCDIUAD    : NYDYJX          ETVGKR          JWSWVYKTKSSR    EETSQEDDKWVBE  
PQTOUR          : TNBKODMWOSTOXY  QAKMUONPNMRBN   OVNYS           DPTVGYSHF       IPMG           
HHHQFIFCEEY     : VSETVAIAHIJLQ   ONQGEOWD        AOWRPBN        
DSMNIORSLTXYJO  : EOUIYISJPIG     DOFFW           GENAHGSGE       WFWAENYNFTIETBG
AJMO            : XEFQSUW         GVONOPDXWMK    
VXJBG           : KJUCMDF         DYKLGOEDMWXGC   MLCDUIXWMCNN    WIKLTLMVHVHWAI 
GMTFH           : RTXTE           OLBKDPYQHJPCMNO
ATMILEDWBBWM    : NTOPBR          MYVVOKXQISMSOYG JRBHHQFWFRWVN   NQPOTOG         XJEINK          RLGNT          
TNBJETHCDLKSR   : UBLYFMK         FWSGLJBRPN     
OWFN            : QWBGXJVJYWDEUV  MUEURAJXN       VAVAJV          EEBMCY         
CAINHMKIPJUG    : MTONOATRMPFNFV  XGGTDJKPUPKOC   FYDOWLKLAYXJW   SUWUREEUADJC    BDJGFQRQLKCKTFC EBFTHBENUITXNXA
KJPOEWSHIECCC   : VVLQBLVLCMQ     YQYNEXDNQWVP    UHNP            SJEGNJBWIBJMOAR AUXBMMMXSXAPE   JOBKUDXEUFQ    
CJGCLHMBQB      : MWIBDRWWHJBQ    NYPSPBNAGMRFCKB ICSQUTGH        ORGHNJGNAPE     LGCEPHLKK       WTHLFKQS        GMNEMYUMOVN    
BRXXA           : OTSRY           RPJOPQW         RNKCUQQDAYY     HDKK            JLWAKCTSQKRVLC  LAWSSDNYY      
JJVANTTXEXAHA   : EIFNCLIIAVIKKN  GGRIYHGRTNP     EOUNL          
LJANXJABA       : NIYLVVMFRWWVUDB KNOOFVM         PBVOAVUL       
PBVOAVUL        : YGINTAXQ        GVXRHOOCMYYLJF  AHQVQUPBIX      LJANXJABA       RNLEIXRKEWC     YSRPMHIMYMEEX  
RLXNFVTFXDFRORU : JBRXOGAPQ       MVLV            PGJVAOKDFKV     VGSICMFR        WYMQSW         
REFSFJJI        : TTWNSTRYRM      FWNQOSXDLPRW    YFGBAXLLIBRFPJC
AKDWVM          : KWHPBIBERAUGX   BSOT            SKSXDQJPSP      SVML            BTMFW          
KKGRIBXJG       : ENYPMN          CXUUPMXVUT      AOWRPBN         PBLUEOIIXHPJT  
BVWXCQDJK       : EYQEKCHLVMRIIF  AIPTQMPUPI      PCOU           
SVSCXGHUEUOOH   : FMLDWKHLUPV     PCVQ            OJIWNMDWCH     
HQVHCFMDBKEFBH  : WQBPHK          DHYQI           ESSFYTBKXBWYI  
NRKLMNJUUH      : UQKGT           VKXPOC          NNNUIMEMLW      JVCSNEANFNKMIO  JRNPPLTFKQFM    MVLJM          
PVQXQAQPHS      : KOPTTUPXKTJM    LAESIIP        
UXXHCDK         : QYEQX           XERWMVXYEPOIVHJ RJILQFGNYDSVSXC ACXXBSFGQD     
SBFEMUR         : OIKEWBAAXFQPVHD YOTCGQXOSWR     SKBB           
POERFC          : RQRPH           IQRWPWYLE       KIXDNQ         
FSLXIVSDSSDCXH  : AGPRLWBVETKW    RAIK            WWCDJA         
JCNP            : KCDKOQ          SODWHKPNLQGUDG  UEXIK           KRVBCPYRKQISMQ 
BKAAAPGUWIGEBR  : CQYQYDYTC       HXTRQDJCJ       BRDQE          
MPWRIPVMNFAXHP  : ILQDUY          PRXDAYKERQHTPS  RGJBLOWXDAG    
QSAQSCIYWHH     : HTKEKURXMOFKTN  BJYBCYVKQSG     QSWCRSGT        TSJIDXQP        AMFSHIRVG       INCVSOL        
LLXP            : OGTXSP          SYWTTNEVMTVWML  VOPDJXEBVPQ     TOLXYW          PUDKHYKK        TCLNJILU        XHERLXHUBKY    
PMRBDNN         : LSAWLR          KJUYGOXUWHEGNC  BJYBCYVKQSG     DXTTU          
SPQDGGTYIMUNXVM : TSJSXLWUTEI     KDIEPRYNQGKQ   
GSTRSJRIYLJ     : CPNDQH          FEAJMVKMEW     
CXUUPMXVUT      : NIYLVVMFRWWVUDB JRVPCYW         COVUYTQHYITUQ   KKGRIBXJG       HCLYCYSIMJ     
GHUT            : IQUFO           XGMGESFHGSOPJLY QGLQQT         
QGKWYGQRQ       : WITNPWD         ENHM           
DPWOTYO         : BXLKI           CNTVYUCQAUMBEVD CIVMHDPCMMYAVDM
VFFWBBQBHAVDFN  : PVCFKUNLBI      GQWVTTNHNYAYWLM SXFOYHSV        BYMFOCG         WPEBMG         
SMLYGF          : LEWCOPHO        VLFVEEJJFOYXN   RNRRRDQVQOKHQ  
QKJPAF          : ERAHE           OBBAGIHKSG      ITLSMDLGNQKY    OWFTSKROY      
OWPTCMVFFYOI    : FAJY            RCMJWHMBKU     
RNLEIXRKEWC     : NOGSWJT         PXUJVFS         YUFJ            PBVOAVUL        OIVVBTTAMYXOPR  IGPHGESDWQOIPR 
IOPITHYQWTVLR   : YDPW            YHXNKCSYAXM     INDQHHPV        XJDX           
SQQBMKP         : SFCFR           ODJLHNXMOXJGOWP EXLBCXAPDXVS   
OAYIKFGNFQCVBV  : UIVORQHQVEPJUP  COGNPAXAMF      WXDBNSNWBJGX   
APCTLNNMG       : AVCMSDYSLNFBK   MYVVOKXQISMSOYG YUFJ            BIRBAUGBKVQQ    EOUNL          
FITSASJ         : GXIIKTS         BXSLCUAQUYMCHKH FBFAELADJLUJV  
TSLBBBHRFDUBIU  : XEFQSUW         OFUBKMAH        BJRANALV       
KREA            : HYTVL          
TIMYQHTS        : ACKOQEI         XKPU            QSOVUVYYHYCSNYE
ETVWHYXIGRNLM   : IVSNWDMSIO      THUFYKJMFXODTJF DTEHBXFTIOMU    MXAUENVMTVYD   
VJKGDQILKRXMKFG : ERJLIKICKE      YCAMWUOXBFNYDF 
HMXFJFF         : HDRMAU          RYLVTIDIMQF     QDBBUAMQKCLSOQ  EEBMCY          HSTQXKNDSR     
NNBD            : GTVREGBWGEONFL  BSMXFUDSXDL     PDCARVV        
PTVAGFFXNQKHPYS : EIFNCLIIAVIKKN  ACXSWJNHPCWFP   KLGKYXWHLIEMSD  GNSMBGM        
GWFSWM          : JEDMSDBGY       JKTEXREKSBJFD   BDPIUWCHIDHL    BRDQE          
CRORGSWIIQEK    : MWIBDRWWHJBQ    EWEDCJ          EFGHLFLNMAS     KNGDM           INCVSOL        
LQACJKJBKCB     : EPMJDVPHYFGKNKR TSJSXLWUTEI     JIHF            IMGLUQJGG      
BGNXUSCNKTVDQE  : WHVIQH          KNGPTHGAGTO     MYSN            OSIAW          
KKBMW           : JHIJLOJXIIWCY   VADXHXMFYMSCO   ULHDMJUJVG      NFYJUTSCNGDPCX 
MBDYKHLPIG      : HCGUYGFW        SDWFOWFUF       BKYLVEQQAS      WEFSJNBKVIAS    SJVYMWUY       
QURLPTB         : NWYHTJQDV       IEGUWBOGPCYTIE  YGUPDTVADPS     PASURTTLU      
QWHHDVT         : UBWI            EHAVXRKHT       EDFVHVSAMFJFDJ 
WINSUOVWBFI     : ASGAHIJEB       KSAIMOVBT       BDPIUWCHIDHL   
NRKGMESEXVH     : UBWI            IUBISPSUBPWX    SDJE            LGOV           
TQYYMU          : HBMGINH         PNOJVEKUWWUTA   UVDMUYHQQTCHB   DVTO            YXLADJH         VVXHVJOUOU      HIGVFTK         EBFTHBENUITXNXA
LEDGBTDX        : YRBRFMTRS       KODTOPGYVLAA    FSWGPUUPCUOT    PLOYXSSOCJHQYWQ NQEBXUSBWBEVUAX
KJOBBBHPFATEWD  : YPCMSVLVHVOTM   KKDOAHPYUMYQB  
SUVRJTIXXNEYKJ  : DNCDHWPHMQKTS   JBJHEECSSRE     YMKFVDRPMBMYSNO VQRYOTPYACPNUU  AVJNVKRDKYRX    BBYXSJRLEMG     OCMXF          
GUJUXMWF        : JJREGB          GWKGOTLW       
EIXKHEGCYETK    : LAESIIP         YKWEYFOSLAF    
EKVUR           : KMUOJXFAEDOTTE  VJLJL           OBNSTIBFO       WVLK            WIKLTLMVHVHWAI 
FBANX           : CNLYDEPEVIWYXYF LLWRYRAPJCTCOI  GAGMMQV        
KVXJE           : CQYQYDYTC       HJBI            RFMQ            FDYRWDOCFHDCNVN TRPQVCOYP      
OMAYTEHVF       : TUHPEE          OMPPRLSYKEQPF   DTHFWNILADXB    EJVEKM         
RSKYDJVUJ       : CBWQIJNVWFH     QULIJVMX        CJBACO          GNSMBGM        
YJOY            : SMVXASLPWH      VJLJL           NDUNBUPIOH      JPASDYMHAQYTMHU EBFTHBENUITXNXA
BXSLCUAQUYMCHKH : NIADJFWGV       UJLDROD         LIASQC          FITSASJ         LIMHBI         
EAIDGR          : BPAGAUIBGQBO    DGTBDESX        EYUQKMEXUHATVF 
DDCCMSEJUCC     : SHIDYKC         EGDSUEAPFUMRF   OTBDXHSYM       YNWJAHT        
GWIYUJLW        : TIYEWKOWQP      DACPPWYE        VPJWJDFUMLB     DLKNKNJJOJW     LGOV           
VEOAHXGNRHQV    : UGOQYTE         EKKSN           FIRYYJI         WAXWM           NTVQGWHQDOGLQ   HCNDCX         
VIHASCEWKM      : BFUYGDSUYRDWQ   OEMANBXYYWTSN  
ULRFYQXWW       : CCOYRSYINEUB    KIBVXXSXTVPWB   FSWGPUUPCUOT    YAUESQJPK       EFYSYRQCCS     
YELFTDPNYCL     : MNEWCYTLCPFBDQ  UCPDRGSNMQR     QJWVUXAFSC      GETODAL        
JLFORCBGBWTUCSL : DKQB            TAQF            OLSJ           
RJNQ            : KUVURBIWJVNOQNQ CKDC            KXKUBTESEJWJ   
BYMFOCG         : EOYAGQSEMJURA   DWPYOQVGNMRJLQI AEEYONWPVLPQJAU AYMVVBHLRRPSPVR WJBHFGHWMRRNDYS VFFWBBQBHAVDFN  AKDWTTUF       
NQEBXUSBWBEVUAX : CPFXCWJRFBENU   UKXBLDNUCRQER   BEIQJYLLCS      LEDGBTDX        AYNSOIXGMQICXV 
LAJWQAPRB       : ORIPVJITVDGQUSU YQDNP          
YRGGMVYRWXMR    : COVUYTQHYITUQ   CMMYRDCUYWQ    
LSFHPHHFTKQSB   : UPUWFLKVMOCDK   FXMFSRFGYH      GMTAAQBPDQEF   
KUUQ            : TGQQYGENNDIO    BKFQNYK         CIUMDPNBV      
MYFCUETREIL     : EKBF            TTXYOTDOLKLXCR  VEHAVDTTVQH    
UENCVUMDQWTKXNW : UGOQYTE         GPUVX           KJTMI           RJVYCIKQBGL     GVBAHCVLCPCC    HASJ            PJCYWRTY       
IQRWPWYLE       : IDCJDNNYRCF     MNYIPYAGQAKA    AWCADKAFCPRMD   TLHVLCOCJDJOEYS HKVDG           POERFC          IRITHSP        
FIET            : IXXBCH          LPPLONDYG       TNVOREYOMH      JRIDOH          KFENMYWLKNJB   
BXEFWYRAQOUDM   : WVIJPJP         AMSY            DXAUYL         
AKSQEPJERUI     : KBVBQMDECNRFWYO HIPRIDWWA       XXEHKXBCQ       GVIOXOQIULPIWY  JPDIELYIGAJ    
CQSVHTWLATLRV   : RUCCENAXQCF     VLGB            VUISR           UAOQTORTI       LLWRYRAPJCTCOI 
JQHVYHI         : CPNDQH          EBQE           
BNKKREHA        : AYEIPCJCOK      CAAVFWGJDQP     FUMMAGYGKBBDD   KYPGHCGKEEJKXHY SJBXKYGYVPOL    DFDJLGTA       
LSMKDIJQKD      : NRHIRTNDBQPDA   XMSKGNKFBOLTFL 
FBIOSPMTAVODJ   : GFCQYAVXSNJTWDL UNBVRVAMYKAEX  
NBFWD           : VMNONWH         WMHCJSQPLPKVMWK GBEPQARHVKU     YHXNKCSYAXM     SUXPDCYVMJIQM   WYSTPPODCF     
KXKUBTESEJWJ    : SFNBO           UYHCKOKHHAKUYH  RJNQ           
IAGXNAAJODS     : INVBGGCLAICGXV 
QVUPBT          : WHYP            MUMNMPQTUDW     YFBCVNFCRSTW    QEXYSQJBTEARN   UMYPYUOPSCIRFAJ SUXPDCYVMJIQM   OOJT           
YEXBADVFOUQCDR  : OOMHUVHYLU      AFTR            OXDHFPBFPT      XCAIPPMQGTGCG  
EFJEQAIJQBHNTIH : UIBYCOQUWCHSPI  UJBPCFKDFLAKA   EGERLE          RBSBTPJYDLQHVFU
HOUKQAGXPEP     : HVCEHSD         JVLYMSOPOWP    
JJBNQMUHMDSFGC  : RAIK            OBBAGIHKSG     
AKDWTTUF        : KJKY            GCEEMV          IUGNGE          BYMFOCG         YYFA            YEHWWEVYQVSM   
UNJMRBFCKIR     : BQFOJWHUJJDNEEV SMBCUNKGR       PPQYVQNOBHDJCR  DVANYAPNSNKUU   HASJ           
UMMHRHNBJJB     : MRLMPXGLG       NTOPBR          OYLXNVNAJTD    
MBQHVVUSLEGEGNI : AYEIPCJCOK      MUEURAJXN       DOFFW           UYND            FSWGPUUPCUOT    TKNTTOFBDUCKYMF
VCWQRLAJ        : DBTE            SCARSTAHIXMU    VTIPSGXYG       IGBPR          
PKDY            : OLOYBHJTDSMF    TAHF           
AORSX           : MMKDB           SYWTTNEVMTVWML  JEJKIQOULHRCAPU PYMCUL          QAKMUONPNMRBN  
OSIAW           : WQRIFIGDIUXSNF  KRHVWJ          ABXSVMSLRQMEIR  BGNXUSCNKTVDQE  HFHDXVNG       
GFCQYAVXSNJTWDL : TWNLOMVFXMMVUJ  SGKYRUEBDMJXEY  FBIOSPMTAVODJ  
JNYLCQEAGSUQ    : BQBYU           USGIBFMIPTHCQXR LGXS            WWCWWQELAFIPBPS
RGEAKWYLSWE     : XSSKSQCKJCCY    XHWYJ           DRMRFOFSMLY     LELHTHQGBQVAK  
GAGMMQV         : HMRPWEW         UWYALAJHVO      FBANX           SCCCOBAQA      
RHEKLESGBJDURJ  : LEEYEJFTOB      PDELDW          STJOWHWBY       THKSCSTA        AAKAS           LWUPKM          CJBRMLJEICVEY  
DHTQCSULAXRMKK  : SGBNYSSRCOT     MBUVKCSRMV      LGOCFAGTUAJEFSU SSKKTOGJPEXA   
MERQOFWJN       : IAJDXKWCMOTOCTC MUMNMPQTUDW     OWJEOTRNJCGQT   LUGQT          
UQSNBOSKKJOEG   : MSRPADY         GVBAHCVLCPCC    GSUDWMVLO      
EETSQEDDKWVBE   : NCHTAJ          VPXNDXHXYWU     QXSPIPCDIUAD    GQFMXCIYKLJMTVK
KRQGIMVLBOXLANR : AWCADKAFCPRMD   CBUYECNMUOQW    VTGNERFAJ       AEBOK          
NVPIQGOVM       : EYAWNOK         UIVORQHQVEPJUP  YMKFVDRPMBMYSNO LDNY            BCKGYAR         SRDVVNB        
UIBYCOQUWCHSPI  : CBGIHVMUXLTFNF  EFJEQAIJQBHNTIH TJBIKDJJGU      MVKUP          
OWJEOTRNJCGQT   : MERQOFWJN      
DVANYAPNSNKUU   : KMUOJXFAEDOTTE  SVBFBUP         UNJMRBFCKIR     HJVTUVNPMKM     FDYRWDOCFHDCNVN
LGOCFAGTUAJEFSU : HFJGC           CMGDPDNCW       DHTQCSULAXRMKK  KJOK           
XAUXOTAGKTT     : KQUBDORWPIIVCK  TQLGOHQRRDJ     BTBKFDLIH       MIWSMQKLMLIECYC UPIGGIEYQYQ    
QRDEXTGFU       : CFBM            LYOHCHH         EATGNTBER      
BRPLVUETVCVSCMM : PWBDAA          GJJXIEIYMEND    IOKTID          GNSMBGM        
TYWPWNHCUHV     : LLVYJ           EVCUBV          GFKONWPBETYAG  
MSQO            : HDFCCDV         TEFPMLTIBHI     FWJDMP          GBBNML          HKYK            JJLJRTBUY       XQAJBUUCIV     
ICHFI           : IJYIEGICLTO     NSKMEYSKAXN     RFIQRJWPV      
BMYTOMIRI       : MNYIPYAGQAKA    RJVYCIKQBGL     THKSCSTA        CETVCWYXBTMB   
QXHHILC         : UTSCGODR        JNWVYSBPBDEBUN  TTWEGDY         AYNSOIXGMQICXV 
HFHDXVNG        : OYDHPHTH        DJQGLR          WVIJPJP         NXLBQH          RQPOGCH         OSIAW          
WLIAO           : QBERJEBBTTNXW   VPPKCRDAPKH     TRPQVCOYP       DGICGQULTX      JBGIABQDREB    
CKJQTEYEUYNE    : TGEBHK          RCMJWHMBKU      LCTTJSWXYAP    
YGCIMJL         : SCARSTAHIXMU   
HCTJYHR         : SBIM            EIAFWFKBUOR     EKFYYWOOLJMEIJE TUITWYI        
WOGHAWDG        : GNOBGCAFVJB     MTONOATRMPFNFV  JPGIGVFDRCMFU  
JCWYIHAPLLEUYOE : KATTSFQBWOAJD   AYVQWAM         DHYQI           ONQGEOWD        OCMXF          
INDQHHPV        : WSKGFWNULKIYP   TDJVWFYWB       IOPITHYQWTVLR   HPCFTSPDQFXBCMN
YXMFFKQHJ       : EYETJXXTHCKR    UGAVCPUSUKKUBNT FYQGFGORL       VTLWX           GQFMXCIYKLJMTVK
RQSHCE          : OTBDXHSYM       ISIG            DNIPJRB         EGVHSXLTQV      KKOCVWP        
YEDFHNSK        : EFEJFT         
ARVXHXWVD       : RQRPH           WBBGDMSQTOQXSLL GVIOXOQIULPIWY 
ITLSMDLGNQKY    : EKKSN           MUEURAJXN       RCMJWHMBKU      QKJPAF         
QEXYSQJBTEARN   : WQVQ            THMQHBAG        GBBNML          DCSONENMWBFQ    BDLSINKSUBDCE   QVUPBT          OWFTSKROY       ENHM           
QEXYSQJBTEARN   : ABBW            ASBEEA         
QKBUUWG         : QQJD            APKQTBKCICBPJXI NKFUIEGOYLG     LHBGQLK        
KMASAQFBIW      : SAXDIV          KVSIDPKUIEK     CGQUT           OSPSUXJ         KVNNLLRWOIFEWOU
GVBAHCVLCPCC    : CXELFCNCLU      YDXFQPDWBCPKTYA MSRPADY         MQKOXCE         UENCVUMDQWTKXNW UQSNBOSKKJOEG   PDCARVV        
OFCJDLX         : AYMVVBHLRRPSPVR NRFJLTJLLBFGDCR GDOPEBLC       
AAKAS           : EHKNTTWMQ       EHJRD           RHEKLESGBJDURJ 
DBMLKKOMSTIGXX  : TTWNSTRYRM      EOCXPGXRVIX     DNIPJRB         OIVVBTTAMYXOPR 
BHYGKJ          : QJHKWGNIP      
XJDX            : RJBSHXHVHVNWSTW LBLQAFYILNCYKMQ AFXJN           IOPITHYQWTVLR   FDYRWDOCFHDCNVN INCVSOL        
NAEEFHSTREIGW   : JJLJRTBUY       FQYXMUYWNPRQ    KNGDM          
ODBPOCWNK       : IXXBCH          EDFVHVSAMFJFDJ 
YYHKCHVQJAWRI   : OSRPSXTOPCOOQVC YDDIXYOUJDLFWG  JEPEJYGNPGOO    DAEIAJY         CNTVYUCQAUMBEVD MBUVKCSRMV      VKHFORBN       
LCTTJSWXYAP     : CKJQTEYEUYNE    FVIUBJPIXPY     YQDNP          
ENDO            : APKQTBKCICBPJXI YUFJ            HAWFUPRQWEXN   
DPHNSOKLBMKSUA  : JLAADIMW        RPIAXJBOEXSPH  
XWXJRWJQYAEDN   : LWHE           
UKPKRDDJPQ      : YLAUTEAPYQRGMOX FIRYYJI         GYTXVUAO        NQPOTOG        
FBFAELADJLUJV   : SLRXJMQ         PWFXFALLWSKSETU JTIFMWJAMRPL    IEWC            FITSASJ         JUSNTYEOMEUJA  
IVSMLDJXSTSYA   : LKULGYFERFB     YNLPQXXQRL      RANE            PCVQ            DHCFYGSQTNP     IATNJRGEBEIN   
QSOVUVYYHYCSNYE : SDWFOWFUF       XAOKLRUFTU      TIMYQHTS        EEBMCY         
LNHHCSKLQGH     : UDSO            QSDLSTCXYTALVL 
HJNXDEWACVYJW   : EGDSUEAPFUMRF   BXPELMNUKFG    
FKEJTQWDXBVKOP  : TAKUTK          GDSUG           BTMFW          
WBAGPY          : WIQIPEXGWTJAHX  FWNQOSXDLPRW    VLDL            KARCH           NSJTOKK        
VVLYT           : JXPUKYTBM       KKOCVWP        
KQRPEWAAP       : XAOKLRUFTU      SIWVL           IBEAKIO         PUBLD           NBTJCDVP       
EPBCA           : IGPFS           YYOB            SWRGWBRACJ     
RVMVVVLWJJU     : LOLQU           GLXYXJBSAD      TJQS           
IOKTID          : EEOXFWFWECE     BRPLVUETVCVSCMM PHMDGESESUQEYGH GMTAAQBPDQEF    VMILPSCGMTTNJ  
OCLO            : TCAVPCSXWMQ     UUCSQIGUCNXO    VUISR           RMOJVFEQTHKDPJQ IGBPR          
JUHMXJCRFRNEPBB : GVRAQUHSKYEGXTE USGIBFMIPTHCQXR IFGRMMP        
LWWVLIRV        : WQBPHK          TSJIDXQP        IKXL            DVMPEQUMGK     
EKPPAHBWQNUCQ   : DLIFNV          RYOXVTPOK       UEVTFAX        
KKDOAHPYUMYQB   : UUTPOYUDH       XQFICVQC        PPVRB           KJOBBBHPFATEWD 
LWUPKM          : CWMOTFQFUCQO    WAHKIUEEXV      NGSCT           RHEKLESGBJDURJ 
MVLJM           : SQTIMBUWWQB     DKJDEBP         MLRVSY          NRKLMNJUUH     
FORU            : YJQFOGTQPGGUMQ  UFFHBNJOQCCRUU  YUFJ            VUHNIYHONORVH   GSRGYU          XBJHVQUYCLW    
CAPEHGGCSFVVMJ  : BUUOMN          CVOLABYT        KIXDNQ         
JBEXISTTCG      : VRIYWMHNVWLPL   GQBC            SHOLFFFCKYWQSS  MBCINKLMEU     
HWPEYSHO        : FMBF            BCJPQRCDFQQBY   GXVEAQUHPD      KARCH           QEEENWY        
OWFTSKROY       : GTTKUO          QKJPAF          QEXYSQJBTEARN   MYDG           
KKCQI           : IVSNWDMSIO      QJWVUXAFSC      WDVPBTVRNLVQNG 
JCHM            : IIMHJDTDUQ      MHTXCCR         KVSIDPKUIEK     VACSPJOFHEJ     BBCICWYM        PGUFM           GJQRJA         
FVIUBJPIXPY     : IYUITCUK        LCTTJSWXYAP     SKBB           
USQGMFFN        : IETX           
QRHBFT          : RDIJVLNUPEYO    XOITOIPSJ       BHBUP           YGCBN          
OGOTCWQ         : MMKXVMGWCHKHW   OVHBJSII        XCAIPPMQGTGCG  
GHPHWPFTKXAX    : UBFXMR          UNHYUHMK        HCLYCYSIMJ     
INVBGGCLAICGXV  : NVXFYLPY        MHREYEVRW       KRVBCPYRKQISMQ  OWREOOISISGOJ   IAGXNAAJODS    
WOQGV           : PDELDW          YNMYLORTAERRSN  RNAFRMTFJCGQ    UEQLWGKW        MLYXIF         
NUXUPLSRJX      : OEHXNNNOJ       CJWLAOX         SFNBO          
YUFFDKS         : HRUX            OLOYBHJTDSMF    HQKRIJUMPAN     MWDJOJEKJMS    
SULQSV          : BCAKWHVBKIP     BPQBJSSWNWUNKOT
IOUGVKCVHTHCN   : YUFJ           
CQSWXXCITFCOQU  : PMHANPGXFRRX    XKFXUI          FTFKDQWMEG      PUBLD          
NJSCGYASDWA     : EHKNTTWMQ       TGQQYGENNDIO   
GENAHGSGE       : HSAAPFBWDX      XDUBTKPQH       VHXVA           DSMNIORSLTXYJO  JPHM            GRNUXJRVFKKT   
JNMORCIMOXY     : ISWGBAJ         VVNAWUO         FWNAMMXKKFE     EIOBY           WQRIFIGDIUXSNF  IBEAKIO         IATNJRGEBEIN   
CHIDBOCDNIIBKR  : UNODWDKJ       
DXOWHEJYVN      : LVNOYVGNQMUEXC  RGRV            OBUEIBJB        VYJUOPKNF      
KCHLLJTUO       : BXLKI           TVIHHKM        
JSAYEKDOEMSDDR  : CVVINJIQF       HHMERURHCOGV    EKRGGPRVXOJG   
JBNHRWSTEEGQA   : NFFUB           WRRIUUYK        RPCSRYUGRFK     VEHAVDTTVQH     MLCPDLKAPUI    
HWOBANHKSVR     : ARGEC           CPNDQH          FXMFSRFGYH      BRDQE          
QULIJVMX        : FWNAMMXKKFE     TQOGPDOQIERPG   HOJFQBVWU       YSMJXYH         RSKYDJVUJ       DYVENBDISKT    
EWXXEFGUFJC     : AMOSAIPYKUKN   
XFDOMPHJ        : EOUNL          
PCECLQAX        : EDFOHPXT        UQPJNJ          IPMJ            GFKONWPBETYAG  
FCNGCRLJMQSRVT  : YDPW            WAPRUSVFHU     
BIMTPXDIA       : VQRYOTPYACPNUU  VPJWJDFUMLB     OVNYS           VTIPSGXYG      
MNYMLPT         : TGEBHK          GVXLMAJ         LWHE            QBERJEBBTTNXW  
DASVLCKFWED     : IEVQGKOTXKHFP   EKFYYWOOLJMEIJE QJEG            JINVFWG         IBEAKIO        
EFYSYRQCCS      : YNRMWYVMBMALBGB KQUBDORWPIIVCK  HQKRIJUMPAN     ULRFYQXWW      
OHNDU           : ATQOSKNDTY      APKQTBKCICBPJXI WPDWDNFB        THUFYKJMFXODTJF EXLBCXAPDXVS   
YLLAG           : XYOXJLIVAVROGTJ DWIGQQHUR       LJBC            NRICWIGGXYQUW  
NKVUHBYYHEAAFT  : AQBHMIDAIWT     JABCLPNCNULA    AHUDJVB         NHCSPJFWWUJXNNQ YOAAXNJBVB      VMILPSCGMTTNJ  
JVLYMSOPOWP     : KJMDQMMBWIUNHXC DTVXDUJHBWCEAL  DGEIP           STPRWKJAEDIKX   HOUKQAGXPEP    
IRITHSP         : JJREGB          IIMHJDTDUQ      UFHCCPX         IQRWPWYLE       TJFFF          
CQCDAIGAPA      : XEFQSUW         FWJDMP         
YYFA            : NXTFNHGTURFD    HJUMHU          BQLGNNFEBYC     CXMAPDR         AKDWTTUF       
XPEOM           : WXTIYOVNLSNH    YQTPDVBIQ       XDUBTKPQH       UCPDRGSNMQR    
SWNBQWVGAB      : LVCWHBHNKQQV    BFRVOAGHIVAA    TAHF            VIKFFTOL        AUMBJHEJMSJFFP 
EEAMKDCN        : OICYWF          KOJRTFHGA       UEQLWGKW        EGVHSXLTQV     
EMBEA           : RVCHAEEOOEAEGJ  JCNFGLMRT       OCNUKXBPWUUW   
VGSICMFR        : NMGUBX          SRAVI           YOTCGQXOSWR     CNTVYUCQAUMBEVD RLXNFVTFXDFRORU UWBBMSJGWBY    
XPMFRN          : DFKCT           JCTY           
WTHLFKQS        : PREC            KVCUW           CJGCLHMBQB      EWRKRQSTSNWR    VICYVMNHDYS    
UHMBJOXQII      : BCSFRFMUES      LXMNUECUHDGHR   GAKVY          
UQPKOHY         : CIBJC           OHBBTXUJXN      CPDOSYBHEVUKNBQ CBEJDALJGNCT   
YOBVJLK         : LKQJMHIFIOGEQK  MBKHGPLLGASXRGR KAPICY          OBBAGIHKSG      QIHGW          
XBJHVQUYCLW     : XOITOIPSJ       VTCKVVHMTXX     FORU           
TGQQYGENNDIO    : KJUCMDF         RGKOVG          VKMNDWQKQJSLXKL KUUQ            NJSCGYASDWA    
LNCYXS          : PMHANPGXFRRX    RXHQJLRT        OKOOPPNPAE      RLGNT          
YEHWWEVYQVSM    : FLWUIGCSO       AKDWTTUF       
LGDRKQHPBVI     : RNRFKHC         LFIXMFLHNIWHRQ  BFJMCROHQQLPN   YQDNP           KHKO            SDJE           
JMOHHMILWFIB    : WGGAARNMHMWWOWF OBMKVRN         JFEVEPCJCVN     CVTLIDRUOAN     RPCSRYUGRFK     SEUVLQQB       
ITADHEONJIA     : FWGYRN          RLGHGWO        
PPELBT          : CKVDNFAQYIVFBSJ DXSGEHHSV      
NIFX            : EDFVHVSAMFJFDJ  PUDKHYKK        LIMHBI         
QJWVUXAFSC      : TUTOMJQHOMSODC  YELFTDPNYCL     KKCQI          
CIYRRH          : PWFXFALLWSKSETU RQRPH           GXVEAQUHPD      PGTXQEHXDP      GSQKB           VKODGXENLYVFY  
UWJYKKUIBDQYD   : RWIXLICKBILDNW  BULXL          
KADFBGKTKUXTTPN : OAYTIWIQLQ      SHOLFFFCKYWQSS 
JKXSLJEGRFM     : UPUWFLKVMOCDK   GKQG           
GRRQSXWTEJPQFPM : XVFTKWKA        KSAIMOVBT       MDDSFJK         JFOPYHBIR      
HDBQNY          : PGHMVX          GTTKUO          DYHXLWMFBJXKDK 
CKRK            : WVHASVEXG       XOITOIPSJ       TRVXAOGWYM      XKNYHGVGDQYJOE  RESYOTBADM      RJUXWIJNDBKC   
WWPF            : PMHTOMDAPIQOL   AUNLQVBUFQPOO   TENLYPHS        VKXPOC          IFNQXLLQRR     
IWKGTGMDXDI     : EIFNCLIIAVIKKN  CBEJDALJGNCT    EYUQKMEXUHATVF  PASURTTLU      
SIWVL           : AOPIIGLHQ       MVLV            TTWEGDY         KQRPEWAAP       EJSAW          
JMBNXT          : LKULGYFERFB     DBTE            GAKE            MBCINKLMEU      DXAUYL         
FSXUYPFV        : HIXYWFPQOFHNKI  SLCLYJVRXHRY    FIRYYJI         IVXILTFWKCG     UWYLEGROXBVYV  
NRICWIGGXYQUW   : ARFBNAKVBNI     KOPTTUPXKTJM    YDPW            OPRMCDYVELSR    KIBVXXSXTVPWB   YLLAG          
KIQM            : OMPPRLSYKEQPF   XGMGESFHGSOPJLY
OIVVBTTAMYXOPR  : RNLEIXRKEWC     DBMLKKOMSTIGXX  RLGHGWO         XQNWBOM        
RPIAXJBOEXSPH   : QVCM            MAPJGTBY        UCPDRGSNMQR     XBNYUYARN       DPHNSOKLBMKSUA  TUITWYI         NFCIOHEJIRGXCL 
EEBMCY          : SODWHKPNLQGUDG  HJLFWN          HVMXAITI        RFMQ            OWFN            HMXFJFF         QSOVUVYYHYCSNYE
XSSKSQCKJCCY    : PFPQLFNHINFAX   SASHXGMSJJEDRIA RGEAKWYLSWE     HIETHVTCMJWQUQW KJOK           
DYVENBDISKT     : HYARSDBSWYK     VHXVA           QULIJVMX       
QWLSWBQ         : GVONOPDXWMK     MHTXCCR        
VCKNEUYIAAUDYTH : VLGB            OGTXSP         
UMYPYUOPSCIRFAJ : EWEDCJ          QVUPBT          BDJGFQRQLKCKTFC
EWRKRQSTSNWR    : VUHGBDMTKL      KAPICY          SHOLFFFCKYWQSS  WTHLFKQS        PWJFRHKETBIDHX 
HIETHVTCMJWQUQW : GWVNYHQGM       WQRIFIGDIUXSNF  LQFAUJ          XSSKSQCKJCCY   
BBYXSJRLEMG     : UQMDVHXJUFOAC   HWVIMEWEJTIGK   SUVRJTIXXNEYKJ  TQVAXMKYL      
LAESIIP         : LVFCYKBJWQLXCXP PVQXQAQPHS      EIXKHEGCYETK   
HJVTUVNPMKM     : NOGSWJT         CRMQU           JHIJLOJXIIWCY   DVANYAPNSNKUU   NDGACXGHVHGM   
NNNI            : JXPUKYTBM      
ITDUAXGCCCKM    : HFJGC           KJTMI           UEXIK           COGNPAXAMF      USDQTTYJP       AMNVYIDF       
EVDAQAVESJQFYGV : IQUFO           LSAFIDBLNRKMUQ  KLGKYXWHLIEMSD 
OUVI            : WVGAYAEWI       NSKMEYSKAXN     YGCBN          
SKBB            : NMGUBX          PCVQ            KQHYJPKUBOV     GQEBVXNXGXVRXB  SBFEMUR         FVIUBJPIXPY     GFKONWPBETYAG  
FDYRWDOCFHDCNVN : PVCFKUNLBI      KVXJE           DVANYAPNSNKUU   XJDX           
DMMBCBWALAUXBWM : QENUYWF         HCBKA           NJGKH           ALAWMJLXUTNB   
CLAAQQCVXHXNF   : OQOXEJAJRGKGT   JNOVMOWYGUGT   
TJBIKDJJGU      : RPJOPQW         BPAGAUIBGQBO    IEMQ            UIBYCOQUWCHSPI  AYHX           
BSMXFUDSXDL     : SLCLYJVRXHRY    NNBD            GBQLWBBJVSUFIIQ
HIPRIDWWA       : WEKQKHTQXDHMEPR EODSGSWMR       LLWRYRAPJCTCOI  AKSQEPJERUI    
AITFUFLPRNLGNS  : HOFSUIUI        APKQTBKCICBPJXI DBTE            WVGCEQSFAGRSE   PLUIPXWMLTAJHG  EYUQKMEXUHATVF 
QOCVASEKIVV     : CVVINJIQF       IALAQLYSPYMG    QWCONUOFVMF     UEMFDN         
SSQCU           : TEXFVUOTBQP     BPRBRHWUXJGKHK  FLREAMWNULUNEP  FXOSPUDQMCIJ    FSWGPUUPCUOT    YGUPDTVADPS    
XAVDMOWCCGPU    : OXDAQHQXVXUIJ   IVJNACTHUVLUBRR UJXEKXECQPWD   
HLODMJJYS       : WQJSRNNA        RBAUPPG        
UJBPCFKDFLAKA   : UGYY            DXKFAGKMANNU    EFJEQAIJQBHNTIH
ICSQRPDBCR      : GMYBYLXACSMVII  MPOETDVCYEWFUJ  DPTVGYSHF       ADNIXUWDHX     
OBONVWLHABJ     : ARGEC           HYARSDBSWYK     ISIG            LEWCOPHO        UJNFRWSKWMLE    BIRBAUGBKVQQ   
OPMCRWCIHG      : DOYOMAHQRR      KXCU            JRCHXBNWFRD     UPIGGIEYQYQ     HDKK            DFDJLGTA       
XXSBCUUHL       : NLASHVNU        HHJO            HKKEPNWK        JWTEVJCRFTI     NULNEFJL        LUWHFBLO       
XAWWNFWOQGDI    : UIVORQHQVEPJUP  SIAGJFQHBTXTVP  CMPLOW          HXTRQDJCJ       FPGO           
HASJ            : KWHPBIBERAUGX   SHIDYKC         UENCVUMDQWTKXNW UNJMRBFCKIR    
CPNDQH          : POIPWJGSY       GVRAQUHSKYEGXTE FEPVOI          AMNVYIDF        GSTRSJRIYLJ     JQHVYHI         HWOBANHKSVR    
SCCCOBAQA       : THKSCSTA        GAGMMQV        
EHWUYG          : ESVJXQPAROBLF   SGBNYSSRCOT     UIGMX           HXTRQDJCJ       HWVIMEWEJTIGK   HPTPWANLWSMMXH  GMHPNBMUUV     
JBIKVUW         : LTCXBYSIGCMVL   DWPYOQVGNMRJLQI XTBGP          
MLCDUIXWMCNN    : OSNF            BTRHJJEGTXIDBF  TYHXRXCSLJIWWQ  BIRBAUGBKVQQ    KNOOFVM         VXJBG           TJUC            OYOFQBUXBXXUUTE
GQFMXCIYKLJMTVK : AJDRA           EETSQEDDKWVBE   YXMFFKQHJ       YKWEYFOSLAF    
SJEGNJBWIBJMOAR : MWSQWGMYOLDIV   TVTAR           KJPOEWSHIECCC  
SWKQCUQMGCBDX   : QWMLEAHR        MRQGARTUJKRUQH  BQLGNNFEBYC    
TQVAXMKYL       : DDGDBPRLMVIX    BBYXSJRLEMG     PJYAFT         
CWHRWARR        : PLUIPXWMLTAJHG  UFJISFNESLCKEA  HQGASHWKWDKBGMJ ACXXBSFGQD     
CJBACO          : LCOJLYDKCJ      NSKMEYSKAXN     RSKYDJVUJ      
EPLC            : SQTIMBUWWQB     HXGFBFRWP      
IUBISPSUBPWX    : AWSUIVKKQ       QCHMBOQDHJJY    TOLXYW          NRKGMESEXVH    
QXAIPWNYBNBPVHH : IAYO            VKMNDWQKQJSLXKL MPCHBTEMVN      KIJECAEOPJJI   
JMSFPDAFYWGO    : DHVAKKML        AYOAHYACDHCPYDO WOSJFFSBEBEJRR 
GMNEMYUMOVN     : LTCXBYSIGCMVL   RKHAIAO         FQYXMUYWNPRQ    CJGCLHMBQB     
AFAHOKTBF       : QYEQX           MUMNMPQTUDW     YDXFQPDWBCPKTYA USPCLYUN       
SJBXKYGYVPOL    : CTJFTDPVIHTDWJS WWCDJA          BNKKREHA        PHMDGESESUQEYGH SREUIDVS       
DMQRBNHFPMG     : JDVQWNL         BCSFRFMUES      OMPPRLSYKEQPF   VOFDFDRTDCARB   RBMWTSRR        NIYGAKDRHNJHG  
ESSFYTBKXBWYI   : DXCOI           JFUUEVUNWOPANR  DWIGQQHUR       HQVHCFMDBKEFBH  AYYJDCWX       
WXMITSVLKYBSFSH : FRBCYACDRJAOW   UMKKEYRTS       OXDHFPBFPT     
RLGNT           : PWFXFALLWSKSETU CUQCVFRVOAMV    MBKHGPLLGASXRGR ATMILEDWBBWM    LNCYXS         
JUTJV           : OMPPRLSYKEQPF   IAYO            XTUBNUMFKOK     AUMBJHEJMSJFFP  CXMAPDR        
IGPHGESDWQOIPR  : XKGVWMXDYNFOBA  RNLEIXRKEWC     KQCWR           TVCLWM          RKIEEGNN       
UMKKEYRTS       : ENYPMN          UTWG            NCKTTPSN        WXMITSVLKYBSFSH
GPVP            : DYAAOF          CTJFTDPVIHTDWJS FYDWHMSJ       
OBUEIBJB        : YHHJMFC         GULINFLRMJWHHLD DXOWHEJYVN      URXLTDQAC      
IRUS            : KATTSFQBWOAJD   ORPTJYERDSTB    NDHCAIIFJOYIAGV XJEINK          CXEONXVRTD     
OVHBJSII        : JQVTUXEXNT      OGOTCWQ         GNSMBGM        
EBLKS           : AWCADKAFCPRMD   XTKXD          
DEYEBFM         : BCAKWHVBKIP     SFCFR           KWGYABDTSPP     JEDMSDBGY       WYSTPPODCF     
QQLAK           : JBSAOWQCU       XJBRXHEMMKJVFJ  JOBKUDXEUFQ    
SUXPDCYVMJIQM   : OTMKA           MTRYMIJJIEVDUF  WISASVDQLMMR    NBFWD           QVUPBT          BDJGFQRQLKCKTFC
EFGHLFLNMAS     : GODFTVULUXSKIMS JJREGB          UQPJNJ          CRORGSWIIQEK   
QEEENWY         : HWPEYSHO        QIHGW           CUMMMRE        
OEQPCFYK        : JUTNFYDIK       QTSGSIWHGMFMVN  UYHCKOKHHAKUYH 
NHCSPJFWWUJXNNQ : NKVUHBYYHEAAFT 
TUITWYI         : MBKHGPLLGASXRGR HCTJYHR         RPIAXJBOEXSPH  
PBEUCQSQAVLRHQ  : QBKKKHKM        ETCVKJDTTJO    
FNYDBOV         : HKUJMIYANBNGRHT PBLUEOIIXHPJT   XWIMLRDLSAP    
JRIDOH          : ECTSQRPBNKALRB  FIET            PUBLD           GBQLWBBJVSUFIIQ
RYOXVTPOK       : ARFBNAKVBNI     PYRLRTYXWJ      WUUU            AIPTQMPUPI      MMDSNFPGG       EKPPAHBWQNUCQ   KHKO           
MVKUP           : XMYIKXGSPWHV    LTCXBYSIGCMVL   RRMRCMREMDCNML  WSKGFWNULKIYP   VACSPJOFHEJ     ILSNBOQPIBDOVD  UIBYCOQUWCHSPI 
AFAFH           : OYOFQBUXBXXUUTE
BHBUP           : SROUWCHGNMV     IQLW            ACWWMGFNOCE     XGGTDJKPUPKOC   QRHBFT          MHABEMBHWTRS   
JWTEVJCRFTI     : KVQPE           DYAAOF          FLOBCICSFSRF    LOLQU           AYMVVBHLRRPSPVR XXSBCUUHL      
OVNYS           : KRMHNQGNQWFBGFS IIUIHCO         AFXJN           ILSNBOQPIBDOVD  PQTOUR          BIMTPXDIA       OOJT            PUTP           
AULDA           : RDIJVLNUPEYO    MHTXCCR         QDBBUAMQKCLSOQ  LHBGQLK        
UDCXYTEKQ       : BBKMY           CJBRMLJEICVEY  
OOJT            : LCOJLYDKCJ      BSMUUY          TLCYXULJIINVDCS QVUPBT          OVNYS          
ONQGEOWD        : UNKESVT         YLAUTEAPYQRGMOX JWCSCYIXQHW     HHHQFIFCEEY     JCWYIHAPLLEUYOE
EGERLE          : GODFTVULUXSKIMS BTJNFKRT        PQVHNMAQVXFF    EFJEQAIJQBHNTIH HVXIYJ         
GKQG            : VLDL            JKXSLJEGRFM    
KKTDIJTSD       : ENWHFEEGQWSBG   SGKYRUEBDMJXEY  CTVPFQVGDPKRR   PFUYWOK         OPVGM          
HSTQXKNDSR      : HMXFJFF         GNSMBGM         DXSGEHHSV      
YKWEYFOSLAF     : AEEYONWPVLPQJAU PPVRB           JEJKIQOULHRCAPU EIXKHEGCYETK    GQFMXCIYKLJMTVK
TJFFF           : WTHSYUNXACIJ    KBQRC           MSVPFWKUNKF     IRITHSP        
KIJECAEOPJJI    : NQNFCGMDL       QXAIPWNYBNBPVHH
JUSNTYEOMEUJA   : PPQYVQNOBHDJCR  FBFAELADJLUJV  
QGLQQT          : RDSCPNSSCJKNMQC GHUT            AJLBYRBWMJ     
WXDBNSNWBJGX    : RJXACFIWTGWXS   WISASVDQLMMR    OAYIKFGNFQCVBV 
VUFCJSIE        : XMYIKXGSPWHV    SGBNYSSRCOT     UAKWIBAKIPPEDQ  TWPDTCY        
JKUPYLISNG      : DQNJD           WQRIFIGDIUXSNF 
QJHKWGNIP       : DGJRNAXCQGI     AVJNVKRDKYRX    BHYGKJ          OLBAASHKN      
NLHSQSNYXRIKMAJ : BAFUYGBWSA      OGSNYYMJGRBBVOB FPGO            PQEHJKE         UNBVRVAMYKAEX  
JFOPYHBIR       : AOPIIGLHQ       KMYQCIUTLGLTCWQ GRRQSXWTEJPQFPM MKAYQNIHBKVVHT 
QIHGW           : YOTCGQXOSWR     YOBVJLK         QEEENWY        
UEQLWGKW        : JFUUEVUNWOPANR  JESFRYQNDOFREX  WOQGV           EEAMKDCN       
TKNTTOFBDUCKYMF : APXCNKRAP       MBQHVVUSLEGEGNI XAPSISJWQM     
ENHM            : KJUCMDF         NVXFYLPY        QSSCMUPOGNAB    OKOOPPNPAE      QGKWYGQRQ       QEXYSQJBTEARN   EOINXDTI        AAUKWSJIFUCJIU 
FHQXSPE         : TRVXAOGWYM      LJWCUS          RBMWTSRR        GNRVAOXGIKRBPT  PUTP            XMRDRSCAUDYKS  
PDCARVV         : UBLYFMK         QICFGHCSRJUQYX  WBQM            UEMFDN          NNBD            GVBAHCVLCPCC    IVJNACTHUVLUBRR
EXLBCXAPDXVS    : TQLGOHQRRDJ     JSTKGVB         SQQBMKP         OHNDU          
IFNQXLLQRR      : QIDHTSGRLPABCO  DTHFWNILADXB    WWPF            PQNUDQCSCPFNP  
VTIPSGXYG       : GOIJ            VITVGEQKKIFG    VCWQRLAJ        BIMTPXDIA       MLCPDLKAPUI    
AJLBYRBWMJ      : WCUEYBHB        DOFFW           QGLQQT          GREQSYO         LPEAFY         
SYXSKM          : NJHCYND         XGMGESFHGSOPJLY PVCU            HQGASHWKWDKBGMJ
DGTBDESX        : EDHJGCDNLWOORJ  KSWDTCTDQ       EAIDGR          IUXJDHFKNTPEYBJ AYHX            UWYLEGROXBVYV  
SWRGWBRACJ      : FPPUE           VPHSNY          IXOVSEBBXJS     UDOKR           EPBCA           WKFIIW         
YYNHRNFM        : FIASFW          NQLVGBCUS       GBQLWBBJVSUFIIQ
TYFBSGEXBCLVYD  : JPASDYMHAQYTMHU AYNSOIXGMQICXV 
XHWYJ           : KQTCTLKMBWGSHA  RGEAKWYLSWE     KDIEPRYNQGKQ   
BLHOSBEAO       : LVUNGPDAUOKYJM  IHHKRCEK       
UPKVKTC         : ICPCJOYWAYP     WVRY            WAPRUSVFHU     
UEVTFAX         : MRDGPJGXGEFSKL  UGRBMGMXA       EKPPAHBWQNUCQ   GSWVVSOMFCRI   
HWCSIFGPUB      : WNXXTIOXSSMFUD  RCKQJALLDXHA    VKHFORBN       
BCKGYAR         : VUHIMSHOW       IIMHJDTDUQ      NVPIQGOVM       FADPWKGKH      
MLYXIF          : WOQGV          
CKVDNFAQYIVFBSJ : HUSMFN          WOSJFFSBEBEJRR  KCRXFMKAHL      KVOIDV          VSETVAIAHIJLQ   PPELBT          CCFME           CQLGMYRPUL     
ULHDMJUJVG      : LGXS            KKBMW          
TRPQVCOYP       : VPOYU           KVXJE           WLIAO          
CIVMHDPCMMYAVDM : UJDFSRCIAY      STJOWHWBY       DPWOTYO        
XXEHKXBCQ       : BXLKI           NLDEAGF         RJILQFGNYDSVSXC AKSQEPJERUI     EBQE           
EGYU            : WIKFJ           FCKP           
DFYRM           : CVVINJIQF       XBEHXHOLQCUK    JSHYFFRFHJKJF  
IRPWQRTVFBU     : OFUBKMAH        XVFTKWKA        UBWI            MEIIGIM        
FEQGF           : OGTDURC         QKVHMENFFPS     KFENMYWLKNJB   
YEXFDUK         : BMOVHP          FEKATT          WRRIUUYK        VROPJ           UTAOEKPBKPVK   
CJBRMLJEICVEY   : XAMSI           PRUCETJLFOUQY   RHEKLESGBJDURJ  UDCXYTEKQ      
IVJNACTHUVLUBRR : TNUNWIO         TJHC            PMFNJUYHYJGLLVL XAVDMOWCCGPU    PDCARVV        
AUXBMMMXSXAPE   : HVMXAITI        KJPOEWSHIECCC  
UMWGBWIW        : LLLPSTCYAQING   VSBQYSYJWYIUPHU MHFSEXVKYRJKJCD JINVFWG        
GSUDWMVLO       : AUNLQVBUFQPOO   UQSNBOSKKJOEG  
JSHYFFRFHJKJF   : CFBM            YOTCGQXOSWR     EKFYYWOOLJMEIJE DLIRKPWVXYBA    AEPFPJLVSMETII  DFYRM           BLSKIOE        
GNAG            : TJQS           
AMFSHIRVG       : KLCKKWFY        MQKOXCE         QSAQSCIYWHH    
LBPEIO          : WAPRUSVFHU      PJYAFT         
PGTXQEHXDP      : UEQODVFTSWTG    PFBXOLJNRQWU    CIYRRH         
GVKG            : IXXBCH          LTORYQ          TAQF            FRRTWYSCBIQQB  
RBSBTPJYDLQHVFU : RVCHAEEOOEAEGJ  JBRXOGAPQ       YWNXLHSJL       VVXHVJOUOU      EFJEQAIJQBHNTIH
OOMHUVHYLU      : WOAXHURE        OEMANBXYYWTSN   HJBI            KLVYPINTPJK     YEXBADVFOUQCDR 
IGNTXQMBKCN     : CCOYRSYINEUB    OBMKVRN         WVHASVEXG       HLLQWLEQAULXAA 
FYDOWLKLAYXJW   : VVNAWUO         VAVXIUAWU       XKFXUI          UBTQJRUNURNIVI  CAINHMKIPJUG   
QXILFSTUMS      : LVFCYKBJWQLXCXP QABNBVPTVNHYRF  HSPRAAHTEDPSFFI
YVYEJNLIQBICN   : WIKFJ           WTHSYUNXACIJ    VSETVAIAHIJLQ  
EOUNL           : LOYT            YMKFVDRPMBMYSNO XNNVSC          JJVANTTXEXAHA   APCTLNNMG       XFDOMPHJ       
GJYSQTOLG       : BCSFRFMUES      IXYGN           UEMFDN         
XIEYM           : IEGUWBOGPCYTIE  JYTPAGUMDUER    QWCONUOFVMF     IUGNGE         
MAYFDJIQDO      : LIIJLVT         OKREIHCOHWDXM   HGSPFSOWIUT     KQTCTLKMBWGSHA 
AFTR            : YEXBADVFOUQCDR 
GSGWNVJTFJC     : UVDMUYHQQTCHB   VJLJL           NVYHPRMATX      FCKP            HJBI            AAVRKAL        
KQCWR           : IGPHGESDWQOIPR 
CUMMMRE         : TTXYOTDOLKLXCR  UBTQJRUNURNIVI  QEEENWY        
SJQKWYD         : NKSQLOQJ        BEIQJYLLCS      EOUIYISJPIG     AHQVQUPBIX      PJCYWRTY       
WSCI            : FJPCIY          UNKESVT         OQOXEJAJRGKGT   JYPYVGFSUMNG    OKOOPPNPAE     
HTRTELV         : BFUYGDSUYRDWQ   OCPEDQUFVIII    RESYOTBADM      MKLWHNVUGLGGT  
DYHXLWMFBJXKDK  : HDBQNY         
CQNB            : RJXACFIWTGWXS   VUONYUIX        WISASVDQLMMR    MKLWHNVUGLGGT  
PJYAFT          : XAEUMJGT        XKGVWMXDYNFOBA  MODBDMXD        TQVAXMKYL       LBPEIO         
JFROIQ          : UQMDVHXJUFOAC   AJDRA          
IETX            : IAJDXKWCMOTOCTC USQGMFFN       
WHKJMUSRLHSVY   : GVXLMAJ         TYIWRPJODLYS    PYQLBULOVBTPLS 
WYMQSW          : JEDMSDBGY       IEIEHNRFLAEYP   EIAFWFKBUOR     MDDSFJK         RLXNFVTFXDFRORU FXMFSRFGYH      AVDUAGKKO      
KNGDM           : JDVQWNL         CRORGSWIIQEK    NAEEFHSTREIGW   YFFMF          
JINVFWG         : HMMKSXKWVPOOTY  COVDKTGEJ       VUONYUIX        DASVLCKFWED     UMWGBWIW       
KDIEPRYNQGKQ    : OSNF            OMPPRLSYKEQPF   SPQDGGTYIMUNXVM XHWYJ          
EJSAW           : SLICXUR         NKCLE           GNOBGCAFVJB     NFFUB           SIWVL          
JCTY            : FIRYYJI         ARMOWFFJHYFAFX  MBCINKLMEU      GXIIKTS         XPMFRN         
CMIILQYX        : JPGIGVFDRCMFU   MIIVUHGYPFLVS   VSBQYSYJWYIUPHU
HCLYCYSIMJ      : HTGHJPIUPGPEG   YDPW            TQLGOHQRRDJ     ARMOWFFJHYFAFX  CXUUPMXVUT      GHPHWPFTKXAX   
SUWUREEUADJC    : VRIYWMHNVWLPL   EEMXH           CAINHMKIPJUG    MLCPDLKAPUI    
TMGK            : GPBBS           PASURTTLU      
EGVHSXLTQV      : GLCK            PQVHNMAQVXFF    RQSHCE          EEAMKDCN       
ABBW            : VACFFACLVC      XUBFTOVFUMHG    DTHFWNILADXB    QEXYSQJBTEARN  
WPEBMG          : HOJFQBVWU       BWRCUVRXF       VFFWBBQBHAVDFN 
XJBRXHEMMKJVFJ  : WQJLXJYPRAVLRVI WWJKWIDDMREHM   PLUIPXWMLTAJHG  QQLAK          
CCFME           : QGYJMTCBRK      BMLHQ           CKVDNFAQYIVFBSJ BPQBJSSWNWUNKOT
OBJNQPQF        : YSMJXYH         ESMVAOQFBJULVSN
XDIAUGHBVVOF    : FFUOBMKFVKLAB   JFUUEVUNWOPANR 
VQBXSJLWRC      : XCRFEESOOKTLFVB XRWOCGG         OCMXF          
DPTVGYSHF       : SYYUDHOGP       PQTOUR          ICSQRPDBCR      UWBBMSJGWBY     YOAAXNJBVB     
HCLQEHNSOHQ     : WRRIUUYK        STPRWKJAEDIKX  
JPASDYMHAQYTMHU : SVTTT           PFBXOLJNRQWU    YJOY            TYFBSGEXBCLVYD  NBTJCDVP       
OCMXF           : HCBKA           SUVRJTIXXNEYKJ  JCWYIHAPLLEUYOE VQBXSJLWRC      SRDVVNB        
RLGHGWO         : FAJY            JPHNBPKYDLGVRV  MFEMJNPJGHTD    HWVIMEWEJTIGK   ITADHEONJIA     OIVVBTTAMYXOPR  HIGVFTK         IATNJRGEBEIN   
FXMFSRFGYH      : FXOSPUDQMCIJ    LSFHPHHFTKQSB   HWOBANHKSVR     WYMQSW         
ADNIXUWDHX      : FWERJOEOHT      HYSANHBHPEKNU   IAYO            ICSQRPDBCR     
HPTPWANLWSMMXH  : DLTXSXFPU       FSWGPUUPCUOT    EVCUBV          PVOXBWQQQTSA    EHWUYG         
FPGO            : XAWWNFWOQGDI    NLHSQSNYXRIKMAJ
GREQSYO         : GMYBYLXACSMVII  CBUYECNMUOQW    WVGCEQSFAGRSE   AJLBYRBWMJ     
IMEQEAIBAV      : UQMDVHXJUFOAC   VOPDJXEBVPQ     ONHCOMXWHPJUGP 
YQDNP           : MBKHGPLLGASXRGR EDELI           LAJWQAPRB       LCTTJSWXYAP     LGDRKQHPBVI    
UWBBMSJGWBY     : SGROXXWAXGEM    IEGUWBOGPCYTIE  BTBKFDLIH       JCOSILIIEYOYMK  VGSICMFR        DPTVGYSHF      
RUJGBCKBL       : NFFUB          
DHCFYGSQTNP     : KGWFNOVD        IVSMLDJXSTSYA  
QCRDLRGKQXIAGJ  : TJQS            OBLESQAFDTKLX  
SNQGSXK         : SLKWXBTMUDBLKCN MTONOATRMPFNFV  UJNFRWSKWMLE    QSSCMUPOGNAB   
YSRPMHIMYMEEX   : LOVGJXSGPHPDJQT JSTKGVB         PBVOAVUL        GAKVY          
KJOK            : LGOCFAGTUAJEFSU XSSKSQCKJCCY    PFUYWOK        
RQDUJ           : HHJO            TTNOLSSXB       KGYMQFDJKBJFHK 
NRMLCMN         : CIBJC           RJVYCIKQBGL     UAOQTORTI       MMDHCKIFVIB     MKAYQNIHBKVVHT  KVNNLLRWOIFEWOU
GFKONWPBETYAG   : TYWPWNHCUHV     PCECLQAX        SKBB           
PQEHJKE         : CVVINJIQF       GOIJ            CPDOSYBHEVUKNBQ NLHSQSNYXRIKMAJ
DRMRFOFSMLY     : QGYJMTCBRK      FAJY            XAEUMJGT        RALWJGVRLURQY   RGEAKWYLSWE    
AOWRPBN         : UQNWIJSDMVY     BJYBCYVKQSG     JUIJUYPRBE      HHHQFIFCEEY     KKGRIBXJG      
ETCVKJDTTJO     : CVVINJIQF       WVRY            TJQS            PBEUCQSQAVLRHQ 
BDPIUWCHIDHL    : CWMOTFQFUCQO    ASUKSX          MSRPADY         XBEHXHOLQCUK    RNAFRMTFJCGQ    GWFSWM          WINSUOVWBFI     EKMFICBB       
HDKK            : BRXXA           OPMCRWCIHG      EOINXDTI        HAWFUPRQWEXN   
CQLGMYRPUL      : KBQRC           MFYMMAWFLPQV    ORCJXOHYQSPM    CKVDNFAQYIVFBSJ
MLCPDLKAPUI     : SGKYRUEBDMJXEY  MIWSMQKLMLIECYC JBNHRWSTEEGQA   VTIPSGXYG       SUWUREEUADJC   
CVOLABYT        : NNJMEN          KQUBDORWPIIVCK  QIDHTSGRLPABCO  CAPEHGGCSFVVMJ 
PHMDGESESUQEYGH : UDVLWNHFYULM    LLLPSTCYAQING   FUPXSQFTLV      IOKTID          SJBXKYGYVPOL    XAPSISJWQM     
RJEMTYQQ        : JBRXOGAPQ       WMHCJSQPLPKVMWK FCKP            SSKKTOGJPEXA   
FSREMXTV        : VTGNERFAJ       IDMOHSVVOILPWP  RIDG            GULINFLRMJWHHLD GQEBVXNXGXVRXB 
WFSSJLPAR       : JTJODHMQOOLQE   HYARSDBSWYK     HWQDGHIFSL      POXWMBKXEFX    
IBEAKIO         : VTLWX           KQRPEWAAP       JNMORCIMOXY     DASVLCKFWED    
KIXDNQ          : PQLL            KURFBRPFLBSI    VHYMPASDNPHP    POERFC          CAPEHGGCSFVVMJ 
RFUNBHNGDGPOX   : SVTTT          
JOBKUDXEUFQ     : OBNSTIBFO       KJPOEWSHIECCC   QQLAK          
DTSTQ           : EYQEKCHLVMRIIF  RJXACFIWTGWXS   EEFNNA          RACFDKLG        WAHKIUEEXV      RJUXWIJNDBKC    RVSKHPJBVM     
YOAAXNJBVB      : SLKWXBTMUDBLKCN UBLYFMK         ECTSQRPBNKALRB  NKVUHBYYHEAAFT  DPTVGYSHF      
TVCLWM          : NBFM            IGPHGESDWQOIPR  VCKGKCSWPQF    
CMMYRDCUYWQ     : NWYHTJQDV       QUCTQBXEYXMQ    RGJBLOWXDAG     YRGGMVYRWXMR    GMHPNBMUUV     
JPHM            : LIASQC          GENAHGSGE      
FAEJW           : ORPCGVYJUJJSMS  BEIQJYLLCS      RMOJVFEQTHKDPJQ
ASBEEA          : DNNSDCE         SYYUDHOGP       IAJDXKWCMOTOCTC BNFGXVFGXOE     JNOVMOWYGUGT    QEXYSQJBTEARN  
NDGACXGHVHGM    : NYPSPBNAGMRFCKB ODJLHNXMOXJGOWP USPCLYUN        YFPUMGWK        HJVTUVNPMKM    
QFLDXR          : VVLQBLVLCMQ     QIYEHDIVLKSQ   
CBEJDALJGNCT    : ARGEC           THQBBIXIL       DLFQXRK         UQPKOHY         IWKGTGMDXDI    
IUXJDHFKNTPEYBJ : VRQJJPJFIPUFQ   AAVRKAL         TOLXYW          DGTBDESX       
SRDVVNB         : APXCNKRAP       NVPIQGOVM       OCMXF          
BKFQNYK         : JABCLPNCNULA    KUUQ           
VIHY            : LOVGJXSGPHPDJQT GULINFLRMJWHHLD
MMDHCKIFVIB     : BYXSSTSW        QJIOKLVIGLAQD   MFYMMAWFLPQV    UAKWIBAKIPPEDQ  CGQUT           KLPSGTWEP       NRMLCMN         KIISFWGNWSGHY  
NWMBBKENPVDPICN : NHSDRDMUPKVYUH  IEMQ           
JPIYENI         : TFEKVHL         WOSJFFSBEBEJRR 
XQNWBOM         : GCEEMV          OIVVBTTAMYXOPR  HHUFJJWONI     
OYSPKXFCVJ      : WRHEVXPBCO      GALNYV         
ELIUWXFXC       : YDDIXYOUJDLFWG 
GMTAAQBPDQEF    : SASHXGMSJJEDRIA LSFHPHHFTKQSB   IOKTID         
VRKBTGMO        : KWHPBIBERAUGX   QGYJMTCBRK      QXRGMFMEWKA     LKULGYFERFB     OXFNC          
AYHX            : DDGDBPRLMVIX    TJBIKDJJGU      DGTBDESX       
OXDHFPBFPT      : QTSGSIWHGMFMVN  OGTXSP          YEXBADVFOUQCDR  WXMITSVLKYBSFSH
HAALFMJY        : TUHPEE          OMPPRLSYKEQPF   LGXS            HPCFTSPDQFXBCMN
NUFALRDKBDJPB   : QQVP            TMMMFUTO        HJUMHU          FLSKJKVE       
YGCBN           : PXLIMGAMMI      QRHBFT          OUVI            CIUMDPNBV      
WWCWWQELAFIPBPS : QNRBQ           FLWUIGCSO       JNYLCQEAGSUQ   
HVXIYJ          : TJHC            MYCF            BSYDWYRMNHNM    XLHYFDF         YHXNKCSYAXM     EGERLE          BLSKIOE        
AYYJDCWX        : UYHCKOKHHAKUYH  ESSFYTBKXBWYI  
TDYSTGEVLOOM    : YDXFQPDWBCPKTYA JXPUKYTBM       JVTW           
HCNDCX          : TGEBHK          UOOPWWIWWRPSSHO EEOXFWFWECE     VEOAHXGNRHQV    NRHIRTNDBQPDA  
LXCKXNQ         : FLIPMCN         EFEJFT          PSUMYOBEMI      HIWNOPNBD      
LQCHTCBPKHO     : CKPXAQI         UPLGQPIOHYFNN   QWCYJDGQ        DEYRQNQQXSKSJ  
WDLDK           : VJNB            BYXSSTSW        DKQB            RMKQSLDP        NFFUB          
RNRRRDQVQOKHQ   : OYHHXN          XNKKXJASHKKH    FXBLLGI         PTVJDTTL        SMLYGF         
AVDUAGKKO       : TLHVLCOCJDJOEYS NVMDYM          WYMQSW         
INCVSOL         : QWEECNBC        QSAQSCIYWHH     CRORGSWIIQEK    XJDX            GSQKB          
EDFVHVSAMFJFDJ  : NYPSPBNAGMRFCKB QWHHDVT         ODBPOCWNK       NIFX           
IGBPR           : LLLPSTCYAQING   VCWQRLAJ        OCLO           
GSWVVSOMFCRI    : XKGVWMXDYNFOBA  URVB            UEVTFAX         CATUSG         
NRHIRTNDBQPDA   : MSVPFWKUNKF     LSMKDIJQKD      HCNDCX          UHMW           
GRNUXJRVFKKT    : EHKNTTWMQ       JVHVCDF         HDPKAWXXK       GENAHGSGE       LGOV            OJIWNMDWCH     
OLBAASHKN       : MIWSMQKLMLIECYC QJHKWGNIP      
YSFRIKTH        : KTJIWGMWLXYQC   VRIYWMHNVWLPL   BPAGAUIBGQBO    VSBQYSYJWYIUPHU UPLGQPIOHYFNN  
NULNEFJL        : PMHTOMDAPIQOL   XYOXJLIVAVROGTJ XXSBCUUHL       WSQEVESGUOL     KFENMYWLKNJB   
WIKLTLMVHVHWAI  : PDYBSIKXRBHXTRN PSUMYOBEMI      DTVXDUJHBWCEAL  DXWJTKKMNT      HJWMUBD         TTWEGDY         VXJBG           EKVUR          
FADPWKGKH       : CBWQIJNVWFH     VLGB            BCKGYAR         DTEHBXFTIOMU   
YMAKA           : QSKXIOXSQF      HYXH           
HIGVFTK         : BBBFJGUACFBRU   TQYYMU          RLGHGWO        
DGICGQULTX      : FLWUIGCSO       YNMYLORTAERRSN  NFFUB           WLIAO          
SIKFPHGEJRHFY   : OQOXEJAJRGKGT   CWMOTFQFUCQO    DUFBSONIVDPTX  
LUWHFBLO        : OAWAUTW         RQPOGCH         WGSFPCFHFB      XXSBCUUHL      
PUDKHYKK        : JRTMC           IAYO            XGMGESFHGSOPJLY VMNONWH         LLXP            NIFX           
UWYLEGROXBVYV   : PQGOWFCEUFFNMII NKFUIEGOYLG     FSXUYPFV        DGTBDESX       
WSQEVESGUOL     : NOGSWJT         NULNEFJL        PGUFM          
XMSKGNKFBOLTFL  : LSMKDIJQKD      NIYGAKDRHNJHG  
BLSKIOE         : KPMYNQMXPXG     ICSQUTGH        AQYD            MPCHBTEMVN      QBKKKHKM        JSHYFFRFHJKJF   HVXIYJ         
KIISFWGNWSGHY   : OIIKLCAOAC      VLDL            MMDHCKIFVIB    
RHVJSRQHO       : AQBHMIDAIWT     IALAQLYSPYMG    JBRXOGAPQ       MCAA            CTJFTDPVIHTDWJS VKHFORBN       
UIFFY           : QQJD            COGNPAXAMF      AQYD           
TJUC            : NLASHVNU        TTXYOTDOLKLXCR  HIHSGNSOF       YAUESQJPK       GSRGYU          MLCDUIXWMCNN   
ABLNXFTIG       : VXSXONAGXNVP    SLKWXBTMUDBLKCN TFJWMRGIGDJRX   CNTVYUCQAUMBEVD UJXEKXECQPWD   
ANMLJGDQUXNFFSE : JSMGGTGJWRC     VCUBC          
MQMRVOSHFRMBCTR : PMHTOMDAPIQOL   JNOVMOWYGUGT   
JGQSMTJKTWPYRWQ : EBQE           
NFYJUTSCNGDPCX  : BVVOBNMTAYOM    KKBMW           GETODAL        
LELHTHQGBQVAK   : IIUIHCO         RGEAKWYLSWE    
RRIYSTTNNXBVCRA : VHXVA           AEBOK          
MNGAUCHO        : PWFXFALLWSKSETU JLWAKCTSQKRVLC 
IHHKRCEK        : MOHDWIRFSGMMA   IJUNJKEDRWK     LHOFC           UQMLGWEVYK      BLHOSBEAO      
EDHAQWYSUBMU    : QFAFILIAMAJW    OMPPRLSYKEQPF   COLKTABBTYWKJK 
YLLBGOIUY       : GTVREGBWGEONFL  FWJDMP          DFDJLGTA        OLSJ           
CGFUJKHYQMIQ    : BMDSBTJRQVFWY   PMHANPGXFRRX   
GPBBS           : EFEJFT          FCHISKMAJEHVUUP FRRTWYSCBIQQB   TMGK           
YXOKKPSBAQCS    : RBMWTSRR       
JXPUKYTBM       : OFUBKMAH        CDVQYGMX        PPQYVQNOBHDJCR  BTRHJJEGTXIDBF  VVLYT           NNNI            TDYSTGEVLOOM   
SSKKTOGJPEXA    : EEFNNA          JCNFGLMRT       UTWG            DHTQCSULAXRMKK  RJEMTYQQ       
PUTP            : PWBDAA          NRAQBYHGTKQI    UGAVCPUSUKKUBNT RJXACFIWTGWXS   AEPCFUEYYY      QLGOCLNMHD      OVNYS           FHQXSPE        
PUTP            : RBYUMOSLABIX   
WKFIIW          : NVIHYBOKTRVCN   LNRWFXFI        HSAAPFBWDX      TUTOMJQHOMSODC  UOOPWWIWWRPSSHO UJBI            SWRGWBRACJ     
VWYWLDRGO       : MVLV            RYLVTIDIMQF     MONPDODMW       GBEPQARHVKU     BTMFW          
CFLLUPLW        : KWHPBIBERAUGX   NJWAXVCDB       QDBBUAMQKCLSOQ  EDXVUFWJHI     
BRDQE           : LKULGYFERFB     IJUNJKEDRWK     RAIK            UIRE            JWDCXWDRVOQWY   BKAAAPGUWIGEBR  GWFSWM          HWOBANHKSVR    
DLKNKNJJOJW     : LSAWLR          OTIJPVJ         RJFIGWD         GWIYUJLW       
BDJGFQRQLKCKTFC : OLOYBHJTDSMF    HLLQWLEQAULXAA  YGUPDTVADPS     CAINHMKIPJUG    UMYPYUOPSCIRFAJ SUXPDCYVMJIQM  
VICYVMNHDYS     : RUCCENAXQCF     BJITXFUUTW      LOYT            WHEWVHYVARPURCF WTHLFKQS       
IQOKTXSCQLUC    : AUNLQVBUFQPOO   QIDHTSGRLPABCO  QICFGHCSRJUQYX  WRRIUUYK        YSMJXYH         TSWXF           NSJTOKK        
XMRDRSCAUDYKS   : YJQFOGTQPGGUMQ  FHQXSPE        
PUBLD           : DJEOK           IVDYOHAXMXU     OFYSJEOFXENBOCF YFBCVNFCRSTW    KQRPEWAAP       CQSWXXCITFCOQU  JRIDOH         
BPQBJSSWNWUNKOT : QONMRHAESREBDI  SGOEGNSJWUJ     WRHEVXPBCO      ISIG            JVEPFAMXRJKB    SULQSV          CCFME           FMTBHBJSSB     
HXGFBFRWP       : SAMQ            EPLC            IMWP           
RRUUNVNE        : HYSANHBHPEKNU  
WYSTPPODCF      : UUTPOYUDH       NBFWD           DEYEBFM         MJADPAK        
IMWP            : QIARXFCNSU      GQBC            HXGFBFRWP      
BULXL           : NGSCT           UWJYKKUIBDQYD  
RFQOUOCAOYYJUO  : ILQDUY          HOJFQBVWU       MONPDODMW      
LUGQT           : FVGVTJCPXMXR    MERQOFWJN       HQGASHWKWDKBGMJ
GRFASCMSPHKWA   : JDVQWNL         CIBJC           QCHMBOQDHJJY   
SREUIDVS        : TCAVPCSXWMQ     GAKE            WVLK            SJBXKYGYVPOL   
NWOID           : MNEWCYTLCPFBDQ  VLDL            UTWG            QIDHTSGRLPABCO 
ESMVAOQFBJULVSN : TFKJTVCQFILE    AQBHMIDAIWT     OBJNQPQF       
NFCIOHEJIRGXCL  : TDSFMJ          JLAADIMW        RPIAXJBOEXSPH   IATNJRGEBEIN   
HHUFJJWONI      : JWDCXWDRVOQWY   XQNWBOM        
YFFMF           : XNORQ           AXDHSTI         EODSGSWMR       JFYFVKUMYIV     KNGDM          
UHDJOJUACB      : LOYT            QQVP            IPPPSCGABQSNNV  WGSFPCFHFB     
EOINXDTI        : ENHM            HDKK           
QWCYJDGQ        : HFWOHMWGNJ      XBVMJSVWC       LQCHTCBPKHO    
LLNUQY          : QUCTQBXEYXMQ   
BTMFW           : YDDIXYOUJDLFWG  JYPYVGFSUMNG    UDUNYJWHHUN     RJSFBMXQKGFO    AKDWVM          FKEJTQWDXBVKOP  VWYWLDRGO      
JLWAKCTSQKRVLC  : EEOXFWFWECE     BRXXA           MNGAUCHO        CIUMDPNBV      
USTIHJEXIQY     : TJHC            UBLYFMK         JHIJLOJXIIWCY  
DEYRQNQQXSKSJ   : CTJFTDPVIHTDWJS SEIRTWBNATVBSP  LQCHTCBPKHO    
KHKO            : QGHTBASSGTFJF   IJYIEGICLTO     DOYOMAHQRR      RNRFKHC         LGDRKQHPBVI     RYOXVTPOK      
FKFQR           : RTXTE           XKDOYWOX       
URXLTDQAC       : SFNBO           NVSLHVQSFRG     OBUEIBJB       
SPDLPVXIHU      : EEOXFWFWECE     GNSMBGM        
PIMBNYIESX      : WEKQKHTQXDHMEPR MRQGARTUJKRUQH  AHUNYST         VWFICCUL        DLCNRJLFHYRPXKS DTEHBXFTIOMU   
LYOHCHH         : UNODWDKJ        QRDEXTGFU      
RBYUMOSLABIX    : YPHYLAX         VBDGV           KLPSGTWEP       MHFSEXVKYRJKJCD PUTP           
QKVHMENFFPS     : CPEBWFO         OYHHXN          VSBQYSYJWYIUPHU EAKJJVDNKGHJXO  IVFNMWLCA       FEQGF          
GAKOIQ          : YYSCFCJLIKR     NKSQLOQJ        HVCEHSD         NYDYJX          QSSCMUPOGNAB   
LPEAFY          : VPLNGPP         DFKCT           NIADJFWGV       AJLBYRBWMJ     
HAWFUPRQWEXN    : RDSCPNSSCJKNMQC ENDO            HDKK           
DFDJLGTA        : BNKKREHA        OPMCRWCIHG      YLLBGOIUY       XCAIPPMQGTGCG   TRPSIA         
MJADPAK         : UTSCGODR        WYSTPPODCF     
OTRNYMDQGDXEQKH : BWLE            HQPA           
NSJTOKK         : WBAGPY          IQOKTXSCQLUC    RVSKHPJBVM     
VMILPSCGMTTNJ   : TGKLAF          IOKTID          NKVUHBYYHEAAFT 
HPCFTSPDQFXBCMN : UPFGRGQ         RANE            OICYWF          INDQHHPV        HAALFMJY        GJQRJA         
PJCYWRTY        : MRLMPXGLG       PTVJDTTL        XEDMCTTBMFGD    HSPRAAHTEDPSFFI QDGCFAULHHE     UENCVUMDQWTKXNW SJQKWYD        
JVTW            : BJYBCYVKQSG     HWVIMEWEJTIGK   TDYSTGEVLOOM   
SEUVLQQB        : ILQDUY          TTNOLSSXB       TVNGCAAIGPAEN   NYDKVLGVFECXPO  JMOHHMILWFIB   
KJRNLG          : PWBDAA          UFJISFNESLCKEA 
CVMEW           : DGEIP           ABMEH           VSETVAIAHIJLQ   WMLFXPEOQ      
XTKXD           : KRMHNQGNQWFBGFS LVCWHBHNKQQV    HBUWSTXYO       VTCKVVHMTXX     USPCLYUN        EBLKS          
TCLNJILU        : QOTIRGNBAYKI    YISN            LLXP            DXSGEHHSV      
EYUQKMEXUHATVF  : KJUYGOXUWHEGNC  EAIDGR          IWKGTGMDXDI     AITFUFLPRNLGNS 
HFMU            : DHVAKKML        KOJRTFHGA       HDPKAWXXK       DCQGGKLSRRJHSG 
RBAUPPG         : QNICYGLOKX      NYDYJX          HLODMJJYS       PGUFM          
BBCICWYM        : WXXMSKSGX       CCDFVTSPIDIMCM  SXFOYHSV        JCHM           
GMHPNBMUUV      : VSCPCEBT        VYEARNXADMKPSH  JFEVEPCJCVN     EHWUYG          CMMYRDCUYWQ    
HQGASHWKWDKBGMJ : DNLNYCSHSRKNQF  WOELFGOQNQFB    CWHRWARR        SYXSKM          LUGQT          
MKAYQNIHBKVVHT  : JFOPYHBIR       NRMLCMN        
QLFSG           : TUQLGW          ESVJXQPAROBLF   XNKKXJASHKKH    DURSXRANYW      DXWJTKKMNT      CKIYRPILIPEW   
PQNUDQCSCPFNP   : UGYY            ISIG            IFNQXLLQRR      YCAMWUOXBFNYDF 
GDOPEBLC        : AHDWCJXVYEJ     OFCJDLX        
IDCTK           : QCHMBOQDHJJY    VTCKVVHMTXX     JLDJHHBW       
AYNSOIXGMQICXV  : MLMNFVEUY       IMTLGLNMQDVGUVG VVLQBLVLCMQ     WOELFGOQNQFB    NQEBXUSBWBEVUAX QXHHILC         TYFBSGEXBCLVYD 
EDXVUFWJHI      : XICSLNUMPTKD    WJBHFGHWMRRNDYS JNWVYSBPBDEBUN  CFLLUPLW       
MKLWHNVUGLGGT   : JKTEXREKSBJFD   ILSNBOQPIBDOVD  IMGLUQJGG       WMLFXPEOQ       HTRTELV         CQNB            OMLOMGOAYWCXL   TRPSIA         
ACXXBSFGQD      : JABCLPNCNULA    UXXHCDK         CWHRWARR       
VCKGKCSWPQF     : FIASFW          VUHGBDMTKL      RNRFKHC         ORPTJYERDSTB    FQEMYV          TVCLWM         
OCLCI           : LVDAQRRWITBS    GCNQX          
VCUBC           : KSHDNRQTRUGILF  RQRPH           DXCOI           DNLNYCSHSRKNQF  ANMLJGDQUXNFFSE LGOV           
CUAKLDLKI       : UUWRTFWP       
QSDLSTCXYTALVL  : VSCPCEBT        CBTXLEROBEK     LQTPLVHAO       LNHHCSKLQGH    
UNBVRVAMYKAEX   : NIYLVVMFRWWVUDB EYITEX          MPYGHGD         FBIOSPMTAVODJ   NLHSQSNYXRIKMAJ
MYDG            : RGJBLOWXDAG     GKFUHIFOGWHNHK  OWFTSKROY      
PBYTBXND        : MWSQWGMYOLDIV   FBEBSTRVBXFDP   VSETVAIAHIJLQ  
MORHEUF         : PXUJVFS         SYYUDHOGP       THQBBIXIL       MENOQRFF        YYHJIFKXRMTOOA  UIRE           
RFIQRJWPV       : FIASFW          APSCPKNNOUGJ    FJPCIY          VYEARNXADMKPSH  WJBHFGHWMRRNDYS AAVRKAL         STIFWSOCEBW     ICHFI          
PASURTTLU       : HMLREGF         AAVRIOHTU       QURLPTB         IWKGTGMDXDI     TMGK           
CXEONXVRTD      : IRUS           
NIYGAKDRHNJHG   : YKXMW           LTEVDICBX       DMQRBNHFPMG     XMSKGNKFBOLTFL  MXAUENVMTVYD   
YCAMWUOXBFNYDF  : UEQODVFTSWTG    LTCXBYSIGCMVL   VJKGDQILKRXMKFG PQNUDQCSCPFNP  
GVIOXOQIULPIWY  : FUQBIXU         RJVYCIKQBGL     KATTSFQBWOAJD   MFEMJNPJGHTD    CMGDPDNCW       OBNSTIBFO       AKSQEPJERUI     ARVXHXWVD      
EATGNTBER       : AHUDJVB         QRDEXTGFU      
KFENMYWLKNJB    : SHJT            FIET            FEQGF           NULNEFJL       
RVSKHPJBVM      : IQUFO           JPHNBPKYDLGVRV  MLRVSY          QICFGHCSRJUQYX  PJCUAEVPFRIBP   BBBFJGUACFBRU   NCKTTPSN        DTSTQ          
RVSKHPJBVM      : NSJTOKK        
DCQGGKLSRRJHSG  : CBUYECNMUOQW    XKNYHGVGDQYJOE  HFMU           
DTEHBXFTIOMU    : OKREIHCOHWDXM   OTBDXHSYM       DYHEHCL         ETVWHYXIGRNLM   FADPWKGKH       PIMBNYIESX     
IHNNJGURTI      : ODJLHNXMOXJGOWP JABCLPNCNULA   
LAWSSDNYY       : RGJBLOWXDAG     JSVGDDQNXAEAHLF BRXXA          
GBQLWBBJVSUFIIQ : CXELFCNCLU      GNRVAOXGIKRBPT  BSMXFUDSXDL     JRIDOH          YYNHRNFM       
FLJNYWNV        : YQTPDVBIQ       AMSY            GNCRW           CTVPFQVGDPKRR  
JBGIABQDREB     : LVCWHBHNKQQV    KWGYABDTSPP     IVXILTFWKCG     WLIAO          
FMTBHBJSSB      : OFUBKMAH        PHXGUPUJAQQGHM  BPQBJSSWNWUNKOT
EKMFICBB        : JFEVEPCJCVN     MBWSWYUUQFUE    WJJMNIQXINBFHY  BDPIUWCHIDHL    NWJADGKL       
EJVEKM          : AHTUPPUEJ       KMEHDP          GBEPQARHVKU     OMAYTEHVF      
ERLAYA          : MHFSEXVKYRJKJCD
CIUMDPNBV       : NYDYJX          WHEWVHYVARPURCF KUUQ            YGCBN           JLWAKCTSQKRVLC 
PBLUEOIIXHPJT   : UQCTO           KKGRIBXJG       FNYDBOV        
NNNPPNLTVJGYY   : JTJODHMQOOLQE   KJKY            GRIXF           PYMCUL          NQNFCGMDL      
DXAUYL          : BXEFWYRAQOUDM   JMBNXT         
GCYOAGELCGCS    : DLIFNV         
RKIEEGNN        : IGPHGESDWQOIPR 
OMLOMGOAYWCXL   : CDVQYGMX        CBTXLEROBEK     MKLWHNVUGLGGT  
GSQKB           : OLBKDPYQHJPCMNO RAIK            RYLVTIDIMQF     CIYRRH          INCVSOL        
DVMPEQUMGK      : SAXDIV          LWWVLIRV       
XWIMLRDLSAP     : AEPCFUEYYY      NMGUBX          EJFEEUO         COVUYTQHYITUQ   FNYDBOV        
OVYJMJK         : MRQGARTUJKRUQH 
PGUFM           : BCJPQRCDFQQBY   HGDJHP          EKRGGPRVXOJG    PLOYXSSOCJHQYWQ JCHM            WSQEVESGUOL     RBAUPPG        
AAUKWSJIFUCJIU  : PMFNJUYHYJGLLVL BATPIU          ENHM           
ALAWMJLXUTNB    : IQHT            DMTUSSRYIXA     DTJG            JFUUEVUNWOPANR  TVRXXKNYUPK     DMMBCBWALAUXBWM
TQCVQWJPRU      : KXNSVHQXGKPPNY 
XQAJBUUCIV      : CYCIYSNLWUAUJR  XAMSI           XPOVEYXORQGF    FWJDMP          MSQO           
WFMVCGJ         : JNUUPS         
WFWAENYNFTIETBG : WXXUIOGQFLFJY   XAMSI           TIOUJLNJFYDY    FCKP            DSMNIORSLTXYJO 
FEAJMVKMEW      : LTCXBYSIGCMVL   TNVOREYOMH      GSTRSJRIYLJ    
GETODAL         : VVNAWUO         EKFYYWOOLJMEIJE LAOMENNIS       YELFTDPNYCL     NFYJUTSCNGDPCX 
EBFTHBENUITXNXA : LSOOBHHE        GXVEAQUHPD      CAINHMKIPJUG    TQYYMU          YJOY           
NWJADGKL        : CBUYECNMUOQW    CJTUNN          WAHKIUEEXV      QAKMUONPNMRBN   NCKTTPSN        EKMFICBB       
EBQE            : DKQB            OGSNYYMJGRBBVOB JQHVYHI         XXEHKXBCQ       JGQSMTJKTWPYRWQ
VKODGXENLYVFY   : WIKFJ           EIOBY           PMMSMSTSCNFDYQ  CIYRRH         
GAKVY           : XTBGP           HWVIMEWEJTIGK   GWKGOTLW        UHMBJOXQII      YSRPMHIMYMEEX  
XCAIPPMQGTGCG   : HRUX            UYHCKOKHHAKUYH  FIEDSPYTBTPNOX  KUVMPXPOMXOS    YEXBADVFOUQCDR  OGOTCWQ         DFDJLGTA        XAPSISJWQM     
GNSMBGM         : WVIJPJP         PTVAGFFXNQKHPYS RSKYDJVUJ       BRPLVUETVCVSCMM OVHBJSII        HSTQXKNDSR      SPDLPVXIHU     
NNMVPY          : UVFNUVELIHDE    PLUIPXWMLTAJHG  LCOJLYDKCJ      GCNQX          
OSPSUXJ         : QYEQX           GIQILTELSPUFS   KMASAQFBIW     
NASHGVND        : SVTTT           GVXRHOOCMYYLJF  VTCKVVHMTXX    
DXSGEHHSV       : RCKQJALLDXHA    TYIWRPJODLYS    PPELBT          HSTQXKNDSR      TCLNJILU       
OLSJ            : PPVRB           HQKRIJUMPAN     BQLGNNFEBYC     JLFORCBGBWTUCSL YLLBGOIUY      
NBTJCDVP        : RDIJVLNUPEYO    QLGOCLNMHD      GKFUHIFOGWHNHK  KQRPEWAAP       JPASDYMHAQYTMHU
PYONMSTS        : AIFGF           TPDRSFESITGBA  
MYXUH           : RVCHAEEOOEAEGJ  VUISR           FVMVQVODUVJSPP  VPXNDXHXYWU    
SDJE            : NJGKH           RQPOGCH         NRKGMESEXVH     LGDRKQHPBVI    
UHMW            : MKMOPA          NRHIRTNDBQPDA  
VYJUOPKNF       : MRQGARTUJKRUQH  RFMQ            PTBLTJLESWRJ    DXOWHEJYVN     
CATUSG          : VKMNDWQKQJSLXKL QDBBUAMQKCLSOQ  GSWVVSOMFCRI   
SDGNVJXBISKVPO  : WQBPHK          OFUBKMAH        GQAWYSVD        BPCJPIVJUH     
OYOFQBUXBXXUUTE : LVDAQRRWITBS    UEQODVFTSWTG    WHEWVHYVARPURCF ACWWMGFNOCE     IKXL            MLCDUIXWMCNN    AFAFH          
MHABEMBHWTRS    : EMFRIEAPFAH     BOTOQGQ         FMLDWKHLUPV     MOEGLYY         GGRIYHGRTNP     RNAFRMTFJCGQ    BHBUP          
JPDIELYIGAJ     : UFFHBNJOQCCRUU  BTRHJJEGTXIDBF  DNIPJRB         AKSQEPJERUI    
XHERLXHUBKY     : QEEYC           BWRCUVRXF       LLXP           
LIMHBI          : GODFTVULUXSKIMS AIYCOXOJVTVSSFK UNHYUHMK        BXSLCUAQUYMCHKH NIFX           
MXAUENVMTVYD    : AEPCFUEYYY      RTSCTKEB        ETVWHYXIGRNLM   NIYGAKDRHNJHG  
GJQRJA          : PHXGUPUJAQQGHM  JCHM            HPCFTSPDQFXBCMN
KKOCVWP         : POIPWJGSY       YKXMW           RQSHCE          VVLYT          
AXAOVCJC        : VBDRWAHCP       PGHMVX         
IPMG            : EXHPKYKBGVRWGE  IQLQJHXR        PQTOUR         
PFUYWOK         : RMPSVFOCORXMGOL NXTFNHGTURFD    NKFUIEGOYLG     KKTDIJTSD       KJOK           
DVITXGT         : MRQGARTUJKRUQH  LEYNEV          TYHXRXCSLJIWWQ 
KVNNLLRWOIFEWOU : KMASAQFBIW      NRMLCMN        
TRPSIA          : DNIPJRB         QABNBVPTVNHYRF  CHFOLIUAXFTF    MODBDMXD        DFDJLGTA        MKLWHNVUGLGGT  
LXBIWHCO        : IIMHJDTDUQ      LPPLONDYG       AVJNVKRDKYRX    CXMAPDR        
XDKJQCHFMOLLDI  : FLIPMCN         UFHCCPX         DGEIP           JCYAE           AMOSAIPYKUKN   
XAPSISJWQM      : BIFW            TKNTTOFBDUCKYMF PHMDGESESUQEYGH XCAIPPMQGTGCG  
PWJFRHKETBIDHX  : PPIPBOYIUGGJRV  AUMBJHEJMSJFFP  OXFNC           EWRKRQSTSNWR   
UJXEKXECQPWD    : ICPCJOYWAYP     UUABTLSQQ       DLWTMMGLSSUQMQ  PRINLH          XAVDMOWCCGPU    ABLNXFTIG      
OPVGM           : NKCJONCBTLUAWU  AVJNVKRDKYRX    GQEBVXNXGXVRXB  KKTDIJTSD      
LGOV            : IJYIEGICLTO     BIMP            PVRNPPESLADG    YISN            NRKGMESEXVH     GWIYUJLW        GRNUXJRVFKKT    VCUBC          
IATNJRGEBEIN    : IVSMLDJXSTSYA   JNMORCIMOXY     RLGHGWO         NFCIOHEJIRGXCL 
PSUHPXVGOTNBBBK : KGYMQFDJKBJFHK  JHIJLOJXIIWCY  
XUBA            : UVDMUYHQQTCHB   PDELDW          RTSCTKEB       
OJIWNMDWCH      : KRMHNQGNQWFBGFS BUUOMN          TFEKVHL         SVSCXGHUEUOOH   GRNUXJRVFKKT   
WDVPBTVRNLVQNG  : KKCQI          
