VFVCE           : VOOI            JAURJW          YFGJDQMB        QDGQ            TUSS           
WHYXOU          : NSUVKSSFE       EQLDXPPMPTK     IIOEPSWXYN      QPYUNWGVV       HYNNJYQORCRWOS  AJMJOJH        
QKNHTWOHWEYJAE  : RIRTANUNCVSCJ   KXUM            HFDJVN          WFKSKQGGMPS     XBSBLWNYCVXEFTK
TLBRT           : YPMR            GDIC            ERCFQKCPALTCG   QJADA           RGMTVIDGYJ     
VAKSHJTXGAQ     : FLMBPJILTISHBOO IJTX            HGTK           
NANKPVHTWSTC    : QLMOJETUBXSXSYX IVSDSWLVE       SYGFVRLPX       EYSQHP          OKVTBCXJRVGOQBJ OSYJWEUPNWWA   
PPPHJQEJC       : WHGAIRDVE       MKFKAJCXWTNKCG  SWWEVFVCPRMIUKM YFJXGK         
TNURW           : QVGMLIAWWFNBD   RSKQVKCHYMINCYM DDXXLE         
JQKJEVBCFWABSCO : SFKXLIXTHH      FKPTA           CFHTHQMIDAK     SFVNPYGV       
REQEXWPAVJNRE   : SPBMIK          IBORQMOOPMRDH   JCVMYC         
OPDABI          : PQWVSUAMI       UDESO           BPGEUBCPKTBPSV 
DKFAKGTOVEJC    : YRBOYXM         NJJIBXJIRI      NKDEFFOUQHRGT  
PARFAQPQ        : YCKRLD          WEUPINYRPFQXHWV
TDYLJYMRY       : YFEYBLWWQE      IWNBEKSMRXVL   
EFSRL           : JQPUP           FJWDBOTBANVNLL  LVFHDVLEGISR    MGMFDJDFHPQUIPK NJMVHC         
GJSRM           : EFSMLJI         SRSWLDIUH       JUVM            IDHIEDNYF      
HMKNPB          : SPBMIK          KGWNRERMKK      WRNLUFUMKNYK   
INBNNMWOY       : FHLTPFFNPYNSRW  YRSTQUSAGFFTRIR QAAUHICRT      
ORVVKPJYXTTQG   : TPGT           
AUXPMBUWPV      : UEOKH           DFLNY           SBWAWJIYTMXRE   DLLAFDOXQQKOJPO FPIBF          
FIKVKEMC        : KNBYEN          FKPCSMYXRXC     VTCJIJTVYMKT    GTBVMPQRC      
IMRSNPOJI       : EAFHXKNCT       GOXL           
WJRWY           : PNKTTGGKA       VGNFOVG         EAYSKPL         NMUAHRBUGWADHX  YADIKAVTEK     
XWEPSRWEDTQHGSL : RKGJXNX         MIBENRQMHY     
HDMWUB          : RVPKA           PAHNHKWICOGKGWW
EXFPRCQYDNEUJ   : UBNPIG          ILMDRGR        
SPBMIK          : REQEXWPAVJNRE   HMKNPB          HRWASUQBJYRY   
BVOK            : AEFQMUENV       WWFIJCCNDJIJY   IETAX           KBGPMEMSHHPPX   XOBHA          
BHUCPBC         : JQFUHYYFYRKL    OCUYVVCJBE      OUBOOCWXOX     
SUALTFAABL      : NOIHQLSOVNWLLGG PINGKIKOXQIM    XSGPJFWRPNPQH   SHVNRVJHEDXVF   TAWBPKNDNESF   
TDAILLDOH       : GTXUKCXX        NNTYBGQVOCDML  
YJVI            : ALGWQJNX        BUOKHONHRMHYB   QMOFMXJVQYO     EJTQLOD         RVEWPYDQGEIO    JGPVDSKCWOC     IFYFXUEDQ      
BXJDVCAWN       : EQKF            DFJQFAK         WRNLUFUMKNYK   
CPWDDX          : OBAGLTU         ATJDU           OKEGCL          URFXHUSU       
IYHTMNKTILFETLF : CKKUPA          PKXFNGPUXVSAKLR RBGFIVDIRXJ     VSNYOFMQYJA     RWMOVEATFP     
WLQYLPP         : JXUUHMQARAKWR   EQKF            SNINMINN       
SFKXLIXTHH      : JQKJEVBCFWABSCO OUCGN           YXMQARO         BSKVVIJUQOG     BDSIBDMASSY     UMKIEYSYCHTXGIS
TUBQDPXI        : DBKWNWCWIVTKN   HDEE            JQNJ            NKIQYGUKPI     
MPEJDVLP        : JJMKPUJUCHV    
BCGIMHTVHOFO    : LGSEHJX         KEQVKTCDSKDVUC  QOWVHCJ        
CKKUPA          : IYHTMNKTILFETLF GOXL            APTINQ          QVQPV           GAWDT          
XKHQQRTODLBGOJ  : IMTMVYJNRICXH   VSMFVQOUIRFKGM  EELULEKN       
BQLYXAHPJLA     : FKCKLROVGLFWMXK SYDLOYH         XMXYUSJTTNUL   
GPUBQ           : MVAUOUBBJ       EJTQLOD         KFKUJKHN       
JHXDDNI         : NFEY            FMJTPERL        BAPEWBGWNUE     UDESO          
QOGAFJRQJRSSHCE : YDGAHVWSGPM    
WKCRNUYYEWC     : OBMFF           FGORWOIHBIRGY   PXAQFYU         CFXJYUM         XBSBLWNYCVXEFTK KVDQ           
MMYDBFEJ        : FLQJXDBMOIUGXQF JICKDW          AJMJOJH         IUWNMPMC       
XABRVTCX        : QKIINNGKMK      PWXKWEMPW      
NUKPOXMPXQPC    : TJGXME          QTPQORAEYDUIJ   SENSOGG        
CPAGSGMCVMFW    : OBMFF           RSRWRFJIX       SHHOHFYOMGD     HLPJ            YQFCOT         
BSIYQWWDM       : ATOUKJCFNLPUR   LSJGERWAKX      LOCAM           GSATVEBTEU      IAFHQTRWJQQL    XGPIYM          KYFOXTPIPDBV   
BAEBSTG         : IPBBHSQTGTC     VTFAVWJOUMXJW   KEQNS           XBVCSAJ         CIPTPOMNRNCVGT 
VVUEQBSTYF      : INCPTYLOBFXN    VOSP            BCDUQTBHWLK     HPEWHBQHNBN     UWOEXOKNWLCV   
XMCQUDJ         : TJGXME          NBLKP           CHWS            JMHBOPOWCLH     JBTA            FQXDH           HAQEFXJ         KVDQ           
CMHQPJURCQXWOVT : EBES            PBWS            PMPLHRPVJWLK   
MWOIVUJTHNKCRVU : AEFQMUENV       GRNPBQA         FPIBF           BFEVD          
IEMXNJRRAROPN   : XBTFDQFMHCYFL   UGOKYHHWH       FBRJAGKBXTKBF   DAEYEMMXF       KYFOXTPIPDBV   
LDHALDWXY       : MPALK           SYYUXOE        
LLJFHGCPKQOX    : VQEJPBATAQXLBN  HEXIYYCIP       DTPFKQRYCT      QDCALKDCRQE    
IPBBHSQTGTC     : BAEBSTG         EXUEQRKNQW      LWRRL           HRPOOJEOYFQB   
IFGGH           : BOXTCFSYRTND    SMAAMRY         LMTENIX         GTBVMPQRC       KCAPJSWLXM     
TSWABDESNUJNVS  : CUCK            LBGPFO          QITDHWUDRYSMP  
ATOUKJCFNLPUR   : BSIYQWWDM       IIVBWNIJLRFEQV  XLOH            ASGSUIGKQGT    
CFRVCTYHXRWV    : BFNJ            AJFJ            FHXPXDVWVB      XRPKC           COREW           SVGJHKDDJTOLFS  TAKXAWKYAY     
MRUSTQJP        : KKXXYIBEVTU     QXAODL          NTURAQ         
UTIIFXEYVIHOELI : ARXRHRGKEKUQ    LHPOOF         
TJXQ            : MGPNII          GVHQXXECQMCKTM  HPBNM          
CEYWYTNKL       : WBSJEAPTA       BTKTCRGNXUSIK   PKFRLVFJKMD    
GFCQMAUNYEUNK   : UAVDNUKOEJLJ    YOBMLAI        
XQDHQVMSCMRBI   : HKXJYCMDDGUIJ   PHLABEAHYGQ     UPXYWLQUK       PEWCTLODFRTWQR 
MTXUBC          : KFKUJKHN       
PFJFEPBTCKRSPA  : NQEBNJKWBQL     VPXTJJ          BFEVD          
LOEOBXRLFEHGBKI : NHOLDDMWPBWB    DASECBLAT       CWWUFGXB        EFABEI          DMEQRT          SMBTWX         
ANYGTOJ         : JICKDW         
QVGMLIAWWFNBD   : TNURW           DBUEVATEA       CQYOIUONORI     VTCJIJTVYMKT    YHTPMHMP       
MLMWROHCEISFQ   : GTFSA           DGFK            XRPKC           WOCNKOUHTQ      TIDQ           
TCBMXJ          : IBFOCVGQAMO     EEFUDSBKLTH     NVGXPLWTAXGHITP MFOUBWAMWB     
JRCIQJWROFHA    : QESYMODCYR      KVQGAMVLHOR     FCXPXRAKPDXD    PXYSFPGOGOHQ    WQHUWK         
ETILYOVR        : MVAUOUBBJ       MGXAVFUTDFYWWMW PEWCTLODFRTWQR 
MGPQ            : GEBGMISJDKJH    PLCLLVXN        NSEKD           NHBHULXALPA     SCSLKQUHJQJVLE 
DOSEAKIJCR      : GOXL            DAHWPFWWHOL     TRRHWQVC       
VHPDJHHES       : GRLXKRXAQI      QXXPYGS         FUYFFDKGWBUI    JKICUGUIMTB     OVTYTUGM        MFDBDY         
FHRWCHF         : DAGCVDPYCHN     MAGKSDFNCU      IXGJKV          EYSQHP         
XNWNI           : HBYH            RHCHITARTNWPJQK DDGFCS          TFTEITBSUGNWP   MPALK          
PTMYXHJTOYAAJH  : QSVXEVES        ARYPI           UUYM            IIMTG          
CDLLVINDOI      : MMVYBSYAHMCBP   JXFLVVBKSSYE    NGYVTQKWKK     
EFSMLJI         : GJSRM           JLTH            SEBUUOBQLFCG    BDHVCHAUGWD     VDBU           
IIGUD           : SEBMFPQETXGMEOL VDBU            AJPFJA         
VDWFMEJQPVOB    : GPXV            LMTENIX         OLAHPMPCMW      PINQPDL        
TRTWXC          : LNAWRM          HAPVTQC         TXKD            XJAYHKBLPLHSSH 
MNAVOKGU        : VSIEHLTEFULLJRT DVNYVBENRIJ     OLHQGRJMSBRDBIO
JTEORLCXV       : CSMAFOPQ        JQNJ            PYQUVSQJJUODQ  
NTLQFFICEGEWV   : QFXIRAJE        WMAGYRIHCPEWN   GOGUSYRVIKJBE  
YTJMAETKBABSMFQ : IDBDNEBIIGT     SGJBEI          WRNLUFUMKNYK   
CGENXL          : QYTEMEPQ       
INCPTYLOBFXN    : VVUEQBSTYF      FRDWRHWMONEB    SKUAVWLHRC      EQAHKYAHXVSMTG  QDPAKYGWYS     
EHRFIV          : QPTLPEFDAPRFIB  COIEOCWHT       BXATB          
WBSJEAPTA       : CEYWYTNKL       WHGAIRDVE       ORJWMJLP       
RIRTANUNCVSCJ   : QKNHTWOHWEYJAE  LETNEV          RKAEDSXLRHQ     EBES            ARYPI          
JTUQCSRBUMKBMA  : HTHQJLS        
ODOXUIXJ        : FHVTLVENCNUFXS  YUDPGYBO        EKYVQHYGE       RCRPVCIUIV      KGTGKD         
MNCHSMKEGIU     : GILCYXDYDSYQLS  PDVBFPC         UMSLOUG         RRGXLVMRMLD     UFHCLN          GXSMDHFQVGNBMCN MAGKSDFNCU      MGMFDJDFHPQUIPK
BONXCX          : IOWJCOVWGIEM    FQXDH           EJTQLOD         TIPEOYVUH       VHRRG          
QAYGDNEBYEM     : RRNCCLOHSQS     TBXAQDDRIEO     QLNMHAFQXGE     YDQOVHMDAGMOVPP QGPYNCUTXPPD    JRQDXDXWNDDOON 
QCJYUVJYETWQ    : ALGWQJNX        GBPYEPWLKSSFRY  LSXKYTERSWPFQ  
LETNEV          : RIRTANUNCVSCJ   MMLI            GTPLEP          BGNMASGT        AHAGCXQCKQ      GOOBXHUMW      
GUNKITNJXAOPCB  : MDYOP           TDAF            LHFKVXXIHFGM    WNJEYSBLNH      BLRRRRBESNA    
AWCBE           : LNAWRM          IOIPOTFVAA      VOSP            LVFHDVLEGISR    PTGUVXKWGDMDSM  GOGUSYRVIKJBE  
XWSK            : BMUWSCFIT       KCKYLHYRT       GXREFAPUFL      UUYM           
MAIIHPDWCOQPX   : EQAHKYAHXVSMTG  COFRSHAJNVBX    HRPOOJEOYFQB    OLYFIWB        
RPHVQXVPAAVWX   : OUCGN           ARLMLCG        
PKXFNGPUXVSAKLR : IYHTMNKTILFETLF SWKOBFULF       WFIJMCULIFVWIFP HPBNM           RNEUIQ          GSAHEPB        
BJAIISGGLJGHGHB : UOXQJEP         DIJT            WOCNKOUHTQ     
RBGFIVDIRXJ     : IYHTMNKTILFETLF PGBULFP         WIJCNLD         LNPBXK         
JDPNPRV         : AJBLPVR         YXMQARO         YCKRLD          NKDEFFOUQHRGT  
NFEY            : JHXDDNI         TDOJ            GURRG           XYLMKBRGI      
NGYUKXOLGUVDAFW : IOWJCOVWGIEM    PINGKIKOXQIM    FRWRG          
QCHTR           : WWCE            MEWWCBE         ONPUKOEWUSKJ    NFAMQTVFAO      SPQMVMKVY      
JLTH            : EFSMLJI         IBORQMOOPMRDH   JFNXHXTV       
BOXTCFSYRTND    : IFGGH           HDWFDJ          BGODPNAEBUPI   
IADIFDIXFSR     : UAVDNUKOEJLJ    HKXJYCMDDGUIJ   IAXUOHX         HEVPVHJRVP      DLLAFDOXQQKOJPO
PCKLLKMCIGEP    : PTHCCFEJL       TIPEOYVUH       OBFWLXRKDO      OLYFIWB        
FHVTLVENCNUFXS  : ODOXUIXJ        NSUVKSSFE       NOHN            WHWREVJQAXSTPI  OKSUHOUFRK     
QMLH            : ASMTW           HCVCIGPSOIRWDE  SBYAKJQGTN     
VSDG            : JKKDLMDXSLYCKT  GQTAIWWONSJERSG XXYXEWN        
FPQMHSRPOLDNQS  : AGMFEPP         YTHHEWHHMU     
GPWG            : SATWS           NDENIXQV        NTIPRMXX        TWXK            UBNPIG          EKYVQHYGE       LVDKIBHDVECCCJ 
JXUUHMQARAKWR   : WLQYLPP         GMVNXCYDMNMRP   BVMRRJJVW       NHRASNTX        DWXTODMYHU     
LYWG            : IISCGEJYGI      LWGQFYEFFI     
MTTCMOTSEQ      : BBCGFVSMG       HJRJDUGAQWD     YXKNQG          TMTDHJFUDASCJP  RLJWSEXFSG      JTJIQ          
OAAKWHY         : FIOJ            DLNQCYCA        YRHQHDQDQ       LYUUGLCNNTATY   OFHKWNSHCGUYY  
JQPUP           : EFSRL           GNCPCCGPR      
YCHVIXKC        : DNUQXLXQV       LSJGERWAKX      TTBLAVJWIMV     DBKWNWCWIVTKN  
MPJGKO          : HDUH            IAGLHHSUVNTH   
MDYOP           : GUNKITNJXAOPCB  PLOFDXPEK       PUCI            NTURAQ          MQSTMUXYKTDUL  
VOOI            : VFVCE           GPXV            JSGJI           PWWAQOVANIMXHKP QPYUNWGVV      
EDXMCATAKT      : QESYMODCYR      QFTNOGOPD       JXQAJQ          NILMXBAJCTHJLT 
MOXEY           : LNAWRM          RDLPSTL         PRIXBUSIBLEGX   EAYSKPL         MFRF            PPMDFJLF       
RPGEUITLG       : DAVOPM          FSALMYCOCPD     PYQUVSQJJUODQ  
CUCK            : TSWABDESNUJNVS  JDFAWQPLCVHW    JICQRSLRY      
FIOJ            : OAAKWHY         KWOMMIVCCRCBBST QPTLPEFDAPRFIB  KGJD           
KKUEXJTXQU      : VQEJPBATAQXLBN  CDJHOOSXV       UALDOLOUAVMNCRB RRUEXTKI        HIEERJJVHRBNTIW
IMMOHWKUDFABHM  : JAURJW          DLNQCYCA        DDYDJV          OEQJFVP        
NWTYHELEIJPEKGB : PEWRMOPON       DYUC            SNUHGDJ         PAHNHKWICOGKGWW DSTGPC         
ONEGXBQS        : EPNLBD          BCDUQTBHWLK     NYGOANHUQVXPOTW
VSIEHLTEFULLJRT : MNAVOKGU        ERCDJUKTIMVHSUM UQNFOHL         QVLXUFRB        OBFWLXRKDO      FGSKUWUULVYXR   BWEXWKQMGNK    
IBFOCVGQAMO     : TCBMXJ          JAURJW          TXOOKWQ         EIUEXUSEXVHQT   TTBLAVJWIMV     JICQRSLRY      
FJLCFTIMHER     : LTDSYCAC        BSKVVIJUQOG     QXNDVOFIQY      SVGJHKDDJTOLFS 
YFAKXVGGWLWCJD  : JKICUGUIMTB     RQCJKAEG        NQBP           
KRJQXUCCA       : JVHGCBAOOVUCE   HPDNCFYO        TBXAQDDRIEO     BRRIXFEKB       SBYAKJQGTN     
KPFQHVROVDOTJ   : YXGEMEWFPLQ     QVQPV          
TUUVFAQR        : AJBLPVR         VQEJPBATAQXLBN  TCDQTYJYT       TRRHWQVC       
CKQWMUAKFPRXWN  : GPXV            KYYXUHTOWS     
NLSDF           : RAHHLIEKETO     GMVNXCYDMNMRP   GBPYEPWLKSSFRY  JXJC            COFRSHAJNVBX    TUSS            FRWRG          
ABAU            : XYJQ            PADRGYUTJX      OBXI            JWBOXYEO       
HVPBQTLHRXCRKJJ : BWEXWKQMGNK     WFOVEPSUTVA     QITDHWUDRYSMP   EBAOLDR        
HIPY            : LQYV            YKLCAO          HBHNKLBSAJOSE  
DSYIWAMW        : CEJKQQSYIPSH    SHHOHFYOMGD     BSKVVIJUQOG     GLXNGJI        
LGSEHJX         : BCGIMHTVHOFO    GPXV            PLOFDXPEK       LVFHDVLEGISR    WMAGYRIHCPEWN  
SRSWLDIUH       : GJSRM           HXRRRRHLJJ      PIDAUIS         ACXRPFFPHJYTNDS NKHULQKUBRIBYI  SBRNAAGPMAMLHQ 
DWRCAMBLJ       : GTJNHSC        
AJBLPVR         : JDPNPRV         TUUVFAQR        IKFWSVFHPXKPG  
ISUDKODYT       : YORRAYNUEYUYO   HNOAJJ          HULSHHNHLO      ICCF            IJMBHSP         HTERUIQPABHE    RVYCMYOPP      
VCGCBXEC        : JMHBOPOWCLH     XYJQ            BTKTCRGNXUSIK   BBGJ            DTPFKQRYCT     
HPVLPFOD        : LQKLMGQJHUU     JXYCIIGAPENCK  
MVAUOUBBJ       : GPUBQ           ETILYOVR        DEGOYMNYDS      FAVGKA          CWNIVRNH        RSDBFYPIRLDUWXH VQEDEBOIN      
CERYIXBJXHLKODH : TWXK            GAWDT          
UOSYOGWOD       : YCHBPIMYKHTNGM 
KEQVKTCDSKDVUC  : BCGIMHTVHOFO    GDIC           
IMTMVYJNRICXH   : XKHQQRTODLBGOJ  YDGAHVWSGPM     MRDBJYNXJ      
EUEKOA          : KNBYEN          LPCS           
IDBDNEBIIGT     : YTJMAETKBABSMFQ ASXDJDCGESFCD   IAXUOHX         WJYSNWDY        QMRTWXSFADAEAKG
CGVBR           : UJAA            TRLYGRY         DIJT            ICLI           
TBMTKG          : TCRMWQ          WWHLUEQMFHMA    QSVXEVES        QXITSNVPVEWTERB ECVJWJYNTUQ    
IKLWKJFNMKESLO  : WFKSKQGGMPS     OVTYTUGM        VHRRG          
RICTQXVJKRKWNW  : EMOWDH          SJTCFYYCM       YDQOVHMDAGMOVPP BXATB          
OFPCCCN         : FFALSOOIAWTT    GEUGYN          TGSTNFNEAHPG    QSXDTDUV        SBWAWJIYTMXRE   YXRUMJPYCLBPU  
SATWS           : GPWG            IISXORLUDXSUFLL NHBGB           EAHP            AKLF           
LUYUYTLXRUILH   : UCCIXPB        
YFMPMETR        : YQFCOT          PHBUTXQMCMCQPMH OPYSIRGJVAQKOLL TFYK            YOBMLAI        
HBYH            : XNWNI           ARYVEEGNLK      EELULEKN       
VBDIXFFX        : WWHLUEQMFHMA    PHLABEAHYGQ     EYEGQHTK        OKEGCL         
QVSOGEVPF       : QSXDTDUV        NXEQMAYJOIGK   
CVQGRIOAL       : YFBW            VPXTJJ          CWNIVRNH        VNWEOW         
JJMKPUJUCHV     : MPEJDVLP        KGNYYGLKEDI     JEEPMQTLBNOE    HPBNM           MFBEMVOVYWWW    MTVDLBQJKEV    
FOKNSGDAM       : CWWUFGXB        VSYDPTMH       
XDPQN           : FVKAEKQ         XKEHBJWSFE      HKKFQRJYTCWOX   OCLKHE          GKXJD          
SYSCLGNBDYXIG   : UOXQJEP         FFSAAEVSGJGX    UVNTVURPEPLTGG 
ENKODFWGFJNEO   : JNXHYQDO        DAEYEMMXF       KSYRUEVN        JFYTIDHVKSN    
UCJPEDRRLF      : QSFKDIHFOFQGAI  QXITSNVPVEWTERB RHPDVDEEVS      ELSLOYVDEM      HTWF           
QESYMODCYR      : JRCIQJWROFHA    EDXMCATAKT      KWTQNPUPMSG     TGSTNFNEAHPG    TXKD           
EPNLBD          : ONEGXBQS        WKLTVBOMV       MRDBJYNXJ       TBNRWXYVP      
QIMUS           : FGORWOIHBIRGY   OUAKNJPWOMGH   
BXUS            : WNMOKQO         AEFQMUENV       BWEXWKQMGNK    
CNCJ            : EXUEQRKNQW      WBYOSUCIC       RRUEXTKI        TXYLAORGMPDD    TWVLOEMCABVO    SWJRDEJUC       OKEGCL         
EXWHBVCICT      : VOOSCLRJTB      GDIC            KSYRUEVN        YTHHEWHHMU     
OUCGN           : SFKXLIXTHH      RPHVQXVPAAVWX   QPTLPEFDAPRFIB  GTQSYSHFNWEI    JUKJVTCJDWL     NBEYKOPD        WPNRXHSNIJKH   
TJGXME          : NUKPOXMPXQPC    XMCQUDJ         BFPAOIXRBCEGXO  YCMWCL          ORBCXBPQYC     
GPXV            : VDWFMEJQPVOB    VOOI            CKQWMUAKFPRXWN  LGSEHJX         SEFQIGKJEMCJPTT
JFXHCGIBITDES   : QYRQYMY         QKBRQGVNKTD     XSGPJFWRPNPQH  
YUDPGYBO        : ODOXUIXJ        QSFKDIHFOFQGAI  GOXL            QBPUWQUEFYGVEQR WIRLJ           PADRGYUTJX      MBISB           CQOYGSPUNAJXV  
YUDPGYBO        : HCVCIGPSOIRWDE 
NSUVKSSFE       : WHYXOU          FHVTLVENCNUFXS  MOYX            ARLMLCG         FWKOJJNNBBXAEVM MXMXHHFPLTWX    VOFCM           MQQIBBDTPMU    
DLALWBVQHAJ     : QUCHEKFYP       NQFBOYEOFL      NWFKQYWEDRH     PFWNCBXPO      
CGGRPHSEFGXC    : WGNBJSOR        SEFQIGKJEMCJPTT QAAUHICRT       ICLI            IUXHRH         
IUVPYVTMVFJA    : MFRF           
AJCL            : IISXORLUDXSUFLL LVDCCXAK        TRPOLHLA        DKDNXBHHETHD   
EUVXKFQOKA      : MGMDNWQ         HNOAJJ         
MDAJBPK         : JCVMYC          QVQPV           SDBPSSUL       
JAURJW          : VFVCE           IMMOHWKUDFABHM  IBFOCVGQAMO     EMOWDH          GLXNGJI        
MGXAVFUTDFYWWMW : ETILYOVR        GEUGYN          FBMLBTOTDEUST   HTERUIQPABHE    WBBARCKSKKRFOVC
BCNNDEACPAYHKW  : UCIFHQNLYWWSNCB HKQV           
YFEYBLWWQE      : TDYLJYMRY       JALBJKVDENNQW   WVPEWFTGFLXYN  
NBLKP           : XMCQUDJ         HPEWHBQHNBN     KCDXNV         
MDCRJDVADVJPUPQ : GILCYXDYDSYQLS  BPGEUBCPKTBPSV  AYEJCNFOGTSURIT
VQEJPBATAQXLBN  : LLJFHGCPKQOX    KKUEXJTXQU      TUUVFAQR        FPHS            TNINNB         
QSFKDIHFOFQGAI  : UCJPEDRRLF      YUDPGYBO        WIRLJ           PQWVSUAMI       ARXRHRGKEKUQ    YHTPMHMP       
CEQGPGIQCKHAYK  : XKCIG           IDBTJWX         XHQSDODVSUHDII  NCKVSFAFFBI     FAVGKA         
CDJHOOSXV       : KKUEXJTXQU      OCMQVHG         MWERKKMUSFOFW   LNPBXK          LANOPVDPFQI    
DMNFXNHCEQUM    : VSFEJTTF        MPKMHHVEJ       SWQSGDLDM       DWXTODMYHU     
LPLUPKHGOLPWAG  : WHGAIRDVE       XNWLT          
XCYDQOIODRT     : APTINQ          KGWNRERMKK      MTRDWGWR        GTBVMPQRC      
IOWJCOVWGIEM    : BONXCX          NGYUKXOLGUVDAFW HCDO            TFTEITBSUGNWP   WHCHSBMN       
PEWRMOPON       : NWTYHELEIJPEKGB MAGKSDFNCU      FDNRQPCONBXDRCK
GCBWHVQR        : ATUF            UFHCLN          IWNBEKSMRXVL   
FQOHFMGLWLBW    : LGMEYJ          JKKDLMDXSLYCKT  LWEFW          
FTVSILJXHRBKPIG : KGJD            DQWBCA          AKIRYWVJJ      
ALOSCXXQF       : FNWOSIH         HFDJVN          VGNFOVG         MXMXHHFPLTWX    QMRTWXSFADAEAKG
NSNNVUH         : XOKU            GXSMDHFQVGNBMCN MFRF           
NSIAQPRTAJ      : FTUFJXTONMAXWG  NOIHQLSOVNWLLGG PPGLVMCT        HVJATYXLE      
JQFUHYYFYRKL    : BHUCPBC         FKPTA           IOIPOTFVAA      WFIJMCULIFVWIFP SFEXLIM        
DYUC            : NWTYHELEIJPEKGB JQPDWDP        
FVKAEKQ         : XDPQN           BFPAOIXRBCEGXO  HCHRNSFTT       QYCESMWU        OBXI           
FNWOSIH         : ALOSCXXQF       CEJKQQSYIPSH    BQSBAWY         EIUEXUSEXVHQT   BFXBQVOKBJLGK   GSAHEPB        
FOYEUBXF        : GMRNOSY         PMPLHRPVJWLK   
FLMBPJILTISHBOO : VAKSHJTXGAQ     NDHVLIBCJHW     DASECBLAT       RRUEXTKI        QXHBFA         
NDHVLIBCJHW     : FLMBPJILTISHBOO LXPQQWUXFRB     QDGQ            PYQUVSQJJUODQ   PJHJIOVJVL     
FFALSOOIAWTT    : OFPCCCN         YYHA            AMTFNANMRI      PUCI            GSATVEBTEU      WRVVICUWOKVBNRM
ODIERXRXHQ      : KQTHXXECCPPSU   UJANKJJWDSES    YQIAJEVNRDM    
RRNCCLOHSQS     : QAYGDNEBYEM     CKKDPJR         FMOBRUNOHMMFR  
HHTHGPE         : YRSTQUSAGFFTRIR MXMXHHFPLTWX   
FJWLCUFC        : IIVBWNIJLRFEQV  FFSAAEVSGJGX   
VNWQBYSMPAHJVSQ : MCCUNEVYVXLF    QGPYNCUTXPPD   
OBMFF           : WKCRNUYYEWC     CPAGSGMCVMFW    HCDO            JEWWUOTBISJUJG  EOLX            KQNNJMQHDNRVJE  PPMDFJLF       
MOYX            : NSUVKSSFE       QWIMLJ         
TFUYCIVU        : XKCIG           PTGUVXKWGDMDSM 
WPBO            : KVQGAMVLHOR     KDVQRCBTADK     QPCYBLBJJIPQP  
JANCTVRUKYC     : ALGWQJNX        JDVIYOKJRKN     LKGR            WVAEVXLIYWFPBSA
LQKLMGQJHUU     : HPVLPFOD        COIEOCWHT      
RHCHITARTNWPJQK : XNWNI           KKXXYIBEVTU     RXBILKS        
PMHDG           : YDEDSLYGIETYVRT JVHMHNQNRJ      LWRRL           LFLPGQJWU      
QUCHEKFYP       : DLALWBVQHAJ     FILT            GKXJD          
GUFPQHJK        : WIRLJ           SMYEBTLJSGXXN  
GDHWNDOD        : FHLTPFFNPYNSRW  SIDEYOCEPOSYLCY
RLIIG           : JALBJKVDENNQW   IOOOAFGYHCV     CRLAHPV        
SMAAMRY         : IFGGH           BQMASOOBJRBKO   EIFAIK          HVJATYXLE       HIITVRQMC      
MGMDNWQ         : EUVXKFQOKA      TGSTNFNEAHPG    JWMRU          
FTUFJXTONMAXWG  : NSIAQPRTAJ      MYPQEXPYIWEBDV  SMYEBTLJSGXXN   OLAHPMPCMW      MPALK           YCTPRTNBV       HRPOOJEOYFQB    OPYSIRGJVAQKOLL
FTUFJXTONMAXWG  : FMOBRUNOHMMFR   WRVVICUWOKVBNRM
RVLR            : PHIFNVEN        BRRIXFEKB       ATJDU           YOBMLAI        
GTFSA           : MLMWROHCEISFQ   OJGBKIYCDFJO    GMVH            IETAX           BSKVVIJUQOG    
YORRAYNUEYUYO   : ISUDKODYT       LGOTPEX         TRLYGRY         JXYCIIGAPENCK   MGMFDJDFHPQUIPK
NOJKXWFTLWER    : AJPFJA          XXYXEWN        
LMTENIX         : IFGGH           VDWFMEJQPVOB    PNKTTGGKA       HJNATLIXS       BFPAOIXRBCEGXO  TVINJILJME     
KXUHCW          : WGAFXMJEQ       NILMXBAJCTHJLT 
DLNQCYCA        : OAAKWHY         IMMOHWKUDFABHM  SGJBEI          XUBYBPUPJBTMJBW IHNAUEBN        DSRFGKXTP       RNELRHJBGXUCNM  NKHULQKUBRIBYI 
DLNQCYCA        : ASGSUIGKQGT    
JVHGCBAOOVUCE   : KRJQXUCCA       UEOKH           SSBLFRQWSSHG    XWRHSLTIQAREVS 
KQTHXXECCPPSU   : ODIERXRXHQ      QBDEGBVVPMR     GEUUY           WLIQWM         
WWNGVWPXBR      : TXOOKWQ         KVBUYJXWTJNXFK  SNMTWWHBOY     
PNKTTGGKA       : WJRWY           LMTENIX         NYVYBSFQ       
KXUM            : QKNHTWOHWEYJAE  PINGKIKOXQIM    EIUEXUSEXVHQT   JICQRSLRY      
NDVIVS          : TWCCPFKWQ       WBBARCKSKKRFOVC
LABJPCMJQCWBX   : SEBUUOBQLFCG    JUMCQWRBGFFMURT HCVCIGPSOIRWDE 
HFDJVN          : QKNHTWOHWEYJAE  ALOSCXXQF       OVTYTUGM       
QAKEF           : EDGLETO         MAQRAQEMVDPUC   JDFAWQPLCVHW    EQAHKYAHXVSMTG 
MCCUNEVYVXLF    : VNWQBYSMPAHJVSQ JVMVR           FBMLBTOTDEUST  
PCSOUDVAORN     : TTHKGFXPEF      OBXI            XCDJEUJUWMKAK   YLACHXA        
INMNVUCXWW      : GEBGMISJDKJH    OTGUPANQUWWI    QPCYBLBJJIPQP  
DVNYVBENRIJ     : MNAVOKGU        PTATNIJN        FJWDBOTBANVNLL  UBNPIG          FFSAAEVSGJGX    WLIQWM         
DOED            : CGABOTKY        UBNPIG          QDPAKYGWYS     
VSFEJTTF        : DMNFXNHCEQUM    IHTUDHUHJX      LTDSYCAC        EEYQFI          VIBPNQXFYNMPQO  VQYLMR         
YFOXSRT         : HEVPVHJRVP      WTXHMUOBQTUBIRL
RSKXICHTK       : NYVYBSFQ        WFOVEPSUTVA     EBAOLDR        
IOQQK           : FIWIWBSLSQRGX   JWBOXYEO       
XQURNAIMHYKB    : DGFK            MNOHTKQNQLMUQ   LVDCCXAK        QWKDULANWUKKRX 
HJNATLIXS       : LMTENIX         EEFUDSBKLTH     AUSYWGPGTYQX    SFVNPYGV       
KGNYYGLKEDI     : JJMKPUJUCHV     MDAOERNXU       GQTAIWWONSJERSG
SIHFSGRTAYFNY   : DPMEOGKCWAQXNH  UJANKJJWDSES   
CKCUPNDFM       : OVTJCUDTFC      BFEVD           AKAOFGWHHLO    
MYPQEXPYIWEBDV  : FTUFJXTONMAXWG  EELULEKN       
GXFVWHXJJVYWBF  : BUOKHONHRMHYB   FKCLLAW         JFNXHXTV       
GRLXKRXAQI      : VHPDJHHES       WWHLUEQMFHMA    NUWKDWMNV       WPEW            NGDUUKXMWAFO    NNIHUA          FSISNUTMMJ     
WMFUJLSOJ       : VNJEF           AKAOFGWHHLO    
XKCIG           : CEQGPGIQCKHAYK  TFUYCIVU        QFHWCHPFADP    
FHLTPFFNPYNSRW  : INBNNMWOY       GDHWNDOD        OLAHPMPCMW      TUSS            TFYK           
QJWOSKH         : FBRJAGKBXTKBF   DAHWPFWWHOL     MRDBJYNXJ      
UCIFHQNLYWWSNCB : BCNNDEACPAYHKW  JUVM            COFRSHAJNVBX    JQNJ           
TCRMWQ          : TBMTKG          QTPQORAEYDUIJ   FFSAAEVSGJGX    LUFN           
NAEEU           : HEXIYYCIP       OKLELXG         HDUH           
OFKQ            : MNOHTKQNQLMUQ   TWXK            JFNXHXTV       
RAHHLIEKETO     : NLSDF           GSAHEPB         BAOFAFSJUHXT   
XJLRXIIFYIKD    : UGOKYHHWH       DGFK            WFRPP           PUUWHS          TTHKGFXPEF     
ARLMLCG         : RPHVQXVPAAVWX   NSUVKSSFE       JRQDXDXWNDDOON 
LNAWRM          : TRTWXC          AWCBE           MOXEY           GLPEURGEDJR    
MEKM            : HVJATYXLE      
VGNFOVG         : WJRWY           ALOSCXXQF       FUYFFDKGWBUI    BUOKHONHRMHYB   VOUXOOHHLPNVJVP
GLEIGRUTVBFIQ   : ROHAOQVNLEDARO  PTPDAINJQN      NIIU            WWFIJCCNDJIJY   HVJATYXLE      
FIWIWBSLSQRGX   : IOQQK           LPCS            KNROUVTXTPP     JJTUXE          AYEJCNFOGTSURIT TAKXAWKYAY     
CEJKQQSYIPSH    : DSYIWAMW        FNWOSIH         PTHCCFEJL       YOCNOKYQAKT    
APJKWSH         : QPTLPEFDAPRFIB  RLGSKVDESQSA    GAWDT          
RKAEDSXLRHQ     : RIRTANUNCVSCJ   RKGJXNX         QFHWCHPFADP    
QBOHWNSMIAGJRPT : DPMEOGKCWAQXNH  BDHVCHAUGWD     KVPGXWAAUGYUJG 
KBXFNALQ        : FHXPXDVWVB      AQXAS           PBWS            CIPTPOMNRNCVGT 
JEKSWJKY        : EAFHXKNCT       UCULWIF        
TXOOKWQ         : IBFOCVGQAMO     WWNGVWPXBR      UOXQJEP         GKXJD          
GILCYXDYDSYQLS  : MNCHSMKEGIU     MDCRJDVADVJPUPQ KHTHRFGWGQYOGEV JBKW           
QFTNOGOPD       : EDXMCATAKT      NHBGB           ARYPI          
ERCDJUKTIMVHSUM : VSIEHLTEFULLJRT LVDKIBHDVECCCJ 
WEARHSWBIMKA    : VTFAVWJOUMXJW   LWMNNJIR        PYQUVSQJJUODQ  
NOIHQLSOVNWLLGG : SUALTFAABL      NSIAQPRTAJ      HDYQRU          HEXIYYCIP       UOVIAVFYQMBTCY 
VTFAVWJOUMXJW   : BAEBSTG         WEARHSWBIMKA    YDEDSLYGIETYVRT QYCESMWU        AKAOFGWHHLO    
LKOTSIFLWEBVROD : UEBT            PJRFPNAJBDTB   
XBTFDQFMHCYFL   : IEMXNJRRAROPN   BBGJ            KSGBJWWYYMT    
HYJWUCFCQEITAAL : QBQEBADVKKYLQP  YBVENBCYD       OVTYTUGM        YADIKAVTEK      KCDXNV          MFDBDY          PJHJIOVJVL     
ALGWQJNX        : YJVI            QCJYUVJYETWQ    JANCTVRUKYC     COFRSHAJNVBX    UUCEC           QXMKFW         
UAVDNUKOEJLJ    : GFCQMAUNYEUNK   IADIFDIXFSR     KLTQC           VTWAFSR        
OCUYVVCJBE      : BHUCPBC         XRPKC           BSREMBH         EPOJCY          MFRF           
IBORQMOOPMRDH   : REQEXWPAVJNRE   JLTH            QVQPV           NXVXFAPO        QTINNU         
ULQGWHWYDW      : VNJEF           RIEORDUCSWX     EONUAVQIQDSBKU 
YYHA            : FFALSOOIAWTT    LUQDYSGUVX      NILMXBAJCTHJLT  PKMHVRCLTJV     LVKFFESYKXY    
DKHRDXETMVGGAPN : RSKQVKCHYMINCYM DDGFCS          SPCR            WKLTVBOMV      
BEBYNY          : RVPKA           NDENIXQV        XDTAIBXNPHQQ   
QXXPYGS         : VHPDJHHES       ICDUQDLMWPYA    QITDHWUDRYSMP   KMHAHCQMVFVL   
LFLDIM          : GXSULMBWWT      EBAOLDR        
EBGK            : KBGPMEMSHHPPX   BOCEAAPP        ORBCXBPQYC      PFWNCBXPO      
ICXFEEIFRHFJHG  : YULCXFREW       QGODLABIMOI    
GMVNXCYDMNMRP   : JXUUHMQARAKWR   NLSDF           YDQMPLFQQJPT    QBQEBADVKKYLQP  LOCAM           DIJT            SWQSGDLDM      
EAFHXKNCT       : IMRSNPOJI       JEKSWJKY        NHBGB           GTXUKCXX        YQFCOT          SUEUAEJYFPEITK 
TDAF            : GUNKITNJXAOPCB  LBGPFO          HJRJDUGAQWD     CWWUFGXB        CWJEGL          FCUU           
IHTUDHUHJX      : VSFEJTTF        GOXL            UIMISSMAX       SENSOGG        
WNMOKQO         : BXUS            WNJEYSBLNH      MGMFDJDFHPQUIPK
XOBL            : VQPG            IGBR            SSBLFRQWSSHG   
WGNBJSOR        : CGGRPHSEFGXC    SIMDRITY        FMJTPERL        FKCKLROVGLFWMXK PGNWWGMAFRRVYK  MPALK           WOCNKOUHTQ     
IPIQMPCNKBDY    : IUVDRHRWWES     RNJHXRYNTHM     DXFPOGSKX      
NSHGQWKFPHNDIY  : DBFSUCM         NRIAGRH        
WRBIJJBVCDJ     : ACTBEFCV        VQEDEBOIN      
EMOWDH          : RICTQXVJKRKWNW  JAURJW          KPFBFR          MGPNII          PFUDFEFDVSOQBLF BCVJ            YFJXGK         
JACVHTEV        : NJJIBXJIRI      JRKVSPTDEXTCAAA TAWBPKNDNESF    VSVWDVYC       
OUBOOCWXOX      : BHUCPBC         ORJMYBXBYAHO    GYFYMIQP        GMFYHJNYU       GEOAKNQQUHS    
SDGHHVXFYFKKIOH : NXEQMAYJOIGK    CTSG           
KNNKCLLSAQPBHPX : UXBGMPGD        HULSHHNHLO      PGPESKIV       
SGJBEI          : YTJMAETKBABSMFQ DLNQCYCA        ACXRPFFPHJYTNDS GOOBXHUMW      
DNUQXLXQV       : YCHVIXKC        YQIAJEVNRDM     JGPVDSKCWOC    
EHPRULULBVURVU  : YXMQARO         TMTDHJFUDASCJP  YLACHXA        
EHPJPXOFS       : YKYUSLH         ICDUQDLMWPYA   
EEFUDSBKLTH     : TCBMXJ          HJNATLIXS       OBFWLXRKDO      QWKDULANWUKKRX 
OVAMQTKOHOVW    : JXFLVVBKSSYE    IOOOAFGYHCV     SUEUAEJYFPEITK 
LXPQQWUXFRB     : NDHVLIBCJHW     YRSTQUSAGFFTRIR YXRUGELCXNK     PYQUVSQJJUODQ  
TNLP            : PHIFNVEN        UOXQJEP         IOOOAFGYHCV     TCDJQDNRRUIIRUS NNSPCPSOATVDR  
KEQNS           : BAEBSTG         DGCEHMNC        YOLEUTEJSJDX   
HDYQRU          : NOIHQLSOVNWLLGG QHKHJJY         EJQUXSW        
UGOKYHHWH       : IEMXNJRRAROPN   XJLRXIIFYIKD    QDGQ           
OINK            : VTBMGDT         HDWFDJ          DXPEDOKANXYDF   PSQQPMADKFQMPBB EKVLAOEQHQQ    
BCVOIMCBYLEXFY  : PKJIXRQM        FKPTA           IAGLHHSUVNTH   
VTBMGDT         : OINK            VSFRWLBKPUABHAM JRYLMYQYAI     
AEFQMUENV       : BVOK            MWOIVUJTHNKCRVU BXUS            RFQAFXMSVKBJPQ  COREW          
JMPXQQXDXV      : JALBJKVDENNQW   TLOU           
WRISUUYXQOX     : URDRJPIHPVMY    BAOFAFSJUHXT    IIMTG          
TRKOVXNEJATHT   : MMVYBSYAHMCBP   NCYHJJKLSLSGH   CEMFUSSWLRY     XLENFCKA        GDDBGGQ        
FYNEJMVRFQOER   : XGNVMTD         HXXU            OEQJFVP         CEMFUSSWLRY     ICLI           
URDRJPIHPVMY    : WRISUUYXQOX     FUYFFDKGWBUI    OQPQAL          OKSUHOUFRK     
IISXORLUDXSUFLL : SATWS           AJCL            YSRRJDMRSLG     GGOBLX          KGTGKD         
DSHV            : GJAVSVAWGOF     MFOUBWAMWB      ECVJWJYNTUQ     MSULKXTLS      
BFNJ            : CFRVCTYHXRWV    JUVM            NHBGB           KOLYCC          WVPEWFTGFLXYN  
DGCEHMNC        : KEQNS           FKPTA           BCVJ           
ETYYYX          : DYMDIO          JAEOLSNUVPUWDP  VWWNXKAWFABIWWP SNINMINN       
VFDHRJA         : YCHBPIMYKHTNGM  WGAFXMJEQ       NFAMQTVFAO     
FBCMOLCUTGYB    : VSSWXKNUM       VPXTJJ          UIGUHIPAC      
ODHSYG          : XGNVMTD         VOSP            GMRNOSY         TORLIQEAPANOILN HBHNKLBSAJOSE  
XGNVMTD         : FYNEJMVRFQOER   ODHSYG          WCMBKHHLHHQUC   GXSMDHFQVGNBMCN MFLIW           QDQWT          
DGFK            : MLMWROHCEISFQ   XQURNAIMHYKB    XJLRXIIFYIKD    OCLKHE          DKDNXBHHETHD    VTCJIJTVYMKT   
HWXUCSPKUSELWN  : PTHCCFEJL       EVDKOFULBII     TFYK           
XUBYBPUPJBTMJBW : DLNQCYCA        AAIQVXJ         WNJEYSBLNH      WOCNKOUHTQ      HTTMAN         
KVQGAMVLHOR     : JRCIQJWROFHA    WPBO            YDQQUC          BCDUQTBHWLK    
NGAOBENETKUDNQR : KRSIJGXHHNPWRK  FSYCMPVCIQJIWP  XSGPJFWRPNPQH  
UQNFOHL         : VSIEHLTEFULLJRT MPKMHHVEJ       RXGLTGTTOXR    
TJBBYUVO        : FGCOH           YXMQARO        
YDEDSLYGIETYVRT : PMHDG           VTFAVWJOUMXJW   BFPAOIXRBCEGXO  KLCXIPYKOX      VTCJIJTVYMKT    OVMIXVSHRO     
HCDO            : IOWJCOVWGIEM    OBMFF           UKYHGG          AYBNSOP        
SIXVLYTKNWLRCOM : JRYLMYQYAI      YESNFKRUYDTP    PINQPDL         LXMFTGEFW      
PSXTNYRH        : FJVW           
GOXL            : IMRSNPOJI       CKKUPA          DOSEAKIJCR      YUDPGYBO        IHTUDHUHJX     
NHOLDDMWPBWB    : LOEOBXRLFEHGBKI TMTMQE         
YRHQHDQDQ       : OAAKWHY         WFKSKQGGMPS     QDPAKYGWYS     
UALDOLOUAVMNCRB : KKUEXJTXQU      YWWBFGHKJEDBRF  FKPCSMYXRXC    
HEXIYYCIP       : LLJFHGCPKQOX    NAEEU           NOIHQLSOVNWLLGG HULSHHNHLO      SVDF            GURRG          
LGMEYJ          : FQOHFMGLWLBW    UEBT            CPMKTWKJCQTYC   IETAX           JVOLPRQPEPIWK  
MMVYBSYAHMCBP   : CDLLVINDOI      TRKOVXNEJATHT   CHWS            QKBRQGVNKTD     EBAOLDR        
ITESUDUEVGRE    : RDLPSTL         HTIC            VPXTJJ          XFKQUXBUV       WMAGYRIHCPEWN   PJUSLNNM       
YDEF            : JCSDAFTDKPOR    RNELRHJBGXUCNM  YTHHEWHHMU     
QBPUWQUEFYGVEQR : YUDPGYBO        HJXEMTW         EVDKOFULBII     RVOWHMEU        XYLMKBRGI      
MNOHTKQNQLMUQ   : XQURNAIMHYKB    OFKQ            RKMXTHCJAYF    
NHVFCSVYADXIBD  : PXYSFPGOGOHQ   
TNNJCXDOOQG     : JAQW            BVYR            YXMQARO         FOVVWFOJIIAQFN  JFYTIDHVKSN    
GDQBQBWVFS      : AQXAS           NIIU            OEPMYS          AKLF           
FUYFFDKGWBUI    : VHPDJHHES       VGNFOVG         URDRJPIHPVMY    IDQGQEKVFEKUVJK WXLBGBBW        FBRJAGKBXTKBF  
SNUHGDJ         : NWTYHELEIJPEKGB KPFBFR          AHGD            JKICUGUIMTB     VQXRIXNTHLAU    UEBT            EVRGFVKBWNEWDO 
GBPYEPWLKSSFRY  : QCJYUVJYETWQ    NLSDF           XTGVDMHKUE     
ULQTMNE         : QWIMLJ          RXBILKS         BUJFUXGA       
GRNPBQA         : MWOIVUJTHNKCRVU YCHBPIMYKHTNGM  GWHVOTO         VOFCM           AHPMMNB        
YDGAHVWSGPM     : QOGAFJRQJRSSHCE IMTMVYJNRICXH   YRSTQUSAGFFTRIR HDWGBAGHTIKKCL  ICDUQDLMWPYA    VTWAFSR        
JNXHYQDO        : ENKODFWGFJNEO   VNJEF           YWWBFGHKJEDBRF  UUCEC          
IHNAUEBN        : DLNQCYCA        IHRWYOOLHWYQRV  UFRKSJOIOQWFN  
ROHAOQVNLEDARO  : GLEIGRUTVBFIQ   XVAVADQVUCTRVD 
RVPKA           : HDMWUB          BEBYNY          QFGMKWOH        FAVGKA          HTTMAN          TIHBELBALJNT   
PINGKIKOXQIM    : SUALTFAABL      NGYUKXOLGUVDAFW KXUM            GEBGMISJDKJH    HTIC            MQQIBBDTPMU     SUATDOEXTIGWRC  VQHJRB         
IDQGQEKVFEKUVJK : FUYFFDKGWBUI    QVLXUFRB        NJBQKB          PKMTDDIWVEJSCI 
LQYV            : HIPY            DLLAFDOXQQKOJPO
FGORWOIHBIRGY   : WKCRNUYYEWC     QIMUS           JVHMHNQNRJ      HKQGKFWMXOGDB   TMTDHJFUDASCJP  EVRGFVKBWNEWDO  HDUH            ASGSUIGKQGT    
WFKSKQGGMPS     : QKNHTWOHWEYJAE  IKLWKJFNMKESLO  YRHQHDQDQ       YXRUMJPYCLBPU   NILMXBAJCTHJLT  NWFKQYWEDRH    
BMUWSCFIT       : XWSK            SDUSNHLAX       KVBUYJXWTJNXFK  FSYCMPVCIQJIWP  XSGPJFWRPNPQH  
WCMBKHHLHHQUC   : XGNVMTD         HPFLXUXNFUK    
LIMBXFWBTT      : TTMELVFDUIE     VOFCM           GXVYOX          HTERUIQPABHE   
NVGXPLWTAXGHITP : TCBMXJ          PLCLLVXN       
KMTQ            : YXRUGELCXNK     PJRFPNAJBDTB    KYFOXTPIPDBV   
DDYDJV          : IMMOHWKUDFABHM  WWXPVFILMLWAYM  SPQMVMKVY      
FPHS            : VQEJPBATAQXLBN  QDGQ           
NQFBOYEOFL      : DLALWBVQHAJ     ARXRHRGKEKUQ    MFOUBWAMWB     
YDQMPLFQQJPT    : GMVNXCYDMNMRP   UFHCLN          XBROVUK         HCVCIGPSOIRWDE 
OBAGLTU         : CPWDDX         
MADBCHSJURL     : UJAA            VDBU            AJMJOJH         SRSOFAT        
JAQW            : TNNJCXDOOQG     CGISABV        
HNOAJJ          : ISUDKODYT       EUVXKFQOKA      SBWGDIQYOX      UPLVADDTQLOK    WYGX           
NKWYGTASWD      : XBROVUK        
YMPKIHVJSXAPEKF : OCMQVHG         JPGLVEPSBHCMN   KOAOED         
KPFBFR          : EMOWDH          SNUHGDJ         YESNFKRUYDTP    HBHNKLBSAJOSE   PFWNCBXPO      
EXUEQRKNQW      : IPBBHSQTGTC     CNCJ            VHRRG           CTSG            QDPAKYGWYS     
BFPAOIXRBCEGXO  : TJGXME          FVKAEKQ         LMTENIX         YDEDSLYGIETYVRT
FRDWRHWMONEB    : INCPTYLOBFXN   
WXLBGBBW        : FUYFFDKGWBUI    UPGHNXONOK      VSYDPTMH       
YOLEUTEJSJDX    : KEQNS           PTATNIJN        LYUUGLCNNTATY  
XIFKWURXBQXNRG  : PKJIXRQM        KNBYEN          AKIRYWVJJ      
SEBUUOBQLFCG    : EFSMLJI         LABJPCMJQCWBX   VQPG            NTIPRMXX        SXULSELESJHQR   OJVTTEIMRSY     MFLIW          
GEBGMISJDKJH    : MGPQ            INMNVUCXWW      PINGKIKOXQIM    SYGFVRLPX       PJUSLNNM       
KWTQNPUPMSG     : QESYMODCYR      QPTLPEFDAPRFIB  MAGKSDFNCU      JFNXHXTV        WNJEYSBLNH     
JRULXNTD        : YJKDYAYXMRX     KOCK            GMVH            VCGKUKXUW      
ARYVEEGNLK      : HBYH            QVCFXVXIJRNMC   VOUXOOHHLPNVJVP
IHRWYOOLHWYQRV  : IHNAUEBN        NYGOANHUQVXPOTW ATJDU           SMBTWX          OKVTBCXJRVGOQBJ
PLBUCENBA       : YQIAJEVNRDM     VSVWDVYC       
FIHTTIEDCD      : OUQKEIUPDM      JVMVR           PPMDFJLF       
QTNY            : SYDLOYH         WKJBBWNOVQOPWG  DMEQRT          GQQOARVPFH     
ORJMYBXBYAHO    : OUBOOCWXOX     
HIIPPCLA        : KWOMMIVCCRCBBST BSKVVIJUQOG     DOHYOAOYOXIVFJ  CMDLVUMNAEYANQW
OCMQVHG         : CDJHOOSXV       YMPKIHVJSXAPEKF DMWNU          
BUOKHONHRMHYB   : YJVI            GXFVWHXJJVYWBF  VGNFOVG         IFCOKFSXO      
IJTX            : VAKSHJTXGAQ     PAHNHKWICOGKGWW FKEIFGHWOA      JRQDXDXWNDDOON 
XKEHBJWSFE      : XDPQN           QTPQORAEYDUIJ   RSDBFYPIRLDUWXH
CHWS            : XMCQUDJ         MMVYBSYAHMCBP   RSKQVKCHYMINCYM EIUEXUSEXVHQT   WEUPINYRPFQXHWV QGPYNCUTXPPD    IAFHQTRWJQQL   
GJHOBUXC        : QVLXUFRB        AHXUKFBBEPOGSI  RSDBFYPIRLDUWXH
JKKDLMDXSLYCKT  : VSDG            FQOHFMGLWLBW   
QVLXUFRB        : VSIEHLTEFULLJRT IDQGQEKVFEKUVJK GJHOBUXC        XPBMLHACAXASU   FGSKUWUULVYXR   JICKDW         
YRSTQUSAGFFTRIR : INBNNMWOY       HHTHGPE         LXPQQWUXFRB     YDGAHVWSGPM     ONPUKOEWUSKJ    NDRDTRWJ       
VQPG            : XOBL            SEBUUOBQLFCG    WNXAA          
WWHLUEQMFHMA    : TBMTKG          VBDIXFFX        GRLXKRXAQI     
ISVDSEIAXCK     : TXKD           
PHIFNVEN        : RVLR            TNLP            JAHLQQ          RSDBFYPIRLDUWXH NMACTDL        
PKJIXRQM        : BCVOIMCBYLEXFY  XIFKWURXBQXNRG  YKLCAO          QSVXEVES        IAOKDSIXRGI     VSMFVQOUIRFKGM 
SWKOBFULF       : PKXFNGPUXVSAKLR ICGYFHUYWDCIB   SMBTWX         
ORMEYX          : UUCEC           XRODSKCYEKJKTS  OVMIXVSHRO      BHEAONP         AQXDXQUISUKM    RVOWHMEU       
PTPDAINJQN      : GLEIGRUTVBFIQ   IWCGSDIKJ       UYALQYBICDKOPN  BDSIBDMASSY     BAOFAFSJUHXT   
JCSDAFTDKPOR    : YDEF            NDRDTRWJ       
FKCLLAW         : GXFVWHXJJVYWBF  PPCEFNAJPRMQ    UCUIFDVI        ACTBEFCV        MVNWOTFKGFT     CFONKTBELQJ    
TPGT            : ORVVKPJYXTTQG   GTXUKCXX        IVFUCBXNV      
UEOKH           : AUXPMBUWPV      JVHGCBAOOVUCE   BJKTRIMWBLL     KLCXIPYKOX      FIOUA          
NDENIXQV        : GPWG            BEBYNY          PXAQFYU         GYHUE           IKFWSVFHPXKPG   GSATVEBTEU     
HPDNCFYO        : KRJQXUCCA       FKPCSMYXRXC     PXYSFPGOGOHQ   
YRBOYXM         : DKFAKGTOVEJC    OJGBKIYCDFJO    FILT            NRIAGRH        
EDGLETO         : QAKEF           KOIUJXXXMDPKJYM XPBMLHACAXASU   BKNPLJOMBCTRYUQ RWMOVEATFP     
JXJC            : NLSDF           YCMWCL         
YKLCAO          : HIPY            PKJIXRQM        LVVX            JDFAWQPLCVHW    JUVM            OUAKNJPWOMGH    ALUALE         
BFQAWU          : WHGAIRDVE       NNIHUA          WQHUWK         
VSFRWLBKPUABHAM : VTBMGDT         CKKDPJR         IUVDRHRWWES     IJMBHSP         SBRNAAGPMAMLHQ  XSGPJFWRPNPQH   PVHOGWJJ       
VLVJQVXAA       : XGMEFVLQOLU    
TCDQTYJYT       : TUUVFAQR        YSRRJDMRSLG     OSUYDPL        
KUSDRUGYUSLQ    : YXRUGELCXNK     WBYOSUCIC       IWCGSDIKJ       HTTMAN         
HDWGBAGHTIKKCL  : YDGAHVWSGPM    
EHEQEYTYUCAPU   : MFOUBWAMWB     
JCVMYC          : REQEXWPAVJNRE   MDAJBPK         WWCE            HDWFDJ          QIHQENADFXIBXE  MFLIW           GLXNGJI        
YKYUSLH         : EHPJPXOFS       TXYLAORGMPDD    MFBEMVOVYWWW    XNWLT          
AFEHLUOLRNI     : FKCKLROVGLFWMXK QXXGPHHSEADFNH  OBFWLXRKDO      XTGVDMHKUE     
NARCJVXXUCQW    : JKNCRPNATETNRN  PPGLVMCT        ATBEAMWSSUWQ   
PTHCCFEJL       : PCKLLKMCIGEP    CEJKQQSYIPSH    HWXUCSPKUSELWN  IWVWUFCCM      
VHCH            : RATCTUVQD       TUSS            XTGVDMHKUE      JUMCQWRBGFFMURT
RRUGROKCKICIKSH : LWEFW          
LBGPFO          : TSWABDESNUJNVS  TDAF            UPLVADDTQLOK    HHTGEE          YWQQ           
PAHNHKWICOGKGWW : HDMWUB          NWTYHELEIJPEKGB IJTX           
IFNSRIAQVDX     : PLOFDXPEK       BGRLFGHNOI      TXKD            QDPAKYGWYS      NHTEWUWINGRLII 
JMHBOPOWCLH     : XMCQUDJ         VCGCBXEC        MMLI           
APTINQ          : CKKUPA          XCYDQOIODRT     EIUEXUSEXVHQT   CVCOA          
XYJQ            : ABAU            VCGCBXEC        YQMSKLR         QXMKFW          MCRCGWQSXGR     BKNPLJOMBCTRYUQ WLIQWM         
RSKQVKCHYMINCYM : TNURW           DKHRDXETMVGGAPN CHWS           
KWOMMIVCCRCBBST : FIOJ            HIIPPCLA        HJBST          
NELKQQR         : EIYM            JKPMRCBP        PEWCTLODFRTWQR  CAQKH           LSXKYTERSWPFQ  
DDGFCS          : XNWNI           DKHRDXETMVGGAPN SBWGDIQYOX      EQAHKYAHXVSMTG  NSEKD           LOCAM          
PPCEFNAJPRMQ    : FKCLLAW         RKMXTHCJAYF     AOXJOLCU       
HKQV            : BCNNDEACPAYHKW  MPKMHHVEJ       DUPWF           IEFLNY          CAQKH          
CGISABV         : JAQW            SDUSNHLAX       VCRBHXYCJD      ALUALE         
HDIAQXSV        : HGNQGJWDNGYRLX  RNELRHJBGXUCNM  UPLVADDTQLOK    PGRJCTBOOOKRG   TUNRDQ          YURTWNHWGXPHCN 
AJFJ            : CFRVCTYHXRWV    OSUYDPL         YULCXFREW       WWXPVFILMLWAYM  AKIRYWVJJ       WVPEWFTGFLXYN  
YXRUGELCXNK     : LXPQQWUXFRB     KMTQ            KUSDRUGYUSLQ    ASMTW          
HKKFQRJYTCWOX   : XDPQN           RATCTUVQD       LRDGPKPIWUDDUVC BLRRRRBESNA    
OJGBKIYCDFJO    : GTFSA           YRBOYXM         BBCGFVSMG       FKCKLROVGLFWMXK QXXGPHHSEADFNH  TNINNB         
HEVQ            : RXGLTGTTOXR     HDEE            HTTMAN          VSVWDVYC       
JBTA            : XMCQUDJ         GEOAKNQQUHS     ISCX           
FBRJAGKBXTKBF   : IEMXNJRRAROPN   QJWOSKH         FUYFFDKGWBUI    DMEHMAFTHDYDHYR NYEYRWTLAXEN   
CJVKSMTBSSRHCV  : HEVPVHJRVP      OKLELXG         PPGLVMCT        NILMXBAJCTHJLT  CDESVYPJYV     
EQKF            : BXJDVCAWN       WLQYLPP         GXSMDHFQVGNBMCN YULCXFREW      
TFTEITBSUGNWP   : XNWNI           IOWJCOVWGIEM    GNCPCCGPR       IKUTHHKDKUVPEV  OUAKNJPWOMGH    YQIAJEVNRDM    
HJXEMTW         : QBPUWQUEFYGVEQR PNJLXV          FELOXEV         DXPEDOKANXYDF   MVWCKKNJHWQLWX 
BBCGFVSMG       : MTTCMOTSEQ      OJGBKIYCDFJO    WUJQYSOQLM     
RATCTUVQD       : VHCH            HKKFQRJYTCWOX   GIDJESDIY       UMKIEYSYCHTXGIS
QSVXEVES        : PTMYXHJTOYAAJH  TBMTKG          PKJIXRQM        MDAOERNXU       OVTJCUDTFC      HPEWHBQHNBN     IUWNMPMC       
DASECBLAT       : LOEOBXRLFEHGBKI FLMBPJILTISHBOO GTJNHSC         EONUAVQIQDSBKU 
HJRJDUGAQWD     : MTTCMOTSEQ      TDAF           
PXAQFYU         : WKCRNUYYEWC     NDENIXQV        IRKUPJDUNB     
OYXKF           : QPTLPEFDAPRFIB  PLOFDXPEK       RIEORDUCSWX    
LRDGPKPIWUDDUVC : HKKFQRJYTCWOX   DLLAFDOXQQKOJPO
ASXDJDCGESFCD   : IDBDNEBIIGT     BDITVDVJJNCIJUR
HPFLXUXNFUK     : WCMBKHHLHHQUC  
AHGD            : SNUHGDJ         INTDEGHKY       YSAQWIWGNJJFIFM EELULEKN       
JVHMHNQNRJ      : PMHDG           FGORWOIHBIRGY   LVDKIBHDVECCCJ  FSYCMPVCIQJIWP  SPQMVMKVY      
VNJEF           : WMFUJLSOJ       ULQGWHWYDW      JNXHYQDO        OPYSIRGJVAQKOLL
RDLPSTL         : MOXEY           ITESUDUEVGRE    FELOXEV         RSOJXWRHACWW    NXEQMAYJOIGK   
ENMNQTWODLVS    : WGNYSNDSBVO     PHIXTKXX        BDHVCHAUGWD     JKNCRPNATETNRN  SUATDOEXTIGWRC 
MMLI            : LETNEV          JMHBOPOWCLH     PJUSLNNM        RDKMYKMLPHDKXI 
BTPGKHJXYERMJ   : YXKNQG          NXVXFAPO        DMEQRT         
BVMRRJJVW       : JXUUHMQARAKWR   ICCF            VLQQBBEPJUFMXOA PPEMIKAH        VTCJIJTVYMKT    YWQQ           
QYTEMEPQ        : CGENXL          HAPVTQC         QXMKFW          EFMQUSBCGSMRO  
FWKOJJNNBBXAEVM : NSUVKSSFE       GICK            OOMTIOBDVS     
OXFMWPDVJHLQWC  : WWCE            LKGR            ARYPI           CQSNBD          JGPVDSKCWOC    
EBES            : CMHQPJURCQXWOVT RIRTANUNCVSCJ   RSOJXWRHACWW   
NJBQKB          : IDQGQEKVFEKUVJK TDOCWBDOSLGQWTV UIMISSMAX       TAWCXNYIVKQEHP 
QWIMLJ          : MOYX            ULQTMNE        
XGMEFVLQOLU     : VLVJQVXAA       WHGAIRDVE       UBNPIG          HHTGEE          HTWF           
PVMJJCSKUFNQ    : HRWASUQBJYRY    UOVIAVFYQMBTCY 
KCKYLHYRT       : XWSK            OQPQAL          QXITSNVPVEWTERB QTINNU          CMDLVUMNAEYANQW
YSRRJDMRSLG     : IISXORLUDXSUFLL TCDQTYJYT       YESNFKRUYDTP    KVBUYJXWTJNXFK  UDESO          
UKYHGG          : HCDO            EUPKWMLRQVFGKOV TUSS            MRCGFHEMDRYV    EVDKOFULBII    
YCHBPIMYKHTNGM  : UOSYOGWOD       VFDHRJA         GRNPBQA         JICKDW          KCAPJSWLXM     
YXKNQG          : MTTCMOTSEQ      BTPGKHJXYERMJ   NHRASNTX       
YMVKMDSSARXKT   : LNPBXK          PGPESKIV        WEUPINYRPFQXHWV
SIMDRITY        : WGNBJSOR        MSULKXTLS      
DAVOPM          : RPGEUITLG       EULVMANJUTHY   
PNJLXV          : HJXEMTW         VAJGIPFGDOFSNKM VAQYSWVT        GIYDBKSNTSVKSE  FUDG            COGGFJLGNWVYE  
QPTLPEFDAPRFIB  : EHRFIV          FIOJ            OUCGN           APJKWSH         KWTQNPUPMSG     OYXKF           ROTWYUQETE      CDESVYPJYV     
JXFLVVBKSSYE    : CDLLVINDOI      OVAMQTKOHOVW    YWQQ           
WBYOSUCIC       : CNCJ            KUSDRUGYUSLQ    ISHBRLIOOJFJ    NKHULQKUBRIBYI  JSSIHDISMXE     UHSW            VCGKUKXUW      
NCYHJJKLSLSGH   : TRKOVXNEJATHT   PITUBTBS        SVGJHKDDJTOLFS  JGPVDSKCWOC    
ISHBRLIOOJFJ    : WBYOSUCIC       ACXRPFFPHJYTNDS GVURNBKXAGVJ    LWGQFYEFFI      AKLF            TBNRWXYVP      
HTHQJLS         : JTUQCSRBUMKBMA  JDFAWQPLCVHW    XLNNXHRCYLWT    MQSTMUXYKTDUL  
UCCIXPB         : LUYUYTLXRUILH   GAWDT           EONUAVQIQDSBKU  HTWF           
XPMQY           : EHMCDWCBB      
KNBYEN          : FIKVKEMC        EUEKOA          XIFKWURXBQXNRG 
OUQKEIUPDM      : FIHTTIEDCD      SEFQIGKJEMCJPTT YLVXHJO         ISCX            LWMNNJIR        IVFUCBXNV       CMDLVUMNAEYANQW
FQXDH           : XMCQUDJ         BONXCX          ACXRPFFPHJYTNDS OUVGQANR        BLRRRRBESNA    
KHRYXSR         : YFBW            QDGQ            YHSNHBLM        DDXXLE         
GTJNHSC         : DWRCAMBLJ       DASECBLAT       NMUAHRBUGWADHX 
KOIUJXXXMDPKJYM : EDGLETO         KGJD            HJBST           BQMASOOBJRBKO   LERUSXRBGB     
GEUGYN          : OFPCCCN         MGXAVFUTDFYWWMW VKNGJDP         NQBP           
GJAVSVAWGOF     : DSHV            NDRBBBLPMMWEBOH
YFBW            : CVQGRIOAL       KHRYXSR         AUSYWGPGTYQX    HTIC            HRGVGB          ICCF           
GOFPNRLVX       : QAAUHICRT      
CWWUFGXB        : LOEOBXRLFEHGBKI FOKNSGDAM       TDAF            SHHOHFYOMGD    
TBXAQDDRIEO     : QAYGDNEBYEM     KRJQXUCCA       YDQQUC          LXMFTGEFW       MWWEVSRVQVM    
KGJD            : FIOJ            FTVSILJXHRBKPIG KOIUJXXXMDPKJYM WPRRAATCUO      SIQWGMHTU      
BQSBAWY         : FNWOSIH         FOVVWFOJIIAQFN  AJMJOJH        
SEFQIGKJEMCJPTT : GPXV            CGGRPHSEFGXC    OUQKEIUPDM      MKFKAJCXWTNKCG  LHESEPFJBSXSQDM GTMNMFJNP      
LWGRGJNKBILDIM  : SJTCFYYCM       YHTPMHMP        MQSTMUXYKTDUL  
BTKTCRGNXUSIK   : CEYWYTNKL       VCGCBXEC        CPMKTWKJCQTYC   YULCXFREW       NQBP            WRVVICUWOKVBNRM
CGABOTKY        : DOED            TGSTNFNEAHPG    OLAHPMPCMW      JRKVSPTDEXTCAAA
UCUIFDVI        : FKCLLAW         INMR            JUKJVTCJDWL    
PTATNIJN        : DVNYVBENRIJ     YOLEUTEJSJDX    QAAUHICRT       DBUEVATEA      
CVPRBXTENOOM    : NYKNRLSRV      
LOVUVASFIK      : ROTWYUQETE     
LGOTPEX         : YORRAYNUEYUYO   AOXJOLCU        UOUHCQGEQOKDSI  UPXYWLQUK      
DPMEOGKCWAQXNH  : SIHFSGRTAYFNY   QBOHWNSMIAGJRPT XHQSDODVSUHDII  XLNNXHRCYLWT   
KDWFIFPLQV      : QXXGPHHSEADFNH  KGWNRERMKK      WBBARCKSKKRFOVC
NOHN            : FHVTLVENCNUFXS  JUVM            NIIU            BHEAONP         QITDHWUDRYSMP   QTINNU         
KDVQRCBTADK     : WPBO            PJRFPNAJBDTB    CMDLVUMNAEYANQW
RRUEXTKI        : KKUEXJTXQU      CNCJ            FLMBPJILTISHBOO LTDSYCAC       
AUSYWGPGTYQX    : HJNATLIXS       YFBW            PGPESKIV        BDFAF          
JRYLMYQYAI      : VTBMGDT         SIXVLYTKNWLRCOM FKCKLROVGLFWMXK RNJHXRYNTHM     SNINMINN        VPXTJJ          UFRKSJOIOQWFN  
WPRRAATCUO      : KGJD            PHLABEAHYGQ    
UVSBRRUROEKOPW  : NGDUUKXMWAFO    ALUALE         
HXRRRRHLJJ      : SRSWLDIUH       YDQOVHMDAGMOVPP RCRPVCIUIV      QDQWT          
FMJTPERL        : JHXDDNI         WGNBJSOR        VFSJE           EVRGFVKBWNEWDO  NQBP            VQEDEBOIN      
KDDCUJ          : VFSJE           NHBHULXALPA     AHPMMNB        
JALBJKVDENNQW   : YFEYBLWWQE      RLIIG           JMPXQQXDXV      RRKTXLFELVLUHJK NHDLFCCDQREOR  
FELOXEV         : HJXEMTW         RDLPSTL         CTSG            CWJEGL         
PGBULFP         : RBGFIVDIRXJ     GXSULMBWWT     
SBWGDIQYOX      : HNOAJJ          DDGFCS          JWMRU          
EQLDXPPMPTK     : WHYXOU          LHESEPFJBSXSQDM SVDF            TUNRDQ         
LSJGERWAKX      : BSIYQWWDM       YCHVIXKC        MSULKXTLS      
QDIKEW          : IVSDSWLVE       INMR            LHFKVXXIHFGM   
QBDEGBVVPMR     : KQTHXXECCPPSU   FBMLBTOTDEUST   PIMIIHF         LWGQFYEFFI      WFOVEPSUTVA     LPQRHLIQGITK   
UFVHMBYLD       : GOGUSYRVIKJBE  
JEEPMQTLBNOE    : JJMKPUJUCHV     YESNFKRUYDTP   
VFOTVDOYA       : RKGVEJBBT       HWYL            NNSPCPSOATVDR   WNXAA           QKSMEXX        
WHGAIRDVE       : PPPHJQEJC       WBSJEAPTA       LPLUPKHGOLPWAG  BFQAWU          XGMEFVLQOLU     LPCS            EEYQFI          JUKJVTCJDWL    
BVYR            : TNNJCXDOOQG     PBWS           
LVDCCXAK        : AJCL            XQURNAIMHYKB    MGSGDTJJGMROB   LBADXNUGCHN    
WIRLJ           : YUDPGYBO        QSFKDIHFOFQGAI  GUFPQHJK        ULFDHXJWWY     
FGCOH           : TJBBYUVO        BGODPNAEBUPI    JFNXHXTV        EONUAVQIQDSBKU 
IMJOW           : GXVYOX         
KWEB            : FUKVIMCYOSGJJCJ XWRHSLTIQAREVS  JSDQGWWYHD      KOLYCC          OSYJWEUPNWWA   
AGMFEPP         : FPQMHSRPOLDNQS  INMR           
MXMXHHFPLTWX    : NSUVKSSFE       ALOSCXXQF       HHTHGPE         KLTQC          
KHTHRFGWGQYOGEV : GILCYXDYDSYQLS  FHXPXDVWVB      XBSBLWNYCVXEFTK PGNWWGMAFRRVYK  KOAOED         
VQKTGIDNPTYMQW  : PRIXBUSIBLEGX   SBWAWJIYTMXRE   YJRHOGPOE       GKXJD          
DFLNY           : AUXPMBUWPV      VDBU            YWJLDFPNWWKIA   NYEYRWTLAXEN   
TXYLAORGMPDD    : CNCJ            YKYUSLH         DFIGL           DOHYOAOYOXIVFJ  GXRHUUPOS      
YJKDYAYXMRX     : JRULXNTD        PMPLHRPVJWLK    HYNNJYQORCRWOS 
VFSJE           : FMJTPERL        KDDCUJ          MAQRAQEMVDPUC   QKQRPLAYWMIRU   UDNFABDWOIV     KVPGXWAAUGYUJG  QXNDVOFIQY     
DFJQFAK         : BXJDVCAWN       HIBAORV         JRKVSPTDEXTCAAA
MAQRAQEMVDPUC   : QAKEF           VFSJE           VYCJXCAL        QVCFXVXIJRNMC  
OCLKHE          : XDPQN           DGFK            KSGBJWWYYMT    
LPCS            : EUEKOA          FIWIWBSLSQRGX   WHGAIRDVE       JXAPWK          BFEVD           ANNIAJEF       
UXBGMPGD        : KNNKCLLSAQPBHPX VSMFVQOUIRFKGM  OCKOBX          RQCJKAEG       
JVMVR           : MCCUNEVYVXLF    FIHTTIEDCD      GXSMDHFQVGNBMCN IIOEPSWXYN     
NOVSEXE         : OVHCUTOUM       MEWWCBE         NSAACQLLNWDX    PGRJCTBOOOKRG   XKVULVO        
FKPTA           : JQKJEVBCFWABSCO JQFUHYYFYRKL    BCVOIMCBYLEXFY  DGCEHMNC        AHAGCXQCKQ      XLNNXHRCYLWT    PRKMHHMXVT     
MCOND           : NLHSRAUQAV     
CVCFG           : HVJATYXLE      
EULVMANJUTHY    : DAVOPM          MTRDWGWR        WRNQOSUHAG      AJMJOJH        
PLCLLVXN        : MGPQ            NVGXPLWTAXGHITP JAHLQQ         
NTIPRMXX        : GPWG            SEBUUOBQLFCG    UJANKJJWDSES    LANOPVDPFQI     CWNIVRNH        ASMTW          
CSMAFOPQ        : JTEORLCXV       OKLELXG         LWGQFYEFFI     
JBKW            : GILCYXDYDSYQLS 
VYCJXCAL        : MAQRAQEMVDPUC   PIDAUIS         TTBLAVJWIMV     WUJQYSOQLM      MTVDLBQJKEV     YFJXGK         
TVINJILJME      : LMTENIX         SEBMFPQETXGMEOL FCXUIKHUEW      MCRCGWQSXGR    
PLOFDXPEK       : MDYOP           LGSEHJX         IFNSRIAQVDX     OYXKF           NHDLFCCDQREOR  
WGNYSNDSBVO     : ENMNQTWODLVS    HDUH           
HCHRNSFTT       : FVKAEKQ         RIEORDUCSWX     WWFIJCCNDJIJY   ICCF            IXGJKV          SIQWGMHTU      
FKCKLROVGLFWMXK : BQLYXAHPJLA     WGNBJSOR        AFEHLUOLRNI     OJGBKIYCDFJO    JRYLMYQYAI      WQAFVWWE       
QMOFMXJVQYO     : YJVI            FUKVIMCYOSGJJCJ RGMTVIDGYJ     
SKUAVWLHRC      : INCPTYLOBFXN    UJUBIPDXEWS     KJLCX           MIVDQS         
XOKU            : NSNNVUH        
IIVBWNIJLRFEQV  : ATOUKJCFNLPUR   FJWLCUFC        WHWREVJQAXSTPI  DSTGPC          IIMTG          
LHYM            : WFRPP           CEMFUSSWLRY    
YXMQARO         : SFKXLIXTHH      JDPNPRV         EHPRULULBVURVU  TJBBYUVO        TNNJCXDOOQG     PKFRLVFJKMD    
DMWNU           : OCMQVHG         GQDTCBUI        VDBU            OCSOOEW        
PRIXBUSIBLEGX   : MOXEY           VQKTGIDNPTYMQW  VAQYSWVT        XNPEOJYP       
HKQGKFWMXOGDB   : FGORWOIHBIRGY   IOIPOTFVAA      FILT            WRNQOSUHAG      MBISB           PBRGEUCQMKHRV  
QXXGPHHSEADFNH  : AFEHLUOLRNI     OJGBKIYCDFJO    KDWFIFPLQV      BGRLFGHNOI     
LVVX            : YKLCAO          TTBLAVJWIMV    
EIUEXUSEXVHQT   : IBFOCVGQAMO     FNWOSIH         KXUM            CHWS            APTINQ          IWCGSDIKJ       CPMKTWKJCQTYC   OBXI           
EIUEXUSEXVHQT   : WPNRXHSNIJKH    SHVNRVJHEDXVF  
XLOH            : ATOUKJCFNLPUR   PTXSSXDDRCANM   NYEYRWTLAXEN    RGMTVIDGYJ     
SJHBW           : JAEOLSNUVPUWDP 
QLMOJETUBXSXSYX : NANKPVHTWSTC    ICDUQDLMWPYA    OLAHPMPCMW      OOMTIOBDVS     
IOIPOTFVAA      : AWCBE           JQFUHYYFYRKL    HKQGKFWMXOGDB   JDFAWQPLCVHW    KIPEDEMXFV      DFIGL          
JDFAWQPLCVHW    : CUCK            QAKEF           YKLCAO          HTHQJLS         IOIPOTFVAA     
HRWASUQBJYRY    : SPBMIK          PVMJJCSKUFNQ    UBNPIG          VTCJIJTVYMKT    MEDDCLGJN      
YWWBFGHKJEDBRF  : UALDOLOUAVMNCRB JNXHYQDO        GLPEURGEDJR     QVCFXVXIJRNMC   AYEJCNFOGTSURIT
CFXJYUM         : WKCRNUYYEWC     XVIG            GIYDBKSNTSVKSE  BFEVD           VQHJRB         
PDVBFPC         : MNCHSMKEGIU     RTDLKYTBWB      PKWAWIDDMN     
QAAUHICRT       : INBNNMWOY       CGGRPHSEFGXC    GOFPNRLVX       PTATNIJN        HXXU            TTMELVFDUIE     ONPUKOEWUSKJ   
WWCE            : QCHTR           JCVMYC          OXFMWPDVJHLQWC  NWFKQYWEDRH    
EJTQLOD         : YJVI            GPUBQ           BONXCX          TEKG            LPQRHLIQGITK   
GICK            : FWKOJJNNBBXAEVM
UMSLOUG         : MNCHSMKEGIU     EKVLAOEQHQQ     SFVNPYGV       
FKPCSMYXRXC     : FIKVKEMC        UALDOLOUAVMNCRB HPDNCFYO        GXRHUUPOS       YWERI          
RSOJXWRHACWW    : RDLPSTL         EBES            IAOKDSIXRGI     TSEJEGKFWFDEY  
RIEORDUCSWX     : ULQGWHWYDW      OYXKF           HCHRNSFTT       RLJWSEXFSG      UIMISSMAX      
XVAVADQVUCTRVD  : ROHAOQVNLEDARO  EAYSKPL         DEGOYMNYDS      AJMJOJH         XTGARUTBRHNF   
YDQQUC          : KVQGAMVLHOR     TBXAQDDRIEO     DXFPOGSKX      
MTAHXTGV        : XHQSDODVSUHDII  FUKVIMCYOSGJJCJ NAGARRDYUY     
GTEFWHVSEAO     : VAQYSWVT        CKSTYNMUCWIX    EFABEI          VTWAFSR        
VSSWXKNUM       : FBCMOLCUTGYB    ATUF            QJADA           JSSIHDISMXE     HHBBIUWMYS      LXMFTGEFW      
HGNQGJWDNGYRLX  : HDIAQXSV        SWJRDEJUC      
JSGJI           : VOOI            NYGOANHUQVXPOTW DLLAFDOXQQKOJPO WFOVEPSUTVA     CWSSH           KMHAHCQMVFVL    YWJLDFPNWWKIA  
HDWFDJ          : BOXTCFSYRTND    OINK            JCVMYC          SEBMFPQETXGMEOL UPGHNXONOK      ICGYFHUYWDCIB  
XVIG            : CFXJYUM         QVQPV           TDOJ           
YWKIWPWD        : EKVLAOEQHQQ    
OQPQAL          : URDRJPIHPVMY    KCKYLHYRT       DAEYEMMXF       QMRTWXSFADAEAKG GNCPCCGPR       SNMTWWHBOY     
LTDSYCAC        : FJLCFTIMHER     VSFEJTTF        RRUEXTKI        PUUWHS          NJMVHC         
VAJGIPFGDOFSNKM : PNJLXV          SDTTJMGERUC     AUEMSG          AJMJOJH        
BFXBQVOKBJLGK   : FNWOSIH         SRPKRIRKOFQBA   RLJWSEXFSG      PAOYBPDXUPXJ   
TIPEOYVUH       : BONXCX          PCKLLKMCIGEP    MCRCGWQSXGR     FIOUA          
LOSYYHDAMBD     : SDUSNHLAX       XLNNXHRCYLWT    IFYFXUEDQ      
YRPDBBJNQDV     : ACXRPFFPHJYTNDS AGGMHAQHIYSJRP  WVAEVXLIYWFPBSA CDESVYPJYV      FDNRQPCONBXDRCK
JLKII           : XBVCSAJ         BHEAONP         HGCTXHLWMMWVYGM
HTIC            : ITESUDUEVGRE    PINGKIKOXQIM    YFBW            GGOBLX          OEPMYS         
HKXJYCMDDGUIJ   : XQDHQVMSCMRBI   IADIFDIXFSR     TRPOLHLA        EFABEI          QXHBFA         
RXRXTBJHLRPHCJ  : GIYDBKSNTSVKSE  WTXHMUOBQTUBIRL
EEYQFI          : VSFEJTTF        WHGAIRDVE      
JUVM            : GJSRM           UCIFHQNLYWWSNCB BFNJ            YKLCAO          NOHN            LHESEPFJBSXSQDM
QVNPPLIPFLCPA   : RRKTXLFELVLUHJK JICKDW          HIBAORV         RBXRGQUBISDS   
FHXPXDVWVB      : CFRVCTYHXRWV    KBXFNALQ        KHTHRFGWGQYOGEV TFXNJHUQQKAQIGP
MKFKAJCXWTNKCG  : PPPHJQEJC       SEFQIGKJEMCJPTT
QIHQENADFXIBXE  : JCVMYC          BAPEWBGWNUE     HMVDVUVDEC      BUJFUXGA       
GTPLEP          : LETNEV          NDRDTRWJ        SFVNPYGV       
INTDEGHKY       : AHGD            XBSBLWNYCVXEFTK QLNMHAFQXGE     NCKVSFAFFBI     SHKNJU         
SGQWTRAYRK      : NNSPCPSOATVDR   NDRDTRWJ        RDKMYKMLPHDKXI  ATBEAMWSSUWQ   
RRGXLVMRMLD     : MNCHSMKEGIU     SHHOHFYOMGD     EKVLAOEQHQQ     XNWLT          
IGGOPQNQJUHJQBL : ACTBEFCV       
TWVLOEMCABVO    : CNCJ            LVDKIBHDVECCCJ 
YRUHAMARAQDWAMQ : VTCJIJTVYMKT   
YLVXHJO         : OUQKEIUPDM      NLHSRAUQAV      SGRCRAPR        JKPMRCBP        RCRPVCIUIV      GSATVEBTEU      BUJFUXGA        GKXJD          
VSNYOFMQYJA     : IYHTMNKTILFETLF LANOPVDPFQI    
VAQYSWVT        : PNJLXV          PRIXBUSIBLEGX   GTEFWHVSEAO     MPALK           PWWAQOVANIMXHKP YLACHXA        
OXKATKHFYUCTLD  : JJTUXE          FAUUBE         
SPCR            : DKHRDXETMVGGAPN QKIINNGKMK      RVEWPYDQGEIO   
EQAHKYAHXVSMTG  : INCPTYLOBFXN    MAIIHPDWCOQPX   QAKEF           DDGFCS         
PQWVSUAMI       : OPDABI          QSFKDIHFOFQGAI  BOCEAAPP       
XBVCSAJ         : BAEBSTG         JLKII          
AQXAS           : KBXFNALQ        GDQBQBWVFS      WNJEYSBLNH      OUVGQANR       
XPBMLHACAXASU   : QVLXUFRB        EDGLETO         QLNMHAFQXGE    
IDHIEDNYF       : GJSRM           VPXTJJ          QFHWCHPFADP    
MGPNII          : TJXQ            EMOWDH          QXNDVOFIQY      UIGUHIPAC      
IAXUOHX         : IADIFDIXFSR     IDBDNEBIIGT     FAVGKA          DMEQRT          JFYTIDHVKSN    
IVSDSWLVE       : NANKPVHTWSTC    QDIKEW          GNCPCCGPR       JEKQDXOGA      
CKKDPJR         : RRNCCLOHSQS     VSFRWLBKPUABHAM LUFN            WYGX            NFAMQTVFAO      MWWEVSRVQVM    
YFGJDQMB        : VFVCE           SDUSNHLAX       ACXRPFFPHJYTNDS TNVXHBQOHYNM    NLHSRAUQAV     
BJKTRIMWBLL     : UEOKH           BCKJQOLF        OCKOBX         
PIDAUIS         : SRSWLDIUH       VYCJXCAL        NLHSRAUQAV      JSSIHDISMXE     OVOYMUACB      
AQFIAOLQB       : RNELRHJBGXUCNM  WPEW            GOOBXHUMW       CAQKH          
FCXPXRAKPDXD    : JRCIQJWROFHA    MEWWCBE         BCDUQTBHWLK    
OLHQGRJMSBRDBIO : MNAVOKGU        VRFHI           DAEYEMMXF       KSIUDUQ         CTSG            IUXHRH         
MDAOERNXU       : KGNYYGLKEDI     QSVXEVES        RNEUIQ          TFYK           
PXYSFPGOGOHQ    : JRCIQJWROFHA    NHVFCSVYADXIBD  HPDNCFYO        JXYCIIGAPENCK  
ATUF            : GCBWHVQR        VSSWXKNUM      
GTQSYSHFNWEI    : OUCGN          
VIBPNQXFYNMPQO  : VSFEJTTF        NDRBBBLPMMWEBOH
OTGUPANQUWWI    : INMNVUCXWW      SDBPSSUL        FMOBRUNOHMMFR   XWJNO          
DQWBCA          : FTVSILJXHRBKPIG DSMYWKHBGIND    OUVGQANR       
RSRWRFJIX       : CPAGSGMCVMFW    BDHVCHAUGWD     YOBMLAI        
TMTDHJFUDASCJP  : MTTCMOTSEQ      EHPRULULBVURVU  FGORWOIHBIRGY   RXGLTGTTOXR    
COIEOCWHT       : EHRFIV          LQKLMGQJHUU     YQMSKLR         UEBT           
BBGJ            : VCGCBXEC        XBTFDQFMHCYFL   ECVJWJYNTUQ    
GGOBLX          : IISXORLUDXSUFLL HTIC            SHKNJU         
QTPQORAEYDUIJ   : NUKPOXMPXQPC    TCRMWQ          XKEHBJWSFE      HRGVGB          HMVDVUVDEC      YURTWNHWGXPHCN 
MGSGDTJJGMROB   : LVDCCXAK        UYALQYBICDKOPN  MEDDCLGJN      
AAIQVXJ         : XUBYBPUPJBTMJBW SGRCRAPR        WIPBXAVCROA    
QKQRPLAYWMIRU   : VFSJE           QXITSNVPVEWTERB KGWNRERMKK      PADRGYUTJX      TDOJ           
NGYVTQKWKK      : CDLLVINDOI      LPMTLETEMWIOM  
SDUSNHLAX       : BMUWSCFIT       CGISABV         LOSYYHDAMBD     YFGJDQMB        OEPMYS         
RLGSKVDESQSA    : APJKWSH         JUKJVTCJDWL     VHRRG          
OVHCUTOUM       : NOVSEXE         PXXUAMOTSDRD   
PHIXTKXX        : ENMNQTWODLVS    IEFLNY          EIYM            GTBVMPQRC      
MEWWCBE         : QCHTR           NOVSEXE         FCXPXRAKPDXD    DUPWF           QOWVHCJ         QKBRQGVNKTD     PTXLHQAVSGLAC   JSSIHDISMXE    
TWXK            : GPWG            CERYIXBJXHLKODH OFKQ           
TRPOLHLA        : AJCL            HKXJYCMDDGUIJ  
EHMCDWCBB       : XPMQY           ASMTW          
IAOKDSIXRGI     : PKJIXRQM        RSOJXWRHACWW    DUPWF           BXATB          
ACXRPFFPHJYTNDS : SRSWLDIUH       SGJBEI          ISHBRLIOOJFJ    FQXDH           YRPDBBJNQDV     YFGJDQMB       
GVHQXXECQMCKTM  : TJXQ            LHFKVXXIHFGM    BHEAONP        
VOSP            : VVUEQBSTYF      AWCBE           ODHSYG          VWWNXKAWFABIWWP LPMTLETEMWIOM   NGDUUKXMWAFO   
XVVHFW          : LVDKIBHDVECCCJ 
TCXMLVVCTUGXNV  : QPYUNWGVV       GXRHUUPOS       IVFUCBXNV      
YPMR            : TLBRT           GWHVOTO        
DMEHMAFTHDYDHYR : FBRJAGKBXTKBF   TGSTNFNEAHPG   
UOXQJEP         : BJAIISGGLJGHGHB SYSCLGNBDYXIG   TXOOKWQ         TNLP            NYGOANHUQVXPOTW BDSIBDMASSY     YSAQWIWGNJJFIFM
ARXRHRGKEKUQ    : UTIIFXEYVIHOELI QSFKDIHFOFQGAI  NQFBOYEOFL      AOXJOLCU        TWCCPFKWQ       IJQMMHBYBTFMXMW TRRHWQVC       
AMTFNANMRI      : FFALSOOIAWTT    JDVIYOKJRKN     BWEXWKQMGNK     QJADA          
IGBR            : XOBL            DBJUOJNW        HLPJ            BDSIBDMASSY     OVOYMUACB      
SRPKRIRKOFQBA   : BFXBQVOKBJLGK   ERCFQKCPALTCG   AYEJCNFOGTSURIT
NAWJILJXAEGKM   : FQAR            PEWCTLODFRTWQR 
NHBGB           : SATWS           QFTNOGOPD       EAFHXKNCT       BFNJ            BEEIVOUJIL     
SSBLFRQWSSHG    : JVHGCBAOOVUCE   XOBL            INMR            FQAR            WBDBNIRIO       MQQIBBDTPMU    
GQDTCBUI        : DMWNU           QXMKFW          QKSMEXX        
HXXU            : FYNEJMVRFQOER   QAAUHICRT       HEVPVHJRVP      UWOEXOKNWLCV    FDNRQPCONBXDRCK
BDITVDVJJNCIJUR : ASXDJDCGESFCD   NLYOR           MAGKSDFNCU      GQQOARVPFH     
QXITSNVPVEWTERB : TBMTKG          UCJPEDRRLF      KCKYLHYRT       QKQRPLAYWMIRU   NLYOR           BUJFUXGA       
WJYSNWDY        : IDBDNEBIIGT     KRSIJGXHHNPWRK  QXHBFA         
FJWDBOTBANVNLL  : EFSRL           DVNYVBENRIJ     UEBT            LANOPVDPFQI    
RKGVEJBBT       : VFOTVDOYA       WYGX           
UJAA            : CGVBR           MADBCHSJURL     RNEUIQ          MTVDLBQJKEV     CMDLVUMNAEYANQW LVKFFESYKXY    
NHTMKWCEXCUWR   : RKMXTHCJAYF     WBDBNIRIO       QDCALKDCRQE     WBBARCKSKKRFOVC AJMJOJH        
IDBTJWX         : CEQGPGIQCKHAYK  KSGBJWWYYMT    
BAPEWBGWNUE     : JHXDDNI         QIHQENADFXIBXE  ENSHDDA         HDUH            NKDEFFOUQHRGT  
JPGLVEPSBHCMN   : YMPKIHVJSXAPEKF WUJQYSOQLM      UYALQYBICDKOPN  YLACHXA        
IWCGSDIKJ       : PTPDAINJQN      KUSDRUGYUSLQ    EIUEXUSEXVHQT  
NQEBNJKWBQL     : PFJFEPBTCKRSPA  NMUAHRBUGWADHX  KBGPMEMSHHPPX   GURRG          
XBSBLWNYCVXEFTK : QKNHTWOHWEYJAE  WKCRNUYYEWC     KHTHRFGWGQYOGEV INTDEGHKY       TDOJ            NFAMQTVFAO      TAKXAWKYAY     
GTXUKCXX        : TDAILLDOH       EAFHXKNCT       TPGT            JAEOLSNUVPUWDP  NTURAQ         
JXQAJQ          : EDXMCATAKT      QVCFXVXIJRNMC   SUATDOEXTIGWRC  PBRGEUCQMKHRV  
KLCXIPYKOX      : YDEDSLYGIETYVRT UEOKH           VNWEOW          GUEA           
TTBLAVJWIMV     : YCHVIXKC        IBFOCVGQAMO     VYCJXCAL        LVVX            HLPJ            JXYCIIGAPENCK   FAUUBE         
CFHTHQMIDAK     : JQKJEVBCFWABSCO PBWS            GXSMDHFQVGNBMCN LUQDYSGUVX     
ICDUQDLMWPYA    : QXXPYGS         EHPJPXOFS       YDGAHVWSGPM     QLMOJETUBXSXSYX LSXKYTERSWPFQ  
IWVWUFCCM       : PTHCCFEJL       HRGVGB          KFTRENXNVXEI    QXHBFA         
KFKUJKHN        : GPUBQ           MTXUBC          JKPMRCBP        TIDQ           
JQPDWDP         : DYUC            AHBGWBJHINBQ    GYFYMIQP        TJQRLPPWTPENTEQ
UOVIAVFYQMBTCY  : NOIHQLSOVNWLLGG PVMJJCSKUFNQ    HTTMAN         
HJBST           : KWOMMIVCCRCBBST KOIUJXXXMDPKJYM QDPAKYGWYS      IFYFXUEDQ      
GQTAIWWONSJERSG : VSDG            KGNYYGLKEDI     DBKWNWCWIVTKN   DXPEDOKANXYDF   OCKOBX         
AGGMHAQHIYSJRP  : YRPDBBJNQDV     DKDNXBHHETHD    RNUK            WLIQWM         
BGODPNAEBUPI    : BOXTCFSYRTND    FGCOH          
KOCK            : JRULXNTD        QKSMEXX         HCVCIGPSOIRWDE 
JAHLQQ          : PHIFNVEN        PLCLLVXN        EAHP            WIPBXAVCROA     NFAMQTVFAO     
RJGMYBPIRSAFUGJ : YXGEMEWFPLQ     WIGNPIXPBPHHC  
VRFHI           : OLHQGRJMSBRDBIO FILT            LWGQFYEFFI      XDTAIBXNPHQQ   
TGSTNFNEAHPG    : OFPCCCN         QESYMODCYR      MGMDNWQ         CGABOTKY        DMEHMAFTHDYDHYR LTRTBYOLVLHSYFR VHRRG           RAULYPEACUCR   
TGSTNFNEAHPG    : AYEJCNFOGTSURIT
PHLABEAHYGQ     : XQDHQVMSCMRBI   VBDIXFFX        WPRRAATCUO     
EKWLSGIY        : QDGQ            HAQEFXJ         CWSSH           IAGLHHSUVNTH   
COFRSHAJNVBX    : MAIIHPDWCOQPX   NLSDF           UCIFHQNLYWWSNCB ALGWQJNX        BWEXWKQMGNK     UOUHCQGEQOKDSI 
DYMDIO          : ETYYYX          EFMQUSBCGSMRO   YBHOUFE        
BGRLFGHNOI      : IFNSRIAQVDX     QXXGPHHSEADFNH  FLQJXDBMOIUGXQF UUYM           
SXULSELESJHQR   : SEBUUOBQLFCG    DSRFGKXTP       PKMHVRCLTJV    
RHPDVDEEVS      : UCJPEDRRLF      UEBT            GXVYOX          SWWEVFVCPRMIUKM NTURAQ         
EAYSKPL         : WJRWY           MOXEY           XVAVADQVUCTRVD  QCWP            WIGNPIXPBPHHC  
MWERKKMUSFOFW   : CDJHOOSXV       WRVVICUWOKVBNRM NYEYRWTLAXEN   
VCRBHXYCJD      : CGISABV         FUKVIMCYOSGJJCJ QYRQYMY        
JVOBIANHGHU     : EHGHJPGYVE      AJMJOJH         EONUAVQIQDSBKU 
TRLYGRY         : CGVBR           YORRAYNUEYUYO   NSEKD           XXYXEWN         TAWCXNYIVKQEHP 
PBWS            : CMHQPJURCQXWOVT KBXFNALQ        BVYR            CFHTHQMIDAK     VKNGJDP        
VSMFVQOUIRFKGM  : XKHQQRTODLBGOJ  PKJIXRQM        UXBGMPGD        SUEUAEJYFPEITK  OKSUHOUFRK      LPGJUBOYCCWCYP 
NJJIBXJIRI      : DKFAKGTOVEJC    JACVHTEV        CVABYQIHESESBF 
JKICUGUIMTB     : VHPDJHHES       YFAKXVGGWLWCJD  SNUHGDJ         KFTRENXNVXEI    NHDLFCCDQREOR   GVURNBKXAGVJ   
OJVTTEIMRSY     : SEBUUOBQLFCG    OLAHPMPCMW      QOSFKKBLHAKRF   IJQMMHBYBTFMXMW
TWOCOWPXHBC     : YOCNOKYQAKT     ROTWYUQETE      SEBMFPQETXGMEOL CJGCJKTVAXJ    
HAPVTQC         : TRTWXC          QYTEMEPQ        EONUAVQIQDSBKU  ULFDHXJWWY     
DAEYEMMXF       : IEMXNJRRAROPN   ENKODFWGFJNEO   OQPQAL          OLHQGRJMSBRDBIO
DCKRGBOWBYAD    : AKLF           
JDVIYOKJRKN     : JANCTVRUKYC     AMTFNANMRI      YMQGJIOWHIONAN 
QDGQ            : VFVCE           NDHVLIBCJHW     UGOKYHHWH       FPHS            KHRYXSR         EKWLSGIY        IXGJKV         
TTMELVFDUIE     : LIMBXFWBTT      QAAUHICRT      
LKGR            : JANCTVRUKYC     OXFMWPDVJHLQWC  NCKVSFAFFBI     QXNDVOFIQY      CFONKTBELQJ    
OSUYDPL         : TCDQTYJYT       AJFJ            VOUXOOHHLPNVJVP
HEVPVHJRVP      : IADIFDIXFSR     YFOXSRT         CJVKSMTBSSRHCV  HXXU            QBQEBADVKKYLQP  NHBHULXALPA    
TWJOFP          : MVTMYRYLRNCJQAV AUEMSG         
SAQMIHGFH       : JFYTIDHVKSN    
UUCEC           : ALGWQJNX        JNXHYQDO        ORMEYX          XRODSKCYEKJKTS 
TXKD            : TRTWXC          QESYMODCYR      ISVDSEIAXCK     IFNSRIAQVDX    
IUVDRHRWWES     : IPIQMPCNKBDY    VSFRWLBKPUABHAM RNUK            DEYFVGWYLW     
UFHCLN          : MNCHSMKEGIU     GCBWHVQR        YDQMPLFQQJPT   
WIJCNLD         : RBGFIVDIRXJ     INMR            FSALMYCOCPD     WTXHMUOBQTUBIRL
LNPBXK          : RBGFIVDIRXJ     CDJHOOSXV       YMVKMDSSARXKT  
BDHVCHAUGWD     : EFSMLJI         QBOHWNSMIAGJRPT ENMNQTWODLVS    RSRWRFJIX       OBFWLXRKDO      PPEMIKAH        JXAPWK         
YOCNOKYQAKT     : CEJKQQSYIPSH    TWOCOWPXHBC     JTJIQ          
XJAYHKBLPLHSSH  : TRTWXC          IXGJKV         
YESNFKRUYDTP    : SIXVLYTKNWLRCOM KPFBFR          YSRRJDMRSLG     JEEPMQTLBNOE    PPEMIKAH       
GLPEURGEDJR     : LNAWRM          YWWBFGHKJEDBRF  FILT            HYNNJYQORCRWOS  XLENFCKA       
UBNPIG          : EXFPRCQYDNEUJ   GPWG            DVNYVBENRIJ     DOED            XGMEFVLQOLU     HRWASUQBJYRY    YBAGU           HRPOOJEOYFQB   
OBFWLXRKDO      : PCKLLKMCIGEP    VSIEHLTEFULLJRT EEFUDSBKLTH     AFEHLUOLRNI     BDHVCHAUGWD     RQCJKAEG       
IWNBEKSMRXVL    : TDYLJYMRY       GCBWHVQR        WLIQWM         
RNJHXRYNTHM     : IPIQMPCNKBDY    JRYLMYQYAI      SWWEVFVCPRMIUKM MGMFDJDFHPQUIPK ALUALE          TAWCXNYIVKQEHP 
FGSKUWUULVYXR   : VSIEHLTEFULLJRT QVLXUFRB        KFTRENXNVXEI   
RRJENBRALPRM    : RKMXTHCJAYF     ELSLOYVDEM      QFGMKWOH        HCIQPP         
LTRTBYOLVLHSYFR : TGSTNFNEAHPG    RVOWHMEU        SHKNJU         
WFRPP           : XJLRXIIFYIKD    LHYM            EAHP            TNINNB         
DSRFGKXTP       : DLNQCYCA        SXULSELESJHQR  
PKFRLVFJKMD     : CEYWYTNKL       YXMQARO         NKDEFFOUQHRGT  
SWJRDEJUC       : CNCJ            HGNQGJWDNGYRLX  NANEREYQFHOCUYT
PUUWHS          : XJLRXIIFYIKD    LTDSYCAC       
WFIJMCULIFVWIFP : PKXFNGPUXVSAKLR JQFUHYYFYRKL    AJPFJA          ULFDHXJWWY     
RKMXTHCJAYF     : MNOHTKQNQLMUQ   PPCEFNAJPRMQ    NHTMKWCEXCUWR   RRJENBRALPRM    SDTTJMGERUC     PJUSLNNM       
GXREFAPUFL      : XWSK            EYSQHP         
NSEKD           : MGPQ            DDGFCS          TRLYGRY         KSIUDUQ         SNMTWWHBOY      WGAFXMJEQ       OUAKNJPWOMGH    GKXJD          
DKDNXBHHETHD    : AJCL            DGFK            AGGMHAQHIYSJRP  PSQQPMADKFQMPBB TEXTKNIKBT     
EKYVQHYGE       : ODOXUIXJ        GPWG            SEBMFPQETXGMEOL AUYTSSCVMX     
TMTMQE          : NHOLDDMWPBWB    AYBNSOP        
AHBGWBJHINBQ    : JQPDWDP         GSAHEPB         PHBUTXQMCMCQPMH LVKFFESYKXY    
CWGDVYMUH       : HRGVGB         
BCDUQTBHWLK     : VVUEQBSTYF      ONEGXBQS        KVQGAMVLHOR     FCXPXRAKPDXD    QBQEBADVKKYLQP  RBXRGQUBISDS    YQIAJEVNRDM    
INMR            : UCUIFDVI        QDIKEW          AGMFEPP         SSBLFRQWSSHG    WIJCNLD         SMBTWX          TFYK           
DSMYWKHBGIND    : DQWBCA         
HGTK            : VAKSHJTXGAQ     LWGQFYEFFI     
LHESEPFJBSXSQDM : SEFQIGKJEMCJPTT EQLDXPPMPTK     JUVM            RXBILKS         RVOWHMEU       
ELSLOYVDEM      : UCJPEDRRLF      RRJENBRALPRM    MVTMYRYLRNCJQAV PFWNCBXPO      
KGWNRERMKK      : HMKNPB          XCYDQOIODRT     KDWFIFPLQV      QKQRPLAYWMIRU   MBPOGPXILDXMFH 
TLOU            : JMPXQQXDXV      WBDBNIRIO      
GXSMDHFQVGNBMCN : MNCHSMKEGIU     NSNNVUH         XGNVMTD         EQKF            JVMVR           CFHTHQMIDAK    
ILMDRGR         : EXFPRCQYDNEUJ   LYUUGLCNNTATY   GXSULMBWWT      IGQYWKYQOJFNW  
SMYEBTLJSGXXN   : GUFPQHJK        FTUFJXTONMAXWG 
OKLELXG         : NAEEU           CJVKSMTBSSRHCV  CSMAFOPQ        NQBP           
WRNLUFUMKNYK    : HMKNPB          BXJDVCAWN       YTJMAETKBABSMFQ AUYTSSCVMX     
DEGOYMNYDS      : MVAUOUBBJ       XVAVADQVUCTRVD  HIITVRQMC      
PFUDFEFDVSOQBLF : EMOWDH          IAXEYGVPEGJ     HRPOOJEOYFQB   
AHXUKFBBEPOGSI  : GJHOBUXC        ATJDU           LWRRL          
KNROUVTXTPP     : FIWIWBSLSQRGX   FSALMYCOCPD     RVYCMYOPP      
QBQEBADVKKYLQP  : HYJWUCFCQEITAAL GMVNXCYDMNMRP   HEVPVHJRVP      BCDUQTBHWLK     SRDWJ           PKWAWIDDMN     
WKLTVBOMV       : EPNLBD          DKHRDXETMVGGAPN BICJUTISANK     JNLT            MXWP            BDFAF          
GWHVOTO         : GRNPBQA         YPMR            FQAR            JJTUXE          RDKMYKMLPHDKXI  TIDQ           
MVTMYRYLRNCJQAV : TWJOFP          ELSLOYVDEM      WEUPINYRPFQXHWV
TTHKGFXPEF      : PCSOUDVAORN     XJLRXIIFYIKD   
SYDLOYH         : BQLYXAHPJLA     QTNY            NTURAQ         
AYBNSOP         : HCDO            TMTMQE          CWJEGL         
HPBNM           : TJXQ            PKXFNGPUXVSAKLR JJMKPUJUCHV     RVYCMYOPP      
UWECWTH         : BGYXKHGISR      ENSHDDA         NYKNRLSRV      
JAEOLSNUVPUWDP  : ETYYYX          SJHBW           GTXUKCXX        VLQQBBEPJUFMXOA CVABYQIHESESBF  JICQRSLRY      
VWWNXKAWFABIWWP : ETYYYX          VOSP            EPOJCY          RXBILKS        
HRGVGB          : YFBW            QTPQORAEYDUIJ   IWVWUFCCM       CWGDVYMUH      
BWEXWKQMGNK     : VSIEHLTEFULLJRT HVPBQTLHRXCRKJJ BXUS            AMTFNANMRI      COFRSHAJNVBX    RBXRGQUBISDS   
NUWKDWMNV       : GRLXKRXAQI      WPNRXHSNIJKH   
FXUYGRFJGJHKHGW : JTJIQ          
UDNFABDWOIV     : VFSJE           EYEGQHTK        MTVDLBQJKEV    
XRODSKCYEKJKTS  : ORMEYX          UUCEC           HIEERJJVHRBNTIW UKCNHWNHHV      BLRRRRBESNA    
DBUEVATEA       : QVGMLIAWWFNBD   PTATNIJN        TWCCPFKWQ      
JWMRU           : MGMDNWQ         SBWGDIQYOX      MIBENRQMHY     
RNEUIQ          : PKXFNGPUXVSAKLR MDAOERNXU       UJAA            TEXTKNIKBT      HIVXE           MVWCKKNJHWQLWX 
HULSHHNHLO      : ISUDKODYT       KNNKCLLSAQPBHPX HEXIYYCIP       DBJUOJNW        FFSAAEVSGJGX    SCSLKQUHJQJVLE  AUYTSSCVMX     
RNELRHJBGXUCNM  : DLNQCYCA        YDEF            HDIAQXSV        AQFIAOLQB       TNVXHBQOHYNM    AUYTSSCVMX     
UJANKJJWDSES    : ODIERXRXHQ      SIHFSGRTAYFNY   NTIPRMXX        RNUK            RWMOVEATFP     
RKGJXNX         : XWEPSRWEDTQHGSL RKAEDSXLRHQ     LOCAM           VQXRIXNTHLAU    TNVBRYBNEVIAWK 
UJUBIPDXEWS     : SKUAVWLHRC      NILMXBAJCTHJLT 
WHCHSBMN        : IOWJCOVWGIEM    FAVGKA          RVEWPYDQGEIO   
FQAR            : NAWJILJXAEGKM   SSBLFRQWSSHG    GWHVOTO         UFRKSJOIOQWFN   OVOYMUACB      
MPKMHHVEJ       : DMNFXNHCEQUM    UQNFOHL         HKQV            QKIINNGKMK     
VOFCM           : NSUVKSSFE       GRNPBQA         LIMBXFWBTT     
RLJWSEXFSG      : MTTCMOTSEQ      RIEORDUCSWX     BFXBQVOKBJLGK   LSXKYTERSWPFQ  
LHFKVXXIHFGM    : GUNKITNJXAOPCB  QDIKEW          GVHQXXECQMCKTM  SNINMINN       
NIIU            : GLEIGRUTVBFIQ   GDQBQBWVFS      NOHN            KSIUDUQ         OVOYMUACB      
WWFIJCCNDJIJY   : BVOK            GLEIGRUTVBFIQ   HCHRNSFTT       IEFLNY          NCKVSFAFFBI     YHSNHBLM        MXWP           
SHHOHFYOMGD     : CPAGSGMCVMFW    DSYIWAMW        CWWUFGXB        RRGXLVMRMLD     ROTWYUQETE      HHTGEE          NMACTDL        
VOOSCLRJTB      : EXWHBVCICT      LOCAM           UCULWIF        
XRPKC           : CFRVCTYHXRWV    MLMWROHCEISFQ   OCUYVVCJBE      MIBENRQMHY     
LYUUGLCNNTATY   : OAAKWHY         YOLEUTEJSJDX    ILMDRGR         XOBHA          
RNUK            : AGGMHAQHIYSJRP  IUVDRHRWWES     UJANKJJWDSES   
ICCF            : ISUDKODYT       BVMRRJJVW       YFBW            HCHRNSFTT      
QFXIRAJE        : NTLQFFICEGEWV   IRKUPJDUNB     
GYHUE           : NDENIXQV       
IAXEYGVPEGJ     : PFUDFEFDVSOQBLF TNVXHBQOHYNM    JXAPWK          WMMNLB         
KLTQC           : UAVDNUKOEJLJ    MXMXHHFPLTWX    TFYK            HIITVRQMC      
QMRTWXSFADAEAKG : IDBDNEBIIGT     ALOSCXXQF       OQPQAL          HWYL            ENSHDDA         KOLYCC          TUSS            WPNRXHSNIJKH   
OFHKWNSHCGUYY   : OAAKWHY         MTRDWGWR       
YQMSKLR         : XYJQ            COIEOCWHT       PJUSLNNM       
RRKTXLFELVLUHJK : JALBJKVDENNQW   QVNPPLIPFLCPA   FAVGKA          FRWRG           MXWP            ATBEAMWSSUWQ   
SNINMINN        : WLQYLPP         ETYYYX          JRYLMYQYAI      LHFKVXXIHFGM    RQCJKAEG       
BGNMASGT        : LETNEV          GNCPCCGPR       SWQSGDLDM      
BRRIXFEKB       : KRJQXUCCA       RVLR            NSAACQLLNWDX   
VLQQBBEPJUFMXOA : BVMRRJJVW       JAEOLSNUVPUWDP  CDESVYPJYV     
OVTJCUDTFC      : CKCUPNDFM       QSVXEVES        CRLAHPV        
LOCAM           : BSIYQWWDM       GMVNXCYDMNMRP   DDGFCS          RKGJXNX         VOOSCLRJTB      UEBT            RFQAFXMSVKBJPQ 
SDTTJMGERUC     : VAJGIPFGDOFSNKM RKMXTHCJAYF     JUKJVTCJDWL     XLNNXHRCYLWT   
VPXTJJ          : PFJFEPBTCKRSPA  CVQGRIOAL       FBCMOLCUTGYB    ITESUDUEVGRE    JRYLMYQYAI      IDHIEDNYF      
GMRNOSY         : FOYEUBXF        ODHSYG          MRDBJYNXJ       GSATVEBTEU      TAWBPKNDNESF   
XBROVUK         : YDQMPLFQQJPT    NKWYGTASWD     
HWYL            : VFOTVDOYA       QMRTWXSFADAEAKG QCWP           
VQXRIXNTHLAU    : SNUHGDJ         RKGJXNX         FKEIFGHWOA      NQBP           
NLYOR           : BDITVDVJJNCIJUR QXITSNVPVEWTERB ANNIAJEF        SBYAKJQGTN     
QLNMHAFQXGE     : QAYGDNEBYEM     INTDEGHKY       XPBMLHACAXASU   MFLIW           WGAFXMJEQ      
DUPWF           : HKQV            MEWWCBE         IAOKDSIXRGI     DEYFVGWYLW      PPGLVMCT        QGPYNCUTXPPD   
NYVYBSFQ        : PNKTTGGKA       RSKXICHTK       SBYAKJQGTN     
GIYDBKSNTSVKSE  : PNJLXV          CFXJYUM         RXRXTBJHLRPHCJ  EYEGQHTK        GTBVMPQRC      
IJMBHSP         : ISUDKODYT       VSFRWLBKPUABHAM RTDLKYTBWB     
TNVXHBQOHYNM    : YFGJDQMB        RNELRHJBGXUCNM  IAXEYGVPEGJ     CQSNBD         
XHQSDODVSUHDII  : CEQGPGIQCKHAYK  DPMEOGKCWAQXNH  MTAHXTGV        KCDXNV          PTXSSXDDRCANM  
DAHWPFWWHOL     : DOSEAKIJCR      QJWOSKH         PADRGYUTJX      WMAGYRIHCPEWN   GMVH            MVNWOTFKGFT    
NYGOANHUQVXPOTW : ONEGXBQS        IHRWYOOLHWYQRV  JSGJI           UOXQJEP        
EHGHJPGYVE      : JVOBIANHGHU     QJADA           TEXTKNIKBT     
FUKVIMCYOSGJJCJ : KWEB            QMOFMXJVQYO     MTAHXTGV        VCRBHXYCJD      HAQEFXJ         NHRASNTX        NKDEFFOUQHRGT   YBHOUFE        
TFXNJHUQQKAQIGP : FHXPXDVWVB      OOMTIOBDVS      IGQYWKYQOJFNW   YWERI          
BCKJQOLF        : BJKTRIMWBLL     EVRGFVKBWNEWDO 
ROTWYUQETE      : QPTLPEFDAPRFIB  LOVUVASFIK      TWOCOWPXHBC     SHHOHFYOMGD     UFRKSJOIOQWFN  
DBJUOJNW        : IGBR            HULSHHNHLO      FMOBRUNOHMMFR   MWWEVSRVQVM    
FLQJXDBMOIUGXQF : MMYDBFEJ        BGRLFGHNOI      UMHR            IIMTG           TAWCXNYIVKQEHP 
LVFHDVLEGISR    : EFSRL           AWCBE           LGSEHJX         SRDWJ           OCSOOEW        
SIDEYOCEPOSYLCY : GDHWNDOD       
HAQEFXJ         : XMCQUDJ         EKWLSGIY        FUKVIMCYOSGJJCJ
LPMTLETEMWIOM   : NGYVTQKWKK      VOSP            OKSUHOUFRK     
SEBMFPQETXGMEOL : IIGUD           TVINJILJME      HDWFDJ          TWOCOWPXHBC     EKYVQHYGE       XNPEOJYP       
SYGFVRLPX       : NANKPVHTWSTC    GEBGMISJDKJH   
PGPESKIV        : KNNKCLLSAQPBHPX YMVKMDSSARXKT   AUSYWGPGTYQX   
ONPUKOEWUSKJ    : QCHTR           YRSTQUSAGFFTRIR QAAUHICRT       TEXTKNIKBT      EVRGFVKBWNEWDO  FJVW           
KRSIJGXHHNPWRK  : NGAOBENETKUDNQR WJYSNWDY        TCDJQDNRRUIIRUS LUFN            MFRF            MVWCKKNJHWQLWX 
DIJT            : BJAIISGGLJGHGHB CGVBR           GMVNXCYDMNMRP   UHSW           
CQJSU           : ISCX            HHBBIUWMYS      NRIAGRH        
NNTYBGQVOCDML   : TDAILLDOH       MBISB          
DBKWNWCWIVTKN   : TUBQDPXI        YCHVIXKC        GQTAIWWONSJERSG HBHNKLBSAJOSE  
FILT            : QUCHEKFYP       YRBOYXM         HKQGKFWMXOGDB   VRFHI           GLPEURGEDJR    
FSALMYCOCPD     : RPGEUITLG       WIJCNLD         KNROUVTXTPP     SFEXLIM        
UEBT            : LKOTSIFLWEBVROD LGMEYJ          SNUHGDJ         COIEOCWHT       FJWDBOTBANVNLL  RHPDVDEEVS      LOCAM           NMCDQLKQGL     
UEBT            : GEOAKNQQUHS     NFAMQTVFAO     
XWRHSLTIQAREVS  : JVHGCBAOOVUCE   KWEB            TCDJQDNRRUIIRUS DMEQRT          CLIONR         
QSXDTDUV        : OFPCCCN         QVSOGEVPF       DAGCVDPYCHN     SWWEVFVCPRMIUKM YTHHEWHHMU     
XNPEOJYP        : PRIXBUSIBLEGX   SEBMFPQETXGMEOL NANEREYQFHOCUYT
QYCESMWU        : FVKAEKQ         VTFAVWJOUMXJW   SUEUAEJYFPEITK 
CQYOIUONORI     : QVGMLIAWWFNBD   NXVXFAPO        IUWNMPMC        WIUERIMLSOVWIO 
MIBENRQMHY      : XWEPSRWEDTQHGSL JWMRU           XRPKC           QFHWCHPFADP     KYFOXTPIPDBV   
GDIC            : TLBRT           KEQVKTCDSKDVUC  EXWHBVCICT      KYYXUHTOWS      CLIONR          XYLMKBRGI      
IWWKQYBYTP      : MQQIBBDTPMU     WFOVEPSUTVA    
KKXXYIBEVTU     : MRUSTQJP        RHCHITARTNWPJQK TIDQ           
DVRMACQSKNRUG   : HHTGEE          OVOYMUACB       UIGUHIPAC      
XFKQUXBUV       : ITESUDUEVGRE    LHPOOF          AKIRYWVJJ      
DAGCVDPYCHN     : FHRWCHF         QSXDTDUV        TFYK            XWJNO          
JEWWUOTBISJUJG  : OBMFF           MRDBJYNXJ      
MBPOGPXILDXMFH  : KGWNRERMKK      QKIINNGKMK      GXSULMBWWT      GQQOARVPFH     
JTJIQ           : MTTCMOTSEQ      YOCNOKYQAKT     FXUYGRFJGJHKHGW COREW           QPCQKEHJN       VQEDEBOIN      
XKKI            : DEYFVGWYLW      MSULKXTLS       LBADXNUGCHN     YURTWNHWGXPHCN 
TDOCWBDOSLGQWTV : NJBQKB          HDEE            SDBPSSUL       
IEFLNY          : HKQV            PHIXTKXX        WWFIJCCNDJIJY   QVCFXVXIJRNMC  
WPEW            : GRLXKRXAQI      AQFIAOLQB      
QFGMKWOH        : RVPKA           RRJENBRALPRM    QVQPV           LSXKYTERSWPFQ  
TVTGEMDXIAH     : VQHJRB         
FUDG            : PNJLXV          VOUXOOHHLPNVJVP
CVABYQIHESESBF  : NJJIBXJIRI      JAEOLSNUVPUWDP  PITUBTBS        KBGPMEMSHHPPX  
YBVENBCYD       : HYJWUCFCQEITAAL TMDROVIQ        PKMHVRCLTJV    
NLHSRAUQAV      : MCOND           YLVXHJO         YFGJDQMB        PIDAUIS         PJHJIOVJVL     
TGYXAFSDN       : KIPEDEMXFV      HIBAORV         FURPUEA        
COGGFJLGNWVYE   : PNJLXV          RXGLTGTTOXR    
QHKHJJY         : HDYQRU          TBNRWXYVP       VXPCT          
PADRGYUTJX      : ABAU            YUDPGYBO        QKQRPLAYWMIRU   DAHWPFWWHOL     HRPOOJEOYFQB   
SGRCRAPR        : YLVXHJO         AAIQVXJ         JWBOXYEO       
QXMKFW          : ALGWQJNX        XYJQ            QYTEMEPQ        GQDTCBUI        CVCOA          
PITUBTBS        : NCYHJJKLSLSGH   CVABYQIHESESBF  LSXKYTERSWPFQ  
AOXJOLCU        : PPCEFNAJPRMQ    LGOTPEX         ARXRHRGKEKUQ    LWRRL           YADIKAVTEK      NNIHUA         
HPEWHBQHNBN     : VVUEQBSTYF      NBLKP           QSVXEVES        YXGEMEWFPLQ     JNLT           
UFXQCB          : MCRCGWQSXGR     QVPVODTV       
DTPFKQRYCT      : LLJFHGCPKQOX    VCGCBXEC        GVURNBKXAGVJ   
FBMLBTOTDEUST   : MGXAVFUTDFYWWMW MCCUNEVYVXLF    QBDEGBVVPMR     SMBTWX         
ATJDU           : CPWDDX          RVLR            IHRWYOOLHWYQRV  AHXUKFBBEPOGSI  VDBU            PINQPDL         BLRRRRBESNA    
IOOOAFGYHCV     : RLIIG           OVAMQTKOHOVW    TNLP            WWXPVFILMLWAYM 
GIDJESDIY       : RATCTUVQD       CMMGCGFQY      
BSREMBH         : OCUYVVCJBE      EIYM            MRDBJYNXJ       WWXPVFILMLWAYM  OITAOSVVMS     
ARYPI           : PTMYXHJTOYAAJH  RIRTANUNCVSCJ   QFTNOGOPD       OXFMWPDVJHLQWC  YWQQ            DDXXLE         
WQAFVWWE        : FKCKLROVGLFWMXK NYKNRLSRV       SYYUXOE        
ANMUSUUS        : VHRRG          
NMCDQLKQGL      : UEBT            WPNRXHSNIJKH   
QKIINNGKMK      : XABRVTCX        SPCR            MPKMHHVEJ       MBPOGPXILDXMFH  TWCCPFKWQ      
MAGKSDFNCU      : FHRWCHF         MNCHSMKEGIU     PEWRMOPON       KWTQNPUPMSG     BDITVDVJJNCIJUR
GXSULMBWWT      : LFLDIM          PGBULFP         ILMDRGR         MBPOGPXILDXMFH 
FCXUIKHUEW      : TVINJILJME     
LHPOOF          : UTIIFXEYVIHOELI XFKQUXBUV       FVMRKNU         UOUHCQGEQOKDSI 
JICKDW          : MMYDBFEJ        ANYGTOJ         QVLXUFRB        YCHBPIMYKHTNGM  QVNPPLIPFLCPA   LFLPGQJWU      
PAUPTHWY        : MRDBJYNXJ       RSDBFYPIRLDUWXH
SJTCFYYCM       : RICTQXVJKRKWNW  LWGRGJNKBILDIM 
SBWAWJIYTMXRE   : AUXPMBUWPV      OFPCCCN         VQKTGIDNPTYMQW  GNCPCCGPR      
OVTYTUGM        : VHPDJHHES       IKLWKJFNMKESLO  HFDJVN          HYJWUCFCQEITAAL
BQMASOOBJRBKO   : SMAAMRY         KOIUJXXXMDPKJYM MEDDCLGJN      
UPGHNXONOK      : WXLBGBBW        HDWFDJ          KVPGXWAAUGYUJG 
NGDUUKXMWAFO    : GRLXKRXAQI      UVSBRRUROEKOPW  VOSP            NSAACQLLNWDX   
IXGJKV          : FHRWCHF         HCHRNSFTT       QDGQ            XJAYHKBLPLHSSH  VHRRG          
GNCPCCGPR       : JQPUP           TFTEITBSUGNWP   OQPQAL          IVSDSWLVE       BGNMASGT        SBWAWJIYTMXRE   SHVNRVJHEDXVF  
AHAGCXQCKQ      : LETNEV          FKPTA           CVCOA           AKIRYWVJJ      
RFQAFXMSVKBJPQ  : AEFQMUENV       LOCAM           SWQSGDLDM       FSYCMPVCIQJIWP 
RXGLTGTTOXR     : UQNFOHL         HEVQ            TMTDHJFUDASCJP  COGGFJLGNWVYE   XNWLT           URMQUOQHIOPYGQ  PBRGEUCQMKHRV   DDXXLE         
DEYFVGWYLW      : IUVDRHRWWES     DUPWF           XKKI            BCVJ           
GSAHEPB         : PKXFNGPUXVSAKLR FNWOSIH         RAHHLIEKETO     AHBGWBJHINBQ    JXYCIIGAPENCK   KKLRYPBSQ      
KYYXUHTOWS      : CKQWMUAKFPRXWN  GDIC            KCDXNV          JRKVSPTDEXTCAAA
DXPEDOKANXYDF   : OINK            HJXEMTW         GQTAIWWONSJERSG WMMNLB         
DMYVNRGOSEJAYBW : CEMFUSSWLRY     JNLT            SFVNPYGV       
MCRCGWQSXGR     : XYJQ            TVINJILJME      TIPEOYVUH       UFXQCB          WIGNPIXPBPHHC  
LWRRL           : IPBBHSQTGTC     PMHDG           AHXUKFBBEPOGSI  AOXJOLCU        NHDLFCCDQREOR   MQSTMUXYKTDUL   CWNIVRNH        PEWCTLODFRTWQR 
NCKVSFAFFBI     : CEQGPGIQCKHAYK  INTDEGHKY       LKGR            WWFIJCCNDJIJY  
WUJQYSOQLM      : BBCGFVSMG       VYCJXCAL        JPGLVEPSBHCMN   CVCOA           EVDKOFULBII    
DLLAFDOXQQKOJPO : AUXPMBUWPV      IADIFDIXFSR     LQYV            LRDGPKPIWUDDUVC JSGJI           YXRUMJPYCLBPU   MGMFDJDFHPQUIPK
VSYDPTMH        : FOKNSGDAM       WXLBGBBW       
FVMRKNU         : LHPOOF          OLAHPMPCMW     
YXGEMEWFPLQ     : KPFQHVROVDOTJ   RJGMYBPIRSAFUGJ HPEWHBQHNBN     AJPFJA          SYYUXOE        
DIDVHINEVWA     : PTXSSXDDRCANM   FSISNUTMMJ     
UOUHCQGEQOKDSI  : LGOTPEX         COFRSHAJNVBX    LHPOOF         
KVBUYJXWTJNXFK  : WWNGVWPXBR      BMUWSCFIT       YSRRJDMRSLG     MTRDWGWR        TNINNB         
IIOEPSWXYN      : WHYXOU          JVMVR           YQFCOT          JEKQDXOGA       GOGUSYRVIKJBE  
KSIUDUQ         : OLHQGRJMSBRDBIO NSEKD           NIIU           
PSQQPMADKFQMPBB : OINK            DKDNXBHHETHD   
QVQPV           : CKKUPA          KPFQHVROVDOTJ   MDAJBPK         IBORQMOOPMRDH   XVIG            QFGMKWOH        MFRF           
EIYM            : NELKQQR         PHIXTKXX        BSREMBH        
EKVLAOEQHQQ     : OINK            UMSLOUG         YWKIWPWD        RRGXLVMRMLD     EBAOLDR        
DXFPOGSKX       : IPIQMPCNKBDY    YDQQUC          GMVH            JGPVDSKCWOC    
CPMKTWKJCQTYC   : LGMEYJ          BTKTCRGNXUSIK   EIUEXUSEXVHQT   MFBEMVOVYWWW    SYYUXOE         JUMCQWRBGFFMURT
PGNWWGMAFRRVYK  : WGNBJSOR        KHTHRFGWGQYOGEV ENSHDDA        
YAKOOVKMITQ     : MPALK           LPQRHLIQGITK   
PPEMIKAH        : BVMRRJJVW       BDHVCHAUGWD     YESNFKRUYDTP    JABVAYWILJYIVF  NWFKQYWEDRH     HIITVRQMC      
GTMNMFJNP       : SEFQIGKJEMCJPTT
MRDBJYNXJ       : IMTMVYJNRICXH   EPNLBD          QJWOSKH         GMRNOSY         JEWWUOTBISJUJG  BSREMBH         PAUPTHWY       
OLAHPMPCMW      : VDWFMEJQPVOB    FTUFJXTONMAXWG  FHLTPFFNPYNSRW  CGABOTKY        QLMOJETUBXSXSYX OJVTTEIMRSY     FVMRKNU         NOOFFLCPWDJQNST
VTCJIJTVYMKT    : FIKVKEMC        QVGMLIAWWFNBD   DGFK            YDEDSLYGIETYVRT BVMRRJJVW       HRWASUQBJYRY    YRUHAMARAQDWAMQ
NDRBBBLPMMWEBOH : GJAVSVAWGOF     VIBPNQXFYNMPQO 
OVMIXVSHRO      : YDEDSLYGIETYVRT ORMEYX          QYRQYMY        
GYFYMIQP        : OUBOOCWXOX      JQPDWDP         IETAX          
TCDJQDNRRUIIRUS : TNLP            KRSIJGXHHNPWRK  XWRHSLTIQAREVS  PAOYBPDXUPXJ   
TLCNCNUDSVRDMIO : GVURNBKXAGVJ   
MTRDWGWR        : XCYDQOIODRT     EULVMANJUTHY    OFHKWNSHCGUYY   KVBUYJXWTJNXFK  ATBEAMWSSUWQ   
GAWDT           : CKKUPA          CERYIXBJXHLKODH APJKWSH         UCCIXPB         JJTUXE          PGRJCTBOOOKRG  
YHTPMHMP        : QVGMLIAWWFNBD   QSFKDIHFOFQGAI  LWGRGJNKBILDIM  PKMHVRCLTJV    
IKFWSVFHPXKPG   : AJBLPVR         NDENIXQV        EFMQUSBCGSMRO   HRPOOJEOYFQB   
HLPJ            : CPAGSGMCVMFW    IGBR            TTBLAVJWIMV     CRLAHPV        
VDBU            : EFSMLJI         IIGUD           MADBCHSJURL     DFLNY           DMWNU           ATJDU           IRKUPJDUNB     
WMAGYRIHCPEWN   : NTLQFFICEGEWV   LGSEHJX         ITESUDUEVGRE    DAHWPFWWHOL    
EFMQUSBCGSMRO   : QYTEMEPQ        DYMDIO          IKFWSVFHPXKPG   IKUTHHKDKUVPEV 
UMHR            : FLQJXDBMOIUGXQF IFYFXUEDQ      
JXYCIIGAPENCK   : HPVLPFOD        YORRAYNUEYUYO   PXYSFPGOGOHQ    TTBLAVJWIMV     GSAHEPB         NYKNRLSRV       RWMOVEATFP     
OEQJFVP         : IMMOHWKUDFABHM  FYNEJMVRFQOER   MVNWOTFKGFT    
KIPEDEMXFV      : IOIPOTFVAA      TGYXAFSDN       NMUAHRBUGWADHX  RDKMYKMLPHDKXI  KCAPJSWLXM     
EAHP            : SATWS           JAHLQQ          WFRPP           NHTEWUWINGRLII 
JFNXHXTV        : JLTH            GXFVWHXJJVYWBF  OFKQ            KWTQNPUPMSG     FGCOH          
MFLIW           : XGNVMTD         SEBUUOBQLFCG    JCVMYC          QLNMHAFQXGE     UMKIEYSYCHTXGIS
SFEXLIM         : JQFUHYYFYRKL    FSALMYCOCPD     GMFYHJNYU       AHPMMNB        
NKHULQKUBRIBYI  : SRSWLDIUH       DLNQCYCA        WBYOSUCIC       GKXJD          
WNJEYSBLNH      : GUNKITNJXAOPCB  WNMOKQO         XUBYBPUPJBTMJBW KWTQNPUPMSG     AQXAS          
NSAACQLLNWDX    : NOVSEXE         BRRIXFEKB       NGDUUKXMWAFO    HVJATYXLE      
ERCFQKCPALTCG   : TLBRT           SRPKRIRKOFQBA   GOOBXHUMW      
PUCI            : MDYOP           FFALSOOIAWTT    DBFSUCM         MWWEVSRVQVM    
WKJBBWNOVQOPWG  : QTNY            BKNPLJOMBCTRYUQ
EYEGQHTK        : VBDIXFFX        UDNFABDWOIV     GIYDBKSNTSVKSE 
BGYXKHGISR      : UWECWTH         AQXDXQUISUKM   
VQYLMR          : VSFEJTTF        SENSOGG         QGODLABIMOI    
EOLX            : OBMFF           KGTGKD          JRKVSPTDEXTCAAA MFDBDY         
MFBEMVOVYWWW    : JJMKPUJUCHV     YKYUSLH         CPMKTWKJCQTYC  
FFSAAEVSGJGX    : SYSCLGNBDYXIG   FJWLCUFC        DVNYVBENRIJ     TCRMWQ          HULSHHNHLO      HIVXE          
MPALK           : LDHALDWXY       XNWNI           FTUFJXTONMAXWG  WGNBJSOR        VAQYSWVT        YAKOOVKMITQ    
QOSFKKBLHAKRF   : OJVTTEIMRSY    
KFTRENXNVXEI    : IWVWUFCCM       JKICUGUIMTB     FGSKUWUULVYXR   PJUSLNNM        YWJLDFPNWWKIA  
GTBVMPQRC       : FIKVKEMC        IFGGH           XCYDQOIODRT     PHIXTKXX        GIYDBKSNTSVKSE  KOLYCC         
UPLVADDTQLOK    : HNOAJJ          LBGPFO          HDIAQXSV        CVCOA           YMQGJIOWHIONAN  HVJATYXLE       NKIQYGUKPI      JNLT           
EIFAIK          : SMAAMRY         YHSNHBLM        YSAQWIWGNJJFIFM QVPVODTV        ORJWMJLP       
YQFCOT          : CPAGSGMCVMFW    YFMPMETR        EAFHXKNCT       IIOEPSWXYN     
GMVH            : GTFSA           JRULXNTD        DAHWPFWWHOL     DXFPOGSKX      
LUFN            : TCRMWQ          CKKDPJR         KRSIJGXHHNPWRK  AJPFJA          GDDBGGQ         LVKFFESYKXY     UIGUHIPAC      
JJTUXE          : FIWIWBSLSQRGX   OXKATKHFYUCTLD  GWHVOTO         GAWDT           IISCGEJYGI     
COREW           : CFRVCTYHXRWV    AEFQMUENV       JTJIQ           MFOUBWAMWB     
PXXUAMOTSDRD    : OVHCUTOUM       SRSOFAT         HIITVRQMC      
FAUUBE          : OXKATKHFYUCTLD  TTBLAVJWIMV     WIPBXAVCROA     MVWCKKNJHWQLWX 
WBDBNIRIO       : SSBLFRQWSSHG    NHTMKWCEXCUWR   TLOU            BXATB           GUEA           
OEPMYS          : GDQBQBWVFS      HTIC            SDUSNHLAX       TTAP           
QOWVHCJ         : BCGIMHTVHOFO    MEWWCBE        
DFIGL           : TXYLAORGMPDD    IOIPOTFVAA     
ENSHDDA         : BAPEWBGWNUE     UWECWTH         QMRTWXSFADAEAKG PGNWWGMAFRRVYK  HIEERJJVHRBNTIW
SRDWJ           : QBQEBADVKKYLQP  LVFHDVLEGISR    RGMTVIDGYJ     
YCTPRTNBV       : FTUFJXTONMAXWG  TNINNB          LWEFW          
PYFAIQPMGJVMO   : PVHOGWJJ        AUYTSSCVMX      JVOLPRQPEPIWK  
AJPFJA          : IIGUD           NOJKXWFTLWER    WFIJMCULIFVWIFP YXGEMEWFPLQ     LUFN           
IETAX           : BVOK            GTFSA           LGMEYJ          GYFYMIQP        KMLGVORSLSTAM   GVURNBKXAGVJ   
NYKNRLSRV       : CVPRBXTENOOM    UWECWTH         WQAFVWWE        JXYCIIGAPENCK  
IKUTHHKDKUVPEV  : TFTEITBSUGNWP   EFMQUSBCGSMRO  
OCKOBX          : UXBGMPGD        BJKTRIMWBLL     GQTAIWWONSJERSG SRSOFAT        
CKSTYNMUCWIX    : GTEFWHVSEAO     FIOUA          
PHBUTXQMCMCQPMH : YFMPMETR        AHBGWBJHINBQ    HMVDVUVDEC     
NMUAHRBUGWADHX  : WJRWY           GTJNHSC         NQEBNJKWBQL     KIPEDEMXFV      WGAFXMJEQ      
WHWREVJQAXSTPI  : FHVTLVENCNUFXS  IIVBWNIJLRFEQV  CWSSH           QGPYNCUTXPPD   
KVPGXWAAUGYUJG  : QBOHWNSMIAGJRPT VFSJE           UPGHNXONOK      RBXRGQUBISDS    SFVNPYGV       
HDEE            : TUBQDPXI        HEVQ            TDOCWBDOSLGQWTV OOMTIOBDVS      NKIQYGUKPI      XWJNO          
ICGYFHUYWDCIB   : SWKOBFULF       HDWFDJ          XOBHA          
QYRQYMY         : JFXHCGIBITDES   VCRBHXYCJD      OVMIXVSHRO      NXVXFAPO       
HIEERJJVHRBNTIW : KKUEXJTXQU      XRODSKCYEKJKTS  ENSHDDA         UYALQYBICDKOPN 
HUTLF           : PWWAQOVANIMXHKP DOHYOAOYOXIVFJ 
GXVYOX          : LIMBXFWBTT      IMJOW           RHPDVDEEVS      BHEAONP        
NXVXFAPO        : IBORQMOOPMRDH   BTPGKHJXYERMJ   CQYOIUONORI     QYRQYMY         MQSTMUXYKTDUL   WQHUWK          LBADXNUGCHN    
NXEQMAYJOIGK    : QVSOGEVPF       SDGHHVXFYFKKIOH RDLPSTL         YQIAJEVNRDM    
NHDLFCCDQREOR   : JALBJKVDENNQW   PLOFDXPEK       JKICUGUIMTB     LWRRL           SUATDOEXTIGWRC  SBYAKJQGTN     
QJADA           : TLBRT           VSSWXKNUM       AMTFNANMRI      EHGHJPGYVE      VNWEOW          LWMNNJIR        BOCEAAPP       
JQNJ            : TUBQDPXI        JTEORLCXV       UCIFHQNLYWWSNCB VQEDEBOIN      
YADIKAVTEK      : WJRWY           HYJWUCFCQEITAAL AOXJOLCU        JICQRSLRY      
GMFYHJNYU       : OUBOOCWXOX      SFEXLIM        
JUKJVTCJDWL     : OUCGN           UCUIFDVI        WHGAIRDVE       RLGSKVDESQSA    SDTTJMGERUC     WVPEWFTGFLXYN  
BTPDP           : KVDQ           
HCIQPP          : RRJENBRALPRM    WMXKBDWIO       CMMGCGFQY      
WYGX            : HNOAJJ          CKKDPJR         RKGVEJBBT       QWKDULANWUKKRX 
NHRASNTX        : JXUUHMQARAKWR   YXKNQG          FUKVIMCYOSGJJCJ KCDXNV          CWNIVRNH       
YULCXFREW       : ICXFEEIFRHFJHG  AJFJ            EQKF            BTKTCRGNXUSIK  
NANEREYQFHOCUYT : SWJRDEJUC       XNPEOJYP        SBRNAAGPMAMLHQ  QGPYNCUTXPPD   
TJQRLPPWTPENTEQ : JQPDWDP         GURRG           UIGUHIPAC      
GEOAKNQQUHS     : OUBOOCWXOX      JBTA            UEBT            YDQOVHMDAGMOVPP XOBHA          
GOOBXHUMW       : LETNEV          SGJBEI          AQFIAOLQB       ERCFQKCPALTCG  
JSDQGWWYHD      : KWEB            HTTMAN         
YDQOVHMDAGMOVPP : QAYGDNEBYEM     RICTQXVJKRKWNW  HXRRRRHLJJ      GEOAKNQQUHS     MTVDLBQJKEV    
KCDXNV          : NBLKP           HYJWUCFCQEITAAL XHQSDODVSUHDII  KYYXUHTOWS      NHRASNTX        HIITVRQMC      
EFABEI          : LOEOBXRLFEHGBKI GTEFWHVSEAO     HKXJYCMDDGUIJ  
KJLCX           : SKUAVWLHRC      CIPTPOMNRNCVGT  JABVAYWILJYIVF 
JKPMRCBP        : NELKQQR         YLVXHJO         KFKUJKHN       
SUEUAEJYFPEITK  : EAFHXKNCT       OVAMQTKOHOVW    VSMFVQOUIRFKGM  QYCESMWU        QGODLABIMOI    
CVCOA           : APTINQ          QXMKFW          AHAGCXQCKQ      WUJQYSOQLM      UPLVADDTQLOK    RVEWPYDQGEIO   
XLNNXHRCYLWT    : HTHQJLS         DPMEOGKCWAQXNH  FKPTA           LOSYYHDAMBD     SDTTJMGERUC    
SWWEVFVCPRMIUKM : PPPHJQEJC       RHPDVDEEVS      RNJHXRYNTHM     QSXDTDUV        UIMISSMAX       JVOLPRQPEPIWK  
KOLYCC          : BFNJ            KWEB            QMRTWXSFADAEAKG GTBVMPQRC      
LVDKIBHDVECCCJ  : GPWG            ERCDJUKTIMVHSUM JVHMHNQNRJ      TWVLOEMCABVO    XVVHFW         
EYSQHP          : NANKPVHTWSTC    FHRWCHF         GXREFAPUFL     
TDOJ            : NFEY            XVIG            QKQRPLAYWMIRU   XBSBLWNYCVXEFTK
NNSPCPSOATVDR   : TNLP            VFOTVDOYA       SGQWTRAYRK     
HTERUIQPABHE    : ISUDKODYT       MGXAVFUTDFYWWMW LIMBXFWBTT      TRRHWQVC       
KSGBJWWYYMT     : XBTFDQFMHCYFL   OCLKHE          IDBTJWX         OCSOOEW        
OOMTIOBDVS      : FWKOJJNNBBXAEVM QLMOJETUBXSXSYX TFXNJHUQQKAQIGP HDEE           
EMRGP           : PPGLVMCT       
KMLGVORSLSTAM   : IETAX           WNXAA           SHKNJU         
OBXI            : ABAU            FVKAEKQ         PCSOUDVAORN     EIUEXUSEXVHQT   FOVVWFOJIIAQFN 
PMPLHRPVJWLK    : CMHQPJURCQXWOVT FOYEUBXF        YJKDYAYXMRX     QPYUNWGVV       JVOLPRQPEPIWK  
YXRUMJPYCLBPU   : OFPCCCN         WFKSKQGGMPS     DLLAFDOXQQKOJPO
SVDF            : HEXIYYCIP       EQLDXPPMPTK     WBBARCKSKKRFOVC
PWWAQOVANIMXHKP : VOOI            VAQYSWVT        HUTLF          
ACTBEFCV        : WRBIJJBVCDJ     FKCLLAW         IGGOPQNQJUHJQBL RVYCMYOPP      
UPXYWLQUK       : XQDHQVMSCMRBI   LGOTPEX         PTXSSXDDRCANM  
LANOPVDPFQI     : CDJHOOSXV       NTIPRMXX        VSNYOFMQYJA     FJWDBOTBANVNLL 
QKBRQGVNKTD     : JFXHCGIBITDES   MMVYBSYAHMCBP   MEWWCBE         VOUXOOHHLPNVJVP
UCULWIF         : JEKSWJKY        VOOSCLRJTB     
ISCX            : JBTA            OUQKEIUPDM      CQJSU           UYALQYBICDKOPN 
FOVVWFOJIIAQFN  : TNNJCXDOOQG     BQSBAWY         OBXI            RCRPVCIUIV     
BSKVVIJUQOG     : SFKXLIXTHH      FJLCFTIMHER     DSYIWAMW        GTFSA           HIIPPCLA       
HIBAORV         : DFJQFAK         QVNPPLIPFLCPA   TGYXAFSDN       PBRGEUCQMKHRV  
QDCALKDCRQE     : LLJFHGCPKQOX    NHTMKWCEXCUWR  
MQQIBBDTPMU     : NSUVKSSFE       PINGKIKOXQIM    SSBLFRQWSSHG    IWWKQYBYTP     
UYALQYBICDKOPN  : PTPDAINJQN      MGSGDTJJGMROB   JPGLVEPSBHCMN   HIEERJJVHRBNTIW ISCX            FPIBF          
KHWFTOWERAJM    : WIGNPIXPBPHHC   PTGUVXKWGDMDSM  OPYSIRGJVAQKOLL
VHRRG           : BONXCX          IKLWKJFNMKESLO  EXUEQRKNQW      RLGSKVDESQSA    TGSTNFNEAHPG    ANMUSUUS        IXGJKV         
FAVGKA          : MVAUOUBBJ       CEQGPGIQCKHAYK  RVPKA           IAXUOHX         WHCHSBMN        RRKTXLFELVLUHJK GSATVEBTEU     
WOCNKOUHTQ      : MLMWROHCEISFQ   BJAIISGGLJGHGHB WGNBJSOR        XUBYBPUPJBTMJBW TMDROVIQ       
SWQSGDLDM       : DMNFXNHCEQUM    GMVNXCYDMNMRP   BGNMASGT        RFQAFXMSVKBJPQ 
WVAEVXLIYWFPBSA : JANCTVRUKYC     YRPDBBJNQDV     IISCGEJYGI      QWKDULANWUKKRX 
PIMIIHF         : QBDEGBVVPMR    
DMEQRT          : LOEOBXRLFEHGBKI QTNY            BTPGKHJXYERMJ   IAXUOHX         XWRHSLTIQAREVS  WTXHMUOBQTUBIRL DSTGPC          ATBEAMWSSUWQ   
QPYUNWGVV       : WHYXOU          VOOI            TCXMLVVCTUGXNV  PMPLHRPVJWLK   
DOHYOAOYOXIVFJ  : HIIPPCLA        TXYLAORGMPDD    HUTLF           YFJXGK         
TORLIQEAPANOILN : ODHSYG         
QCWP            : EAYSKPL         HWYL            KSYRUEVN       
YHSNHBLM        : KHRYXSR         WWFIJCCNDJIJY   EIFAIK         
NHBHULXALPA     : MGPQ            KDDCUJ          HEVPVHJRVP      GXRHUUPOS      
FIOUA           : UEOKH           TIPEOYVUH       CKSTYNMUCWIX    RSDBFYPIRLDUWXH
WWXPVFILMLWAYM  : DDYDJV          AJFJ            IOOOAFGYHCV     BSREMBH        
AUEMSG          : VAJGIPFGDOFSNKM TWJOFP          OITAOSVVMS     
JICQRSLRY       : CUCK            IBFOCVGQAMO     KXUM            JAEOLSNUVPUWDP  YADIKAVTEK     
QXAODL          : MRUSTQJP        LWEFW          
SYYUXOE         : LDHALDWXY       WQAFVWWE        YXGEMEWFPLQ     CPMKTWKJCQTYC   OPYSIRGJVAQKOLL
JKNCRPNATETNRN  : NARCJVXXUCQW    ENMNQTWODLVS   
CEMFUSSWLRY     : TRKOVXNEJATHT   FYNEJMVRFQOER   LHYM            DMYVNRGOSEJAYBW
SNMTWWHBOY      : WWNGVWPXBR      OQPQAL          NSEKD           UUYM           
PTXLHQAVSGLAC   : MEWWCBE         PPMDFJLF       
SBRNAAGPMAMLHQ  : SRSWLDIUH       VSFRWLBKPUABHAM NANEREYQFHOCUYT
IISCGEJYGI      : LYWG            JJTUXE          WVAEVXLIYWFPBSA WBBARCKSKKRFOVC HHBBIUWMYS      VXPCT          
NTURAQ          : MRUSTQJP        MDYOP           GTXUKCXX        RHPDVDEEVS      SYDLOYH         NWFKQYWEDRH    
TEXTKNIKBT      : DKDNXBHHETHD    RNEUIQ          EHGHJPGYVE      ONPUKOEWUSKJ    PINQPDL        
TWCCPFKWQ       : NDVIVS          ARXRHRGKEKUQ    DBUEVATEA       QKIINNGKMK      BOCEAAPP       
DBFSUCM         : NSHGQWKFPHNDIY  PUCI           
SIQWGMHTU       : KGJD            HCHRNSFTT       NBEYKOPD       
WRNQOSUHAG      : EULVMANJUTHY    HKQGKFWMXOGDB   MRCGFHEMDRYV   
SSJUA           : CMMGCGFQY      
RCRPVCIUIV      : ODOXUIXJ        HXRRRRHLJJ      YLVXHJO         FOVVWFOJIIAQFN  NHTEWUWINGRLII 
FSYCMPVCIQJIWP  : NGAOBENETKUDNQR BMUWSCFIT       JVHMHNQNRJ      RFQAFXMSVKBJPQ 
RBXRGQUBISDS    : QVNPPLIPFLCPA   BCDUQTBHWLK     BWEXWKQMGNK     KVPGXWAAUGYUJG  PPMDFJLF       
MQSTMUXYKTDUL   : MDYOP           HTHQJLS         LWGRGJNKBILDIM  LWRRL           NXVXFAPO        CMMGCGFQY      
FKEIFGHWOA      : IJTX            VQXRIXNTHLAU    PTGUVXKWGDMDSM 
PKMTDDIWVEJSCI  : IDQGQEKVFEKUVJK
WMXKBDWIO       : HCIQPP          IFCOKFSXO      
QVCFXVXIJRNMC   : ARYVEEGNLK      MAQRAQEMVDPUC   YWWBFGHKJEDBRF  JXQAJQ          IEFLNY         
KGTGKD          : ODOXUIXJ        IISXORLUDXSUFLL EOLX           
JRKVSPTDEXTCAAA : JACVHTEV        CGABOTKY        DFJQFAK         KYYXUHTOWS      EOLX            PYQUVSQJJUODQ  
AKIRYWVJJ       : FTVSILJXHRBKPIG XIFKWURXBQXNRG  AJFJ            XFKQUXBUV       AHAGCXQCKQ     
EPOJCY          : OCUYVVCJBE      VWWNXKAWFABIWWP
OUVGQANR        : FQXDH           AQXAS           DQWBCA          HRPOOJEOYFQB   
PTXSSXDDRCANM   : XLOH            XHQSDODVSUHDII  DIDVHINEVWA     UPXYWLQUK       YTHHEWHHMU     
TSEJEGKFWFDEY   : RSOJXWRHACWW    ULFDHXJWWY     
RQCJKAEG        : YFAKXVGGWLWCJD  UXBGMPGD        OBFWLXRKDO      SNINMINN       
IJQMMHBYBTFMXMW : ARXRHRGKEKUQ    OJVTTEIMRSY     GVURNBKXAGVJ    MBISB          
LFLPGQJWU       : PMHDG           JICKDW         
JXAPWK          : LPCS            BDHVCHAUGWD     IAXEYGVPEGJ     TFYK           
PAOYBPDXUPXJ    : BFXBQVOKBJLGK   TCDJQDNRRUIIRUS
GVURNBKXAGVJ    : ISHBRLIOOJFJ    JKICUGUIMTB     DTPFKQRYCT      TLCNCNUDSVRDMIO IETAX           IJQMMHBYBTFMXMW SHVNRVJHEDXVF  
XCDJEUJUWMKAK   : PCSOUDVAORN    
PJRFPNAJBDTB    : LKOTSIFLWEBVROD KMTQ            KDVQRCBTADK     PYQUVSQJJUODQ  
CWNIVRNH        : MVAUOUBBJ       CVQGRIOAL       NTIPRMXX        LWRRL           NHRASNTX        EVDKOFULBII    
JSSIHDISMXE     : WBYOSUCIC       VSSWXKNUM       PIDAUIS         MEWWCBE         NYEYRWTLAXEN   
EVRGFVKBWNEWDO  : SNUHGDJ         FGORWOIHBIRGY   FMJTPERL        BCKJQOLF        ONPUKOEWUSKJ    UMKIEYSYCHTXGIS
UDESO           : OPDABI          JHXDDNI         YSRRJDMRSLG     GEUUY           JKMPEVUY        IUXHRH         
LWGQFYEFFI      : LYWG            ISHBRLIOOJFJ    QBDEGBVVPMR     CSMAFOPQ        VRFHI           HGTK           
BDSIBDMASSY     : SFKXLIXTHH      PTPDAINJQN      UOXQJEP         IGBR           
HTTMAN          : XUBYBPUPJBTMJBW RVPKA           KUSDRUGYUSLQ    HEVQ            UOVIAVFYQMBTCY  JSDQGWWYHD      KVDQ           
YBAGU           : UBNPIG         
HYNNJYQORCRWOS  : WHYXOU          YJKDYAYXMRX     GLPEURGEDJR     TIHBELBALJNT    OSYJWEUPNWWA   
HRPOOJEOYFQB    : IPBBHSQTGTC     MAIIHPDWCOQPX   FTUFJXTONMAXWG  UBNPIG          PFUDFEFDVSOQBLF PADRGYUTJX      IKFWSVFHPXKPG   OUVGQANR       
WVPEWFTGFLXYN   : YFEYBLWWQE      BFNJ            AJFJ            JUKJVTCJDWL    
YCKRLD          : PARFAQPQ        JDPNPRV         MVNWOTFKGFT     PGRJCTBOOOKRG  
CTSG            : SDGHHVXFYFKKIOH EXUEQRKNQW      FELOXEV         OLHQGRJMSBRDBIO
SMBTWX          : LOEOBXRLFEHGBKI IHRWYOOLHWYQRV  SWKOBFULF       INMR            FBMLBTOTDEUST  
MFOUBWAMWB      : TCBMXJ          DSHV            NQFBOYEOFL      EHEQEYTYUCAPU   COREW           QWKDULANWUKKRX 
NAGARRDYUY      : MTAHXTGV        GOGUSYRVIKJBE  
BKNPLJOMBCTRYUQ : EDGLETO         XYJQ            WKJBBWNOVQOPWG 
KOAOED          : YMPKIHVJSXAPEKF KHTHRFGWGQYOGEV BAOFAFSJUHXT   
EUPKWMLRQVFGKOV : UKYHGG         
RAULYPEACUCR    : TGSTNFNEAHPG   
FPIBF           : AUXPMBUWPV      MWOIVUJTHNKCRVU UYALQYBICDKOPN  SPQMVMKVY       PWXKWEMPW      
XSGPJFWRPNPQH   : SUALTFAABL      JFXHCGIBITDES   NGAOBENETKUDNQR BMUWSCFIT       VSFRWLBKPUABHAM
LUQDYSGUVX      : YYHA            CFHTHQMIDAK     RVOWHMEU       
BPGEUBCPKTBPSV  : OPDABI          MDCRJDVADVJPUPQ OCSOOEW         UIGUHIPAC      
GLXNGJI         : DSYIWAMW        JAURJW          JCVMYC          LWMNNJIR       
OKSUHOUFRK      : FHVTLVENCNUFXS  URDRJPIHPVMY    VSMFVQOUIRFKGM  LPMTLETEMWIOM  
WIPBXAVCROA     : AAIQVXJ         JAHLQQ          FAUUBE          HDUH           
XNWLT           : LPLUPKHGOLPWAG  YKYUSLH         RRGXLVMRMLD     RXGLTGTTOXR     BCVJ           
WTXHMUOBQTUBIRL : YFOXSRT         RXRXTBJHLRPHCJ  WIJCNLD         DMEQRT         
TMDROVIQ        : YBVENBCYD       WOCNKOUHTQ     
GEUUY           : KQTHXXECCPPSU   UDESO          
RSDBFYPIRLDUWXH : MVAUOUBBJ       XKEHBJWSFE      GJHOBUXC        PHIFNVEN        PAUPTHWY        FIOUA          
RTDLKYTBWB      : PDVBFPC         IJMBHSP        
RVEWPYDQGEIO    : YJVI            SPCR            WHCHSBMN        CVCOA          
TUSS            : VFVCE           NLSDF           FHLTPFFNPYNSRW  VHCH            UKYHGG          QMRTWXSFADAEAKG
ASMTW           : QMLH            YXRUGELCXNK     NTIPRMXX        EHMCDWCBB       NHTEWUWINGRLII 
GXRHUUPOS       : TXYLAORGMPDD    FKPCSMYXRXC     TCXMLVVCTUGXNV  NHBHULXALPA     JKMPEVUY       
OKVTBCXJRVGOQBJ : NANKPVHTWSTC    IHRWYOOLHWYQRV 
UVNTVURPEPLTGG  : SYSCLGNBDYXIG   YCMWCL         
URMQUOQHIOPYGQ  : RXGLTGTTOXR    
XLENFCKA        : TRKOVXNEJATHT   GLPEURGEDJR     VXPCT          
PPGLVMCT        : NSIAQPRTAJ      NARCJVXXUCQW    CJVKSMTBSSRHCV  DUPWF           EMRGP          
OKEGCL          : CPWDDX          VBDIXFFX        CNCJ           
QDQWT           : XGNVMTD         HXRRRRHLJJ     
WIGNPIXPBPHHC   : RJGMYBPIRSAFUGJ EAYSKPL         MCRCGWQSXGR     KHWFTOWERAJM   
WGAFXMJEQ       : KXUHCW          VFDHRJA         NSEKD           QLNMHAFQXGE     NMUAHRBUGWADHX 
UKCNHWNHHV      : XRODSKCYEKJKTS 
WEUPINYRPFQXHWV : PARFAQPQ        CHWS            YMVKMDSSARXKT   MVTMYRYLRNCJQAV BHEAONP        
ICLI            : CGVBR           CGGRPHSEFGXC    FYNEJMVRFQOER   AJMJOJH        
VKNGJDP         : GEUGYN          PBWS            WRVVICUWOKVBNRM
YMQGJIOWHIONAN  : JDVIYOKJRKN     UPLVADDTQLOK    OPYSIRGJVAQKOLL
YJRHOGPOE       : VQKTGIDNPTYMQW  TEKG            SCSLKQUHJQJVLE  UWOEXOKNWLCV   
CMMGCGFQY       : GIDJESDIY       HCIQPP          SSJUA           MQSTMUXYKTDUL   JWBOXYEO       
BHEAONP         : ORMEYX          NOHN            JLKII           GVHQXXECQMCKTM  GXVYOX          WEUPINYRPFQXHWV
NFAMQTVFAO      : QCHTR           VFDHRJA         CKKDPJR         XBSBLWNYCVXEFTK JAHLQQ          UEBT           
FRWRG           : NGYUKXOLGUVDAFW NLSDF           RRKTXLFELVLUHJK
WMMNLB          : IAXEYGVPEGJ     DXPEDOKANXYDF  
UFRKSJOIOQWFN   : IHNAUEBN        JRYLMYQYAI      FQAR            ROTWYUQETE      NHTEWUWINGRLII  WQHUWK         
NNIHUA          : GRLXKRXAQI      BFQAWU          AOXJOLCU       
NILMXBAJCTHJLT  : EDXMCATAKT      KXUHCW          YYHA            WFKSKQGGMPS     CJVKSMTBSSRHCV  UJUBIPDXEWS    
WKNLCLSRFI      : JKMPEVUY       
NQBP            : YFAKXVGGWLWCJD  GEUGYN          BTKTCRGNXUSIK   FMJTPERL        OKLELXG         VQXRIXNTHLAU   
QXNDVOFIQY      : FJLCFTIMHER     VFSJE           MGPNII          LKGR            JGPVDSKCWOC    
AKLF            : SATWS           GDQBQBWVFS      ISHBRLIOOJFJ    DCKRGBOWBYAD   
VTWAFSR         : UAVDNUKOEJLJ    YDGAHVWSGPM     GTEFWHVSEAO     LPGJUBOYCCWCYP 
BXATB           : EHRFIV          RICTQXVJKRKWNW  IAOKDSIXRGI     WBDBNIRIO       OLYFIWB        
TRRHWQVC        : DOSEAKIJCR      TUUVFAQR        ARXRHRGKEKUQ    HTERUIQPABHE   
OCSOOEW         : DMWNU           LVFHDVLEGISR    KSGBJWWYYMT     BPGEUBCPKTBPSV  IUXHRH         
AQXDXQUISUKM    : ORMEYX          BGYXKHGISR      CWJEGL         
CIPTPOMNRNCVGT  : BAEBSTG         KBXFNALQ        KJLCX           JUMCQWRBGFFMURT
KQNNJMQHDNRVJE  : OBMFF           LWMNNJIR        PRKMHHMXVT      MSULKXTLS      
HIVXE           : RNEUIQ          FFSAAEVSGJGX    ORBCXBPQYC     
MRCGFHEMDRYV    : UKYHGG          WRNQOSUHAG      YWQQ            LVKFFESYKXY    
MFRF            : MOXEY           IUVPYVTMVFJA    NSNNVUH         OCUYVVCJBE      KRSIJGXHHNPWRK  QVQPV           TAWCXNYIVKQEHP 
XTGVDMHKUE      : GBPYEPWLKSSFRY  AFEHLUOLRNI     VHCH            DWXTODMYHU     
YSAQWIWGNJJFIFM : AHGD            UOXQJEP         EIFAIK         
MFDBDY          : VHPDJHHES       HYJWUCFCQEITAAL EOLX            HGCTXHLWMMWVYGM
BCVJ            : EMOWDH          DGCEHMNC        DEYFVGWYLW      XNWLT          
QPCQKEHJN       : JTJIQ           MBISB           MVNWOTFKGFT    
QDPAKYGWYS      : INCPTYLOBFXN    DOED            YRHQHDQDQ       EXUEQRKNQW      IFNSRIAQVDX     HJBST          
CWJEGL          : TDAF            FELOXEV         AYBNSOP         AQXDXQUISUKM    MEDDCLGJN      
DWXTODMYHU      : JXUUHMQARAKWR   DMNFXNHCEQUM    XTGVDMHKUE      AKAOFGWHHLO     SCSLKQUHJQJVLE  IFYFXUEDQ      
WBBARCKSKKRFOVC : MGXAVFUTDFYWWMW NDVIVS          KDWFIFPLQV      NHTMKWCEXCUWR   SVDF            IISCGEJYGI      RWMOVEATFP     
AJMJOJH         : WHYXOU          MMYDBFEJ        MADBCHSJURL     BQSBAWY         EULVMANJUTHY    XVAVADQVUCTRVD  VAJGIPFGDOFSNKM NHTMKWCEXCUWR  
AJMJOJH         : JVOBIANHGHU     ICLI            JVOLPRQPEPIWK  
XMXYUSJTTNUL    : BQLYXAHPJLA     YFJXGK         
HGCTXHLWMMWVYGM : JLKII           MFDBDY          RVOWHMEU       
QWKDULANWUKKRX  : XQURNAIMHYKB    EEFUDSBKLTH     WYGX            WVAEVXLIYWFPBSA MFOUBWAMWB     
BFEVD           : MWOIVUJTHNKCRVU PFJFEPBTCKRSPA  CKCUPNDFM       LPCS            CFXJYUM         FJVW           
JABVAYWILJYIVF  : PPEMIKAH        KJLCX          
HHTGEE          : LBGPFO          XGMEFVLQOLU     SHHOHFYOMGD     DVRMACQSKNRUG  
XDTAIBXNPHQQ    : BEBYNY          VRFHI          
QPCYBLBJJIPQP   : WPBO            INMNVUCXWW     
YWQQ            : LBGPFO          BVMRRJJVW       JXFLVVBKSSYE    ARYPI           MRCGFHEMDRYV   
VNWEOW          : CVQGRIOAL       KLCXIPYKOX      QJADA          
EELULEKN        : XKHQQRTODLBGOJ  HBYH            MYPQEXPYIWEBDV  AHGD            TUNRDQ         
NBEYKOPD        : OUCGN           SIQWGMHTU      
CDESVYPJYV      : CJVKSMTBSSRHCV  QPTLPEFDAPRFIB  YRPDBBJNQDV     VLQQBBEPJUFMXOA WPNRXHSNIJKH    YQIAJEVNRDM    
VQEDEBOIN       : MVAUOUBBJ       WRBIJJBVCDJ     FMJTPERL        JTJIQ           JQNJ            MIVDQS         
MBISB           : YUDPGYBO        HKQGKFWMXOGDB   NNTYBGQVOCDML   IJQMMHBYBTFMXMW QPCQKEHJN      
KSYRUEVN        : ENKODFWGFJNEO   EXWHBVCICT      QCWP           
WFOVEPSUTVA     : HVPBQTLHRXCRKJJ RSKXICHTK       QBDEGBVVPMR     JSGJI           IWWKQYBYTP     
KKLRYPBSQ       : GSAHEPB        
FJVW            : PSXTNYRH        ONPUKOEWUSKJ    BFEVD           TIHBELBALJNT   
DSTGPC          : NWTYHELEIJPEKGB IIVBWNIJLRFEQV  DMEQRT          KVDQ           
MGMFDJDFHPQUIPK : EFSRL           MNCHSMKEGIU     YORRAYNUEYUYO   WNMOKQO         RNJHXRYNTHM     DLLAFDOXQQKOJPO
KBGPMEMSHHPPX   : BVOK            EBGK            NQEBNJKWBQL     CVABYQIHESESBF  LBADXNUGCHN     YTHHEWHHMU     
NMACTDL         : PHIFNVEN        SHHOHFYOMGD    
JUMCQWRBGFFMURT : LABJPCMJQCWBX   VHCH            CPMKTWKJCQTYC   CIPTPOMNRNCVGT  HBHNKLBSAJOSE  
NDRDTRWJ        : YRSTQUSAGFFTRIR JCSDAFTDKPOR    GTPLEP          SGQWTRAYRK     
WNXAA           : VQPG            VFOTVDOYA       KMLGVORSLSTAM   ICIEQSXPHNLLP  
LWMNNJIR        : WEARHSWBIMKA    OUQKEIUPDM      QJADA           GLXNGJI         KQNNJMQHDNRVJE 
NWFKQYWEDRH     : DLALWBVQHAJ     WFKSKQGGMPS     WWCE            PPEMIKAH        NTURAQ         
JEKQDXOGA       : IVSDSWLVE       IIOEPSWXYN     
RXBILKS         : RHCHITARTNWPJQK ULQTMNE         LHESEPFJBSXSQDM VWWNXKAWFABIWWP
BICJUTISANK     : WKLTVBOMV      
OVOYMUACB       : PIDAUIS         IGBR            FQAR            NIIU            DVRMACQSKNRUG   LBADXNUGCHN    
SUATDOEXTIGWRC  : PINGKIKOXQIM    ENMNQTWODLVS    JXQAJQ          NHDLFCCDQREOR  
CWSSH           : JSGJI           EKWLSGIY        WHWREVJQAXSTPI 
HDUH            : MPJGKO          NAEEU           FGORWOIHBIRGY   WGNYSNDSBVO     BAPEWBGWNUE     WIPBXAVCROA     YFJXGK         
PJUSLNNM        : ITESUDUEVGRE    GEBGMISJDKJH    MMLI            RKMXTHCJAYF     YQMSKLR         KFTRENXNVXEI   
TBNRWXYVP       : EPNLBD          ISHBRLIOOJFJ    QHKHJJY        
OUAKNJPWOMGH    : QIMUS           YKLCAO          TFTEITBSUGNWP   NSEKD          
PEWCTLODFRTWQR  : XQDHQVMSCMRBI   ETILYOVR        NELKQQR         NAWJILJXAEGKM   LWRRL          
NKDEFFOUQHRGT   : DKFAKGTOVEJC    JDPNPRV         BAPEWBGWNUE     PKFRLVFJKMD     FUKVIMCYOSGJJCJ
PYQUVSQJJUODQ   : JTEORLCXV       RPGEUITLG       NDHVLIBCJHW     WEARHSWBIMKA    LXPQQWUXFRB     JRKVSPTDEXTCAAA PJRFPNAJBDTB    PKWAWIDDMN     
UIMISSMAX       : IHTUDHUHJX      NJBQKB          RIEORDUCSWX     SWWEVFVCPRMIUKM
WPNRXHSNIJKH    : OUCGN           EIUEXUSEXVHQT   NUWKDWMNV       QMRTWXSFADAEAKG NMCDQLKQGL      CDESVYPJYV     
CQOYGSPUNAJXV   : YUDPGYBO       
KVDQ            : WKCRNUYYEWC     XMCQUDJ         BTPDP           HTTMAN          DSTGPC         
SENSOGG         : NUKPOXMPXQPC    IHTUDHUHJX      VQYLMR          ATBEAMWSSUWQ   
PTGUVXKWGDMDSM  : AWCBE           TFUYCIVU        KHWFTOWERAJM    FKEIFGHWOA     
QITDHWUDRYSMP   : TSWABDESNUJNVS  HVPBQTLHRXCRKJJ QXXPYGS         NOHN           
SPQMVMKVY       : QCHTR           DDYDJV          JVHMHNQNRJ      FPIBF           DDXXLE         
ECVJWJYNTUQ     : TBMTKG          DSHV            BBGJ           
TNINNB          : VQEJPBATAQXLBN  OJGBKIYCDFJO    WFRPP           KVBUYJXWTJNXFK  YCTPRTNBV       IAGLHHSUVNTH   
FCUU            : TDAF            PVHOGWJJ       
IRKUPJDUNB      : PXAQFYU         QFXIRAJE        VDBU           
KMHAHCQMVFVL    : QXXPYGS         JSGJI          
YLACHXA         : PCSOUDVAORN     EHPRULULBVURVU  VAQYSWVT        JPGLVEPSBHCMN   WQHUWK         
PKMHVRCLTJV     : YYHA            SXULSELESJHQR   YBVENBCYD       YHTPMHMP       
QVPVODTV        : UFXQCB          EIFAIK          TAWCXNYIVKQEHP 
GSATVEBTEU      : BSIYQWWDM       FFALSOOIAWTT    NDENIXQV        YLVXHJO         GMRNOSY         FAVGKA         
QKSMEXX         : VFOTVDOYA       GQDTCBUI        KOCK            GUEA           
HVJATYXLE       : NSIAQPRTAJ      SMAAMRY         MEKM            GLEIGRUTVBFIQ   CVCFG           NSAACQLLNWDX    UPLVADDTQLOK   
HHBBIUWMYS      : VSSWXKNUM       CQJSU           IISCGEJYGI     
TEKG            : EJTQLOD         YJRHOGPOE      
ALUALE          : YKLCAO          CGISABV         UVSBRRUROEKOPW  RNJHXRYNTHM    
UHSW            : WBYOSUCIC       DIJT            IAGLHHSUVNTH   
EBAOLDR         : HVPBQTLHRXCRKJJ RSKXICHTK       LFLDIM          MMVYBSYAHMCBP   EKVLAOEQHQQ     UMKIEYSYCHTXGIS
YQIAJEVNRDM     : ODIERXRXHQ      DNUQXLXQV       PLBUCENBA       TFTEITBSUGNWP   BCDUQTBHWLK     NXEQMAYJOIGK    CDESVYPJYV      FURPUEA        
OITAOSVVMS      : BSREMBH         AUEMSG          XXYXEWN        
SVGJHKDDJTOLFS  : CFRVCTYHXRWV    FJLCFTIMHER     NCYHJJKLSLSGH   LVKFFESYKXY    
UMKIEYSYCHTXGIS : SFKXLIXTHH      RATCTUVQD       MFLIW           EVRGFVKBWNEWDO  EBAOLDR        
CQSNBD          : OXFMWPDVJHLQWC  TNVXHBQOHYNM   
EONUAVQIQDSBKU  : ULQGWHWYDW      DASECBLAT       UCCIXPB         FGCOH           JVOBIANHGHU     HAPVTQC         PVHOGWJJ       
LWEFW           : FQOHFMGLWLBW    RRUGROKCKICIKSH YCTPRTNBV       QXAODL         
OPYSIRGJVAQKOLL : YFMPMETR        FTUFJXTONMAXWG  VNJEF           KHWFTOWERAJM    SYYUXOE         YMQGJIOWHIONAN 
EVDKOFULBII     : HWXUCSPKUSELWN  QBPUWQUEFYGVEQR UKYHGG          WUJQYSOQLM      CWNIVRNH       
NHTEWUWINGRLII  : IFNSRIAQVDX     EAHP            RCRPVCIUIV      ASMTW           UFRKSJOIOQWFN  
YWJLDFPNWWKIA   : DFLNY           JSGJI           KFTRENXNVXEI    WIUERIMLSOVWIO 
TIHBELBALJNT    : RVPKA           HYNNJYQORCRWOS  FJVW           
YCMWCL          : TJGXME          JXJC            UVNTVURPEPLTGG  YBHOUFE        
NOOFFLCPWDJQNST : OLAHPMPCMW     
GURRG           : NFEY            HEXIYYCIP       NQEBNJKWBQL     TJQRLPPWTPENTEQ
NKIQYGUKPI      : TUBQDPXI        UPLVADDTQLOK    HDEE           
GOGUSYRVIKJBE   : NTLQFFICEGEWV   AWCBE           UFVHMBYLD       IIOEPSWXYN      NAGARRDYUY     
HCVCIGPSOIRWDE  : QMLH            YUDPGYBO        LABJPCMJQCWBX   YDQMPLFQQJPT    KOCK            LPGJUBOYCCWCYP 
MIVDQS          : SKUAVWLHRC      VQEDEBOIN      
PKWAWIDDMN      : PDVBFPC         QBQEBADVKKYLQP  PYQUVSQJJUODQ   PRKMHHMXVT     
LPQRHLIQGITK    : QBDEGBVVPMR     EJTQLOD         YAKOOVKMITQ    
IUWNMPMC        : MMYDBFEJ        QSVXEVES        CQYOIUONORI    
JFYTIDHVKSN     : ENKODFWGFJNEO   TNNJCXDOOQG     IAXUOHX         SAQMIHGFH       QGPYNCUTXPPD   
MVNWOTFKGFT     : FKCLLAW         DAHWPFWWHOL     OEQJFVP         YCKRLD          QPCQKEHJN      
EJQUXSW         : HDYQRU         
AYEJCNFOGTSURIT : MDCRJDVADVJPUPQ FIWIWBSLSQRGX   YWWBFGHKJEDBRF  SRPKRIRKOFQBA   TGSTNFNEAHPG   
CAQKH           : NELKQQR         HKQV            AQFIAOLQB      
OLYFIWB         : MAIIHPDWCOQPX   PCKLLKMCIGEP    BXATB          
HBHNKLBSAJOSE   : HIPY            ODHSYG          KPFBFR          DBKWNWCWIVTKN   JUMCQWRBGFFMURT XGPIYM         
BAOFAFSJUHXT    : RAHHLIEKETO     WRISUUYXQOX     PTPDAINJQN      KOAOED         
GQQOARVPFH      : QTNY            BDITVDVJJNCIJUR MBPOGPXILDXMFH 
AKAOFGWHHLO     : CKCUPNDFM       WMFUJLSOJ       VTFAVWJOUMXJW   DWXTODMYHU     
SHVNRVJHEDXVF   : SUALTFAABL      EIUEXUSEXVHQT   GNCPCCGPR       GVURNBKXAGVJ    VGJOGAVYXX     
RVYCMYOPP       : ISUDKODYT       KNROUVTXTPP     HPBNM           ACTBEFCV       
XOBHA           : BVOK            LYUUGLCNNTATY   ICGYFHUYWDCIB   GEOAKNQQUHS    
TTAP            : OEPMYS         
TNVBRYBNEVIAWK  : RKGJXNX        
YBHOUFE         : DYMDIO          FUKVIMCYOSGJJCJ YCMWCL         
PGRJCTBOOOKRG   : HDIAQXSV        NOVSEXE         GAWDT           YCKRLD          PRKMHHMXVT     
TUNRDQ          : HDIAQXSV        EQLDXPPMPTK     EELULEKN       
PINQPDL         : VDWFMEJQPVOB    SIXVLYTKNWLRCOM ATJDU           TEXTKNIKBT      XKVULVO        
JKMPEVUY        : UDESO           GXRHUUPOS       WKNLCLSRFI     
JNLT            : WKLTVBOMV       HPEWHBQHNBN     DMYVNRGOSEJAYBW UPLVADDTQLOK    MEDDCLGJN       NJMVHC         
SDBPSSUL        : MDAJBPK         OTGUPANQUWWI    TDOCWBDOSLGQWTV
MTVDLBQJKEV     : JJMKPUJUCHV     VYCJXCAL        UJAA            UDNFABDWOIV     YDQOVHMDAGMOVPP GKXJD          
IUXHRH          : CGGRPHSEFGXC    OLHQGRJMSBRDBIO UDESO           OCSOOEW         URFXHUSU       
GDDBGGQ         : TRKOVXNEJATHT   LUFN            CJGCJKTVAXJ     MWWEVSRVQVM     FURPUEA        
ANNIAJEF        : LPCS            NLYOR          
IVFUCBXNV       : TPGT            OUQKEIUPDM      TCXMLVVCTUGXNV 
WQHUWK          : JRCIQJWROFHA    BFQAWU          NXVXFAPO        UFRKSJOIOQWFN   YLACHXA         XGPIYM         
ASGSUIGKQGT     : ATOUKJCFNLPUR   DLNQCYCA        FGORWOIHBIRGY  
LPGJUBOYCCWCYP  : VSMFVQOUIRFKGM  VTWAFSR         HCVCIGPSOIRWDE  BDFAF          
VOUXOOHHLPNVJVP : VGNFOVG         ARYVEEGNLK      OSUYDPL         FUDG            QKBRQGVNKTD    
JGPVDSKCWOC     : YJVI            DNUQXLXQV       OXFMWPDVJHLQWC  NCYHJJKLSLSGH   DXFPOGSKX       QXNDVOFIQY     
PRKMHHMXVT      : FKPTA           KQNNJMQHDNRVJE  PKWAWIDDMN      PGRJCTBOOOKRG  
HMVDVUVDEC      : QIHQENADFXIBXE  QTPQORAEYDUIJ   PHBUTXQMCMCQPMH BOCEAAPP       
AHPMMNB         : GRNPBQA         KDDCUJ          SFEXLIM        
NRIAGRH         : NSHGQWKFPHNDIY  YRBOYXM         CQJSU           BDFAF          
QGPYNCUTXPPD    : QAYGDNEBYEM     VNWQBYSMPAHJVSQ CHWS            DUPWF           WHWREVJQAXSTPI  NANEREYQFHOCUYT JFYTIDHVKSN    
TAWBPKNDNESF    : SUALTFAABL      JACVHTEV        GMRNOSY        
ULFDHXJWWY      : WIRLJ           HAPVTQC         WFIJMCULIFVWIFP TSEJEGKFWFDEY  
UUYM            : PTMYXHJTOYAAJH  XWSK            BGRLFGHNOI      SNMTWWHBOY     
CJGCJKTVAXJ     : TWOCOWPXHBC     GDDBGGQ        
SRSOFAT         : MADBCHSJURL     PXXUAMOTSDRD    OCKOBX          GUEA           
YFJXGK          : PPPHJQEJC       EMOWDH          VYCJXCAL        DOHYOAOYOXIVFJ  XMXYUSJTTNUL    HDUH           
CLIONR          : XWRHSLTIQAREVS  GDIC           
RDKMYKMLPHDKXI  : MMLI            SGQWTRAYRK      GWHVOTO         KIPEDEMXFV     
RVOWHMEU        : QBPUWQUEFYGVEQR ORMEYX          LTRTBYOLVLHSYFR LHESEPFJBSXSQDM LUQDYSGUVX      HGCTXHLWMMWVYGM
IGQYWKYQOJFNW   : ILMDRGR         TFXNJHUQQKAQIGP XGPIYM         
BOCEAAPP        : EBGK            PQWVSUAMI       QJADA           TWCCPFKWQ       HMVDVUVDEC     
LERUSXRBGB      : KOIUJXXXMDPKJYM
IAFHQTRWJQQL    : BSIYQWWDM       CHWS           
URFXHUSU        : CPWDDX          IUXHRH         
MSULKXTLS       : DSHV            SIMDRITY        LSJGERWAKX      XKKI            KQNNJMQHDNRVJE 
LXMFTGEFW       : SIXVLYTKNWLRCOM TBXAQDDRIEO     VSSWXKNUM      
SCSLKQUHJQJVLE  : MGPQ            HULSHHNHLO      YJRHOGPOE       DWXTODMYHU     
VCGKUKXUW       : JRULXNTD        WBYOSUCIC      
QFHWCHPFADP     : XKCIG           RKAEDSXLRHQ     IDHIEDNYF       MIBENRQMHY     
YWERI           : FKPCSMYXRXC     TFXNJHUQQKAQIGP
FMOBRUNOHMMFR   : RRNCCLOHSQS     FTUFJXTONMAXWG  OTGUPANQUWWI    DBJUOJNW       
KCAPJSWLXM      : IFGGH           YCHBPIMYKHTNGM  KIPEDEMXFV     
WLIQWM          : KQTHXXECCPPSU   DVNYVBENRIJ     XYJQ            AGGMHAQHIYSJRP  IWNBEKSMRXVL   
LBADXNUGCHN     : LVDCCXAK        XKKI            NXVXFAPO        KBGPMEMSHHPPX   OVOYMUACB      
MXWP            : WKLTVBOMV       WWFIJCCNDJIJY   RRKTXLFELVLUHJK
IIMTG           : PTMYXHJTOYAAJH  WRISUUYXQOX     IIVBWNIJLRFEQV  FLQJXDBMOIUGXQF
XGPIYM          : BSIYQWWDM       HBHNKLBSAJOSE   WQHUWK          IGQYWKYQOJFNW   ICIEQSXPHNLLP   BEEIVOUJIL     
XXYXEWN         : VSDG            NOJKXWFTLWER    TRLYGRY         OITAOSVVMS     
FSISNUTMMJ      : GRLXKRXAQI      DIDVHINEVWA    
UWOEXOKNWLCV    : VVUEQBSTYF      HXXU            YJRHOGPOE      
BUJFUXGA        : ULQTMNE         QIHQENADFXIBXE  YLVXHJO         QXITSNVPVEWTERB
QTINNU          : IBORQMOOPMRDH   KCKYLHYRT       NOHN           
WRVVICUWOKVBNRM : FFALSOOIAWTT    FTUFJXTONMAXWG  BTKTCRGNXUSIK   MWERKKMUSFOFW   VKNGJDP         TAKXAWKYAY     
PWXKWEMPW       : XABRVTCX        FPIBF          
XKVULVO         : NOVSEXE         PINQPDL        
RWMOVEATFP      : IYHTMNKTILFETLF EDGLETO         UJANKJJWDSES    JXYCIIGAPENCK   WBBARCKSKKRFOVC
TIDQ            : MLMWROHCEISFQ   KFKUJKHN        GWHVOTO         KKXXYIBEVTU    
PPMDFJLF        : MOXEY           OBMFF           FIHTTIEDCD      PTXLHQAVSGLAC   RBXRGQUBISDS   
ICIEQSXPHNLLP   : WNXAA           XGPIYM         
SFVNPYGV        : JQKJEVBCFWABSCO HJNATLIXS       UMSLOUG         GTPLEP          DMYVNRGOSEJAYBW KVPGXWAAUGYUJG 
WIUERIMLSOVWIO  : CQYOIUONORI     YWJLDFPNWWKIA   PFWNCBXPO      
XYLMKBRGI       : NFEY            QBPUWQUEFYGVEQR GDIC           
VXPCT           : QHKHJJY         IISCGEJYGI      XLENFCKA       
BEEIVOUJIL      : NHBGB           XGPIYM          LVKFFESYKXY    
HTWF            : UCJPEDRRLF      XGMEFVLQOLU     UCCIXPB         GKXJD          
VQHJRB          : PINGKIKOXQIM    CFXJYUM         TVTGEMDXIAH    
CRLAHPV         : RLIIG           OVTJCUDTFC      HLPJ           
TAWCXNYIVKQEHP  : NJBQKB          TRLYGRY         RNJHXRYNTHM     FLQJXDBMOIUGXQF MFRF            QVPVODTV       
CMDLVUMNAEYANQW : HIIPPCLA        KCKYLHYRT       OUQKEIUPDM      KDVQRCBTADK     UJAA           
KYFOXTPIPDBV    : BSIYQWWDM       IEMXNJRRAROPN   KMTQ            MIBENRQMHY     
QGODLABIMOI     : ICXFEEIFRHFJHG  VQYLMR          SUEUAEJYFPEITK  CFONKTBELQJ    
PJHJIOVJVL      : NDHVLIBCJHW     HYJWUCFCQEITAAL NLHSRAUQAV     
PBRGEUCQMKHRV   : HKQGKFWMXOGDB   JXQAJQ          RXGLTGTTOXR     HIBAORV        
TFYK            : YFMPMETR        FHLTPFFNPYNSRW  HWXUCSPKUSELWN  MDAOERNXU       INMR            KLTQC           DAGCVDPYCHN     JXAPWK         
SBYAKJQGTN      : QMLH            KRJQXUCCA       NLYOR           NYVYBSFQ        NHDLFCCDQREOR  
DDXXLE          : TNURW           KHRYXSR         ARYPI           RXGLTGTTOXR     SPQMVMKVY      
QXHBFA          : FLMBPJILTISHBOO HKXJYCMDDGUIJ   WJYSNWDY        IWVWUFCCM      
PVHOGWJJ        : VSFRWLBKPUABHAM PYFAIQPMGJVMO   FCUU            EONUAVQIQDSBKU 
LVKFFESYKXY     : YYHA            UJAA            AHBGWBJHINBQ    LUFN            MRCGFHEMDRYV    SVGJHKDDJTOLFS  BEEIVOUJIL     
MEDDCLGJN       : HRWASUQBJYRY    MGSGDTJJGMROB   BQMASOOBJRBKO   CWJEGL          JNLT           
BLRRRRBESNA     : GUNKITNJXAOPCB  HKKFQRJYTCWOX   FQXDH           XRODSKCYEKJKTS  ATJDU          
SHKNJU          : INTDEGHKY       GGOBLX          LTRTBYOLVLHSYFR KMLGVORSLSTAM  
IFCOKFSXO       : BUOKHONHRMHYB   WMXKBDWIO       BDFAF          
NYEYRWTLAXEN    : FBRJAGKBXTKBF   DFLNY           XLOH            MWERKKMUSFOFW   JSSIHDISMXE    
HIITVRQMC       : SMAAMRY         DEGOYMNYDS      KLTQC           PPEMIKAH        PXXUAMOTSDRD    KCDXNV         
ORJWMJLP        : WBSJEAPTA       EIFAIK         
MWWEVSRVQVM     : TBXAQDDRIEO     CKKDPJR         DBJUOJNW        PUCI            GDDBGGQ        
GUEA            : KLCXIPYKOX      WBDBNIRIO       QKSMEXX         SRSOFAT        
XTGARUTBRHNF    : XVAVADQVUCTRVD 
LSXKYTERSWPFQ   : QCJYUVJYETWQ    NELKQQR         ICDUQDLMWPYA    RLJWSEXFSG      QFGMKWOH        PITUBTBS       
AUYTSSCVMX      : EKYVQHYGE       WRNLUFUMKNYK    HULSHHNHLO      RNELRHJBGXUCNM  PYFAIQPMGJVMO  
ORBCXBPQYC      : TJGXME          EBGK            HIVXE          
VGJOGAVYXX      : SHVNRVJHEDXVF  
YURTWNHWGXPHCN  : HDIAQXSV        QTPQORAEYDUIJ   XKKI            IFYFXUEDQ      
RGMTVIDGYJ      : TLBRT           QMOFMXJVQYO     XLOH            SRDWJ          
UIGUHIPAC       : FBCMOLCUTGYB    MGPNII          DVRMACQSKNRUG   LUFN            TJQRLPPWTPENTEQ BPGEUBCPKTBPSV 
NJMVHC          : EFSRL           LTDSYCAC        JNLT           
JRQDXDXWNDDOON  : QAYGDNEBYEM     ARLMLCG         IJTX           
YTHHEWHHMU      : FPQMHSRPOLDNQS  EXWHBVCICT      YDEF            QSXDTDUV        PTXSSXDDRCANM   KBGPMEMSHHPPX  
ATBEAMWSSUWQ    : NARCJVXXUCQW    SGQWTRAYRK      RRKTXLFELVLUHJK MTRDWGWR        DMEQRT          SENSOGG        
MVWCKKNJHWQLWX  : HJXEMTW         RNEUIQ          KRSIJGXHHNPWRK  FAUUBE         
JVOLPRQPEPIWK   : LGMEYJ          PYFAIQPMGJVMO   SWWEVFVCPRMIUKM PMPLHRPVJWLK    AJMJOJH        
PFWNCBXPO       : DLALWBVQHAJ     EBGK            KPFBFR          ELSLOYVDEM      WIUERIMLSOVWIO 
YOBMLAI         : GFCQMAUNYEUNK   YFMPMETR        RVLR            RSRWRFJIX      
XWJNO           : OTGUPANQUWWI    DAGCVDPYCHN     HDEE           
FURPUEA         : TGYXAFSDN       YQIAJEVNRDM     GDDBGGQ        
JWBOXYEO        : ABAU            IOQQK           SGRCRAPR        CMMGCGFQY      
FDNRQPCONBXDRCK : PEWRMOPON       YRPDBBJNQDV     HXXU           
TAKXAWKYAY      : CFRVCTYHXRWV    FIWIWBSLSQRGX   XBSBLWNYCVXEFTK WRVVICUWOKVBNRM
CFONKTBELQJ     : FKCLLAW         LKGR            QGODLABIMOI    
GKXJD           : XDPQN           QUCHEKFYP       TXOOKWQ         VQKTGIDNPTYMQW  YLVXHJO         NSEKD           NKHULQKUBRIBYI  MTVDLBQJKEV    
GKXJD           : HTWF           
VSVWDVYC        : JACVHTEV        PLBUCENBA       HEVQ           
BDFAF           : AUSYWGPGTYQX    WKLTVBOMV       LPGJUBOYCCWCYP  NRIAGRH         IFCOKFSXO      
OSYJWEUPNWWA    : NANKPVHTWSTC    KWEB            HYNNJYQORCRWOS 
IFYFXUEDQ       : YJVI            LOSYYHDAMBD     HJBST           UMHR            DWXTODMYHU      YURTWNHWGXPHCN 
IAGLHHSUVNTH    : MPJGKO          BCVOIMCBYLEXFY  EKWLSGIY        TNINNB          UHSW           
