TPWKQNQLFMTL    : PBRETLIA        JPEICIKO        OQSQ            WFNJLIVTDBBJNIO AXRIOLWEG       RFBFHLURRR     
CYSTQAOFR       : UMUCGJ          JJWHPUSFXFDM   
IWPYHE          : EAMNEXP        
PAGOK           : WKDHDQSVF       GJHRO           FEQHYHAYCBMVNKE XLXJLYNLRHTAW   NGAL            IKVJMJPQJRA    
CBKIQHTHJSAFKAW : FGDX            JPEICIKO        TUEXLFM         FPYJILUHARNJ   
RQCQIB          : UKAXDVRV        HCWFD           ADSOTC          BJTNBNS        
ORPOXEYWHDJRT   : GOFVDTKB       
LBAG            : FDGX            WKDHDQSVF       AOJD            DNCYIIFY        TASLKPLCKLHQE   JYRCHTWKGQQTS   QBACK           CRTGXQCQNXG    
LBAG            : XCKHO          
GSDFMWXOP       : FNCPU           TGFWEYKLTA      HOLXJBXHGQDWVMN
SPUMFLMLKJU     : IHDJNMRNOVYUMAP TFLVDTWFOCWRNSW TNRPQBAGQ      
UMJMAM          : IPRVTEEQ        DYNCYTAX        NXFSJUDUBJIMMLV RKFHMRFPG      
HPUCUCPTAE      : TVIDPF          DBAWHKX         LAHEXPYSEBCV    MPLGIWDF       
GYYDL           : SLOUHECIFFEMR   XNDLFJB         FEYANISGKDPXNY  SADJMMJTEEOJ    UTTWQLACDPR     ITUQ           
OXUCJPRFDER     : HLBICLMLWBXY    JUGLFSASQRTO    VBMNOJB        
SGMLEP          : YIUGEBWOIRIAJ   BUSQ            HNOAJ          
IHDJNMRNOVYUMAP : SPUMFLMLKJU     LWGPF           KTNKXQJVOSHJG   TCUSRTYVFAKHEGS
JIJQNPKQITGVAX  : HTPXCFOY        FEWRODVYWYG     WAMATSH         FCRGSFOWN      
IFIRS           : SFCOOCMKPW      VPIIVXDTSUPABH 
KGLI            : ETFHIRXYRFQEMQ  ATRIJ           RKFHMRFPG       WPUQPABTDYAV   
HUKYMVJ         : MLCMLFOYFPTTO   WDVMKVTRBALI    SMURGPRIXFA     TUXIPJBXILPXL   NBGCMG          IUTYFWGVKG     
NWNXQXTWUT      : FGWNBUFRWFP     SOSRFJPTTKWRSTC PQTDRYFGCXV    
CDCKUUHHETP     : LWGPF           PDIJLQCV       
BNYCCWMAKLPL    : AYSMWALHH       DPMM            TOHMWRPGY       UQXBVXEDOJ      WFOIDTPV       
PFYMCVOFXY      : BMEUMIUFEEJH    OVOYQGFR        EOJILCCGE      
THKABC          : MUJDOLJXGVAGB   HSUBFA          KMWS            UWFUFSXVLC     
ERPGTMUVAHLLL   : FHYNOLQHG       VYHHBM          MRLRKDMDXE     
SLOUHECIFFEMR   : GYYDL           PJFUJNNNLMFKYYO DNLVGSGXPCIMUDI CSKYFDSBJSOOFUD
NTUTOKDIYAFYHS  : FDGX            GWOGYEHOWMEJW   JMQSLU          VOUCV           WMYORICLHOXQCS  JGQBR           DHSYAHVNNJGCOQD
TUGHMDQSI       : WDVMKVTRBALI    PQROQ           YUNGGWYGOURVLB  SEVJ           
XNDLFJB         : GYYDL           LCWSAEDHHLGVYJ  JJWHPUSFXFDM    ULUEJU         
EVPQBBQBIPL     : NQSAE           HIKUNEHJOQPXYC  DPHLVY         
FHYNOLQHG       : ERPGTMUVAHLLL   OQSQ            LUFLBAAMX       EEESRKXDNXXY   
HEOMRTYVXFTNWUQ : CMJRMKCGATWXI  
VYHHBM          : ERPGTMUVAHLLL   MSYVWBFWMCW     JSTQWIKVQOLXF   KHLFRUXEXEEVJ   JWGDOAH        
AAFNTNVUU       : JDMTOQKUMC      AKIEACUFLNQCN   EHWIFVDNMGJ     IIMCNCJVFCFU   
KJUGIQEOKU      : XGVBGUTGVK      GKGQMYJHBN      LWEGMYTCDYNRBK 
FNFBNM          : YTHG            FOHVTINQWWC     GTRTJQI         UPLVQMXSHIORNX 
OCAQCGGXVC      : BTUVJYSWL       NGAYYACYSKVKE   JBYSIHHGWUCOH  
SEECYMNPTE      : VHRTTWXCILNKXB  SOORIEXMVCRJYAB OJBBASLLNI      XMYSPMFUB       IKRBGA         
QTHEYJRLUIPWBSF : HWSYFRMPLW      OTCOPNWHKDLJU   MLWLUGHBRQ     
QBNMTSSW        : FEKLRDE         PQKWQKNSKGPYNAV ASJW           
GMMCSMSMUY      : UQJGBCGY        TUNIFAWQB       NPSQC          
GRYDCP          : DWPKKQPGDOVSF   GNLAAVV         EDYVPRUBXOFTRP 
GKGPDHEQ        : GGUEMC          AMNHXGHF        TYCAFLJAGOAF    PITMPCR         PYCO            UBKVYSMDYLFFEDP NNXYVRXYR      
YJDUPPHTIWMUT   : VHRTTWXCILNKXB 
IAGJDK          : LJKQVHDYVOKVWGW JWHDHTRXDDYDMSX AMNHXGHF        PYCO            XGNCNQC         CAYXVIKS        JDSV           
FQLN            : LLNCGPLD        VPUDYQ          OFHB            WMBKWSCUHLCB   
PVNGCORFJIUT    : JSTQWIKVQOLXF   CLIFYVNKKVT     FTTOAIOJA       NEKWKS          HOLXJBXHGQDWVMN
FQRCKGKMMVRWXW  : OKHFBLHLWVTJFFV PUOTCGXMONHW   
JLXYJ           : FJNKUWXE        QUUGTIGRI      
HLEAQPKNJO      : WDLHANYDXOJTIM  VWHTGISHK       EWHOHDXV        JQVFMLUKS       FTTOAIOJA       PQTDRYFGCXV    
CIWOOJBDFSDDST  : VUCQKAROL       GPRBGAWFNOBFGFK GPQO            OKINFNHS       
GRQRHYDLBV      : JAVGKLREIX      MKLCAXKKWN     
LLNCGPLD        : FQLN            BMTEXK          KKWNBJTK        ONFBS           KICNLGYP        FHBESADSC      
CMIGT           : JCYGASFNVHT     BIDKDYNIA      
JXWFNFYEWG      : XOLADJ          AMRTBUAVQSPXUK  KDSNW           JQCUWMNC       
CTGAWTLKYRDKWIO : LILOXXHA        BUSQ            UWFUFSXVLC      CWDWTN         
QWFWIDTNSBMA    : DWXBCXK        
SFCOOCMKPW      : IFIRS           MRLRKDMDXE      PYCO            DWUQPXDQLC      JOCHHKUP       
JAVGKLREIX      : GRQRHYDLBV      EUUGQUC         LWYMDHLCRUB     FTTOAIOJA      
RDXHWYUYANG     : OREKBPPTQLMKH   NLSHTSCRSENBEX  PNJCXRDTFQF    
DUHRGWORHROPEC  : BETBNEDTGQBOB   KLMLXRAV        POVXAJCPNLLU   
IMIMGLMOKN      : HLBICLMLWBXY    OHGDKYJVQNWWY   BULCIIX         NPSQC           OAKHBL         
JNYQUENCVTB     : LEOQBG          IFYYTE          JPEICIKO       
OKHFBLHLWVTJFFV : FQRCKGKMMVRWXW  UQJGBCGY        NGAL            UYGSUOOCRFLNI  
SLFCAGSUNHYLDCY : IWADBVOAY       SGJJT           NLABXHIT       
NIYQWGCTFXF     : MUJDOLJXGVAGB   STANEWRSMLBYI   OWTDVCLRXCGK    XOLADJ          HLRYUU         
FDGX            : LBAG            NTUTOKDIYAFYHS  QXUKWT         
LBQTVNHFMTJRU   : ALGXETU         OTEPISFR        GKGQMYJHBN     
FGDX            : CBKIQHTHJSAFKAW MJYATABGX       AKIEACUFLNQCN   RFLEWHHTJD     
LCWSAEDHHLGVYJ  : XNDLFJB         IDQL            AEBTMNAYRXI    
TFBBLQWWIUCPB   : STANEWRSMLBYI   MLEKKBBMW       QHQWYAWKXBUMPPS TIVSGRKDQBXRM  
PGVRDOTHUDQGJM  : PUOTCGXMONHW    FUIXSNPJSHTO    BFYNB          
SCABGD          : FEQHYHAYCBMVNKE HHJS            CBNDILHJAHVRECL YJNABKQNRQVM    LYCIH          
WDLHANYDXOJTIM  : HLEAQPKNJO      GKVC            VSSU            FNCEMIHAF      
EVFH            : XJDHUEWGVG      OHWJMPO         SEVJ            WDYGVVCAKDRXVGJ
MRBUMEUNKA      : HSUBFA          GYLVCICXEWRGTI  TEHGSDAFUI      TGFWEYKLTA     
JFNQFERICGRV    : NGCQC           FEWRODVYWYG    
GGUEMC          : GKGPDHEQ        FJXFWIHFYWIX    GTVBSWNUCETMIPU GYLVCICXEWRGTI  QFSQWOYUJS      CINKAQAJDMT    
BTUVJYSWL       : OCAQCGGXVC      KLMLXRAV        XXQTW          
AUYP            : WNBEGNRYGQTA    SIXHPNA         RFLEWHHTJD     
GTFPVNJT        : UQRXRYM         BXPVCADL        VKPAKX         
SDYWPBQQXL      : TEKG            GRJXPJEODWP     CBNDILHJAHVRECL
HKHEXAGUB       : JWHDHTRXDDYDMSX URAJGTCNTC      RRJBXQNRO      
KKSPCR          : ULUEJU          EBYBOPP         TQQDHRP        
LLJEOICGLSY     : GSBBLXYGNOLDW  
GNQSUXQXGLBDVLY : NQSAE           CJJP            ADAXESSJL      
NQSAE           : EVPQBBQBIPL     GNQSUXQXGLBDVLY NLSHTSCRSENBEX  BONQPCDRHOIN    FYHHSDLJWHX    
GTOKC           : EDYVPRUBXOFTRP  GFAO            JUSTVRPODN     
FEKLRDE         : QBNMTSSW        YQANASIOOAQP   
DWPKKQPGDOVSF   : GRYDCP          TBPYUJOPHPKTWTE VYGIXW         
UMUCGJ          : CYSTQAOFR       YFHSJFQCHI     
KMUOWIJCPBGMQ   : DOPBKPQUO       JYRCHTWKGQQTS   NGAL            NINDV           PJMMHBBH       
XJIGMA          : TEKG            RYWQORJJY      
IHVDTT          : PYCO            HCWFD           KONBPIYFSGIJF   VEXS            TDTOURQHBGWRR  
CFWPRREQCPTR    : TBPYUJOPHPKTWTE XOLADJ          KGRNMHSAPJR    
CHJUHT          : URAJGTCNTC      VSSU            VYGIXW         
NIHSQPRW        : UQJCJDVOVWA     MXTTCKOEHCM     LHUBHERFVM      JOOJCX          XVCSUJYAHW      MGOSW          
LEOQBG          : JNYQUENCVTB     SWOFSBSYPGBRE   DPMM            UISFI           NLFNISVO        XMRWG          
UKAXDVRV        : RQCQIB          LILOXXHA        QQTNT           QFCVEMHVDORJB   AESWIFBELMPCPI 
YIUGEBWOIRIAJ   : SGMLEP          BMGGHSKO        GNIXCTI         NDYOQWQLKVKX    UXWPV          
MUJDOLJXGVAGB   : THKABC          NIYQWGCTFXF     DDQJIAFKFUDPGG  PJUXMOYPFFEQCXO AJXLHOT        
YXYAIUJ         : UBJW            KRMTKJXTO       ISMWKOAEGXG     YIIJBKRFRNRN    YPWAEYTRYXOM    JBYSIHHGWUCOH  
XIDG            : DDKWG          
LJKQVHDYVOKVWGW : IAGJDK          JPEICIKO        CINKAQAJDMT     GCNMNKMRKCMVBWI PQMB           
IXFIWHQRQFP     : QAEWJAVCYKJROET QPQLPJURBMMQ    LAXEH           JLLNPMAKOPWIOYU XRXGSN         
IYCWIMNGT       : NHKVUCWSJWDWLKA PSYNBSLAEULEX  
HQJRMHXLNI      : PLSSVJELF       BXPVCADL        LTUA           
UQJCJDVOVWA     : NIHSQPRW        LXKCSMXHD       FSLDB           OWXPUHMOFRCUYV 
YWFNMLKG        : HQYMJ           OJBBASLLNI      GPTDNSMVPJ      OHWJMPO         MKLCAXKKWN     
DPKPYKEMVPJMY   : QNMASJFEWORY    UMDWUWCNHWIJ   
WFKNBJNXLMDBA   : OREKBPPTQLMKH   VARDJVNTKHLERXN ONFBS           NRIFWJHK        ODQNSQWVVYVPEHW
LILOXXHA        : CTGAWTLKYRDKWIO UKAXDVRV        VBMNOJB        
LOGD            : INLDBMLFBC      WDVMKVTRBALI   
TFNSKAILJYLWLO  : PHDEKIPWMGEOWYC PRADRFXEAK      KMWS            FNCEMIHAF       QBACK           XUSBEYAUWLAHFU  FUIXSNPJSHTO    GRJXPJEODWP    
NHKVUCWSJWDWLKA : IYCWIMNGT       YBWCJLKDAFQHV   XXQTW           RPTUHVGYVDRK   
GFABP           : VDTXFKXK        RNOVTCPQVQGB    WOJJKVVI        LUFLBAAMX      
JDOIOLWFMKMXHH  : FIJUHDTWEX      FKEMEXJGVBAQ   
GCLFGISSK       : FYDNGDGGFVMIBVV YOMJHIP         XTJQFREQAJS     UYGSUOOCRFLNI  
BQICGLLKAWBNT   : KSYIOEPUCPQKVV  ETXUHX          PBYMVVQK        VUYWDG          JUSTVRPODN      JORXWRLCYEPWPDI
BETBNEDTGQBOB   : DUHRGWORHROPEC  WGBTXKABNHCYYDG XLXJLYNLRHTAW   EOJILCCGE      
HLBICLMLWBXY    : OXUCJPRFDER     IMIMGLMOKN      BWWKX           UNAOEGLRV       CVPPTI         
YNRGQXDRM       : VWHTGISHK       GUKWPUCPHASB   
WINNMFO         : BEARS           JOALHDINKJVNYYN PUSS            NPBFNMD         UXEAWVOCBHBR    FLBSLCILSPGSC  
OAKXFVMQVNOU    : PDKRQNTIOPA     IUKJIFEJGLICK  
PKFWBEAUSHRDWFP : IQKY            BLLGX           VUCQKAROL       TGVVHTGBOHVCWPS
VYRYJREIGW      : JDMTOQKUMC      UEPSHXUHCTBKPJT VSSU            EPDIHNRIAP      DORXMLKYR      
ULBIDMOAPUA     : HFWSKAAEDR      KLJVFGN         RPLPOKGIB       VOYCCPAYUUHNUDA OMHDCCQWUNTXWQF GNWKQXDA        CLUDHKLRJLUF   
PJFUJNNNLMFKYYO : SLOUHECIFFEMR   PUOTCGXMONHW    VINGXTGTUPB     LCUKVARWEK      DMOEYWLNV       NIQPKYBN       
INLDBMLFBC      : LOGD            UYKHNKSWNCN     KLMLXRAV        IXAD            JDHJGPAPVJGNH   YPWAEYTRYXOM    AWXYSIIA       
TYIHORO         : SWOFSBSYPGBRE   SFOLHDXFCWELED  EDUEOCXTJJNK    SULEIWKXFNK     AVTPYUKGILSYHME
BEARS           : WINNMFO         MSSKAUPHKFN     GRCCL           OBOYQD          XJDHUEWGVG      RSKIQLGL        KABTR          
YDNYUUHIIMK     : XMLUETNWELEE    BJTNBNS        
APYFWUEFEVAVIDC : XRLKVXLTE       NRDAQ           OHGDKYJVQNWWY   XLXJLYNLRHTAW   XYFA            RLQMYYFARKV    
UUWUBNVVIFGTRSR : GDQWYV          HBVJU           CSNILMR         UJXNSQTGSCXGMX 
KSYIOEPUCPQKVV  : BQICGLLKAWBNT   HPPRDTVXDDNG    ISMWKOAEGXG     QJVAVHQGAINTXJY
QQTNT           : UKAXDVRV        BJDATIETOS      SJTNWVCXC      
JPSOYMITEFFYEP  : CIOHPCSX        DMOEYWLNV      
KFLOX           : FDKYJREJ        HPCMCSVPC       QUUGTIGRI       LPSBPCF        
YTATKTOYNXKEQ   : GDQWYV          UDLNETYQQOXYYO  LDEWFMK         LMCKTNCNRKGOAX  BHFX           
FDKYJREJ        : KFLOX           QWUHBOBM        LLRCFVD         FCRGSFOWN       BIDKDYNIA      
VYLCKBAP        : RLKQMJBFRVJKP   MKQXNKVQNRCEAAA FNCPU           XYFA           
TRWGLNFA        : UULGIIQEJE      UJXNSQTGSCXGMX 
QGDU            : RNOVTCPQVQGB    BJTNBNS        
IHMSATE         : QAEWJAVCYKJROET OJBBASLLNI      LGQSUCVORTHQLD  CVWHKXSMW      
PDKRQNTIOPA     : OAKXFVMQVNOU    UQRXRYM         EOJILCCGE      
WMDEMQWSVRGFASA : SIKMQILXAGTR    NFHDIUXLGWI     UQJGBCGY        FMRVAFQJAJMT    EWHOHDXV       
MEBFJNYACT      : WVXV            PXHCTJGW        TUXIPJBXILPXL  
SJJIIXLNKC      : HMUPJ           KANKTEBPXDHQA   PLXUXIGVLAO     WDYGVVCAKDRXVGJ
FYDNGDGGFVMIBVV : GCLFGISSK       JECHND          NTTIGHIBVMP     DLKJLBFYHLRIF   UQQIK           PBXWVT          OBBRVEPU        PWGCKYLCDV     
YXVHSISBQSMEF   : RURE            CWDWTN          KDSNW          
RKQUXY          : YOMJHIP         OVSJ            ALGXETU        
HHHFTP          : VBMNOJB        
RLKQMJBFRVJKP   : VYLCKBAP        IQKY            KHWJEYKIHBMROR  IITJMYR         XMARJQJLKIJHR   TFIIFMJBYYCARC 
PUPHIIEIHGRO    : QXUKWT          VUCQKAROL       IEFNXKWILHBB    FPYJILUHARNJ   
WKDHDQSVF       : PAGOK           LBAG            GWOGYEHOWMEJW   BCIXOHMVAHY     TXPIRGGJHV     
YNVVWG          : VPJGD          
UXKLHUTL        : BXPVCADL        HHJS           
ETXUHX          : BQICGLLKAWBNT   ATXRUNK         BMTOHSANBJG     OSGQBJLQWSEFL  
MFLGAJNEJBCH    : GBNXHKHJWHIHWF  MJYATABGX      
LWXJHLTFHHLL    : KWMNCXCRHXVO    VEWK           
JHJJPYRBF       : SBTBBALLTOQ     YMJVX          
MSYVWBFWMCW     : VYHHBM          HIKUNEHJOQPXYC  HFLLDCKRFWCTO   HEBDHQHOH       FLBSLCILSPGSC  
KISPQ           : BYGMYLLOTOUGY   NRDAQ           NHAQWQWSX       DUGRUGQ        
DEEOLOYDPQGUK   : YFHSJFQCHI      JOWATVRXVEYNNRW SQAHDAKP        KSEEVASSUJAXRY 
PJPMN           : WWOTTMQRE       OTEPISFR        TRLOHJES        JWGDOAH         TDTOURQHBGWRR  
MCXJBKUV        : JUGLFSASQRTO    CJJP            UHJQQY          POVXAJCPNLLU   
NYFRDUGTV       : JWHDHTRXDDYDMSX VKPAKX          DWXBCXK         TOFHSLQ         CSNILMR        
JOQGYKWLCJYXXB  : LBJDMXDQYXRWW   HWGYWYB         XJDHUEWGVG     
KFLFBOSCVKGQSAM : SJGWIUAVNPGQ    MDBUFLBLOTTFKV  WPUQPABTDYAV   
MBTSDGPOICPHCS  : OJBBASLLNI     
MXTTCKOEHCM     : NIHSQPRW        LAXEH           RMIPDGEBVVTLJ   WYPAUOJSOFEJYR 
UNNXCQTU        : LDKQA           OBOYQD         
ANMJRESTXDJXWDA : TVIDPF          DPHLVY         
SHRUTRRJHQLBMJ  : WOJJKVVI        JOOJCX          UMDWUWCNHWIJ    SULEIWKXFNK    
NYMYQQTMQ       : VWAN            GOMDTYTJ        QYRCXKJHQNWBGOJ WMBKWSCUHLCB    IDTW           
XPVCRGWYX       : SIXHPNA         TQQDHRP        
TSLFAETD        : YGSUPMOKJOOT    OQSQ            YJQDSQP         OTCOPNWHKDLJU  
DDHEPGWIAJA     : PMIDOE          JXBNUMBPE       RPXBBPYU        HBVJU           SOIVYPBONNMV    HSJMDFSDLBPTI  
IPUMHELJ        : PANYNAPKBQLTM   ULFMRDANJKSVEFG DWUQPXDQLC      AVTPYUKGILSYHME LAAIJ           LHNEKAKFOAMJ   
HFWSKAAEDR      : ULBIDMOAPUA     SGXW            DWUQPXDQLC      KVMJ            RCBDMMEWEJRT   
GBNXHKHJWHIHWF  : MFLGAJNEJBCH    XBQVBJ          VQCDB           GCNMNKMRKCMVBWI
GJHRO           : PAGOK           JOXG            RLQMYYFARKV     RXXKIJADDMRHMA 
WLJKNJQRDBAEQYN : EJXKSSTWUO      BTGJLFK         XOLADJ          KYQXUD          PSYNBSLAEULEX  
GYDNJKMPGUBNNP  : DHWJLRNC        DYNCYTAX        RDVXDSEVNJDW   
MENW            : LJVAKEQKQWCIIDF CRTGXQCQNXG     BROYSJYUHOMWWWV
AOJD            : LBAG            HTIAIAD         UTTWQLACDPR     LCJBE          
KKKLA           : EMPWKDBAEMLTCW  WQIODLFMPRHGITE TEKG            EALWEANEEWBWC  
RATHJEVBMSDC    : QPQLPJURBMMQ    BQYNAHCDYXRFL  
SGXW            : HFWSKAAEDR      DRPQGDXIH       THEIPSXLDKGLW   PIBMHY         
URWLDAF         : PAFMJ           YWYXNDETQWUYNP  IUKJIFEJGLICK   BKSESNJB       
MQBNJUP         : DEJQOCCOAD      MRLRKDMDXE      BRKJFWLVYXCNT  
CYKABXVGCE      : JSTQWIKVQOLXF   VKPAKX         
JCYGASFNVHT     : CMIGT           DOPBKPQUO       UNAOEGLRV       ATRIJ          
UMNKVJACNBNQCNM : BKICPJLCCTJFNDH OGXFWVXJIUTGW   OVQMUMFLSMF     CLUDHKLRJLUF   
PSMBXNJAG       : GTVBSWNUCETMIPU WLETCSA         OKYHLLOXSVA     PYRFIXVOUNTJRGM
NCWJOTX         : NTTIGHIBVMP     OMGSXSU         XGNCNQC        
GWOGYEHOWMEJW   : NTUTOKDIYAFYHS  WKDHDQSVF       TUYLWIIVUO      OUQKHWIU       
FJXFWIHFYWIX    : GGUEMC          EQFQMUJFTJER    DYNCYTAX        NIVHOAKXPSMYGKG OCJXPERHWKWYNME
YTHG            : FNFBNM          DHFXLTPMGH     
GUGICOWYDC      : FMRVAFQJAJMT    JOXG            RPLPOKGIB       OBBRVEPU       
AYSMWALHH       : BNYCCWMAKLPL    VPJGD           GTYB           
JECHND          : FYDNGDGGFVMIBVV FEYANISGKDPXNY  QJVAVHQGAINTXJY VKJWOPUMX       HUIHYAGOD       LHGTJXACGPYVQ  
XKCEH           : VDTXFKXK        EPFBKGEB        OMPMI          
MLCMLFOYFPTTO   : HUKYMVJ         MRLRKDMDXE      NYLAYSVEDELSP  
GWBAGFE         : XHLGBNISKIFF    FAFPFVR         LDEWFMK        
VHRTTWXCILNKXB  : SEECYMNPTE      YJDUPPHTIWMUT   PLFSKPJ         VKPAKX          NNXYVRXYR       OREJ           
OAWGTTUPATQC    : MXVWWHGWCL      NYHNNP          GTYS            WMYORICLHOXQCS  FIJUHDTWEX      VUNMQRS        
YGSUPMOKJOOT    : TSLFAETD        HEUAQHBRR       LRNPKESW        HPGJKN         
EGCGXQIVYF      : FSWPPKPMPULGQB 
UUROMVRLEMIT    : MJORKRFVF       JJRVQEDCFGTRQ   FRVYTFR         RFAU            DHSYAHVNNJGCOQD
YGJNUFQC        : XBXSHHPMA       LIVADORJRWNLHMS VPONRMLXIRTOXT 
SIKMQILXAGTR    : WMDEMQWSVRGFASA PLXUXIGVLAO     KMWS            JLLNPMAKOPWIOYU FRVYTFR         QELAIQMH       
IPRVTEEQ        : UMJMAM          GTYS           
DWOSU           : KXBDSXNRFSYBK   GFAO           
JWHDHTRXDDYDMSX : IAGJDK          HKHEXAGUB       NYFRDUGTV       XSSXE           BFBMBQOVLVQUTJD FSWPPKPMPULGQB  YTEITGXEIMGF   
DNCYIIFY        : LBAG            LHUBHERFVM     
KXBDSXNRFSYBK   : DWOSU           MDBTTQOQD       TOHMWRPGY       NSIXCDUWSGQDV  
EPYICTIO        : PTYLSL          YYDDVCDTG       JQVFMLUKS       YPWAEYTRYXOM   
VSXGBDFNNGQQY   : QLIMVQJW        THVYOXOBN       OSGQBJLQWSEFL  
GTVBSWNUCETMIPU : GGUEMC          PSMBXNJAG       UQIV            UBJW            YQANASIOOAQP    CLIFYVNKKVT     SKGVLVBVHIFHQDC
MSSKAUPHKFN     : BEARS           RWWA            PYCO            OREJ            UYGSUOOCRFLNI   KTLRYDSBR      
WPTFJ           : QNMASJFEWORY    UBKVYSMDYLFFEDP VPUDYQ         
HEOUASBTFKMCKY  : TOFHSLQ         FPNFRITJODAI    LRNPKESW        GTRTJQI        
FMXAEHM         : WDUXCMMVHUDQFE  FNCEMIHAF       OFHB           
VRJLLOW         : XYFA            UYGSUOOCRFLNI   UULGIIQEJE     
XBQVBJ          : GBNXHKHJWHIHWF  ULFMRDANJKSVEFG LWYMDHLCRUB     ERDA           
XRLKVXLTE       : APYFWUEFEVAVIDC KKMMXGICHRJLS   UMDWUWCNHWIJ   
TGFC            : RLGDTS          NRIFWJHK        VUNMQRS         XMRWG          
PANYNAPKBQLTM   : IPUMHELJ        SGILOBSIY      
GNLAAVV         : GRYDCP          AMNHXGHF        QUUGTIGRI       DUGRUGQ        
HSCIOJNSFFUSGIS : WDVMKVTRBALI    VJOY            UCQWCXQVJECXIR  HBVJU           TYSJVYEFCYWV    HCLCJYAMBY     
SWOFSBSYPGBRE   : LEOQBG          TYIHORO         JNOUSRODVK     
PLSSVJELF       : HQJRMHXLNI      AQTMN           PLXUXIGVLAO     DYNCYTAX        GPGFIWNPX      
QAEWJAVCYKJROET : IXFIWHQRQFP     IHMSATE         THEIPSXLDKGLW   ALBWBV         
KUXQUNDPI       : FEQHYHAYCBMVNKE BTGJLFK         NSIXCDUWSGQDV  
AMNHXGHF        : GKGPDHEQ        IAGJDK          GNLAAVV         IUIK           
QFCVEMHVDORJB   : UKAXDVRV        ETJNU           AGIVQXMV        LDEWFMK         MGOSW          
HSIXVB          : RRJBXQNRO       NGAL           
WDVMKVTRBALI    : HUKYMVJ         TUGHMDQSI       LOGD            HSCIOJNSFFUSGIS AAEMFAILSG      IUIK            FSWPPKPMPULGQB 
JMQSLU          : NTUTOKDIYAFYHS  HMUPJ           YTQKWRUIHSWB    GPQAIQVHPRW     HFLLDCKRFWCTO   XPAOESAMACRH   
DEJQOCCOAD      : MQBNJUP         DHFXLTPMGH      QYBMG          
WIUMSRGMU       : WUODT           LBNWGBIOCX      FUJJTKYTHPD    
XEKJSBDEVKK     : KOAEODFLKCO     HNOAJ           FSVANAHEVBQJ   
VDTXFKXK        : GFABP           XKCEH           VXUMHHIIPKPA    HLRYUU         
XSFKN           : MXVWWHGWCL      OLBEH           RAYNPUNMLTI     CDSCJTKH        SFFPBBMXNUJXO  
SBTBBALLTOQ     : JHJJPYRBF       GLHRMUKFOJDDN   OSGQBJLQWSEFL  
LDKQA           : UNNXCQTU        XOLADJ          QUUGTIGRI       PIVGGBMDHEYOWL  GSBBLXYGNOLDW  
MXVWWHGWCL      : OAWGTTUPATQC    XSFKN           HEUAQHBRR      
SKCT            : TBPYUJOPHPKTWTE IEGUNTBWW       HHJS            IPTGPSMFWBH    
DWHQIDFB        : ETSTTEFJVAENQI  FGWNBUFRWFP    
SFOLHDXFCWELED  : TYIHORO         VSAPXS          WMYORICLHOXQCS  GKGQMYJHBN      GVWLWMOQOVYRSKA TDTOURQHBGWRR  
PMIDOE          : DDHEPGWIAJA     GNIXCTI         IDWRMDMYM      
TCTMMXS         : PHDEKIPWMGEOWYC SPXIUSO         IWMYFIOD        LYCIH          
ENVSADYA        : JJRVQEDCFGTRQ   ATRIJ           DFFXEVRFJLQWL  
BXPOESEVINYW    : XTJQFREQAJS     FYHHSDLJWHX     IDTW           
NTTIGHIBVMP     : FYDNGDGGFVMIBVV NCWJOTX        
HRWITHLTYAXU    : NBJOYM          DPMM            ONFBS           OKINFNHS        FUJJTKYTHPD     TNRPQBAGQ       QVDEBNPVWSPU    MLDYA          
HRWITHLTYAXU    : NEKWKS         
WDUXCMMVHUDQFE  : FMXAEHM         XSSXE           XLCFPLWLL      
TVIDPF          : HPUCUCPTAE      ANMJRESTXDJXWDA HTPXCFOY       
KOAEODFLKCO     : XEKJSBDEVKK     PHNNREK         PVMYNA          UWFUFSXVLC     
AQTMN           : PLSSVJELF       FANQ            JORXWRLCYEPWPDI JLWMDIESJ       XYRILUKTBLJHVGU
JSTQWIKVQOLXF   : VYHHBM          PVNGCORFJIUT    CYKABXVGCE      OMSWRJES        ONFBS           BQEYQK         
PHDEKIPWMGEOWYC : TFNSKAILJYLWLO  TCTMMXS         LHUBHERFVM      DPMM            GGJP            YIIJBKRFRNRN   
CNFWFFF         : MPVPPB          RAXTVDHLUKBEPB  NNNARGL        
BYGMYLLOTOUGY   : KISPQ           UTSTCVN         BMEUMIUFEEJH    NPBFNMD         LXDXYAFTWJ      KDSNW          
ENSKCSJ         : FOHVTINQWWC     DKCJQW         
HMUPJ           : SJJIIXLNKC      JMQSLU          EHWIFVDNMGJ     YYDDVCDTG       XKKCPYOSGIQAMKB
UQRXRYM         : GTFPVNJT        PDKRQNTIOPA    
MXIIOEPNQ       : SFFHXAANRRRDFJ  FXTJVDMFQBUGNUR OJBBASLLNI      BKEUEIFLB       PJUXMOYPFFEQCXO NKADKWS        
BMGGHSKO        : YIUGEBWOIRIAJ   JNOUSRODVK      WOJJKVVI        UCOIVPVGLOWFQ  
FEQHYHAYCBMVNKE : PAGOK           SCABGD          KUXQUNDPI       GTYS            NXEXWRQUYUX    
CIORC           : VPJGD           HYJAFKIMDXVB    DQHXHGSKCUV     BJTNBNS         EOJILCCGE      
VOUCV           : NTUTOKDIYAFYHS  BIDKDYNIA       KHMN           
OMSWRJES        : JSTQWIKVQOLXF   HPCMCSVPC       NLABXHIT        SYWCPLYPJUPCSU  OKYHLLOXSVA    
ESXFHTVTXUVJJ   : PLFSKPJ         HECHIWMGNV      DORXMLKYR      
LXKCSMXHD       : UQJCJDVOVWA     YTQKWRUIHSWB    POVXAJCPNLLU   
AAEMFAILSG      : WDVMKVTRBALI    GFAO           
CAPVAMSJV       : WOJJKVVI        JOOJCX         
UVTWOIWVLKYOQNT : PRADRFXEAK      MJYATABGX       MDRSL           FWFAESXIMWP    
XHLGBNISKIFF    : GWBAGFE         JXBNUMBPE       QLIMVQJW        RPXBBPYU       
DOPBKPQUO       : KMUOWIJCPBGMQ   JCYGASFNVHT     JUGLFSASQRTO    XUSBEYAUWLAHFU  XMARJQJLKIJHR  
IBPW            : XRPXRBBIROVMFPF FSWPPKPMPULGQB 
FSLDB           : UQJCJDVOVWA     UCQWCXQVJECXIR  SKXXEASRIGN     BHFX           
LENTA           : DYNCYTAX        XXWOCTSNGYOPHNC LDEWFMK         EXQCWKCOKWB    
DHFXLTPMGH      : YTHG            DEJQOCCOAD      ONFBS           SYKFMGHC        PYRFIXVOUNTJRGM
BWWKX           : HLBICLMLWBXY    FHLEDJHMPXYSXFG PGOFHXPVUXV     PTHFPHDPIVYRXPA
HSUBFA          : THKABC          MRBUMEUNKA      LEUDTYV         QYRCXKJHQNWBGOJ QVDEBNPVWSPU   
DMIQGIRL        : NFHDIUXLGWI     CMLLB           SEIMUHGIY       GTYB            GPGFIWNPX      
WLETCSA         : PSMBXNJAG       PQROQ           TUDILAFUEVYQPB  GHHJHHNJF       NSIXCDUWSGQDV  
BCIXOHMVAHY     : WKDHDQSVF       WBFGJHWAKIPRWMJ
IDKU            : YOMJHIP         UCQWCXQVJECXIR  BJTNBNS         BDOJBKWSVRA     HJDVYHUXUJ      CLUDHKLRJLUF   
EDYVPRUBXOFTRP  : GRYDCP          GTOKC           WVXV            KABTR          
VXUMHHIIPKPA    : VDTXFKXK        NLFNISVO        GVOGJELUABYPSJ 
BUGHAIDPA       : WVXV            TACCJHGXAPT    
TBPYUJOPHPKTWTE : DWPKKQPGDOVSF   CFWPRREQCPTR    SKCT            GTYB            XGNCNQC        
JOALHDINKJVNYYN : WINNMFO         IQKY            VUCQKAROL       IDWRMDMYM       QELAIQMH       
AFSWQJOXBBR     : KRMTKJXTO       VUYWDG          GVOGJELUABYPSJ  JLWMDIESJ      
UYKHNKSWNCN     : INLDBMLFBC      PAFMJ           FSVANAHEVBQJ    MHCRYDQGMJURXA  VUNMQRS        
LLNMKEG         : HECHIWMGNV      GKGQMYJHBN     
LBJDMXDQYXRWW   : JOQGYKWLCJYXXB  NRBXJKMFMHJXB   LWXNL           TEHGSDAFUI      YMBMIM         
EMPWKDBAEMLTCW  : KKKLA           JWGDOAH         IPTGPSMFWBH    
KLMLXRAV        : DUHRGWORHROPEC  BTUVJYSWL       INLDBMLFBC      EEESRKXDNXXY    MDBUFLBLOTTFKV  MHCRYDQGMJURXA 
QXUKWT          : FDGX            PUPHIIEIHGRO    VAWLKPYJCOMBQGK ERDA            OFHB            GRJXPJEODWP    
BJDATIETOS      : QQTNT           JOOJCX          KLOAFYXVJ       EAMNEXP         OKYHLLOXSVA     RXXKIJADDMRHMA 
JUGLFSASQRTO    : OXUCJPRFDER     MCXJBKUV        DOPBKPQUO       SJGWIUAVNPGQ    PBYMVVQK        DKCJQW          XSLPHJXUTKSDW   ACMSN          
JUGLFSASQRTO    : WBFGJHWAKIPRWMJ
MOOX            : UVODHWDU       
JNOUSRODVK      : SWOFSBSYPGBRE   BMGGHSKO        MEXLRTXHON      HTPXCFOY        PAFMJ           KRIXN           ITKIM          
OREKBPPTQLMKH   : RDXHWYUYANG     WFKNBJNXLMDBA   KRMTKJXTO       YYLPOOLPLUMRE   RPOGHDE        
ETSTTEFJVAENQI  : DWHQIDFB        HWSYFRMPLW      AMRTBUAVQSPXUK  OSBPD          
DBAWHKX         : HPUCUCPTAE      TTDVQ           CUSEHOTRMM      ACMSN           SHWLAUFDXNUNMKU
DRPQGDXIH       : SGXW            PAFMJ           PIVGGBMDHEYOWL  YYDDVCDTG       OCJXPERHWKWYNME
DDQJIAFKFUDPGG  : MUJDOLJXGVAGB   NFHDIUXLGWI     FGWNBUFRWFP    
HEAT            : LYPTGCBPYPSVU   RPHROSEF        XXQTW          
YWWR            : MIRPWBBJSPB     AXRIOLWEG       MPLGIWDF       
DWNN            : BRKJFWLVYXCNT  
IQKY            : PKFWBEAUSHRDWFP RLKQMJBFRVJKP   JOALHDINKJVNYYN PYCO            DPMM            RFLEWHHTJD      YFWDUEO        
UBIG            : KVMJ           
EJXKSSTWUO      : WLJKNJQRDBAEQYN KWMNCXCRHXVO    TUNIFAWQB       NXFSJUDUBJIMMLV
UNAOEGLRV       : HLBICLMLWBXY    JCYGASFNVHT     ETFHIRXYRFQEMQ  OHGDKYJVQNWWY  
ANEBQAD         : RSKIQLGL       
GLHRMUKFOJDDN   : SBTBBALLTOQ     OHGDKYJVQNWWY   QVDEBNPVWSPU    IPTGPSMFWBH    
RNOVTCPQVQGB    : GFABP           QGDU            XXWOCTSNGYOPHNC LWEGMYTCDYNRBK  WTQUUPWIBIX     HPGJKN          EOJILCCGE      
YBWCJLKDAFQHV   : NHKVUCWSJWDWLKA NLSHTSCRSENBEX  HWGYWYB         BUSQ            NRIFWJHK        UQQIK          
KANKTEBPXDHQA   : SJJIIXLNKC      REWH            SFFHXAANRRRDFJ  OTEPISFR        IPTGPSMFWBH    
YBUAETDNHPS     : BDOJBKWSVRA    
WJRSKESARMESE   : GTYB            BQEYQK          AWXYSIIA       
WMVYOXCJXIE     : OQSQ            PEBEHYFEXNHUAIM EVWMSCTQUKYG    FSWPPKPMPULGQB 
XLSQVPBP        : LBNWGBIOCX      XYFA           
LVENN           : JOOJCX          AUSCBI          MDBUFLBLOTTFKV 
SHAXGOV         : KHWJEYKIHBMROR 
ETJNU           : QFCVEMHVDORJB   IDRKQ           FFUSAIUV        HNJUESEJL       SOGB            XCKHO          
TXPIRGGJHV      : WKDHDQSVF       KHLFRUXEXEEVJ   OMHDCCQWUNTXWQF IKVJMJPQJRA     SMJSFVOUSMY    
URAJGTCNTC      : HKHEXAGUB       CHJUHT          AKIEACUFLNQCN  
JXBNUMBPE       : DDHEPGWIAJA     XHLGBNISKIFF    ARNHLSPGV       SGJJT           FSVANAHEVBQJ   
NVGHCMTMIMJCOS  : FHBESADSC       JOCHHKUP       
IWADBVOAY       : SLFCAGSUNHYLDCY UCQWCXQVJECXIR  WYPAUOJSOFEJYR 
ULFMRDANJKSVEFG : IPUMHELJ        XBQVBJ          NNXYVRXYR      
QLIMVQJW        : VSXGBDFNNGQQY   XHLGBNISKIFF    AVTPYUKGILSYHME
NSKNUOKGWWY     : CIOHPCSX        NPJXJKQXUGJYTWI SOGB            TLGTJ          
YOMJHIP         : GCLFGISSK       RKQUXY          IDKU            ADAXESSJL       UULGIIQEJE     
RLGDTS          : TGFC            LBAQYFXSLGFIQ   GOBDQOJOTF      EEESRKXDNXXY    JQCUWMNC       
MEXLRTXHON      : JNOUSRODVK      NYLAYSVEDELSP  
WKQVMQN         : OKYHLLOXSVA     NEKWKS          OUQKHWIU       
CUKUKEGSHCLIORJ : LJVAKEQKQWCIIDF VYGIXW          TUXIPJBXILPXL   RBNJHG          IDTW           
MDBTTQOQD       : KXBDSXNRFSYBK   IDRKQ           LWXNL           HEBDHQHOH      
PRADRFXEAK      : TFNSKAILJYLWLO  UVTWOIWVLKYOQNT WQVPWOYTYVSOKA  PJUXMOYPFFEQCXO OVQMUMFLSMF     WMBKWSCUHLCB   
IDRKQ           : ETJNU           MDBTTQOQD       KWTFHYCS        PXHCTJGW       
BLLGX           : PKFWBEAUSHRDWFP HEUAQHBRR       FHLEDJHMPXYSXFG OWXPUHMOFRCUYV  RSKIQLGL       
HTIAIAD         : AOJD            XMYSPMFUB       VAPYMU          KABTR          
PUSS            : WINNMFO         TYCAFLJAGOAF    HYJAFKIMDXVB   
XSSXE           : JWHDHTRXDDYDMSX WDUXCMMVHUDQFE  FXOGCVATPHHANB  RFLEWHHTJD      JOWATVRXVEYNNRW
IJUSDXWOLDMBMG  : GSBBLXYGNOLDW   FUJJTKYTHPD     NIDWXS          QRYG           
MRLRKDMDXE      : ERPGTMUVAHLLL   SFCOOCMKPW      MQBNJUP         MLCMLFOYFPTTO   XLCFPLWLL      
TYCAFLJAGOAF    : GKGPDHEQ        PUSS            DWUQPXDQLC      QIPGYCQFDVPXR   TQQDHRP        
MIRPWBBJSPB     : YWWR            UJBJAQQCJNDUGGN GGJP            RLQMYYFARKV    
UQIV            : GTVBSWNUCETMIPU
MPVPPB          : CNFWFFF         BMTEXK          IEFNXKWILHBB    FSVANAHEVBQJ   
BELSG           : LIVADORJRWNLHMS GBBUD           NLABXHIT        EBYBOPP        
VUCQKAROL       : CIWOOJBDFSDDST  PKFWBEAUSHRDWFP PUPHIIEIHGRO    JOALHDINKJVNYYN MCWH           
GPRBGAWFNOBFGFK : CIWOOJBDFSDDST  SKXXEASRIGN     QMGC           
JXDRRYNUPAWJQ   : YFHSJFQCHI      NVCSDJSDLGWFYDK MDRSL          
VWAN            : NYMYQQTMQ       CDSCJTKH        OAKHBL          BIDKDYNIA      
GOALE           : FANQ            LUFLBAAMX      
PLXUXIGVLAO     : SJJIIXLNKC      SIKMQILXAGTR    PLSSVJELF       OWGXM           CINKAQAJDMT    
PLFSKPJ         : VHRTTWXCILNKXB  ESXFHTVTXUVJJ   OQSQ            FSDOQAPODWEJKGB XYRILUKTBLJHVGU
LJVAKEQKQWCIIDF : MENW            CUKUKEGSHCLIORJ EEESRKXDNXXY   
LNEXNUNGGSYQIIM : NGAYYACYSKVKE  
TIWEONRFMVPUY   : TBEUAGSNJ       LRNPKESW        FDNLDBJJD      
DLKJLBFYHLRIF   : FYDNGDGGFVMIBVV LAHEXPYSEBCV    KYQXUD         
STANEWRSMLBYI   : NIYQWGCTFXF     TFBBLQWWIUCPB   HDBWBUYO        NKADKWS         TCUSRTYVFAKHEGS YFWDUEO        
VJOY            : HSCIOJNSFFUSGIS QWUHBOBM        AYIHHYUYQSCSLD  FHBESADSC       YQNIEFHYDDFKFJ 
BKICPJLCCTJFNDH : UMNKVJACNBNQCNM ETFHIRXYRFQEMQ 
HEUAQHBRR       : YGSUPMOKJOOT    MXVWWHGWCL      BLLGX           UXAFMQCOHTF     ACMSN           JOCHHKUP       
NBJOYM          : HRWITHLTYAXU    FSDOQAPODWEJKGB PIVGGBMDHEYOWL 
HPPRDTVXDDNG    : KSYIOEPUCPQKVV  LYLEILBPPVSANF  PTYLSL          CLUDHKLRJLUF   
QPQLPJURBMMQ    : IXFIWHQRQFP     RATHJEVBMSDC    DBEWKQUMCDBRML  AMRTBUAVQSPXUK 
XFPKGYCXQGROG   : NHAQWQWSX       CVWHKXSMW      
RTFEKUUX        : OQTEGYWTDPGPO   OBOYQD          GTYB            HNJUESEJL      
ETFHIRXYRFQEMQ  : KGLI            UNAOEGLRV       BKICPJLCCTJFNDH GOCKNF          FFJEOHMRFSQ    
KJPFYVCSRI      : RWWA            QNMASJFEWORY   
EDUEOCXTJJNK    : TYIHORO         RRIKICIUBTY     XTJQFREQAJS     TLMCFJN        
HPCMCSVPC       : KFLOX           OMSWRJES        HNKOSRMPG       OAONQOI        
UBJW            : YXYAIUJ         GTVBSWNUCETMIPU YKNSLIYAGSFSK   GPQAIQVHPRW     YJNABKQNRQVM   
DHWJLRNC        : GYDNJKMPGUBNNP  NLSHTSCRSENBEX  PJUXMOYPFFEQCXO KDSNW          
OWGXM           : PLXUXIGVLAO     QFSQWOYUJS      EPFBKGEB        KTNKXQJVOSHJG  
IUIK            : AMNHXGHF        WDVMKVTRBALI    MLEKKBBMW       PXHCTJGW        JGNFPTEKKKFDJ  
NFHDIUXLGWI     : WMDEMQWSVRGFASA DMIQGIRL        DDQJIAFKFUDPGG  RWWA            CMLLB           DPHLVY         
FFUSAIUV        : ETJNU           VARDJVNTKHLERXN LDEWFMK        
REWH            : KANKTEBPXDHQA   NPJXJKQXUGJYTWI OQSQ            OWTDVCLRXCGK    FRVYTFR        
IEGUNTBWW       : SKCT            XMARJQJLKIJHR  
RWWA            : MSSKAUPHKFN     KJPFYVCSRI      NFHDIUXLGWI     FGWNBUFRWFP     JLLNPMAKOPWIOYU KMGGSXAI       
ILDPG           : BQYNAHCDYXRFL   DBNET          
PQROQ           : TUGHMDQSI       WLETCSA         PDIJLQCV        YMCRCHGBUK     
SPSQXWWVMSYJRKD : CSKYFDSBJSOOFUD
JDMTOQKUMC      : AAFNTNVUU       VYRYJREIGW      BSHR            UXAFMQCOHTF    
EQFQMUJFTJER    : FJXFWIHFYWIX    RKHGUAXBXIOCD  
WQIODLFMPRHGITE : KKKLA           QILOTQKOEAFX   
VSAPXS          : SFOLHDXFCWELED  JORXWRLCYEPWPDI
SDJOMN          : NINDV           VUNMQRS        
KMWS            : THKABC          TFNSKAILJYLWLO  SIKMQILXAGTR    SWTOIRKPHUCRI   ODQNSQWVVYVPEHW
AHGPY           : PAFMJ           GOFVDTKB        UWHS            CINKAQAJDMT    
YFHSJFQCHI      : UMUCGJ          DEEOLOYDPQGUK   JXDRRYNUPAWJQ   JJTOCCVN        RRJBXQNRO       OHJXLJPREX     
BMTEXK          : LLNCGPLD        MPVPPB          SJGWIUAVNPGQ    TGFWEYKLTA     
NRDAQ           : APYFWUEFEVAVIDC KISPQ           OVSJ            JOCHHKUP       
BTGJLFK         : WLJKNJQRDBAEQYN KUXQUNDPI       VKPAKX          KHLFRUXEXEEVJ   SMURGPRIXFA     SIXHPNA         BKSESNJB       
KTFWYVYGHCHV    : EPVRHLN         FJNKUWXE        RKHGUAXBXIOCD   ITSPHCI         KGRNMHSAPJR     AQHNIGONP      
NUIGKC          : TUEXLFM         PHRDTALNXN     
LVNOPTYBBJNNDS  : UADVFYCPKJYJXI  HBVJU           RFAU           
EQMKXOUUM       : SOORIEXMVCRJYAB JYRCHTWKGQQTS   FRVYTFR        
RURE            : YXVHSISBQSMEF   VSSU            GOBDQOJOTF      AXRIOLWEG       IEFNXKWILHBB    SYKFMGHC        QRYG           
EPVRHLN         : KTFWYVYGHCHV    INDRKTJ         EVWMSCTQUKYG    JEJD            XRPXRBBIROVMFPF
OQTEGYWTDPGPO   : RTFEKUUX        TBEUAGSNJ       MHCRYDQGMJURXA 
KLJVFGN         : ULBIDMOAPUA     JFXCSSLVCN      UWHS            OVOYQGFR       
GRCCL           : BEARS           CYDQKE          VPJGD           HLRYUU         
PBRETLIA        : TPWKQNQLFMTL   
HTPXCFOY        : JIJQNPKQITGVAX  TVIDPF          JNOUSRODVK      OXQUUVO         YQNIEFHYDDFKFJ  LBRWN           SQAHDAKP       
CIOHPCSX        : JPSOYMITEFFYEP  NSKNUOKGWWY    
UBJGQKAXGN      : VARDJVNTKHLERXN LWYMDHLCRUB    
GXQDPQFVHFOJPD  : DWXBCXK         OREJ            FJEENKSOG      
FHLEDJHMPXYSXFG : BWWKX           BLLGX           RRIKICIUBTY     SVOCV           LBRWN          
NHAQWQWSX       : KISPQ           XFPKGYCXQGROG  
JJTOCCVN        : YFHSJFQCHI      NWJBDPYQ        WTQUUPWIBIX    
YYPNRPMKORQVIXV : CLIFYVNKKVT     BQEYQK         
VOXQOCBXWRAB    : XMLUETNWELEE    GTYS            SIXHPNA         YMBMIM         
PJNPYCHQQRHLKDT : KTPHPBMEUS     
BSHR            : JDMTOQKUMC      HYJAFKIMDXVB    MKHHNXVLGO      KICNLGYP        SGILOBSIY       BQEYQK          TTDVQ           IKRBGA         
XGVBGUTGVK      : KJUGIQEOKU      ADAXESSJL       KRIXN           YMBMIM          DBITBKVPGN     
FXOGCVATPHHANB  : XSSXE           WNBEGNRYGQTA   
OVSJ            : RKQUXY          NRDAQ           WMYORICLHOXQCS  SMJSFVOUSMY     TPAVOE         
TRMWYHSFGDE     : HYJAFKIMDXVB    HECHIWMGNV      LSWOJFCWPXA    
EUUGQUC         : JAVGKLREIX      VKJWOPUMX       XRPXRBBIROVMFPF LCJBE          
CJJP            : GNQSUXQXGLBDVLY MCXJBKUV        INJHXDPEGV      GVOGJELUABYPSJ 
UHJQQY          : MCXJBKUV        UDLNETYQQOXYYO  LRNPKESW        TNRPQBAGQ      
INJHXDPEGV      : CJJP            LUFLBAAMX      
KRMTKJXTO       : YXYAIUJ         AFSWQJOXBBR     OREKBPPTQLMKH   RCBDMMEWEJRT   
FEYANISGKDPXNY  : GYYDL           JECHND          KWMNCXCRHXVO   
SQCB            : IWMYFIOD        GOMDTYTJ        WDYGVVCAKDRXVGJ OFMDFWTOXSA     TGFWEYKLTA      SYKFMGHC        UWTMMGOSHKRFS  
WOJJKVVI        : GFABP           SHRUTRRJHQLBMJ  BMGGHSKO        CAPVAMSJV       UQJGBCGY        LUFLBAAMX       BFBMBQOVLVQUTJD AEBTMNAYRXI    
KUWQUAFFSLPYDQ  : HNJUESEJL       JDSV           
FOHVTINQWWC     : FNFBNM          ENSKCSJ         GNIXCTI         SEIMUHGIY       OVOYQGFR        OFHB            BFYNB          
TASLKPLCKLHQE   : LBAG            CJWVHWWEYSC     KTCTW           FEHVKTIB       
IFYYTE          : JNYQUENCVTB     SVOCV           BFYNB          
DCMOQ           : EALWEANEEWBWC  
NPJXJKQXUGJYTWI : NSKNUOKGWWY     REWH            SADJMMJTEEOJ    YPWAEYTRYXOM   
BEUJFUDJN       : YMJVX           LWYMDHLCRUB     YYDDVCDTG      
LAXEH           : IXFIWHQRQFP     MXTTCKOEHCM     QJVAVHQGAINTXJY QMGC            IIMCNCJVFCFU    EOJILCCGE      
UQJGBCGY        : GMMCSMSMUY      OKHFBLHLWVTJFFV WMDEMQWSVRGFASA WOJJKVVI        OLBEH           CLIFYVNKKVT     NRIFWJHK        OSBPD          
PAFMJ           : URWLDAF         UYKHNKSWNCN     JNOUSRODVK      DRPQGDXIH       AHGPY           GUKWPUCPHASB    NDYOQWQLKVKX    XYFA           
PAFMJ           : GRJXPJEODWP    
QNMASJFEWORY    : DPKPYKEMVPJMY   WPTFJ           KJPFYVCSRI      VKJWOPUMX       GPGFIWNPX       PTHFPHDPIVYRXPA
WGBTXKABNHCYYDG : BETBNEDTGQBOB   IAHUBNKE        GTYS            DFFXEVRFJLQWL   SFFPBBMXNUJXO  
MXHCK           : FCRGSFOWN       NXEXWRQUYUX    
WUODT           : WIUMSRGMU       FJNKUWXE        RXQDRBENJ       RLQMYYFARKV    
UTSTCVN         : BYGMYLLOTOUGY   XJDHUEWGVG      GSBBLXYGNOLDW   UPLVQMXSHIORNX 
HQEWXGXYJENVEWA : CCPUDSJDSPTJBW  IIMCNCJVFCFU   
GYLVCICXEWRGTI  : MRBUMEUNKA      GGUEMC          FUIXSNPJSHTO   
DYNCYTAX        : UMJMAM          GYDNJKMPGUBNNP  FJXFWIHFYWIX    PLSSVJELF       LENTA           LBNWGBIOCX     
GOCKNF          : ETFHIRXYRFQEMQ  TFIIFMJBYYCARC 
UEPSHXUHCTBKPJT : VYRYJREIGW     
KHWJEYKIHBMROR  : RLKQMJBFRVJKP   SHAXGOV         EWCNQVEBHFDBHK  HLRYUU         
LYLEILBPPVSANF  : HPPRDTVXDDNG    ODQNSQWVVYVPEHW
JPEICIKO        : TPWKQNQLFMTL    CBKIQHTHJSAFKAW JNYQUENCVTB     LJKQVHDYVOKVWGW OBOYQD          BDOJBKWSVRA    
RRIKICIUBTY     : EDUEOCXTJJNK    FHLEDJHMPXYSXFG SOORIEXMVCRJYAB GVWLWMOQOVYRSKA
HDBWBUYO        : STANEWRSMLBYI   IWMYFIOD        XBLKTJWUENK     LIVADORJRWNLHMS IPTGPSMFWBH     GNWKQXDA       
VARDJVNTKHLERXN : WFKNBJNXLMDBA   FFUSAIUV        UBJGQKAXGN      LCUKVARWEK      DEPJYLXEH      
GKVC            : WDLHANYDXOJTIM  VSSU            WFNJLIVTDBBJNIO LWYMDHLCRUB     CCPUDSJDSPTJBW 
HLOJKPGKFI      : OVQMUMFLSMF    
FANQ            : AQTMN           GOALE           IDWRMDMYM       HDOCC          
CMLLB           : DMIQGIRL        NFHDIUXLGWI     RXQDRBENJ       MKLCAXKKWN     
DBEWKQUMCDBRML  : QPQLPJURBMMQ    FMRVAFQJAJMT    BULCIIX         FEHVKTIB       
UVODHWDU        : MOOX            BXPVCADL        LLRCFVD         OTEPISFR        UISFI           YPWAEYTRYXOM   
CYDQKE          : GRCCL           UADVFYCPKJYJXI 
PHNNREK         : KOAEODFLKCO     UDLNETYQQOXYYO  SYUKDACLPNB     HNJUESEJL       HLRYUU         
GNIXCTI         : YIUGEBWOIRIAJ   PMIDOE          FOHVTINQWWC     TEKG            DIQCMVBOYWXGG  
SWACTG          : LXUYDSNW        XMLUETNWELEE    MLWLUGHBRQ     
KKWNBJTK        : LLNCGPLD        MKQXNKVQNRCEAAA
BXPVCADL        : GTFPVNJT        HQJRMHXLNI      UXKLHUTL        UVODHWDU        XKOD            NWJBDPYQ       
NLSHTSCRSENBEX  : RDXHWYUYANG     NQSAE           YBWCJLKDAFQHV   DHWJLRNC        TYSJVYEFCYWV    TGFWEYKLTA     
DNPMH           : OHGDKYJVQNWWY   LEUDTYV         IDWRMDMYM       FSWPPKPMPULGQB 
OLBEH           : XSFKN           UQJGBCGY        HWGYWYB         YYLPOOLPLUMRE  
FMRVAFQJAJMT    : WMDEMQWSVRGFASA GUGICOWYDC      DBEWKQUMCDBRML  VBMNOJB         UUIR            SJTNWVCXC      
SJGWIUAVNPGQ    : KFLFBOSCVKGQSAM JUGLFSASQRTO    BMTEXK          NIDWXS          OCJXPERHWKWYNME FRIN           
RRJBXQNRO       : HKHEXAGUB       HSIXVB          YFHSJFQCHI      XVDWNAIECYKSCN 
XFYAPLVWFFDEPBH : AVTPYUKGILSYHME LHGTJXACGPYVQ   QRYG            SFFPBBMXNUJXO  
QWUHBOBM        : FDKYJREJ        VJOY            NGCQC           NGAL            PIVGGBMDHEYOWL  HNKOSRMPG       KTNKXQJVOSHJG   PIBMHY         
CDHV            : RPXBBPYU        CLIFYVNKKVT     FSVANAHEVBQJ    UPLVQMXSHIORNX 
WVXV            : MEBFJNYACT      EDYVPRUBXOFTRP  BUGHAIDPA       TACCJHGXAPT     HFLLDCKRFWCTO  
PITMPCR         : GKGPDHEQ        IHEQXSP         PEBEHYFEXNHUAIM XMRWG          
TUDILAFUEVYQPB  : WLETCSA        
WWOTTMQRE       : PJPMN           VQCDB          
OQSQ            : TPWKQNQLFMTL    FHYNOLQHG       TSLFAETD        WMVYOXCJXIE     PLFSKPJ         REWH            UUIR           
OMGSXSU         : NCWJOTX         MADNFCOFHLFS    NXFSJUDUBJIMMLV
PYCO            : GKGPDHEQ        IAGJDK          SFCOOCMKPW      IHVDTT          MSSKAUPHKFN     IQKY            UTTWQLACDPR    
RRNPP           : AGIVQXMV        FWFAESXIMWP     HFLLDCKRFWCTO  
LLRCFVD         : FDKYJREJ        UVODHWDU        YJQDSQP         JEJD            QVDEBNPVWSPU   
PVMYNA          : KOAEODFLKCO     YWYXNDETQWUYNP  RFAU            HLRYUU         
IXAD            : INLDBMLFBC      DPMM            UJBJAQQCJNDUGGN
SFFHXAANRRRDFJ  : MXIIOEPNQ       KANKTEBPXDHQA   VEWK            RPOGHDE         JTCLVQHM        FSVANAHEVBQJ   
KINFXMRYARGIR   : HBVJU           AESWIFBELMPCPI 
NVCSDJSDLGWFYDK : JXDRRYNUPAWJQ   IAHUBNKE        UISFI           PHRDTALNXN     
LXUYDSNW        : SWACTG          SGJJT           VEXS            WBFGJHWAKIPRWMJ KHMN           
NRBXJKMFMHJXB   : LBJDMXDQYXRWW   FYHHSDLJWHX    
MJORKRFVF       : UUROMVRLEMIT    ITKIM           SYWCPLYPJUPCSU 
SEIMUHGIY       : DMIQGIRL        FOHVTINQWWC     ACMSN           PWGCKYLCDV      XMRWG          
JJRVQEDCFGTRQ   : UUROMVRLEMIT    ENVSADYA       
LBAQYFXSLGFIQ   : RLGDTS          MLDYA          
RPXBBPYU        : DDHEPGWIAJA     XHLGBNISKIFF    CDHV           
EWCNQVEBHFDBHK  : KHWJEYKIHBMROR  YRCDRFJJYJSPHA  XLCFPLWLL      
AYIHHYUYQSCSLD  : VJOY            NNNARGL         MWLONXSUWBWCTU  BULCIIX         UWHS           
KKMMXGICHRJLS   : XRLKVXLTE       FXTJVDMFQBUGNUR HNJQUM          OKQRKJT        
VSSU            : WDLHANYDXOJTIM  CHJUHT          VYRYJREIGW      RURE            GKVC            MADNFCOFHLFS    PHRDTALNXN     
ADAXESSJL       : GNQSUXQXGLBDVLY YOMJHIP         XGVBGUTGVK      MJYATABGX       RDVXDSEVNJDW    WAMATSH        
OBOYQD          : BEARS           UNNXCQTU        RTFEKUUX        JPEICIKO       
WNBEGNRYGQTA    : AUYP            FXOGCVATPHHANB 
UCQWCXQVJECXIR  : HSCIOJNSFFUSGIS FSLDB           IDKU            IWADBVOAY       YTQKWRUIHSWB    OVRGTIFPJELY    PJUXMOYPFFEQCXO FKEMEXJGVBAQ   
YWYXNDETQWUYNP  : URWLDAF         PVMYNA         
BMEUMIUFEEJH    : PFYMCVOFXY      BYGMYLLOTOUGY   AJXLHOT        
TBEUAGSNJ       : TIWEONRFMVPUY   OQTEGYWTDPGPO   VPJGD           TGFWEYKLTA     
HCWFD           : RQCQIB          IHVDTT          LWXNL           KABTR          
WFNJLIVTDBBJNIO : TPWKQNQLFMTL    GKVC            SOSRFJPTTKWRSTC XKOD            LEUDTYV         KYQXUD         
LUFLBAAMX       : FHYNOLQHG       GFABP           GOALE           INJHXDPEGV      WOJJKVVI        FSDOQAPODWEJKGB SLDESV         
QWOUJNAX        : GHHJHHNJF       OMPMI          
NIVHOAKXPSMYGKG : FJXFWIHFYWIX    HOWACMVORA      GNWKQXDA        UWTMMGOSHKRFS  
LHUBHERFVM      : NIHSQPRW        DNCYIIFY        PHDEKIPWMGEOWYC EBYBOPP        
JOOJCX          : NIHSQPRW        SHRUTRRJHQLBMJ  CAPVAMSJV       BJDATIETOS      LVENN          
MMIWKXSAYYKG    : VINGXTGTUPB     EAMNEXP         OAKHBL         
XPOYWVRETGV     : XMLUETNWELEE   
VKPAKX          : GTFPVNJT        NYFRDUGTV       CYKABXVGCE      VHRTTWXCILNKXB  BTGJLFK        
WGMKGF          : AUSCBI         
FGWNBUFRWFP     : NWNXQXTWUT      DWHQIDFB        DDQJIAFKFUDPGG  RWWA            JBYSIHHGWUCOH  
JJWHPUSFXFDM    : CYSTQAOFR       XNDLFJB        
LYPTGCBPYPSVU   : HEAT            QMGC            BIYCX           XORNIKXATXF     TGFWEYKLTA     
SADJMMJTEEOJ    : GYYDL           NPJXJKQXUGJYTWI AVTPYUKGILSYHME IDQL           
WORACSR         : ALGXETU         VFRUEMHOPVJ    
ATXRUNK         : ETXUHX          BQYNAHCDYXRFL   FRIN           
KWMNCXCRHXVO    : LWXJHLTFHHLL    EJXKSSTWUO      FEYANISGKDPXNY  JOXG            QUHTERACKCBVE  
ISMWKOAEGXG     : YXYAIUJ         KSYIOEPUCPQKVV  VMCSBXVSBOTUM   DHSYAHVNNJGCOQD QRYG           
VAWLKPYJCOMBQGK : QXUKWT          XLXJLYNLRHTAW   OWXPUHMOFRCUYV  NEKWKS         
CYGKSSKFHKJN    : IHEQXSP        
RPHROSEF        : HEAT            RAXNMWV         PJMMHBBH        BROYSJYUHOMWWWV UXWPV          
OHGDKYJVQNWWY   : IMIMGLMOKN      APYFWUEFEVAVIDC UNAOEGLRV       GLHRMUKFOJDDN   DNPMH           GVOGJELUABYPSJ 
QJVAVHQGAINTXJY : KSYIOEPUCPQKVV  JECHND          LAXEH           LTUA            SEVJ            XGUDUGEXXA      TMDEN          
DPMM            : BNYCCWMAKLPL    LEOQBG          HRWITHLTYAXU    PHDEKIPWMGEOWYC IQKY            IXAD           
ALGXETU         : LBQTVNHFMTJRU   RKQUXY          WORACSR         SYUKDACLPNB    
ULUEJU          : XNDLFJB         KKSPCR          FNCEMIHAF       UCELKYDOVIV    
QNJSWYPWKOC     : TLMCFJN        
GOBDQOJOTF      : RLGDTS          RURE            PUOTCGXMONHW    OSONPHDDW      
XBXSHHPMA       : YGJNUFQC        QYBMG          
XVDWNAIECYKSCN  : RRJBXQNRO       VYGIXW          BKEUEIFLB       JQCUWMNC       
QYBMG           : DEJQOCCOAD      XBXSHHPMA       XOLADJ          SOGB           
KHLFRUXEXEEVJ   : VYHHBM          TXPIRGGJHV      BTGJLFK         FSDOQAPODWEJKGB RFBFHLURRR      MEDPXYGLFW     
JLLNPMAKOPWIOYU : IXFIWHQRQFP     SIKMQILXAGTR    RWWA            WLGQQ           SYWCPLYPJUPCSU 
OIFDPYX         : ARNHLSPGV       JGQBR           AMRTBUAVQSPXUK 
FXTJVDMFQBUGNUR : MXIIOEPNQ       KKMMXGICHRJLS   UBKVYSMDYLFFEDP IDQL            PSYNBSLAEULEX  
KONBPIYFSGIJF   : IHVDTT          RPOGHDE         RYWQORJJY      
YMJVX           : JHJJPYRBF       BEUJFUDJN       YMCRCHGBUK      BROYSJYUHOMWWWV
YKNSLIYAGSFSK   : UBJW            NNNARGL         AJXLHOT        
UADVFYCPKJYJXI  : LVNOPTYBBJNNDS  CYDQKE         
VPJGD           : YNVVWG          AYSMWALHH       CIORC           GRCCL           TBEUAGSNJ       JOWATVRXVEYNNRW
UMDWUWCNHWIJ    : DPKPYKEMVPJMY   SHRUTRRJHQLBMJ  XRLKVXLTE       PJUXMOYPFFEQCXO XRXGSN         
EPDIHNRIAP      : VYRYJREIGW      NYHNNP          LCUKVARWEK      RSKIQLGL        HSJMDFSDLBPTI   HOLXJBXHGQDWVMN
HNJQUM          : KKMMXGICHRJLS   XMLUETNWELEE   
PBYMVVQK        : BQICGLLKAWBNT   JUGLFSASQRTO    VPUDYQ          SJTNWVCXC       CVWHKXSMW      
PUOTCGXMONHW    : FQRCKGKMMVRWXW  PGVRDOTHUDQGJM  PJFUJNNNLMFKYYO GOBDQOJOTF      PSYNBSLAEULEX  
YQANASIOOAQP    : FEKLRDE         GTVBSWNUCETMIPU CVPPTI          HPGJKN         
ONFBS           : LLNCGPLD        WFKNBJNXLMDBA   HRWITHLTYAXU    JSTQWIKVQOLXF   DHFXLTPMGH      RUFFGALCNK      XRXGSN         
YJQDSQP         : TSLFAETD        LLRCFVD         OHJXLJPREX     
HWGYWYB         : JOQGYKWLCJYXXB  YBWCJLKDAFQHV   OLBEH           XBLKTJWUENK    
BUSQ            : SGMLEP          CTGAWTLKYRDKWIO YBWCJLKDAFQHV   LPSBPCF         OVQMUMFLSMF    
UJBJAQQCJNDUGGN : MIRPWBBJSPB     IXAD            PIVGGBMDHEYOWL  JNJPITVJ       
VWHTGISHK       : HLEAQPKNJO      YNRGQXDRM       NPBFNMD         OUQKHWIU       
JFXCSSLVCN      : KLJVFGN         NKADKWS         LMCKTNCNRKGOAX 
SPXIUSO         : TCTMMXS         ITKIM           PTHFPHDPIVYRXPA
JOXG            : GJHRO           GUGICOWYDC      KWMNCXCRHXVO    TOHMWRPGY       MLWLUGHBRQ     
TOHMWRPGY       : BNYCCWMAKLPL    KXBDSXNRFSYBK   JOXG            BMTOHSANBJG    
KRIXN           : JNOUSRODVK      XGVBGUTGVK      TENBE          
LAHEXPYSEBCV    : HPUCUCPTAE      DLKJLBFYHLRIF   KWTFHYCS        CSKYFDSBJSOOFUD
LTUA            : HQJRMHXLNI      QJVAVHQGAINTXJY HIKUNEHJOQPXYC  DEPJYLXEH       PGOFHXPVUXV     BFBMBQOVLVQUTJD
HWSYFRMPLW      : QTHEYJRLUIPWBSF ETSTTEFJVAENQI  OKQRKJT         VPUDYQ          NANEP          
YJCYQ           : NSIXCDUWSGQDV   YTHUWDLXQ       YNVUFMLXAYXKSRB QILOTQKOEAFX   
YIFS            : JYRCHTWKGQQTS   ILIJLHULKRXDH  
IUKJIFEJGLICK   : OAKXFVMQVNOU    URWLDAF         MLDYA           UULGIIQEJE     
VYGIXW          : DWPKKQPGDOVSF   CHJUHT          CUKUKEGSHCLIORJ XVDWNAIECYKSCN  AKIEACUFLNQCN  
HYJAFKIMDXVB    : CIORC           PUSS            BSHR            TRMWYHSFGDE     YIIJBKRFRNRN   
FJNKUWXE        : JLXYJ           KTFWYVYGHCHV    WUODT           RWLUKPPWWUKKAO  FEHVKTIB       
LWYMDHLCRUB     : JAVGKLREIX      XBQVBJ          UBJGQKAXGN      BEUJFUDJN       GKVC            SYUKDACLPNB     OFOQLVPTDQH     LWEGMYTCDYNRBK 
VINGXTGTUPB     : PJFUJNNNLMFKYYO MMIWKXSAYYKG    KHMN           
FNCEMIHAF       : WDLHANYDXOJTIM  TFNSKAILJYLWLO  FMXAEHM         ULUEJU          OMPMI           SMJSFVOUSMY    
MKQXNKVQNRCEAAA : VYLCKBAP        KKWNBJTK        MLDYA          
VUYWDG          : BQICGLLKAWBNT   AFSWQJOXBBR     LWXNL          
FNCPU           : GSDFMWXOP       VYLCKBAP       
UCOIVPVGLOWFQ   : BMGGHSKO        EAMNEXP        
FSDOQAPODWEJKGB : PLFSKPJ         NBJOYM          LUFLBAAMX       KHLFRUXEXEEVJ   XBLKTJWUENK     PIBMHY         
IWMYFIOD        : TCTMMXS         SQCB            HDBWBUYO        GPQO            NHURG          
ARNHLSPGV       : JXBNUMBPE       OIFDPYX         OSGQBJLQWSEFL   HEBDHQHOH      
XXWOCTSNGYOPHNC : LENTA           RNOVTCPQVQGB    BQYNAHCDYXRFL  
SKXXEASRIGN     : FSLDB           GPRBGAWFNOBFGFK
MLEKKBBMW       : TFBBLQWWIUCPB   IUIK            SYKFMGHC        XMRWG          
ADSOTC          : RQCQIB          CCPUDSJDSPTJBW  DMOEYWLNV      
XLXJLYNLRHTAW   : PAGOK           BETBNEDTGQBOB   APYFWUEFEVAVIDC VAWLKPYJCOMBQGK
MJYATABGX       : FGDX            MFLGAJNEJBCH    UVTWOIWVLKYOQNT ADAXESSJL       AGIVQXMV        FWFAESXIMWP    
GDQWYV          : UUWUBNVVIFGTRSR YTATKTOYNXKEQ   UQXBVXEDOJ      EVWMSCTQUKYG   
XJDHUEWGVG      : EVFH            BEARS           JOQGYKWLCJYXXB  UTSTCVN         NINDV           XMRWG          
VEWK            : LWXJHLTFHHLL    SFFHXAANRRRDFJ 
VKJWOPUMX       : JECHND          EUUGQUC         QNMASJFEWORY    NANEP          
DWXBCXK         : QWFWIDTNSBMA    NYFRDUGTV       GXQDPQFVHFOJPD  SFLM           
FFJEOHMRFSQ     : ETFHIRXYRFQEMQ  TYSJVYEFCYWV    YIIJBKRFRNRN   
INDRKTJ         : EPVRHLN         NYHNNP          ILURRIX        
GHHJHHNJF       : WLETCSA         QWOUJNAX        ILURRIX         JGQBR           BKEUEIFLB       JOCHHKUP        VXWGMDMCCNK    
QMGC            : GPRBGAWFNOBFGFK LAXEH           LYPTGCBPYPSVU   OVRGTIFPJELY    KMGGSXAI       
WLGQQ           : JLLNPMAKOPWIOYU VQCDB          
HIKUNEHJOQPXYC  : EVPQBBQBIPL     MSYVWBFWMCW     LTUA            VPIIVXDTSUPABH 
GPQO            : CIWOOJBDFSDDST  IWMYFIOD        KLOAFYXVJ       FUJJTKYTHPD    
HBVJU           : UUWUBNVVIFGTRSR DDHEPGWIAJA     HSCIOJNSFFUSGIS LVNOPTYBBJNNDS  KINFXMRYARGIR  
UDLNETYQQOXYYO  : YTATKTOYNXKEQ   UHJQQY          PHNNREK         CCPUDSJDSPTJBW  HEBDHQHOH       FLBSLCILSPGSC  
OOQQWAG         : ETHYEEDP        FPNFRITJODAI    SYKFMGHC       
OWXPUHMOFRCUYV  : UQJCJDVOVWA     BLLGX           VAWLKPYJCOMBQGK BMTOHSANBJG    
RPLPOKGIB       : ULBIDMOAPUA     GUGICOWYDC      FUJJTKYTHPD     GPGFIWNPX      
AUSCBI          : LVENN           WGMKGF          TOFHSLQ         IAHUBNKE        OVQMUMFLSMF    
AGIVQXMV        : QFCVEMHVDORJB   RRNPP           MJYATABGX      
OSONPHDDW       : GOBDQOJOTF      DKCJQW          HFLLDCKRFWCTO   SFLM           
NGCQC           : JFNQFERICGRV    QWUHBOBM        XRPXRBBIROVMFPF
LWGPF           : IHDJNMRNOVYUMAP CDCKUUHHETP     FIJUHDTWEX      CRVODJPX        EXQCWKCOKWB    
RMIPDGEBVVTLJ   : MXTTCKOEHCM     LHGTJXACGPYVQ   UXWPV           MGOSW          
SOORIEXMVCRJYAB : SEECYMNPTE      EQMKXOUUM       RRIKICIUBTY     PTYLSL          UPLVQMXSHIORNX 
ATRIJ           : KGLI            JCYGASFNVHT     ENVSADYA       
QOXOKTA         : QNEQCUBWBFVDA  
GUKWPUCPHASB    : YNRGQXDRM       PAFMJ           KWTFHYCS        OGXFWVXJIUTGW  
TENBE           : KRIXN           UXEAWVOCBHBR    UULGIIQEJE     
SOSRFJPTTKWRSTC : NWNXQXTWUT      WFNJLIVTDBBJNIO UBKVYSMDYLFFEDP
JYRCHTWKGQQTS   : LBAG            KMUOWIJCPBGMQ   EQMKXOUUM       YIFS            NIDWXS         
DNLVGSGXPCIMUDI : SLOUHECIFFEMR   TACCJHGXAPT     ODQNSQWVVYVPEHW KGRNMHSAPJR     OAKHBL         
TUYLWIIVUO      : GWOGYEHOWMEJW   QIPGYCQFDVPXR  
MKHHNXVLGO      : BSHR            AKIEACUFLNQCN   RAXNMWV         OJSAMLWV       
GEYRSTUC        : DKCJQW          ITKIM           BIDKDYNIA       NGAYYACYSKVKE  
OWTDVCLRXCGK    : NIYQWGCTFXF     REWH            RXQDRBENJ       VPONRMLXIRTOXT  NYLAYSVEDELSP  
OTCOPNWHKDLJU   : QTHEYJRLUIPWBSF TSLFAETD        PEBEHYFEXNHUAIM JGQBR           XYFA            RAXNMWV         OOIBRGHRYS      AAPOS          
OTCOPNWHKDLJU   : JBYSIHHGWUCOH  
DQHXHGSKCUV     : CIORC           BJTNBNS         BQEYQK         
UXAFMQCOHTF     : HEUAQHBRR       JDMTOQKUMC      CVPPTI          FDNLDBJJD       GNWKQXDA        IDTW           
BPKNYHUEAEEIK   : TACCJHGXAPT     PGOFHXPVUXV     PQTDRYFGCXV    
SMURGPRIXFA     : HUKYMVJ         BTGJLFK         DFFXEVRFJLQWL  
THVYOXOBN       : VSXGBDFNNGQQY   EJQEMQXCHWRFU   NXEXWRQUYUX     QVDEBNPVWSPU   
IITJMYR         : RLKQMJBFRVJKP   XVCSUJYAHW     
XMLUETNWELEE    : YDNYUUHIIMK     VOXQOCBXWRAB    SWACTG          XPOYWVRETGV     HNJQUM          WYPAUOJSOFEJYR  XMARJQJLKIJHR   XORNIKXATXF    
XMLUETNWELEE    : GVOGJELUABYPSJ 
XOLADJ          : JXWFNFYEWG      NIYQWGCTFXF     CFWPRREQCPTR    WLJKNJQRDBAEQYN LDKQA           QYBMG           AXRIOLWEG       SQINNGDJ       
XOLADJ          : JUSTVRPODN      FRIN           
EWHOHDXV        : HLEAQPKNJO      WMDEMQWSVRGFASA PQKWQKNSKGPYNAV
RUFFGALCNK      : ONFBS           IKRBGA         
BONQPCDRHOIN    : NQSAE           XTJQFREQAJS     YRCDRFJJYJSPHA  IKVJMJPQJRA    
RDVXDSEVNJDW    : GYDNJKMPGUBNNP  ADAXESSJL       UQXBVXEDOJ     
QBACK           : LBAG            TFNSKAILJYLWLO  PIVGGBMDHEYOWL  PGOFHXPVUXV    
SYUKDACLPNB     : PHNNREK         ALGXETU         LWYMDHLCRUB     XYRILUKTBLJHVGU
HECHIWMGNV      : ESXFHTVTXUVJJ   LLNMKEG         TRMWYHSFGDE    
KICNLGYP        : LLNCGPLD        BSHR            BIYCX           TLMCFJN        
XKOD            : BXPVCADL        WFNJLIVTDBBJNIO XKKCPYOSGIQAMKB
TOFHSLQ         : NYFRDUGTV       HEOUASBTFKMCKY  AUSCBI          EHWIFVDNMGJ     JQVFMLUKS      
NYHNNP          : OAWGTTUPATQC    EPDIHNRIAP      INDRKTJ         LGQSUCVORTHQLD 
LBNWGBIOCX      : WIUMSRGMU       XLSQVPBP        DYNCYTAX        SWTOIRKPHUCRI  
AKIEACUFLNQCN   : AAFNTNVUU       FGDX            URAJGTCNTC      VYGIXW          MKHHNXVLGO     
DWUQPXDQLC      : SFCOOCMKPW      IPUMHELJ        HFWSKAAEDR      TYCAFLJAGOAF    XBLKTJWUENK     NLFNISVO        NEKWKS         
OKQRKJT         : KKMMXGICHRJLS   HWSYFRMPLW     
RAXTVDHLUKBEPB  : CNFWFFF         FJEENKSOG       NXFSJUDUBJIMMLV JWGDOAH         DVWUXA         
HQYMJ           : YWFNMLKG        LSWOJFCWPXA     BKAOPUKSQWUBHUF NANEP           NYLAYSVEDELSP  
OJBBASLLNI      : SEECYMNPTE      YWFNMLKG        IHMSATE         MBTSDGPOICPHCS  MXIIOEPNQ       GKGQMYJHBN     
NGAL            : PAGOK           OKHFBLHLWVTJFFV KMUOWIJCPBGMQ   HSIXVB          QWUHBOBM       
IAHUBNKE        : WGBTXKABNHCYYDG NVCSDJSDLGWFYDK AUSCBI          NWJBDPYQ        MEDPXYGLFW     
TUNIFAWQB       : GMMCSMSMUY      EJXKSSTWUO      NSIXCDUWSGQDV   BFYNB          
SULEIWKXFNK     : TYIHORO         SHRUTRRJHQLBMJ  YMCRCHGBUK      LMCKTNCNRKGOAX 
XMYSPMFUB       : SEECYMNPTE      HTIAIAD         HCLCJYAMBY      LBRWN           HDOCC          
PQKWQKNSKGPYNAV : QBNMTSSW        EWHOHDXV        BQEYQK         
XBLKTJWUENK     : HDBWBUYO        HWGYWYB         FSDOQAPODWEJKGB DWUQPXDQLC      QISRCWDGUUWP    AQHNIGONP       BFYNB          
KLOAFYXVJ       : BJDATIETOS      GPQO           
QUUGTIGRI       : JLXYJ           KFLOX           GNLAAVV         LDKQA           WQVPWOYTYVSOKA  UVQUORCS       
SWTOIRKPHUCRI   : KMWS            LBNWGBIOCX      ASJW           
TNPTKAIDWDK     : GVWLWMOQOVYRSKA
NSIXCDUWSGQDV   : KXBDSXNRFSYBK   KUXQUNDPI       WLETCSA         YJCYQ           TUNIFAWQB       UWFUFSXVLC     
AXRIOLWEG       : TPWKQNQLFMTL    YWWR            RURE            XOLADJ          PHRDTALNXN     
GOMDTYTJ        : NYMYQQTMQ       SQCB            BJTNBNS         CJWVHWWEYSC     TLMCFJN        
EHWIFVDNMGJ     : AAFNTNVUU       HMUPJ           TOFHSLQ         PREAY           RYWQORJJY      
IHEQXSP         : PITMPCR         CYGKSSKFHKJN    UCELKYDOVIV     PJUXMOYPFFEQCXO
YYLPOOLPLUMRE   : OREKBPPTQLMKH   OLBEH           UCELKYDOVIV     YUNGGWYGOURVLB 
CLIFYVNKKVT     : PVNGCORFJIUT    GTVBSWNUCETMIPU YYPNRPMKORQVIXV UQJGBCGY        CDHV            JOCHHKUP       
NRIFWJHK        : WFKNBJNXLMDBA   TGFC            YBWCJLKDAFQHV   UQJGBCGY        HCLCJYAMBY      FJEENKSOG      
VBMNOJB         : OXUCJPRFDER     LILOXXHA        HHHFTP          FMRVAFQJAJMT   
PNJCXRDTFQF     : RDXHWYUYANG     FTTOAIOJA       HLRYUU         
KWTFHYCS        : IDRKQ           LAHEXPYSEBCV    GUKWPUCPHASB    FHBESADSC      
OTEPISFR        : LBQTVNHFMTJRU   PJPMN           KANKTEBPXDHQA   UVODHWDU        POVXAJCPNLLU    SKGVLVBVHIFHQDC
OHJXLJPREX      : YFHSJFQCHI      YJQDSQP         HHJS           
LCUKVARWEK      : PJFUJNNNLMFKYYO VARDJVNTKHLERXN EPDIHNRIAP      SEVJ            IDQL           
SGILOBSIY       : PANYNAPKBQLTM   BSHR           
RKHGUAXBXIOCD   : EQFQMUJFTJER    KTFWYVYGHCHV   
AESWIFBELMPCPI  : UKAXDVRV        KINFXMRYARGIR   GFAO            XLCFPLWLL      
PREAY           : EHWIFVDNMGJ     LEUDTYV         UUIR           
UBKVYSMDYLFFEDP : GKGPDHEQ        WPTFJ           FXTJVDMFQBUGNUR SOSRFJPTTKWRSTC OQYHIABP        PQMB            CRVODJPX       
GTYS            : OAWGTTUPATQC    IPRVTEEQ        FEQHYHAYCBMVNKE VOXQOCBXWRAB    WGBTXKABNHCYYDG
BJTNBNS         : RQCQIB          YDNYUUHIIMK     QGDU            CIORC           IDKU            DQHXHGSKCUV     GOMDTYTJ        GKGQMYJHBN     
BJTNBNS         : MEAKQODHMDYIN   OVQMUMFLSMF     WPUQPABTDYAV   
NDYOQWQLKVKX    : YIUGEBWOIRIAJ   PAFMJ           JTCLVQHM        NPBFNMD         FJEENKSOG      
RFFIQNCQHORS    : VMCSBXVSBOTUM  
GTYB            : AYSMWALHH       DMIQGIRL        TBPYUJOPHPKTWTE WJRSKESARMESE   RTFEKUUX        XKKCPYOSGIQAMKB
OGXFWVXJIUTGW   : UMNKVJACNBNQCNM GUKWPUCPHASB    WMBKWSCUHLCB   
LEUDTYV         : HSUBFA          DNPMH           WFNJLIVTDBBJNIO PREAY          
NNXYVRXYR       : GKGPDHEQ        VHRTTWXCILNKXB  ULFMRDANJKSVEFG CSNILMR         RXXKIJADDMRHMA  AWXYSIIA       
GPTDNSMVPJ      : YWFNMLKG        KABTR           ALBWBV         
OXQUUVO         : HTPXCFOY        QHQWYAWKXBUMPPS UCXFNIPBQMMBGM  PIBMHY         
RSKIQLGL        : BEARS           ANEBQAD         BLLGX           EPDIHNRIAP     
GFAO            : GTOKC           DWOSU           AAEMFAILSG      AESWIFBELMPCPI  SJTNWVCXC      
TRLOHJES        : PJPMN           XTJQFREQAJS     RXQDRBENJ       NANEP          
SQINNGDJ        : XOLADJ          GSBBLXYGNOLDW  
XTJQFREQAJS     : GCLFGISSK       BXPOESEVINYW    EDUEOCXTJJNK    BONQPCDRHOIN    TRLOHJES        JWGDOAH         JEJD            PQMB           
HNJUESEJL       : ETJNU           RTFEKUUX        KUWQUAFFSLPYDQ  PHNNREK        
EEESRKXDNXXY    : FHYNOLQHG       KLMLXRAV        RLGDTS          LJVAKEQKQWCIIDF ITKIM           FAFPFVR        
FRVYTFR         : UUROMVRLEMIT    SIKMQILXAGTR    REWH            EQMKXOUUM       WDYGVVCAKDRXVGJ
OHWJMPO         : EVFH            YWFNMLKG       
DKCJQW          : ENSKCSJ         JUGLFSASQRTO    OSONPHDDW       GEYRSTUC       
DUGRUGQ         : KISPQ           GNLAAVV        
OKINFNHS        : CIWOOJBDFSDDST  HRWITHLTYAXU    OQYHIABP       
RPOGHDE         : OREKBPPTQLMKH   SFFHXAANRRRDFJ  KONBPIYFSGIJF   YPWAEYTRYXOM   
PIVGGBMDHEYOWL  : LDKQA           DRPQGDXIH       NBJOYM          QWUHBOBM        UJBJAQQCJNDUGGN QBACK          
ITSPHCI         : KTFWYVYGHCHV    GGJP           
TACCJHGXAPT     : BUGHAIDPA       WVXV            DNLVGSGXPCIMUDI BPKNYHUEAEEIK   VWDMCOFFDBIT    JDSV           
XUSBEYAUWLAHFU  : TFNSKAILJYLWLO  DOPBKPQUO      
PXHCTJGW        : MEBFJNYACT      IDRKQ           IUIK            BKSESNJB        KTCTW          
QFSQWOYUJS      : GGUEMC          OWGXM           MPLGIWDF       
PTYLSL          : EPYICTIO        HPPRDTVXDDNG    SOORIEXMVCRJYAB
ASJW            : QBNMTSSW        SWTOIRKPHUCRI  
JGNFPTEKKKFDJ   : IUIK            KVMJ            NNNARGL         FYHHSDLJWHX     PHRDTALNXN     
DFFXEVRFJLQWL   : ENVSADYA        WGBTXKABNHCYYDG SMURGPRIXFA     SIXHPNA         SLDESV          BKAOPUKSQWUBHUF BIYCX           TLMCFJN        
ILURRIX         : INDRKTJ         GHHJHHNJF       TUXIPJBXILPXL  
FEWRODVYWYG     : JIJQNPKQITGVAX  JFNQFERICGRV    VPONRMLXIRTOXT 
WMYORICLHOXQCS  : NTUTOKDIYAFYHS  OAWGTTUPATQC    SFOLHDXFCWELED  OVSJ            DEPJYLXEH      
TEKG            : SDYWPBQQXL      XJIGMA          KKKLA           GNIXCTI         NGAYYACYSKVKE  
PEBEHYFEXNHUAIM : WMVYOXCJXIE     PITMPCR         OTCOPNWHKDLJU   OFMDFWTOXSA    
SOGB            : ETJNU           NSKNUOKGWWY     QYBMG           GGJP           
ETHYEEDP        : OOQQWAG         OAONQOI         YQNIEFHYDDFKFJ 
OFOQLVPTDQH     : LWYMDHLCRUB     LRNPKESW       
LIVADORJRWNLHMS : YGJNUFQC        BELSG           HDBWBUYO        RAYNPUNMLTI    
SIXHPNA         : AUYP            XPVCRGWYX       BTGJLFK         VOXQOCBXWRAB    DFFXEVRFJLQWL  
LSWOJFCWPXA     : TRMWYHSFGDE     HQYMJ           EXQCWKCOKWB    
OREJ            : VHRTTWXCILNKXB  MSSKAUPHKFN     GXQDPQFVHFOJPD  GAEKRHNAKGPUT   OVQMUMFLSMF    
TUXIPJBXILPXL   : HUKYMVJ         MEBFJNYACT      CUKUKEGSHCLIORJ ILURRIX        
JGQBR           : NTUTOKDIYAFYHS  OIFDPYX         GHHJHHNJF       OTCOPNWHKDLJU   QIPGYCQFDVPXR  
FPNFRITJODAI    : HEOUASBTFKMCKY  OOQQWAG         EPFBKGEB        XKKCPYOSGIQAMKB BRKJFWLVYXCNT  
YTQKWRUIHSWB    : JMQSLU          LXKCSMXHD       UCQWCXQVJECXIR 
FUIXSNPJSHTO    : PGVRDOTHUDQGJM  TFNSKAILJYLWLO  GYLVCICXEWRGTI  XGNCNQC        
JUSTVRPODN      : GTOKC           BQICGLLKAWBNT   XOLADJ         
XXQTW           : BTUVJYSWL       NHKVUCWSJWDWLKA HEAT            HCLCJYAMBY      VMCSBXVSBOTUM  
BDOJBKWSVRA     : IDKU            YBUAETDNHPS     JPEICIKO        BQYNAHCDYXRFL  
GSBBLXYGNOLDW   : LLJEOICGLSY     LDKQA           IJUSDXWOLDMBMG  UTSTCVN         SQINNGDJ        KGRNMHSAPJR    
EPFBKGEB        : XKCEH           OWGXM           FPNFRITJODAI    TFIIFMJBYYCARC 
HNOAJ           : SGMLEP          XEKJSBDEVKK     WPUQPABTDYAV    BHFX           
CCPUDSJDSPTJBW  : HQEWXGXYJENVEWA GKVC            ADSOTC          UDLNETYQQOXYYO  VAPYMU         
MDBUFLBLOTTFKV  : KFLFBOSCVKGQSAM KLMLXRAV        LVENN          
TYSJVYEFCYWV    : HSCIOJNSFFUSGIS NLSHTSCRSENBEX  FFJEOHMRFSQ     VEXS            GVWLWMOQOVYRSKA JDSV            HDOCC          
AVTPYUKGILSYHME : TYIHORO         IPUMHELJ        QLIMVQJW        XFYAPLVWFFDEPBH SADJMMJTEEOJ    WMBKWSCUHLCB   
KVMJ            : HFWSKAAEDR      UBIG            JGNFPTEKKKFDJ  
XGNCNQC         : IAGJDK          NCWJOTX         TBPYUJOPHPKTWTE FUIXSNPJSHTO   
OMPMI           : XKCEH           QWOUJNAX        FNCEMIHAF      
MDRSL           : UVTWOIWVLKYOQNT JXDRRYNUPAWJQ   XPAKDQOBLCX    
NNNARGL         : CNFWFFF         AYIHHYUYQSCSLD  YKNSLIYAGSFSK   JGNFPTEKKKFDJ  
UWFUFSXVLC      : THKABC          CTGAWTLKYRDKWIO KOAEODFLKCO     NSIXCDUWSGQDV   FHBESADSC       SHWLAUFDXNUNMKU WFOIDTPV       
BQYNAHCDYXRFL   : RATHJEVBMSDC    ILDPG           ATXRUNK         XXWOCTSNGYOPHNC BDOJBKWSVRA     UISFI          
VOYCCPAYUUHNUDA : ULBIDMOAPUA     FRLNOEFY        QVDEBNPVWSPU    HHJS           
ODQNSQWVVYVPEHW : WFKNBJNXLMDBA   KMWS            LYLEILBPPVSANF  DNLVGSGXPCIMUDI MLWLUGHBRQ      RKFHMRFPG       HHJS           
XYFA            : APYFWUEFEVAVIDC VYLCKBAP        VRJLLOW         XLSQVPBP        PAFMJ           OTCOPNWHKDLJU   WBFGJHWAKIPRWMJ
HCLCJYAMBY      : HSCIOJNSFFUSGIS XMYSPMFUB       NRIFWJHK        XXQTW          
GPQAIQVHPRW     : JMQSLU          UBJW            OVOYQGFR       
BWYA            : XGUDUGEXXA     
EAMNEXP         : IWPYHE          BJDATIETOS      MMIWKXSAYYKG    UCOIVPVGLOWFQ   KHMN           
YRCDRFJJYJSPHA  : EWCNQVEBHFDBHK  BONQPCDRHOIN    XVCSUJYAHW     
YYDDVCDTG       : EPYICTIO        HMUPJ           DRPQGDXIH       BEUJFUDJN       HLRYUU          TQQDHRP        
ITKIM           : JNOUSRODVK      MJORKRFVF       SPXIUSO         GEYRSTUC        EEESRKXDNXXY   
IEFNXKWILHBB    : PUPHIIEIHGRO    MPVPPB          RURE            OAONQOI        
DIQCMVBOYWXGG   : GNIXCTI         UXEAWVOCBHBR    GAEKRHNAKGPUT   ATVYEHLSG      
SOIVYPBONNMV    : DDHEPGWIAJA     XVCSUJYAHW      IUTYFWGVKG     
VWDMCOFFDBIT    : TACCJHGXAPT     KGRNMHSAPJR    
FRLNOEFY        : VOYCCPAYUUHNUDA ERDA           
GOFVDTKB        : ORPOXEYWHDJRT   AHGPY           FHBESADSC      
GBBUD           : BELSG           XMRWG          
BKSESNJB        : URWLDAF         BTGJLFK         PXHCTJGW        BMTOHSANBJG     ITUQ            PHRDTALNXN     
UQXBVXEDOJ      : BNYCCWMAKLPL    GDQWYV          RDVXDSEVNJDW   
TFLVDTWFOCWRNSW : SPUMFLMLKJU     AEBTMNAYRXI    
GGJP            : PHDEKIPWMGEOWYC MIRPWBBJSPB     ITSPHCI         SOGB           
BQEYQK          : JSTQWIKVQOLXF   WJRSKESARMESE   YYPNRPMKORQVIXV BSHR            DQHXHGSKCUV     PQKWQKNSKGPYNAV RAYNPUNMLTI     NGAYYACYSKVKE  
BQEYQK          : IUTYFWGVKG      DPHLVY         
FWFAESXIMWP     : UVTWOIWVLKYOQNT RRNPP           MJYATABGX       CCIAM           KTLRYDSBR      
BMTOHSANBJG     : ETXUHX          TOHMWRPGY       OWXPUHMOFRCUYV  BKSESNJB        XGUDUGEXXA      BFBMBQOVLVQUTJD
MWLONXSUWBWCTU  : AYIHHYUYQSCSLD  SGJJT           AJXLHOT        
JTCLVQHM        : SFFHXAANRRRDFJ  NDYOQWQLKVKX    YTHUWDLXQ       THEIPSXLDKGLW   TPAVOE          PTHFPHDPIVYRXPA
DMOEYWLNV       : PJFUJNNNLMFKYYO JPSOYMITEFFYEP  ADSOTC          IUTYFWGVKG     
CJWVHWWEYSC     : TASLKPLCKLHQE   GOMDTYTJ        UISFI           DVWUXA         
CVPPTI          : HLBICLMLWBXY    YQANASIOOAQP    UXAFMQCOHTF    
HJDVYHUXUJ      : IDKU            UCXFNIPBQMMBGM  UYGSUOOCRFLNI  
TLGTJ           : NSKNUOKGWWY     ACMSN          
QISRCWDGUUWP    : XBLKTJWUENK     THEIPSXLDKGLW   YYCNLJPVCGCK    XGUDUGEXXA     
WYPAUOJSOFEJYR  : MXTTCKOEHCM     IWADBVOAY       XMLUETNWELEE    MDBRVPOMIDYDKU 
UCELKYDOVIV     : ULUEJU          IHEQXSP         YYLPOOLPLUMRE   NEKWKS         
FUJJTKYTHPD     : WIUMSRGMU       HRWITHLTYAXU    IJUSDXWOLDMBMG  GPQO            RPLPOKGIB       RFLEWHHTJD     
GKGQMYJHBN      : KJUGIQEOKU      LBQTVNHFMTJRU   SFOLHDXFCWELED  LLNMKEG         OJBBASLLNI      BJTNBNS        
NPBFNMD         : WINNMFO         BYGMYLLOTOUGY   VWHTGISHK       NDYOQWQLKVKX    DEPJYLXEH       NXEXWRQUYUX    
RXQDRBENJ       : WUODT           CMLLB           OWTDVCLRXCGK    TRLOHJES        VQCDB          
SLDESV          : LUFLBAAMX       DFFXEVRFJLQWL  
RFAU            : UUROMVRLEMIT    LVNOPTYBBJNNDS  PVMYNA          CSKYFDSBJSOOFUD OVQMUMFLSMF    
XKKCPYOSGIQAMKB : HMUPJ           XKOD            GTYB            FPNFRITJODAI    DDKWG          
AMRTBUAVQSPXUK  : JXWFNFYEWG      ETSTTEFJVAENQI  QPQLPJURBMMQ    OIFDPYX        
TUEXLFM         : CBKIQHTHJSAFKAW NUIGKC          CSKYFDSBJSOOFUD
LWXNL           : LBJDMXDQYXRWW   MDBTTQOQD       HCWFD           VUYWDG          XMARJQJLKIJHR  
RFLEWHHTJD      : FGDX            AUYP            IQKY            XSSXE           FUJJTKYTHPD     YMBMIM          EJQEMQXCHWRFU  
CSKYFDSBJSOOFUD : SLOUHECIFFEMR   SPSQXWWVMSYJRKD LAHEXPYSEBCV    RFAU            TUEXLFM        
UQQIK           : FYDNGDGGFVMIBVV YBWCJLKDAFQHV  
VPUDYQ          : FQLN            WPTFJ           PBYMVVQK        HWSYFRMPLW      QNEQCUBWBFVDA  
DDQXPPETLH      : KHMN           
EVWMSCTQUKYG    : WMVYOXCJXIE     EPVRHLN         GDQWYV          MEAKQODHMDYIN  
UXEAWVOCBHBR    : WINNMFO         TENBE           DIQCMVBOYWXGG  
HNKOSRMPG       : HPCMCSVPC       QWUHBOBM       
RAXNMWV         : RPHROSEF        MKHHNXVLGO      OTCOPNWHKDLJU  
TTDVQ           : DBAWHKX         BSHR           
KTCTW           : TASLKPLCKLHQE   PXHCTJGW        LHNEKAKFOAMJ   
TEHGSDAFUI      : MRBUMEUNKA      LBJDMXDQYXRWW   XLCFPLWLL       LBRWN          
NINDV           : KMUOWIJCPBGMQ   SDJOMN          XJDHUEWGVG     
YTHUWDLXQ       : YJCYQ           JTCLVQHM        VPONRMLXIRTOXT  KSEEVASSUJAXRY  YFWDUEO        
BKEUEIFLB       : MXIIOEPNQ       XVDWNAIECYKSCN  GHHJHHNJF       TGVVHTGBOHVCWPS IIMCNCJVFCFU   
NIDWXS          : IJUSDXWOLDMBMG  SJGWIUAVNPGQ    JYRCHTWKGQQTS  
LXDXYAFTWJ      : BYGMYLLOTOUGY  
VAPYMU          : HTIAIAD         CCPUDSJDSPTJBW  BFYNB          
RFBFHLURRR      : TPWKQNQLFMTL    KHLFRUXEXEEVJ   FCRGSFOWN      
MADNFCOFHLFS    : OMGSXSU         VSSU            KTPHPBMEUS      CLUDHKLRJLUF   
BULCIIX         : IMIMGLMOKN      DBEWKQUMCDBRML  AYIHHYUYQSCSLD  OAKHBL         
OCJXPERHWKWYNME : FJXFWIHFYWIX    DRPQGDXIH       SJGWIUAVNPGQ   
BKAOPUKSQWUBHUF : HQYMJ           DFFXEVRFJLQWL  
WQVPWOYTYVSOKA  : PRADRFXEAK      QUUGTIGRI       UCXFNIPBQMMBGM 
OMHDCCQWUNTXWQF : ULBIDMOAPUA     TXPIRGGJHV      AEBTMNAYRXI    
OVRGTIFPJELY    : UCQWCXQVJECXIR  QMGC           
LGDXNJ          : RXXKIJADDMRHMA  JOCHHKUP       
RAYNPUNMLTI     : XSFKN           LIVADORJRWNLHMS BQEYQK          NGEXA           VQCDB          
PDIJLQCV        : CDCKUUHHETP     PQROQ           PSBJJA         
NWJBDPYQ        : JJTOCCVN        BXPVCADL        IAHUBNKE       
BIYCX           : LYPTGCBPYPSVU   KICNLGYP        DFFXEVRFJLQWL   UULGIIQEJE     
YMBMIM          : LBJDMXDQYXRWW   VOXQOCBXWRAB    XGVBGUTGVK      RFLEWHHTJD      CUSEHOTRMM      MKLCAXKKWN      UULGIIQEJE     
XPAKDQOBLCX     : MDRSL          
DBNET           : ILDPG           JDSV           
HFLLDCKRFWCTO   : MSYVWBFWMCW     JMQSLU          WVXV            RRNPP           OSONPHDDW       MCWH            UWTMMGOSHKRFS  
LRNPKESW        : YGSUPMOKJOOT    HEOUASBTFKMCKY  TIWEONRFMVPUY   UHJQQY          OFOQLVPTDQH    
RWLUKPPWWUKKAO  : FJNKUWXE       
UTTWQLACDPR     : GYYDL           AOJD            PYCO           
TLMCFJN         : EDUEOCXTJJNK    QNJSWYPWKOC     KICNLGYP        GOMDTYTJ        DFFXEVRFJLQWL   YJNABKQNRQVM   
VFRUEMHOPVJ     : WORACSR         CWDWTN          SKGVLVBVHIFHQDC
SGJJT           : SLFCAGSUNHYLDCY JXBNUMBPE       LXUYDSNW        MWLONXSUWBWCTU  PSYNBSLAEULEX  
LWEGMYTCDYNRBK  : KJUGIQEOKU      RNOVTCPQVQGB    LWYMDHLCRUB     IUTYFWGVKG     
THEIPSXLDKGLW   : SGXW            QAEWJAVCYKJROET JTCLVQHM        QISRCWDGUUWP    KTPHPBMEUS      LMCKTNCNRKGOAX  JDSV           
FJEENKSOG       : GXQDPQFVHFOJPD  RAXTVDHLUKBEPB  NRIFWJHK        NDYOQWQLKVKX    CWDWTN         
SFLM            : DWXBCXK         OSONPHDDW       FIJUHDTWEX     
XLCFPLWLL       : WDUXCMMVHUDQFE  MRLRKDMDXE      EWCNQVEBHFDBHK  AESWIFBELMPCPI  TEHGSDAFUI     
QYRCXKJHQNWBGOJ : NYMYQQTMQ       HSUBFA          NHURG           VPIIVXDTSUPABH 
JORXWRLCYEPWPDI : BQICGLLKAWBNT   AQTMN           VSAPXS          OVQMUMFLSMF    
CCIAM           : FWFAESXIMWP     CRTGXQCQNXG    
JDHJGPAPVJGNH   : INLDBMLFBC      LHNEKAKFOAMJ    UUIR            FRIN           
HUIHYAGOD       : JECHND          XSLPHJXUTKSDW   RLQMYYFARKV    
UISFI           : LEOQBG          UVODHWDU        NVCSDJSDLGWFYDK BQYNAHCDYXRFL   CJWVHWWEYSC     TQQDHRP         UXWPV          
YUNGGWYGOURVLB  : TUGHMDQSI       YYLPOOLPLUMRE   XGUDUGEXXA     
SVOCV           : FHLEDJHMPXYSXFG IFYYTE         
IKRBGA          : SEECYMNPTE      BSHR            RUFFGALCNK     
NLFNISVO        : LEOQBG          VXUMHHIIPKPA    DWUQPXDQLC     
UWHS            : AHGPY           KLJVFGN         AYIHHYUYQSCSLD 
DEPJYLXEH       : VARDJVNTKHLERXN LTUA            WMYORICLHOXQCS  NPBFNMD         HLRYUU         
OSGQBJLQWSEFL   : ETXUHX          VSXGBDFNNGQQY   SBTBBALLTOQ     ARNHLSPGV      
VEXS            : IHVDTT          LXUYDSNW        TYSJVYEFCYWV    OVOYQGFR        FYHHSDLJWHX    
QHQWYAWKXBUMPPS : TFBBLQWWIUCPB   OXQUUVO        
SEVJ            : TUGHMDQSI       EVFH            QJVAVHQGAINTXJY LCUKVARWEK      NPSQC          
OOIBRGHRYS      : OTCOPNWHKDLJU  
ILIJLHULKRXDH   : YIFS            IDTW           
LAAIJ           : IPUMHELJ       
WAMATSH         : JIJQNPKQITGVAX  ADAXESSJL       EALWEANEEWBWC  
UCXFNIPBQMMBGM  : OXQUUVO         HJDVYHUXUJ      WQVPWOYTYVSOKA 
NIQPKYBN        : PJFUJNNNLMFKYYO PWGCKYLCDV     
CAYXVIKS        : IAGJDK          AJXLHOT         QRYG           
KABTR           : BEARS           EDYVPRUBXOFTRP  HTIAIAD         HCWFD           GPTDNSMVPJ      MEOWRIFAXNCKU  
KGRNMHSAPJR     : CFWPRREQCPTR    KTFWYVYGHCHV    DNLVGSGXPCIMUDI GSBBLXYGNOLDW   VWDMCOFFDBIT   
KTNKXQJVOSHJG   : IHDJNMRNOVYUMAP OWGXM           QWUHBOBM       
LHNEKAKFOAMJ    : IPUMHELJ        KTCTW           JDHJGPAPVJGNH   UVQUORCS       
CUSEHOTRMM      : DBAWHKX         YMBMIM         
IDWRMDMYM       : PMIDOE          JOALHDINKJVNYYN FANQ            DNPMH           YNVUFMLXAYXKSRB
FAFPFVR         : GWBAGFE         EEESRKXDNXXY    CWDWTN          XRPXRBBIROVMFPF
FSVANAHEVBQJ    : XEKJSBDEVKK     UYKHNKSWNCN     JXBNUMBPE       MPVPPB          CDHV            SFFHXAANRRRDFJ 
YMCRCHGBUK      : PQROQ           YMJVX           SULEIWKXFNK    
UPAALST         : GNWKQXDA       
LPSBPCF         : KFLOX           BUSQ            UVQUORCS       
GVWLWMOQOVYRSKA : SFOLHDXFCWELED  RRIKICIUBTY     TNPTKAIDWDK     TYSJVYEFCYWV   
AAPOS           : OTCOPNWHKDLJU  
HEBDHQHOH       : MSYVWBFWMCW     MDBTTQOQD       ARNHLSPGV       UDLNETYQQOXYYO  BHFX           
MEAKQODHMDYIN   : BJTNBNS         EVWMSCTQUKYG    MHCRYDQGMJURXA  MEOWRIFAXNCKU   RBNJHG         
XPAOESAMACRH    : JMQSLU          LCJBE          
YYCNLJPVCGCK    : QISRCWDGUUWP   
FLBSLCILSPGSC   : WINNMFO         MSYVWBFWMCW     UDLNETYQQOXYYO  YQNIEFHYDDFKFJ 
WTQUUPWIBIX     : RNOVTCPQVQGB    JJTOCCVN       
NGEXA           : RAYNPUNMLTI     NPSQC           XRXGSN         
LDEWFMK         : YTATKTOYNXKEQ   GWBAGFE         QFCVEMHVDORJB   LENTA           FFUSAIUV       
CRTGXQCQNXG     : LBAG            MENW            CCIAM          
IKVJMJPQJRA     : PAGOK           TXPIRGGJHV      BONQPCDRHOIN   
XGUDUGEXXA      : QJVAVHQGAINTXJY BWYA            BMTOHSANBJG     QISRCWDGUUWP    YUNGGWYGOURVLB 
XSLPHJXUTKSDW   : JUGLFSASQRTO    HUIHYAGOD       KTPHPBMEUS     
VPONRMLXIRTOXT  : YGJNUFQC        OWTDVCLRXCGK    FEWRODVYWYG     YTHUWDLXQ       EALWEANEEWBWC   RKFHMRFPG      
ACMSN           : JUGLFSASQRTO    DBAWHKX         HEUAQHBRR       SEIMUHGIY       TLGTJ          
CWDWTN          : CTGAWTLKYRDKWIO YXVHSISBQSMEF   VFRUEMHOPVJ     FJEENKSOG       FAFPFVR        
YNVUFMLXAYXKSRB : YJCYQ           IDWRMDMYM      
NPSQC           : GMMCSMSMUY      IMIMGLMOKN      SEVJ            NGEXA           NHURG          
EJQEMQXCHWRFU   : THVYOXOBN       RFLEWHHTJD      ERDA           
TGVVHTGBOHVCWPS : PKFWBEAUSHRDWFP BKEUEIFLB       UPLVQMXSHIORNX 
EALWEANEEWBWC   : KKKLA           DCMOQ           WAMATSH         VPONRMLXIRTOXT  JQVFMLUKS      
UYGSUOOCRFLNI   : OKHFBLHLWVTJFFV GCLFGISSK       MSSKAUPHKFN     VRJLLOW         HJDVYHUXUJ     
FDNLDBJJD       : TIWEONRFMVPUY   UXAFMQCOHTF    
NHURG           : IWMYFIOD        QYRCXKJHQNWBGOJ NPSQC          
PBXWVT          : FYDNGDGGFVMIBVV
NXFSJUDUBJIMMLV : UMJMAM          EJXKSSTWUO      OMGSXSU         RAXTVDHLUKBEPB  RYWQORJJY      
OVOYQGFR        : PFYMCVOFXY      KLJVFGN         FOHVTINQWWC     GPQAIQVHPRW     VEXS            LYCIH          
JQVFMLUKS       : HLEAQPKNJO      EPYICTIO        TOFHSLQ         EALWEANEEWBWC  
TNRPQBAGQ       : SPUMFLMLKJU     HRWITHLTYAXU    UHJQQY         
ERDA            : XBQVBJ          QXUKWT          FRLNOEFY        EJQEMQXCHWRFU   PYRFIXVOUNTJRGM
CSNILMR         : UUWUBNVVIFGTRSR NYFRDUGTV       NNXYVRXYR      
KYQXUD          : WLJKNJQRDBAEQYN DLKJLBFYHLRIF   WFNJLIVTDBBJNIO FEHVKTIB        CVWHKXSMW      
JWGDOAH         : VYHHBM          PJPMN           EMPWKDBAEMLTCW  RAXTVDHLUKBEPB  XTJQFREQAJS    
GAEKRHNAKGPUT   : OREJ            DIQCMVBOYWXGG   JLWMDIESJ      
OAONQOI         : HPCMCSVPC       ETHYEEDP        IEFNXKWILHBB    PGOFHXPVUXV    
FTTOAIOJA       : PVNGCORFJIUT    HLEAQPKNJO      JAVGKLREIX      PNJCXRDTFQF    
JEJD            : EPVRHLN         LLRCFVD         XTJQFREQAJS    
WDYGVVCAKDRXVGJ : EVFH            SJJIIXLNKC      SQCB            FRVYTFR         QILOTQKOEAFX   
OFMDFWTOXSA     : SQCB            PEBEHYFEXNHUAIM TPAVOE         
CDSCJTKH        : XSFKN           VWAN           
MHCRYDQGMJURXA  : UYKHNKSWNCN     KLMLXRAV        OQTEGYWTDPGPO   MEAKQODHMDYIN  
UVQUORCS        : QUUGTIGRI       LHNEKAKFOAMJ    LPSBPCF         CINKAQAJDMT     HDOCC          
UUIR            : FMRVAFQJAJMT    OQSQ            PREAY           JDHJGPAPVJGNH  
PJUXMOYPFFEQCXO : MUJDOLJXGVAGB   MXIIOEPNQ       PRADRFXEAK      DHWJLRNC        UCQWCXQVJECXIR  UMDWUWCNHWIJ    IHEQXSP        
XMARJQJLKIJHR   : RLKQMJBFRVJKP   DOPBKPQUO       IEGUNTBWW       XMLUETNWELEE    LWXNL          
PJMMHBBH        : KMUOWIJCPBGMQ   RPHROSEF       
JOWATVRXVEYNNRW : DEEOLOYDPQGUK   XSSXE           VPJGD          
CINKAQAJDMT     : GGUEMC          LJKQVHDYVOKVWGW PLXUXIGVLAO     AHGPY           UVQUORCS       
PDXBTVCNRV      : MDBRVPOMIDYDKU  DPHLVY         
NANEP           : HWSYFRMPLW      VKJWOPUMX       HQYMJ           TRLOHJES        RKFHMRFPG      
BRKJFWLVYXCNT   : MQBNJUP         DWNN            FPNFRITJODAI    MGOSW          
FYHHSDLJWHX     : NQSAE           BXPOESEVINYW    NRBXJKMFMHJXB   JGNFPTEKKKFDJ   VEXS           
HLRYUU          : NIYQWGCTFXF     VDTXFKXK        GRCCL           KHWJEYKIHBMROR  PHNNREK         PVMYNA          PNJCXRDTFQF     YYDDVCDTG      
HLRYUU          : DEPJYLXEH      
FHBESADSC       : LLNCGPLD        NVGHCMTMIMJCOS  VJOY            KWTFHYCS        UWFUFSXVLC      GOFVDTKB       
MLWLUGHBRQ      : QTHEYJRLUIPWBSF SWACTG          JOXG            ODQNSQWVVYVPEHW
YQNIEFHYDDFKFJ  : VJOY            HTPXCFOY        ETHYEEDP        FLBSLCILSPGSC  
FPYJILUHARNJ    : CBKIQHTHJSAFKAW PUPHIIEIHGRO   
FCRGSFOWN       : JIJQNPKQITGVAX  FDKYJREJ        MXHCK           RFBFHLURRR      OQYHIABP       
VQCDB           : GBNXHKHJWHIHWF  WWOTTMQRE       WLGQQ           RXQDRBENJ       RAYNPUNMLTI     EXQCWKCOKWB    
PGOFHXPVUXV     : BWWKX           LTUA            BPKNYHUEAEEIK   QBACK           OAONQOI        
LHGTJXACGPYVQ   : JECHND          XFYAPLVWFFDEPBH RMIPDGEBVVTLJ  
OSBPD           : ETSTTEFJVAENQI  UQJGBCGY        IPTGPSMFWBH    
XRXGSN          : IXFIWHQRQFP     UMDWUWCNHWIJ    ONFBS           NGEXA           CLUDHKLRJLUF   
NLABXHIT        : SLFCAGSUNHYLDCY OMSWRJES        BELSG          
ITUQ            : GYYDL           BKSESNJB        YIIJBKRFRNRN   
VMCSBXVSBOTUM   : ISMWKOAEGXG     RFFIQNCQHORS    XXQTW          
NBGCMG          : HUKYMVJ        
MPLGIWDF        : HPUCUCPTAE      YWWR            QFSQWOYUJS      AQHNIGONP       TFIIFMJBYYCARC 
OBBRVEPU        : FYDNGDGGFVMIBVV GUGICOWYDC     
SJTNWVCXC       : QQTNT           FMRVAFQJAJMT    PBYMVVQK        GFAO           
MKLCAXKKWN      : GRQRHYDLBV      YWFNMLKG        CMLLB           YMBMIM          TCUSRTYVFAKHEGS
KDSNW           : JXWFNFYEWG      YXVHSISBQSMEF   BYGMYLLOTOUGY   DHWJLRNC       
SMJSFVOUSMY     : TXPIRGGJHV      OVSJ            FNCEMIHAF      
OFHB            : FQLN            FMXAEHM         QXUKWT          FOHVTINQWWC     ALBWBV         
LBRWN           : HTPXCFOY        FHLEDJHMPXYSXFG XMYSPMFUB       TEHGSDAFUI     
MDBRVPOMIDYDKU  : WYPAUOJSOFEJYR  PDXBTVCNRV     
GPGFIWNPX       : PLSSVJELF       DMIQGIRL        QNMASJFEWORY    RPLPOKGIB       LGQSUCVORTHQLD  CVWHKXSMW      
EBYBOPP         : KKSPCR          BELSG           LHUBHERFVM      OAKHBL         
QIPGYCQFDVPXR   : TYCAFLJAGOAF    TUYLWIIVUO      JGQBR           XYRILUKTBLJHVGU
NXEXWRQUYUX     : FEQHYHAYCBMVNKE MXHCK           THVYOXOBN       NPBFNMD         AEBTMNAYRXI    
XORNIKXATXF     : LYPTGCBPYPSVU   XMLUETNWELEE   
FIJUHDTWEX      : JDOIOLWFMKMXHH  OAWGTTUPATQC    LWGPF           SFLM           
BROYSJYUHOMWWWV : MENW            RPHROSEF        YMJVX          
QVDEBNPVWSPU    : HRWITHLTYAXU    HSUBFA          GLHRMUKFOJDDN   LLRCFVD         THVYOXOBN       VOYCCPAYUUHNUDA TQQDHRP        
PSBJJA          : PDIJLQCV       
SYWCPLYPJUPCSU  : OMSWRJES        MJORKRFVF       JLLNPMAKOPWIOYU DPHLVY         
TIVSGRKDQBXRM   : TFBBLQWWIUCPB  
TPAVOE          : OVSJ            JTCLVQHM        OFMDFWTOXSA     KMGGSXAI       
BFBMBQOVLVQUTJD : JWHDHTRXDDYDMSX WOJJKVVI        LTUA            BMTOHSANBJG     ALBWBV         
TGFWEYKLTA      : GSDFMWXOP       MRBUMEUNKA      BMTEXK          SQCB            NLSHTSCRSENBEX  TBEUAGSNJ       LYPTGCBPYPSVU  
PQTDRYFGCXV     : NWNXQXTWUT      HLEAQPKNJO      BPKNYHUEAEEIK  
KTPHPBMEUS      : PJNPYCHQQRHLKDT MADNFCOFHLFS    THEIPSXLDKGLW   XSLPHJXUTKSDW   DDKWG          
SYKFMGHC        : DHFXLTPMGH      RURE            SQCB            MLEKKBBMW       OOQQWAG        
XVCSUJYAHW      : NIHSQPRW        IITJMYR         YRCDRFJJYJSPHA  SOIVYPBONNMV   
TQQDHRP         : KKSPCR          XPVCRGWYX       TYCAFLJAGOAF    YYDDVCDTG       UISFI           QVDEBNPVWSPU   
OKYHLLOXSVA     : PSMBXNJAG       OMSWRJES        BJDATIETOS      WKQVMQN        
UXWPV           : YIUGEBWOIRIAJ   RPHROSEF        RMIPDGEBVVTLJ   UISFI          
OVQMUMFLSMF     : UMNKVJACNBNQCNM PRADRFXEAK      HLOJKPGKFI      BUSQ            AUSCBI          BJTNBNS         OREJ            RFAU           
OVQMUMFLSMF     : JORXWRLCYEPWPDI
ATVYEHLSG       : DIQCMVBOYWXGG   POVXAJCPNLLU   
PIBMHY          : SGXW            QWUHBOBM        FSDOQAPODWEJKGB OXQUUVO        
DHSYAHVNNJGCOQD : NTUTOKDIYAFYHS  UUROMVRLEMIT    ISMWKOAEGXG     QNEQCUBWBFVDA   AWXYSIIA       
MEOWRIFAXNCKU   : KABTR           MEAKQODHMDYIN   IDTW           
OAKHBL          : IMIMGLMOKN      VWAN            MMIWKXSAYYKG    DNLVGSGXPCIMUDI BULCIIX         EBYBOPP         PQMB           
WBFGJHWAKIPRWMJ : BCIXOHMVAHY     JUGLFSASQRTO    LXUYDSNW        XYFA           
RKFHMRFPG       : UMJMAM          KGLI            ODQNSQWVVYVPEHW VPONRMLXIRTOXT  NANEP          
AQHNIGONP       : KTFWYVYGHCHV    XBLKTJWUENK     MPLGIWDF        HSJMDFSDLBPTI  
WMBKWSCUHLCB    : FQLN            NYMYQQTMQ       PRADRFXEAK      OGXFWVXJIUTGW   AVTPYUKGILSYHME QILOTQKOEAFX   
IIMCNCJVFCFU    : AAFNTNVUU       LAXEH           HQEWXGXYJENVEWA BKEUEIFLB      
NKADKWS         : MXIIOEPNQ       STANEWRSMLBYI   JFXCSSLVCN     
HPGJKN          : YGSUPMOKJOOT    RNOVTCPQVQGB    YQANASIOOAQP   
POVXAJCPNLLU    : DUHRGWORHROPEC  MCXJBKUV        LXKCSMXHD       OTEPISFR        ATVYEHLSG      
SQAHDAKP        : DEEOLOYDPQGUK   HTPXCFOY       
FEHVKTIB        : TASLKPLCKLHQE   DBEWKQUMCDBRML  FJNKUWXE        KYQXUD         
XRPXRBBIROVMFPF : IBPW            EPVRHLN         EUUGQUC         NGCQC           FAFPFVR        
YIIJBKRFRNRN    : YXYAIUJ         PHDEKIPWMGEOWYC HYJAFKIMDXVB    FFJEOHMRFSQ     ITUQ           
SHWLAUFDXNUNMKU : DBAWHKX         UWFUFSXVLC     
RCBDMMEWEJRT    : HFWSKAAEDR      KRMTKJXTO      
FSWPPKPMPULGQB  : EGCGXQIVYF      JWHDHTRXDDYDMSX WDVMKVTRBALI    IBPW            WMVYOXCJXIE     DNPMH          
DVWUXA          : RAXTVDHLUKBEPB  CJWVHWWEYSC    
LMCKTNCNRKGOAX  : YTATKTOYNXKEQ   JFXCSSLVCN      SULEIWKXFNK     THEIPSXLDKGLW   TMDEN          
RLQMYYFARKV     : APYFWUEFEVAVIDC GJHRO           MIRPWBBJSPB     WUODT           HUIHYAGOD      
GVOGJELUABYPSJ  : VXUMHHIIPKPA    AFSWQJOXBBR     CJJP            OHGDKYJVQNWWY   XMLUETNWELEE   
JLWMDIESJ       : AQTMN           AFSWQJOXBBR     GAEKRHNAKGPUT   KHMN            PHRDTALNXN     
AJXLHOT         : MUJDOLJXGVAGB   BMEUMIUFEEJH    YKNSLIYAGSFSK   MWLONXSUWBWCTU  CAYXVIKS       
GCNMNKMRKCMVBWI : LJKQVHDYVOKVWGW GBNXHKHJWHIHWF  SKGVLVBVHIFHQDC DORXMLKYR       DPHLVY         
JNJPITVJ        : UJBJAQQCJNDUGGN
VUNMQRS         : OAWGTTUPATQC    TGFC            UYKHNKSWNCN     SDJOMN         
HHJS            : SCABGD          UXKLHUTL        SKCT            OHJXLJPREX      VOYCCPAYUUHNUDA ODQNSQWVVYVPEHW
BFYNB           : PGVRDOTHUDQGJM  FOHVTINQWWC     IFYYTE          TUNIFAWQB       XBLKTJWUENK     VAPYMU         
MLDYA           : HRWITHLTYAXU    LBAQYFXSLGFIQ   IUKJIFEJGLICK   MKQXNKVQNRCEAAA
QILOTQKOEAFX    : WQIODLFMPRHGITE YJCYQ           WDYGVVCAKDRXVGJ WMBKWSCUHLCB   
BIDKDYNIA       : CMIGT           FDKYJREJ        VOUCV           VWAN            GEYRSTUC       
JDSV            : IAGJDK          KUWQUAFFSLPYDQ  TACCJHGXAPT     TYSJVYEFCYWV    DBNET           THEIPSXLDKGLW  
RXXKIJADDMRHMA  : GJHRO           BJDATIETOS      NNXYVRXYR       LGDXNJ         
IDQL            : LCWSAEDHHLGVYJ  SADJMMJTEEOJ    FXTJVDMFQBUGNUR LCUKVARWEK     
TMDEN           : QJVAVHQGAINTXJY LMCKTNCNRKGOAX 
PSYNBSLAEULEX   : IYCWIMNGT       WLJKNJQRDBAEQYN FXTJVDMFQBUGNUR PUOTCGXMONHW    SGJJT          
QRYG            : IJUSDXWOLDMBMG  RURE            XFYAPLVWFFDEPBH ISMWKOAEGXG     CAYXVIKS       
HOWACMVORA      : NIVHOAKXPSMYGKG
YPWAEYTRYXOM    : YXYAIUJ         INLDBMLFBC      EPYICTIO        NPJXJKQXUGJYTWI UVODHWDU        RPOGHDE        
MCWH            : VUCQKAROL       HFLLDCKRFWCTO  
DBITBKVPGN      : XGVBGUTGVK     
GRJXPJEODWP     : SDYWPBQQXL      TFNSKAILJYLWLO  QXUKWT          PAFMJ          
LCJBE           : AOJD            EUUGQUC         XPAOESAMACRH    KSEEVASSUJAXRY 
KHMN            : VOUCV           LXUYDSNW        VINGXTGTUPB     EAMNEXP         DDQXPPETLH      JLWMDIESJ      
JOCHHKUP        : SFCOOCMKPW      NVGHCMTMIMJCOS  HEUAQHBRR       NRDAQ           GHHJHHNJF       CLIFYVNKKVT     LGDXNJ         
PYRFIXVOUNTJRGM : PSMBXNJAG       DHFXLTPMGH      ERDA           
PWGCKYLCDV      : FYDNGDGGFVMIBVV SEIMUHGIY       NIQPKYBN       
OQYHIABP        : UBKVYSMDYLFFEDP OKINFNHS        FCRGSFOWN      
ALBWBV          : QAEWJAVCYKJROET GPTDNSMVPJ      OFHB            BFBMBQOVLVQUTJD
TCUSRTYVFAKHEGS : IHDJNMRNOVYUMAP STANEWRSMLBYI   MKLCAXKKWN      UJXNSQTGSCXGMX 
YTEITGXEIMGF    : JWHDHTRXDDYDMSX
EOJILCCGE       : PFYMCVOFXY      BETBNEDTGQBOB   PDKRQNTIOPA     CIORC           RNOVTCPQVQGB    LAXEH          
NEKWKS          : PVNGCORFJIUT    HRWITHLTYAXU    WKQVMQN         VAWLKPYJCOMBQGK DWUQPXDQLC      UCELKYDOVIV     IDTW           
HSJMDFSDLBPTI   : DDHEPGWIAJA     EPDIHNRIAP      AQHNIGONP       WPUQPABTDYAV   
XYRILUKTBLJHVGU : AQTMN           PLFSKPJ         SYUKDACLPNB     QIPGYCQFDVPXR   PTHFPHDPIVYRXPA
XCKHO           : LBAG            ETJNU           UPLVQMXSHIORNX 
OJSAMLWV        : MKHHNXVLGO     
UULGIIQEJE      : TRWGLNFA        VRJLLOW         YOMJHIP         IUKJIFEJGLICK   TENBE           BIYCX           YMBMIM         
TDTOURQHBGWRR   : IHVDTT          PJPMN           SFOLHDXFCWELED 
SFFPBBMXNUJXO   : XSFKN           WGBTXKABNHCYYDG XFYAPLVWFFDEPBH
KSEEVASSUJAXRY  : DEEOLOYDPQGUK   YTHUWDLXQ       LCJBE          
KTLRYDSBR       : MSSKAUPHKFN     FWFAESXIMWP    
QNEQCUBWBFVDA   : QOXOKTA         VPUDYQ          DHSYAHVNNJGCOQD
XMRWG           : LEOQBG          TGFC            PITMPCR         SEIMUHGIY       MLEKKBBMW       XJDHUEWGVG      GBBUD          
PQMB            : LJKQVHDYVOKVWGW UBKVYSMDYLFFEDP XTJQFREQAJS     OAKHBL         
MEDPXYGLFW      : KHLFRUXEXEEVJ   IAHUBNKE       
CBNDILHJAHVRECL : SCABGD          SDYWPBQQXL     
VXWGMDMCCNK     : GHHJHHNJF      
SKGVLVBVHIFHQDC : GTVBSWNUCETMIPU OTEPISFR        VFRUEMHOPVJ     GCNMNKMRKCMVBWI
IPTGPSMFWBH     : SKCT            EMPWKDBAEMLTCW  GLHRMUKFOJDDN   KANKTEBPXDHQA   HDBWBUYO        OSBPD          
OUQKHWIU        : GWOGYEHOWMEJW   WKQVMQN         VWHTGISHK      
JQCUWMNC        : JXWFNFYEWG      RLGDTS          XVDWNAIECYKSCN 
KMGGSXAI        : RWWA            QMGC            TPAVOE         
YJNABKQNRQVM    : SCABGD          UBJW            TLMCFJN         DPHLVY         
HDOCC           : FANQ            XMYSPMFUB       TYSJVYEFCYWV    UVQUORCS        CMJRMKCGATWXI  
PHRDTALNXN      : NUIGKC          NVCSDJSDLGWFYDK VSSU            AXRIOLWEG       JGNFPTEKKKFDJ   BKSESNJB        JLWMDIESJ      
CMJRMKCGATWXI   : HEOMRTYVXFTNWUQ HDOCC          
GNWKQXDA        : ULBIDMOAPUA     HDBWBUYO        NIVHOAKXPSMYGKG UXAFMQCOHTF     UPAALST        
GTRTJQI         : FNFBNM          HEOUASBTFKMCKY 
UWTMMGOSHKRFS   : SQCB            NIVHOAKXPSMYGKG HFLLDCKRFWCTO  
NGAYYACYSKVKE   : OCAQCGGXVC      LNEXNUNGGSYQIIM GEYRSTUC        TEKG            BQEYQK         
DORXMLKYR       : VYRYJREIGW      ESXFHTVTXUVJJ   GCNMNKMRKCMVBWI
RBNJHG          : CUKUKEGSHCLIORJ MEAKQODHMDYIN  
UPLVQMXSHIORNX  : FNFBNM          UTSTCVN         CDHV            SOORIEXMVCRJYAB TGVVHTGBOHVCWPS XCKHO          
CRVODJPX        : LWGPF           UBKVYSMDYLFFEDP
JBYSIHHGWUCOH   : OCAQCGGXVC      YXYAIUJ         FGWNBUFRWFP     OTCOPNWHKDLJU  
HOLXJBXHGQDWVMN : GSDFMWXOP       PVNGCORFJIUT    EPDIHNRIAP     
AWXYSIIA        : INLDBMLFBC      WJRSKESARMESE   NNXYVRXYR       DHSYAHVNNJGCOQD
IUTYFWGVKG      : HUKYMVJ         SOIVYPBONNMV    BQEYQK          DMOEYWLNV       LWEGMYTCDYNRBK 
MGOSW           : NIHSQPRW        QFCVEMHVDORJB   RMIPDGEBVVTLJ   BRKJFWLVYXCNT  
PTHFPHDPIVYRXPA : BWWKX           QNMASJFEWORY    SPXIUSO         JTCLVQHM        XYRILUKTBLJHVGU
LYCIH           : SCABGD          TCTMMXS         OVOYQGFR       
VPIIVXDTSUPABH  : IFIRS           HIKUNEHJOQPXYC  QYRCXKJHQNWBGOJ
EXQCWKCOKWB     : LENTA           LWGPF           LSWOJFCWPXA     VQCDB          
CLUDHKLRJLUF    : ULBIDMOAPUA     UMNKVJACNBNQCNM IDKU            HPPRDTVXDDNG    MADNFCOFHLFS    XRXGSN         
QUHTERACKCBVE   : KWMNCXCRHXVO   
IDTW            : NYMYQQTMQ       BXPOESEVINYW    CUKUKEGSHCLIORJ UXAFMQCOHTF     ILIJLHULKRXDH   MEOWRIFAXNCKU   NEKWKS         
FRIN            : SJGWIUAVNPGQ    ATXRUNK         XOLADJ          JDHJGPAPVJGNH  
WFOIDTPV        : BNYCCWMAKLPL    UWFUFSXVLC      UJXNSQTGSCXGMX 
WPUQPABTDYAV    : KGLI            KFLFBOSCVKGQSAM BJTNBNS         HNOAJ           HSJMDFSDLBPTI  
DPHLVY          : EVPQBBQBIPL     ANMJRESTXDJXWDA NFHDIUXLGWI     BQEYQK          PDXBTVCNRV      SYWCPLYPJUPCSU  GCNMNKMRKCMVBWI YJNABKQNRQVM   
LGQSUCVORTHQLD  : IHMSATE         NYHNNP          GPGFIWNPX      
DDKWG           : XIDG            XKKCPYOSGIQAMKB KTPHPBMEUS     
YFWDUEO         : IQKY            STANEWRSMLBYI   YTHUWDLXQ      
FKEMEXJGVBAQ    : JDOIOLWFMKMXHH  UCQWCXQVJECXIR 
QELAIQMH        : SIKMQILXAGTR    JOALHDINKJVNYYN
BHFX            : YTATKTOYNXKEQ   FSLDB           HNOAJ           HEBDHQHOH      
AEBTMNAYRXI     : LCWSAEDHHLGVYJ  WOJJKVVI        TFLVDTWFOCWRNSW OMHDCCQWUNTXWQF NXEXWRQUYUX    
UJXNSQTGSCXGMX  : UUWUBNVVIFGTRSR TRWGLNFA        TCUSRTYVFAKHEGS WFOIDTPV       
TFIIFMJBYYCARC  : RLKQMJBFRVJKP   GOCKNF          EPFBKGEB        MPLGIWDF       
RYWQORJJY       : XJIGMA          KONBPIYFSGIJF   EHWIFVDNMGJ     NXFSJUDUBJIMMLV
NYLAYSVEDELSP   : MLCMLFOYFPTTO   MEXLRTXHON      OWTDVCLRXCGK    HQYMJ          
RPTUHVGYVDRK    : NHKVUCWSJWDWLKA
CVWHKXSMW       : IHMSATE         XFPKGYCXQGROG   PBYMVVQK        KYQXUD          GPGFIWNPX      
