TTWPTQT         : LNBK           
SQYATKXRQY      : VVXKQKD         YOXCK          
YNSTPWUNKY      : TCTARPTOXA      NECTBRLKFSEMG   RARKLLEHHTT     EAEWYUCXLYVBJEV TFUTFMCKMJY     ORTCPL         
EUXBMTRGRKWS    : RESQXAKGKCQ     EDQGMPTELVU     RPDBMEIOL       HMQOEBLFX      
TEILWJLVXGRPEMD : WKVVVCWNA       DPNHIWLGWIHW    FGVGJHNNLM     
NJSLIWXCQFW     : QSRI            ADUMWYBDPQI     EJDIJRSJT       XBFNDQG         GVXKU          
CROXVA          : WKJH            DCWTQ           DCPPUHJVHNOR    MPWHDDPSVVJF   
SJXQJFIYLXFC    : VHFGGRNSGSKF    INNTGOTBBCT     MEXXFTAFGS     
OWYYTXELDDPHUG  : BNCFHUKKMXMOV   EVBVKWKYDF      SRGXBVRVD       EDQGMPTELVU    
RGUMSUECCOENMJR : DSOTYWRXQP      FEFGJDPWACCL    IWBNATUIHDPVIYH JWSIVIHETD     
APAALX          : BLDOFFJYFJJ     ELDCC           BXRFVDCGEFO     YHQGJMFHN      
YDJOLEX         : LYRGJYLMEKD     QPYIBKL         MKAQKIFVQQ     
XEONYJTE        : ITFGWSSXNP      LFITXOBUF       NIVAODGIBQYSFN  NDPLF           FEWVXEHJ       
IICXTUBTMBTXC   : OPVIMVTIDM      ICVGDSICYEIEPE  WQGBFIRBI      
XFLOS           : UPHJAYAHO       YENHL           KDRIIJYK        ERKAKFW         YDPKOECCWFLNA  
MOSTFIUR        : WFTPBTEKRYPLMN  NOLBXQPFITQQKTD LPYFCNL        
YGNJ            : YFATFSHK        VNQN            CIMDSPOYEQPOKJ  IMWUTPVKWIUVR   DKAASIFSRP      JENRBMOCBFN     OFLIJB          JDPSM          
YGNJ            : UNAKSSBG        JTCAXKYLL      
LDFOXRPTSTW     : CXBC            FAHMXJREHCQNMJ  XBPDBJ          KVCRYIJLXXCBGDE
CKFWFUMYO       : FCWJQMCSR       RSHO            WVRAQLQSKHAUQV 
JJJMLPAWBN      : RCLTUYQDULV     LIPNKRA         JVPJLGOGTOKTR   ROIWDEITCWPCDO  KKJPKGXE        QROJWAERBVXB   
GCDBTWTQV       : NPSUWILQIKG     LECYHVGXFLVBH   HNSFJQHHYA     
SJRPOOCPDWAP    : PCXPNRJOPUXPVC  HMLKFVBSBBEVSM  QPTDH           QJJXFCHK       
ODYQAAG         : MWQNYACTGWNR    KEJXGJDQEY      PCGYNYEVGQ     
IIGLE           : FRXFGVDLGUOO    AIQXDHOHQNKAT   RYAOTGLR       
FUERP           : LRANSYW         DKSLCXDMEG      RCLTUYQDULV     CJEMQ          
MGHDKWHJY       : PWSJVDNMBU      ENIWJOTLPOHSC   FCAMHSSTKGPU    QFKYWDPPBSB    
QPERGGT         : RCLTUYQDULV     AAAKHPKU       
KEWSQEB         : UKAVQ           LECYHVGXFLVBH   OPWSUTIIHRHO    UUKDDAQGINGFOFI RXCVNPDEV      
BIQRXF          : HDRUEDCLIKPBQNI
FIMFRWGS        : VBLBMLWWFCDDU   FAHMXJREHCQNMJ  LIBE            TABDLJENXYX    
WWHF            : QUQIMEVXFLX    
BUQHTLXXN       : PUVYO           XRIIJ           TOBFKG         
AXPTVWTEFG      : HTUD            RGGLWKPA        KAHLDHPHCB      QKLOCJFXY       EEBDNRKMWTY    
AFRSUQSC        : NNVCCWCBWPPQO   OHAANRPTRDTPX   KGYQO           VMWTTDJXK      
YFTPNN          : BBDSYFTAUBQDIX 
NOSMOQCIPBETJ   : NWFPCKDYXK      LHEGEC          XKKYE           CVGDDUMLXJULQ   DLLSQTRFVKSOPE 
FJSYE           : HCBRQIIBK       AFCKQKEKHKGPSFX LAWJXUNSJ      
QYSPXALPNBTE    : BFYINAGQSUABCDD UVKRIMTNTOI     CCDCIQN         GOKMAUNCJBG     GHXQYXMRHEBY   
MQGEVOTWUNG     : MLIICWCJCGAHIAX JTRTDCONTG     
UPBTWQMVJEU     : WSOCWS          EXMHPSRQLU      WKJH            MRLGVIVEUUSS   
RMATGEJTXQX     : NPGUYYBFDXARM   VNOIL           CXVUHPCFVCXDD  
HTQFJANEPQAO    : AJWYJKON        MHXEYBSD        LATAVNAWTMH     BGRQCXRPQXEUJI  JVMBI          
PLRV            : FCAMHSSTKGPU    SKYOMCXBNC      PLUOHLORCTDE    JUGMJMCG        QINVJGREPLOVGQ  ISENHSSULPGI   
EOUEKCLTXLMVFUP : ROLJOBOPYNX     DTLAQ          
ABXPFQGH        : OVBRHG          PNQME          
PWSJVDNMBU      : MGHDKWHJY       XFMSFMUQHVJD   
FISDT           : AWBV            DCWTQ           MWQIYJEDXQIQD   VXFWVDTDP       GVEXTBQHMS     
BBDSYFTAUBQDIX  : YFTPNN          LIPCAPVW        MSEADOYBDJK     HVSLELHOJXCEYEQ
ITFGWSSXNP      : XEONYJTE        HMLKFVBSBBEVSM  QYXMXU          JSEQVREC        LQYGALA         RBPYY          
XIIRQLSTEUYA    : FRXFGVDLGUOO    NGHKJBUNVQVTP   DBRSWSP         LIACXLY         DIBLMJIVSIJU   
VBLBMLWWFCDDU   : FIMFRWGS        DMPYEYARKMFIMD  VVGBYFARDXAC    YDVFDJVWC       TQPOJFE         JLXODF         
DLNLJV          : UTNSCYXEL       FPDXXFAPXKXYWD  OPETASBUUJKU    TBLLQW          JQLPCNOOVV      DOKNMNBHYBWRCS 
ENIWJOTLPOHSC   : MGHDKWHJY       RNXBUCMSJQ      UDYIRPPYNNWTU   ARLDSNYIX      
FOGETIHYFDFSS   : MUFHNKFNMTSYFK  SKNVGLPXNT      GQRHILTTSPEB   
DRMJHW          : HGUWWNXOEYFT    QPATSPA        
QMDCERKWUVF     : YLWDXGBAOLXO    KIGRTUETG       RKYQ            IETCAWRLRKHMQFE
EJFOTHTWMNQFSK  : LKKIIENVV       ONUXLXJRAGRJT   KJJERBLQRV      MDCS            AXCKRDLFOSB    
CRRMIEP         : ALUVEO          UTNMOROUQXG     MRVWS           WQOYVFC        
IKXHHVOSAB      : CWRC            RGFDIESPNL      IRMAICMVK       LLUACXJYRHKQAG 
QUHKTVAMBS      : JJXIPIPJD       NCKMQXSY        KGPBDDHBXXN     XFHJXUN        
VWONKXTCLEML    : KHUJOKRAB       YIIABOQBFIIXEYG HFJSKONXDYEF    AKHAEB         
TJDMLEPCBYM     : NFALT           JDJTDRNMSKEPY   WKPT            YLGVJNGNTT     
VPIYKFWK        : YWREI           RKUWSFDRHBOP   
MUWG            : KUEGUTGMNTNJ    GXMV            GKLFSRBOBN      KQYBKXNFTFYKCKL MQCKR           EQDXYCXOBCPFB  
KKMVYIHEXSKN    : MOJIWJFMMFQW    QTVXSJNRSVO     WYQQ            GNJHKLKXDLTEI   MTEECDS        
LMJGKBQMMYJ     : JPBIFSUIARSJ    HWCSSYFNWR     
VWTSFSDSH       : IDRVMKCKPWHHGK  TSWTIP          MRVAGAHOBW      UPVLCXFR        HIFSVGDQDYDPN   VELBVAW        
TQIXOD          : EAVSL           NLKOBONBB       UEXMOTQFEQ      SUSCKIOV       
EAVSL           : TQIXOD          OPKRYRVHFBEHTU  VDXSLSKR        WLSSJQIPLMPLW  
ENVQAUCYQ       : NJEANQFJBNF     LCSFILXB        MDWYSADEEI      UYTHWRELOLQMIAM IOLIIVPQW       VHVKE          
SLHNOAV         : SBYWWURRGYF     HEGUAIGOEEQ     KAUX            SQEIUWRVWHKEC   MCKWHSA        
TOCTFFELFAEQE   : NRWDGQMVAQMHKBI TNYUG           FMVWWBOV        CEPASUKPCGRYN  
EABGWGFPH       : SVEN            EPRGFBWBJTMGG  
BQQRSMJODLIK    : MXQGMNUJCKGD   
MVXMARTLXTOFRUM : QXITL          
FPLXGDRUPGAB    : MIDFRPIF        XOQPNMKNIVDIEPA YQHWOEECP       IGCNU          
KUEGUTGMNTNJ    : MUWG            KNUWGSY        
SBGHLLYYMF      : FSBNHKIYHTOHNX  CCLB           
ECTMCXEMUJ      : WMWPSCRGGBK     WPGUX           GAEJ            SIWVCSECEACV    HXNVP           WEOLYOMT        JEGPRKKGN       IWRDBCWVXKJWX  
ECTMCXEMUJ      : OQMY           
PDCFSVS         : CRQDUOFOR       TKXAV           YOXCK           WPVUMJAR        XEUYAQTU        NISWI           WAJDVJJHHYONR  
FNGOWT          : FBVVRCRWR       NAXUPW          XDNPCKXISDU    
WSOCWS          : UPBTWQMVJEU     VHFGGRNSGSKF    MHXEYBSD        WBKODWEXBRBORSQ LAEQQECFTWTVBEI
RGJRKWMVPEB     : DOBYHLIWLHP     RPBENOK         WLSSJQIPLMPLW   SVWPTHBFIAU     EOOG            VUVSVKACTNL    
JTQEWVR         : FOCVIHVQVG      EBOQDMSAW       BHAA            VORSEFXIFTXM    GIWUTQW         QXDVCLE         DLVRROWE        EDFKUSBTBRLM   
KRYN            : FKGRP           PCXUERHDX       BJIGTTQGQOM     OYKUSSAFNBSBRL  UXWVXTAEPQUN   
RESQXAKGKCQ     : EUXBMTRGRKWS    SIYUTI          LHSTXOLYSOWKXQ  OOXJKHIF        PINAP          
ONYTOT          : UPDFACUG        RLFP            GQEXDSWRIBL     RWIAW           YBXAMYEQSUTGTL  ABAB           
LKKIIENVV       : EJFOTHTWMNQFSK  PUXTUQUEBAM     VWPK            LUXLLQQEBWWW    RGPRJ           OWDLPQSYQNYON  
LKGPGWPGIVQK    : JENRBMOCBFN     WPDQKJLGHDHUT   MMJUHNS        
ACDCXTVDFIP     : VTCCBYRKPXGM    XGIQAHXAOJ      ORQSXPXOSP      RDEPW          
SUFOSRCGXSMXISG : ETKAX           UKQJXGBJHD      OVLBIEKVNTHE    DWKPBGCQA      
MSWOWAQUVMYEWQ  : AMUAQUCEI       BWSNGJDDEXA     TXTEEYOQXYATL  
QLCH            : NABI            QUQIMEVXFLX    
TKNUFASPUBWJTT  : TJDTASPBXUEOI   GAJBC           IWPMCWTCNMHWLP 
RVROU           : FBEB            OVXDHRC        
PBEH            : OPSIOJSUVOXCV   FXQPRWH        
WUYFCTR         : USMRBTCYRHF     HXNVP           SKEUANKRHGJWUU 
QYTJORKOBGKCAJW : LHCMFOHUDQD     KHHPQQXXPMLMMV  QLNENTYVOA     
EEHHIOEIM       : RWIAW           OCRGGLJMRGGKSSQ XIVRSIMRANHT   
NOAH            : LRANSYW         KLYTPANFYXYI    IOPQRFR        
QGDC            : DYXSIHD         CKGJWQSAUWTNMBI
UOLYWWDXGAPMEW  : DEIYFOQI        EDQGMPTELVU     YLEIGVQNFJXUYX 
POAXB           : OUHHQDDCNE      POIXIDCQMXMIQS  UPQSGCDCY       BJEVXIWDQSKB    BXGYYMU         JSKESASDGP     
NPGUYYBFDXARM   : RMATGEJTXQX     FMOQPOW         DNSTB           LJQLDGPHQSIXAS  UPANVTOKDN      LCCFQGLJKMBYK  
PJDPRDFGKECASC  : TGRYAGX         OORVGUEGDXGI    SMJVVTVMHWA    
TJNMRINTLSWL    : NITJOQQYEV      PINMYYUPO       EROVHEWMOG      HIFWOSQ         VKWXOAP         UGWKICU        
RXUJJABDGIJQ    : WMPVPITIUJQG    HCORK           KEJXGJDQEY      IMDCCLOYHCCCGP  ISJU           
LQGQ            : ORLWAARCT       OVQFCQXH        GNVXUBWAR       AFTJY           JAKGV           KWDKQ           DMWYQNGSATPQCUC
CCEOVO          : VKDLDCXBJSVRVAB LYGJU           TFPIUU         
PCXPNRJOPUXPVC  : SJRPOOCPDWAP    QIFYJVUVWIMU    BOAPCUNGNDQQ   
ENMSCFBS        : FTXDETJ         DSHGJOPXW      
EWCUSQALSYDJQ   : YTRJBLL         RXYJUVTEN       BJNYQIAKMB      JXFFGERMXWHHR   YTJOG          
XIJX            : TSWTIP          HYEHT          
FCWJQMCSR       : CKFWFUMYO       QSGEQ           OPKRYRVHFBEHTU  ALEHQCIDHYMCY   DTVRAOJGSP     
NQKKSFFKGQ      : GXMV            OIMXPUMM        OGHIKX          WPQFSLWEADAJYFB
FVOXIMHRNIY     : RMNAUXAKIBHSUB  NKWO            QKLOCJFXY       VDYGEUMMWRK     HCMHYIFUBDH    
FKGRP           : KRYN            NUVHAWRRCUBMT   NKEJ            JOXOXUW         ORNRAWTNRADXUO  RDEPCBAHU      
MTODGY          : IHJGWIKOG       BWSXKT         
LFITXOBUF       : XEONYJTE        UTLXESOMEJVAAH  IWKBTE          YWRVLU         
FULAIT          : MKWCCS          KRASLPCJSBR     NITRRKLRDPNHPG  JRSFFQBQ        BFJNGTUYRVMP   
XBMHVCIKXXNEYL  : MMSEDWXMKIAAIW  QAJWIXGGTUXJE  
GUMHLPCSRJNDJ   : JANCFEX         SIBIKYI        
YLWDXGBAOLXO    : QMDCERKWUVF     VRUVBPTWTJDKR   OJSPUJPXSGYIK  
EQMVYHKGUDI     : NYWXQYEIIAIHHUC TGGPMBFUYWBWBR  KVULIHTFAC      SOBBTMHC       
UUEBEBCRAFPGIR  : BFYINAGQSUABCDD ILYAR           BMMVBNBOTA     
TROSVF          : PVCVH           VRSYCYWDRCYNB   QIFYJVUVWIMU    UDVGLHKSLEEO    BGTFXC         
UERFN           : VKDLDCXBJSVRVAB EYXHXBSTVCHT    DEABLXARSBEFV   QPTDH           OFIGICLCQ       YPHTMFIKJ       WVGFJ          
KVEGQIJ         : VQQQPNBLJQVLJJT UWEWFTRKNDOAB  
LLPLTITCCRYUGR  : YWLKTTPILTI     UTLXESOMEJVAAH  PPFKYJNPTLHW    GTQQ            FMTDVHEWUDLBIF  HLRYLGKRBCNE    RCUPTHYTOCCYMKR HOALTQYQLL     
NCNTUVHIGGOOYY  : IMWUTPVKWIUVR   CTCVSNOWXOW     FOPE            MKGJTMQS       
YLMRYIATME      : QMXECOCWPSPVFL  LKVUTNG         XGVFMBQSX       XWUNPCNDWS     
LYTGSJIIFDE     : XEJJPTJRSVNLGNP RHRIBIUHG      
NNVCCWCBWPPQO   : AFRSUQSC        SLGR            CTBEGLNYQEA    
QIMWVYWR        : QYXSUK          JXOWCN         
RDPCJTHBJUWMYVQ : QMXECOCWPSPVFL  HHGGVJLYUIGU    VPQGQUEYLAUMTG  XQCQQ          
UIRLWREIFCGG    : CPGBYESIIIFPJ   CAFJIYXVTVYSEV  BLQBWMGXJF     
YNUEDWPYGQJDP   : MMSEDWXMKIAAIW  DAFMJAHTOX     
DMOFJY          : YWAFQ           GKUEKPK         DCJG            XIIVLPKSEQUDHDX FYJDPIFJ        BNMF           
VVRAEYELFFMUCQY : OMEJMBFO       
HXGXHK          : BACQQETIRFUQ    KILCECQJBDM     WSEHBNNI        LNHPVIQ        
FPDVUMUUKTNL    : FPKB            BKRSMVPFOJ      EEBDNRKMWTY     GWNFM           VDEVARNEFQDYP  
ORLWAARCT       : LQGQ            LPCFXQYSXXQAGHD AFTJY           AOMPESPTJIKMP  
CBRLBBXRHPUFKK  : WPJMXQIDLX      DLLSQTRFVKSOPE  ROYK           
IUWXIWMBL       : CRQDUOFOR       OGHIKX          GQOSVWLQUFO     FSBNHKIYHTOHNX  KJYLSPNPGTDMASO YXDKYAEJV       VRPERSWXOJQXGR  NGOEP          
IUWXIWMBL       : ROYK           
BNCFHUKKMXMOV   : OWYYTXELDDPHUG  SHYHEUWHVNKJ    DOKXTKBYJGWY   
XNEFXOIGLHEUHT  : CLAO            WWHAK           DLRINJNAJHCNCLO
UDBIHGQDSBRQP   : QUOLWPMSYOS     TBLLQW          MDQAPFGWM       MXDX            UGWKICU         RXCVNPDEV      
OWGCBMBPUJ      : YRWRAXSNSHB     EKLXLUREWQXOJX  YANENNEECDKFFYC TQPOJFE        
FQXMKVHPYPX     : MQMNVHTX        RTGMJDQHIN      YLGVJNGNTT      IQRYP           LXWKAGSSMSPQMP  TTMFELCNQQXHNL 
IDYMUSCEH       : HDRUEDCLIKPBQNI YRYNJFSHA       LWFGCQHRG      
KKCWNTUYXAPVOCU : JXWLEGJEJTE     ADDQCAWGDEE    
UTNSCYXEL       : DLNLJV          ETNLMUKIOKBBBV  OKVWCJDBTBU    
WNYGPK          : LVWWQMSUSABWVWT BOIWWJJHXFPTO  
TJGOEGMGX       : IBTKSTUIT       EIFQIALGVBDFP   XWMJYUOTBCDVJXI FLJAKRUJNL     
UDFQ            : BILHFPMTHPHC    YRWRAXSNSHB     DLLSQTRFVKSOPE  VXFWVDTDP       ONWACL         
CHSGGQKRLJHLQY  : ASKHBXIMBT      GSXWLRSY        RYYQWUXSINMAV   LAWJXUNSJ       AMITW           EGVCNCIRTWPS    BHVFLWQR       
JTHQK           : XBPDBJ          NTAPVJO         IMJCDLMNGMB     IJQVUSIJECCM    QKLOCJFXY      
YWUW            : JEGRPYXJE      
QAPJXTQQ        : HKQDKLBB        RNXBUCMSJQ      QRXEKCR         YJGT            WPJFATPKDRIHJ  
WJNQVYBJ        : GXIJ            JDXM            XQCQQ           LTOSKFYPUKF    
AHCVQUG         : MQMNVHTX        MPHUASVKYTU     DTBMPCPUTKI     QDXNREEDL       JSEQVREC        SYUVKQMLIBX    
TDBSNTVFD       : AOQSDB          AUQMOBKJRVR     OMDC            BWSXKT          UXIHFNFVXWYO   
BUNDTYS         : AOQSDB          CGHUIRWRPRRBRM  RWJAQKGOF       CTKWROUFGXJC   
UUOGMQ          : KYQMLXJJPEQIAX  EJDIJRSJT       LIPHFL         
QNHLTMHAP       : SVEICGS         BBDYKIFBAS     
PJYWNUXKKDGK    : SHYHEUWHVNKJ    SJEQYOXDIAUXH   YQPTTTBQMNNRIMS QRXEKCR         ELEBLNMYN       KFCPR           VCNBWHAEWWWMXI  IKJCVBOFQFNUBW 
THRKOGCEX       : NIMENQUCBV      DKSLCXDMEG      KLFNVDIYT       EJDIJRSJT       VNCURBCNUMC     EBDCF           IJMWABBQXJ     
NLNBV           : VKDLDCXBJSVRVAB PTXDVNTNWRIM    PJKIQGXUQC      XNURCBYS        KVULIHTFAC      IONRXCSNK       VMWTTDJXK       KDLVPLNAOKHTWU 
QYFDXEQUCDGIJ   : MUFHNKFNMTSYFK  SIPA            LHJIOUARS      
FGAY            : OHAANRPTRDTPX   OETYWGMV        SONVKYDUJLWJFJR BPAAEUOUJQSLEY 
QFWXDOL         : QWLMTRWXARFBR   RYXBHOSAAHIW    WPRWQYNEMCQ     OOHK           
FONUIM          : RGGLWKPA        TFQJVNEC        KKHPLTDIXV      BRBD           
LMHEJMHPUSKAB   : YWAFQ           JJPJJ           QOCB            OLWKHYYYXFR     VORSEFXIFTXM    MGGHTYWOHQDBTVC MRRPDGWWEQ     
YWEGTEKLQEQ     : NTVUN           LQYGALA        
RLPGODS         : XGIQAHXAOJ      JBMLG          
HCJQUGM         : DWUPVJIU        SBVNYYBXDD      OJRPOARHSEBKG   WBPDQIPRLQNDGHF RMDWNJELBXIBJ  
GNSHKANH        : GFDEBIEBPUBE    NFFUDPGKDFOLEK  BGTFXC          FGVGJHNNLM     
ASWELFXY        : NTOPJGWKYMFLQJ  HUMOUCUYELL     FXDOBVX         LAWJXUNSJ       GYDJECPHM       PPRX            MBBQUJG        
EOBYNKEYCYFQGN  : GNCADUD         FSIMBLKIW       TBBBGG          KEMTBDHCUKXQ   
CWRC            : IKXHHVOSAB      QGOURVQ         SCIJOIYYNCBWPQI GNJHKLKXDLTEI  
BGNT            : VRUVBPTWTJDKR   YVKCIIFYRCGNL   DQSHYLRNEG      HXNVP           SPGPXGMX       
THLUGIYWLBKWF   : VVLI            RQDMSNXHV       MXIDDKKW        QYPJJB          LEACVRSAI       CEIKBTSBB       UBVIGRRCEVDVMI 
BGSR            : KAIRCTVYJKVQSJN SFQLAGOKFOVV    MWTSP          
GXQDRSQSA       : HTUD            RXPNLL          BDCNN           ASQTLKUPBLR     GPCFTM         
OGCVTY          : ROBT            DJTXCIVDYAVP    QBPVUCKTJHPCUDH NUCJPWWHFGFKRVQ
EYAQCN          : RWIAW           JWSIVIHETD      DEJWSMTQGWQXGM 
HBSNUMCBKTHFOAX : TPATICGBTOBOW   BMOFHRAYSXTW    CIJYLSMOOC      ICBRQMCHFQ      UXRCXPJUX      
IPWMNQMS        : BERKJFBF        MDQAPFGWM       VQAEJ          
NTOPJGWKYMFLQJ  : ASWELFXY        RPRLBO          ALEHQCIDHYMCY   JPHP           
KSFASGQBVQNJJCD : MOEAGBFMTTLUMAE TCTARPTOXA      EHSMPAEASBJIH   EAORLLTQJDREND 
PYXFKE          : OJMDHRVKSVR     QUOLWPMSYOS     YDROPFAW       
UFQDSIORU       : TUETHPTYSCVILCH MBDKJBXIKYHAQ   NYWXQYEIIAIHHUC QKBKBUWJ        MYHOYFKYWUWBVD 
YWAFQ           : DMOFJY          LMHEJMHPUSKAB   BLNU            XXJHHYLCCVXTAXF
BHSNSVQBLRBRCGV : BOEYDX          WUORFCSUBVV     QSEY            CIJYLSMOOC      XNTSSJUD       
LPCFXQYSXXQAGHD : ORLWAARCT       DBMCHYHBF       PLGY            OVLBIEKVNTHE   
QYUJUNMIF       : PIPVOB          DASLQMUUFXY     FOBGVNHSKNLRY   FEMRWSVCGH      DEJWSMTQGWQXGM  BMNQSTJE       
AJWYJKON        : HTQFJANEPQAO    RKOXXCJVEIS     MVIFH           ESPOOVODRU      RPDBMEIOL       WCUGA          
OHSHFTAIA       : DFJBPGCSR       VORSEFXIFTXM    RBLKOMEYT      
LHCMFOHUDQD     : QYTJORKOBGKCAJW CDGJPXHRWWE    
SMSTXEKM        : XJCYPFIQHUFCGTN MUMKXSFOAWL     PUSEVQBBBXINDM 
YTRJBLL         : EWCUSQALSYDJQ   CUOCIV          BFYINAGQSUABCDD OFLIJB          JVIOMQTENEAMNWN UMNYLJEJ       
LVXU            : BACQQETIRFUQ    PBLARSYVFCLQT   OKOYMPERF       KLTUWJI         BMFBLEPSMYBAU  
KCOUASNDMIRGDQM : DFOLHXUHV       WDXYSDMPSGVMCKE UGTRG           CVGDDUMLXJULQ   KOKUUVDXXHQYOU  TGRYAGX         FDXXMGOKSUJXX   EWXMGJYAO      
KCOUASNDMIRGDQM : CDGJPXHRWWE    
DMPYEYARKMFIMD  : VBLBMLWWFCDDU   ARKGADBEHXQR    SYUVKQMLIBX    
YFATFSHK        : YGNJ            LYGJU           QVIM            RVYUYVIKQ      
SDQVTFLYRBAYCC  : RMNAUXAKIBHSUB  RNXBUCMSJQ      TJDTASPBXUEOI   FLJAKRUJNL      CFXPIUITQO     
NOWX            : OKOYMPERF       SEMTSARJQF      WVRAQLQSKHAUQV  QTMUSTIHBKUHS   EXESTFCEYX     
AJDHKYP         : HNRBUVWYCWACPBA PUPUYPMIGUV     XEWTM          
JANCFEX         : GUMHLPCSRJNDJ   XYNQONIVVQRFKEB RKNFOQG         YHER            OWCFI          
JLACNA          : QSGEQ           SGNWEPUMV       GITIQK          JVJLYJ          BPDQXA          PEYFPAXLGICVYWR NNDSHAQPU      
PFTFTSG         : CLIBEEQ         TXTEEYOQXYATL   QBFNUF          GHRMGSCJMKCEX   LQYGALA        
UPDFACUG        : ONYTOT          EIXRBULIAT      YQFCSAB         UIBMHMTGVJMK   
UTPDBNCKCFO     : PTXDVNTNWRIM    IGCNU           SVQFKNE        
HRHMOPJJXJFNOK  : PBLARSYVFCLQT   MYHDRPNMCVFEIR 
SHYHEUWHVNKJ    : BNCFHUKKMXMOV   PJYWNUXKKDGK    FOUMBOFFYR      HVWRP           JEVJOQH         ORQSXPXOSP      PPCDKFO        
RAHYUQOLIXU     : GOKMAUNCJBG     YEPKNJYFL      
JCUAMNST        : CXSOXPBAL       RDXL            BGKRIPSASOMMK   VOVIKUHEUXNYMH  LJQLDGPHQSIXAS 
AYJAIIPUTHMV    : KYFYUIHU       
OQHFEQFAWOC     : HPBUDWRFSDLMU  
ORHJNVMOIMXQE   : OPETASBUUJKU    YQFCSAB         IVYMUDJFT       IIYBDJHLGBAO    FRSWSQBPIGK    
MLIICWCJCGAHIAX : MQGEVOTWUNG     GSCBC           WUORFCSUBVV     YKYXJGLBBNGUQR  UMMREGKNCGDP    EDMXS           DEWBLUIH       
TOFEXUCK        : BBTN            HIAVK          
KYKDDDPQNBS     : UMGXPJVFWCUEO   JVMBI          
DFOLHXUHV       : KCOUASNDMIRGDQM IUKFOJBQLC      RNHRUMCA        OCRGGLJMRGGKSSQ BYIRNOUYW       MRVWS           DIQLBEK        
CMPI            : TREPATDJQUDDIU  EVBVKWKYDF      WSEHBNNI        VETOEW         
KKXWVAH         : IOPQRFR        
FNRWD           : XJBSTRWCDJX     NRVETMFKIXQCE   HUWMPOCCSY     
ROVW            : LQMUMKAXJGUTK   CJNKVYIRDPST   
HFGE            : UGYXUF          WBPDQIPRLQNDGHF UKQJXGBJHD      LKRHTBR         DHAHRPKEPY     
EMSREBF         : CRQDUOFOR       BCSTCCCGX      
MDOIDY          : WNMUFGL         PFKUH           CTPAVBVMYL     
LODI            : NVVTHMLFJEW     WPJMXQIDLX      DOKNMNBHYBWRCS  KWDNFJ         
VAITAQEHW       : YJHPOXHSCDOMFH  MDLHAHW         CTFYSODRH       NEDFWX          BPAAEUOUJQSLEY  HOFYCIK        
VBXPUEQ         : GXIJ            RKOXXCJVEIS     ESPOOVODRU      UROUVGIEE       THGMF          
VFGNPLMCW       : WBHNWCPXG       RMYFKGVOCXNMWX  WQOAIMJYLQL     GKJILRM         UKLCRIBLFKLWW   BNMF            YLTYMYJAM      
FFWEIGXKYERVP   : MPHUASVKYTU     VYJFAR          LHXIFARK        GHXQYXMRHEBY    EYMDUOBFBT      PATJRAHWJKLXLA  WTAKWWCQ       
YNFUTYUQEBEUNSW : WNISTPGKFYBEE   FQQJVASJLWXWM   WNNJOUY         RVYUYVIKQ      
VESSID          : HGNKVCCGW       MRIDJWOSL      
JNCNFADU        : OPWSUTIIHRHO    TVVNUIOQG       OCSA           
SDWNCRE         : XIIVLPKSEQUDHDX QSNPQVKKE       UPYQAXSSGAC     KSNLEDXD       
VKDLDCXBJSVRVAB : CCEOVO          UERFN           NLNBV           DBGNELVFLNRQLFU KIMUEFWEGBXDSM  IDEWPJOEVUSR    OINTKLHPAN     
CRQDUOFOR       : PDCFSVS         IUWXIWMBL       EMSREBF         NUWWQNNTKWLCNW  PUVYO           XYNQONIVVQRFKEB NBFVNBIOKHKBK   USQU           
ETVKCRUIFAMEDVY : MPTLQFOIHSIEX   CLMD            UEUEJ           CCDCIQN         GCDGQDID        GNJHKLKXDLTEI  
OVBRHG          : ABXPFQGH        KOKUUVDXXHQYOU  XWIDRIGTJFPB   
YJHPOXHSCDOMFH  : VAITAQEHW       GNVJAMK         CKESKGTNTGSRQCI MVHK            UPQSGCDCY      
POLDS           : IUFBF           CFAWPNKXKBESH   GPWIPWUSHPGR   
BSPR            : LRJVVOLEGKV     OSKBGO          JVQWWHUUVN      CRTJD          
TKXAV           : PDCFSVS         ICVGDSICYEIEPE  GUDKNOWTMLMSTO 
LDQCBXUFBJTJSFY : WJDVGOCWTEVTOBQ FTXDETJ         ALUVEO          BJEVXIWDQSKB   
QEDHIXAAO       : SQSNICLBXDQNAY  SMMGLWNMY       LYLEAMOX        YNGISTVFIYUXC   SMJVVTVMHWA    
MPTLQFOIHSIEX   : ETVKCRUIFAMEDVY KIGRTUETG       TITCBKEDPDIRC   UELPDUOXGLG    
NUVHAWRRCUBMT   : FKGRP           NPHNQEQKEUDB    GUKMDQF         WAJDVJJHHYONR  
MKWCCS          : FULAIT          TCORVGQUEPLTUV  LPAGXEMYOV      FROTPSOYWBHQA   GWROHQGGUBF    
VAEEJYONX       : LEGI           
EUWLU           : MJNYMN          TQITUNNSJBUN    EGTCGVHBDALG    TLCHBQ          IXAJG          
FOYASLVVA       : ETNLMUKIOKBBBV  UKLCRIBLFKLWW  
TCLORHPWNYVDPV  : FOUMBOFFYR      GRYSVVPWSJNX   
TQEHOYMDAOVNLSN : NUWWQNNTKWLCNW  FUOVEPVS        BESPHR          OGCUCONV       
OSGDMQUJEWIJMGO : HFJSKONXDYEF    OPPN           
AUPOVETVSSJGN   : GQOSVWLQUFO     AYXAVW          KWPMUTIHUVGNW   VJAKQRPFSWCTX  
BERKJFBF        : IPWMNQMS        CSTWXIDUK       HYPC           
HCBRQIIBK       : FJSYE           MIEEPGPVQEGLGT  QAEUHBUOHS      QXITL          
SBYWWURRGYF     : SLHNOAV         BLGYKP          KDXBHAOTVGDKP  
CLAO            : XNEFXOIGLHEUHT  UEUEJ           NNXMDKY         JHLEWDXYQRVPI  
FPDXXFAPXKXYWD  : DLNLJV          TITCBKEDPDIRC   BNMF            KMRVOBPRSL     
XCQWYKPFLW      : XRVBCCWRR       MQCKR           WEHQ            SNIKBP          ROYK           
OJMDHRVKSVR     : PYXFKE          AEUSQYJLXJDDR   TXAJJEGWNKHHGB  ODEVEGSDI      
NPHNQEQKEUDB    : NUVHAWRRCUBMT   EBRHVUGTJGGJXX  EOMTF           KEMTBDHCUKXQ    JHDFX          
PQBCQNS         : DEIYFOQI        AWLVQ           CCBVGNJXTBW     RNYOMCN         BWSXKT          OHKGY          
BXHUTTNRLIFDP   : ULJDWXBJJW     
VVLI            : THLUGIYWLBKWF   BOEYDX          UCLAT           EQDXYCXOBCPFB   RSDDFBEAWO      YVIDNMFKSI     
GNCADUD         : EOBYNKEYCYFQGN  BESPHR          HHGGVJLYUIGU    RTUIS           RQBLVRHAJ       UTALK           MKXPHJGXAET    
LRANSYW         : FUERP           NOAH            IDEWPJOEVUSR    OVUCD          
UQEN            : CFKLJXBYUGPPMCD QAPTYHWHKEUSNQ  JVQWWHUUVN      EQDXYCXOBCPFB  
OUHHQDDCNE      : POAXB           CIODLXEEHLJAMQ  BLQBWMGXJF      NNMCTNRSBAL    
BILHFPMTHPHC    : UDFQ            GBRS            LUHTNJRWM      
HTLXXBD         : QTUXOSAAJOGEND 
WMWPSCRGGBK     : ECTMCXEMUJ      BFYINAGQSUABCDD VOQM            FHFVHFNCSO      VDEVARNEFQDYP  
NRWDGQMVAQMHKBI : TOCTFFELFAEQE   RWSESNSOVHAXFF  JEFQTKVDQ       GAFBTQCBJSP     GXYLUMNDTPJB    PRCUKKVXVBGGOJX
CLDBACQUEJC     : HEGUAIGOEEQ     WLVH            HNRBUVWYCWACPBA ETVQYAIAXP      SCPF            IIYBDJHLGBAO   
MOEAGBFMTTLUMAE : KSFASGQBVQNJJCD TCUMV           KVULIHTFAC      XYVFUFRKYHWIIP 
BMNGA           : PFOCSHNWWOWDX   DXISX          
HBSBVWMAKY      : QOCB            KRTW            WPRWQYNEMCQ     TFPJGQSWR      
RCWUJMP         : FRJL            XYXOEAOYEN      BWXWKVKU        UMYXWG          IOLIIVPQW       FXQPRWH        
AMUAQUCEI       : MSWOWAQUVMYEWQ  QOVCVWUKXK      SNQDI           TITYBNLHTIJHM  
EBRHVUGTJGGJXX  : NPHNQEQKEUDB    OJSPUJPXSGYIK   XDCVFPUJ        CHRJJIWFYFGVA  
UTYJLHJX        : FSIMBLKIW      
KQXOUJWCKQJJOPF : SFJUNTKKIHCLBMP DSOTYWRXQP      USPLKGDNDYBWAEU WYNGL          
YLJWMWTIYE      : BYIWGVNX        NECTBRLKFSEMG  
GNVJAMK         : YJHPOXHSCDOMFH  RTUIS           TMNFUNWDT      
KTNMGFX         : YPJC            JPBIFSUIARSJ    QXGDNOFQBQDPCYW JGUNMWBFKQJX    NOLTFL         
TQURPJEOXBIIC   : LECYHVGXFLVBH   VTESJVCUSIKOG   GOKMAUNCJBG    
EJFAUFOFUYYIN   : GVDIIVGRF       MHXEYBSD        UNAKSSBG        ALCMWBQ        
PMXLFVGWFKLF    : LXGTMPWJRNWQC   ARFBNKGG        DPYCWRUBVH      MCKWHSA        
VNQN            : YGNJ            DPWVYE          QOGDPSRHQBLXQ   JRSFFQBQ       
CSTWXIDUK       : BERKJFBF        SVEN            PYFFTTU         DPYCWRUBVH     
GXMV            : MUWG            NQKKSFFKGQ      PFOCSHNWWOWDX   DOKXTKBYJGWY    CEPASUKPCGRYN  
NITJOQQYEV      : TJNMRINTLSWL    NLKOBONBB       UPANVTOKDN     
BLDOFFJYFJJ     : APAALX          FHDFCSEWFEYEHN  RVYUYVIKQ      
FVMLWAJLNRGYIW  : VXDAVHDNBABM    GLFANTPRLN      PVAAVB         
HCNWFYCV        : EJRNOGORJ       HVSETNXYT       LDOCVUSQYTFYP  
KHHPQQXXPMLMMV  : QYTJORKOBGKCAJW OOFWBJLBT       BYIRNOUYW       VQUEJF          CTKWROUFGXJC    BHVJCHQWCGYXK  
CPGBYESIIIFPJ   : UIRLWREIFCGG    LRCKASQLRJUE   
NPSUWILQIKG     : GCDBTWTQV       LQLWLKIEEGIXAR  VETOEW          WQGBFIRBI      
XUKTUMKCQLILTS  : XLXFBWIY       
AIEI            : AUNCWCI         KKNPGYNOQ       JAAMNW          GEUGNBY        
WDSTLE          : XBDIKMASGREYXVL SSYPEYSQCMGXAU  TLCHBQ         
VQQQPNBLJQVLJJT : KVEGQIJ         CRFYDJTKNKVVF   MPODQIYMICGK    SJCFXGHQYGUMJS 
EOREWYOUVRNPFTB : YRYNJFSHA       MPTBDX          JVQUIL         
NTTDIXOTONFAYBW : JJXIPIPJD       AKGBAKHJPNA     WDLMEEP         CYKIPUDKH       AYWN            HFRPSXEGNE     
PPHOQXLMRB      : QSNPQVKKE       GAEJ            ROLJOBOPYNX     DIYVCJSCBGU     UPANVTOKDN      SYUVKQMLIBX     CHNCJYSR       
WWHAK           : XNEFXOIGLHEUHT  UOBDYJ          NABI            WRVNM          
WNMUFGL         : MDOIDY          PMRHTAUSNIATH   GYPFGMKXWKHVU   TTMFELCNQQXHNL 
NLTOKAGAJWQIKFA : CCBVGNJXTBW     QIHN           
KAIRCTVYJKVQSJN : BGSR            FHLLUEG         NTAPVJO         JCRACYNKLMN     IQSQPPWHVCLGCTW WSEHBNNI       
WKWIKFKV        : CMWJOPNPPTTDAC  HIAVK           FMXTXUMQB       DCLAUMFXJ       IHJQVXSM       
CEOJH           : PVABXHRSA       IWKBTE          VNCURBCNUMC    
VHNQLJONSALMUVC : LAFGLS          MVHK           
UOBDYJ          : WWHAK           HDSCLK          REEQR          
VNSCFEJHBSU     : KMCW            ROBT            ETVQYAIAXP     
HEGUAIGOEEQ     : SLHNOAV         CLDBACQUEJC     NHDGHILNRAN     EFGNSUF        
AGLFHUTF        : AFTJY           HWGNXGBPUVNXTKY SEEBSRTN       
OKQTVXW         : GCTSALYGQ       PPWIJGUBDQ      JHDFX           TUOLSWAPOACV   
VQYCWTEICS      : ESTFUXOA        XJNAELEDH      
HMYJUKOCIL      : SOBBTMHC       
TCUMV           : MOEAGBFMTTLUMAE JGABOFHRI       UCECS          
KUIILJLLFRTILI  : VRPERSWXOJQXGR  RGCRYIO        
XJBSTRWCDJX     : FNRWD           UYGPUELKIHJV    TVVXBTCITEWH   
EKEXXCIINSVYAO  : GKLFSRBOBN      RNXBUCMSJQ      TGMTRGGWVMBO    SNMVXNUBGXTXG   PCAJOWDF       
IAFCAOF         : WOYTNCHTLI      QAEUHBUOHS      HNRBUVWYCWACPBA UCSLSE          AKHAEB         
JXRNDEOLI       : OVUCD           FLMEXKXITMYFFA  USPLKGDNDYBWAEU EAORLLTQJDREND  ONQAADODFCSF   
SIYUTI          : RESQXAKGKCQ     WKJDEJBSJ       NEDFWX          ONUXLXJRAGRJT   UPQSGCDCY       ILYAR           DWKPBGCQA      
OGKOU           : SEMTSARJQF      NTMXHDOH        VXFWVDTDP      
AUNCWCI         : AIEI            QXKTDPTDEFMLWM  XVPOSRLNNMSK    AMEKVN         
NIMENQUCBV      : THRKOGCEX       DKAASIFSRP      HUWMPOCCSY      KKJPKGXE        GVEXTBQHMS      LSIFJ           UBQXGUVCIPO    
KVRGGC          : GIGFVNAGHBEFXU  HDCGASXK        WVGFJ           EWXRVM         
MOJIWJFMMFQW    : KKMVYIHEXSKN    CLKTSEMWYN      RJHERXOSO      
FHLLUEG         : KAIRCTVYJKVQSJN QAIIACLL       
GCTSALYGQ       : OKQTVXW         RTGMJDQHIN      KKBFVTPNWUGED   BGTFXC         
VHFGGRNSGSKF    : SJXQJFIYLXFC    WSOCWS          NOFPY           YAYCDLB         VGNIMX          XTBUTNGRO       KHISKQRCJVPULME
RMEFHJLHRNBMQ   : NTAPVJO        
LYGJU           : CCEOVO          YFATFSHK        MVIIUYUEOYG     YDROPFAW        HEFYMV         
OBWIPPOKCTDVII  : FUOVEPVS        LUJARHLGUMTT    DEBKGKGBAB      LMORFODFXBNE   
QTMANDBAV       : OPWSUTIIHRHO    LHSTXOLYSOWKXQ 
NUWWQNNTKWLCNW  : CRQDUOFOR       TQEHOYMDAOVNLSN HWCSSYFNWR     
KCDSMHLGVLVBN   : WARESWLRXFWJKYN KFKQCAAQGIFBWI  AYWN            KKBFVTPNWUGED  
WGJSEILTWHEV    : KGPBDDHBXXN     KNTTVWWNNASX    DVWEPXX         UGWKICU         VAOFPMU        
IJSPVUVPIFDQBPP : AUSJ            QCVBA           DXISX           KFUBMOMV       
FLCLXW          : VNCURBCNUMC    
GKLFSRBOBN      : MUWG            EKEXXCIINSVYAO  FUEWVNYOYA     
SJEQYOXDIAUXH   : PJYWNUXKKDGK    LNVDQ           SVWPTHBFIAU    
JJPJJ           : LMHEJMHPUSKAB   OFADUIT         WRVNM          
STVXMOAB        : AANFMLRHJTJKS   NCYPR           VOVIKUHEUXNYMH  KLFNVDIYT      
NKMW            : SLGR            MXEMIPAYSQW     AMITW           TMXPXVM         HSREFWEOYIQCM   TWJJPDFFLLUUYGT
GYGEEOEBM       : RDXL            EPRGFBWBJTMGG  
DYXSIHD         : QGDC            UDEWCFXCMMED    USILFK         
BACQQETIRFUQ    : HXGXHK          LVXU            HKQDKLBB        PMBW            FNHILDLJXXC     JLXTKH         
BRDGXUM         : RKYQ            SIHNWNGVFOJ     CHNCJYSR       
HBEGBXRKDUNDWE  : SVEN            PPGJYWGDBKC     GEGM            ADDQCAWGDEE     IUSUCFQMWSKWQB 
BYEUGCODDIIL    : XPXWML          QAEUHBUOHS      PHILNHEVJXUTON  EAORLLTQJDREND  ONJCSC         
DBGNELVFLNRQLFU : VKDLDCXBJSVRVAB MRLGVIVEUUSS    KNUWGSY         FRGEGV         
MQMNVHTX        : FQXMKVHPYPX     AHCVQUG         JUDONGJCJDBG    SCRDMXY         IVSVQXP        
YDHHRONS        : DPWVYE          OKVWCJDBTBU     PFJDBCORME      FJQDECIJKTCLB  
BYIWGVNX        : YLJWMWTIYE      MEPELMQHDILQL   XBFNDQG         UXINTHCFIVW    
YFKHRD          : QVIM            FIGI           
FBEB            : RVROU           TGMTRGGWVMBO    IWPE            EEWQKSRRRFLUTUP NAHS           
CAFJIYXVTVYSEV  : UIRLWREIFCGG    HBAYMDATTGWPD  
DJYQIEDSYGM     : XBETJJ          NRILAKFWXQC    
ISIJVKQFSPGQJC  : BXGYYMU         WWYYCJR        
CIODLXEEHLJAMQ  : OUHHQDDCNE      FPCDFOEDUNMMJW  DTBMPCPUTKI     UXINTHCFIVW    
SYIDKGO         : HIMHBSDAGUXMR   XBCJF           ONJCSC         
NHRTBCVSGHHMUI  : WINHL           CKESKGTNTGSRQCI ULJDWXBJJW     
CRELT           : JVICUL          WEOLYOMT       
CIMDSPOYEQPOKJ  : YGNJ            YDNSJV          NUYE            JPSGRKIRNPJGPJN ONWACL          WGJVYXS        
OIMXPUMM        : NQKKSFFKGQ      YOYUMPTIB       UTLXESOMEJVAAH  PMGN            YJGT            USPLKGDNDYBWAEU LEPMXHYYMXTWF  
FOUMBOFFYR      : SHYHEUWHVNKJ    TCLORHPWNYVDPV  YWLKTTPILTI     DEVSNTKS       
UKAVQ           : KEWSQEB         NJROHMTVDVGEF   TVYKKT          VOBOY           TLCHBQ         
LFFVYUG         : INOJVRMNKYGOFK  TUFRBC          FXQPRWH         PKBKFPVANXSCXW 
SVJFKM          : DLXR            JWNBVUDJUFKFDW 
AJYD            : RLFP            YYXJRRHW        EOLGCWBXON      UKEG            OTINEPKISTOYWIS
HIBYTXLTUD      : FGCNOOTGAGUAM   FXGPM           ISGYWBRXAIN    
GKUEKPK         : DMOFJY          QCIAATQ         MWBJBRHWKMJI   
KIGRTUETG       : QMDCERKWUVF     MPTLQFOIHSIEX   VWRGBTMJWVFKRRC QRSP            DHAHRPKEPY      KFUBMOMV       
WINHL           : NHRTBCVSGHHMUI  OPWSUTIIHRHO    OOHK           
CKDXFGNNQIU     : VNRGTUMRWWQQV   IBKAH           BYPDG           YJGT            SNCQYF         
AFCKQKEKHKGPSFX : FJSYE           GKPEVAB         KGYQO           DPBRYJYSIYHQRKT QAEERVTNBBLG    VHNODUAWVMFI   
MKXOUB          : RQBLVRHAJ       KKNPGYNOQ      
CJBPC           : MWQNYACTGWNR    GXYLUMNDTPJB    MXQGMNUJCKGD   
KILSKXJXE       : ETVQYAIAXP     
FOCVIHVQVG      : JTQEWVR         BOEYDX         
LDTBHDEAIRMQDF  : QJSKLWSS        GITIQK          RWJAQKGOF       LIPNKRA         YHUPHJBFEIMJ    CFXPIUITQO     
DQBHMHXOFGXBXUK : EWCFEWIKGJQUAY  USCXYGVAIATT    CHWAIKJH       
IPLLXOPXYHKPMST : FOHFW           FMTDVHEWUDLBIF  CVDBYLKFXGCWJS 
JUYY            : WBHNWCPXG       RCLTUYQDULV     MTUSY           VEIAFUMIAEBO   
WPJGQNGLAWVPI   : YQBUSNNJG       CGHUIRWRPRRBRM  RBIWAWXEOFF    
PAYPYIDRUXLOJ   : XRVBCCWRR       XNTXEYX         OOXJKHIF        EYREIT         
PINMYYUPO       : TJNMRINTLSWL    EAEWYUCXLYVBJEV
DOBYHLIWLHP     : RGJRKWMVPEB     EIXRBULIAT      YAQEEOPJKKMC   
RSHO            : CKFWFUMYO       DGLUKGCAD       XSNJHERU        IVXHORHFQWMDYD  QAEERVTNBBLG    ANWEIHDP        TWQIXLHFCN      JSUIUG         
RSHO            : HPBUDWRFSDLMU  
SDADSLSHM       : VLQE            NDFQKFCAR      
DCJG            : DMOFJY          FIFMUWCYEQNQCMK CIJYLSMOOC     
YHIGTQF         : WXTWQTHAVDHP    IHFOLMFESJW     AVBBXE          IKJCVBOFQFNUBW 
AWWRREIKYLNF    : KRSLW           OSBA            XTBUTNGRO      
YXNLS           : LHEGEC          MCWGNVTAJA      SNMVXNUBGXTXG   AIQXDHOHQNKAT   SMUCNAFTJ       VGNIMX          QOGDPSRHQBLXQ   DUOESXRG       
PDAWCHFKDXRN    : RPBENOK         IRMAICMVK       YRWRAXSNSHB     GONJTSDPJXVV    CLKTSEMWYN      ODOBHWBYE       XBDIKMASGREYXVL
PMRHTAUSNIATH   : WNMUFGL         BWXWKVKU        LNBK            NWBUUUJAI       TVMBX          
HSRYIUYHYIM     : IEGBJ           KXWXHLCOVF      HKDEEFSQDBNGPP 
OMECMVOGFII     : WDXYSDMPSGVMCKE UDYIRPPYNNWTU   IOLIIVPQW      
EVIEPP          : PINAP           RBLKOMEYT      
WKXXUUYCUIOGWDM : DXYOPOERHLKNNW  IAESWR          HPBUDWRFSDLMU  
PIPVOB          : QYUJUNMIF       MOFALGFFJ       GTASDFMHQ      
OHAANRPTRDTPX   : AFRSUQSC        FGAY            MFCD            YJXVIJHRHPHEG  
PBLARSYVFCLQT   : LVXU            HRHMOPJJXJFNOK  QJSKLWSS        GEGM           
FUOVEPVS        : TQEHOYMDAOVNLSN OBWIPPOKCTDVII  UCSLSE          GDAXKFMEMSS    
OMBT            : YDNSJV          PVCVH           WARESWLRXFWJKYN IYDJC           KWDKQ           KQYJRBNAKEYUSSN
RRWJUL          : JENRBMOCBFN     MPKNOOW         JUGMJMCG       
NEMLLOW         : TSDQJMTJ        KLTUWJI         JSEQVREC        QSSXNTX        
IHJGWIKOG       : MTODGY          BEIY            EKLXLUREWQXOJX 
XWTCQC          : EVXNUYP         GOEUKL          FIBQISRVCBDEE  
LAFGLS          : VHNQLJONSALMUVC OLWKHYYYXFR     HCWSMV          RHRXT           TVVXBTCITEWH   
RFFFVFKEOVMNGAC : ICJXRXK        
FDMAHGCD        : UXWALUYPTFI     FYCNXDLRNRQFI   XJOQRVLQONMDJVI
EIXRBULIAT      : UPDFACUG        DOBYHLIWLHP     NNMCTNRSBAL    
HGKWCXMLARBFWP  : JCANJ           SXHWDYA         PKKMEGMHJA      OINTKLHPAN     
EXMHPSRQLU      : UPBTWQMVJEU     YJET            PVABXHRSA       FHDOHDQRUVFC    VHVKE          
YDNSJV          : CIMDSPOYEQPOKJ  OMBT            GWXOHUWFGPHTYCO EMPBYGFJAFXP   
TUETHPTYSCVILCH : UFQDSIORU       WBSJCJGTYKGMGB  YJXRNDDJ       
JYRBPFVBEBRAK   : SEMTSARJQF      PNDVOUBU        QJJXFCHK       
YHKDBTUXVNCTYNW : DVVROBBKOUWBG   ORMBHIPKSTWOJQV
OGHIKX          : NQKKSFFKGQ      IUWXIWMBL       KFKQCAAQGIFBWI  KROII          
IBTKSTUIT       : TJGOEGMGX       AOQSDB          TJDTASPBXUEOI   SKYOMCXBNC      BOPROFGT        HFRPSXEGNE     
UYGPUELKIHJV    : XJBSTRWCDJX     ERKAKFW         QSSXNTX        
RMNAUXAKIBHSUB  : FVOXIMHRNIY     SDQVTFLYRBAYCC 
FWSBYBSVHEGPNQ  : LQLWLKIEEGIXAR 
SIBIKYI         : GUMHLPCSRJNDJ   RAMF            NJEANQFJBNF     VBTQFILAIDJBK   HQNTQ          
LQMSKJWBQV      : TVVNUIOQG       QCIAATQ         OOHK            OKVWCJDBTBU     POEC           
RWXKSFQAXFSMADN : OKOYMPERF       UUPMPQLKJOXJB  
OOQYBJNTTWS     : NYWXQYEIIAIHHUC LIPHFL          YLEIGVQNFJXUYX 
OPVIMVTIDM      : IICXTUBTMBTXC   AQEKIPBMGMTAUO  CVHM           
BTDNTGEEUSWW    : NPSOGIVRS       RUPGB           VELBVAW        
HKQDKLBB        : QAPJXTQQ        BACQQETIRFUQ    NVVTHMLFJEW     DFAOOJW         RUPGB          
YJSUFBXSLAMOPJW : AJYFOMMVUUTGG   FRHRHRFTTVWTL   OTINEPKISTOYWIS
NSPLPLSCEXM     : KVKBAWLQAYWN    KXWXHLCOVF      EENT            YNQPJXR        
YNTAXOU         : HIFWOSQ         GKJILRM         UKLCRIBLFKLWW   UWEWFTRKNDOAB  
PTXDVNTNWRIM    : NLNBV           UTPDBNCKCFO     YMRIQLTWIGWI    SVXQYL          TIGBW           LNIUU          
AAELUGQ         : QCIAATQ         DOYICPXSKYRF    UKEG            GDTRCBU        
TJUHFVHUQNMMN   : MNUENANARY      KNTTVWWNNASX    IFYE           
KBMYAGJNSJN     : SKPPUI          QPTDH           USILFK         
WJGNFAYAHFVR    : CCDCIQN         BWPSIDFVFO      QRBUR           KQYJRBNAKEYUSSN RBLKOMEYT       QFOJV          
PFOCSHNWWOWDX   : BMNGA           GXMV            BMOFHRAYSXTW    UXXL            FRSWSQBPIGK    
WJDVGOCWTEVTOBQ : LDQCBXUFBJTJSFY WDCXJLYALWMF    GUPFSHPJ        CUESPFVRGWBOX   QJJXFCHK        RWEGJKQANVGWUBL
DGLUKGCAD       : RSHO            ALUUJNUYLJHLY   UDYIRPPYNNWTU  
QBDOPCASAJHF    : NJKL            EBDCF          
BJEXXGQ         : WXTWQTHAVDHP    JLXODF         
LYRGJYLMEKD     : YDJOLEX         CNOCKAHURLTAT   WQRWMUVPQPTJ    QRXEKCR         VWBOCDHD        KEJXGJDQEY      BRDKAXBS        CRTJD          
LYRGJYLMEKD     : KIQKYC          GUIVJFPXRD     
PUXTUQUEBAM     : LKKIIENVV       WKBTBWNSHJBYRVT RTUIS           XBMEN          
LRCKASQLRJUE    : CPGBYESIIIFPJ   YENHL           CNRCIJTC        HVSLELHOJXCEYEQ RYAOTGLR       
GQOSVWLQUFO     : IUWXIWMBL       AUPOVETVSSJGN   UCITYD          RGPRJ           YGJPGYOOX      
CUOCIV          : YTRJBLL         KLYTPANFYXYI    RLISOJKN        BIQJHVQMRBRIFM  HXJWQKXPDTSRF  
CXBC            : LDFOXRPTSTW     RKGYCKXOCTHLORI NWFM            PRRB            PINAP           LSIFJ           LNHPVIQ         NOLTFL         
TPNFMRPUKHOH    : YWLKTTPILTI     LOPSDUWTNAJID   QJXL            IOJSNN          MEXXFTAFGS      AKHAEB         
AADFOQ          : DPWVYE          BYPIDEBDAYFGISC
KIMUEFWEGBXDSM  : VKDLDCXBJSVRVAB QXGDNOFQBQDPCYW IWBNATUIHDPVIYH YCFNMFEJ        SNIKBP          MTEECDS        
GGBB            : MUFUMWFTY       LKYEDJH         DEBKGKGBAB      YUUPQBHEIJGLO   FMVWWBOV        BMNQSTJE       
KPBQRBTASMKDWY  : AGRADRG         DKHSEFWY        QUOLWPMSYOS     XJOQRVLQONMDJVI QEUDHDMOBOGGFLE EYREIT         
BFYINAGQSUABCDD : QYSPXALPNBTE    UUEBEBCRAFPGIR  YTRJBLL         WMWPSCRGGBK     UPVLCXFR       
NUYE            : CIMDSPOYEQPOKJ  NWFPCKDYXK      YQFCSAB         ORCGFRU         QMCQGXWIAIQQ    KMRVOBPRSL     
CAPUOCAMBAPIY   : RDXL            PRCUKKVXVBGGOJX HWCSSYFNWR     
WBHNWCPXG       : VFGNPLMCW       JUYY            DEIYFOQI        NKAQBYNVYW      HEKYMSXDGP      CVHM           
DEIYFOQI        : UOLYWWDXGAPMEW  PQBCQNS         WBHNWCPXG       SVUOOJPL        PPGJYWGDBKC    
GDGKESLEKUGJTHS : YBXAMYEQSUTGTL  BFSFGQK         UKOKKCWNCGN     BHHH            LKRHTBR         NDAWH           HOALTQYQLL     
EWCFEWIKGJQUAY  : DQBHMHXOFGXBXUK YCXX            IVAWEE          JSUIUG         
IESSIL          : QJSKLWSS        EXIOJD         
PVCVH           : TROSVF          OMBT            EIFQIALGVBDFP   UMGXPJVFWCUEO   VKWXOAP         SNXLMI         
FAHMXJREHCQNMJ  : LDFOXRPTSTW     FIMFRWGS       
OIWXNPS         : PYHBSGGDEJCHITT SROXDNPGAFU     MADUBLYDXSWOOJ  KRSLW           RSCIVHJRVFDF    TOBFKG          SSYPEYSQCMGXAU 
DANCELLCRMKEMVX : RJHERXOSO       MUNPBKKWUI     
DAJSOVEEGDE     : REEQR          
VWUY            : AJCGDSGLJSGUMGB RLISOJKN        FWOSFIVGPYV    
IDEWPJOEVUSR    : VKDLDCXBJSVRVAB LRANSYW        
LVWWQMSUSABWVWT : WNYGPK          CACCQXWJQI      AAWGRFRIGAPYUXA
VTCCBYRKPXGM    : ACDCXTVDFIP     CHWAIKJH        JJJQCMFMFV      JVQUIL         
AHEXEB          : VRSYCYWDRCYNB   VKXJBWNRCNI     HBSEYXFDLEGYX  
QWMJW           : XEJJPTJRSVNLGNP RKIGGLDN        QDXNREEDL       KDLVPLNAOKHTWU  CDGJPXHRWWE    
IUKFOJBQLC      : DFOLHXUHV       FXGPM           XDKBRPVKOXAYY   DPJLHRBYF      
FOHFW           : IPLLXOPXYHKPMST PINAP           ONHEYMGTCQYWC  
VXDAVHDNBABM    : FVMLWAJLNRGYIW  VSEBBIGPBQ      KKEOHDQXA      
OVUCD           : LRANSYW         JXRNDEOLI       STNTI           SNXLMI         
LECYHVGXFLVBH   : GCDBTWTQV       KEWSQEB         TQURPJEOXBIIC   LIBE            RQDMSNXHV      
EJRNOGORJ       : HCNWFYCV        RSSTN           UGYXUF          ELRBVQ         
QACNCF          : HBSEYXFDLEGYX   QSEY            TWJJPDFFLLUUYGT
PJDQ            : IRMAICMVK       AWDFNQ         
YWREI           : VPIYKFWK        GCWXUHMAGD      BXRFVDCGEFO     YAYCDLB         HUPENDRNSFWM    TTMFELCNQQXHNL 
FRJL            : RCWUJMP         BOIWWJJHXFPTO   UXRCXPJUX      
DASLQMUUFXY     : QYUJUNMIF       JAUSXQPLPOFX    OOIIPMPUKCSK    HWGNXGBPUVNXTKY DHAHRPKEPY     
AEUSQYJLXJDDR   : OJMDHRVKSVR     LJKLKHOCEH      XYVFUFRKYHWIIP  UGWKICU         QSSXNTX         XLYFELPF       
KMCW            : VNSCFEJHBSU     SLGR            MDTLWUWXWSO    
IWKTN           : DWUPVJIU        AOWS           
RLFP            : ONYTOT          AJYD            QVIM            QTVXSJNRSVO     YHQGJMFHN       UMSBUBOH       
YPRTKKSWV       : XRWJCXJOUAVIOJ  YYXJRRHW        IAYRWMLHT       RVYUYVIKQ       KWDNFJ          BFJNGTUYRVMP    SSYPEYSQCMGXAU  GKYRYCUX       
GCWXUHMAGD      : YWREI           KKKLUBTFQKSYFHJ
DPETPVFU        : NPSOGIVRS       XWMJYUOTBCDVJXI
RVELR           : SCIJOIYYNCBWPQI ITHIUT          ETOBMC          PEPJJEUMQEGBFK 
VLLUHTWE        : SIBJUTAMAV      MWQIYJEDXQIQD  
RNHRUMCA        : DFOLHXUHV       MSEADOYBDJK    
HTUD            : AXPTVWTEFG      GXQDRSQSA       TXXICUMCYFDNYVG ONGKSDTFBSDVNWH
PPTLTHFKEQYY    : GITIQK          MDWYSADEEI      QUQIMEVXFLX     IXAJG          
SVEN            : EABGWGFPH       CSTWXIDUK       HBEGBXRKDUNDWE  DNXMOFAGCCTW   
UVKRIMTNTOI     : QYSPXALPNBTE    XBPDBJ          GBCIQUT         JXWLEGJEJTE     BIDKVSBNGTFEHP  CKGJWQSAUWTNMBI
RXPNLL          : GXQDRSQSA       OETYWGMV        NPSOGIVRS       BDFYITIYDMNJ   
RVCKWDLQBR      : OHUETG          EHDIJ           KGLTTJTVK       VKWXOAP        
QOCB            : LMHEJMHPUSKAB   HBSBVWMAKY      SBVNYYBXDD      AAWGRFRIGAPYUXA BEIY            QDXNREEDL       YPHTMFIKJ      
LOBBKRKILK      : EAREMEMQGYACRT  DSHGJOPXW       YJRFBSH         PYLOPGDMKSN     INNTGOTBBCT     CFXPIUITQO     
AWLVQ           : PQBCQNS         HBSEYXFDLEGYX   XGVFMBQSX       PPPRNNJ        
XDHBQXCJ        : SDKH            MHSB            PDXB           
UAJWJWNK        : OGANON          KGIMHU          VOQM            AQEKIPBMGMTAUO 
XEJJPTJRSVNLGNP : LYTGSJIIFDE     QWMJW           VUBLKUQE        JWNBVUDJUFKFDW  XWUNPCNDWS     
QGOURVQ         : CWRC            RGFDIESPNL      FMXTXUMQB      
FPCDFOEDUNMMJW  : CIODLXEEHLJAMQ  MIDFRPIF        QPRQENITHUXX    SMUCNAFTJ       UGAPHPP         PYBJNBKWCEEBPT 
DUUOBLGQEPF     : SROXDNPGAFU     CHTHQ           BVSVYR         
HDSCLK          : UOBDYJ          JCANJ           KRCTGTLEQ       QJJXFCHK       
OPWSUTIIHRHO    : KEWSQEB         JNCNFADU        QTMANDBAV       WINHL           XEWTM          
CLMD            : ETVKCRUIFAMEDVY SONVKYDUJLWJFJR XLXFBWIY       
SVEICGS         : QNHLTMHAP       PBFYPC          DIYVCJSCBGU     LGPLBJHGDKILMGT
BWSNGJDDEXA     : MSWOWAQUVMYEWQ  YEYY            BODWOU         
IJHPXER         : FYNAOYMJLXB     BOAPCUNGNDQQ    BVOY            SCPQFYKRF      
QWLMTRWXARFBR   : QFWXDOL         LPAGXEMYOV      MUGYEE         
QXKTDPTDEFMLWM  : AUNCWCI         RKKUPIDGO       RDEPCBAHU       WUAJSKDX       
PYJOMVKEVKGNQ   : ELVLG           WSXJOCDERPOHWNJ CXTIQOYCDYFC    TYVDQQAIOKSLRWG QGICI           DLLSQTRFVKSOPE  IHJQVXSM       
FTXDETJ         : ENMSCFBS        LDQCBXUFBJTJSFY YQBUSNNJG       HVWRP           WXAY            DQTHBCTTP      
PMBW            : BACQQETIRFUQ    BQJMDLLYYSMTB   VTESJVCUSIKOG   BMFBLEPSMYBAU  
MUQF            : KKHPLTDIXV      JBXVBMIH       
RPBENOK         : RGJRKWMVPEB     PDAWCHFKDXRN    BJIGTTQGQOM     CHTTOSMYDMNWGQW FGVGJHNNLM     
YQARAFLA        : WRYUQNTH        JBMLG           USILFK         
SVUOOJPL        : DEIYFOQI        UXLHJOMUQFE     IMIIMCIYDBEIE  
FIFMUWCYEQNQCMK : DCJG            TAVILT          ODINRPLE        YHER           
FKKSNVLLSBAES   : DTAWHXIVSL      MNUENANARY      YUOOWXCAKXUMT   CNRCIJTC        ETFNIQTPWPHVBY 
UXWALUYPTFI     : FDMAHGCD       
WLVH            : CLDBACQUEJC     WAJDVJJHHYONR   OINTKLHPAN     
DTAWHXIVSL      : FKKSNVLLSBAES   PUVYO           EVXNUYP         XAPPYOQ         TJXC           
XFMSFMUQHVJD    : PWSJVDNMBU      WDXYSDMPSGVMCKE OQEPMR          UFYDDWDVNY      WNNJOUY         BHPFYUHW       
RMYFKGVOCXNMWX  : VFGNPLMCW       ANQFCQCONNOKJMN EGERSYSXIJT     RBIWAWXEOFF     HBOYHPGWRELYNP 
PKEPPTIUGF      : NRVETMFKIXQCE  
PCXUERHDX       : KRYN            CKADDRGIP       XBFNDQG         JWSIVIHETD     
LVIPTXC         : VRWEPNFXCRHMVTB EENT            UIUYHWYR        XWUNPCNDWS     
WKJH            : CROXVA          UPBTWQMVJEU     YWLKTTPILTI     LUHTNJRWM       AFKAWKGHSG      EYMDUOBFBT      FPJQMREHB      
YWLKTTPILTI     : LLPLTITCCRYUGR  FOUMBOFFYR      TPNFMRPUKHOH    WKJH            MPODQIYMICGK   
XBPDBJ          : LDFOXRPTSTW     JTHQK           UVKRIMTNTOI     UEKLSQR         GURHC           NQAXTKJBMBEUPRH
WUHQSJ          : JRLVU           OFYNQDWDFOFOE   ICJXRXK         OOHK           
PUVYO           : BUQHTLXXN       CRQDUOFOR       DTAWHXIVSL      WHXKLRAJOGKNOLH BMOFHRAYSXTW    DHWPSDGFWP      BOIWWJJHXFPTO  
XAHSVA          : NKEJ            EMPBYGFJAFXP    EWXMGJYAO      
JTORSPHXSS      : DPNHIWLGWIHW    XYAIGTOCPAOITJG RKAOGC         
PPWIJGUBDQ      : OKQTVXW         IVAWEE          NYWXQYEIIAIHHUC TGGPMBFUYWBWBR  VXFWVDTDP      
ROBT            : OGCVTY          VNSCFEJHBSU     WDCXJLYALWMF   
VRXC            : SKPPUI          IRCRUBETQTOMEVH XBIIUKT        
SQSNICLBXDQNAY  : QEDHIXAAO       EBOQDMSAW       TAXMXKLIVUQUU  
JUDONGJCJDBG    : MQMNVHTX        FMOQPOW        
YIYTYSJH        : BXMEVKRJJDY     VONEUTHBWPGYGDC RPRLBO          WOPRNIVBSTEMKF  LPXU            BFJNGTUYRVMP   
XKUBBLECKPYNE   : RCCTXQJAADDRM   QAFYGUICVCDJ    RDEPCBAHU       PRTJJWVBPI     
VNRGTUMRWWQQV   : CKDXFGNNQIU     GXIIWB          JBMLG           THDNK          
DFJBPGCSR       : OHSHFTAIA       UPHJAYAHO       HYCE            UXLHJOMUQFE     RKNFOQG        
WDXYSDMPSGVMCKE : KCOUASNDMIRGDQM OMECMVOGFII     XFMSFMUQHVJD    EEBDNRKMWTY    
HXRFJUKUVCCBWT  : OMQIFLRNGLTWC   RWEGJKQANVGWUBL
VYKU            : RDYUXFBBLLDSVYM ALUVEO          MHSB            VRPERSWXOJQXGR 
PJKIQGXUQC      : NLNBV           QNXNS           VVXKQKD         KAAU           
AANFMLRHJTJKS   : STVXMOAB        LRJVVOLEGKV     WMOEASDGREYJ    UMMREGKNCGDP    AKHAEB         
WOHJKCYTM       : EIFQIALGVBDFP   KLYTPANFYXYI    HOFYCIK         IWPMCWTCNMHWLP 
MUFHNKFNMTSYFK  : FOGETIHYFDFSS   QYFDXEQUCDGIJ   WSDHDRGVMS      HONJDTUBIEAKUEB
QGSEB           : NFXLSOGWKFDV    BKBUUWHM        IUVQVGHHNGBCA   CHNCJYSR       
BQJMDLLYYSMTB   : PMBW            TRKSCOEOMD      SXDMKRC        
KNCXAXRC        : YVMMPXYOTAAEPJP
ELVLG           : PYJOMVKEVKGNQ   QMXECOCWPSPVFL  YDVFDJVWC       QKBKBUWJ        TJXENUGDFXLN    EYMDUOBFBT      RSDDFBEAWO     
MIDFRPIF        : FPLXGDRUPGAB    FPCDFOEDUNMMJW  ENDESRTYTYVLLB  HUWMPOCCSY      KHISKQRCJVPULME QYTAA          
KGWWBXUNLY      : MHXEYBSD        IJQVUSIJECCM    CIHNW           GLKBXXSLPJIW    KVMTAPCBFRO     BEHPAKXOBR     
NWFPCKDYXK      : NOSMOQCIPBETJ   NUYE            FEBVLUNLDEAV    QIGSKREUR       VSHBKAYGQAVCI  
MUFUMWFTY       : GGBB            MOKRQGTW        XGIQAHXAOJ      QXITL          
BXMEVKRJJDY     : YIYTYSJH        EXESTFCEYX      GVNUAQWOMB      QPLTMFPCU      
JRLVU           : WUHQSJ          SROXDNPGAFU     NEOVMOTAAIEETC  EDGYNPNFJDK    
VHOICVDOSJJTBMR : OSVDJAHQOM      HHFX            BPDQXA          DAYIPUCTJELWH   IEAAH          
QPYIBKL         : YDJOLEX         MKXPHJGXAET    
RWSESNSOVHAXFF  : NRWDGQMVAQMHKBI QSNPQVKKE       GHXQYXMRHEBY    QDJQUFTBKQFDEX  CHRJJIWFYFGVA   QOGDPSRHQBLXQ   JRSFFQBQ       
YQBUSNNJG       : WPJGQNGLAWVPI   FTXDETJ         NQVGBPNWKMUEXO  XYVFUFRKYHWIIP  XFHJXUN         WQOYVFC        
KOFUAIPABVU     : HIMHBSDAGUXMR   SIGMBEY        
OKOYMPERF       : LVXU            NOWX            RWXKSFQAXFSMADN LOLCGKISMAP     JLXTKH          XRQVE          
LIBE            : FIMFRWGS        LECYHVGXFLVBH   RKNFOQG         DAYIPUCTJELWH   TTMFELCNQQXHNL  UBQXGUVCIPO    
OPETASBUUJKU    : DLNLJV          ORHJNVMOIMXQE   UDVGLHKSLEEO    NRCVFFUC        HWGNXGBPUVNXTKY
GQEXDSWRIBL     : ONYTOT          XYOESQJKYUR     MXDX            HDTJV          
HWAID           : TWQIXLHFCN     
YSEUSYWQ        : BGDBQPMQEDEUQN  QPTA            VVXKQKD         XSIEWPNQ        UTJL           
IDRVMKCKPWHHGK  : VWTSFSDSH       MWQNYACTGWNR    DBMCHYHBF       BENEDVWEPYHA   
VRSYCYWDRCYNB   : TROSVF          AHEXEB          TLHCWHEBDE      GPCFTM         
GXIJ            : WJNQVYBJ        VBXPUEQ         MUMKXSFOAWL     LJXRSB         
GVDIIVGRF       : EJFAUFOFUYYIN   EENT            NNDSHAQPU      
DBMWWLCVJFPN    : TPFMUVNDTBLMNBX GQAY            JRSFFQBQ        IXAJG          
DQEJPNVKTRN     : WKJDEJBSJ       CCLPKFQWAVR     LJXRSB          YANDODJDRSFLJ  
BLNU            : YWAFQ           MRLGVIVEUUSS    FLMEXKXITMYFFA  IWBNATUIHDPVIYH ORQSXPXOSP      NDVDSXIFFWWGNAX
CXSOXPBAL       : JCUAMNST        QLLCFAXEI       ANWEIHDP        HCMHYIFUBDH    
FCAMHSSTKGPU    : MGHDKWHJY       PLRV            OGANON          FBVVRCRWR       RWYKFVVVITLST   KBDIASQLRQADX  
HLKKWXGOAGI     : XSPKUKBAV       BOPROFGT       
EAREMEMQGYACRT  : LOBBKRKILK      JQVOUKHBA       DHAHRPKEPY      JWVJFPMKYHAC   
BJIGTTQGQOM     : KRYN            RPBENOK         FMTDVHEWUDLBIF  NRCWTTQRCTC    
OVQFCQXH        : LQGQ            PRAKUUNDB       XGWNASYKSUN     WSEHBNNI       
EVXNUYP         : XWTCQC          DTAWHXIVSL      EWXMGJYAO       UGWKICU         POAS           
SCRDMXY         : MQMNVHTX        ASKHBXIMBT      BYPDG           LXGTMPWJRNWQC   LTSO            JUGMJMCG        RSCIVHJRVFDF   
OFADUIT         : JJPJJ           GIADKEDIU       TMLFBXBTGHBSITF UFYDDWDVNY     
BCSTCCCGX       : EMSREBF         YLGVJNGNTT      NRILAKFWXQC     TTMFELCNQQXHNL 
VUBLKUQE        : XEJJPTJRSVNLGNP MOKRQGTW        ROYRT          
DDBMTGOABWTRA   : EXIOJD         
NTAPVJO         : JTHQK           KAIRCTVYJKVQSJN RMEFHJLHRNBMQ   TAXMXKLIVUQUU  
FLATXWMDYRGAGC  : GCDGQDID        NIUFIBOPYBH    
UCITYD          : GQOSVWLQUFO     HFJSKONXDYEF   
WQOAIMJYLQL     : VFGNPLMCW       TCORVGQUEPLTUV  XOQPNMKNIVDIEPA SRGXBVRVD       RUTLHHBKH      
MJNYMN          : EUWLU           LWDQXLNMRMCEIJD RWJAQKGOF       DOHRCIGQDKVAI   PYLOPGDMKSN    
UPAXYVCKPBN     : UMGXPJVFWCUEO   BPAAEUOUJQSLEY  ORMBHIPKSTWOJQV XFHJXUN         OFNKEWFV        BHVJCHQWCGYXK  
BGDBQPMQEDEUQN  : YSEUSYWQ        RAQXWQMPAMJWGLU PRRB            FLJAKRUJNL     
RDXL            : JCUAMNST        GYGEEOEBM       CAPUOCAMBAPIY   TUJDKNP         TQITUNNSJBUN   
OMAPIFA         : TOLDWYSVTQYVVV  EAEWYUCXLYVBJEV PKKMEGMHJA     
INOJVRMNKYGOFK  : LFFVYUG         XTYEUAYAY       SNBCMXUMULYTUXD WPQFSLWEADAJYFB ROYRT          
VATN            : NKEJ            NHVGWTKBLOABHQ  QYXSUK          AWBN            PHILNHEVJXUTON  DEJK           
SCIJOIYYNCBWPQI : CWRC            RVELR           BBTN           
IVEUWKLCWWA     : XQWYLOOXSAOQG   HGNKVCCGW       XNURCBYS        JDPSM           FRGEGV         
RQDMSNXHV       : THLUGIYWLBKWF   LECYHVGXFLVBH   HGUWWNXOEYFT    XWUSALAMGOUA   
GMBJ            : YLEIGVQNFJXUYX  OMSVDW          SSYPEYSQCMGXAU 
TAVILT          : FIFMUWCYEQNQCMK HEKYMSXDGP      DODGVTHQUBC     HLIGVCQUIGKTW   MWBJBRHWKMJI   
GRYSVVPWSJNX    : TCLORHPWNYVDPV  DUXBOVHKNPLKHT  GSCBC           POAS           
INVPMVXYWHMQK   : XNCFSHBL        XCOLFVTRL       FMXTXUMQB       RDEPW           DEJWSMTQGWQXGM 
BVFP            : JEFQTKVDQ       AMEKVN         
YOYUMPTIB       : OIMXPUMM        KEMTBDHCUKXQ   
IXRWV           : SIWVCSECEACV    NWBUUUJAI      
JRJKPTW         : USCXYGVAIATT    JEGPRKKGN       RVYUYVIKQ       XRTA           
EJMCOCGPTGLGXHO : FGKDMHRCGDU     DXRLKUHXWXQG   
RXYJUVTEN       : EWCUSQALSYDJQ   BLGYKP          YJXVIJHRHPHEG   HYPLHQKULDPWA  
OFYNQDWDFOFOE   : WUHQSJ          LUHTNJRWM      
WPGUX           : ECTMCXEMUJ      CGHUIRWRPRRBRM  HBSEYXFDLEGYX   XNCFSHBL       
VRUVBPTWTJDKR   : YLWDXGBAOLXO    BGNT            OPKRYRVHFBEHTU  WCNGTSMANIDB    QPRQENITHUXX    IVYMUDJFT       QRSP           
XIIVLPKSEQUDHDX : DMOFJY          SDWNCRE         SKPPUI          KMRVOBPRSL      NWMIQ          
AWBV            : FISDT           ROVMWHD        
CNOCKAHURLTAT   : LYRGJYLMEKD     RNYOMCN         CWQWXNII        XVPOSRLNNMSK    AALDD           ASVNIB         
NKEJ            : FKGRP           XAHSVA          VATN            EXFJT          
UEUEJ           : ETVKCRUIFAMEDVY CLAO            XGIQAHXAOJ     
NJROHMTVDVGEF   : UKAVQ           OLWKHYYYXFR     BYPDG           WTEAHIXJBRTHAL  CNEOYRNE       
XQWYLOOXSAOQG   : IVEUWKLCWWA     AOQSDB          FSBNHKIYHTOHNX  QEOCUOSPWDMDR   JUSILPFULCR     VEIAFUMIAEBO   
UPHJAYAHO       : XFLOS           DFJBPGCSR       MOKRQGTW        ENSE            IXTAHF          HMLKFVBSBBEVSM  FQQJVASJLWXWM  
FTRLXYP         : RKIGGLDN        GYPFGMKXWKHVU   UELPDUOXGLG     AFMEPYED       
QMXECOCWPSPVFL  : YLMRYIATME      RDPCJTHBJUWMYVQ ELVLG           QSRI            TREPATDJQUDDIU  TYVDQQAIOKSLRWG
MWQNYACTGWNR    : ODYQAAG         CJBPC           IDRVMKCKPWHHGK  TKPRL           CACCQXWJQI      PTRKSOVMJUVUJWJ
NHVGWTKBLOABHQ  : VATN            TGGPMBFUYWBWBR  QEUDHDMOBOGGFLE
OENBBGRCHTVNS   : UXLHJOMUQFE     FLBOAKYDRVYVA   HEFYMV         
HQCRM           : JDJTDRNMSKEPY   MYPJHR          FAGIVKVAWKYHPG  FOBGVNHSKNLRY  
OJSPUJPXSGYIK   : YLWDXGBAOLXO    EBRHVUGTJGGJXX  DWKPBGCQA      
LNVDQ           : SJEQYOXDIAUXH   XBTGJXOWP       WGJVYXS        
AOQSDB          : TDBSNTVFD       BUNDTYS         IBTKSTUIT       XQWYLOOXSAOQG   OQEPMR          DDSGLJSVJEBTNYH MXQGMNUJCKGD   
FSBNHKIYHTOHNX  : SBGHLLYYMF      IUWXIWMBL       XQWYLOOXSAOQG   RWJAQKGOF       CHTHQ           TEOG           
VKXJBWNRCNI     : AHEXEB          UWSCVMTHD       VQAEJ          
IMWUTPVKWIUVR   : YGNJ            NCNTUVHIGGOOYY 
MBDKJBXIKYHAQ   : UFQDSIORU       TTXUPRJJ       
PBFYPC          : SVEICGS         XBBEQV          DVWEPXX         RSDDFBEAWO     
KRTW            : HBSBVWMAKY      ERKAKFW         LSMHPILM       
EROVHEWMOG      : TJNMRINTLSWL    QJSKLWSS        YRYNJFSHA       HKDEEFSQDBNGPP 
OQBN            : XCOLFVTRL      
BGKRIPSASOMMK   : JCUAMNST        YBXAMYEQSUTGTL  UPPQHR          VRWEPNFXCRHMVTB UVQR           
GOEUKL          : XWTCQC          DODGVTHQUBC     UXINTHCFIVW     PFJDBCORME     
JBSRQHJRV       : OFLIJB          ANWEIHDP        TABDLJENXYX    
VCTPMMIPFYCTJOA : IQHBWFPOATVXEBT MKAQKIFVQQ      CFXPIUITQO     
SXKGYTHTLY      : FMOQPOW         PUPUYPMIGUV    
WSXJOCDERPOHWNJ : PYJOMVKEVKGNQ   OVLBIEKVNTHE    YRHGVPJHIR      TOBFKG         
WXTWQTHAVDHP    : YHIGTQF         BJEXXGQ         SLGR            JEVJOQH        
IRQCR           : THGMF           DGVPSENLMWIY   
SWGAO           : TFPJGQSWR      
OVXDHRC         : RVROU           CKESKGTNTGSRQCI KAHLDHPHCB      ICXAWBAVHXTLLG  DJTWXWEGMRY    
NABI            : QLCH            WWHAK           MEGS            SCOPR           NRILAKFWXQC    
BGNJXHTSXXKYR   : QAEDHQT         NUCJPWWHFGFKRVQ
FRXFGVDLGUOO    : IIGLE           XIIRQLSTEUYA    JAENHLVF        EXIOJD          IFYE           
QPTA            : YSEUSYWQ        LIXCQ           PWQWPQYMOKKVH   PEPJJEUMQEGBFK 
CPDAWYSXXGWPP   : OAKS            ADYQEW          JSEQVREC       
JQLROPEUMULXNCR : HBSEYXFDLEGYX   HIFSVGDQDYDPN  
VVGBYFARDXAC    : VBLBMLWWFCDDU  
SIBJUTAMAV      : VLLUHTWE        UVJWHFDS        HBOYHPGWRELYNP  QPWAXXQLSQPQONA
WHXKLRAJOGKNOLH : PUVYO           UGWKICU         KJCWDEEA       
LKYEDJH         : GGBB            FRHRHRFTTVWTL   UGWKICU        
EBOQDMSAW       : JTQEWVR         SQSNICLBXDQNAY  CKIKW          
KKKLUBTFQKSYFHJ : GCWXUHMAGD      OFIGICLCQ       BBDYKIFBAS     
LOPSDUWTNAJID   : TPNFMRPUKHOH    LIPNKRA         EVPBX           BKALFYGOR       PRTJJWVBPI     
BNSMBNNVTF      : TIIQL           IWPE            YANENNEECDKFFYC
MGNVRTH         : YSMW            NBBIPWKIVK      RXBD           
MDLHAHW         : VAITAQEHW       TBLLQW          LSLNB           IVYMUDJFT       PCAJOWDF       
QIFYJVUVWIMU    : PCXPNRJOPUXPVC  TROSVF          FRSWSQBPIGK    
TCTARPTOXA      : YNSTPWUNKY      KSFASGQBVQNJJCD FEBVLUNLDEAV    FNHILDLJXXC     LHSTXOLYSOWKXQ 
DNKFUJHO        : DQSHYLRNEG      XDCVFPUJ        GTASDFMHQ       UPANVTOKDN     
PPCLKAKVO       : TTCWPHKWMVIME   SBVNYYBXDD      TEOG            MKXPHJGXAET     BEHPAKXOBR     
AIKT            : GURHC           NPRI            NISWI          
CKESKGTNTGSRQCI : YJHPOXHSCDOMFH  NHRTBCVSGHHMUI  OVXDHRC         JXHKJGC         NRILAKFWXQC    
RAMF            : SIBIKYI         HVSETNXYT       MXEMIPAYSQW     OOHK            PPPRNNJ        
PSJEY           : ADUMWYBDPQI     EEBDNRKMWTY     OYUSOFKXMTT     FIHSBDVBOE     
NJEANQFJBNF     : ENVQAUCYQ       SIBIKYI         LYCBRYODDDJ     JTBLQ           CCLPKFQWAVR     ULJDWXBJJW     
IMJCDLMNGMB     : JTHQK           ROLJOBOPYNX     VKWXOAP        
AQGJUFVKQCL     : CJNKVYIRDPST    DIBLMJIVSIJU   
SSSVGXMQ        : EDGYNPNFJDK     USQU            MWTSP          
XSNJHERU        : RSHO            IYDJC          
GWXOHUWFGPHTYCO : YDNSJV          IJSWH           RITNOGDGX       DOYICPXSKYRF    IQRYP          
AUQMOBKJRVR     : TDBSNTVFD       GNJOKKJQYGVQB   RHRIBIUHG      
QMDYJBNSVKA     : OLWKHYYYXFR     ICJXRXK         HHFX           
BHAA            : JTQEWVR         OORVGUEGDXGI    QTTO           
OSLMLABO        : VBEIXV          QPEJ            DAYIPUCTJELWH  
KILCECQJBDM     : HXGXHK          BXRFVDCGEFO     EXFJT           IOJSNN          QPTDH           ISENHSSULPGI   
XJCYPFIQHUFCGTN : SMSTXEKM        EAORLLTQJDREND  ROYRT          
UDVGLHKSLEEO    : TROSVF          OPETASBUUJKU    VGNIMX         
RGFDIESPNL      : IKXHHVOSAB      QGOURVQ         OSBA            HGJVBLSK       
KRASLPCJSBR     : FULAIT          WWGXWENK        XBTGJXOWP       PLGY            EUVQYCTWK       GSRCBMIPDBOG   
KCCWGGL         : FXDOBVX         YDPKOECCWFLNA   HEPDSHTLXF     
XRVBCCWRR       : XCQWYKPFLW      PAYPYIDRUXLOJ   LCSFILXB       
RCCTXQJAADDRM   : XKUBBLECKPYNE   OQEPMR          HDRUEDCLIKPBQNI UMYXWG         
TOLDWYSVTQYVVV  : OMAPIFA         MEGS            HOLVOFGIXVWWV  
PFKUH           : MDOIDY          PYLOPGDMKSN     RHRIBIUHG      
SXNUASY         : QYXSUK          THGMF          
FNOVB           : GSXWLRSY        DSOTYWRXQP      YNQPJXR        
TCORVGQUEPLTUV  : MKWCCS          WQOAIMJYLQL     UGTG            RKMDLMOUARVQY   RCUPTHYTOCCYMKR
EAHFNFFHEAO     : JSYOUHS        
OLWKHYYYXFR     : LMHEJMHPUSKAB   LAFGLS          NJROHMTVDVGEF   QMDYJBNSVKA     YEYY           
LHEGEC          : NOSMOQCIPBETJ   YXNLS           HPJJAVSIT       WLIEHGAVHXSPG   SOBBTMHC        KOHKQVROJVJDW  
JEFQTKVDQ       : NRWDGQMVAQMHKBI BVFP            NDPLF          
SMMGLWNMY       : QEDHIXAAO       NDPLF           RXRWI           YLGVJNGNTT     
KGGDSQJYUNVGR   : GBCIQUT         IQRYP           JGMUYLCBAN     
WMPVPITIUJQG    : RXUJJABDGIJQ    HEFYMV          YPOEHPWABUR    
GTHUGOEKHUV     : TWQIXLHFCN     
RKGYCKXOCTHLORI : CXBC            RDYUXFBBLLDSVYM TIDI           
JRGPLQNTFREOOBY : OMDC            USILFK          LKRHTBR         LCCFQGLJKMBYK  
LFHPRIHUCOIS    : QLLCFAXEI       DKSLCXDMEG      DNXMOFAGCCTW    IETCAWRLRKHMQFE PWQWPQYMOKKVH   PKESEMRVVNIYX  
QSRI            : NJSLIWXCQFW     QMXECOCWPSPVFL  HDGGJJYWQX      ALCMWBQ         WQGBFIRBI      
IVSVQXP         : MQMNVHTX        MRLGVIVEUUSS    KYQMLXJJPEQIAX  NXMLJSNBUFL     RHRXT           KNELCMQM       
OGANON          : UAJWJWNK        FCAMHSSTKGPU    CCDCIQN         NKAQBYNVYW      UGXBIQH         PRCUKKVXVBGGOJX
YENHL           : XFLOS           LRCKASQLRJUE    BOPROFGT        VCNBWHAEWWWMXI 
LCSFILXB        : ENVQAUCYQ       XRVBCCWRR       JXWLEGJEJTE     MXQGMNUJCKGD   
ALUUJNUYLJHLY   : DGLUKGCAD       LYCBRYODDDJ     QCVBA          
AUWGI           : YYHPBW          DUXBOVHKNPLKHT  QKBKBUWJ        FJVQFHVEVNXXIP  XLXFBWIY       
RSSTN           : EJRNOGORJ       MWTSP          
EYXHXBSTVCHT    : UERFN           UGTRG           IQJEMG          MXIDDKKW        ALEHQCIDHYMCY  
SDKH            : XDHBQXCJ        NOFPY           KGUBGWKRB       VDYGEUMMWRK    
JJXIPIPJD       : QUHKTVAMBS      NTTDIXOTONFAYBW SQEIUWRVWHKEC  
FQILRITQJOK     : TXXNINVMFWNPX  
TTCWPHKWMVIME   : PPCLKAKVO       EXESTFCEYX      CFXPIUITQO     
UTLXESOMEJVAAH  : LFITXOBUF       LLPLTITCCRYUGR  OIMXPUMM        JAENHLVF        MNPKF          
MRLGVIVEUUSS    : UPBTWQMVJEU     DBGNELVFLNRQLFU BLNU            IVSVQXP         NVVTHMLFJEW    
GAFBTQCBJSP     : NRWDGQMVAQMHKBI UUKL            PVDAHFARDL     
CLSEVKQPVA      : NDPLF           FHDFCSEWFEYEHN  FMTDVHEWUDLBIF  HVFSBSEBSGLK    RXXHR          
HVSETNXYT       : HCNWFYCV        RAMF            CWQWXNII        OEHABNEJJJP    
FXTVAUISLBVYT   : FIPYIQVI        FNHILDLJXXC     TATOALYADBSV    QROJWAERBVXB   
WFTPBTEKRYPLMN  : MOSTFIUR        KAHLDHPHCB      ENLGULI         HDTJV           QUQIMEVXFLX    
HNSFJQHHYA      : GCDBTWTQV       CCLPKFQWAVR     OHKGY          
AXVW            : DTBMPCPUTKI     USMRBTCYRHF     QJXL           
TCUJFQPQIO      : GLIYANNEMIYDJS  RXLDINYNWXDRD   SRSOWERGUITUYC  WLIEHGAVHXSPG   PPKJHDNCFGKDYAV
WBXKK           : NNXMDKY         ADRDTKQIWBX     GYDJECPHM      
DPWVYE          : VNQN            YDHHRONS        AADFOQ          EJCMUDLCGOMKGHG PMIWERDINABPA   UBQXGUVCIPO     OMEJMBFO       
AYXAVW          : AUPOVETVSSJGN   GRBOHDM         QCTTDC          WKBTBWNSHJBYRVT
RYXBHOSAAHIW    : QFWXDOL         FAGIVKVAWKYHPG  RXBD            MBHVHKNTPMHBQUC GGWXKJKYVPXRRPX
GJTTOLQKLVIN    : KOAOBPVP       
JPSGRKIRNPJGPJN : CIMDSPOYEQPOKJ  TVWWDNE         FSIMBLKIW       XBDIKMASGREYXVL
IYIRUC          : HYCE           
GUSTSEJQNAJVTW  : NKAQBYNVYW      WUORFCSUBVV    
LKVUTNG         : YLMRYIATME      DXISX           XFHJXUN        
POIXIDCQMXMIQS  : POAXB           RPGVJBKKTAEO    UXLHJOMUQFE     SCOPR           WEHQ           
HIUTEOQLCBJA    : MXIDDKKW        GGHNKTXFHQS    
XGFNVNOGTQX     : EUVQYCTWK      
OMQIFLRNGLTWC   : HXRFJUKUVCCBWT  BTPMEQKFT      
AGRADRG         : KPBQRBTASMKDWY  SKEUANKRHGJWUU  XYAIGTOCPAOITJG
FEBVLUNLDEAV    : NWFPCKDYXK      TCTARPTOXA      AOMKAAJNXQUHJU  SBVNYYBXDD      CVHM           
HIFWOSQ         : TJNMRINTLSWL    YNTAXOU         SCOPR           KHEGPVJVNNUYA  
XYOESQJKYUR     : GQEXDSWRIBL     FRSWSQBPIGK    
VORSEFXIFTXM    : JTQEWVR         LMHEJMHPUSKAB   OHSHFTAIA       TAXMXKLIVUQUU   QBFNUF         
DJTXCIVDYAVP    : OGCVTY          XPXWML          HBESXQ          GMLQIEP        
IQHBWFPOATVXEBT : VCTPMMIPFYCTJOA TPHODIMSMDBUIXW XGIQAHXAOJ      EESLNETQITFXGY 
PYHBSGGDEJCHITT : OIWXNPS         SAUGJHHIFQV     UYWURKAIJFKBC  
KDRIIJYK        : XFLOS          
XKKYE           : NOSMOQCIPBETJ   MDCS            ROYRT          
RDYUXFBBLLDSVYM : VYKU            RKGYCKXOCTHLORI SNCQYF          JVMBI          
MPHUASVKYTU     : AHCVQUG         FFWEIGXKYERVP  
VCCPF           : NCKMQXSY        YYXJRRHW        CTKWROUFGXJC    GPCFTM         
KGIMHU          : UAJWJWNK        CFKLJXBYUGPPMCD
NNXMDKY         : CLAO            WBXKK          
TVVNUIOQG       : JNCNFADU        LQMSKJWBQV      AJCGDSGLJSGUMGB HHFX            YTJOG          
MIEEPGPVQEGLGT  : HCBRQIIBK       USPLKGDNDYBWAEU PPRX           
EIFQIALGVBDFP   : TJGOEGMGX       PVCVH           WOHJKCYTM       XOQPNMKNIVDIEPA ODOBHWBYE      
LRJVVOLEGKV     : BSPR            AANFMLRHJTJKS   LXKNLDSOTV      FRSWSQBPIGK    
QJSKLWSS        : LDTBHDEAIRMQDF  PBLARSYVFCLQT   IESSIL          EROVHEWMOG      XNCFSHBL        UXLHJOMUQFE    
DTBMPCPUTKI     : AHCVQUG         CIODLXEEHLJAMQ  AXVW            IBAKRLOCOJESIUE
UEKLSQR         : XBPDBJ          HGUWWNXOEYFT   
OETYWGMV        : FGAY            RXPNLL          XGWNASYKSUN     ICBRQMCHFQ      PINAP          
GLFANTPRLN      : FVMLWAJLNRGYIW  VCNULRLBOQXSUG  UTALK           VQACDVRHRUCRGI  QYTAA          
WXAT            : NDVDSXIFFWWGNAX NWPIKIM        
MHXEYBSD        : HTQFJANEPQAO    WSOCWS          EJFAUFOFUYYIN   KGWWBXUNLY      GPCNJVLROHADI   IGBA           
TCDHXENJ        : CMQPH           RKKUPIDGO       TXAJJEGWNKHHGB  EAEWYUCXLYVBJEV RWIP           
PYFFTTU         : CSTWXIDUK       RGGLWKPA        XNURCBYS        RBBYQSBNLWUKR   HWGNXGBPUVNXTKY LMPUFMUGHOKGIN 
QVIM            : YFATFSHK        YFKHRD          RLFP            EOMTF           JVQWWHUUVN     
XTYEUAYAY       : INOJVRMNKYGOFK  OOHK            WMBP            EFXWHXDCOXLGSY  WPVUMJAR        GUDKNOWTMLMSTO 
CCDCIQN         : QYSPXALPNBTE    ETVKCRUIFAMEDVY WJGNFAYAHFVR    OGANON          SNCQYF         
GPCNJVLROHADI   : MHXEYBSD        XCOLFVTRL       EHSMPAEASBJIH   ORMBHIPKSTWOJQV
YJET            : EXMHPSRQLU      QINVJGREPLOVGQ 
ETKAX           : SUFOSRCGXSMXISG ASQJEG          KNELCMQM        UPVLCXFR       
DCWTQ           : CROXVA          FISDT           FNHILDLJXXC     KNUWGSY         GPCFTM          GDTRCBU        
CGYRPWFJMOL     : CVGDDUMLXJULQ   AVBBXE          XRKELPTKXCFWYLN
YMRIQLTWIGWI    : PTXDVNTNWRIM    RITNOGDGX       LJKLKHOCEH     
ALUVEO          : CRRMIEP         LDQCBXUFBJTJSFY VYKU            DLHYUB          WWYYCJR        
MNUENANARY      : TJUHFVHUQNMMN   FKKSNVLLSBAES   CFKLJXBYUGPPMCD AJYFOMMVUUTGG   RWIAW           MVIIUYUEOYG     OBOIPGBJQ      
QLLCFAXEI       : CXSOXPBAL       LFHPRIHUCOIS    EHDIJ           FMXTXUMQB       VOBOY           TUFRBC         
CSCE            : ISAYWYUKDVSKL   VHNODUAWVMFI   
WBKODWEXBRBORSQ : WSOCWS          QNXNS           CNRCIJTC        EAEWYUCXLYVBJEV
JCANJ           : HGKWCXMLARBFWP  HDSCLK          WPJMXQIDLX      HDRUEDCLIKPBQNI UDUHG           USQU            PKBKFPVANXSCXW  HOALTQYQLL     
MOKRQGTW        : MUFUMWFTY       VUBLKUQE        UPHJAYAHO       JOXOXUW         IJSWH           YNGISTVFIYUXC   MVEUAK          TFQJVNEC       
MOKRQGTW        : LWFGCQHRG      
TXXICUMCYFDNYVG : HTUD            VONEUTHBWPGYGDC VRWEPNFXCRHMVTB
IJQVUSIJECCM    : JTHQK           KGWWBXUNLY      YDVFDJVWC       IWMDRESJUG     
AWSA            : WNFDLB          TCUNXWUJJOQ    
BESPHR          : TQEHOYMDAOVNLSN GNCADUD         XEUYAQTU        UJDFPIUUCQYKOGT
KHUJOKRAB       : VWONKXTCLEML    RWGHUAUTRAQIA   FHFVHFNCSO     
UUYHBDJNC       : NERXHKYARPN     WDLMEEP         TXXNINVMFWNPX   TLDAH           JHOXPG         
MUMKXSFOAWL     : SMSTXEKM        GXIJ            JJJQCMFMFV      KBDIASQLRQADX   JRMUGOFNM      
GIWUTQW         : JTQEWVR         DTVRAOJGSP      NWBUUUJAI       ODOBHWBYE       GUDKNOWTMLMSTO 
GURHC           : XBPDBJ          AIKT            JEGRPYXJE      
LNIP            : RQBLVRHAJ       IQSQPPWHVCLGCTW BJEVXIWDQSKB    BYIRNOUYW      
VNOIL           : RMATGEJTXQX     SVPGTKXJDGBFTUJ
NCKMQXSY        : QUHKTVAMBS      VCCPF           ROVMWHD        
QSNPQVKKE       : SDWNCRE         PPHOQXLMRB      RWSESNSOVHAXFF  DNVCAUFMAFE     LEPMXHYYMXTWF   QKSVUUGONSS    
GRBOHDM         : AYXAVW          DXRLKUHXWXQG    PATJRAHWJKLXLA 
TUJDKNP         : RDXL            WDJR            JQVOUKHBA       DODGVTHQUBC     HKQNHPNVOCA     THGMF          
ENSE            : UPHJAYAHO       IJSWH           EDGYNPNFJDK     PGUCXWHWPRRXLLM
LYCBRYODDDJ     : NJEANQFJBNF     ALUUJNUYLJHLY  
GAEJ            : ECTMCXEMUJ      PPHOQXLMRB      QIHN            TFUTFMCKMJY    
CFKLJXBYUGPPMCD : UQEN            KGIMHU          MNUENANARY      QEWKNSETMXLEAO  PMGN           
HHGGVJLYUIGU    : RDPCJTHBJUWMYVQ GNCADUD         BWXWKVKU        OSCIYMYILHQ     UUKDDAQGINGFOFI
RKOXXCJVEIS     : AJWYJKON        VBXPUEQ         NXMLJSNBUFL     VKWXOAP         ROQCHUT        
AJYFOMMVUUTGG   : YJSUFBXSLAMOPJW MNUENANARY      HKDEEFSQDBNGPP  UGYUALNR       
BOEYDX          : BHSNSVQBLRBRCGV VVLI            FOCVIHVQVG      YBXAMYEQSUTGTL  UPPQHR         
UVJWHFDS        : SIBJUTAMAV      RCLTUYQDULV     XXAY            HPBUDWRFSDLMU   KHISKQRCJVPULME
RSKQABGMAD      : XRKELPTKXCFWYLN CXVUHPCFVCXDD  
TKPRL           : MWQNYACTGWNR    VCYVOYSCVL      QXGDNOFQBQDPCYW LAERIYHAYLCR    SSYPEYSQCMGXAU 
XMKWYFUIEDOIVP  : AUSJ            LMFWO           EDQGMPTELVU     YIYUQBCLB      
QCTTDC          : AYXAVW          OFLIJB          XNTXEYX         EBDCF           MEXXFTAFGS     
DFQAPIREPQQ     : OLFCSDFOE       VWPK            BBTN            KHJUCENANL      FPFOPKPFCBM    
PPFKYJNPTLHW    : LLPLTITCCRYUGR  VIUTHGYDNDSSX   HONJDTUBIEAKUEB
JSYOUHS         : EAHFNFFHEAO     SEMTSARJQF      JRSXMWIL        RKAOGC          XRIBUG         
AUSJ            : IJSPVUVPIFDQBPP XMKWYFUIEDOIVP 
YYHPBW          : AUWGI           HGNKVCCGW       NWPIKIM        
GIJRXBOMILRT    : IXTAHF          JVICUL          XWMJYUOTBCDVJXI JYUWGSFIP       TJXC            BHHH            ANOYEDALUDTRF   EPHKLVWNW      
QIBADDBXXKPYL   : YRWRAXSNSHB     PGFTFU          MVIFH           CCLPKFQWAVR     IMIIMCIYDBEIE  
PMUAUFJODKDRU   : KGYQO           SKYOMCXBNC      JTCAXKYLL      
JOWCYADDGED     : EENT           
QSGEQ           : FCWJQMCSR       JLACNA          QYXMXU         
QNXNS           : PJKIQGXUQC      WBKODWEXBRBORSQ
CXTIQOYCDYFC    : PYJOMVKEVKGNQ   SXDNLHCHWQB     IJMWABBQXJ     
IHFOLMFESJW     : YHIGTQF        
CMQPH           : TCDHXENJ        IEGBJ           RXCVNPDEV      
TITCBKEDPDIRC   : MPTLQFOIHSIEX   FPDXXFAPXKXYWD  RNXBUCMSJQ      YPJC            IUVQVGHHNGBCA   CJEMQ           YFSCMIJ        
CIHNW           : KGWWBXUNLY      AFWJU           DLHYUB          LTSO            BRBD           
TPATICGBTOBOW   : HBSNUMCBKTHFOAX SXHWDYA         ELIK            GWNFM          
SXHWDYA         : HGKWCXMLARBFWP  TPATICGBTOBOW   TXTEEYOQXYATL   ENSUIUFYYQXT   
SFJUNTKKIHCLBMP : KQXOUJWCKQJJOPF ASQTLKUPBLR    
NKAQBYNVYW      : WBHNWCPXG       OGANON          GUSTSEJQNAJVTW  IBAKRLOCOJESIUE TBLLQW          DLLSQTRFVKSOPE 
DVVROBBKOUWBG   : YHKDBTUXVNCTYNW MXEMIPAYSQW     TWSRSR          RIEKGG          PMFSRNSOWNF     JQDMBNO        
FRHRHRFTTVWTL   : YJSUFBXSLAMOPJW LKYEDJH         SROXDNPGAFU     YRYNJFSHA       QRSP           
SKNVGLPXNT      : FOGETIHYFDFSS   DXISX           QTVXSJNRSVO     DTLAQ           ARLDSNYIX       USILFK         
EQHIW           : UXRIXQNUIJYN    MYHDRPNMCVFEIR  CWCCARGP        EYREIT         
NQVGBPNWKMUEXO  : YQBUSNNJG       NWFM            BVSVYR          EEWQKSRRRFLUTUP
LEVTPLR         : MDQAPFGWM       HLRYLGKRBCNE    GCBMMWRLMTQCU  
HEKYMSXDGP      : WBHNWCPXG       TAVILT          RXLDINYNWXDRD   UROUVGIEE      
OSPDPA          : IXTAHF          MDWYSADEEI      MQSDPRPPMLLDOT  RYAOTGLR       
KGPBDDHBXXN     : QUHKTVAMBS      WGJSEILTWHEV    PPGJYWGDBKC     CUESPFVRGWBOX  
DWUPVJIU        : HCJQUGM         IWKTN           DKAASIFSRP      QDJQUFTBKQFDEX  BOAPCUNGNDQQ    HGJVBLSK        EYREIT         
RMNGFDLWFDKLVLR : XCCBQNYQKDUHK   SIHD            JGUNMWBFKQJX   
TSWTIP          : VWTSFSDSH       XIJX            FIPYIQVI        SAUGJHHIFQV     PCMJQMYML      
GKPEVAB         : AFCKQKEKHKGPSFX RNXBUCMSJQ      GSXWLRSY        VNCURBCNUMC    
RNXBUCMSJQ      : ENIWJOTLPOHSC   QAPJXTQQ        SDQVTFLYRBAYCC  EKEXXCIINSVYAO  TITCBKEDPDIRC   GKPEVAB         SRSOWERGUITUYC  ABVVR          
RNXBUCMSJQ      : WRVNM          
XOQPNMKNIVDIEPA : FPLXGDRUPGAB    WQOAIMJYLQL     EIFQIALGVBDFP   VHLGVBVNSR      SJIXOAVHDJ      ARFBNKGG       
LAKVUA          : EMHGAWGNERGGT   DHWPSDGFWP      WSEHBNNI       
VVXKQKD         : SQYATKXRQY      PJKIQGXUQC      YSEUSYWQ        YRYNJFSHA      
IRMAICMVK       : IKXHHVOSAB      PDAWCHFKDXRN    PJDQ            GDTRCBU        
YUOOWXCAKXUMT   : FKKSNVLLSBAES   LWDQXLNMRMCEIJD BHPFYUHW       
IUFBF           : POLDS           JEGPRKKGN      
WPDMPLOCHBNIYC  : QYXMXU         
VCYVOYSCVL      : TKPRL           QRSP           
SROXDNPGAFU     : OIWXNPS         DUUOBLGQEPF     JRLVU           FRHRHRFTTVWTL   YPJC            PUFCRBO         FGCNOOTGAGUAM   QMOOEQ         
JESYNTCMPGMM    : FEFGJDPWACCL    YHKSHLYFRU     
NFALT           : TJDMLEPCBYM     OYKUSSAFNBSBRL  DEJK           
ENDESRTYTYVLLB  : MIDFRPIF        KFKQCAAQGIFBWI  EVBVKWKYDF      TLHCWHEBDE      OQOVSTQMXVYLF   XWUNPCNDWS     
KOAOBPVP        : GJTTOLQKLVIN    JSEQVREC       
TGMTRGGWVMBO    : EKEXXCIINSVYAO  FBEB            NXMLJSNBUFL     GMGQL          
XPXWML          : BYEUGCODDIIL    DJTXCIVDYAVP    DSHGJOPXW       XCHF           
NRVETMFKIXQCE   : FNRWD           PKEPPTIUGF      MRRPDGWWEQ      TJCC           
VVLFUJTYXXWOX   : UXIHFNFVXWYO    GSRCBMIPDBOG    CTBEGLNYQEA    
DKHSEFWY        : KPBQRBTASMKDWY  TXAJJEGWNKHHGB  CWIGPKEWKXTXHA  RPDBMEIOL       UBVIGRRCEVDVMI 
ELDCC           : APAALX          OCSA            YEPKNJYFL      
GIGFVNAGHBEFXU  : KVRGGC          HWKJXEKWSKLA    HASGVURACI      MXQGMNUJCKGD   
WARESWLRXFWJKYN : KCDSMHLGVLVBN   OMBT           
GXYLUMNDTPJB    : NRWDGQMVAQMHKBI CJBPC           EGERSYSXIJT    
HIMHBSDAGUXMR   : SYIDKGO         KOFUAIPABVU     TIIQL          
YRWRAXSNSHB     : OWGCBMBPUJ      UDFQ            PDAWCHFKDXRN    QIBADDBXXKPYL  
DSHGJOPXW       : ENMSCFBS        LOBBKRKILK      XPXWML          ASQHQPW         AAUKISLFWTKROJ 
RAQXWQMPAMJWGLU : BGDBQPMQEDEUQN  XLKWO          
YPJC            : KTNMGFX         TITCBKEDPDIRC   SROXDNPGAFU     NXMLJSNBUFL    
NVVTHMLFJEW     : LODI            HKQDKLBB        MRLGVIVEUUSS    WRVNM          
UXJNKBNYK       : DLVRROWE        BJNYQIAKMB      XQCQQ           QKSVUUGONSS     WAJDVJJHHYONR  
GXIIWB          : VNRGTUMRWWQQV   BGRQCXRPQXEUJI 
YQHWOEECP       : FPLXGDRUPGAB    RPGVJBKKTAEO    VSEBBIGPBQ      DRKKCN          LAERIYHAYLCR    HHHMRPWTDANM    LQYGALA         WPJFATPKDRIHJ  
YQHWOEECP       : YANDODJDRSFLJ  
LUJARHLGUMTT    : OBWIPPOKCTDVII  JWLTDYUYUIUAKV  KTYYWVGK        FMOQPOW         RXXHR          
HCWSMV          : LAFGLS          ITHIUT          MBBQUJG         KHISKQRCJVPULME
HUMOUCUYELL     : ASWELFXY        CVHM            KAAU           
IXTAHF          : UPHJAYAHO       GIJRXBOMILRT    OSPDPA          PMGN            NTVUN           BBCF           
CTFYSODRH       : VAITAQEHW       WPJMXQIDLX      WOPRNIVBSTEMKF  JAKGV           RLODVHTFRIA     ENSUIUFYYQXT   
NFXLSOGWKFDV    : QGSEB           WQRWMUVPQPTJ    LUHTNJRWM      
UGTRG           : KCOUASNDMIRGDQM EYXHXBSTVCHT    TUFRBC          IKJCVBOFQFNUBW 
WRGR            : DTVRAOJGSP     
HMLKFVBSBBEVSM  : SJRPOOCPDWAP    ITFGWSSXNP      UPHJAYAHO      
DUXBOVHKNPLKHT  : GRYSVVPWSJNX    AUWGI           QDXNREEDL       KKHPLTDIXV      PKESEMRVVNIYX  
GBRS            : BILHFPMTHPHC    YVKCIIFYRCGNL   AOWS            UYHWXCVSBKY     ATFBGD          XIVRSIMRANHT   
YQPTTTBQMNNRIMS : PJYWNUXKKDGK    KAHLDHPHCB      WEHQ           
ICJXRXK         : RFFFVFKEOVMNGAC WUHQSJ          QMDYJBNSVKA     TLHCWHEBDE      AMEKVN          FJQDECIJKTCLB  
RPGVJBKKTAEO    : POIXIDCQMXMIQS  YQHWOEECP      
HHIV            : JWLTDYUYUIUAKV  GVEXTBQHMS      WSDHDRGVMS     
CGHUIRWRPRRBRM  : BUNDTYS         WPJGQNGLAWVPI   WPGUX           PRCUKKVXVBGGOJX STXAPVYA        MBBQUJG        
AICESO          : OFHPMXIJNPBOVC  EDGYNPNFJDK    
USMRBTCYRHF     : WUYFCTR         AXVW            IWBNATUIHDPVIYH
CNRCIJTC        : LRCKASQLRJUE    FKKSNVLLSBAES   WBKODWEXBRBORSQ RUPGB           HUPENDRNSFWM   
NOFPY           : VHFGGRNSGSKF    SDKH            NGHKJBUNVQVTP   TIDI            XQEUSBYOPVKJCT 
TTXUPRJJ        : MBDKJBXIKYHAQ   BLQBWMGXJF      PPCDKFO        
GNVXUBWAR       : LQGQ            OCCJWIS         AHAQCUDPEYUQHFV YANENNEECDKFFYC EYMKCD         
CCBVGNJXTBW     : PQBCQNS         NLTOKAGAJWQIKFA NPNSRVNHNMWBLT  IEGBJ           DOYICPXSKYRF    TIHIJEISRCCWKKU
VTESJVCUSIKOG   : TQURPJEOXBIIC   PMBW            GAJBC           JXWLEGJEJTE     RVJGKDO        
RGGLWKPA        : AXPTVWTEFG      FONUIM          PYFFTTU         ANQFCQCONNOKJMN PGUCXWHWPRRXLLM HUPENDRNSFWM   
WQRWMUVPQPTJ    : LYRGJYLMEKD     NFXLSOGWKFDV    QPEJ            HYVHDKIYXIXJD   EBDCF          
ROVMWHD         : AWBV            NCKMQXSY        WWGXWENK        VNDXBLSOWPKRN   FXHE           
PVKVJJI         : JVPJLGOGTOKTR   SKEUANKRHGJWUU 
KQYBKXNFTFYKCKL : MUWG            DITTS           VDEVARNEFQDYP  
YILWPODFMNDW    : GMMUBYTPIV      RQBLVRHAJ      
LYLEAMOX        : QEDHIXAAO       GLYSTLVDAYKRIMS HYVHDKIYXIXJD  
TRKSCOEOMD      : BQJMDLLYYSMTB   QIGSKREUR       YEYY            RMDWNJELBXIBJ  
XCQNFVAUBYU     : GSCBC          
AGSAVH          : SBRHQTEQME      EOOG            LTOSKFYPUKF     SISRXNEGSKV    
ADUMWYBDPQI     : NJSLIWXCQFW     PSJEY           LPXU            UWOOPYWPPYN     HOALTQYQLL     
OLFCSDFOE       : DFQAPIREPQQ     VIUTHGYDNDSSX  
LUHTNJRWM       : BILHFPMTHPHC    WKJH            OFYNQDWDFOFOE   NFXLSOGWKFDV    WDJR            KJCWDEEA        QIRRHPQNWAFHI  
DHHCGLFWCPNQ    : CFAWPNKXKBESH   GAJBC           CDGJPXHRWWE    
TVWWDNE         : JPSGRKIRNPJGPJN ENLGULI         RPRLBO          LTCNRQ         
YYSUPD          : KTYYWVGK        IAYRWMLHT       FXHE           
OPKRYRVHFBEHTU  : EAVSL           FCWJQMCSR       VRUVBPTWTJDKR   STNTI           SIWVCSECEACV    FGDLGTDTGWM     OMSVDW          MEXXFTAFGS     
WOYTNCHTLI      : IAFCAOF         YPQJCY          OCSA            THGMF          
HGNKVCCGW       : VESSID          IVEUWKLCWWA     YYHPBW          QXDVCLE         EDAA           
XSIEWPNQ        : YSEUSYWQ        VBTQFILAIDJBK   VRWEPNFXCRHMVTB BSLOMTG        
ONBNKQRRLGDHNJU : TPHODIMSMDBUIXW EGVCNCIRTWPS   
FYCNXDLRNRQFI   : FDMAHGCD        YKYXJGLBBNGUQR  JUSILPFULCR     HBOYHPGWRELYNP 
RWYSNJMFEXL     : NIUFIBOPYBH     JEGRPYXJE      
HBSEYXFDLEGYX   : AHEXEB          QACNCF          AWLVQ           WPGUX           JQLROPEUMULXNCR NMVCRHOICPAAIB  QAJWIXGGTUXJE   LNIUU          
TOCCAU          : UXIHFNFVXWYO    WSEHBNNI        SNIKBP          OHKE           
YPQJCY          : WOYTNCHTLI      LMFWO           WEOLYOMT        EVPBX           SIHNWNGVFOJ    
CMWJOPNPPTTDAC  : WKWIKFKV        TOBFKG          GEUGNBY        
XYXOEAOYEN      : RCWUJMP         UXLHJOMUQFE     WBSJCJGTYKGMGB  JYUWGSFIP      
UYTT            : XBBEQV          BBCF            XXJHHYLCCVXTAXF
VHLGVBVNSR      : XOQPNMKNIVDIEPA XCEHHPRUKCU     CAHTIWXN       
VRKYRJYGNC      : HQNTQ           RQCOACWS        UDUHG          
OGNGDMCACX      : POAS            OYNXFKUGSAHFW  
PGFTFU          : QIBADDBXXKPYL   VUCCK          
WDJR            : TUJDKNP         LUHTNJRWM      
KJYLSPNPGTDMASO : IUWXIWMBL       JAUSXQPLPOFX    YXQM            KLFNVDIYT       NUCJPWWHFGFKRVQ
WPJMXQIDLX      : CBRLBBXRHPUFKK  LODI            JCANJ           CTFYSODRH       FWOSFIVGPYV     NNMCTNRSBAL    
OHUETG          : RVCKWDLQBR     
FBVVRCRWR       : FNGOWT          FCAMHSSTKGPU    QUOLWPMSYOS     BWSXKT          WKJUXLRRXCQ     QLNENTYVOA     
PITMXD          : HAGQALDBCAJDBHM XXAY            NUCJPWWHFGFKRVQ
YVKCIIFYRCGNL   : BGNT            GBRS            MHSB            WLIEHGAVHXSPG  
VMKRGOJEGEVRXJR : EEUYPAEOYTMYVL  JLXODF          IUSUCFQMWSKWQB 
NQAXTKJBMBEUPRH : XBPDBJ          SVQFKNE         VKWXOAP        
ETFNIQTPWPHVBY  : FKKSNVLLSBAES   IBKAH           PGPIB           PWQWPQYMOKKVH  
OQEPMR          : XFMSFMUQHVJD    AOQSDB          RCCTXQJAADDRM  
NECTBRLKFSEMG   : YNSTPWUNKY      YLJWMWTIYE      HQXWCDIWG       WKPT            TIGBW          
GCEDTNYXP       : ERKAKFW         HKQNHPNVOCA     VCNBWHAEWWWMXI 
OIIEU           : EJCMUDLCGOMKGHG JVQUIL          MMWEUSSNLDYL    UJGUUNCVCEAA    KIQKYC         
FIGI            : YFKHRD          VOFLLKBRCOM     HASGVURACI      WNNJOUY         BVOY           
HCORK           : RXUJJABDGIJQ    HNRBUVWYCWACPBA DPJLHRBYF       FIHSBDVBOE     
VWPK            : LKKIIENVV       DFQAPIREPQQ     PMIWERDINABPA   LNHPVIQ        
TPHODIMSMDBUIXW : IQHBWFPOATVXEBT ONBNKQRRLGDHNJU UYHWXCVSBKY     MWQIYJEDXQIQD   HASGVURACI      HCONQA         
JDXM            : WJNQVYBJ        OKVWCJDBTBU     QROJWAERBVXB   
BDCNN           : GXQDRSQSA       XWTJBGFET       LQMUMKAXJGUTK   SVWPTHBFIAU     IKJCVBOFQFNUBW 
KFKQCAAQGIFBWI  : KCDSMHLGVLVBN   OGHIKX          ENDESRTYTYVLLB  QTVXSJNRSVO     IWBNATUIHDPVIYH DOKNMNBHYBWRCS 
TSDQJMTJ        : NEMLLOW         TLHCWHEBDE      HOLVOFGIXVWWV  
EMHGAWGNERGGT   : LAKVUA          JEVJOQH         UPVLCXFR        CAHTIWXN       
YAQEEOPJKKMC    : DOBYHLIWLHP     CHTTOSMYDMNWGQW
CVGDDUMLXJULQ   : NOSMOQCIPBETJ   KCOUASNDMIRGDQM CGYRPWFJMOL     JXFFGERMXWHHR   PTPK           
RWIAW           : ONYTOT          EEHHIOEIM       EYAQCN          MNUENANARY      HHFX            RMDWNJELBXIBJ  
QDPHU           : IVXHORHFQWMDYD 
SGNWEPUMV       : JLACNA          CACCQXWJQI      WEOLYOMT        UPQSGCDCY      
IKMGUHTLVNKGNJ  : AXFHEYEIDJT    
GNJOKKJQYGVQB   : AUQMOBKJRVR     HIAVK           OWDLPQSYQNYON   PPPRNNJ        
OCSA            : JNCNFADU        ELDCC           WOYTNCHTLI      XBBEQV          HDTJV          
BWXWKVKU        : RCWUJMP         PMRHTAUSNIATH   HHGGVJLYUIGU    GJTIFC          MNPKF          
AFWJU           : CIHNW           VOFLLKBRCOM     ANWEIHDP        SIHNWNGVFOJ    
AFTJY           : LQGQ            ORLWAARCT       AGLFHUTF        NPGINWJDBQXISKF LNBK            BFJNGTUYRVMP   
RWNSHDWDDL      : BVOY            JWNBVUDJUFKFDW  DGUUTKVFQ      
CLEMHQHKT       : OSCIYMYILHQ     GNJHKLKXDLTEI   MXDX           
JDJTDRNMSKEPY   : TJDMLEPCBYM     HQCRM           DAFMJAHTOX      NJAWFIJCBDYV   
YEWCJKJLWNXE    : YDVFDJVWC      
HQXWCDIWG       : NECTBRLKFSEMG   JTBLQ           KYFYUIHU       
MUUXYKYBM       : BPDQXA          EUVQYCTWK       XTBUTNGRO       TABDLJENXYX     LQRE           
AOMKAAJNXQUHJU  : FEBVLUNLDEAV    ABCENREK       
MYPJHR          : HQCRM           SKEUANKRHGJWUU  KIQKYC         
DNVCAUFMAFE     : QSNPQVKKE       XJOQRVLQONMDJVI OSCIYMYILHQ     AFMEPYED       
QEOCUOSPWDMDR   : XQWYLOOXSAOQG   OPSIOJSUVOXCV   FGDLGTDTGWM    
SBVNYYBXDD      : HCJQUGM         QOCB            PPCLKAKVO       FEBVLUNLDEAV   
JQVOUKHBA       : EAREMEMQGYACRT  TUJDKNP         OOFWBJLBT       EEBDNRKMWTY    
VOFLLKBRCOM     : FIGI            AFWJU           DLLSQTRFVKSOPE  LIPHFL          UNAKSSBG       
KAHLDHPHCB      : AXPTVWTEFG      OVXDHRC         WFTPBTEKRYPLMN  YQPTTTBQMNNRIMS NDFQKFCAR       PFJDBCORME      TEOG            ADDQCAWGDEE    
XRWJCXJOUAVIOJ  : YPRTKKSWV       NERXHKYARPN    
GLYSTLVDAYKRIMS : LYLEAMOX        SAUGJHHIFQV     OOXJKHIF        EYMKCD          LSMHPILM       
LMFWO           : XMKWYFUIEDOIVP  YPQJCY          DNXMOFAGCCTW    QXGDNOFQBQDPCYW LCCFQGLJKMBYK  
GFBI            : EMPBYGFJAFXP    WNNJOUY        
JWLTDYUYUIUAKV  : LUJARHLGUMTT    HHIV            OSVDJAHQOM      EGERSYSXIJT     ORTCPL          XRTA            BNJBORLJEGGK   
CFAWPNKXKBESH   : POLDS           DHHCGLFWCPNQ    KGUBGWKRB       NSUDKHJQJGIFUD  QTTO           
BLQBWMGXJF      : UIRLWREIFCGG    OUHHQDDCNE      TTXUPRJJ        OJRPOARHSEBKG   UPPQHR          VETOEW         
UCVFBHIIJFXWRXJ : BVSVYR          HEPDSHTLXF     
CEDL            : SPGPXGMX        OWDLPQSYQNYON   RXXHR           XTBUTNGRO      
ODINRPLE        : FIFMUWCYEQNQCMK LOLCGKISMAP     ASQHQPW        
HYCE            : DFJBPGCSR       IYIRUC          KRDK            ANWEIHDP        GOJAP          
DNQLYYLVQ       : SIHNWNGVFOJ    
HMOLRBSGGEVAT   : RXBD            RBBYQSBNLWUKR   EGVCNCIRTWPS    SSYPEYSQCMGXAU 
ESTFUXOA        : VQYCWTEICS      FULDCVYPXXAVTPQ EYMKCD         
FLMEXKXITMYFFA  : JXRNDEOLI       BLNU            EENT            UXXL           
NGHKJBUNVQVTP   : XIIRQLSTEUYA    NOFPY           IFYE           
TFPIUU          : CCEOVO          ROIWDEITCWPCDO 
HUQCHRJMS       : ICCLG           HVWRP           UCSLSE          YJXRNDDJ        MTRYX           AMEKVN         
BBTN            : TOFEXUCK        SCIJOIYYNCBWPQI DFQAPIREPQQ     BSGOYOQFPTNIQKI ONWACL          SUSCKIOV       
WKBTBWNSHJBYRVT : PUXTUQUEBAM     AYXAVW          IEAAH          
DQSHYLRNEG      : BGNT            DNKFUJHO        QSEY           
HBESXQ          : DJTXCIVDYAVP    DNSTB          
TSSJNATOYN      : AQEKIPBMGMTAUO  ENLGULI        
VOQM            : WMWPSCRGGBK     UAJWJWNK        NWFM            DNXMOFAGCCTW    QPLTMFPCU       THGMF          
XNURCBYS        : NLNBV           IVEUWKLCWWA     PYFFTTU         TREPATDJQUDDIU  RBIWAWXEOFF     GOJAP           JHWBL          
CACCQXWJQI      : LVWWQMSUSABWVWT MWQNYACTGWNR    SGNWEPUMV       TUOLSWAPOACV   
SEMTSARJQF      : NOWX            OGKOU           JYRBPFVBEBRAK   JSYOUHS         JRMUGOFNM       OTINEPKISTOYWIS
QUOLWPMSYOS     : UDBIHGQDSBRQP   PYXFKE          KPBQRBTASMKDWY  FBVVRCRWR       DPBRYJYSIYHQRKT WGJVYXS        
SJDR            : ASKHBXIMBT     
VBTQFILAIDJBK   : SIBIKYI         XSIEWPNQ        GWICLREKBLMHR   FHFVHFNCSO      IWMDRESJUG      DEVSNTKS       
UGTG            : TCORVGQUEPLTUV  RTUIS           THDNK           KOHKQVROJVJDW  
LUXLLQQEBWWW    : LKKIIENVV       YKYXJGLBBNGUQR  JXWLEGJEJTE     PHMGDCXXKDI     FIBQISRVCBDEE   JQLPCNOOVV     
ASKHBXIMBT      : CHSGGQKRLJHLQY  SCRDMXY         SJDR            VUCCK           WCUGA           TQPOJFE        
OYKUSSAFNBSBRL  : KRYN            NFALT           QGICI           SECXJFFLC      
UIFTEFMQOQOW    : FOBGVNHSKNLRY   HGJVBLSK        LATAVNAWTMH     RWEGJKQANVGWUBL
RTUIS           : GNCADUD         GNVJAMK         PUXTUQUEBAM     UGTG            AWBN           
DODGVTHQUBC     : TAVILT          GOEUKL          TUJDKNP        
WNISTPGKFYBEE   : YNFUTYUQEBEUNSW TUFRBC          UJGUUNCVCEAA   
XBETJJ          : DJYQIEDSYGM     BMOFHRAYSXTW    DQIJLBY         PUSEVQBBBXINDM 
PPGJYWGDBKC     : HBEGBXRKDUNDWE  DEIYFOQI        KGPBDDHBXXN     BMLTEPA        
UUKL            : GAFBTQCBJSP     BIDKVSBNGTFEHP  HVFSBSEBSGLK    QMOOEQ          KAAU            XBDIKMASGREYXVL JSUIUG         
USCXYGVAIATT    : DQBHMHXOFGXBXUK JRJKPTW         GSCBC           VUBACB          PCMJQMYML       DQLG           
EJCMUDLCGOMKGHG : DPWVYE          OIIEU           HVSLELHOJXCEYEQ ROIWDEITCWPCDO  RSCIVHJRVFDF    BOJBDUP         LWFGCQHRG      
UJOPMOR         : YSMW            GMLQIEP        
KRDK            : HYCE            GLIYANNEMIYDJS  SAUGJHHIFQV     BTQPFT          IONRXCSNK       NWPIKIM        
XWTJBGFET       : BDCNN           VONEUTHBWPGYGDC FUEWVNYOYA      QLKVUYHBSTKWLKN
NIVAODGIBQYSFN  : XEONYJTE        NDPLF           UCLAT           BSBETHF        
ABCENREK        : AOMKAAJNXQUHJU  MPTBDX          BHHH           
NNTSUNCIYX      : RYAOTGLR       
NERXHKYARPN     : UUYHBDJNC       XRWJCXJOUAVIOJ  ANOYEDALUDTRF   SECXJFFLC      
QRXEKCR         : QAPJXTQQ        PJYWNUXKKDGK    LYRGJYLMEKD     YANDODJDRSFLJ  
SFQLAGOKFOVV    : BGSR            RTGMJDQHIN      OHKGY          
PVAAVB          : FVMLWAJLNRGYIW  ODEVEGSDI       TABDLJENXYX    
LOLCGKISMAP     : OKOYMPERF       ODINRPLE        PRTJJWVBPI      KUXDDVE         DAFMJAHTOX     
GITIQK          : JLACNA          LDTBHDEAIRMQDF  PPTLTHFKEQYY    WYQQ            BXGYYMU         PPPRNNJ         JBXVBMIH       
WYRUUHQUJMXDAOO : JCRACYNKLMN     WYQQ            XYVFUFRKYHWIIP 
XYNQONIVVQRFKEB : JANCFEX         CRQDUOFOR       CHRJJIWFYFGVA  
GSCBC           : MLIICWCJCGAHIAX GRYSVVPWSJNX    XCQNFVAUBYU     USCXYGVAIATT    RTNUFK          BLGYKP          MFCD            XBIIUKT        
XLKWO           : RAQXWQMPAMJWGLU PUFCRBO         UJGUUNCVCEAA   
NDPLF           : XEONYJTE        JEFQTKVDQ       SMMGLWNMY       CLSEVKQPVA      NIVAODGIBQYSFN  UKMKUI          CYKIPUDKH      
FVSNRPHMURQV    : ALEHQCIDHYMCY   QLKVUYHBSTKWLKN QKBKBUWJ        QWIGNJBQTEKQP  
YQFCSAB         : UPDFACUG        ORHJNVMOIMXQE   NUYE            SIHNWNGVFOJ    
KAUX            : SLHNOAV        
XNCFSHBL        : INVPMVXYWHMQK   WPGUX           QJSKLWSS        VRWEPNFXCRHMVTB
VBEIXV          : OSLMLABO        PSHSTGEMHF      DQLG           
VWBOCDHD        : LYRGJYLMEKD     UDUHG           JVIOMQTENEAMNWN KLRSU          
NPGINWJDBQXISKF : AFTJY           WMBP            QEUDHDMOBOGGFLE
NKWO            : FVOXIMHRNIY     OGCUCONV        UGAPHPP         DPJLHRBYF      
AKGBAKHJPNA     : NTTDIXOTONFAYBW QMOOEQ         
WKVVVCWNA       : TEILWJLVXGRPEMD NPRI           
GMMUBYTPIV      : YILWPODFMNDW    IWKBTE          FOBGVNHSKNLRY   FMTL            MDCS           
QAEDHQT         : BGNJXHTSXXKYR   UPANVTOKDN      YANENNEECDKFFYC TJCC           
QCVBA           : IJSPVUVPIFDQBPP ALUUJNUYLJHLY   ILYAR          
XCOLFVTRL       : INVPMVXYWHMQK   OQBN            GPCNJVLROHADI   ERKAKFW         AHAQCUDPEYUQHFV CJEMQ          
UKMKUI          : NDPLF          
NITRRKLRDPNHPG  : FULAIT          ISAYWYUKDVSKL   ONQAADODFCSF    OTFRD          
UWSCVMTHD       : VKXJBWNRCNI     FOBGVNHSKNLRY   HHHMRPWTDANM    PHILNHEVJXUTON 
TREPATDJQUDDIU  : CMPI            QMXECOCWPSPVFL  XNURCBYS        SKPPUI          LJKLKHOCEH      GWICLREKBLMHR   MUGYEE         
XJOQRVLQONMDJVI : FDMAHGCD        KPBQRBTASMKDWY  DNVCAUFMAFE     KUXDDVE         JTRTDCONTG     
QAIIACLL        : FHLLUEG         ELEBLNMYN       YIDQB          
JRYT            : UTNMOROUQXG     RARKLLEHHTT    
GSXWLRSY        : CHSGGQKRLJHLQY  FNOVB           GKPEVAB         JPBIFSUIARSJ    QUSEHQMRUGEV    XYVFUFRKYHWIIP 
JOXOXUW         : FKGRP           MOKRQGTW        RTNUFK          FYJDPIFJ       
NYKVYOJNKUF     : SRSOWERGUITUYC  XBBEQV          QTTO           
PTRKSOVMJUVUJWJ : MWQNYACTGWNR    FROTPSOYWBHQA   IUSUCFQMWSKWQB 
RGNFFADGPMV     : WBBLCEHFP       TJDTASPBXUEOI   NWBUUUJAI       AKHAEB         
IDLAAFKSTIHFFE  : EAORLLTQJDREND  NSUDKHJQJGIFUD  VJAKQRPFSWCTX  
OBJAURQCYQFHIT  : OSKBGO         
KEJXGJDQEY      : ODYQAAG         RXUJJABDGIJQ    LYRGJYLMEKD    
MEGS            : NABI            TOLDWYSVTQYVVV  EOLGCWBXON     
WVRAQLQSKHAUQV  : CKFWFUMYO       NOWX            IQJEMG          SQEIUWRVWHKEC   KXWXHLCOVF     
DBMCHYHBF       : LPCFXQYSXXQAGHD IDRVMKCKPWHHGK  QSEY            OBOIPGBJQ      
ETNLMUKIOKBBBV  : UTNSCYXEL       FOYASLVVA       AFKAWKGHSG      MPODQIYMICGK    UIBMHMTGVJMK   
JVICUL          : CRELT           GIJRXBOMILRT    KWVJNNTYYCLLKW  XDNPCKXISDU    
VYJFAR          : FFWEIGXKYERVP   FDXXMGOKSUJXX  
FYNAOYMJLXB     : IJHPXER         MXHP            SNXLMI          JVIOMQTENEAMNWN FXHE           
YCXX            : EWCFEWIKGJQUAY  SVQFKNE         YLEIGVQNFJXUYX 
JTBLQ           : NJEANQFJBNF     HQXWCDIWG       XDKBRPVKOXAYY  
TMNFUNWDT       : GNVJAMK         HVSLELHOJXCEYEQ XNTXEYX         NTJSHQYGTIBSYR 
STNTI           : OVUCD           OPKRYRVHFBEHTU  TXTEEYOQXYATL   XEWTM          
GIADKEDIU       : OFADUIT         YNGISTVFIYUXC   YOHIGHHPIQVGO   ROQCHUT         QQJSE          
EVBVKWKYDF      : OWYYTXELDDPHUG  CMPI            ENDESRTYTYVLLB  MDTLWUWXWSO     ASVNIB         
CLIBEEQ         : PFTFTSG         UCECS           NAHS           
NPFXSKIWNS      : TJCC           
BXRFVDCGEFO     : APAALX          YWREI           KILCECQJBDM     UJGUUNCVCEAA    DEJK           
ICCLG           : HUQCHRJMS       YHKSHLYFRU      CEIKBTSBB       JVQUIL          UYWURKAIJFKBC  
CHTTOSMYDMNWGQW : RPBENOK         YAQEEOPJKKMC    SAUGJHHIFQV    
VSEBBIGPBQ      : VXDAVHDNBABM    YQHWOEECP       PLVEUXBBGMDI    XRIBUG          WUAJSKDX       
DEBKGKGBAB      : OBWIPPOKCTDVII  GGBB            WKJDEJBSJ       QSUMNHTDK      
YHCOELIBMGVSHW  : SIWVCSECEACV    WXAY           
QPEJ            : OSLMLABO        WQRWMUVPQPTJ    RGCRYIO         RKUWSFDRHBOP   
KOKUUVDXXHQYOU  : KCOUASNDMIRGDQM OVBRHG          HLIGVCQUIGKTW  
UGYXUF          : HFGE            EJRNOGORJ       JEVJOQH         WAJDVJJHHYONR  
NPSOGIVRS       : BTDNTGEEUSWW    DPETPVFU        RXPNLL          KWVJNNTYYCLLKW 
GFDEBIEBPUBE    : GNSHKANH        TQITUNNSJBUN    ORQSXPXOSP      PPCDKFO        
RYYQWUXSINMAV   : CHSGGQKRLJHLQY  DLHYUB          AAAKHPKU        OPSIOJSUVOXCV   YTJOG           UHSBAWIADHBFEUG
VONEUTHBWPGYGDC : YIYTYSJH        TXXICUMCYFDNYVG XWTJBGFET       MUGYEE          KLSTUHNX       
TTOVMLQKHYBTBW  : YBXAMYEQSUTGTL 
WNFDLB          : AWSA            QAPTYHWHKEUSNQ  UENADHXBX       FGKDMHRCGDU     GUPFSHPJ       
MADUBLYDXSWOOJ  : OIWXNPS         WEHQ            RDEPCBAHU       YVIDNMFKSI     
HWKJXEKWSKLA    : GIGFVNAGHBEFXU  KKBFVTPNWUGED   UJDFPIUUCQYKOGT
WBBLCEHFP       : RGNFFADGPMV     MMSEDWXMKIAAIW 
JPBIFSUIARSJ    : LMJGKBQMMYJ     KTNMGFX         GSXWLRSY        UPYQAXSSGAC     BEIY            PINAP          
WUORFCSUBVV     : BHSNSVQBLRBRCGV MLIICWCJCGAHIAX GUSTSEJQNAJVTW  FIBQISRVCBDEE   TMXPXVM         HPBUDWRFSDLMU  
AAWGRFRIGAPYUXA : LVWWQMSUSABWVWT QOCB            GPWIPWUSHPGR    NYWXQYEIIAIHHUC TVYKKT          ARKGADBEHXQR    FXQPRWH        
SLGR            : NNVCCWCBWPPQO   NKMW            KMCW            WXTWQTHAVDHP    JTTFTQRR       
XJNAELEDH       : VQYCWTEICS      GOKMAUNCJBG     BTIX            ASVNIB          HOALTQYQLL     
DKSLCXDMEG      : FUERP           THRKOGCEX       LFHPRIHUCOIS    JAUSXQPLPOFX    FXGPM          
GBCIQUT         : UVKRIMTNTOI     KGGDSQJYUNVGR   IXWMO           JVJLYJ         
MDWYSADEEI      : ENVQAUCYQ       PPTLTHFKEQYY    OSPDPA          OMSVDW          DMPXANA        
AOWS            : IWKTN           GBRS            DOKXTKBYJGWY    PDXB           
BSGOYOQFPTNIQKI : BBTN           
NHDGHILNRAN     : HEGUAIGOEEQ    
YIIABOQBFIIXEYG : VWONKXTCLEML    ENLGULI         VLQE            DVWEPXX        
JQYW            : EXIOJD          LNIUU          
EFGNSUF         : HEGUAIGOEEQ     HVFSBSEBSGLK    KKEOHDQXA      
KNTTVWWNNASX    : WGJSEILTWHEV    TJUHFVHUQNMMN  
QCIAATQ         : GKUEKPK         LQMSKJWBQV      AAELUGQ        
SRGXBVRVD       : OWYYTXELDDPHUG  WQOAIMJYLQL     UIBMHMTGVJMK   
IQJEMG          : EYXHXBSTVCHT    WVRAQLQSKHAUQV  JRSXMWIL        FMTDVHEWUDLBIF  GTASDFMHQ      
CTCVSNOWXOW     : NCNTUVHIGGOOYY  NYWXQYEIIAIHHUC CKGJWQSAUWTNMBI SNMVXNUBGXTXG   FYKAATAJARFDB  
IBKAH           : CKDXFGNNQIU     ETFNIQTPWPHVBY  SVPGTKXJDGBFTUJ
BDFYITIYDMNJ    : RXPNLL          FBEF            YFSCMIJ        
QGTOY           : FOPE           
DXISX           : BMNGA           IJSPVUVPIFDQBPP LKVUTNG         SKNVGLPXNT      LSMHPILM       
BYPDG           : CKDXFGNNQIU     SCRDMXY         NJROHMTVDVGEF  
HLIGVCQUIGKTW   : TAVILT          KOKUUVDXXHQYOU  OFNKEWFV        QUQTJLXBSTHIVPF
ASRBDVA         : TIGL            CHRJJIWFYFGVA  
QAPTYHWHKEUSNQ  : UQEN            WNFDLB          MHSB            CQQANDJNWRXL    ARLDSNYIX       VNARH           YPOEHPWABUR    
ELIK            : TPATICGBTOBOW   MBHVHKNTPMHBQUC HKICRNBOL      
CKADDRGIP       : PCXUERHDX       VWRGBTMJWVFKRRC VCNULRLBOQXSUG  YVIDNMFKSI     
XGIQAHXAOJ      : ACDCXTVDFIP     RLPGODS         MUFUMWFTY       UEUEJ           IQHBWFPOATVXEBT
JCRACYNKLMN     : KAIRCTVYJKVQSJN WYRUUHQUJMXDAOO XBMEN           XIVRSIMRANHT   
OSCIYMYILHQ     : HHGGVJLYUIGU    CLEMHQHKT       DNVCAUFMAFE     QGICI           MEQNLUQPDIFCA   UKOKKCWNCGN     MMSEDWXMKIAAIW  BNJBORLJEGGK   
IBAKRLOCOJESIUE : DTBMPCPUTKI     NKAQBYNVYW      UVQR           
JRSXMWIL        : JSYOUHS         IQJEMG          UGXBIQH         VUVSVKACTNL    
HVWRP           : SHYHEUWHVNKJ    FTXDETJ         HUQCHRJMS       AXSX            YPOEHPWABUR    
AQEKIPBMGMTAUO  : OPVIMVTIDM      UAJWJWNK        TSSJNATOYN      QTVXSJNRSVO     LNBK           
TAXMXKLIVUQUU   : SQSNICLBXDQNAY  NTAPVJO         VORSEFXIFTXM    RKKUPIDGO       HVSLELHOJXCEYEQ CRTJD           DEJWSMTQGWQXGM 
KVKBAWLQAYWN    : NSPLPLSCEXM     ONUXLXJRAGRJT   SVPGTKXJDGBFTUJ WVGFJ          
WKJDEJBSJ       : SIYUTI          DQEJPNVKTRN     DEBKGKGBAB      TJDTASPBXUEOI  
ERKAKFW         : XFLOS           UYGPUELKIHJV    KRTW            GCEDTNYXP       XCOLFVTRL       CUESPFVRGWBOX   XQCQQ           XGVFMBQSX      
ERKAKFW         : DEWBLUIH        GGWXKJKYVPXRRPX
PSHSTGEMHF      : VBEIXV          BWPSIDFVFO      CQQANDJNWRXL    DMWYQNGSATPQCUC
UXLHJOMUQFE     : SVUOOJPL        DFJBPGCSR       OENBBGRCHTVNS   POIXIDCQMXMIQS  QJSKLWSS        XYXOEAOYEN      SCEIIHBPWQJ     QBFNUF         
UXLHJOMUQFE     : OWCFI          
KYQMLXJJPEQIAX  : UUOGMQ          IVSVQXP         TIHIJEISRCCWKKU
MHSB            : XDHBQXCJ        VYKU            YVKCIIFYRCGNL   QAPTYHWHKEUSNQ  LDOCVUSQYTFYP   BVOY           
TMLFBXBTGHBSITF : OFADUIT         PMWHWHHD        TIGBW          
SQEIUWRVWHKEC   : SLHNOAV         JJXIPIPJD       WVRAQLQSKHAUQV  QKBKBUWJ       
IVAWEE          : EWCFEWIKGJQUAY  PPWIJGUBDQ      SPGPXGMX        DAYIPUCTJELWH   PMFSRNSOWNF    
FXDOBVX         : ASWELFXY        KCCWGGL         WBPDQIPRLQNDGHF
DSOTYWRXQP      : RGUMSUECCOENMJR KQXOUJWCKQJJOPF FNOVB           YXQM            QFOJV           RVJGKDO        
XCCBQNYQKDUHK   : RMNGFDLWFDKLVLR SHCTBGAB        LKKUUKQIRD     
LAWJXUNSJ       : FJSYE           CHSGGQKRLJHLQY  ASWELFXY        GTASDFMHQ       QKLOCJFXY      
TJDTASPBXUEOI   : TKNUFASPUBWJTT  SDQVTFLYRBAYCC  IBTKSTUIT       RGNFFADGPMV     WKJDEJBSJ       WBSJCJGTYKGMGB  AUXAS          
FULDCVYPXXAVTPQ : ESTFUXOA        QYPJJB          MQCKR           QIRRHPQNWAFHI  
BMOFHRAYSXTW    : HBSNUMCBKTHFOAX PFOCSHNWWOWDX   PUVYO           XBETJJ          DCLAUMFXJ      
EEUYPAEOYTMYVL  : VMKRGOJEGEVRXJR ENTA            QGFJDFL         LEACVRSAI       TUKRVBXI        KHISKQRCJVPULME
NCYPR           : STVXMOAB        RWGHUAUTRAQIA   HDGGJJYWQX     
UYHWXCVSBKY     : GBRS            TPHODIMSMDBUIXW
HYVHDKIYXIXJD   : WQRWMUVPQPTJ    LYLEAMOX        KKCGJWQJPEEX    BRBD           
NEDFWX          : VAITAQEHW       SIYUTI          TWQIXLHFCN     
EXFJT           : NKEJ            KILCECQJBDM     DKAASIFSRP      WBSJCJGTYKGMGB  QPTDH           LCFVHUFLXRK    
KGYQO           : AFRSUQSC        AFCKQKEKHKGPSFX PMUAUFJODKDRU   WSDHDRGVMS      GUDKNOWTMLMSTO 
PVDAHFARDL      : GAFBTQCBJSP    
QAEUHBUOHS      : HCBRQIIBK       IAFCAOF         BYEUGCODDIIL    RKMDLMOUARVQY   HAGQALDBCAJDBHM VQAEJ           TOBFKG         
QOVCVWUKXK      : AMUAQUCEI       ICXAWBAVHXTLLG  MKARSNFQFM     
DLRINJNAJHCNCLO : XNEFXOIGLHEUHT  ENTA            HUWMPOCCSY      TITYBNLHTIJHM   LPYFCNL         BMMVBNBOTA      COPGMLJYTQXW    GUIVJFPXRD     
AXSX            : HVWRP          
JTTFTQRR        : SLGR            QYXMXU          LSIFJ           KFUBMOMV        NOLTFL         
BWPSIDFVFO      : WJGNFAYAHFVR    PSHSTGEMHF      SKYOMCXBNC      DVWEPXX        
JCHVSJ          : MRRPDGWWEQ     
QEWKNSETMXLEAO  : CFKLJXBYUGPPMCD UYTHWRELOLQMIAM BOIWWJJHXFPTO  
RKKUPIDGO       : QXKTDPTDEFMLWM  TCDHXENJ        TAXMXKLIVUQUU   DNXMOFAGCCTW   
KXIDHHVNGHC     : LHXIFARK        BKBUUWHM       
NXMLJSNBUFL     : IVSVQXP         RKOXXCJVEIS     TGMTRGGWVMBO    YPJC           
DDSGLJSVJEBTNYH : AOQSDB          HDGGJJYWQX      ASQHQPW        
IJSWH           : GWXOHUWFGPHTYCO MOKRQGTW        ENSE            OMDC            GYPFGMKXWKHVU  
KTYYWVGK        : LUJARHLGUMTT    YYSUPD          VIUTHGYDNDSSX   IHJQVXSM        KIQKYC          RVJGKDO        
JPYP            : FOPE            JHLEWDXYQRVPI   EJDIJRSJT       NOLTFL         
KLYTPANFYXYI    : NOAH            CUOCIV          WOHJKCYTM       IOJSNN          FPFOPKPFCBM     UKQJXGBJHD      LKKUUKQIRD     
RHRXT           : LAFGLS          IVSVQXP         GJDVJGIJ        GUKMDQF        
YSMW            : MGNVRTH         UJOPMOR         LKKUUKQIRD     
WDLMEEP         : NTTDIXOTONFAYBW UUYHBDJNC       QUSEHQMRUGEV    MQSDPRPPMLLDOT  NISWI           XXJHHYLCCVXTAXF
ROLJOBOPYNX     : EOUEKCLTXLMVFUP PPHOQXLMRB      IMJCDLMNGMB    
FHDFCSEWFEYEHN  : BLDOFFJYFJJ     CLSEVKQPVA      NIUFIBOPYBH    
MRIDJWOSL       : VESSID          SYYTLBFSAN      HKQNHPNVOCA     ONHEYMGTCQYWC  
HDRUEDCLIKPBQNI : BIQRXF          IDYMUSCEH       RCCTXQJAADDRM   JCANJ          
OMDC            : TDBSNTVFD       JRGPLQNTFREOOBY IJSWH          
RTNUFK          : GSCBC           JOXOXUW         ONUXLXJRAGRJT   VDXSLSKR       
AXFHEYEIDJT     : IKMGUHTLVNKGNJ  XDCVFPUJ        YMHFJWVDE       JGMUYLCBAN      VETOEW          EIVRHFBALF     
TMPKA           : ABVVR           LMORFODFXBNE   
GONJTSDPJXVV    : PDAWCHFKDXRN    TBLLQW          RHKLDNTHKMIH    USQU            ONGKSDTFBSDVNWH
VWRGBTMJWVFKRRC : KIGRTUETG       CKADDRGIP       IGCNU           DVWEPXX        
TBLLQW          : DLNLJV          UDBIHGQDSBRQP   MDLHAHW         NKAQBYNVYW      GONJTSDPJXVV    AALDD          
JAUSXQPLPOFX    : DASLQMUUFXY     KJYLSPNPGTDMASO DKSLCXDMEG      CEIKBTSBB       NAXUPW         
YKYXJGLBBNGUQR  : MLIICWCJCGAHIAX FYCNXDLRNRQFI   LUXLLQQEBWWW    XDCVFPUJ        QIHN            UIGK           
HQNTQ           : SIBIKYI         VRKYRJYGNC      TAIC            LQLWLKIEEGIXAR 
ORCGFRU         : NUYE            GHRMGSCJMKCEX  
RKMDLMOUARVQY   : TCORVGQUEPLTUV  QAEUHBUOHS      GPWIPWUSHPGR   
JSATKNNDW       : PRAKUUNDB       YCFNMFEJ        PKESEMRVVNIYX  
UCLAT           : VVLI            NIVAODGIBQYSFN  ORMBHIPKSTWOJQV CJNKVYIRDPST    BSBETHF        
NMVCRHOICPAAIB  : HBSEYXFDLEGYX   BFSFGQK         YNGISTVFIYUXC   DAYIPUCTJELWH   NDVDSXIFFWWGNAX DMWYQNGSATPQCUC
RUTLHHBKH       : WQOAIMJYLQL     MXHP            YCFNMFEJ        JEGPRKKGN      
GJTIFC          : BWXWKVKU        ARKGADBEHXQR    FXHE           
TXXNINVMFWNPX   : FQILRITQJOK     UUYHBDJNC       VOBOY           PQBT            XDNPCKXISDU    
HUBTCKUPTBV     : HDGGJJYWQX      JVQWWHUUVN      XRQVE           ULJDWXBJJW     
UENADHXBX       : WNFDLB          RARKLLEHHTT     ONQAADODFCSF   
QTVXSJNRSVO     : KKMVYIHEXSKN    RLFP            SKNVGLPXNT      KFKQCAAQGIFBWI  AQEKIPBMGMTAUO  UWEWFTRKNDOAB   RALHUQ         
RTGMJDQHIN      : FQXMKVHPYPX     GCTSALYGQ       SFQLAGOKFOVV    CXVUHPCFVCXDD  
VPQGQUEYLAUMTG  : RDPCJTHBJUWMYVQ RXXHR          
NYXCUPVE        : XDNPCKXISDU    
HHXO            : GCDGQDID        SIPA           
LDOCVUSQYTFYP   : HCNWFYCV        MHSB            SPAJLJHQSM      RWEGJKQANVGWUBL BTPMEQKFT      
UXRIXQNUIJYN    : EQHIW           BHHH           
GLIYANNEMIYDJS  : TCUJFQPQIO      KRDK            PNQME          
KKCGJWQJPEEX    : HYVHDKIYXIXJD   GNJHKLKXDLTEI   CXVUHPCFVCXDD   LQRE           
GOKMAUNCJBG     : QYSPXALPNBTE    RAHYUQOLIXU     TQURPJEOXBIIC   XJNAELEDH       IVXHORHFQWMDYD  INNTGOTBBCT    
LHBWBMINQQYNH   : LIPNKRA         LPYFCNL        
FOPE            : NCNTUVHIGGOOYY  QGTOY           JPYP            QXITL           YHER            HGJVBLSK        QPATSPA        
XSPKUKBAV       : HLKKWXGOAGI     TLDAH           KGUBGWKRB      
GTQQ            : LLPLTITCCRYUGR 
NTMXHDOH        : OGKOU           MEPELMQHDILQL   POAS           
YRYNJFSHA       : IDYMUSCEH       EOREWYOUVRNPFTB EROVHEWMOG      FRHRHRFTTVWTL   VVXKQKD         ADSHRKDQALPXGB 
UXWVXTAEPQUN    : KRYN            LXGTMPWJRNWQC   OOFWBJLBT       QJJXFCHK       
QAFYGUICVCDJ    : XKUBBLECKPYNE   QSLFRUOACIXJNP 
JEVJOQH         : SHYHEUWHVNKJ    WXTWQTHAVDHP    EMHGAWGNERGGT   UGYXUF          IVHWLCCN        JLXTKH          SJIXOAVHDJ     
OFHPMXIJNPBOVC  : AICESO          WVGFJ          
SKYOMCXBNC      : PLRV            IBTKSTUIT       PMUAUFJODKDRU   BWPSIDFVFO     
ASQJEG          : ETKAX           GJDVJGIJ       
MXEMIPAYSQW     : NKMW            RAMF            DVVROBBKOUWBG   ETOBMC         
NPHO            : WQGBFIRBI       CXVUHPCFVCXDD  
WTEAHIXJBRTHAL  : NJROHMTVDVGEF   BKRSMVPFOJ      ONHEYMGTCQYWC  
XRIIJ           : BUQHTLXXN       VSOUMWLPVBOVGN 
HDCGASXK        : KVRGGC          FUEWVNYOYA     
EHDIJ           : RVCKWDLQBR      QLLCFAXEI       KXWXHLCOVF     
SIWVCSECEACV    : ECTMCXEMUJ      IXRWV           OPKRYRVHFBEHTU  YHCOELIBMGVSHW  YDVFDJVWC      
KIWULYBNR       : CHTHQ           YWRVLU          XEUMJCBOR      
XCEHHPRUKCU     : VHLGVBVNSR      RHWYHAFUDXD     WEHQ           
ENLGULI         : WFTPBTEKRYPLMN  TVWWDNE         TSSJNATOYN      YIIABOQBFIIXEYG CNEOYRNE        ILVMNVKFLDWWQ   BHVFLWQR        NMJMUSTI       
WUBTPOVTDNTDRA  : DSEKLVHDQXENY   KSNLEDXD        SVPGTKXJDGBFTUJ OVLBIEKVNTHE   
CRFYDJTKNKVVF   : VQQQPNBLJQVLJJT RPRLBO         
GAJBC           : TKNUFASPUBWJTT  VTESJVCUSIKOG   DHHCGLFWCPNQ    HIAVK           NKMDLPMO        MPKNOOW         MRVAGAHOBW      PEPJJEUMQEGBFK 
RQBLVRHAJ       : GNCADUD         MKXOUB          LNIP            YILWPODFMNDW    KVMTAPCBFRO    
NLEUNHEHTTTR    : MEQNLUQPDIFCA   DNSTB          
YBXAMYEQSUTGTL  : ONYTOT          GDGKESLEKUGJTHS BGKRIPSASOMMK   BOEYDX          TTOVMLQKHYBTBW  LXGTMPWJRNWQC   RKIGGLDN        WKJUXLRRXCQ    
TXAJJEGWNKHHGB  : OJMDHRVKSVR     TCDHXENJ        DKHSEFWY       
XDCVFPUJ        : EBRHVUGTJGGJXX  DNKFUJHO        AXFHEYEIDJT     YKYXJGLBBNGUQR  DCPPUHJVHNOR    OAKS           
OGCUCONV        : TQEHOYMDAOVNLSN NKWO            SIHD           
NHXTNXJAHQGK    : ITHIUT          KNUWGSY         QFKYWDPPBSB     RWEGJKQANVGWUBL
ENTA            : EEUYPAEOYTMYVL  DLRINJNAJHCNCLO RBPYY           VAOFPMU        
LXGTMPWJRNWQC   : PMXLFVGWFKLF    SCRDMXY         UXWVXTAEPQUN    YBXAMYEQSUTGTL  DLLSQTRFVKSOPE 
XCIOAROJ        : JBMLG           GHRMGSCJMKCEX   ICBRQMCHFQ     
VUCCK           : PGFTFU          ASKHBXIMBT      KWVJNNTYYCLLKW  DOHRCIGQDKVAI   RBLKOMEYT      
FGKDMHRCGDU     : EJMCOCGPTGLGXHO WNFDLB          BSLOMTG        
DLXR            : SVJFKM          HYEHT          
ABAB            : ONYTOT          CTKWROUFGXJC    TOBFKG         
PMGN            : OIMXPUMM        CFKLJXBYUGPPMCD IXTAHF          EXSKSDGNCIQ     JDPSM           QSLFRUOACIXJNP 
KRSLW           : AWWRREIKYLNF    OIWXNPS         LEACVRSAI      
WCNGTSMANIDB    : VRUVBPTWTJDKR   SIPA            PUPUYPMIGUV     UMNYLJEJ       
UMGXPJVFWCUEO   : KYKDDDPQNBS     PVCVH           UPAXYVCKPBN     WBPDQIPRLQNDGHF GWNFM          
YBMAAOOILH      : JVJLYJ          BOAPCUNGNDQQ   
LWDQXLNMRMCEIJD : MJNYMN          YUOOWXCAKXUMT   UWEWFTRKNDOAB   GCBMMWRLMTQCU  
GJDVJGIJ        : RHRXT           ASQJEG          WPRWQYNEMCQ     YOJIOS          YGJPGYOOX       COPGMLJYTQXW   
YXQM            : KJYLSPNPGTDMASO DSOTYWRXQP      LIPNKRA         YFSCMIJ        
LAEQQECFTWTVBEI : WSOCWS          PLVEUXBBGMDI   
SONVKYDUJLWJFJR : FGAY            CLMD            YPOEHPWABUR    
MXIDDKKW        : THLUGIYWLBKWF   EYXHXBSTVCHT    HIUTEOQLCBJA    QYXSUK         
GUKMDQF         : NUVHAWRRCUBMT   RHRXT           KEMTBDHCUKXQ   
FEFGJDPWACCL    : RGUMSUECCOENMJR JESYNTCMPGMM    YHUPHJBFEIMJ    MTUSY          
TXTEEYOQXYATL   : MSWOWAQUVMYEWQ  PFTFTSG         SXHWDYA         STNTI           TWSRSR         
YDSTKW          : WQXNJEORV       KLFNVDIYT      
QGFJDFL         : EEUYPAEOYTMYVL  FROTPSOYWBHQA   WMBP            JAENHLVF        JUGMJMCG       
SHCTBGAB        : XCCBQNYQKDUHK   CWCCARGP       
QYXSUK          : QIMWVYWR        VATN            SXNUASY         MXIDDKKW        DQTHBCTTP      
UPYQAXSSGAC     : SDWNCRE         JPBIFSUIARSJ    MPWHDDPSVVJF   
HNRBUVWYCWACPBA : AJDHKYP         CLDBACQUEJC     IAFCAOF         HCORK           SCEIIHBPWQJ     SIGMBEY         PEYFPAXLGICVYWR
WKPT            : TJDMLEPCBYM     NECTBRLKFSEMG  
QMCQGXWIAIQQ    : NUYE            MEPELMQHDILQL   XQEUSBYOPVKJCT 
RNYOMCN         : PQBCQNS         CNOCKAHURLTAT  
EDQGMPTELVU     : EUXBMTRGRKWS    OWYYTXELDDPHUG  UOLYWWDXGAPMEW  XMKWYFUIEDOIVP  SSMHP          
BLGYKP          : SBYWWURRGYF     RXYJUVTEN       GSCBC          
TGRYAGX         : PJDPRDFGKECASC  KCOUASNDMIRGDQM VGKLMNNNRJ      EAORLLTQJDREND 
SCEIIHBPWQJ     : UXLHJOMUQFE     HNRBUVWYCWACPBA
CHWAIKJH        : DQBHMHXOFGXBXUK VTCCBYRKPXGM    OOHK            RGPRJ           RCUPTHYTOCCYMKR BMLXOS          SNCQYF          GDAXKFMEMSS    
YJRFBSH         : LOBBKRKILK      QPRQENITHUXX   
QXDVCLE         : JTQEWVR         HGNKVCCGW       VNCURBCNUMC     FPJQMREHB      
MVIFH           : AJWYJKON        QIBADDBXXKPYL   MMWEUSSNLDYL   
HPJJAVSIT       : LHEGEC          LIPHFL         
TNYUG           : TOCTFFELFAEQE   UDYIRPPYNNWTU   RJHERXOSO       LEPMXHYYMXTWF  
FAGIVKVAWKYHPG  : HQCRM           RYXBHOSAAHIW    BWRKWTPL        CTKWROUFGXJC   
YXDKYAEJV       : IUWXIWMBL       JLXODF          WRVNM           BENEDVWEPYHA   
DKAASIFSRP      : YGNJ            NIMENQUCBV      DWUPVJIU        EXFJT           IWRDBCWVXKJWX  
ELRBVQ          : EJRNOGORJ       LIXCQ          
NWFM            : CXBC            NQVGBPNWKMUEXO  VOQM            MSBSYPXNIAYEQL  VGNIMX          JVIOMQTENEAMNWN
JXWLEGJEJTE     : KKCWNTUYXAPVOCU UVKRIMTNTOI     LCSFILXB        VTESJVCUSIKOG   LUXLLQQEBWWW    EJDIJRSJT      
NPRI            : AIKT            WKVVVCWNA       DOYICPXSKYRF    YYJHAORCFXYU    GDTRCBU        
HXNVP           : ECTMCXEMUJ      WUYFCTR         BGNT            RALHUQ         
TIDI            : RKGYCKXOCTHLORI NOFPY           FMTDVHEWUDLBIF 
IWDTWCHD        : DQIJLBY         FPFOPKPFCBM    
RITNOGDGX       : GWXOHUWFGPHTYCO YMRIQLTWIGWI    HXJCO          
PHMGDCXXKDI     : LUXLLQQEBWWW    FLBOAKYDRVYVA   CAHTIWXN       
LHXIFARK        : FFWEIGXKYERVP   KXIDHHVNGHC     OKVWCJDBTBU     POUNYSGOBYPXADW PWQWPQYMOKKVH  
LSFAKLFQJTJ     : QXITL           UUKDDAQGINGFOFI
GPWIPWUSHPGR    : POLDS           AAWGRFRIGAPYUXA RKMDLMOUARVQY   XNTXEYX         OOXJKHIF        PLVEUXBBGMDI   
QYPJJB          : THLUGIYWLBKWF   FULDCVYPXXAVTPQ FOBGVNHSKNLRY   JGUNMWBFKQJX    YGJPGYOOX      
DHWPSDGFWP      : PUVYO           LAKVUA          MEQNLUQPDIFCA  
GHXQYXMRHEBY    : QYSPXALPNBTE    FFWEIGXKYERVP   RWSESNSOVHAXFF  LXWKAGSSMSPQMP  HEPDSHTLXF     
RXLDINYNWXDRD   : TCUJFQPQIO      HEKYMSXDGP     
WDCXJLYALWMF    : WJDVGOCWTEVTOBQ ROBT            OAKS            OEHABNEJJJP     BPFA           
SIGMBEY         : KOFUAIPABVU     HNRBUVWYCWACPBA YVIDNMFKSI     
MOFALGFFJ       : PIPVOB          EUBLKSXKPMVQH   SNMVXNUBGXTXG   IWRDBCWVXKJWX  
FMTDVHEWUDLBIF  : LLPLTITCCRYUGR  IPLLXOPXYHKPMST BJIGTTQGQOM     CLSEVKQPVA      IQJEMG          TIDI            NNDSHAQPU      
QTMUSTIHBKUHS   : NOWX           
RKIGGLDN        : QWMJW           FTRLXYP         YBXAMYEQSUTGTL  OCCJWIS         CTBEGLNYQEA    
CJVNMGUXWPLSIH  : FIBQISRVCBDEE   VRPERSWXOJQXGR 
SKPPUI          : KBMYAGJNSJN     VRXC            XIIVLPKSEQUDHDX TREPATDJQUDDIU 
MSBSYPXNIAYEQL  : NWFM            NFFUDPGKDFOLEK 
LLIBY           : FEMRWSVCGH      QROJWAERBVXB   
MGGHTYWOHQDBTVC : LMHEJMHPUSKAB   LSMHPILM       
WPRWQYNEMCQ     : QFWXDOL         HBSBVWMAKY      GJDVJGIJ        CEIKBTSBB      
DPBRYJYSIYHQRKT : AFCKQKEKHKGPSFX QUOLWPMSYOS     LATAVNAWTMH     OOXJKHIF        KJCWDEEA       
IVXHORHFQWMDYD  : RSHO            QDPHU           GOKMAUNCJBG     ELEBLNMYN       WCUGA           ASQTLKUPBLR     PDXB           
FUEWVNYOYA      : GKLFSRBOBN      XWTJBGFET       HDCGASXK        KNELCMQM        UTALK           VGKLMNNNRJ     
PTKLHV          : GHRMGSCJMKCEX   VCNBWHAEWWWMXI  FXGPM          
FDXXMGOKSUJXX   : KCOUASNDMIRGDQM VYJFAR          UUPMPQLKJOXJB  
SCOPR           : NABI            POIXIDCQMXMIQS  HIFWOSQ         LJKLKHOCEH      TJCC           
GQRHILTTSPEB    : FOGETIHYFDFSS   NKMDLPMO        CFXPIUITQO     
CYKIPUDKH       : NTTDIXOTONFAYBW NDPLF           PDXB           
IXWMO           : GBCIQUT         MMJUHNS         LXWKAGSSMSPQMP 
FEWVXEHJ        : XEONYJTE        AFKAWKGHSG      DXYOPOERHLKNNW  YVMMPXYOTAAEPJP LPYFCNL        
BFSFGQK         : GDGKESLEKUGJTHS NMVCRHOICPAAIB  CDQUIRBDRCW     XNTSSJUD        TOBFKG          UMNYLJEJ       
CUWWYKE         : MMWEUSSNLDYL    GKYRYCUX        NOLTFL         
UDYIRPPYNNWTU   : ENIWJOTLPOHSC   OMECMVOGFII     DGLUKGCAD       TNYUG           VRPERSWXOJQXGR 
WYQQ            : KKMVYIHEXSKN    GITIQK          WYRUUHQUJMXDAOO RALHUQ          WAJDVJJHHYONR  
YHQGJMFHN       : APAALX          RLFP            IOPQRFR        
NPNSRVNHNMWBLT  : CCBVGNJXTBW     BSBETHF        
WQXNJEORV       : YDSTKW          JRMUGOFNM       IXAJG          
BIDKVSBNGTFEHP  : UVKRIMTNTOI     UUKL            YYJHAORCFXYU   
VOVIKUHEUXNYMH  : JCUAMNST        STVXMOAB        QLKVUYHBSTKWLKN DTLAQ           HMQOEBLFX       QFKYWDPPBSB     VIUTHGYDNDSSX  
KLFNVDIYT       : THRKOGCEX       STVXMOAB        KJYLSPNPGTDMASO YDSTKW          QPATSPA         GSRCBMIPDBOG    QTTO           
TYVDQQAIOKSLRWG : PYJOMVKEVKGNQ   QMXECOCWPSPVFL  SXDMKRC        
NFFUDPGKDFOLEK  : GNSHKANH        MSBSYPXNIAYEQL  DOHRCIGQDKVAI  
AJCGDSGLJSGUMGB : VWUY            TVVNUIOQG       SBTBIEODSEWY    MTUSY           JWVJFPMKYHAC    ENSUIUFYYQXT   
TIIQL           : BNSMBNNVTF      HIMHBSDAGUXMR   DGVPSENLMWIY   
AWDFNQ          : PJDQ            MPKNOOW         TFQJVNEC       
XWMJYUOTBCDVJXI : TJGOEGMGX       DPETPVFU        GIJRXBOMILRT   
BLNJVEV         : VOBOY           JXOWCN          BVOY           
EUBLKSXKPMVQH   : MOFALGFFJ       OSVDJAHQOM      TLDAH           WBSJCJGTYKGMGB  ABDCSDFITEAMUD 
KKNPGYNOQ       : AIEI            MKXOUB          EUVQYCTWK       RSCIVHJRVFDF    LTCNRQ         
DEABLXARSBEFV   : UERFN           PGPIB          
PNQME           : ABXPFQGH        GLIYANNEMIYDJS  EFXWHXDCOXLGSY 
AOMPESPTJIKMP   : ORLWAARCT      
QDJQUFTBKQFDEX  : RWSESNSOVHAXFF  DWUPVJIU        BUXQAIMTDA     
JXRAKHH         : TFQJVNEC        LQYGALA        
YDPKOECCWFLNA   : XFLOS           KCCWGGL        
IEGBJ           : HSRYIUYHYIM     CMQPH           CCBVGNJXTBW     BJNYQIAKMB      NBFVNBIOKHKBK  
FIBQISRVCBDEE   : XWTCQC          LUXLLQQEBWWW    WUORFCSUBVV     CJVNMGUXWPLSIH  SIHD            KAAU           
OUCQWY          : AXCKRDLFOSB     JEGPRKKGN       AVTXP          
LPAGXEMYOV      : MKWCCS          QWLMTRWXARFBR   EUVQYCTWK      
YYXJRRHW        : AJYD            YPRTKKSWV       VCCPF           HVSLELHOJXCEYEQ
NBBIPWKIVK      : MGNVRTH         WBPDQIPRLQNDGHF JRWT           
HAGQALDBCAJDBHM : PITMXD          QAEUHBUOHS     
BWSXKT          : MTODGY          TDBSNTVFD       PQBCQNS         FBVVRCRWR       JXFFGERMXWHHR   OTFRD          
SLWGTSQCDSKTU   : ONUXLXJRAGRJT   SJCFXGHQYGUMJS  BNMF           
WXAY            : FTXDETJ         YHCOELIBMGVSHW  RXBD            OFIGICLCQ       FLJAKRUJNL     
DBRSWSP         : XIIRQLSTEUYA   
RCLTUYQDULV     : JJJMLPAWBN      FUERP           QPERGGT         JUYY            UVJWHFDS        CKGJWQSAUWTNMBI HHFX            JBXVBMIH       
OOHK            : QFWXDOL         WINHL           LQMSKJWBQV      WUHQSJ          RAMF            XTYEUAYAY       CHWAIKJH        BPAAEUOUJQSLEY 
GKJILRM         : VFGNPLMCW       YNTAXOU         ANWEIHDP        UKEG            TUOLSWAPOACV    SIHNWNGVFOJ    
JHLEWDXYQRVPI   : CLAO            JPYP            UIBMHMTGVJMK    UJDFPIUUCQYKOGT GTUJ           
KWVJNNTYYCLLKW  : JVICUL          NPSOGIVRS       VUCCK           DMPXANA        
WMOEASDGREYJ    : AANFMLRHJTJKS   BKRSMVPFOJ      UXXL            EWXRVM         
PUFCRBO         : SROXDNPGAFU     XLKWO          
QIGSKREUR       : NWFPCKDYXK      TRKSCOEOMD      JXFFGERMXWHHR  
UGXBIQH         : OGANON          JRSXMWIL        NISWI          
ILQUOIPVKJXB    : XVPOSRLNNMSK    LJQLDGPHQSIXAS 
QJXL            : TPNFMRPUKHOH    AXVW            HWCSSYFNWR      YJXRNDDJ       
RPRLBO          : NTOPJGWKYMFLQJ  YIYTYSJH        TVWWDNE         CRFYDJTKNKVVF   PGPIB           BTIX            JRMUGOFNM      
YPBSWR          : WWGXWENK        QSUMNHTDK       PINAP          
LIXCQ           : QPTA            ELRBVQ          XRKELPTKXCFWYLN CTPAVBVMYL     
YEYY            : BWSNGJDDEXA     OLWKHYYYXFR     TRKSCOEOMD      RHKLDNTHKMIH    QTUXOSAAJOGEND 
QPRQENITHUXX    : FPCDFOEDUNMMJW  VRUVBPTWTJDKR   YJRFBSH         XWUSALAMGOUA   
WOPRNIVBSTEMKF  : YIYTYSJH        CTFYSODRH      
LEACVRSAI       : THLUGIYWLBKWF   EEUYPAEOYTMYVL  KRSLW           JGABOFHRI       MUNPBKKWUI     
WRYUQNTH        : YQARAFLA        ALEHQCIDHYMCY   UWBCBGHOVIMTRW  EOOG            SYUVKQMLIBX    
MWQIYJEDXQIQD   : FISDT           VLLUHTWE        TPHODIMSMDBUIXW RLODVHTFRIA     JLXTKH          LQLWLKIEEGIXAR  PUPUYPMIGUV     GTUJ           
RHKLDNTHKMIH    : GONJTSDPJXVV    YEYY           
XBMEN           : PUXTUQUEBAM     JCRACYNKLMN     POUNYSGOBYPXADW ITHIUT         
UXIHFNFVXWYO    : TDBSNTVFD       VVLFUJTYXXWOX   TOCCAU         
JAAMNW          : AIEI            VDOUQYS        
ALEHQCIDHYMCY   : FCWJQMCSR       NTOPJGWKYMFLQJ  EYXHXBSTVCHT    FVSNRPHMURQV    WRYUQNTH        HDTJV           AMEKVN         
JENRBMOCBFN     : YGNJ            LKGPGWPGIVQK    RRWJUL         
HASGVURACI      : GIGFVNAGHBEFXU  FIGI            TPHODIMSMDBUIXW EOLGCWBXON     
NLKOBONBB       : TQIXOD          NITJOQQYEV      XXJHHYLCCVXTAXF ADSHRKDQALPXGB 
OSVDJAHQOM      : VHOICVDOSJJTBMR JWLTDYUYUIUAKV  EUBLKSXKPMVQH   SVPGTKXJDGBFTUJ
QIHN            : NLTOKAGAJWQIKFA GAEJ            YKYXJGLBBNGUQR 
YNGISTVFIYUXC   : QEDHIXAAO       MOKRQGTW        GIADKEDIU       NMVCRHOICPAAIB  LQMUMKAXJGUTK   JINJCLLOWF      BMLTEPA        
SRSOWERGUITUYC  : TCUJFQPQIO      RNXBUCMSJQ      NYKVYOJNKUF     OKVWCJDBTBU     UVQR           
MFCD            : OHAANRPTRDTPX   GSCBC           UIGK            LTCNRQ         
MVHK            : YJHPOXHSCDOMFH  VHNQLJONSALMUVC
RKYQ            : QMDCERKWUVF     BRDGXUM         CWCCARGP        LJXRSB          IFYE           
YJGT            : QAPJXTQQ        OIMXPUMM        CKDXFGNNQIU     CHRJJIWFYFGVA   IAESWR          QFOJV          
EXSKSDGNCIQ     : PMGN           
QUSEHQMRUGEV    : GSXWLRSY        WDLMEEP         AAAKHPKU       
RWJAQKGOF       : BUNDTYS         LDTBHDEAIRMQDF  MJNYMN          FSBNHKIYHTOHNX  YPHTMFIKJ      
HIAVK           : TOFEXUCK        WKWIKFKV        GNJOKKJQYGVQB   GAJBC           BHPFYUHW       
OCCJWIS         : GNVXUBWAR       RKIGGLDN       
UKLCRIBLFKLWW   : VFGNPLMCW       FOYASLVVA       YNTAXOU         CRTJD          
NEOVMOTAAIEETC  : JRLVU           KNELCMQM        MPKNOOW        
OSKBGO          : BSPR            OBJAURQCYQFHIT  IVHWLCCN        MTUSY          
QSEY            : BHSNSVQBLRBRCGV QACNCF          DQSHYLRNEG      DBMCHYHBF      
SXDNLHCHWQB     : CXTIQOYCDYFC    ICXAWBAVHXTLLG 
TLDAH           : UUYHBDJNC       XSPKUKBAV       EUBLKSXKPMVQH   YHUPHJBFEIMJ   
PVABXHRSA       : CEOJH           EXMHPSRQLU      LRNOYLGDYKXOFD 
XYQQWTEJ        : MPKNOOW         NTJSHQYGTIBSYR  UIGK           
ISAYWYUKDVSKL   : CSCE            NITRRKLRDPNHPG  GVXKU           RRXFJQMROOGWEUR
LOQUHKW         : PRCUKKVXVBGGOJX
IWKBTE          : LFITXOBUF       CEOJH           GMMUBYTPIV     
FIPYIQVI        : FXTVAUISLBVYT   TSWTIP          NAXUPW          FRSWSQBPIGK     HOALTQYQLL     
GLKBXXSLPJIW    : KGWWBXUNLY      IMIIMCIYDBEIE   VGKLMNNNRJ      YFSCMIJ         GUDKNOWTMLMSTO 
GQEDCHYIQ       : LSLNB          
QIGACCKQKXBOVB  : ISGYWBRXAIN     JRSFFQBQ       
IQSQPPWHVCLGCTW : KAIRCTVYJKVQSJN LNIP           
LIPNKRA         : JJJMLPAWBN      LDTBHDEAIRMQDF  LOPSDUWTNAJID   LHBWBMINQQYNH   YXQM            FYKAATAJARFDB   LHJIOUARS      
EXESTFCEYX      : NOWX            BXMEVKRJJDY     TTCWPHKWMVIME  
ONUXLXJRAGRJT   : EJFOTHTWMNQFSK  SIYUTI          KVKBAWLQAYWN    RTNUFK          SLWGTSQCDSKTU  
YHKSHLYFRU      : JESYNTCMPGMM    ICCLG           PFJDBCORME     
WWGXWENK        : KRASLPCJSBR     ROVMWHD         YPBSWR          BYPIDEBDAYFGISC FBEF            LJXRSB         
NYWXQYEIIAIHHUC : EQMVYHKGUDI     UFQDSIORU       OOQYBJNTTWS     PPWIJGUBDQ      AAWGRFRIGAPYUXA CTCVSNOWXOW    
ICXAWBAVHXTLLG  : OVXDHRC         QOVCVWUKXK      SXDNLHCHWQB    
AFKAWKGHSG      : WKJH            ETNLMUKIOKBBBV  FEWVXEHJ        MEPELMQHDILQL  
DPNHIWLGWIHW    : TEILWJLVXGRPEMD JTORSPHXSS      KNKGTMXBM       UCSLSE          CQQANDJNWRXL    RXRWI           LNHPVIQ        
RXBD            : MGNVRTH         RYXBHOSAAHIW    HMOLRBSGGEVAT   WXAY           
JQLPCNOOVV      : DLNLJV          LUXLLQQEBWWW    AXCKRDLFOSB     YFSCMIJ        
EOMTF           : NPHNQEQKEUDB    QVIM            RWIP           
CEIKBTSBB       : THLUGIYWLBKWF   ICCLG           JAUSXQPLPOFX    WPRWQYNEMCQ    
YEPKNJYFL       : RAHYUQOLIXU     ELDCC          
VCNULRLBOQXSUG  : GLFANTPRLN      CKADDRGIP       OEHABNEJJJP    
YAYCDLB         : VHFGGRNSGSKF    YWREI           CJNKVYIRDPST   
DNXMOFAGCCTW    : SVEN            LFHPRIHUCOIS    LMFWO           VOQM            RKKUPIDGO      
LIPCAPVW        : BBDSYFTAUBQDIX  TUKRVBXI       
AVBBXE          : YHIGTQF         CGYRPWFJMOL     BCCYGDIGOKKFRX 
BOPROFGT        : IBTKSTUIT       HLKKWXGOAGI     YENHL          
MVIIUYUEOYG     : LYGJU           MNUENANARY      HCONQA         
UDEWCFXCMMED    : DYXSIHD         XBFNDQG        
XRKELPTKXCFWYLN : CGYRPWFJMOL     RSKQABGMAD      LIXCQ           BXGYYMU         KIQKYC         
TVVXBTCITEWH    : XJBSTRWCDJX     LAFGLS          TJXC           
AMITW           : CHSGGQKRLJHLQY  NKMW            GTASDFMHQ       LCYDHGUQPD      VQACDVRHRUCRGI  DOKNMNBHYBWRCS  OFNKEWFV       
IOJSNN          : TPNFMRPUKHOH    KILCECQJBDM     KLYTPANFYXYI    ADYQEW          UWOOPYWPPYN    
MPODQIYMICGK    : VQQQPNBLJQVLJJT YWLKTTPILTI     ETNLMUKIOKBBBV  PFJDBCORME     
DRKKCN          : YQHWOEECP       HEFYMV          NMJMUSTI        QTTO            QYTAA          
LHVBPMMKAC      : XWUSALAMGOUA   
PRCUKKVXVBGGOJX : NRWDGQMVAQMHKBI CAPUOCAMBAPIY   OGANON          CGHUIRWRPRRBRM  LOQUHKW         AVTXP           ADDQCAWGDEE    
VDOUQYS         : JAAMNW          UOAIENYSVBI     VNDXBLSOWPKRN  
QGICI           : PYJOMVKEVKGNQ   OYKUSSAFNBSBRL  OSCIYMYILHQ     KJJERBLQRV      NJAWFIJCBDYV   
RAFTU           : IVHWLCCN       
GRPCU           : AMEKVN         
LJKLKHOCEH      : AEUSQYJLXJDDR   YMRIQLTWIGWI    TREPATDJQUDDIU  SCOPR           WWYYCJR        
XBTGJXOWP       : LNVDQ           KRASLPCJSBR    
CLKTSEMWYN      : MOJIWJFMMFQW    PDAWCHFKDXRN    SSMHP           LATAVNAWTMH    
KXWXHLCOVF      : HSRYIUYHYIM     NSPLPLSCEXM     WVRAQLQSKHAUQV  EHDIJ           RKNFOQG         HKQNHPNVOCA    
WBSJCJGTYKGMGB  : TUETHPTYSCVILCH XYXOEAOYEN      TJDTASPBXUEOI   EXFJT           EUBLKSXKPMVQH  
SAUGJHHIFQV     : PYHBSGGDEJCHITT TSWTIP          GLYSTLVDAYKRIMS KRDK            CHTTOSMYDMNWGQW ILVMNVKFLDWWQ   MUGYEE          OHKE           
FROTPSOYWBHQA   : MKWCCS          PTRKSOVMJUVUJWJ QGFJDFL        
YOXCK           : SQYATKXRQY      PDCFSVS         CKIKW          
DFAOOJW         : HKQDKLBB        ILYAR           XGVFMBQSX      
DSEKLVHDQXENY   : WUBTPOVTDNTDRA  THDNK           FJVQFHVEVNXXIP 
GCDGQDID        : ETVKCRUIFAMEDVY FLATXWMDYRGAGC  HHXO           
LIACXLY         : XIIRQLSTEUYA    VSOUMWLPVBOVGN  JXFFGERMXWHHR  
OSBCGW          : ISJU            OINTKLHPAN     
JPHP            : NTOPJGWKYMFLQJ 
JBMLG           : RLPGODS         YQARAFLA        VNRGTUMRWWQQV   XCIOAROJ        ABVVR           LTCNRQ          GOVHYWDDBBOGGBK
EJDIJRSJT       : NJSLIWXCQFW     UUOGMQ          THRKOGCEX       JPYP            JXWLEGJEJTE     LNBK           
UTNMOROUQXG     : CRRMIEP         JRYT           
HVMQY           : SBTBIEODSEWY    KUXDDVE         KQYJRBNAKEYUSSN MTEECDS        
CHTHQ           : DUUOBLGQEPF     FSBNHKIYHTOHNX  KIWULYBNR       LXKNLDSOTV      BJEVXIWDQSKB    UPVLCXFR        VUBACB          PWQWPQYMOKKVH  
CHTHQ           : IGBA           
RARKLLEHHTT     : YNSTPWUNKY      JRYT            UENADHXBX      
NIUFIBOPYBH     : FLATXWMDYRGAGC  RWYSNJMFEXL     FHDFCSEWFEYEHN  BSBETHF        
DLHYUB          : ALUVEO          CIHNW           RYYQWUXSINMAV   IGBA           
MDQAPFGWM       : UDBIHGQDSBRQP   IPWMNQMS        LEVTPLR         OVLBIEKVNTHE    LMPUFMUGHOKGIN  OHKGY          
SNQDI           : AMUAQUCEI       RQCOACWS       
NKMDLPMO        : GAJBC           GQRHILTTSPEB   
BVSVYR          : DUUOBLGQEPF     NQVGBPNWKMUEXO  UCVFBHIIJFXWRXJ WPQFSLWEADAJYFB
DLLSQTRFVKSOPE  : NOSMOQCIPBETJ   CBRLBBXRHPUFKK  UDFQ            PYJOMVKEVKGNQ   NKAQBYNVYW      VOFLLKBRCOM     LXGTMPWJRNWQC   QBFNUF         
DLLSQTRFVKSOPE  : AMEKVN         
DOYICPXSKYRF    : AAELUGQ         GWXOHUWFGPHTYCO CCBVGNJXTBW     NPRI            IOLIIVPQW      
QXITL           : MVXMARTLXTOFRUM HCBRQIIBK       MUFUMWFTY       FOPE            LSFAKLFQJTJ     QKBKBUWJ       
MEPELMQHDILQL   : BYIWGVNX        NTMXHDOH        QMCQGXWIAIQQ    AFKAWKGHSG      MUGYEE         
RWGHUAUTRAQIA   : KHUJOKRAB       NCYPR           MKAQKIFVQQ      PDXB           
DLVRROWE        : JTQEWVR         UXJNKBNYK       LEGI           
PLGY            : LPCFXQYSXXQAGHD KRASLPCJSBR     VKWXOAP        
WMBP            : XTYEUAYAY       NPGINWJDBQXISKF QGFJDFL         DCPHGCVDTKQQBS  TLCHBQ         
HYEHT           : XIJX            DLXR            LHJIOUARS       LQLWLKIEEGIXAR 
BWRKWTPL        : FAGIVKVAWKYHPG  BHPFYUHW        HBAYMDATTGWPD  
HDGGJJYWQX      : QSRI            NCYPR           DDSGLJSVJEBTNYH HUBTCKUPTBV     ICBRQMCHFQ     
PMWHWHHD        : TMLFBXBTGHBSITF QBPVUCKTJHPCUDH CXVUHPCFVCXDD  
DESAXFARWLJE    : CKGJWQSAUWTNMBI DWKPBGCQA      
SNBCMXUMULYTUXD : INOJVRMNKYGOFK  FPKB            YOJIOS          SJCFXGHQYGUMJS  FXGPM           AXAVP          
CWIGPKEWKXTXHA  : DKHSEFWY        JINJCLLOWF      UOAIENYSVBI    
ANQFCQCONNOKJMN : RMYFKGVOCXNMWX  RGGLWKPA       
OKVWCJDBTBU     : UTNSCYXEL       YDHHRONS        LQMSKJWBQV      JDXM            LHXIFARK        SRSOWERGUITUYC  PINAP          
LXKNLDSOTV      : LRJVVOLEGKV     CHTHQ          
KLTUWJI         : LVXU            NEMLLOW         RJHERXOSO       EWXRVM         
AVLAAUD         : SBRHQTEQME     
PHYKSWWGLACCTX  : ITHIUT         
ELEBLNMYN       : PJYWNUXKKDGK    QAIIACLL        IVXHORHFQWMDYD  RJHERXOSO       HBSDQBVTSSW    
KNKGTMXBM       : DPNHIWLGWIHW    TFPJGQSWR      
TLHCWHEBDE      : VRSYCYWDRCYNB   ENDESRTYTYVLLB  ICJXRXK         TSDQJMTJ        XBFNDQG        
KSNLEDXD        : SDWNCRE         WUBTPOVTDNTDRA 
IPJTXDI         : YVIDNMFKSI     
GWICLREKBLMHR   : VBTQFILAIDJBK   TREPATDJQUDDIU 
RKNFOQG         : JANCFEX         DFJBPGCSR       LIBE            KXWXHLCOVF     
LQMUMKAXJGUTK   : ROVW            BDCNN           YNGISTVFIYUXC   VEIAFUMIAEBO   
MRRPDGWWEQ      : LMHEJMHPUSKAB   NRVETMFKIXQCE   JCHVSJ          YOHIGHHPIQVGO   EYMKCD          JBXVBMIH       
RWYKFVVVITLST   : FCAMHSSTKGPU    RDEPCBAHU       SPAJLJHQSM      KEMTBDHCUKXQ   
EDGYNPNFJDK     : JRLVU           SSSVGXMQ        ENSE            AICESO         
DITTS           : KQYBKXNFTFYKCKL LGPLBJHGDKILMGT
STXAPVYA        : CGHUIRWRPRRBRM  KRCTGTLEQ       ULJDWXBJJW     
KVMTAPCBFRO     : KGWWBXUNLY      RQBLVRHAJ       QKLOCJFXY       IETCAWRLRKHMQFE
BUXQAIMTDA      : QDJQUFTBKQFDEX  GYPFGMKXWKHVU   YIDQB           CTBEGLNYQEA    
XAPPYOQ         : DTAWHXIVSL      DEVSNTKS       
BODWOU          : BWSNGJDDEXA     JURV           
SBRHQTEQME      : AGSAVH          AVLAAUD         RMDWNJELBXIBJ   KWDKQ          
ABDCSDFITEAMUD  : EUBLKSXKPMVQH   LNBK            UWEWFTRKNDOAB  
YBRVB           : NAXUPW          NWMIQ          
YUUPQBHEIJGLO   : GGBB            USPLKGDNDYBWAEU ISGYWBRXAIN    
ESPOOVODRU      : AJWYJKON        VBXPUEQ         WGJVYXS        
SVXQYL          : PTXDVNTNWRIM    KHJUCENANL      DGUUTKVFQ      
TIGL            : ASRBDVA         DIQLBEK        
PRRB            : CXBC            BGDBQPMQEDEUQN  MNPKF          
DQIJLBY         : XBETJJ          IWDTWCHD       
WPDQKJLGHDHUT   : LKGPGWPGIVQK    YNSG            TWQIXLHFCN     
DCPPUHJVHNOR    : CROXVA          XDCVFPUJ        UKQJXGBJHD     
AUXAS           : TJDTASPBXUEOI   YIDQB           QTUXOSAAJOGEND 
FLBOAKYDRVYVA   : OENBBGRCHTVNS   PHMGDCXXKDI     BYPIDEBDAYFGISC HKICRNBOL      
LPXU            : YIYTYSJH        ADUMWYBDPQI    
WEOLYOMT        : ECTMCXEMUJ      CRELT           YPQJCY          SGNWEPUMV       ABVVR           CDQUIRBDRCW     QUQTJLXBSTHIVPF AVXTPMVBI      
OOFWBJLBT       : KHHPQQXXPMLMMV  JQVOUKHBA       UXWVXTAEPQUN    TJCC            SISRXNEGSKV    
GNJHKLKXDLTEI   : KKMVYIHEXSKN    CWRC            ETVKCRUIFAMEDVY CLEMHQHKT       KKCGJWQJPEEX    TFQJVNEC        DQLG           
TVYKKT          : UKAVQ           AAWGRFRIGAPYUXA OYNXFKUGSAHFW  
CIJYLSMOOC      : HBSNUMCBKTHFOAX BHSNSVQBLRBRCGV DCJG           
CNEOYRNE        : NJROHMTVDVGEF   ENLGULI        
JINJCLLOWF      : YNGISTVFIYUXC   CWIGPKEWKXTXHA  KGUBGWKRB      
BPAAEUOUJQSLEY  : FGAY            VAITAQEHW       UPAXYVCKPBN     OOHK            VSHBKAYGQAVCI  
FQQJVASJLWXWM   : YNFUTYUQEBEUNSW UPHJAYAHO       CKGJWQSAUWTNMBI HSREFWEOYIQCM  
EFXWHXDCOXLGSY  : XTYEUAYAY       PNQME          
UCSLSE          : IAFCAOF         FUOVEPVS        HUQCHRJMS       DPNHIWLGWIHW    NTJSHQYGTIBSYR 
UYTHWRELOLQMIAM : ENVQAUCYQ       QEWKNSETMXLEAO  QJJXFCHK        SKEUANKRHGJWUU 
CCLPKFQWAVR     : DQEJPNVKTRN     NJEANQFJBNF     HNSFJQHHYA      QIBADDBXXKPYL  
QYXMXU          : ITFGWSSXNP      QSGEQ           WPDMPLOCHBNIYC  JTTFTQRR        KWPMUTIHUVGNW   LATAVNAWTMH     PIGPDTB        
UOAIENYSVBI     : VDOUQYS         CWIGPKEWKXTXHA  MRVWS           PYBJNBKWCEEBPT 
FMVWWBOV        : TOCTFFELFAEQE   GGBB            KKBFVTPNWUGED  
MQSDPRPPMLLDOT  : OSPDPA          WDLMEEP        
CVDBYLKFXGCWJS  : IPLLXOPXYHKPMST VAOFPMU         WQOYVFC        
OFLIJB          : YGNJ            YTRJBLL         JBSRQHJRV       QCTTDC          BHHH           
BTQPFT          : KRDK           
BEIY            : IHJGWIKOG       QOCB            JPBIFSUIARSJ   
JYUWGSFIP       : GIJRXBOMILRT    XYXOEAOYEN      YWRVLU          QTTO           
CKGJWQSAUWTNMBI : QGDC            UVKRIMTNTOI     CTCVSNOWXOW     RCLTUYQDULV     DESAXFARWLJE    FQQJVASJLWXWM   JGABOFHRI      
FOBGVNHSKNLRY   : QYUJUNMIF       HQCRM           UIFTEFMQOQOW    GMMUBYTPIV      UWSCVMTHD       QYPJJB         
JDPSM           : YGNJ            IVEUWKLCWWA     PMGN           
LIPHFL          : UUOGMQ          OOQYBJNTTWS     VOFLLKBRCOM     HPJJAVSIT       PEPJJEUMQEGBFK 
TPFMUVNDTBLMNBX : DBMWWLCVJFPN    SIHD            DNSTB          
ADRDTKQIWBX     : WBXKK           KWPMUTIHUVGNW   GVNUAQWOMB      JWNBVUDJUFKFDW 
IMDCCLOYHCCCGP  : RXUJJABDGIJQ    SNIKBP          QUQIMEVXFLX     VHVKE          
VRPERSWXOJQXGR  : IUWXIWMBL       KUIILJLLFRTILI  VYKU            CJVNMGUXWPLSIH  UDYIRPPYNNWTU   VMWTTDJXK      
OAKS            : CPDAWYSXXGWPP   XDCVFPUJ        WDCXJLYALWMF    PLUOHLORCTDE   
MEQNLUQPDIFCA   : OSCIYMYILHQ     NLEUNHEHTTTR    DHWPSDGFWP      KWPMUTIHUVGNW  
GUPFSHPJ        : WJDVGOCWTEVTOBQ WNFDLB          VQACDVRHRUCRGI  QEUDHDMOBOGGFLE
XBFNDQG         : NJSLIWXCQFW     BYIWGVNX        PCXUERHDX       UDEWCFXCMMED    TLHCWHEBDE      HFJSKONXDYEF   
FMXTXUMQB       : WKWIKFKV        QGOURVQ         INVPMVXYWHMQK   QLLCFAXEI       PQBT           
VDXSLSKR        : EAVSL           RTNUFK          PNDVOUBU       
RHWYHAFUDXD     : XCEHHPRUKCU    
FPKB            : FPDVUMUUKTNL    SNBCMXUMULYTUXD FPFOPKPFCBM    
FNHILDLJXXC     : BACQQETIRFUQ    TCTARPTOXA      FXTVAUISLBVYT   DCWTQ           CWQWXNII       
RPDBMEIOL       : EUXBMTRGRKWS    AJWYJKON        DKHSEFWY        XYAIGTOCPAOITJG MWTSP          
RJHERXOSO       : MOJIWJFMMFQW    DANCELLCRMKEMVX TNYUG           KLTUWJI         ELEBLNMYN      
HVFSBSEBSGLK    : CLSEVKQPVA      UUKL            EFGNSUF         XYAIGTOCPAOITJG JBXVBMIH       
QLKVUYHBSTKWLKN : XWTJBGFET       FVSNRPHMURQV    VOVIKUHEUXNYMH  QKBKBUWJ        RXRWI          
BJNYQIAKMB      : EWCUSQALSYDJQ   UXJNKBNYK       IEGBJ           FRXAEYQNVQGB    AYWN            GGHNKTXFHQS    
UPQSGCDCY       : POAXB           YJHPOXHSCDOMFH  SIYUTI          SGNWEPUMV      
MCWGNVTAJA      : YXNLS           ILYAR          
VOBOY           : UKAVQ           QLLCFAXEI       TXXNINVMFWNPX   BLNJVEV        
YMHFJWVDE       : AXFHEYEIDJT     MDCS            IEAAH          
IGCNU           : FPLXGDRUPGAB    UTPDBNCKCFO     VWRGBTMJWVFKRRC FMTL            TQPOJFE         EYMKCD          NYBMRLFJ       
MDTLWUWXWSO     : KMCW            EVBVKWKYDF      QDXNREEDL       BXGYYMU        
KNELCMQM        : IVSVQXP         ETKAX           FUEWVNYOYA      NEOVMOTAAIEETC 
ORNRAWTNRADXUO  : FKGRP           EVPBX           RDEPCBAHU       NRCWTTQRCTC     TCUNXWUJJOQ    
PLUOHLORCTDE    : PLRV            OAKS            YOJIOS          RSCIVHJRVFDF   
USPLKGDNDYBWAEU : KQXOUJWCKQJJOPF JXRNDEOLI       OIMXPUMM        MIEEPGPVQEGLGT  YUUPQBHEIJGLO   PKKMEGMHJA     
SSMHP           : EDQGMPTELVU     CLKTSEMWYN      HBSDQBVTSSW     QINVJGREPLOVGQ 
OCRGGLJMRGGKSSQ : EEHHIOEIM       DFOLHXUHV       VMWTTDJXK       MKXPHJGXAET    
GVXKU           : NJSLIWXCQFW     ISAYWYUKDVSKL   BOIWWJJHXFPTO   JSUIUG          DGUUTKVFQ      
QSUMNHTDK       : DEBKGKGBAB      YPBSWR          ASQTLKUPBLR     JVQWWHUUVN     
HCONQA          : TPHODIMSMDBUIXW MVIIUYUEOYG     VISEUJBHLN     
KHJUCENANL      : DFQAPIREPQQ     SVXQYL          VEIAFUMIAEBO    FPJQMREHB      
AHAQCUDPEYUQHFV : GNVXUBWAR       XCOLFVTRL       LCFVHUFLXRK     QRBUR          
UMYXWG          : RCWUJMP         RCCTXQJAADDRM   AWBN           
UKOKKCWNCGN     : GDGKESLEKUGJTHS OSCIYMYILHQ    
ILYAR           : UUEBEBCRAFPGIR  SIYUTI          QCVBA           DFAOOJW         MCWGNVTAJA      UEXMOTQFEQ     
WLIEHGAVHXSPG   : LHEGEC          TCUJFQPQIO      YVKCIIFYRCGNL   HYPC            TWJJPDFFLLUUYGT
AWBN            : VATN            RTUIS           UMYXWG          LWFGCQHRG      
XBBEQV          : PBFYPC          UYTT            OCSA            NYKVYOJNKUF     BPDQXA          UUPMPQLKJOXJB   SNIKBP         
CWQWXNII        : CNOCKAHURLTAT   HVSETNXYT       FNHILDLJXXC    
POUNYSGOBYPXADW : LHXIFARK        XBMEN           LTOSKFYPUKF    
EAEWYUCXLYVBJEV : YNSTPWUNKY      PINMYYUPO       OMAPIFA         TCDHXENJ        WBKODWEXBRBORSQ RYAOTGLR        QUQIMEVXFLX    
VSOUMWLPVBOVGN  : XRIIJ           LIACXLY         FJVQFHVEVNXXIP 
MQCKR           : MUWG            XCQWYKPFLW      FULDCVYPXXAVTPQ
MPKNOOW         : RRWJUL          GAJBC           AWDFNQ          NEOVMOTAAIEETC  XYQQWTEJ        JVQUIL         
MXQGMNUJCKGD    : BQQRSMJODLIK    CJBPC           AOQSDB          LCSFILXB        GIGFVNAGHBEFXU  DOKXTKBYJGWY    IAESWR         
EMPBYGFJAFXP    : YDNSJV          XAHSVA          GFBI            EYMDUOBFBT     
LEGI            : VAEEJYONX       DLVRROWE        PGUCXWHWPRRXLLM YLTYMYJAM      
VISEUJBHLN      : HCONQA          XIVRSIMRANHT    TUOLSWAPOACV   
QPTDH           : SJRPOOCPDWAP    UERFN           KBMYAGJNSJN     KILCECQJBDM     EXFJT           DGUUTKVFQ      
FPFOPKPFCBM     : DFQAPIREPQQ     KLYTPANFYXYI    IWDTWCHD        FPKB           
MMJUHNS         : LKGPGWPGIVQK    IXWMO           RQCOACWS       
QAEERVTNBBLG    : AFCKQKEKHKGPSFX RSHO            KNUWGSY         NBFVNBIOKHKBK  
QXGDNOFQBQDPCYW : KTNMGFX         KIMUEFWEGBXDSM  TKPRL           LMFWO           BKBUUWHM        FYXGP          
TQITUNNSJBUN    : EUWLU           RDXL            GFDEBIEBPUBE    AWBBISRAVY      FHFVHFNCSO      SNXLMI         
BGHBNKQEQIFJ    : UVQR            QSSXNTX         RSDDFBEAWO      LRNOYLGDYKXOFD 
UMMREGKNCGDP    : MLIICWCJCGAHIAX AANFMLRHJTJKS  
MRVAGAHOBW      : VWTSFSDSH       GAJBC           HOCVUL         
SBTBIEODSEWY    : AJCGDSGLJSGUMGB HVMQY           NDVDSXIFFWWGNAX BYPIDEBDAYFGISC TVMBX          
IOPQRFR         : NOAH            KKXWVAH         YHQGJMFHN      
YOJIOS          : GJDVJGIJ        SNBCMXUMULYTUXD PLUOHLORCTDE   
PRAKUUNDB       : OVQFCQXH        JSATKNNDW      
ITHIUT          : RVELR           HCWSMV          NHXTNXJAHQGK    XBMEN           PHYKSWWGLACCTX  MNPKF           OWCFI          
KJJERBLQRV      : EJFOTHTWMNQFSK  QGICI          
GQAY            : DBMWWLCVJFPN    OYUSOFKXMTT    
BJEVXIWDQSKB    : POAXB           LDQCBXUFBJTJSFY LNIP            CHTHQ           URTYW           JRSFFQBQ       
GTASDFMHQ       : PIPVOB          DNKFUJHO        IQJEMG          LAWJXUNSJ       AMITW          
YOHIGHHPIQVGO   : GIADKEDIU       MRRPDGWWEQ      GGHNKTXFHQS    
FRXAEYQNVQGB    : BJNYQIAKMB      TATOALYADBSV   
SIPA            : QYFDXEQUCDGIJ   HHXO            WCNGTSMANIDB    USILFK         
EHSMPAEASBJIH   : KSFASGQBVQNJJCD GPCNJVLROHADI   WCJVEQDOTB      QKSVUUGONSS     JRWT           
CHRJJIWFYFGVA   : EBRHVUGTJGGJXX  RWSESNSOVHAXFF  XYNQONIVVQRFKEB ASRBDVA         YJGT            FEMRWSVCGH      GTUJ           
LAERIYHAYLCR    : TKPRL           YQHWOEECP       DIYVCJSCBGU    
LCYDHGUQPD      : AMITW           QBPVUCKTJHPCUDH EYREIT          WQOYVFC        
WCUGA           : AJWYJKON        ASKHBXIMBT      IVXHORHFQWMDYD  DOKXTKBYJGWY    QPLTMFPCU      
ANWEIHDP        : RSHO            CXSOXPBAL       JBSRQHJRV       AFWJU           HYCE            GKJILRM        
EDMXS           : MLIICWCJCGAHIAX
BRDKAXBS        : LYRGJYLMEKD    
SPGPXGMX        : BGNT            CEDL            IVAWEE         
LCFVHUFLXRK     : EXFJT           AHAQCUDPEYUQHFV FYKAATAJARFDB   DNSTB           UJDFPIUUCQYKOGT KJCWDEEA       
SNMVXNUBGXTXG   : EKEXXCIINSVYAO  YXNLS           CTCVSNOWXOW     MOFALGFFJ       PMFSRNSOWNF     VETOEW         
WPVUMJAR        : PDCFSVS         XTYEUAYAY      
HOLVOFGIXVWWV   : TOLDWYSVTQYVVV  TSDQJMTJ       
TWSRSR          : DVVROBBKOUWBG   TXTEEYOQXYATL   OFIGICLCQ      
CQQANDJNWRXL    : QAPTYHWHKEUSNQ  PSHSTGEMHF      DPNHIWLGWIHW    XDNPCKXISDU    
TAIC            : HQNTQ          
JAKGV           : LQGQ            CTFYSODRH       VQAEJ          
ASQTLKUPBLR     : GXQDRSQSA       SFJUNTKKIHCLBMP IVXHORHFQWMDYD  QSUMNHTDK       IVHWLCCN        WYNGL          
QBFNUF          : PFTFTSG         VORSEFXIFTXM    UXLHJOMUQFE     DLLSQTRFVKSOPE  KROII          
XBCJF           : SYIDKGO         UTJL            MQFQJ          
UFYDDWDVNY      : XFMSFMUQHVJD    OFADUIT         WPQFSLWEADAJYFB UIBMHMTGVJMK    MTUSY           IWPMCWTCNMHWLP 
AWBBISRAVY      : TQITUNNSJBUN    CTBEGLNYQEA    
RGPRJ           : LKKIIENVV       GQOSVWLQUFO     CHWAIKJH        VKWXOAP         LMORFODFXBNE    YVIDNMFKSI      BSBETHF        
DOKXTKBYJGWY    : BNCFHUKKMXMOV   GXMV            AOWS            MXQGMNUJCKGD    WCUGA           TIGBW           RBBYQSBNLWUKR   FXGPM          
DOKXTKBYJGWY    : TATOALYADBSV   
IYDJC           : OMBT            XSNJHERU        NOLBXQPFITQQKTD
EVPBX           : LOPSDUWTNAJID   YPQJCY          ORNRAWTNRADXUO  FMOQPOW        
UEXMOTQFEQ      : TQIXOD          ILYAR           TBBBGG         
OSBA            : AWWRREIKYLNF    RGFDIESPNL      GOJAP          
YYJHAORCFXYU    : NPRI            BIDKVSBNGTFEHP  YVIDNMFKSI     
YDVFDJVWC       : VBLBMLWWFCDDU   ELVLG           IJQVUSIJECCM    YEWCJKJLWNXE    SIWVCSECEACV   
CUESPFVRGWBOX   : WJDVGOCWTEVTOBQ KGPBDDHBXXN     ERKAKFW         HVSLELHOJXCEYEQ HFRPSXEGNE      JRWT           
ICVGDSICYEIEPE  : IICXTUBTMBTXC   TKXAV           JWSIVIHETD     
TGGPMBFUYWBWBR  : EQMVYHKGUDI     PPWIJGUBDQ      NHVGWTKBLOABHQ  YJXVIJHRHPHEG  
TCYRJDKTFLANQ   : KIQKYC         
UUKDDAQGINGFOFI : KEWSQEB         HHGGVJLYUIGU    LSFAKLFQJTJ     RQCOACWS       
CCLB            : SBGHLLYYMF      YNQPJXR        
WEHQ            : XCQWYKPFLW      POIXIDCQMXMIQS  YQPTTTBQMNNRIMS MADUBLYDXSWOOJ  XCEHHPRUKCU    
UTALK           : GNCADUD         GLFANTPRLN      FUEWVNYOYA     
IWBNATUIHDPVIYH : RGUMSUECCOENMJR KIMUEFWEGBXDSM  BLNU            USMRBTCYRHF     KFKQCAAQGIFBWI  LTSO           
DTLAQ           : EOUEKCLTXLMVFUP SKNVGLPXNT      VOVIKUHEUXNYMH  SUEWTC          AKHAEB         
HKDEEFSQDBNGPP  : HSRYIUYHYIM     EROVHEWMOG      AJYFOMMVUUTGG   DNSTB           TCUNXWUJJOQ    
MXHP            : FYNAOYMJLXB     RUTLHHBKH       OYUSOFKXMTT     UMSBUBOH       
DXRLKUHXWXQG    : EJMCOCGPTGLGXHO GRBOHDM        
VLQE            : SDADSLSHM       YIIABOQBFIIXEYG NJAWFIJCBDYV    SNCQYF         
HHFX            : VHOICVDOSJJTBMR QMDYJBNSVKA     TVVNUIOQG       RWIAW           RCLTUYQDULV     QOGDPSRHQBLXQ  
WNNJOUY         : YNFUTYUQEBEUNSW XFMSFMUQHVJD    FIGI            GFBI            UXXL           
AYWN            : NTTDIXOTONFAYBW KCDSMHLGVLVBN   BJNYQIAKMB      VQUEJF         
TUKRVBXI        : EEUYPAEOYTMYVL  LIPCAPVW        HOFYCIK         QLNENTYVOA      KFUBMOMV       
JAENHLVF        : FRXFGVDLGUOO    UTLXESOMEJVAAH  QGFJDFL        
SVQFKNE         : UTPDBNCKCFO     NQAXTKJBMBEUPRH YCXX            FYXGP          
NGOEP           : IUWXIWMBL       VHNODUAWVMFI   
BCCYGDIGOKKFRX  : AVBBXE          AFMEPYED       
ABVVR           : RNXBUCMSJQ      TMPKA           JBMLG           WEOLYOMT       
IFIXUOO         : HEPDSHTLXF      BNJBORLJEGGK   
GYDJECPHM       : ASWELFXY        WBXKK           GEGM            YIYUQBCLB      
XWIDRIGTJFPB    : OVBRHG          WLRK           
AIQXDHOHQNKAT   : IIGLE           YXNLS          
RDEPCBAHU       : FKGRP           QXKTDPTDEFMLWM  XKUBBLECKPYNE   MADUBLYDXSWOOJ  RWYKFVVVITLST   ORNRAWTNRADXUO 
OORVGUEGDXGI    : PJDPRDFGKECASC  BHAA            YHUPHJBFEIMJ    FWOSFIVGPYV    
UPVLCXFR        : VWTSFSDSH       BFYINAGQSUABCDD ETKAX           EMHGAWGNERGGT   CHTHQ          
JVJLYJ          : JLACNA          GBCIQUT         YBMAAOOILH      QPWAXXQLSQPQONA
UTJL            : YSEUSYWQ        XBCJF          
FSIMBLKIW       : EOBYNKEYCYFQGN  UTYJLHJX        JPSGRKIRNPJGPJN KBDIASQLRQADX   CFXPIUITQO      JTRTDCONTG      DDHYOT         
FMOQPOW         : NPGUYYBFDXARM   JUDONGJCJDBG    SXKGYTHTLY      LUJARHLGUMTT    EVPBX           HEFYMV         
HIFSVGDQDYDPN   : VWTSFSDSH       JQLROPEUMULXNCR UDUHG          
KVULIHTFAC      : EQMVYHKGUDI     NLNBV           MOEAGBFMTTLUMAE
QSLFRUOACIXJNP  : QAFYGUICVCDJ    PMGN            DEJK           
MSEADOYBDJK     : BBDSYFTAUBQDIX  RNHRUMCA        UWBCBGHOVIMTRW 
QKBKBUWJ        : UFQDSIORU       ELVLG           AUWGI           FVSNRPHMURQV    SQEIUWRVWHKEC   QXITL           QLKVUYHBSTKWLKN
RXRWI           : SMMGLWNMY       DPNHIWLGWIHW    QLKVUYHBSTKWLKN
IVHWLCCN        : JEVJOQH         OSKBGO          RAFTU           ASQTLKUPBLR     OTFRD          
SMJVVTVMHWA     : PJDPRDFGKECASC  QEDHIXAAO       UBVIGRRCEVDVMI 
TWTJQ           : FXGPM          
BPDQXA          : JLACNA          VHOICVDOSJJTBMR MUUXYKYBM       XBBEQV         
VNDXBLSOWPKRN   : ROVMWHD         VDOUQYS         BTPMEQKFT      
BKALFYGOR       : LOPSDUWTNAJID  
RIEKGG          : DVVROBBKOUWBG  
CTPAVBVMYL      : MDOIDY          LIXCQ          
SYYTLBFSAN      : MRIDJWOSL       FHDOHDQRUVFC   
SOBBTMHC        : EQMVYHKGUDI     HMYJUKOCIL      LHEGEC          LHSTXOLYSOWKXQ  ULJDWXBJJW     
KWPMUTIHUVGNW   : AUPOVETVSSJGN   QYXMXU          ADRDTKQIWBX     MEQNLUQPDIFCA   TATOALYADBSV    SIHNWNGVFOJ    
JJJQCMFMFV      : VTCCBYRKPXGM    MUMKXSFOAWL     FBEF           
IRCRUBETQTOMEVH : VRXC            MCKWHSA        
EWXMGJYAO       : KCOUASNDMIRGDQM XAHSVA          EVXNUYP         YVMMPXYOTAAEPJP HEFYMV         
HBSDQBVTSSW     : ELEBLNMYN       SSMHP           JUEKRVY        
MPTBDX          : EOREWYOUVRNPFTB ABCENREK        KJCWDEEA        JUEKRVY        
KBDIASQLRQADX   : FCAMHSSTKGPU    MUMKXSFOAWL     FSIMBLKIW       FGVGJHNNLM     
XEUYAQTU        : PDCFSVS         BESPHR          JXOWCN          GMGQL           VNARH           GOJAP           DMWYQNGSATPQCUC
THDNK           : VNRGTUMRWWQQV   UGTG            DSEKLVHDQXENY   NWBUUUJAI       ISGYWBRXAIN     WQGBFIRBI      
OJRPOARHSEBKG   : HCJQUGM         BLQBWMGXJF      GWROHQGGUBF    
KKEOHDQXA       : VXDAVHDNBABM    EFGNSUF        
LTSO            : SCRDMXY         CIHNW           IWBNATUIHDPVIYH JHWBL          
DXYOPOERHLKNNW  : WKXXUUYCUIOGWDM FEWVXEHJ       
TIGBW           : PTXDVNTNWRIM    NECTBRLKFSEMG   TMLFBXBTGHBSITF DOKXTKBYJGWY    YIYUQBCLB       KYFYUIHU        NWMIQ          
EOLGCWBXON      : AJYD            MEGS            HASGVURACI     
MMSEDWXMKIAAIW  : XBMHVCIKXXNEYL  YNUEDWPYGQJDP   WBBLCEHFP       OSCIYMYILHQ     JLXODF         
QDXNREEDL       : AHCVQUG         QWMJW           QOCB            DUXBOVHKNPLKHT  MDTLWUWXWSO     FYJDPIFJ        YHUPHJBFEIMJ    NMJMUSTI       
QDXNREEDL       : FJQDECIJKTCLB  
DOHRCIGQDKVAI   : MJNYMN          VUCCK           NFFUDPGKDFOLEK  BHVFLWQR        JUEKRVY        
LSLNB           : MDLHAHW         GQEDCHYIQ      
KROII           : OGHIKX          QBFNUF          BHVJCHQWCGYXK  
NOLBXQPFITQQKTD : MOSTFIUR        IYDJC           XYVFUFRKYHWIIP  RHRIBIUHG       HOALTQYQLL     
WLRK            : XWIDRIGTJFPB    IETCAWRLRKHMQFE
EXIOJD          : IESSIL          DDBMTGOABWTRA   FRXFGVDLGUOO    JQYW           
TNNJEAKFSCKEVD  : UUPMPQLKJOXJB   JWNBVUDJUFKFDW  BSBETHF        
IAYRWMLHT       : YPRTKKSWV       YYSUPD          KQYJRBNAKEYUSSN
HFJSKONXDYEF    : VWONKXTCLEML    OSGDMQUJEWIJMGO UCITYD          XBFNDQG        
JXOWCN          : QIMWVYWR        BLNJVEV         XEUYAQTU        ONJCSC         
XXAY            : UVJWHFDS        PITMXD         
YLEIGVQNFJXUYX  : UOLYWWDXGAPMEW  OOQYBJNTTWS     GMBJ            YCXX            HOFYCIK         WWYYCJR        
YCFNMFEJ        : KIMUEFWEGBXDSM  JSATKNNDW       RUTLHHBKH      
RLISOJKN        : CUOCIV          VWUY           
OWDLPQSYQNYON   : LKKIIENVV       GNJOKKJQYGVQB   CEDL            KYQFSRIUAQKSYTV MTEECDS         HPBUDWRFSDLMU  
RUPGB           : BTDNTGEEUSWW    HKQDKLBB        CNRCIJTC        LQLWLKIEEGIXAR 
RLODVHTFRIA     : CTFYSODRH       MWQIYJEDXQIQD   QTUXOSAAJOGEND 
HGUWWNXOEYFT    : DRMJHW          RQDMSNXHV       UEKLSQR        
WPQFSLWEADAJYFB : NQKKSFFKGQ      INOJVRMNKYGOFK  BVSVYR          UFYDDWDVNY      FPJQMREHB      
HKQNHPNVOCA     : TUJDKNP         GCEDTNYXP       MRIDJWOSL       KXWXHLCOVF     
JVPJLGOGTOKTR   : JJJMLPAWBN      PVKVJJI        
DQTHBCTTP       : FTXDETJ         QYXSUK          XEWTM          
KDXBHAOTVGDKP   : SBYWWURRGYF     REEQR          
QJGEGAQLRL      : EESLNETQITFXGY 
UPPQHR          : BGKRIPSASOMMK   BOEYDX          BLQBWMGXJF      GEUGNBY        
NRCWTTQRCTC     : BJIGTTQGQOM     ORNRAWTNRADXUO  DMWYQNGSATPQCUC
MVEUAK          : MOKRQGTW        WYNGL          
SVPGTKXJDGBFTUJ : VNOIL           IBKAH           KVKBAWLQAYWN    WUBTPOVTDNTDRA  OSVDJAHQOM     
OFIGICLCQ       : UERFN           KKKLUBTFQKSYFHJ WXAY            TWSRSR          QQJSE           GEUGNBY        
GMLQIEP         : DJTXCIVDYAVP    UJOPMOR         ANOYEDALUDTRF  
NJKL            : QBDOPCASAJHF    BKRSMVPFOJ      UXINTHCFIVW     LLUACXJYRHKQAG  XLYFELPF       
NTVUN           : YWEGTEKLQEQ     IXTAHF          OBOIPGBJQ      
HHHMRPWTDANM    : YQHWOEECP       UWSCVMTHD       KOHKQVROJVJDW   ICBRQMCHFQ      GVNUAQWOMB     
AAAKHPKU        : QPERGGT         RYYQWUXSINMAV   QUSEHQMRUGEV   
UITKFRI         : JRWT           
KRCTGTLEQ       : HDSCLK          STXAPVYA        KWDNFJ          VELBVAW        
GEGM            : HBEGBXRKDUNDWE  PBLARSYVFCLQT   GYDJECPHM       EIVRHFBALF     
HMQOEBLFX       : EUXBMTRGRKWS    VOVIKUHEUXNYMH 
BKBUUWHM        : QGSEB           KXIDHHVNGHC     QXGDNOFQBQDPCYW WSDHDRGVMS     
DTVRAOJGSP      : FCWJQMCSR       GIWUTQW         WRGR            UHSBAWIADHBFEUG
BYIRNOUYW       : DFOLHXUHV       KHHPQQXXPMLMMV  LNIP            FXGPM           WPJFATPKDRIHJ   KFUBMOMV       
VXFWVDTDP       : FISDT           UDFQ            OGKOU           PPWIJGUBDQ      LLUACXJYRHKQAG  RBPYY           BSLOMTG        
HLRYLGKRBCNE    : LLPLTITCCRYUGR  LEVTPLR        
XVPOSRLNNMSK    : AUNCWCI         CNOCKAHURLTAT   ILQUOIPVKJXB   
VHNODUAWVMFI    : AFCKQKEKHKGPSFX CSCE            NGOEP          
ILVMNVKFLDWWQ   : ENLGULI         SAUGJHHIFQV    
JLXTKH          : BACQQETIRFUQ    OKOYMPERF       JEVJOQH         MWQIYJEDXQIQD   TCUNXWUJJOQ     IHJQVXSM       
BMFBLEPSMYBAU   : LVXU            PMBW            SXDMKRC        
NRCVFFUC        : OPETASBUUJKU   
IOLIIVPQW       : ENVQAUCYQ       RCWUJMP         OMECMVOGFII     DOYICPXSKYRF   
WBPDQIPRLQNDGHF : HCJQUGM         HFGE            FXDOBVX         UMGXPJVFWCUEO   NBBIPWKIVK     
MKAQKIFVQQ      : YDJOLEX         VCTPMMIPFYCTJOA RWGHUAUTRAQIA  
GHRMGSCJMKCEX   : PFTFTSG         ORCGFRU         XCIOAROJ        PTKLHV          KJCWDEEA       
TBBBGG          : EOBYNKEYCYFQGN  UEXMOTQFEQ      HXJWQKXPDTSRF   BXGYYMU         DEJWSMTQGWQXGM  OYNXFKUGSAHFW  
SIHD            : RMNGFDLWFDKLVLR OGCUCONV        FIBQISRVCBDEE   TPFMUVNDTBLMNBX
MYHDRPNMCVFEIR  : HRHMOPJJXJFNOK  EQHIW          
KYQFSRIUAQKSYTV : OWDLPQSYQNYON   PDXB            ROYK           
HUWMPOCCSY      : FNRWD           NIMENQUCBV      MIDFRPIF        DLRINJNAJHCNCLO
YHER            : JANCFEX         FIFMUWCYEQNQCMK FOPE            MEXXFTAFGS     
DIYVCJSCBGU     : PPHOQXLMRB      SVEICGS         LAERIYHAYLCR    HGJVBLSK        EYMKCD          JRWT            KHISKQRCJVPULME
ASQHQPW         : DSHGJOPXW       ODINRPLE        DDSGLJSVJEBTNYH
FYKAATAJARFDB   : CTCVSNOWXOW     LIPNKRA         LCFVHUFLXRK     LRNOYLGDYKXOFD 
CDQUIRBDRCW     : BFSFGQK         WEOLYOMT        QKLOCJFXY       YIDQB          
LNBK            : TTWPTQT         PMRHTAUSNIATH   AFTJY           AQEKIPBMGMTAUO  EJDIJRSJT       ABDCSDFITEAMUD  BEHPAKXOBR     
IMIIMCIYDBEIE   : SVUOOJPL        QIBADDBXXKPYL   GLKBXXSLPJIW    JQDMBNO        
KHEGPVJVNNUYA   : HIFWOSQ         VDYGEUMMWRK    
CKIKW           : EBOQDMSAW       YOXCK          
SMUCNAFTJ       : YXNLS           FPCDFOEDUNMMJW 
HVSLELHOJXCEYEQ : BBDSYFTAUBQDIX  LRCKASQLRJUE    EJCMUDLCGOMKGHG TMNFUNWDT       TAXMXKLIVUQUU   YYXJRRHW        CUESPFVRGWBOX   SVWPTHBFIAU    
PYLOPGDMKSN     : LOBBKRKILK      MJNYMN          PFKUH          
NWBUUUJAI       : PMRHTAUSNIATH   IXRWV           GIWUTQW         RGNFFADGPMV     THDNK          
ORQSXPXOSP      : ACDCXTVDFIP     SHYHEUWHVNKJ    BLNU            GFDEBIEBPUBE   
GGHNKTXFHQS     : HIUTEOQLCBJA    BJNYQIAKMB      YOHIGHHPIQVGO   PGPIB          
RQCOACWS        : VRKYRJYGNC      SNQDI           MMJUHNS         UUKDDAQGINGFOFI VRWEPNFXCRHMVTB
QKLOCJFXY       : AXPTVWTEFG      FVOXIMHRNIY     JTHQK           LAWJXUNSJ       KVMTAPCBFRO     CDQUIRBDRCW    
EGERSYSXIJT     : RMYFKGVOCXNMWX  GXYLUMNDTPJB    JWLTDYUYUIUAKV  PIGPDTB         VETOEW         
BKRSMVPFOJ      : FPDVUMUUKTNL    WTEAHIXJBRTHAL  WMOEASDGREYJ    NJKL            NSUDKHJQJGIFUD  DEVSNTKS       
AAUKISLFWTKROJ  : DSHGJOPXW       TQIOFBFVPURLBLB RHRIBIUHG      
PRTJJWVBPI      : XKUBBLECKPYNE   LOPSDUWTNAJID   LOLCGKISMAP     QUQIMEVXFLX    
INNTGOTBBCT     : SJXQJFIYLXFC    LOBBKRKILK      GOKMAUNCJBG    
ISJU            : RXUJJABDGIJQ    OSBCGW          SNCQYF         
XGWNASYKSUN     : OVQFCQXH        OETYWGMV        LJXRSB         
DNSTB           : NPGUYYBFDXARM   HBESXQ          NLEUNHEHTTTR    TPFMUVNDTBLMNBX LCFVHUFLXRK     HKDEEFSQDBNGPP 
ARLDSNYIX       : ENIWJOTLPOHSC   SKNVGLPXNT      QAPTYHWHKEUSNQ 
TUFRBC          : LFFVYUG         QLLCFAXEI       UGTRG           WNISTPGKFYBEE   QUQTJLXBSTHIVPF
CVHM            : OPVIMVTIDM      WBHNWCPXG       FEBVLUNLDEAV    HUMOUCUYELL     VQACDVRHRUCRGI  NISWI          
DAYIPUCTJELWH   : VHOICVDOSJJTBMR LIBE            OSLMLABO        IVAWEE          NMVCRHOICPAAIB  NDAWH          
LGPLBJHGDKILMGT : SVEICGS         DITTS           ASVNIB         
UWEWFTRKNDOAB   : KVEGQIJ         YNTAXOU         QTVXSJNRSVO     LWDQXLNMRMCEIJD ABDCSDFITEAMUD  TOBFKG          OMEJMBFO       
HOFYCIK         : VAITAQEHW       WOHJKCYTM       TUKRVBXI        YLEIGVQNFJXUYX 
ONWACL          : UDFQ            CIMDSPOYEQPOKJ  BBTN            XNTXEYX         VMQNJNUNBUSNB  
VNCURBCNUMC     : THRKOGCEX       CEOJH           FLCLXW          GKPEVAB         QXDVCLE        
EEBDNRKMWTY     : AXPTVWTEFG      FPDVUMUUKTNL    WDXYSDMPSGVMCKE PSJEY           JQVOUKHBA      
KOHKQVROJVJDW   : LHEGEC          UGTG            HHHMRPWTDANM    OBOIPGBJQ      
QRBUR           : WJGNFAYAHFVR    AHAQCUDPEYUQHFV
YVMMPXYOTAAEPJP : KNCXAXRC        FEWVXEHJ        EWXMGJYAO      
FJVQFHVEVNXXIP  : AUWGI           DSEKLVHDQXENY   VSOUMWLPVBOVGN  UROUVGIEE      
KNUWGSY         : KUEGUTGMNTNJ    DBGNELVFLNRQLFU DCWTQ           NHXTNXJAHQGK    QAEERVTNBBLG    NSUDKHJQJGIFUD 
OYUSOFKXMTT     : PSJEY           GQAY            MXHP            BOIWWJJHXFPTO   QPATSPA         CHNCJYSR       
BBCF            : IXTAHF          UYTT           
PDXB            : XDHBQXCJ        AOWS            IVXHORHFQWMDYD  CYKIPUDKH       RWGHUAUTRAQIA   KYQFSRIUAQKSYTV
FLJAKRUJNL      : TJGOEGMGX       SDQVTFLYRBAYCC  BGDBQPMQEDEUQN  WXAY            YDROPFAW        VAOFPMU        
KFCPR           : PJYWNUXKKDGK    VQAEJ           FGVGJHNNLM     
FMTL            : GMMUBYTPIV      IGCNU           UIBMHMTGVJMK    DEVSNTKS       
XNTXEYX         : PAYPYIDRUXLOJ   QCTTDC          TMNFUNWDT       GPWIPWUSHPGR    ONWACL         
UDUHG           : JCANJ           VRKYRJYGNC      VWBOCDHD        HIFSVGDQDYDPN  
YDROPFAW        : PYXFKE          LYGJU           FLJAKRUJNL      JRMUGOFNM      
ROIWDEITCWPCDO  : JJJMLPAWBN      TFPIUU          EJCMUDLCGOMKGHG
MKGJTMQS        : NCNTUVHIGGOOYY 
KKJPKGXE        : JJJMLPAWBN      NIMENQUCBV      BOJBDUP         LTCNRQ         
GCBMMWRLMTQCU   : LEVTPLR         LWDQXLNMRMCEIJD
OBOIPGBJQ       : MNUENANARY      DBMCHYHBF       NTVUN           KOHKQVROJVJDW  
TJXC            : DTAWHXIVSL      GIJRXBOMILRT    TVVXBTCITEWH   
DCPHGCVDTKQQBS  : WMBP            JHVAPF          QEUDHDMOBOGGFLE QLNENTYVOA     
JHOXPG          : UUYHBDJNC       FXHE           
SPAJLJHQSM      : LDOCVUSQYTFYP   RWYKFVVVITLST   JSKESASDGP     
IVYMUDJFT       : ORHJNVMOIMXQE   VRUVBPTWTJDKR   MDLHAHW         MPWHDDPSVVJF   
IONRXCSNK       : NLNBV           KRDK            IQRYP          
ICBRQMCHFQ      : HBSNUMCBKTHFOAX OETYWGMV        XCIOAROJ        HDGGJJYWQX      HHHMRPWTDANM    JRSFFQBQ       
PPCDKFO         : SHYHEUWHVNKJ    TTXUPRJJ        GFDEBIEBPUBE    RHRIBIUHG      
BOAPCUNGNDQQ    : PCXPNRJOPUXPVC  IJHPXER         DWUPVJIU        YBMAAOOILH     
USILFK          : DYXSIHD         KBMYAGJNSJN     YQARAFLA        JRGPLQNTFREOOBY SKNVGLPXNT      SIPA            HGJVBLSK       
NDVDSXIFFWWGNAX : BLNU            WXAT            NMVCRHOICPAAIB  SBTBIEODSEWY   
UNAKSSBG        : YGNJ            EJFAUFOFUYYIN   VOFLLKBRCOM     HYPC           
VQACDVRHRUCRGI  : GLFANTPRLN      AMITW           GUPFSHPJ        CVHM           
FHFVHFNCSO      : WMWPSCRGGBK     KHUJOKRAB       VBTQFILAIDJBK   TQITUNNSJBUN   
LHSTXOLYSOWKXQ  : RESQXAKGKCQ     QTMANDBAV       TCTARPTOXA      SOBBTMHC        CFXPIUITQO     
BIQJHVQMRBRIFM  : CUOCIV          UGAPHPP         QOGDPSRHQBLXQ  
UXINTHCFIVW     : BYIWGVNX        CIODLXEEHLJAMQ  GOEUKL          NJKL            IJMWABBQXJ      OINTKLHPAN      PTPK           
IUVQVGHHNGBCA   : QGSEB           TITCBKEDPDIRC   KHISKQRCJVPULME
TIHIJEISRCCWKKU : CCBVGNJXTBW     KYQMLXJJPEQIAX  FYXGP           BMNQSTJE       
RDEPW           : ACDCXTVDFIP     INVPMVXYWHMQK   CJNKVYIRDPST   
VGKLMNNNRJ      : TGRYAGX         FUEWVNYOYA      GLKBXXSLPJIW    POAS            JUEKRVY        
ARKGADBEHXQR    : DMPYEYARKMFIMD  AAWGRFRIGAPYUXA GJTIFC          MXDX            LHJIOUARS      
XLXFBWIY        : XUKTUMKCQLILTS  CLMD            AUWGI           OVLBIEKVNTHE    LWFGCQHRG       SCPF            KDLVPLNAOKHTWU 
UKQJXGBJHD      : SUFOSRCGXSMXISG HFGE            KLYTPANFYXYI    DCPPUHJVHNOR   
RMDWNJELBXIBJ   : HCJQUGM         TRKSCOEOMD      RWIAW           SBRHQTEQME     
GMGQL           : TGMTRGGWVMBO    XEUYAQTU       
MXDX            : UDBIHGQDSBRQP   GQEXDSWRIBL     CLEMHQHKT       ARKGADBEHXQR   
MBHVHKNTPMHBQUC : RYXBHOSAAHIW    ELIK            SJCFXGHQYGUMJS  ODOBHWBYE      
FGCNOOTGAGUAM   : HIBYTXLTUD      SROXDNPGAFU     RXXHR           NAXUPW          PKESEMRVVNIYX  
XYVFUFRKYHWIIP  : MOEAGBFMTTLUMAE AEUSQYJLXJDDR   YQBUSNNJG       WYRUUHQUJMXDAOO GSXWLRSY        NOLBXQPFITQQKTD
NIKT            : JGABOFHRI       XBIIUKT        
YIYUQBCLB       : XMKWYFUIEDOIVP  GYDJECPHM       TIGBW           QINVJGREPLOVGQ 
GYPFGMKXWKHVU   : WNMUFGL         FTRLXYP         IJSWH           BUXQAIMTDA      WKJUXLRRXCQ     XDKBRPVKOXAYY  
NBFVNBIOKHKBK   : CRQDUOFOR       IEGBJ           QAEERVTNBBLG    BRBD           
PNDVOUBU        : JYRBPFVBEBRAK   VDXSLSKR       
MUGYEE          : QWLMTRWXARFBR   TREPATDJQUDDIU  VONEUTHBWPGYGDC SAUGJHHIFQV     MEPELMQHDILQL   XLYFELPF       
VRWEPNFXCRHMVTB : LVIPTXC         BGKRIPSASOMMK   TXXICUMCYFDNYVG XSIEWPNQ        XNCFSHBL        RQCOACWS        LNHPVIQ        
HGJVBLSK        : RGFDIESPNL      DWUPVJIU        UIFTEFMQOQOW    FOPE            DIYVCJSCBGU     USILFK         
PQBT            : TXXNINVMFWNPX   FMXTXUMQB       LSMHPILM       
UROUVGIEE       : VBXPUEQ         HEKYMSXDGP      FJVQFHVEVNXXIP  RYAOTGLR        JRWT           
VNARH           : QAPTYHWHKEUSNQ  XEUYAQTU        KVCRYIJLXXCBGDE
DOKNMNBHYBWRCS  : DLNLJV          LODI            KFKQCAAQGIFBWI  AMITW           DDHYOT         
YLGVJNGNTT      : TJDMLEPCBYM     FQXMKVHPYPX     BCSTCCCGX       SMMGLWNMY       WVGFJ          
KVCRYIJLXXCBGDE : LDFOXRPTSTW     VNARH           MLPKRIMBPJO    
UIBMHMTGVJMK    : UPDFACUG        ETNLMUKIOKBBBV  SRGXBVRVD       JHLEWDXYQRVPI   UFYDDWDVNY      FMTL            XRQVE           SJIXOAVHDJ     
UIBMHMTGVJMK    : GGWXKJKYVPXRRPX QWIGNJBQTEKQP  
IWPE            : FBEB            BNSMBNNVTF      BFJNGTUYRVMP   
KGLTTJTVK       : RVCKWDLQBR      WSEHBNNI       
BOIWWJJHXFPTO   : WNYGPK          FRJL            PUVYO           QEWKNSETMXLEAO  GVXKU           OYUSOFKXMTT     JLEBORRDOEPW    QBPVUCKTJHPCUDH
GWNFM           : FPDVUMUUKTNL    TPATICGBTOBOW   UMGXPJVFWCUEO  
HWCSSYFNWR      : LMJGKBQMMYJ     NUWWQNNTKWLCNW  CAPUOCAMBAPIY   QJXL            UUPMPQLKJOXJB   IWPMCWTCNMHWLP 
YJXVIJHRHPHEG   : OHAANRPTRDTPX   RXYJUVTEN       TGGPMBFUYWBWBR 
MDCS            : EJFOTHTWMNQFSK  XKKYE           GMMUBYTPIV      YMHFJWVDE       LKKUUKQIRD     
VCNBWHAEWWWMXI  : PJYWNUXKKDGK    YENHL           GCEDTNYXP       PTKLHV         
VQUEJF          : KHHPQQXXPMLMMV  AYWN            PUSEVQBBBXINDM  MWTSP          
SJCFXGHQYGUMJS  : VQQQPNBLJQVLJJT SLWGTSQCDSKTU   SNBCMXUMULYTUXD MBHVHKNTPMHBQUC
JWSIVIHETD      : RGUMSUECCOENMJR EYAQCN          PCXUERHDX       ICVGDSICYEIEPE  IUSUCFQMWSKWQB 
QJJXFCHK        : SJRPOOCPDWAP    JYRBPFVBEBRAK   WJDVGOCWTEVTOBQ HDSCLK          UXWVXTAEPQUN    UYTHWRELOLQMIAM
IQRYP           : FQXMKVHPYPX     GWXOHUWFGPHTYCO KGGDSQJYUNVGR   IONRXCSNK      
UELPDUOXGLG     : MPTLQFOIHSIEX   FTRLXYP         CAHTIWXN       
RCUPTHYTOCCYMKR : LLPLTITCCRYUGR  TCORVGQUEPLTUV  CHWAIKJH        ONHEYMGTCQYWC   LKRHTBR        
LHJIOUARS       : QYFDXEQUCDGIJ   LIPNKRA         HYEHT           ARKGADBEHXQR   
RBBYQSBNLWUKR   : PYFFTTU         HMOLRBSGGEVAT   DOKXTKBYJGWY    UYWURKAIJFKBC  
OVLBIEKVNTHE    : SUFOSRCGXSMXISG LPCFXQYSXXQAGHD WSXJOCDERPOHWNJ WUBTPOVTDNTDRA  MDQAPFGWM       XLXFBWIY       
HXJWQKXPDTSRF   : CUOCIV          TBBBGG         
ORMBHIPKSTWOJQV : YHKDBTUXVNCTYNW UPAXYVCKPBN     GPCNJVLROHADI   UCLAT          
KEMTBDHCUKXQ    : EOBYNKEYCYFQGN  NPHNQEQKEUDB    YOYUMPTIB       GUKMDQF         RWYKFVVVITLST  
DJTWXWEGMRY     : OVXDHRC         FIHSBDVBOE     
OPSIOJSUVOXCV   : PBEH            QEOCUOSPWDMDR   RYYQWUXSINMAV  
YJXRNDDJ        : TUETHPTYSCVILCH HUQCHRJMS       QJXL           
BHHH            : GDGKESLEKUGJTHS GIJRXBOMILRT    ABCENREK        UXRIXQNUIJYN    OFLIJB          XFHJXUN         PFCTGH         
YIDQB           : QAIIACLL        BUXQAIMTDA      AUXAS           CDQUIRBDRCW    
YPHTMFIKJ       : UERFN           QOCB            RWJAQKGOF      
LJQLDGPHQSIXAS  : NPGUYYBFDXARM   JCUAMNST        ILQUOIPVKJXB    JUGMJMCG        UXRCXPJUX      
ADYQEW          : CPDAWYSXXGWPP   IOJSNN          RSDDFBEAWO     
VGNIMX          : VHFGGRNSGSKF    YXNLS           UDVGLHKSLEEO    NWFM           
XFHJXUN         : QUHKTVAMBS      YQBUSNNJG       UPAXYVCKPBN     LKVUTNG         BHHH           
KUXDDVE         : LOLCGKISMAP     XJOQRVLQONMDJVI HVMQY          
RGCRYIO         : KUIILJLLFRTILI  QPEJ            VETOEW         
FXGPM           : HIBYTXLTUD      IUKFOJBQLC      DKSLCXDMEG      PTKLHV          SNBCMXUMULYTUXD DOKXTKBYJGWY    TWTJQ           BYIRNOUYW      
LKKUUKQIRD      : XCCBQNYQKDUHK   KLYTPANFYXYI    YSMW            MDCS           
PHILNHEVJXUTON  : BYEUGCODDIIL    VATN            UWSCVMTHD      
MTRYX           : HUQCHRJMS       FMPAVUJIORV     SVWPTHBFIAU     QLNENTYVOA     
KKBFVTPNWUGED   : GCTSALYGQ       KCDSMHLGVLVBN   HWKJXEKWSKLA    FMVWWBOV       
TMXPXVM         : NKMW            WUORFCSUBVV    
LATAVNAWTMH     : HTQFJANEPQAO    UIFTEFMQOQOW    DPBRYJYSIYHQRKT CLKTSEMWYN      QYXMXU          VUBACB         
TFQJVNEC        : FONUIM          MOKRQGTW        AWDFNQ          JXRAKHH         GNJHKLKXDLTEI   XEUMJCBOR      
JVQWWHUUVN      : BSPR            UQEN            QVIM            HUBTCKUPTBV     QSUMNHTDK      
WKJUXLRRXCQ     : FBVVRCRWR       YBXAMYEQSUTGTL  GYPFGMKXWKHVU  
JHDFX           : NPHNQEQKEUDB    OKQTVXW         RKAOGC         
JUSILPFULCR     : XQWYLOOXSAOQG   FYCNXDLRNRQFI  
LQLWLKIEEGIXAR  : NPSUWILQIKG     FWSBYBSVHEGPNQ  HQNTQ           MWQIYJEDXQIQD   HYEHT           RUPGB          
DAFMJAHTOX      : YNUEDWPYGQJDP   JDJTDRNMSKEPY   LOLCGKISMAP     EYMDUOBFBT     
JLEBORRDOEPW    : BOIWWJJHXFPTO   WRVNM          
TFUTFMCKMJY     : YNSTPWUNKY      GAEJ           
KGUBGWKRB       : SDKH            CFAWPNKXKBESH   XSPKUKBAV       JINJCLLOWF     
JUGMJMCG        : PLRV            RRWJUL          SCRDMXY         QGFJDFL         LJQLDGPHQSIXAS  PFCTGH         
XNTSSJUD        : BHSNSVQBLRBRCGV BFSFGQK         IUSUCFQMWSKWQB 
EEWQKSRRRFLUTUP : FBEB            NQVGBPNWKMUEXO  BVOY            QIRRHPQNWAFHI  
HYPLHQKULDPWA   : RXYJUVTEN      
UGYUALNR        : AJYFOMMVUUTGG   OQOVSTQMXVYLF   DNIMJEIDL      
HYPC            : BERKJFBF        WLIEHGAVHXSPG   UNAKSSBG       
MRVWS           : CRRMIEP         DFOLHXUHV       UOAIENYSVBI    
IAESWR          : WKXXUUYCUIOGWDM YJGT            MXQGMNUJCKGD    UUPMPQLKJOXJB  
OOXJKHIF        : RESQXAKGKCQ     PAYPYIDRUXLOJ   GLYSTLVDAYKRIMS GPWIPWUSHPGR    DPBRYJYSIYHQRKT YOBCVWR         QPWAXXQLSQPQONA
VUBACB          : USCXYGVAIATT    CHTHQ           LATAVNAWTMH    
GVEXTBQHMS      : FISDT           NIMENQUCBV      HHIV            PCGYNYEVGQ     
FRGEGV          : DBGNELVFLNRQLFU IVEUWKLCWWA     UWOOPYWPPYN    
PINAP           : RESQXAKGKCQ     EVIEPP          CXBC            FOHFW           OETYWGMV        JPBIFSUIARSJ    YPBSWR          OKVWCJDBTBU    
VKWXOAP         : TJNMRINTLSWL    PVCVH           RVCKWDLQBR      IMJCDLMNGMB     RKOXXCJVEIS     NQAXTKJBMBEUPRH PLGY            RGPRJ          
XWUSALAMGOUA    : RQDMSNXHV       QPRQENITHUXX    LHVBPMMKAC      TTMFELCNQQXHNL 
BGTFXC          : TROSVF          GNSHKANH        GCTSALYGQ      
XRQVE           : OKOYMPERF       HUBTCKUPTBV     UIBMHMTGVJMK    PCAJOWDF       
UUPMPQLKJOXJB   : RWXKSFQAXFSMADN FDXXMGOKSUJXX   XBBEQV          TNNJEAKFSCKEVD  HWCSSYFNWR      IAESWR          JGMUYLCBAN      BHVFLWQR       
UUPMPQLKJOXJB   : KLRSU          
BXGYYMU         : POAXB           ISIJVKQFSPGQJC  GITIQK          XRKELPTKXCFWYLN MDTLWUWXWSO     TBBBGG          CEPASUKPCGRYN  
KWDKQ           : LQGQ            OMBT            SBRHQTEQME     
IWMDRESJUG      : IJQVUSIJECCM    VBTQFILAIDJBK  
EUVQYCTWK       : KRASLPCJSBR     XGFNVNOGTQX     MUUXYKYBM       KKNPGYNOQ       LPAGXEMYOV     
WYNGL           : KQXOUJWCKQJJOPF ASQTLKUPBLR     MVEUAK          DNIMJEIDL      
JXFFGERMXWHHR   : EWCUSQALSYDJQ   CVGDDUMLXJULQ   BWSXKT          QIGSKREUR       LIACXLY         UXRCXPJUX      
FYJDPIFJ        : DMOFJY          JOXOXUW         QDXNREEDL      
REEQR           : UOBDYJ          DAJSOVEEGDE     KDXBHAOTVGDKP   NUCJPWWHFGFKRVQ
EGVCNCIRTWPS    : CHSGGQKRLJHLQY  ONBNKQRRLGDHNJU HMOLRBSGGEVAT   EGTCGVHBDALG    DEJK            EPRGFBWBJTMGG  
YNSG            : WPDQKJLGHDHUT   QUQIMEVXFLX    
CJEMQ           : FUERP           TITCBKEDPDIRC   XCOLFVTRL       TWQIXLHFCN      BEHPAKXOBR     
TITYBNLHTIJHM   : AMUAQUCEI       DLRINJNAJHCNCLO FXHE           
BGRQCXRPQXEUJI  : HTQFJANEPQAO    GXIIWB         
AXCKRDLFOSB     : EJFOTHTWMNQFSK  OUCQWY          JQLPCNOOVV      ROYRT           SCPQFYKRF      
EKLXLUREWQXOJX  : OWGCBMBPUJ      IHJGWIKOG       PPRX           
FHDOHDQRUVFC    : EXMHPSRQLU      SYYTLBFSAN      NDAWH          
AFMEPYED        : FTRLXYP         DNVCAUFMAFE     BCCYGDIGOKKFRX 
YHUPHJBFEIMJ    : LDTBHDEAIRMQDF  FEFGJDPWACCL    TLDAH           OORVGUEGDXGI    QDXNREEDL       FGVGJHNNLM     
VMQNJNUNBUSNB   : ONWACL         
OFNKEWFV        : UPAXYVCKPBN     HLIGVCQUIGKTW   AMITW          
QAJWIXGGTUXJE   : XBMHVCIKXXNEYL  HBSEYXFDLEGYX  
ETOBMC          : RVELR           MXEMIPAYSQW     CMQEEDNK       
YTJOG           : EWCUSQALSYDJQ   TVVNUIOQG       RYYQWUXSINMAV  
LMORFODFXBNE    : OBWIPPOKCTDVII  TMPKA           RGPRJ           NYBMRLFJ       
JEGPRKKGN       : ECTMCXEMUJ      JRJKPTW         IUFBF           RUTLHHBKH       OUCQWY         
LPYFCNL         : MOSTFIUR        DLRINJNAJHCNCLO LHBWBMINQQYNH   FEWVXEHJ       
CAHTIWXN        : VHLGVBVNSR      EMHGAWGNERGGT   PHMGDCXXKDI     UELPDUOXGLG    
BBDYKIFBAS      : QNHLTMHAP       KKKLUBTFQKSYFHJ
JGMUYLCBAN      : KGGDSQJYUNVGR   AXFHEYEIDJT     UUPMPQLKJOXJB  
EQDXYCXOBCPFB   : MUWG            VVLI            UQEN           
PIGPDTB         : QYXMXU          EGERSYSXIJT    
GVNUAQWOMB      : BXMEVKRJJDY     ADRDTKQIWBX     HHHMRPWTDANM   
RBIWAWXEOFF     : WPJGQNGLAWVPI   RMYFKGVOCXNMWX  XNURCBYS        ONGKSDTFBSDVNWH
UPANVTOKDN      : NPGUYYBFDXARM   NITJOQQYEV      PPHOQXLMRB      DNKFUJHO        QAEDHQT         JQDMBNO        
ANOYEDALUDTRF   : GIJRXBOMILRT    NERXHKYARPN     GMLQIEP        
SJIXOAVHDJ      : XOQPNMKNIVDIEPA JEVJOQH         UIBMHMTGVJMK    IXAJG          
YANENNEECDKFFYC : OWGCBMBPUJ      BNSMBNNVTF      GNVXUBWAR       QAEDHQT         VEIAFUMIAEBO    IIYBDJHLGBAO   
UWOOPYWPPYN     : ADUMWYBDPQI     IOJSNN          FRGEGV         
CWCCARGP        : EQHIW           SHCTBGAB        RKYQ           
NTJSHQYGTIBSYR  : TMNFUNWDT       XYQQWTEJ        UCSLSE         
XQCQQ           : RDPCJTHBJUWMYVQ WJNQVYBJ        UXJNKBNYK       ERKAKFW        
PUPUYPMIGUV     : AJDHKYP         SXKGYTHTLY      WCNGTSMANIDB    MWQIYJEDXQIQD   QFKYWDPPBSB    
GOJAP           : HYCE            XNURCBYS        OSBA            XEUYAQTU        JGUNMWBFKQJX    UBVIGRRCEVDVMI 
TATOALYADBSV    : FXTVAUISLBVYT   FRXAEYQNVQGB    DOKXTKBYJGWY    KWPMUTIHUVGNW   EDAA           
JSKESASDGP      : POAXB           SPAJLJHQSM     
JWPSW           : JWNBVUDJUFKFDW 
LSIFJ           : NIMENQUCBV      CXBC            JTTFTQRR        DEWBLUIH       
QINVJGREPLOVGQ  : PLRV            YJET            SSMHP           YIYUQBCLB       EBDCF          
JXHKJGC         : CKESKGTNTGSRQCI
FMPAVUJIORV     : MTRYX          
EDFKUSBTBRLM    : JTQEWVR         ROQCHUT        
UWBCBGHOVIMTRW  : WRYUQNTH        MSEADOYBDJK     LWFGCQHRG       VUVSVKACTNL    
MTUSY           : JUYY            FEFGJDPWACCL    AJCGDSGLJSGUMGB OSKBGO          UFYDDWDVNY     
DVWEPXX         : WGJSEILTWHEV    PBFYPC          YIIABOQBFIIXEYG BWPSIDFVFO      VWRGBTMJWVFKRRC
KQYJRBNAKEYUSSN : OMBT            WJGNFAYAHFVR    HVMQY           IAYRWMLHT      
DCLAUMFXJ       : WKWIKFKV        BMOFHRAYSXTW    EENT            VUVSVKACTNL    
EBDCF           : THRKOGCEX       QBDOPCASAJHF    QCTTDC          WQRWMUVPQPTJ    QINVJGREPLOVGQ 
UGAPHPP         : FPCDFOEDUNMMJW  NKWO            BIQJHVQMRBRIFM  DIBLMJIVSIJU   
TQPOJFE         : VBLBMLWWFCDDU   OWGCBMBPUJ      ASKHBXIMBT      IGCNU          
HSREFWEOYIQCM   : NKMW            FQQJVASJLWXWM  
SKEUANKRHGJWUU  : WUYFCTR         AGRADRG         PVKVJJI         MYPJHR          UYTHWRELOLQMIAM TJXENUGDFXLN   
BMLTEPA         : PPGJYWGDBKC     YNGISTVFIYUXC   IFYE           
VQAEJ           : IPWMNQMS        VKXJBWNRCNI     QAEUHBUOHS      JAKGV           KFCPR          
TJXENUGDFXLN    : ELVLG           SKEUANKRHGJWUU  SNCQYF          WTAKWWCQ       
KKHPLTDIXV      : FONUIM          MUQF            DUXBOVHKNPLKHT  JEGRPYXJE      
BRBD            : FONUIM          CIHNW           HYVHDKIYXIXJD   NBFVNBIOKHKBK   JQDMBNO        
NISWI           : PDCFSVS         AIKT            WDLMEEP         UGXBIQH         CVHM           
NDFQKFCAR       : SDADSLSHM       KAHLDHPHCB      QOGDPSRHQBLXQ   BMMVBNBOTA      DUOESXRG       
KYFYUIHU        : AYJAIIPUTHMV    HQXWCDIWG       TIGBW           ARFBNKGG        PLVEUXBBGMDI   
RVYUYVIKQ       : YFATFSHK        YNFUTYUQEBEUNSW BLDOFFJYFJJ     YPRTKKSWV       JRJKPTW        
URTYW           : BJEVXIWDQSKB    XWUNPCNDWS      DMPXANA        
LEPMXHYYMXTWF   : OIMXPUMM        QSNPQVKKE       TNYUG           SYUVKQMLIBX    
EYMDUOBFBT      : FFWEIGXKYERVP   WKJH            ELVLG           EMPBYGFJAFXP    DAFMJAHTOX      SUEWTC         
VLHUKUJQMX      : SNCQYF          OEHABNEJJJP    
TWQIXLHFCN      : RSHO            HWAID           GTHUGOEKHUV     NEDFWX          WPDQKJLGHDHUT   CJEMQ          
RSCIVHJRVFDF    : OIWXNPS         SCRDMXY         EJCMUDLCGOMKGHG KKNPGYNOQ       PLUOHLORCTDE   
PCMJQMYML       : TSWTIP          USCXYGVAIATT   
UJDFPIUUCQYKOGT : BESPHR          HWKJXEKWSKLA    JHLEWDXYQRVPI   LCFVHUFLXRK     SEEBSRTN       
EYMKCD          : GNVXUBWAR       GLYSTLVDAYKRIMS ESTFUXOA        MRRPDGWWEQ      IGCNU           DIYVCJSCBGU    
QOGDPSRHQBLXQ   : VNQN            YXNLS           RWSESNSOVHAXFF  HHFX            BIQJHVQMRBRIFM  NDFQKFCAR      
SNXLMI          : PVCVH           OVUCD           FYNAOYMJLXB     TQITUNNSJBUN   
VEIAFUMIAEBO    : JUYY            XQWYLOOXSAOQG   LQMUMKAXJGUTK   KHJUCENANL      YANENNEECDKFFYC RWIP           
HEFYMV          : LYGJU           OENBBGRCHTVNS   WMPVPITIUJQG    DRKKCN          FMOQPOW         EWXMGJYAO      
AVTXP           : OUCQWY          PRCUKKVXVBGGOJX
VDYGEUMMWRK     : FVOXIMHRNIY     SDKH            KHEGPVJVNNUYA   UCECS          
CMQEEDNK        : ETOBMC         
MYHOYFKYWUWBVD  : UFQDSIORU       HKICRNBOL      
QRSP            : KIGRTUETG       VRUVBPTWTJDKR   FRHRHRFTTVWTL   VCYVOYSCVL     
FEMRWSVCGH      : QYUJUNMIF       LLIBY           CHRJJIWFYFGVA  
UGWKICU         : TJNMRINTLSWL    UDBIHGQDSBRQP   WGJSEILTWHEV    AEUSQYJLXJDDR   EVXNUYP         WHXKLRAJOGKNOLH LKYEDJH        
ARFBNKGG        : PMXLFVGWFKLF    XOQPNMKNIVDIEPA KYFYUIHU       
BYPIDEBDAYFGISC : AADFOQ          WWGXWENK        FLBOAKYDRVYVA   SBTBIEODSEWY    JLXODF         
POAS            : EVXNUYP         GRYSVVPWSJNX    OGNGDMCACX      NTMXHDOH        VGKLMNNNRJ     
JSEQVREC        : ITFGWSSXNP      AHCVQUG         NEMLLOW         CPDAWYSXXGWPP   KOAOBPVP        JHWBL          
JGABOFHRI       : TCUMV           LEACVRSAI       CKGJWQSAUWTNMBI NIKT            DMWYQNGSATPQCUC
ROQCHUT         : RKOXXCJVEIS     GIADKEDIU       EDFKUSBTBRLM    BNMF           
JVQUIL          : EOREWYOUVRNPFTB VTCCBYRKPXGM    OIIEU           ICCLG           MPKNOOW        
BHVFLWQR        : CHSGGQKRLJHLQY  ENLGULI         DOHRCIGQDKVAI   UUPMPQLKJOXJB   ODEVEGSDI      
TJCC            : NRVETMFKIXQCE   QAEDHQT         NPFXSKIWNS      SCOPR           OOFWBJLBT      
LLUACXJYRHKQAG  : IKXHHVOSAB      NJKL            VXFWVDTDP      
NJAWFIJCBDYV    : JDJTDRNMSKEPY   QGICI           VLQE            PPPRNNJ        
EAORLLTQJDREND  : KSFASGQBVQNJJCD JXRNDEOLI       BYEUGCODDIIL    XJCYPFIQHUFCGTN IDLAAFKSTIHFFE  TGRYAGX        
PLVEUXBBGMDI    : VSEBBIGPBQ      LAEQQECFTWTVBEI GPWIPWUSHPGR    KYFYUIHU       
FGDLGTDTGWM     : OPKRYRVHFBEHTU  QEOCUOSPWDMDR   JTCAXKYLL      
CFXPIUITQO      : SDQVTFLYRBAYCC  LDTBHDEAIRMQDF  LOBBKRKILK      VCTPMMIPFYCTJOA TTCWPHKWMVIME   GQRHILTTSPEB    FSIMBLKIW       LHSTXOLYSOWKXQ 
CFXPIUITQO      : TWJJPDFFLLUUYGT
PPRX            : ASWELFXY        MIEEPGPVQEGLGT  EKLXLUREWQXOJX  JVIOMQTENEAMNWN
XGVFMBQSX       : YLMRYIATME      AWLVQ           ERKAKFW         DFAOOJW        
PGUCXWHWPRRXLLM : ENSE            RGGLWKPA        LEGI           
DEWBLUIH        : MLIICWCJCGAHIAX ERKAKFW         LSIFJ          
WLSSJQIPLMPLW   : EAVSL           RGJRKWMVPEB    
BOJBDUP         : EJCMUDLCGOMKGHG KKJPKGXE        DPJLHRBYF      
ATFBGD          : GBRS           
PFJDBCORME      : YDHHRONS        GOEUKL          KAHLDHPHCB      YHKSHLYFRU      MPODQIYMICGK    XCHF           
YWRVLU          : LFITXOBUF       KIWULYBNR       JYUWGSFIP      
UVQR            : BGKRIPSASOMMK   IBAKRLOCOJESIUE SRSOWERGUITUYC  BGHBNKQEQIFJ   
YRHGVPJHIR      : WSXJOCDERPOHWNJ
NSUDKHJQJGIFUD  : CFAWPNKXKBESH   IDLAAFKSTIHFFE  BKRSMVPFOJ      KNUWGSY        
RBLKOMEYT       : OHSHFTAIA       EVIEPP          WJGNFAYAHFVR    VUCCK           LNIUU          
QFKYWDPPBSB     : MGHDKWHJY       NHXTNXJAHQGK    VOVIKUHEUXNYMH  PUPUYPMIGUV    
CRTJD           : BSPR            LYRGJYLMEKD     TAXMXKLIVUQUU   UKLCRIBLFKLWW  
GGWXKJKYVPXRRPX : RYXBHOSAAHIW    ERKAKFW         UIBMHMTGVJMK   
QWIGNJBQTEKQP   : FVSNRPHMURQV    UIBMHMTGVJMK   
SVWPTHBFIAU     : RGJRKWMVPEB     SJEQYOXDIAUXH   BDCNN           HVSLELHOJXCEYEQ MTRYX          
ROYRT           : VUBLKUQE        INOJVRMNKYGOFK  XJCYPFIQHUFCGTN XKKYE           AXCKRDLFOSB    
PEYFPAXLGICVYWR : JLACNA          HNRBUVWYCWACPBA
PMFSRNSOWNF     : DVVROBBKOUWBG   IVAWEE          SNMVXNUBGXTXG   WVGFJ          
HBOYHPGWRELYNP  : RMYFKGVOCXNMWX  SIBJUTAMAV      FYCNXDLRNRQFI  
MNPKF           : UTLXESOMEJVAAH  BWXWKVKU        PRRB            ITHIUT         
RXXHR           : CLSEVKQPVA      LUJARHLGUMTT    CEDL            VPQGQUEYLAUMTG  FGCNOOTGAGUAM   RALHUQ          XRIBUG         
FHTDQXTQ        : DUOESXRG        BENEDVWEPYHA   
LWFGCQHRG       : IDYMUSCEH       MOKRQGTW        EJCMUDLCGOMKGHG AWBN            XLXFBWIY        UWBCBGHOVIMTRW  XBDIKMASGREYXVL
ETVQYAIAXP      : CLDBACQUEJC     VNSCFEJHBSU     KILSKXJXE      
MWBJBRHWKMJI    : GKUEKPK         TAVILT          SEEBSRTN       
PMIWERDINABPA   : DPWVYE          VWPK            PYBJNBKWCEEBPT  JHWBL          
PYBJNBKWCEEBPT  : FPCDFOEDUNMMJW  UOAIENYSVBI     PMIWERDINABPA  
ALCMWBQ         : EJFAUFOFUYYIN   QSRI           
FBEF            : BDFYITIYDMNJ    WWGXWENK        JJJQCMFMFV      KLSTUHNX        COMTKX         
TFPJGQSWR       : HBSBVWMAKY      SWGAO           KNKGTMXBM      
TVMBX           : PMRHTAUSNIATH   SBTBIEODSEWY    QIRRHPQNWAFHI   OMEJMBFO       
UKEG            : AJYD            AAELUGQ         GKJILRM         ADSHRKDQALPXGB 
QFOJV           : WJGNFAYAHFVR    DSOTYWRXQP      YJGT            VDEVARNEFQDYP  
MBBQUJG         : ASWELFXY        HCWSMV          CGHUIRWRPRRBRM  DNIMJEIDL      
RYAOTGLR        : IIGLE           LRCKASQLRJUE    OSPDPA          NNTSUNCIYX      EAEWYUCXLYVBJEV UROUVGIEE       EEOIF           BTIX           
MPWHDDPSVVJF    : CROXVA          UPYQAXSSGAC     IVYMUDJFT       GUIVJFPXRD     
GTUJ            : JHLEWDXYQRVPI   MWQIYJEDXQIQD   CHRJJIWFYFGVA   ENSUIUFYYQXT   
QSSXNTX         : NEMLLOW         UYGPUELKIHJV    AEUSQYJLXJDDR   BGHBNKQEQIFJ    MQFQJ          
PGPIB           : ETFNIQTPWPHVBY  DEABLXARSBEFV   RPRLBO          GGHNKTXFHQS    
AALDD           : CNOCKAHURLTAT   TBLLQW         
XYAIGTOCPAOITJG : JTORSPHXSS      AGRADRG         RPDBMEIOL       HVFSBSEBSGLK   
EENT            : NSPLPLSCEXM     LVIPTXC         GVDIIVGRF       JOWCYADDGED     FLMEXKXITMYFFA  DCLAUMFXJ      
EEOIF           : RYAOTGLR       
UIUYHWYR        : LVIPTXC        
UIGK            : YKYXJGLBBNGUQR  MFCD            XYQQWTEJ       
WSEHBNNI        : HXGXHK          CMPI            KAIRCTVYJKVQSJN OVQFCQXH        LAKVUA          TOCCAU          KGLTTJTVK       TOBFKG         
JVIOMQTENEAMNWN : YTRJBLL         VWBOCDHD        FYNAOYMJLXB     NWFM            PPRX            UMNYLJEJ       
CJNKVYIRDPST    : ROVW            AQGJUFVKQCL     UCLAT           YAYCDLB         RDEPW          
BVOY            : IJHPXER         FIGI            RWNSHDWDDL      MHSB            BLNJVEV         EEWQKSRRRFLUTUP IJMWABBQXJ      YANDODJDRSFLJ  
DMWYQNGSATPQCUC : LQGQ            PSHSTGEMHF      NMVCRHOICPAAIB  XEUYAQTU        NRCWTTQRCTC     JGABOFHRI       MWTSP          
FXQPRWH         : PBEH            RCWUJMP         LFFVYUG         AAWGRFRIGAPYUXA PKESEMRVVNIYX   GUDKNOWTMLMSTO 
QMOOEQ          : SROXDNPGAFU     UUKL            AKGBAKHJPNA    
HDTJV           : GQEXDSWRIBL     WFTPBTEKRYPLMN  OCSA            ALEHQCIDHYMCY  
PPKJHDNCFGKDYAV : TCUJFQPQIO     
IJMWABBQXJ      : THRKOGCEX       CXTIQOYCDYFC    UXINTHCFIVW     BVOY           
SUSCKIOV        : TQIXOD          BBTN           
RKUWSFDRHBOP    : VPIYKFWK        QPEJ           
BNMF            : DMOFJY          VFGNPLMCW       FPDXXFAPXKXYWD  SLWGTSQCDSKTU   ROQCHUT        
EDAA            : HGNKVCCGW       TATOALYADBSV   
WSDHDRGVMS      : MUFHNKFNMTSYFK  HHIV            KGYQO           BKBUUWHM       
JLXODF          : VBLBMLWWFCDDU   BJEXXGQ         VMKRGOJEGEVRXJR YXDKYAEJV       MMSEDWXMKIAAIW  BYPIDEBDAYFGISC
RXCVNPDEV       : KEWSQEB         UDBIHGQDSBRQP   CMQPH          
FXHE            : ROVMWHD         YYSUPD          FYNAOYMJLXB     GJTIFC          JHOXPG          TITYBNLHTIJHM  
MMWEUSSNLDYL    : OIIEU           MVIFH           CUWWYKE        
CTKWROUFGXJC    : BUNDTYS         KHHPQQXXPMLMMV  VCCPF           ABAB            FAGIVKVAWKYHPG  JURV           
QBPVUCKTJHPCUDH : OGCVTY          PMWHWHHD        LCYDHGUQPD      BOIWWJJHXFPTO  
PCAJOWDF        : EKEXXCIINSVYAO  MDLHAHW         XRQVE          
KMRVOBPRSL      : FPDXXFAPXKXYWD  NUYE            XIIVLPKSEQUDHDX RHRIBIUHG      
XXJHHYLCCVXTAXF : YWAFQ           UYTT            WDLMEEP         NLKOBONBB       HXJCO          
XIVRSIMRANHT    : EEHHIOEIM       GBRS            JCRACYNKLMN     VISEUJBHLN     
UJGUUNCVCEAA    : OIIEU           WNISTPGKFYBEE   XLKWO           BXRFVDCGEFO    
UCECS           : TCUMV           CLIBEEQ         VDYGEUMMWRK    
LQYGALA         : ITFGWSSXNP      YWEGTEKLQEQ     PFTFTSG         YQHWOEECP       JXRAKHH        
BHVJCHQWCGYXK   : KHHPQQXXPMLMMV  UPAXYVCKPBN     KROII           YANDODJDRSFLJ  
BMLXOS          : CHWAIKJH       
JWNBVUDJUFKFDW  : SVJFKM          XEJJPTJRSVNLGNP RWNSHDWDDL      ADRDTKQIWBX     TNNJEAKFSCKEVD  JWPSW           YLTYMYJAM      
LNHPVIQ         : HXGXHK          CXBC            VWPK            DPNHIWLGWIHW    VRWEPNFXCRHMVTB IWPMCWTCNMHWLP 
ORTCPL          : YNSTPWUNKY      JWLTDYUYUIUAKV  UMSBUBOH       
PUSEVQBBBXINDM  : SMSTXEKM        XBETJJ          VQUEJF         
NAXUPW          : FNGOWT          JAUSXQPLPOFX    FIPYIQVI        YBRVB           FGCNOOTGAGUAM  
IETCAWRLRKHMQFE : QMDCERKWUVF     LFHPRIHUCOIS    KVMTAPCBFRO     WLRK            AXAVP          
HFRPSXEGNE      : NTTDIXOTONFAYBW IBTKSTUIT       CUESPFVRGWBOX  
KWDNFJ          : LODI            YPRTKKSWV       KRCTGTLEQ       YANDODJDRSFLJ  
IKJCVBOFQFNUBW  : PJYWNUXKKDGK    YHIGTQF         UGTRG           BDCNN          
VMWTTDJXK       : AFRSUQSC        NLNBV           VRPERSWXOJQXGR  OCRGGLJMRGGKSSQ
WPJFATPKDRIHJ   : QAPJXTQQ        YQHWOEECP       BYIRNOUYW      
XQEUSBYOPVKJCT  : NOFPY           QMCQGXWIAIQQ   
ONHEYMGTCQYWC   : FOHFW           MRIDJWOSL       WTEAHIXJBRTHAL  RCUPTHYTOCCYMKR
ISGYWBRXAIN     : HIBYTXLTUD      QIGACCKQKXBOVB  YUUPQBHEIJGLO   THDNK          
SXDMKRC         : BQJMDLLYYSMTB   TYVDQQAIOKSLRWG BMFBLEPSMYBAU  
XCHF            : XPXWML          PFJDBCORME      IHJQVXSM       
LXWKAGSSMSPQMP  : FQXMKVHPYPX     GHXQYXMRHEBY    IXWMO          
VETOEW          : CMPI            NPSUWILQIKG     BLQBWMGXJF      AXFHEYEIDJT     SNMVXNUBGXTXG   EGERSYSXIJT     RGCRYIO        
OOIIPMPUKCSK    : DASLQMUUFXY     YOBCVWR         EPRGFBWBJTMGG  
TQIOFBFVPURLBLB : AAUKISLFWTKROJ  COPGMLJYTQXW   
JHVAPF          : DCPHGCVDTKQQBS 
DWKPBGCQA       : SUFOSRCGXSMXISG SIYUTI          OJSPUJPXSGYIK   DESAXFARWLJE    LRNOYLGDYKXOFD 
YOBCVWR         : OOXJKHIF        OOIIPMPUKCSK    NDAWH          
QEUDHDMOBOGGFLE : KPBQRBTASMKDWY  NHVGWTKBLOABHQ  NPGINWJDBQXISKF GUPFSHPJ        DCPHGCVDTKQQBS 
CFXEXAAWRB      : QYTAA          
PATJRAHWJKLXLA  : FFWEIGXKYERVP   GRBOHDM         ADSHRKDQALPXGB 
UHSBAWIADHBFEUG : RYYQWUXSINMAV   DTVRAOJGSP     
KJCWDEEA        : WHXKLRAJOGKNOLH LUHTNJRWM       DPBRYJYSIYHQRKT LCFVHUFLXRK     MPTBDX          GHRMGSCJMKCEX  
QLNENTYVOA      : QYTJORKOBGKCAJW FBVVRCRWR       TUKRVBXI        DCPHGCVDTKQQBS  MTRYX          
LJXRSB          : GXIJ            DQEJPNVKTRN     RKYQ            WWGXWENK        XGWNASYKSUN    
WVGFJ           : UERFN           KVRGGC          KVKBAWLQAYWN    OFHPMXIJNPBOVC  YLGVJNGNTT      PMFSRNSOWNF    
JGUNMWBFKQJX    : KTNMGFX         RMNGFDLWFDKLVLR QYPJJB          GOJAP          
LTCNRQ          : TVWWDNE         KKNPGYNOQ       MFCD            JBMLG           KKJPKGXE       
QIRRHPQNWAFHI   : LUHTNJRWM       FULDCVYPXXAVTPQ EEWQKSRRRFLUTUP TVMBX           XLYFELPF       
WWYYCJR         : ISIJVKQFSPGQJC  ALUVEO          LJKLKHOCEH      YLEIGVQNFJXUYX  RWEGJKQANVGWUBL
IFYE            : TJUHFVHUQNMMN   FRXFGVDLGUOO    NGHKJBUNVQVTP   RKYQ            BMLTEPA        
NYBMRLFJ        : IGCNU           LMORFODFXBNE   
WCJVEQDOTB      : EHSMPAEASBJIH  
SCPF            : CLDBACQUEJC     XLXFBWIY        NWPIKIM         XLYFELPF       
GPCFTM          : GXQDRSQSA       VRSYCYWDRCYNB   VCCPF           DCWTQ           TCUNXWUJJOQ    
SNIKBP          : XCQWYKPFLW      KIMUEFWEGBXDSM  TOCCAU          IMDCCLOYHCCCGP  XBBEQV         
TOBFKG          : BUQHTLXXN       OIWXNPS         WSXJOCDERPOHWNJ CMWJOPNPPTTDAC  QAEUHBUOHS      ABAB            BFSFGQK         UWEWFTRKNDOAB  
TOBFKG          : WSEHBNNI       
QUQTJLXBSTHIVPF : HLIGVCQUIGKTW   WEOLYOMT        TUFRBC         
KAAU            : PJKIQGXUQC      HUMOUCUYELL     UUKL            FIBQISRVCBDEE   OTINEPKISTOYWIS
BMMVBNBOTA      : UUEBEBCRAFPGIR  DLRINJNAJHCNCLO NDFQKFCAR      
RSDDFBEAWO      : VVLI            ELVLG           PBFYPC          BGHBNKQEQIFJ    ADYQEW         
TEOG            : FSBNHKIYHTOHNX  PPCLKAKVO       KAHLDHPHCB      NOLTFL         
OHKE            : TOCCAU          SAUGJHHIFQV    
WQGBFIRBI       : IICXTUBTMBTXC   NPSUWILQIKG     QSRI            NPHO            THDNK          
SECXJFFLC       : OYKUSSAFNBSBRL  NERXHKYARPN    
UXXL            : PFOCSHNWWOWDX   FLMEXKXITMYFFA  WMOEASDGREYJ    WNNJOUY        
ODOBHWBYE       : PDAWCHFKDXRN    EIFQIALGVBDFP   GIWUTQW         MBHVHKNTPMHBQUC
GOVHYWDDBBOGGBK : JBMLG          
VJAKQRPFSWCTX   : AUPOVETVSSJGN   IDLAAFKSTIHFFE 
XEWTM           : AJDHKYP         OPWSUTIIHRHO    STNTI           DQTHBCTTP      
QPATSPA         : DRMJHW          FOPE            KLFNVDIYT       OYUSOFKXMTT    
SNCQYF          : CKDXFGNNQIU     RDYUXFBBLLDSVYM CCDCIQN         CHWAIKJH        VLQE            ISJU            TJXENUGDFXLN    VLHUKUJQMX     
SNCQYF          : JURV           
PWQWPQYMOKKVH   : QPTA            LFHPRIHUCOIS    ETFNIQTPWPHVBY  LHXIFARK        CHTHQ          
IEAAH           : VHOICVDOSJJTBMR WKBTBWNSHJBYRVT YMHFJWVDE      
UYWURKAIJFKBC   : PYHBSGGDEJCHITT ICCLG           RBBYQSBNLWUKR  
XRTA            : JRJKPTW         JWLTDYUYUIUAKV  FYXGP          
LKRHTBR         : HFGE            GDGKESLEKUGJTHS JRGPLQNTFREOOBY RCUPTHYTOCCYMKR
BTIX            : XJNAELEDH       RPRLBO          RYAOTGLR       
JVMBI           : HTQFJANEPQAO    KYKDDDPQNBS     RDYUXFBBLLDSVYM
JURV            : BODWOU          CTKWROUFGXJC    SNCQYF         
TCUNXWUJJOQ     : AWSA            ORNRAWTNRADXUO  HKDEEFSQDBNGPP  JLXTKH          GPCFTM          NRILAKFWXQC    
PKESEMRVVNIYX   : LFHPRIHUCOIS    DUXBOVHKNPLKHT  JSATKNNDW       FGCNOOTGAGUAM   FXQPRWH        
LSMHPILM        : KRTW            GLYSTLVDAYKRIMS DXISX           MGGHTYWOHQDBTVC PQBT           
KLSTUHNX        : VONEUTHBWPGYGDC FBEF           
ADSHRKDQALPXGB  : YRYNJFSHA       NLKOBONBB       UKEG            PATJRAHWJKLXLA 
ULJDWXBJJW      : BXHUTTNRLIFDP   NHRTBCVSGHHMUI  NJEANQFJBNF     HUBTCKUPTBV     STXAPVYA        SOBBTMHC       
EGTCGVHBDALG    : EUWLU           EGVCNCIRTWPS   
NRILAKFWXQC     : DJYQIEDSYGM     BCSTCCCGX       NABI            CKESKGTNTGSRQCI TCUNXWUJJOQ    
OEHABNEJJJP     : HVSETNXYT       WDCXJLYALWMF    VCNULRLBOQXSUG  VLHUKUJQMX      BCXNOKRUYYE     PFCTGH         
QQJSE           : GIADKEDIU       OFIGICLCQ      
JRMUGOFNM       : MUMKXSFOAWL     SEMTSARJQF      WQXNJEORV       RPRLBO          YDROPFAW       
HOCVUL          : MRVAGAHOBW     
XBDIKMASGREYXVL : WDSTLE          PDAWCHFKDXRN    JPSGRKIRNPJGPJN UUKL            LWFGCQHRG       CDGJPXHRWWE     XDNPCKXISDU    
IGBA            : MHXEYBSD        CHTHQ           DLHYUB         
OMSVDW          : GMBJ            OPKRYRVHFBEHTU  MDWYSADEEI     
YLTYMYJAM       : VFGNPLMCW       LEGI            JWNBVUDJUFKFDW 
SUEWTC          : DTLAQ           EYMDUOBFBT      SYUVKQMLIBX    
HWGNXGBPUVNXTKY : AGLFHUTF        DASLQMUUFXY     OPETASBUUJKU    PYFFTTU         BMNQSTJE       
EYREIT          : PAYPYIDRUXLOJ   KPBQRBTASMKDWY  EQHIW           DWUPVJIU        LCYDHGUQPD     
UMNYLJEJ        : YTRJBLL         WCNGTSMANIDB    BFSFGQK         JVIOMQTENEAMNWN
BPFA            : WDCXJLYALWMF    JRSFFQBQ       
JRSFFQBQ        : FULAIT          VNQN            RWSESNSOVHAXFF  DBMWWLCVJFPN    QIGACCKQKXBOVB  BJEVXIWDQSKB    ICBRQMCHFQ      BPFA           
JRSFFQBQ        : RBPYY           FRSWSQBPIGK    
IWRDBCWVXKJWX   : ECTMCXEMUJ      DKAASIFSRP      MOFALGFFJ      
BHPFYUHW        : XFMSFMUQHVJD    YUOOWXCAKXUMT   HIAVK           BWRKWTPL        QPWAXXQLSQPQONA
YPOEHPWABUR     : WMPVPITIUJQG    QAPTYHWHKEUSNQ  HVWRP           SONVKYDUJLWJFJR
XTBUTNGRO       : VHFGGRNSGSKF    AWWRREIKYLNF    MUUXYKYBM       CEDL           
UXRCXPJUX       : HBSNUMCBKTHFOAX FRJL            LJQLDGPHQSIXAS  JXFFGERMXWHHR  
LMPUFMUGHOKGIN  : PYFFTTU         MDQAPFGWM      
DEJWSMTQGWQXGM  : EYAQCN          QYUJUNMIF       INVPMVXYWHMQK   TAXMXKLIVUQUU   TBBBGG         
RALHUQ          : QTVXSJNRSVO     HXNVP           WYQQ            RXXHR          
RWEGJKQANVGWUBL : WJDVGOCWTEVTOBQ HXRFJUKUVCCBWT  UIFTEFMQOQOW    LDOCVUSQYTFYP   NHXTNXJAHQGK    WWYYCJR        
TUOLSWAPOACV    : OKQTVXW         CACCQXWJQI      GKJILRM         VISEUJBHLN     
USQU            : CRQDUOFOR       SSSVGXMQ        JCANJ           GONJTSDPJXVV    FPJQMREHB      
YGJPGYOOX       : GQOSVWLQUFO     GJDVJGIJ        QYPJJB         
PKBKFPVANXSCXW  : LFFVYUG         JCANJ           DIBLMJIVSIJU   
WRVNM           : WWHAK           JJPJJ           RNXBUCMSJQ      NVVTHMLFJEW     YXDKYAEJV       JLEBORRDOEPW   
MTEECDS         : KKMVYIHEXSKN    KIMUEFWEGBXDSM  HVMQY           OWDLPQSYQNYON  
BFJNGTUYRVMP    : FULAIT          YPRTKKSWV       YIYTYSJH        AFTJY           IWPE           
QPLTMFPCU       : BXMEVKRJJDY     VOQM            WCUGA           DGUUTKVFQ      
OQOVSTQMXVYLF   : ENDESRTYTYVLLB  UGYUALNR       
HEPDSHTLXF      : KCCWGGL         UCVFBHIIJFXWRXJ GHXQYXMRHEBY    IFIXUOO        
MKXPHJGXAET     : GNCADUD         QPYIBKL         PPCLKAKVO       OCRGGLJMRGGKSSQ NOLTFL         
VIUTHGYDNDSSX   : PPFKYJNPTLHW    OLFCSDFOE       KTYYWVGK        VOVIKUHEUXNYMH 
MKARSNFQFM      : QOVCVWUKXK     
NNDSHAQPU       : JLACNA          GVDIIVGRF       FMTDVHEWUDLBIF 
XDKBRPVKOXAYY   : IUKFOJBQLC      JTBLQ           GYPFGMKXWKHVU   JTCAXKYLL      
ROYK            : CBRLBBXRHPUFKK  IUWXIWMBL       XCQWYKPFLW      KYQFSRIUAQKSYTV GKYRYCUX       
ONJCSC          : BYEUGCODDIIL    SYIDKGO         JXOWCN          OQMY           
SSYPEYSQCMGXAU  : WDSTLE          OIWXNPS         YPRTKKSWV       GMBJ            TKPRL           HMOLRBSGGEVAT  
AVXTPMVBI       : WEOLYOMT        BCXNOKRUYYE    
QROJWAERBVXB    : JJJMLPAWBN      FXTVAUISLBVYT   JDXM            LLIBY          
ODEVEGSDI       : OJMDHRVKSVR     PVAAVB          BHVFLWQR       
BEHPAKXOBR      : KGWWBXUNLY      PPCLKAKVO       LNBK            CJEMQ           RQVKODVHRNWGV  
MQFQJ           : XBCJF           QSSXNTX         HONJDTUBIEAKUEB
OHKGY           : PQBCQNS         HNSFJQHHYA      SFQLAGOKFOVV    MDQAPFGWM       YVIDNMFKSI     
MWTSP           : BGSR            SSSVGXMQ        RSSTN           RPDBMEIOL       VQUEJF          DMWYQNGSATPQCUC
DHAHRPKEPY      : HFGE            KIGRTUETG       DASLQMUUFXY     EAREMEMQGYACRT 
KFUBMOMV        : IJSPVUVPIFDQBPP KIGRTUETG       JTTFTQRR        TUKRVBXI        BYIRNOUYW      
WGJVYXS         : CIMDSPOYEQPOKJ  LNVDQ           QUOLWPMSYOS     ESPOOVODRU      LCCFQGLJKMBYK  
QKSVUUGONSS     : QSNPQVKKE       UXJNKBNYK       EHSMPAEASBJIH  
RBPYY           : ITFGWSSXNP      ENTA            VXFWVDTDP       JRSFFQBQ       
ONGKSDTFBSDVNWH : HTUD            GONJTSDPJXVV    RBIWAWXEOFF     COMTKX         
SEEBSRTN        : AGLFHUTF        UJDFPIUUCQYKOGT MWBJBRHWKMJI   
OPPN            : OSGDMQUJEWIJMGO
JEGRPYXJE       : YWUW            GURHC           RWYSNJMFEXL     KKHPLTDIXV     
EIVRHFBALF      : AXFHEYEIDJT     GEGM           
EWXRVM          : KVRGGC          WMOEASDGREYJ    KLTUWJI        
NDAWH           : GDGKESLEKUGJTHS DAYIPUCTJELWH   FHDOHDQRUVFC    YOBCVWR        
RWIP            : TCDHXENJ        EOMTF           VEIAFUMIAEBO    LNIUU          
OQMY            : ECTMCXEMUJ      ONJCSC          VHVKE           BNJBORLJEGGK   
FGVGJHNNLM      : TEILWJLVXGRPEMD GNSHKANH        RPBENOK         KBDIASQLRQADX   KFCPR           YHUPHJBFEIMJ   
GKYRYCUX        : YPRTKKSWV       CUWWYKE         ROYK           
DPJLHRBYF       : IUKFOJBQLC      HCORK           NKWO            BOJBDUP        
NMJMUSTI        : ENLGULI         DRKKCN          QDXNREEDL       OINTKLHPAN     
GWROHQGGUBF     : MKWCCS          OJRPOARHSEBKG  
FWOSFIVGPYV     : VWUY            WPJMXQIDLX      OORVGUEGDXGI   
IIYBDJHLGBAO    : ORHJNVMOIMXQE   CLDBACQUEJC     YANENNEECDKFFYC
IWPMCWTCNMHWLP  : TKNUFASPUBWJTT  WOHJKCYTM       UFYDDWDVNY      HWCSSYFNWR      LNHPVIQ        
KLRSU           : VWBOCDHD        UUPMPQLKJOXJB  
TABDLJENXYX     : FIMFRWGS        JBSRQHJRV       MUUXYKYBM       PVAAVB         
RKAOGC          : JTORSPHXSS      JSYOUHS         JHDFX           IXAJG          
TLCHBQ          : EUWLU           WDSTLE          UKAVQ           WMBP           
PKKMEGMHJA      : HGKWCXMLARBFWP  OMAPIFA         USPLKGDNDYBWAEU JTCAXKYLL      
PPPRNNJ         : AWLVQ           RAMF            GNJOKKJQYGVQB   GITIQK          NJAWFIJCBDYV   
NAHS            : FBEB            CLIBEEQ        
DEJK            : VATN            NFALT           BXRFVDCGEFO     QSLFRUOACIXJNP  EGVCNCIRTWPS   
BCXNOKRUYYE     : OEHABNEJJJP     AVXTPMVBI      
QUQIMEVXFLX     : WWHF            QLCH            PPTLTHFKEQYY    WFTPBTEKRYPLMN  IMDCCLOYHCCCGP  EAEWYUCXLYVBJEV PRTJJWVBPI      YNSG           
EESLNETQITFXGY  : IQHBWFPOATVXEBT QJGEGAQLRL     
FYXGP           : QXGDNOFQBQDPCYW SVQFKNE         TIHIJEISRCCWKKU XRTA           
WAJDVJJHHYONR   : PDCFSVS         NUVHAWRRCUBMT   WLVH            UXJNKBNYK       UGYXUF          WYQQ           
CXVUHPCFVCXDD   : RMATGEJTXQX     RSKQABGMAD      RTGMJDQHIN      KKCGJWQJPEEX    NPHO            PMWHWHHD       
JSUIUG          : RSHO            EWCFEWIKGJQUAY  UUKL            GVXKU          
QPWAXXQLSQPQONA : SIBJUTAMAV      JVJLYJ          OOXJKHIF        BHPFYUHW       
PFCTGH          : BHHH            JUGMJMCG        OEHABNEJJJP    
GSRCBMIPDBOG    : KRASLPCJSBR     VVLFUJTYXXWOX   KLFNVDIYT      
NWMIQ           : XIIVLPKSEQUDHDX YBRVB           TIGBW          
YFSCMIJ         : TITCBKEDPDIRC   BDFYITIYDMNJ    YXQM            GLKBXXSLPJIW    JQLPCNOOVV     
DPYCWRUBVH      : PMXLFVGWFKLF    CSTWXIDUK      
NNMCTNRSBAL     : OUHHQDDCNE      EIXRBULIAT      WPJMXQIDLX      FIHSBDVBOE     
CTBEGLNYQEA     : NNVCCWCBWPPQO   VVLFUJTYXXWOX   RKIGGLDN        BUXQAIMTDA      AWBBISRAVY     
DUOESXRG        : YXNLS           NDFQKFCAR       FHTDQXTQ        PEPJJEUMQEGBFK 
FIHSBDVBOE      : PSJEY           HCORK           DJTWXWEGMRY     NNMCTNRSBAL    
IHJQVXSM        : WKWIKFKV        PYJOMVKEVKGNQ   KTYYWVGK        JLXTKH          XCHF           
SIHNWNGVFOJ     : BRDGXUM         YPQJCY          AFWJU           DNQLYYLVQ       YQFCSAB         GKJILRM         KWPMUTIHUVGNW  
XRIBUG          : JSYOUHS         VSEBBIGPBQ      RXXHR          
LNIUU           : PTXDVNTNWRIM    HBSEYXFDLEGYX   JQYW            RBLKOMEYT       RWIP           
LQRE            : MUUXYKYBM       KKCGJWQJPEEX    CEPASUKPCGRYN  
VAOFPMU         : WGJSEILTWHEV    ENTA            CVDBYLKFXGCWJS  FLJAKRUJNL     
KDLVPLNAOKHTWU  : NLNBV           QWMJW           XLXFBWIY       
RRXFJQMROOGWEUR : ISAYWYUKDVSKL  
HUPENDRNSFWM    : YWREI           CNRCIJTC        RGGLWKPA       
RQVKODVHRNWGV   : BEHPAKXOBR      DQLG           
LRNOYLGDYKXOFD  : PVABXHRSA       BGHBNKQEQIFJ    FYKAATAJARFDB   DWKPBGCQA      
THGMF           : VBXPUEQ         IRQCR           SXNUASY         TUJDKNP         WOYTNCHTLI      VOQM           
DIQLBEK         : DFOLHXUHV       TIGL           
DGUUTKVFQ       : RWNSHDWDDL      SVXQYL          GVXKU           QPTDH           QPLTMFPCU      
GDAXKFMEMSS     : FUOVEPVS        CHWAIKJH       
OWCFI           : JANCFEX         UXLHJOMUQFE     ITHIUT         
MUNPBKKWUI      : DANCELLCRMKEMVX LEACVRSAI      
OINTKLHPAN      : VKDLDCXBJSVRVAB HGKWCXMLARBFWP  WLVH            OSBCGW          UXINTHCFIVW     NMJMUSTI       
VHVKE           : ENVQAUCYQ       EXMHPSRQLU      IMDCCLOYHCCCGP  OQMY            VDEVARNEFQDYP  
POEC            : LQMSKJWBQV     
TTMFELCNQQXHNL  : FQXMKVHPYPX     WNMUFGL         YWREI           LIBE            BCSTCCCGX       XWUSALAMGOUA   
UBVIGRRCEVDVMI  : THLUGIYWLBKWF   DKHSEFWY        SMJVVTVMHWA     GOJAP          
XEUMJCBOR       : KIWULYBNR       TFQJVNEC       
HPBUDWRFSDLMU   : OQHFEQFAWOC     RSHO            WKXXUUYCUIOGWDM UVJWHFDS        WUORFCSUBVV     OWDLPQSYQNYON  
QTTO            : BHAA            CFAWPNKXKBESH   NYKVYOJNKUF     KLFNVDIYT       DRKKCN          JYUWGSFIP      
EPHKLVWNW       : GIJRXBOMILRT   
FRSWSQBPIGK     : ORHJNVMOIMXQE   PFOCSHNWWOWDX   QIFYJVUVWIMU    XYOESQJKYUR     LRJVVOLEGKV     FIPYIQVI        JRSFFQBQ       
TWJJPDFFLLUUYGT : NKMW            QACNCF          WLIEHGAVHXSPG   CFXPIUITQO     
VSHBKAYGQAVCI   : NWFPCKDYXK      BPAAEUOUJQSLEY 
PCGYNYEVGQ      : ODYQAAG         GVEXTBQHMS     
DNIMJEIDL       : UGYUALNR        WYNGL           MBBQUJG        
NOLTFL          : KTNMGFX         CXBC            JTTFTQRR        JPYP            CUWWYKE         TEOG            MKXPHJGXAET    
JTCAXKYLL       : YGNJ            PMUAUFJODKDRU   FGDLGTDTGWM     XDKBRPVKOXAYY   PKKMEGMHJA      VDEVARNEFQDYP  
JRWT            : NBBIPWKIVK      EHSMPAEASBJIH   CUESPFVRGWBOX   UITKFRI         DIYVCJSCBGU     UROUVGIEE      
MCKWHSA         : SLHNOAV         PMXLFVGWFKLF    IRCRUBETQTOMEVH
FPJQMREHB       : WKJH            QXDVCLE         KHJUCENANL      WPQFSLWEADAJYFB USQU           
JBXVBMIH        : MUQF            GITIQK          RCLTUYQDULV     MRRPDGWWEQ      HVFSBSEBSGLK   
CEPASUKPCGRYN   : TOCTFFELFAEQE   GXMV            BXGYYMU         LQRE           
JHWBL           : XNURCBYS        LTSO            JSEQVREC        PMIWERDINABPA  
COPGMLJYTQXW    : DLRINJNAJHCNCLO GJDVJGIJ        TQIOFBFVPURLBLB OYNXFKUGSAHFW  
NWPIKIM         : WXAT            YYHPBW          KRDK            SCPF           
AMEKVN          : AUNCWCI         BVFP            ICJXRXK         HUQCHRJMS       ALEHQCIDHYMCY   GRPCU           DLLSQTRFVKSOPE 
YANDODJDRSFLJ   : DQEJPNVKTRN     YQHWOEECP       QRXEKCR         BVOY            BHVJCHQWCGYXK   KWDNFJ         
KIQKYC          : LYRGJYLMEKD     OIIEU           MYPJHR          KTYYWVGK        XRKELPTKXCFWYLN TCYRJDKTFLANQ   XBIIUKT        
HONJDTUBIEAKUEB : MUFHNKFNMTSYFK  PPFKYJNPTLHW    MQFQJ          
PEPJJEUMQEGBFK  : RVELR           QPTA            GAJBC           LIPHFL          DUOESXRG        VELBVAW        
OYNXFKUGSAHFW   : OGNGDMCACX      TVYKKT          TBBBGG          COPGMLJYTQXW   
GUDKNOWTMLMSTO  : TKXAV           XTYEUAYAY       GIWUTQW         KGYQO           GLKBXXSLPJIW    FXQPRWH        
EOOG            : RGJRKWMVPEB     AGSAVH          WRYUQNTH       
MLPKRIMBPJO     : KVCRYIJLXXCBGDE
GUIVJFPXRD      : LYRGJYLMEKD     DLRINJNAJHCNCLO MPWHDDPSVVJF   
LTOSKFYPUKF     : WJNQVYBJ        AGSAVH          POUNYSGOBYPXADW
EPRGFBWBJTMGG   : EABGWGFPH       GYGEEOEBM       EGVCNCIRTWPS    OOIIPMPUKCSK   
VELBVAW         : VWTSFSDSH       BTDNTGEEUSWW    KRCTGTLEQ       PEPJJEUMQEGBFK 
SISRXNEGSKV     : AGSAVH          OOFWBJLBT      
SCPQFYKRF       : IJHPXER         AXCKRDLFOSB    
MEXXFTAFGS      : SJXQJFIYLXFC    TPNFMRPUKHOH    QCTTDC          OPKRYRVHFBEHTU  YHER           
BMNQSTJE        : QYUJUNMIF       GGBB            TIHIJEISRCCWKKU HWGNXGBPUVNXTKY
XWUNPCNDWS      : YLMRYIATME      XEJJPTJRSVNLGNP LVIPTXC         ENDESRTYTYVLLB  URTYW          
JWVJFPMKYHAC    : EAREMEMQGYACRT  AJCGDSGLJSGUMGB
PTPK            : CVGDDUMLXJULQ   UXINTHCFIVW     NUCJPWWHFGFKRVQ
VDEVARNEFQDYP   : FPDVUMUUKTNL    WMWPSCRGGBK     KQYBKXNFTFYKCKL QFOJV           VHVKE           JTCAXKYLL      
XLYFELPF        : AEUSQYJLXJDDR   NJKL            MUGYEE          QIRRHPQNWAFHI   SCPF           
RHRIBIUHG       : LYTGSJIIFDE     AUQMOBKJRVR     PFKUH           NOLBXQPFITQQKTD AAUKISLFWTKROJ  PPCDKFO         KMRVOBPRSL     
LCCFQGLJKMBYK   : NPGUYYBFDXARM   JRGPLQNTFREOOBY LMFWO           WGJVYXS        
ASVNIB          : CNOCKAHURLTAT   EVBVKWKYDF      XJNAELEDH       LGPLBJHGDKILMGT
DIBLMJIVSIJU    : XIIRQLSTEUYA    AQGJUFVKQCL     UGAPHPP         PKBKFPVANXSCXW 
ONQAADODFCSF    : JXRNDEOLI       NITRRKLRDPNHPG  UENADHXBX      
OTFRD           : NITRRKLRDPNHPG  BWSXKT          IVHWLCCN       
DGVPSENLMWIY    : IRQCR           TIIQL          
WQOYVFC         : CRRMIEP         YQBUSNNJG       CVDBYLKFXGCWJS  LCYDHGUQPD     
HXJCO           : RITNOGDGX       XXJHHYLCCVXTAXF
KHISKQRCJVPULME : VHFGGRNSGSKF    MIDFRPIF        UVJWHFDS        HCWSMV          EEUYPAEOYTMYVL  DIYVCJSCBGU     IUVQVGHHNGBCA  
ADDQCAWGDEE     : KKCWNTUYXAPVOCU HBEGBXRKDUNDWE  KAHLDHPHCB      PRCUKKVXVBGGOJX
JTRTDCONTG      : MQGEVOTWUNG     XJOQRVLQONMDJVI FSIMBLKIW      
DDHYOT          : FSIMBLKIW       DOKNMNBHYBWRCS 
YVIDNMFKSI      : VVLI            MADUBLYDXSWOOJ  CKADDRGIP       SIGMBEY         IPJTXDI         RGPRJ           YYJHAORCFXYU    OHKGY          
AXAVP           : SNBCMXUMULYTUXD IETCAWRLRKHMQFE
BSLOMTG         : XSIEWPNQ        FGKDMHRCGDU     VXFWVDTDP      
YNQPJXR         : NSPLPLSCEXM     FNOVB           CCLB           
IUSUCFQMWSKWQB  : HBEGBXRKDUNDWE  VMKRGOJEGEVRXJR PTRKSOVMJUVUJWJ JWSIVIHETD      XNTSSJUD       
RVJGKDO         : VTESJVCUSIKOG   DSOTYWRXQP      KTYYWVGK       
DEVSNTKS        : FOUMBOFFYR      VBTQFILAIDJBK   XAPPYOQ         BKRSMVPFOJ      FMTL           
HOALTQYQLL      : LLPLTITCCRYUGR  GDGKESLEKUGJTHS JCANJ           ADUMWYBDPQI     XJNAELEDH       FIPYIQVI        NOLBXQPFITQQKTD
COMTKX          : FBEF            ONGKSDTFBSDVNWH
UBQXGUVCIPO     : NIMENQUCBV      LIBE            DPWVYE         
SYUVKQMLIBX     : AHCVQUG         DMPYEYARKMFIMD  PPHOQXLMRB      WRYUQNTH        LEPMXHYYMXTWF   SUEWTC         
DMPXANA         : MDWYSADEEI      KWVJNNTYYCLLKW  URTYW          
QTUXOSAAJOGEND  : HTLXXBD         YEYY            AUXAS           RLODVHTFRIA     HKICRNBOL      
BTPMEQKFT       : OMQIFLRNGLTWC   LDOCVUSQYTFYP   VNDXBLSOWPKRN  
WTAKWWCQ        : FFWEIGXKYERVP   TJXENUGDFXLN   
CHNCJYSR        : PPHOQXLMRB      BRDGXUM         QGSEB           OYUSOFKXMTT    
JUEKRVY         : HBSDQBVTSSW     MPTBDX          DOHRCIGQDKVAI   VGKLMNNNRJ     
OMEJMBFO        : VVRAEYELFFMUCQY DPWVYE          UWEWFTRKNDOAB   TVMBX          
ENSUIUFYYQXT    : SXHWDYA         CTFYSODRH       AJCGDSGLJSGUMGB GTUJ           
CDGJPXHRWWE     : LHCMFOHUDQD     KCOUASNDMIRGDQM QWMJW           DHHCGLFWCPNQ    XBDIKMASGREYXVL
ISENHSSULPGI    : PLRV            KILCECQJBDM    
FJQDECIJKTCLB   : YDHHRONS        ICJXRXK         QDXNREEDL      
IXAJG           : EUWLU           PPTLTHFKEQYY    DBMWWLCVJFPN    WQXNJEORV       SJIXOAVHDJ      RKAOGC         
NUCJPWWHFGFKRVQ : OGCVTY          BGNJXHTSXXKYR   KJYLSPNPGTDMASO PITMXD          REEQR           PTPK           
XBIIUKT         : VRXC            GSCBC           NIKT            KIQKYC         
GEUGNBY         : AIEI            CMWJOPNPPTTDAC  UPPQHR          OFIGICLCQ      
XDNPCKXISDU     : FNGOWT          JVICUL          TXXNINVMFWNPX   NYXCUPVE        CQQANDJNWRXL    XBDIKMASGREYXVL
BNJBORLJEGGK    : JWLTDYUYUIUAKV  OSCIYMYILHQ     IFIXUOO         OQMY           
BSBETHF         : NIVAODGIBQYSFN  UCLAT           NPNSRVNHNMWBLT  NIUFIBOPYBH     RGPRJ           TNNJEAKFSCKEVD 
WUAJSKDX        : QXKTDPTDEFMLWM  VSEBBIGPBQ     
QYTAA           : MIDFRPIF        GLFANTPRLN      DRKKCN          CFXEXAAWRB     
UMSBUBOH        : RLFP            MXHP            ORTCPL         
HKICRNBOL       : ELIK            FLBOAKYDRVYVA   MYHOYFKYWUWBVD  QTUXOSAAJOGEND 
BENEDVWEPYHA    : IDRVMKCKPWHHGK  YXDKYAEJV       FHTDQXTQ       
VUVSVKACTNL     : RGJRKWMVPEB     JRSXMWIL        UWBCBGHOVIMTRW  DCLAUMFXJ      
HBAYMDATTGWPD   : CAFJIYXVTVYSEV  BWRKWTPL       
HCMHYIFUBDH     : FVOXIMHRNIY     CXSOXPBAL      
GDTRCBU         : AAELUGQ         DCWTQ           IRMAICMVK       NPRI           
AKHAEB          : VWONKXTCLEML    IAFCAOF         TPNFMRPUKHOH    AANFMLRHJTJKS   RGNFFADGPMV     DTLAQ          
DQLG            : USCXYGVAIATT    VBEIXV          GNJHKLKXDLTEI   RQVKODVHRNWGV  
OTINEPKISTOYWIS : AJYD            YJSUFBXSLAMOPJW SEMTSARJQF      KAAU           
JQDMBNO         : DVVROBBKOUWBG   IMIIMCIYDBEIE   UPANVTOKDN      BRBD           
