QINRJCLFPC      : QWBNOWVQNSEQH   SIHEE           HEKPLRMMP      
CGVYX           : HDMJBHRPNY      LCYPUGOXYRO     XGNBV           OFDEDQUFU       MRLL            DAFWOVABXDN     HWEUXOILTBTD   
ISQCMRVCGVIPSA  : IVMGXXYDPBFIUEF OIMNJREWIV      ICYYP           QUWRAHYXCQQHLT  KRFXURAY        GFUDLXAQXFNMB  
BOBKSORKQYOYWOY : GQGIG           FYHSLIDMQBRMSM  YVHL            WJPGCCR         XVVDCXBCNSFEQ  
WSUBFMYJUUSLPUV : OAIDICS         YQJYITI         XUKSMOTUAOCIU   YLFQKOOUHJWJKX  AMEVELONELTMP  
LYEFNY          : MYXWRXWTSSPHYUA VQTC            GPQXSBJA        LNKOEFKDLOIKE   WIKYRGUQJKT     BLHIKRBWLTMAP   PRGGQ          
HXHGWVGY        : DOIJNTN         VRFJFMRVOEOOQBO
YUXGJWPFTKSMGO  : WURAHDNQG       LJEIIIAMSPRMM   XHRXBHHARHJBJ   ELIUUS         
RQKYEJR         : UTDKCNOT        GWIXTXEVYG      WQDJW          
JYUJ            : RVHBPPUHHFV     EUVSVHRTDIWMOOC AJMKHK          MGKHCS         
DIRC            : ABGIPJI         LLPVLPJXASDBJBI TUYO            NIDLLOWSSV     
RIPQAUKLPW      : JKNTCV          BIVQ            XROYYY          QGXUOECGFJWQJT 
EDLWQLCCDRO     : YKRNFLLWQIJ     FCAGDHTCUPF     XRFOSYTODGOLGM  XXXDTCKVFXR     VGMMNPMPRV     
MXBPGUTOMEE     : TUCTJLGFS       TTQCEFOWLGE     NAFRHSVDXQO    
FBPSQNKWSX      : PLMHSOYPKJG     CXGB           
LJYOM           : TVTGHWOMQYEAKD  VGOA            BMNEUEYX        XMGE           
FQGDRXLMS       : DSFGOGIJDQPF    SBCMHUJHJAHFRKM DLYGBOWISSTIFBW IGWDAS          NREIVPATPLHGUU  VFGNODDOIJD    
YYGEGHU         : YOMUISBH        TGKEQDGYYYX     QJSKGFPRR      
AKLXF           : FYHSLIDMQBRMSM  FOCXFFKWLT      XJYACTK        
URTTIJMN        : XPHGVRHAYVVDGB  ADSRIK          USEDFFCS        XRMJVIWHICLGAM  PQYDIFUVOIIHRH  YSUJCBQJM      
SSUTEHMHJNNPUX  : RMDBUVTAIPNSYR  UKVUCG          GKJOFUBXG       UDDFRBFKMYR     SGHSEQEFFKAUNX 
VAUIXBSUUOQDXE  : UXRX            UKVUCG          UDDFRBFKMYR     JFKISAG         IUGYBHMBYDJDJFD IYMWV          
BYLVSPFHYQVNHSN : VRHN            DIKOTOH         HQCUFDALRS      NNTDXOQDWI     
ONPWOQRLLHDQ    : LVNSTHYOLAT     MWDVKKCMPHL     NRWQXAMNPJCACL  UCQSLFQIDXXY   
HJIIU           : HWKBRFYPTKAV    CUXIPGKTHBUYV   KOBGP          
CMMLMDHCKCPDTF  : OVMDBKJCKHF    
SVLLIYULPCU     : RLTT            VISUBV          TGKQLUGVUKXA    VMRXODHWKWDQLNA USMYDURAJ      
LDVRFIERUIBWUGM : CGOPVYFASYXV    RFQALGUYEPBK    OCQIQQLYMXOS    GOHGJ          
AUSSQEE         : ADXA            GEVYMOEITXTRJC  JYCSYNLWEFAFFXT RQQVRQCFF       DBHWF          
DBKUEHVRLRLSBSM : PALQXGHD        CSONAASHHNCQJS 
DQTXW           : JMSDM           AVMDXUN         SXBFTEPTVVPDNR  FJDKOSQVULAF    ECVCUTCFDIMN    IJLFFANLQVRXCFK
WWFRPWW         : MUNKMJSYEJ      UCYM           
XCXLXESTVEOKAPD : MIEFQ          
LGDH            : MTFOJTSICP      IMWDYKAWMJY     AEXIUFJQGTDSX   UURXHKQLVYBOXXN MSLNOTSTEAYVW  
ASFYXXRU        : CQSRU           PHIO            RSVDG           SKTQYTYHHC      TWDOAMABS      
OVYOHYTAV       : SGAQ            CYTMSETRW       NHFY            MGLWEYXHJXOGUMA UEVWQJD         EJALBAPOW       NRYIXISS       
HKCHAHVNPAXWCQ  : CUFPVI          KESHOSK         IGWDAS          NRWRJJNYRLFFLTK FPQYJ           HGUROBKHAFMCRGH
CQCT            : OYXR            ASOOFOASLYVK    FNKHJWWFK       KYTXOUOL       
YKIBYR          : RNYYQVHWDWTCWA  HSTMEEFHBIDFX   PVCRM          
SRXNBKPIMAFDP   : KMBUW           AOQNP           BLRNRGFJ       
BOJTTN          : NFFOJXOJWEAUDQ  HIBGXYEMRWSTMOX
VJYXVJYVBBQVC   : VQLVJFXWEKBIQNT ULBSHE          RGBTFOQ         RBLLVGOCBPMQSW  KDQHY          
WMWIAWNDO       : XANPJ           QITQWPWTUEMH    IIXQYJRCGLDYOPL XGOWXTYRVMEIP   XVXAVYMIWNSVNDT
GEGAAWKVIKTFT   : XIRJWYP         SXWUQKW         LXHXHR          QXDKVIUIVB      JLUDYAVONNQBSQT DHWCDV         
BXYRTBYQPVBPS   : GFNX            QVXCJSFRAAQTXUG NKOVNRPE        GAIQXEJKSF      OQLOIYRQW       VQFPTQDLMOYJLEC UWYXTA         
UHLDNUD         : MILG            UMLKM           SSSKNWMYIBKCWHG VPMWFWYLUOYJEL 
TQMCDIJYEMWF    : RLUDVRBCD       LYAXNBKBN       UTDKCNOT        NDQLFQHOW      
QGGKVCLOWDLGQPW : WGORQCL         JXTXKYMRMILJH   BVGSLEDQQMRAUQ  JXRY            IFQN            BXEVGBHNETERJC 
SKHLYMOIXOOL    : LBOKTKL        
TSFCYRAD        : UXAIKGAR        PWGWBMCRHKMJU   LHGSXOJOMUDWVQI
OAIDICS         : WSUBFMYJUUSLPUV MVDTFQEWJBU     NXDFPXKVOVE     VHGUKJEPR      
PNSACROQAOFQ    : EYTTCUR         IFQN            XOHBKUPQVAAUG   NHLB            DISUSVABWW     
TKSYOTSPYXGYJJK : HHCX            LYAXNBKBN       EWXTHLWNGSO     MLXNISGNUICT    CFTOPWJJAJVFOI 
EPFUIHWDVN      : TDBGKQPIPTN     KLDYAY          QNBKIPGJRJCVW  
LVWNPHJQYDLODJ  : FFYUAIOTAL      RXJRN           ADEX           
EUHOINHQIRX     : HQCUFDALRS      EJLBPQM         GAIQXEJKSF     
UWVBKTXXJHHCGNN : DLTGVL          EIEIFFVJULN     CIWI           
SYSWWCOFPXVB    : OAQECQMLN       BCERSEPBMFFCI   IQEKUIF         HXPMFB          RHXSSYI        
WINTGQE         : AUNNJBVNKRGHT   NMENM           PWGUP           MLYGC           GLTYMPRFR      
OCLXMNFADCU     : WHRMOSBM        TUKKSSJLY       BXOLBBASA      
WTCBKJRII       : MILG            GBMLXYM         RGNSDMDVVBK    
BFDQY           : RBWQIWXMBETCBHA BPAJJWTBUCYC    RTMC            BNDAOLVXPRM     QAPWTKSLHY     
HDKVHWTVMBXSGSX : WMIORWXTTAP     CQYTEFXSDAXUOLN BVJMNJXGAHLYRY  CUBLRFQNPB     
NAFXJYJTTMYYDX  : LHWWXQOPIRFIO   MRNNBBNL        NHLB           
KDWILTEJIII     : RTKSAXB         HBRCOJXLJMOR    MOKJBTRBUQMUK  
OBBTQDBRPC      : NKKAFWQB        PTTEDYCRRCMDBEN HSTMEEFHBIDFX   DSEUBKBUCCE    
JXNJXSH         : HGQWMDYLKRSMOXH JNJCQQMEQEX     NRWRJJNYRLFFLTK VVCOPVHX       
FNEPBAVKL       : JEYIRVEE        GYGIDGKOQ      
SOUWQRNTSFLXGV  : THTP            IIEUUUXNNLBHYG  RXNJT          
VFTQ            : QXDKVIUIVB      OMVRXRGSUXY     FJDKOSQVULAF   
EVCKNDNKOBQHP   : CWUXTYGUBGRBN   PKBBUTAPBMM     TWDOAMABS       FGQTMIFTBOI    
EIGUFBAQYJMXH   : NFEHF           LFHEUSHSOJGJP   FPQYJ           PCTKGE         
RYHXW           : IWNOIQQMHKHW    THMCMMJDC       JTATBASVIGAJCS  FMEYYHPIREJ     CJXMPCUTNLVHVP 
LLPYVEAMNR      : NYNHDKTOQQQP    YWSEJJSQHHWP    YBQKSBUBBMRFYYC CKWNVQLPHEWLJA 
UBHRGLRYK       : ABENSTQCGDAABYU ECMND           KBFCRCJPLQTULXM OCYTKMJJFHJJ    BDGBWNUUPLUSFRQ WIBCAKWV        UPGCJDARLRDVJM  UDLGSLTHWXX    
MILG            : UHLDNUD         WTCBKJRII       UBSOR           EVNT            DSIDMEU         IRISBPNAW      
KPDJCOUTPQARGN  : MYIFHXXLT       FNGUIVLUNNKP    MLQU            IMMMRDGE        JQRCNOLXDF     
JKNTCV          : RIPQAUKLPW      QQPJKJEH        GPCQRGE         TRDMA          
WURAHDNQG       : YUXGJWPFTKSMGO  WKJETCWIQSFWK   SFEEUNPJNWQGGIV BMOJOXN         VQPSOVHWWNRIDAX MRCJLPSJNUVDSE 
GJIKBFEQYELHUV  : PTTEDYCRRCMDBEN OLSLNTJKWVXRJK  VPMWFWYLUOYJEL  GKVDPOLALJSN    AHIOVJRVESQ    
HJMMFRJAMLK     : SKKC            BMVIWUHQ        TGCPOOMB        LJFC            DTQOIBCF       
ADXA            : AUSSQEE         LXGNUDJL        QVAWRYALYW      IKJCYGPWSR      MOIBM          
JKWKQDEPIPWFN   : FJQSLNT         BTUGLXGSR       VKOCHL          TQKAKMDS        TQVYQN          LHYTKOLNNU      JCVNMDX        
MWDBEWKGJYSBY   : RLRYSVTX        LJEIIIAMSPRMM   KGBSFXUHUYT     QFIPT           IFCBTTN        
YYIJMFVDI       : MGNSEYHH        CIWI            KDKDPXL         MRCJLPSJNUVDSE 
USRRAFJ         : GHBYOGLCJ       PFHTVUVSHVMCA  
EMOIMC          : HNFNTQRWHFC     DFVBAV         
XBKCCJBBRMNYJSJ : TXKJ            RGUJGASN        ECXYKLWNDMYEXL 
NFEHF           : EIGUFBAQYJMXH   YWYJJIHPGHH     OWLRMOOS        UYWXHENHF       UOAADXY         HQHBSGKY        BOYSDRGQ       
TUQGMB          : MYMNMLGHRPEDUW  FKJSMLJKW       BRXDLLECWIQJAP  NIDLLOWSSV     
QSVREX          : XLXPMUHTHWTLWO  VHTFFTTOJWRS    DYALKCKGFOYSJ   KIVUONA         FYKXCG         
NYWHON          : MUEQFAMH        WNJNCCHIP      
XIRJWYP         : GEGAAWKVIKTFT   PTRAARLOW       INUV            WNIFYSSLX       BKYN           
FCAAUJO         : XANPJ           TUTDPQWFOAJJNV  GEVYMOEITXTRJC  KHYJLVCMNRX    
GFPCWVASLCSSQI  : WLQJDEMTTONE    JXAES           AABYM           GTQSHQXVEBFEXD 
OQUAPUSWCWYERI  : FYITQXJMHHNH   
NPYDTYBUTMYOHPW : JBLXETMX        XWGAPYKTGAG     APCKFXYYLMNG   
GQGIG           : BOBKSORKQYOYWOY CJLL            MASX           
BFFAFL          : OAONY           JLUDYAVONNQBSQT KRFXURAY       
PFGHHL          : ERTY            CUXIPGKTHBUYV   BECAHIBGXL     
IPWCCXRM        : VTUYKOWNXEUGCN  OAONY           QKKHSBQH        FHUU            NGAVQMUPT       PXCEYQNES       KQJIWOES       
QWTHFEOIITPIBE  : RXJRN           MCGVIA         
RJJY            : VSRLQN          XWLBPGJ         RFABHN         
WBBOAERXX       : CXKJDK          PPWRXKYMWWBF    VVXRYSFKWGKHA   JQHLPH          NQTSJ           PJUUUXWK       
NODJW           : LNVNKOGFSY      JLNLWQU         JYNQGIL         LPTEYVEDTJR     AGOVQTYYTVHPLK  BOYSDRGQ        ETHVRDUTKGR    
ONTYJMHLQKFAVE  : ONFWKKUT        JNPEW           IFCBTTN         VHQMCCGBPU     
TIUI            : RYWAC           FMBTQ           DVTSVXTRB       GRPWQYRFDDP     POSKJJSGWEFDLTF
BCLYIBQOLNX     : LJEIIIAMSPRMM   RHKNOAALVFWFHP 
DRBMEKXUVFXR    : ONLGBEDGYDW     SKLXWGG         HHCQMYYJDEHRBYJ ISDSCYGBWW      LQYCT           PVXEN          
TNUQYHSD        : HLJPADVX        QCWVLGFARQAQANT VJNSEYFNDBHVBSY YKQFTVPM        WGKROGAAACHNB   SBCBQ          
TOWKDKABO       : IWTSMKCMFFSKBHX MYMQXEBC        JWEEHLJ         MKJUPI         
UPSCCQY         : EPWFSXJDIXWAFYD ILMMD           LNAV            KNJN            JMJNNOHFYYIVLE  AHQJAUVMFG     
WWQJSGGKFPFJLBX : JYLUA           PFAWDPQV        VNXBJA         
MBWOELU         : YEHGEP          QLYBNYEGVW      IGEDMRESHVKLG   ARHJASWECHMSOUC PODVHMBHM      
DNDFEDE         : MTDHBBQSOH      KIOOHXBUSJOQEAP EYUPCIU        
CWOVDWILNPUBQU  : LRFDAMFWRP      ITNCVBUJEE      BDQL            WCKDHRWQVREBP   BBSKPXGPR      
FVKUCX          : MKCUTDXJCEK     APCKFXYYLMNG   
DBDHI           : EYTTCUR         SFCMOJF        
MOPOLGMRGW      : QJRX            VGRTUQCPO       DAYPUGOYTLWKC   YPNVEUQBUL     
TMAWGUKLSWI     : INSDFGSAXLREGGD HYXEWOKRKE      OJVXGCBSHCBFC   TRDMA           NDQLFQHOW       EUGCCANBRUUAJFE LPVUNRBMXSY    
UAAXFHGRT       : OMLAXOOQTPNQJKV HROWE          
HLJPADVX        : TNUQYHSD        WFXU            GLJIUETDKSFRSWY RGBTFOQ         RFABHN          OLSLNTJKWVXRJK 
RMKOUHBJ        : GFNX            FFPPEUPW        BTWXJLWDI      
ARYUUAUAJCRGA   : EDUFNKU         FOCXFFKWLT      RNWSM           TMPWOIPHBM      UPGR            FDTHLBUQPGDNYHX
RLTT            : SVLLIYULPCU     TSGIUXVVYL      QLYBNYEGVW      OFLXPPDLJO      ADEX           
PTAKHNB         : EPWFSXJDIXWAFYD ECMEKDOTSYE     MKCHPBMFGNNF    WLFRETQTBE      QDHOEQAMIMLN    GFUDLXAQXFNMB  
UDNXFIWBDY      : OTNF            DKLEPQHUXCAOJ   PPSYCLNXLPCB    JKNQN          
FJCAPCDJQWDIPXK : JSEPFSUDDORRMM  JRRR            RAGSCGTJGNYWM  
HXBLVGATMISPNSN : KBVKFDFGMCHHNH  NMSRIPSVCEW     HFAJDSWYIST    
CQSRU           : ASFYXXRU        ROVCTBBMA       DLGSORULSXNJL   ASSOFWKJWGHNYP 
DLTGVL          : UWVBKTXXJHHCGNN PHROGSQDJE      ELRSJYTUEHB     NDQLFQHOW      
HLLHPXDV        : QSURKUSPFLV     WDQVI           SXBFTEPTVVPDNR  ARIKUQJT       
YKISCV          : AWVLCHSLX       BXLQTVJUFHPGJXO TGGWXAMLA       VOHCECWAAG      VXDES          
QQPJKJEH        : JKNTCV          SJNUCHGUYR      SSSKNWMYIBKCWHG HGQWMDYLKRSMOXH KXDWXYDWTCYMQOO SEIYNKTHPNSB    ELIUUS         
SDUQPCXDNIS     : QGGFOKDNYRRKM   VQCDYUQABTVADNK BXEVGBHNETERJC 
NRPNEXIH        : ROWO            LJBKLTH         VNBWCRW         DAFWOVABXDN     DUNRYLGK       
XANPJ           : WMWIAWNDO       FCAAUJO         QLNPS           XFGFKKX        
BPJPKOKCGMCKDK  : OGCVWSPDUCYMR   QQAAXPYTBCC     TOKBFWPVSYGRK  
SBYJQEJBNIYN    : QTDMDRUMXORYA   ASOOFOASLYVK    FRUAHNGM        DNPXCXTW        YCLUECJRYUWHPJX
OYXR            : CQCT            RACTHBK         IIKQ           
HHCX            : TKSYOTSPYXGYJJK MDKIQIFO       
EFJIPMV         : JDVTQXI         HAHJTXRHTXAOA   AHIOVJRVESQ     VXBFJVEAGKLTNQ 
HWWSNDFOQNPG    : FOCXFFKWLT      RVJEIKWMTGRNAIV XJFEHHGGPMABMFQ URKX           
GFNX            : BXYRTBYQPVBPS   RMKOUHBJ        QSRSUMELLRROHP  AFVCROPFNAIX   
WFXU            : HLJPADVX        SFEEUNPJNWQGGIV LGQWUU          VWYIPURDTOMRY  
EAINPW          : WESKKXX         SGAQ            LONJCTDCRURCAIK
PHIO            : ASFYXXRU        UMKKULCP        HQKFFFEKSV      QNWFMEFTN      
XRHO            : SMNITQNLBL      BWCMCHIKI       LHLTIYAFJNRBUN  WJAGFIXA       
WESKKXX         : EAINPW          IGRFJMTUXQ      PYUXPLGEOXA     UJHOQWCLAJNPII  WQUKDRCLF       RJHGSSXSD       MMOVNPEBPNCXIMP
VUPUQQBSCOJ     : TKTXNCQAXLW     IMMHY           OLLJ            COXJLAMRQRGCFVS
ABGIPJI         : DIRC            AFVCROPFNAIX    LJMILYRP        JAXD            VTYUQCKSYSJH   
QWTOBMBNMCXIWP  : MMWOGHEJ        GGEL           
PHHJJXUKYV      : OWLRMOOS        ARLYPLBQYTNNDV  VPWV            ACGPXTGNHDHJ    PYUXPLGEOXA     JCNHXHMFB      
JNDSWVP         : LQEKU           ILKCEP          JFUVRDOQXKXHNDX WQUKDRCLF      
MTFOJTSICP      : LGDH            HSMSONB         HUYICHISDCNCHM  WMHBIVPEKJFLLEI PJUUUXWK       
IIHR            : QCKOCFAMMSS    
SPOEOMAB        : JUSTCEJKHFWXLSI BIVQ            FGCFPGSINPMXOEG
DVYBNRQJYFT     : MDOGRQQWNJTFPAE OLUC            QMHOVJLTUPEQC   SQAGFYFLYBQXBK  DOKDNIUAVQE     DAFWOVABXDN    
XEWPE           : EETHPJSGITK     YJGEAN          TONUMTB        
AOWTHP          : UUFKMOCKSQO     GJCBPLDJVACDIL  SGHSEQEFFKAUNX  OJTKRCS         GTQSHQXVEBFEXD 
NEYNHBS         : RNXBSO          PLMHSOYPKJG     CUBLRFQNPB     
AUTRLDQSWLSBJ   : DOIJNTN         HRXESAPE        RCOMFX          AHQJAUVMFG      QAEAG          
GQLUOHEGSSKRI   : TKOOCYWYI       UHCQUQQUNVWE    AQAUNXTCLADO    NVISLW          MWLFIPHMCV     
TCAVYTOMXHH     : LWXXEBAFN      
VCYFOFV         : TNONG           QKKHSBQH        PBVOEYMMAVV     HKUDWUUKFDNMJ  
CMKI            : VRHN            MGLWEYXHJXOGUMA NEAWFACPOB     
FBGYKBUOBRP     : PFRYPAHRWUAUXWD ETTWROXADQV     ULRHAIPBMRTHLD  HBNAYAVRQFXFC  
ICVP            : BMOJOXN         WVIDNX         
QLNPS           : XANPJ           GEIM            YBYNIAUOHBMSUS 
WPFBCRKX        : MWDVKKCMPHL     KNJN            TUVL            OEAAOC         
NEVAH           : YQJYITI         ROKGWH          FFUWMYCETIBR    KBDNRPBILRWUBHF PEBH            JVIOGPMNYWKK    WRSEIBAWHOLL    MSLNOTSTEAYVW  
OIJEGR          : KHXLPAXLAXUKQ   PVCRM          
EJTXXJ          : GGSOTJQ         DAVQFTHBSF      IFCBTTN        
SMNITQNLBL      : XRHO            TNONG           SHCRTONRB       PEOQAIECNPKG    KGKTA          
PRGRYX          : RFNXITD         YKISKKEGEWUTUIE OOSSLKS        
JJNS            : MGRXTTHHA       EIEIFFVJULN     DWUY            MBFXTNCLJQBETB  WARFWVIVPCC    
YWPSUNDLIRBRL   : BGKTKDPPPUH     SINLNRLVU       DDNCGYSKFYKV    RRTS            VGGPFDISHJYMJ   RBLLVGOCBPMQSW  OGNSUVXGO       BAPJFDCVXM     
HYVUHNONF       : OVIPODJIA       UCFMYKDPYR     
OOYXFT          : XALKWVAGBHK     XOCSBWAARIOGE   EAMIMJRFXTHGVY  VRMMTBTRROTTQTW
ERTY            : PFGHHL          LRHOHMU         LAERCHNWK       XXXDTCKVFXR     BBSKPXGPR       DDNHFTUBHV     
JECRVF          : YTNABFTGI       IIXQYJRCGLDYOPL LTMUERG         JOSQGBIDLPMIQGL EEPIWFKKR      
JXSIVPRLEIQ     : XBBQDUCUEGN     ENQHRA          TRLMOUWPXFINIB  UMCPSDBDGLS     LHGSXOJOMUDWVQI BKUW           
YITWNN          : FMNUEK          TNQDHT          AAOYSPK         JNJCQQMEQEX     MWRYXNQW        SEIYNKTHPNSB    SYYLBKFLLBIK   
RHWQYGXB        : LXGNUDJL        BQVJBAHBSSVRM   CTQBBJCVTFA     VCFQLBMMSBLV    EUWJHTPKOFTMML 
VHMGHGQFXLQD    : PNVMYPLVGI      EOKPCKQKRIQ     KIPDQLNUPGTLLQI
HYURSTFJXYSUSR  : XLXPMUHTHWTLWO  INSDFGSAXLREGGD SVOLNABFFOE    
QTDMDRUMXORYA   : SBYJQEJBNIYN    PTOCXIUSJFLFLT  HVGMQYF        
EVRDSKWMRIK     : TWQKVC          MRCJLPSJNUVDSE  DHWCDV         
BGKTKDPPPUH     : YWPSUNDLIRBRL   DUSTHGDBHVKHP   NWNUKI          EMFJ           
HICBJCJNADQ     : WJAGFIXA       
PPFIXSCCBMXLRPD : VTUYKOWNXEUGCN  LOTPJSDUSJCSO   BMVIWUHQ        UFJTEQLF        UNBLFSJRO       TOKBFWPVSYGRK   WPJFWJVBCXXFXR 
KMUTU           : CLWXCTAPKYNCM   KWBLFUBTCYQ     GQMIFQ          GYGIDGKOQ      
UEBGTDJLVAB     : NGDOAAGIUJU    
KCYM            : YGESHARYUDDE    VCFQLBMMSBLV    PJUUUXWK       
ABENSTQCGDAABYU : UBHRGLRYK       LQHVUFA        
BDCGMPF         : DJODBVUORYFIJJX LONJCTDCRURCAIK OCFWXVDSVP      VNXBJA         
SJBUKP          : MBFXTNCLJQBETB  VJNSEYFNDBHVBSY GKHGMXNFLWIJGG 
KQHXL           : PEBH            WVGPV          
OQHTQJ          : JGTPFNARQWWQW   CIWI            BJGPGPWIHJWXRB  VFRFM           HAHJTXRHTXAOA   HKRMDDDJJHPUOH 
RGHUJLCWBH      : EQALVLOCEEH     JLUDYAVONNQBSQT KHYJLVCMNRX     RXFXBYVJQGRWT  
TSPRDFSNYDL     : WETNSJQVQPVW    SKOVLPAKQOKHJ  
ECDOXVXXO       : AKNWLAFIDBN     LHLTIYAFJNRBUN  RYUILUK         DQII           
FJQSLNT         : JKWKQDEPIPWFN   PCMIIFGQWALPE   PTTEDYCRRCMDBEN DUYHSMAU        LQHVUFA        
EPNVHQBDGC      : EOJOSJKPTNI     EIRCTFLNSEPS    UDGOJGMNLIYEWPG GKVDPOLALJSN   
TPMXUDYT        : SVTSNUPHNLYXKVX LRFDAMFWRP      XRSQV           PCTKGE         
WKJETCWIQSFWK   : WURAHDNQG       JHFGURADYTPQC   TVTGHWOMQYEAKD  DLRHYHBEIG     
SUMVXT          : BHHWXJP         UDDFRBFKMYR     WGKROGAAACHNB   CVNMKOYCMGFPHRC QBBOQP         
GPQU            : MIKSSWGBCIH     NVURKXPG        VEOIC          
NYNHDKTOQQQP    : LLPYVEAMNR      LADMWRGJCIA     KYXSSEMMF       JFKGNMUYMVOQCAC
JIGGUAYP        : RTKSAXB         RFNXITD         MIAOYDJTLAKTU   AJOAN           OOVAB          
VPLWXBNTPDSDN   : GAIOHIHXSTKP    FQYVVOKDL       RWOSJYKRK      
PHMGXFXYPIGV    : QJRX            QCXMSGA         TYTAKPPSNKRCPAJ
IXTXV           : AMGPQNYAWR      JXCERHDRUDBBHM  RDPEO           SUVSHACLMVW    
JSKLIEDLY       : JCVNMDX         PEBH            VIJRISXDRKKMAW  DYNLCUB        
YWYJJIHPGHH     : NFEHF           SIHEE           RNWSM          
PFTXDPYYCKT     : GEEAJ           AWVLCHSLX       TCJWSXPNSOMGKPC CFTOPWJJAJVFOI 
VCRCQRJR        : UFMLHLPAKQB     KUFIJWGXAOUNLAE IJKNLDQUUCOSTS 
KBDSJSASCP      : BLUGDNEFJHHRUAH BKWU            FMBTQ           UCYM           
HLILBJMGUH      : RACTHBK         LSTTDBHGKKGN   
SJNUCHGUYR      : QQPJKJEH        GFEMFWMNWSUCPA  OBPO            IMML            LTMUERG         DQII           
CKHWMCY         : ETBTMXWSUINDDY  LGIKCLKLDR      MRLL           
MGRXTTHHA       : JJNS            JPNVC           TXVNYBUVHHPUK  
QVXCJSFRAAQTXUG : BXYRTBYQPVBPS   NNVSATOK        RAGFKYARKPL     BKKAPBJNGTVEXS 
RTKSAXB         : KDWILTEJIII     JIGGUAYP        GVAGXE          KHJUNBVEDL      OCQXFTQEAFWB    HIMAWTBOE      
VVODF           : JCYAAF          DJODBVUORYFIJJX GGIX            IOWQPHUFJVF     VTAL            PBVLYOXEPKEBS  
IVMGXXYDPBFIUEF : ISQCMRVCGVIPSA  RILAINKGVGWFGGF VEWLP           IJWVWXDAFNEDWHP RSMHVUEHKTIEBIB
MYXWRXWTSSPHYUA : LYEFNY          LFRWTBENBYTXIK  FMBPVQQ         JLUWOIFLKDC    
QMPQNQUFUAORGV  : HRTF            UUSVBDR         UMCPSDBDGLS     BDGBWNUUPLUSFRQ JKIKJFC        
SVTSNUPHNLYXKVX : TPMXUDYT        TSGIUXVVYL      HISBVBW         BDGBWNUUPLUSFRQ DQII           
ONLGBEDGYDW     : DRBMEKXUVFXR    IFNUPNX         HITASXJYACLJGHO
MTNFRKXF        : DIVUSPABG       ISDSCYGBWW      RSEVDHI         RQYUMVBIARFTHPC ERYFAEEEGHXULVO
QPUCQUMNV       : AKNWLAFIDBN     JFUVRDOQXKXHNDX TNQDHT          FJLTXN          CFMCYQMLDY      DDNHFTUBHV     
EJVKMANUCTSVGOL : FNRKMHPJAVM     MPPETEIDOARLS   GLIPHRMONRVASH  JKJCENJB       
GVONDFFBHWV     : RMDEAOMLDKRNSGF ECXELMOUWHX     MEUIKJRHT       PTEJKXPOD      
MRGQD           : POBBDAOPLJCJP   KSRTADHPBKWQLJ  HISBVBW        
EPGTNIPIGVWSM   : SVOLNABFFOE     DOIJNTN         YJGEAN          YLRS            EUBIMEQHWS      STQMWTNG       
QBUWIBX         : GLAQXURODX      OSAFK           OJTKRCS         JLHJ           
AVPMQX          : CYTMSETRW       BKGCJBG         GWKCUWK         BLVIOFMMYWMQU   MEUIKJRHT       FXQYMXUJRLOWPA 
TCJMIEATTICSHW  : NPXVHKOKVAL     WDXUO           LVFBKCLGUNTX    EKOBBUQXDD      IOUBS           FCWKTJFTWT     
OQIJNSMNK       : BLRNRGFJ       
JCYAAF          : VVODF           ADSKUETPHHN     TVTGHWOMQYEAKD  XFAHHSRGYSR     QDYDHLMLAD      MDPIELOICUCYW  
EOJOSJKPTNI     : EPNVHQBDGC      BVJMNJXGAHLYRY  MMEUFEICIAJG   
KPPBXYOSOEF     : KWBLFUBTCYQ     JYNQGIL         CKUDFXSOILH     KIPDQLNUPGTLLQI ESHMJQPMTAH    
OHDQJK          : PCMIIFGQWALPE   QLJDM           USRQDTDVFYTHI  
NYYEUIP         : WVGEBUO         QCLR           
EDUFNKU         : ARYUUAUAJCRGA   DTPUMXR         OAONY           WJUAVF          GRPWQYRFDDP     DTQOIBCF       
KWIFLNKOERRWD   : EJNIDUJQG       GLKIPK          BCJJOBJUYIMLBS  RYIPBJTDOH      KSVTCBH         QEQWCTN        
LQEKU           : JNDSWVP         TURE            MYMQXEBC       
VMNAPKIGWDX     : HAJMW           HRHIQKEC       
CGOPVYFASYXV    : LDVRFIERUIBWUGM AENAOYGHBNE     JSWMOUOYOG      PGDKUWPPBW      IVGCR          
LOKXLNVYB       : THADPBWGDPIS    SMITR           YBQKSBUBBMRFYYC FHCRTRUQ       
ONFWKKUT        : ONTYJMHLQKFAVE  LLPVLPJXASDBJBI BIBBROKRKRO     FYFTGE          WIHBCSYE        QPGCRAWLSJNAHN 
EIFAJMDCO       : YRSSQTEL        NKOVNRPE        OYPBPNQHDULN    CIXYHMVLUS     
ASOOFOASLYVK    : CQCT            SBYJQEJBNIYN    PTRAARLOW       KHJUNBVEDL      YDLESADGOEBLNWF
JPNVC           : MGRXTTHHA       RLYGATCYNRMLRJ  KMTVOKUOCGGLKGA FGCFPGSINPMXOEG
PTRAARLOW       : XIRJWYP         ASOOFOASLYVK    UKVUCG          XJAMPOQYVSJ     LKNKKESHTP      EUWJHTPKOFTMML 
DANXQEDGEXRGT   : IXYDENEMG       RHMJXG          MATNEQMNQ      
YDTOYX          : LNFMAFQWRBWEP   PLMHSOYPKJG     CKUDFXSOILH     NUIB            TUNNWAGOSTAKVR  YBYNIAUOHBMSUS 
QSRSUMELLRROHP  : GFNX            XUAFHH          QCKOCFAMMSS     WJYX           
LVNSTHYOLAT     : ONPWOQRLLHDQ    UTDKCNOT        LERMICAO        QBSDBKAQE       DUYHSMAU       
OVIPODJIA       : HYVUHNONF       NRYIXISS        XVIAXI         
MLKHDYQVGDT     : QKGPH           ICRLBEIBUPV     EBMQ            AGGWDOMNQTQL    MBTFTDIGKJHTQ   VQQBIKONUVO    
XNCWEQWBXNWG    : NBWU            SJRO            OSDWJ           AKWHSBSIBELT    IUGYBHMBYDJDJFD
LLPVLPJXASDBJBI : DIRC            ONFWKKUT        CIJJEAFB        CPXXYES         XOXGIKCAFWDXF   VPMWFWYLUOYJEL 
UFMLHLPAKQB     : VCRCQRJR        XDADL           CCLNVXQYE      
PHEETVAHM       : VQRRSWB         QLJDM           MGSFCHNIBPY     IQEKUIF        
FMELQO          : HWKBRFYPTKAV    HUQAFWPGEA      HKLWYVA         QDGDV           VYEKKFPBFQKF   
YFKE            : QSURKUSPFLV     ASSOFWKJWGHNYP  YKITPF         
VNGNORHPQWYW    : MGMCH           UPGR            EMFJ           
UTEDGPKUUVLLLKQ : DLYGBOWISSTIFBW GLAQXURODX      DMTSSHDSOLAC   
QLTFS           : AEXIUFJQGTDSX  
VKQNDQM         : KUFIJWGXAOUNLAE OOKDWKHF        WQDJW           IQCCXVPV        CVLSCIAXAFU    
TKTXNCQAXLW     : VUPUQQBSCOJ     DOXGKIRIFXQODJ  RJOFTSERMNFLBL  LDYS           
YKWPINEC        : PYBXD           KBKRM           TAKWIO          ISJQOCRNB       IQWEIDITJI     
WLQJDEMTTONE    : GFPCWVASLCSSQI  IRDOJ           WGORQCL         WCKDHRWQVREBP   VGMMNPMPRV      XBEGLMENFU     
OTNF            : UDNXFIWBDY      UJHOQWCLAJNPII  AOQNP           LHCGBE         
LSSXRDUJLKN     : ROKGWH          RAXHFVFWRBWCFPA JXCERHDRUDBBHM  NWHKD           FFUWMYCETIBR   
GMCYVHEKBXAQELF : HQHBSGKY        ROWO            LVJARFT         CQYUMAA         BAPJFDCVXM      WMHBIVPEKJFLLEI
YKRNFLLWQIJ     : EDLWQLCCDRO     GSJNARTGOHINGI  XWGAPYKTGAG     XBEGLMENFU     
UYUDMYDKG       : TRIU            SEHTKPONNE      VIOFT           VTAL            TSOOWPNUFRWH   
VJHVBLJGJITD    : EQALVLOCEEH     WBTENASWJRIBAN  DTQOIBCF       
YQJYITI         : WSUBFMYJUUSLPUV NEVAH           WFTSYSJLQMIDPY  CSIBYC          DAVQFTHBSF      RWOSJYKRK      
RHMUVMXHUHDFOB  : HSIPDVDTIWKIAVE TIUCDUOWP       VOUXXBPYGI      SNUGQDETLHPX   
CKON            : RMDBUVTAIPNSYR  ETWMMOKHRUJLWT  XMSX            QRTRWIDFQSBEDFL
IRTKIFLSAVIR    : PAYD            JJEPBUNBVVU     ANXBMMWYMNX    
VMCKNJF         : CSUGDSDD        LVFBKCLGUNTX    MPSNXYLCYICMF  
OKMPSOCIDWSWQ   : LXHXHR         
FWQBYMJQSHFW    : EYTTCUR         WXGFQKKPJ      
SGAQ            : OVYOHYTAV       EAINPW          PWRMJFNXA       UPGR            FQQXMNJMVRLLAQ  HRVKPXGXGX     
MDOGRQQWNJTFPAE : DVYBNRQJYFT     GPPES           SCNMND          MIHNYOKJJL      IQEKUIF         BDNYUIFFK      
DDVM            : TMSWVGIHW       JWEEHLJ        
QWBNOWVQNSEQH   : QINRJCLFPC      PNVMYPLVGI      CQVTVYXFHFN     CFIDASHCA      
KXDILOCSEEWP    : CSUGDSDD        EHNNV           UNDQPGMYVGETTV 
CLWXCTAPKYNCM   : KMUTU           JDOHOFPO        IMMMRDGE       
IFNUPNX         : ONLGBEDGYDW     QDYDHLMLAD      JJKCSVGLWBY    
BMDWTJT         : RFQALGUYEPBK    YATUVRP        
RWWQWBKWSWVG    : USMYDURAJ       IJGWUOFENBMWTAV NXYUCMOFG      
KMJPCEIRCISR    : DDEJIEG         OWTR            QBBOQP          PCOFL          
PNVMYPLVGI      : VHMGHGQFXLQD    QWBNOWVQNSEQH   FWJILGVYP       VCFQLBMMSBLV   
SIRPGXR         : HMTHID          KRONKVLHGGJAO   MHVXNNXP        VJQSKAPFTAKRSB  MQIQQFPGQWRTRWQ
MBJOGRGK        : ROVCTBBMA       LHWWXQOPIRFIO  
BEORRMGQEROKAN  : XWLBPGJ         YTMERIWQSCHUMCN HIOMQTGK       
IFVPFNJRO       : NKKAFWQB        EAYRAE          MVDTFQEWJBU     OLLJ            XVVDCXBCNSFEQ  
IWNOIQQMHKHW    : RYHXW           UEQI           
ABKROKHT        : DTGA            LPVUNRBMXSY     JVIOGPMNYWKK   
NPNUDYNU        : SLLXMRHCPRMJFUC
VRHN            : BYLVSPFHYQVNHSN CMKI            DYLGVYYHO       QDBFAXFQGJA     PMLPKC          YKRNWSAMNWEF   
AGRKSBJJBMTUDGD : WWOWCHUU       
EQPTNVSBQNAK    : AGYRIKCTDXAYCVG SBWVDAHLJY      CVNMKOYCMGFPHRC SAQYFKMSEYDC    LNGGWBGUYPLBSB 
NPXVHKOKVAL     : TCJMIEATTICSHW  SGKYYYVKQUJP    WXSGEROLUTQDGPL VUEFAJOC       
THMCMMJDC       : RYHXW           KSVOH           DUIQAOELHQW     QXYFWBXXWUP     IGBMFIQCTUEU    SIQHALVXKJBM   
SXWUQKW         : GEGAAWKVIKTFT   AGYRIKCTDXAYCVG UEAKFBIWXGYB    ETFAJUGL       
HMTHID          : SIRPGXR         LJFC           
WNPWB           : SKLXWGG         DPEEJR          HCPVN           VOHCECWAAG      NJYQSESN       
SKNWWAGCCKVDHS  : OWTR            QUWRAHYXCQQHLT 
TPXBCRLMWFJK    : GAIOHIHXSTKP    JIUQQD          FWJILGVYP       BKCLKMVB       
IMWDYKAWMJY     : LGDH            BTTLCD          MNWHMWINHFGE   
TUTDPQWFOAJJNV  : FCAAUJO         PYBXD           SDLWISPYIB      QYYXOGN         CUXIPGKTHBUYV   EWGIPVTMR       QTVRQLVTTD     
THTP            : SOUWQRNTSFLXGV  MDRGL           XWLBPGJ         BYEWJAQIWFYL    HVFRL          
IOUHYXGLHGC     : RFNXITD         XGYMSXXJIRBQKKL LKQONOJ         PKBBUTAPBMM     PULX            DEBLWVIMIAHDUM 
DYGTPFBGH       : OPSBSHYA        WIEOCIUQCNTL    OTVWPGU        
RVHBPPUHHFV     : JYUJ            VOLHLASCWBQJB   KSTNUPERBBRYI   KKGPWPGAYCA     KDKDPXL         BTUDQQSCNAA     ASSOFWKJWGHNYP 
MWDVKKCMPHL     : ONPWOQRLLHDQ    WPFBCRKX        ISDSCYGBWW      FSPVUQIPYLD    
DDDFKKQ         : CQVTVYXFHFN     JSWMOUOYOG     
GADXPAHAFFDUCIQ : UEAFFGJXKSPYK   CIABTLOQGG      KAWGRHAUESEH    IPPUXWHFWD     
UUCKCPIGTLLEV   : INITBCRPOWVVW   RXJRN           KILQLXIRSQPEC   KBVJC          
GFEMFWMNWSUCPA  : SJNUCHGUYR      PRSPFBFBCWHI    JIPDRBFABGQODT  IWTSMKCMFFSKBHX QKVRTRAQGP      PBYHDI          CCYW            FHCRTRUQ       
GOFBSPF         : PLOJ            CLBNPACYVA      LBMMPWJDRGS    
XLFLYLJ         : UHPCQNJXDJ      HMOBOW          RXNJT           PTQF            AKWHSBSIBELT   
ROKGWH          : NEVAH           LSSXRDUJLKN     GGVVVWOJIGX     CVNMKOYCMGFPHRC XVKOXVMCSOKBUUX MOKJBTRBUQMUK  
MEOHGE          : BGCMLQABPYPCRU  GJCBPLDJVACDIL  TUYO            SXJCLDNCQDO    
SMYXPRPUDPJIB   : XMCXTFLGHBWHW  
TKOOCYWYI       : GQLUOHEGSSKRI   QLPC           
NMHWUNHNA       : MRTR            IXYSWFQT        NARXWEGOE       NSYAQAXJYLRYFM 
NPADLGSWQVFNIV  : XRSQV           DDNCGYSKFYKV    OVMDBKJCKHF    
KWBLFUBTCYQ     : KMUTU           KPPBXYOSOEF     SKLXWGG         NUWLRYTHK       GOJC            CQYTEFXSDAXUOLN LQHVUFA        
GGSOTJQ         : EJTXXJ          RRLTTHEM        EGCGCJPJLM      RKHXDNXFBL     
WWTTQPBE        : QKGPH           TNQDHT         
AKNWLAFIDBN     : ECDOXVXXO       QPUCQUMNV       BTUGLXGSR       YBHOFQHCUDPNOJ  KNFTFMTQFNNKEY  XCPS            RNGKOHLEEQDSDY  FBGR           
AKNWLAFIDBN     : BQIB            VIJRISXDRKKMAW 
SGKYYYVKQUJP    : NPXVHKOKVAL     VMRXODHWKWDQLNA XRTEYLLQNOWMKA  VRCSMFCK       
FIHJMK          : VMOQFBJEXRI     ETBTMXWSUINDDY  NHKRSC         
YYINBNVEPLH     : QGBFMYBWK       UKBFFTIUEEL    
RRLTTHEM        : GGSOTJQ         JDSWFDFBODE     BXLQTVJUFHPGJXO
QCWVLGFARQAQANT : TNUQYHSD        JMSDM           NNMMRYGOYXYDLHR SBAGGDK         WGSWN          
LXHXHR          : GEGAAWKVIKTFT   OKMPSOCIDWSWQ   EIEIFFVJULN     CIWI            VGDHA          
AGLVNSIUJ       : NFWWOTVAJCQVRJ  BYEWJAQIWFYL    DTGA           
THADPBWGDPIS    : LOKXLNVYB       QSNLUPBE        OOLWRDGNWDG     RYUILUK        
YEHGEP          : MBWOELU         WIBCAKWV       
WRHK            : LIYRVDEEBLWUWK  MCWJOJWYRSHJF   XHKYFWPANOU    
WDXUO           : TCJMIEATTICSHW  TXKJ            LVJARFT        
OWLRMOOS        : NFEHF           PHHJJXUKYV      SKOVLPAKQOKHJ  
ECMND           : UBHRGLRYK       ADSKUETPHHN     JXRY            VXDES          
XLXPMUHTHWTLWO  : QSVREX          HYURSTFJXYSUSR  IPKNLTALEOGC    GFCNLJ          PWFNXWEDELUOLUP
HDWUXLJOFDV     : GDVNURHLUNSJ    RRERKJRGN       TTDFTYCABJ      QBBOQP         
PLOJ            : GOFBSPF         EPWFSXJDIXWAFYD OLKWAVHRHHGDN   PJIQSDEE       
AHYNEIJLHFY     : BIXRCATGLVJFHA  RHMJXG          SYJBDYRTN       MOHWUHG         BCDQUWRUWHUQIY 
TCOAYLXLVMS     : JHFGURADYTPQC   IXYDENEMG       QGWHC          
IETWSDG         : NMENM           YNFF            IPPUXWHFWD      RNGKOHLEEQDSDY 
MIKSSWGBCIH     : GPQU            HMYRCLCI        DEHYAVSU        KPOKFUPRPNJ     LBUDCHC         CCTHPEVLIG      IQCCXVPV       
KVWJIWWGJR      : TPQBSHKJELGCT   OSAFK           XCTJSKW        
UXDRQIAOUIYPC   : WHTXMHWAEC      JPLQRLUFAKDAT   OVVUKMH         HAHJTXRHTXAOA  
YFYHM           : IMMHY           JKNNNWQ        
RLUDVRBCD       : TQMCDIJYEMWF    WLXPHGWKFSIIAUR WRIUNLUWGOGXGU  HWRKFAWEIG      IWFSCJVYG       CCYW            CTYMDNQSU      
NATRTMAUBXFDN   : IMVEKIO        
YMOAV           : BUDREQARIOS     WQKMMLCNFPVVTNS
XNPURNMUR       : WLVNFQAXRNJDN   OMVRXRGSUXY     DDNHFTUBHV     
PFULWP          : AKMYRWBQHCKH   
XMCXTFLGHBWHW   : SMYXPRPUDPJIB   JMSDM           RSDKWGPYEVPKFRU
INSDFGSAXLREGGD : TMAWGUKLSWI     HYURSTFJXYSUSR  RMDBUVTAIPNSYR  FFOGO          
HDMJBHRPNY      : CGVYX           RULCKHCXE       UMKKULCP        PWYYWS          YFJGQJ         
KIPOSDH         : QVAWRYALYW      DMMBR           GOHWP          
KQPMQ           : YJGI            QPGCRAWLSJNAHN  DEKWNJMVMYEEIF 
FWLNBMUEY       : EJNIDUJQG       FYFTGE          GPKUTDJIYSEH    EVNNONMIRIRLC   QJSKGFPRR      
GGVVVWOJIGX     : ROKGWH          SCNMND         
KFAWXR          : URJSXPWSCL      MEDADUEQAOJPPIA
PWRMJFNXA       : SGAQ            QGTXDUKWFPSK    LOTPJSDUSJCSO   WBGVKMGXM      
WGBGDYCCPLMXJOK : SAJEQJECLFYVVAA CSLD            HJCQGUOWL       LRMCCUUANAPJQ  
OIPJSHGKURPK    : GTTPVBACB       QAHWYNP         VRFJFMRVOEOOQBO
RFNXITD         : PRGRYX          JIGGUAYP        IOUHYXGLHGC    
XGYMSXXJIRBQKKL : IOUHYXGLHGC     KBVKFDFGMCHHNH  XPNDGVMH        CAGVYWCAVUD     AQRASVSUADTAKI 
SVOLNABFFOE     : HYURSTFJXYSUSR  EPGTNIPIGVWSM   WHTXMHWAEC      AGQIOEEEGDFMTT  XJPEKOPHMIQ     TYBGYIEVPWAKBX  WSDD            OQLOIYRQW      
KHXLPAXLAXUKQ   : OIJEGR          RNXBSO          QDBFAXFQGJA     HLLUGRUUI       HQKFFFEKSV     
EDKP            : XPNDGVMH       
EOKPCKQKRIQ     : VHMGHGQFXLQD    NHFY            AWCMHEIHSDWGIC  MGKHCS         
SAJEQJECLFYVVAA : WGBGDYCCPLMXJOK UQGCTSADBOWVKLM WVLLJNUIUFFXV   QYAYOWFW        WVIDNX         
KSVOH           : THMCMMJDC       UKBFFTIUEEL     WGSWN          
ELSX            : QBACQ          
LGOVYPFGIOM     : FICGPPQPL       CEUUCVPHATFOLOE EQBSEXVD        FMBUDKWFMK      TKDYXCEMOOQANWD PDAGL          
ARLYPLBQYTNNDV  : PHHJJXUKYV      BMVIWUHQ        KXXACEWRXLIM    BTOVXQLERNISNA  RXOCDCOOFJLCNLC MBYNNHCELEUSBSP
PRSPFBFBCWHI    : GFEMFWMNWSUCPA  OWQUCHI         DVTKXVCDSHP    
VXRYPFAITB      : SEHTKPONNE      SBWVDAHLJY     
SVOGY           : HAHE           
DQFXHKYOLCLS    : RNGKOHLEEQDSDY  FPFAQUG        
SRKK            : DUSTHGDBHVKHP  
DRQLLRMEPCNPPQG : XPNFUB          FJMPHREP        DEVFKR         
RPFQEQUP        : EGCGCJPJLM      AGGWDOMNQTQL    YMLRRGPI       
IIEUUUXNNLBHYG  : SOUWQRNTSFLXGV 
DTPUMXR         : EDUFNKU         XIFMBPDDUVORC   KEHXBXMYKRYJ    VOKSKKDEACTYT   QGXUOECGFJWQJT 
OYXSPSLEDVIY    : EUVSVHRTDIWMOOC SYEAQOIPV       TEBOEPGUFAQOYWK BYRBGOWDGM      GFSMBAGCKQ      QBREVEOB        QYWTTBRBSYMKLNC LQRNVJDKH      
FYHSLIDMQBRMSM  : BOBKSORKQYOYWOY AKLXF           FICGPPQPL       RMDEAOMLDKRNSGF MWBX            LHCGBE         
QGIFF           : RHMJXG          MKCHPBMFGNNF    OIEHJABFMTF    
BWCMCHIKI       : XRHO            MHDABMGNGUN     OTWYDQPTWWODYRK
QILLVWOI        : BVUUVSCOLBCCMQ 
RCDMQFEWNJCWMYB : CAPXKDFODNFU    POBBDAOPLJCJP   UXAIKGAR        CXBXYQOPHANBFVQ GEDFXBUD       
DIKOTOH         : BYLVSPFHYQVNHSN WTIC           
DSXCKIREK       : CSUGDSDD        TPPHLDAUDKKEWF  WARFWVIVPCC     HXXTIKVBCFDPUC 
RDCXAS          : NKNNYPVCC       TBXFFJXXSSBMWKC PFWNU           VEOIC           TYTAKPPSNKRCPAJ
EPWFSXJDIXWAFYD : UPSCCQY         PTAKHNB         PLOJ            QNEBGFXHC      
YHMJYTTWN       : ADSRIK          LQHVUFA        
YLYRUDJT        : YSGL            ERXAA           RTOIHFRO       
CSUGDSDD        : VMCKNJF         KXDILOCSEEWP    DSXCKIREK       MRNNBBNL        CIWI            SPUKTCBEHUCD   
FICGPPQPL       : LGOVYPFGIOM     FYHSLIDMQBRMSM  LSKLYKBHPQQ     CJXMPCUTNLVHVP 
MYMNMLGHRPEDUW  : TUQGMB          VNMKHSFCNAYKEW  GEDAPPTOCSIETW 
BASGGUNQWUH     : NLOTA           CIABTLOQGG      JPDYR           AFEKIQ         
LYAXNBKBN       : TQMCDIJYEMWF    TKSYOTSPYXGYJJK DKLEPQHUXCAOJ   BQIB            YOPJCXPOGDG    
JXSCCXWBXADQGJN : RFQALGUYEPBK    RSVDG           BVTBTUDGJRD     JJEPBUNBVVU     MUNKMJSYEJ      KPOKFUPRPNJ     PTEJKXPOD       RHXSSYI        
JXSCCXWBXADQGJN : PFHTVUVSHVMCA  
BKRKCFJC        : SYETUCNSUKIFV   WFPGRMSEJOVNML  FFYUAIOTAL      AJURJRRLMGLA    VJNSEYFNDBHVBSY XGOWXTYRVMEIP   WJPGCCR        
YGQATRMRMOV     : UNHJWKPUIIQQCKT NHRJKOCG        KHYYOTSTFYYKXH 
NWINBBVMOSNBMA  : XRVPHS          QNEBGFXHC       OJTKRCS        
TLIAKO          : QDBFAXFQGJA     QUHRQVKWMFOXPS  BXEVGBHNETERJC 
NKKAFWQB        : OBBTQDBRPC      IFVPFNJRO       BVGUOSKOAGXWW   DMTSSHDSOLAC    XBWJWTJM       
EYTTCUR         : PNSACROQAOFQ    DBDHI           FWQBYMJQSHFW    FTWUFUJOWBMCGTE WAALLS          OJVXGCBSHCBFC   MGNSEYHH        CWVWDKDXV      
LNFMAFQWRBWEP   : YDTOYX          UKUYVYVNEH      KDAOMERMOMB    
RACTHBK         : OYXR            HLILBJMGUH      KAWGRHAUESEH    FBGR            RQYUMVBIARFTHPC RXJRN          
KQKEKMBDDMQKBS  : RQVBXI          LNVNKOGFSY      KAWGRHAUESEH    CUWBLKIYGNIJ    RNQYDWRCQLTPDO  AMEVELONELTMP  
RPKSOQ          : KQGRIUJBSW      WNIFYSSLX       OLLJ            TGQHQVUUODG    
EJNIDUJQG       : KWIFLNKOERRWD   FWLNBMUEY       LTMUERG        
HQCUFDALRS      : BYLVSPFHYQVNHSN EUHOINHQIRX     UYWXHENHF       CYTMSETRW       UDGOJGMNLIYEWPG MMWOGHEJ        RGNSDMDVVBK     FAHMNCLL       
TNONG           : VCYFOFV         SMNITQNLBL      EGCGCJPJLM      NSJQJOUOO      
JUSTCEJKHFWXLSI : SPOEOMAB       
VFKYHV          : QCJHE           ABCM            BNEUWQJVIWE     XUMQEN         
AUNNJBVNKRGHT   : WINTGQE        
QGTXDUKWFPSK    : PWRMJFNXA       VTOURMRJJF      IFNBESXVUQI     LEPTOQAMEUOUA  
TRBNTV          : MVHBFUK        
JHFGURADYTPQC   : WKJETCWIQSFWK   TCOAYLXLVMS     KMBUW          
OGHBDOSX        : PYBXD           LIKPJANVDTK     FFPPEUPW        VTAL            ECCMJYSEGH     
VTUYKOWNXEUGCN  : IPWCCXRM        PPFIXSCCBMXLRPD LHWWXQOPIRFIO   MGNSEYHH       
FOCXFFKWLT      : AKLXF           ARYUUAUAJCRGA   HWWSNDFOQNPG    UCFMYKDPYR      DTQOIBCF       
QITQLRM         : UUFKMOCKSQO     LXGNUDJL        JKSO            YPNVEUQBUL      EUEMCFG        
QWUNNUTKEV      : OHHWJOI         OCRXIAXODRNSNAR
KCPPCUWMTI      : VXDHXVOMXNVOWU  XHRXBHHARHJBJ  
UBSOR           : MILG            QMHOVJLTUPEQC   KBDNRPBILRWUBHF KILQLXIRSQPEC  
GEKYEHO         : GFSMBAGCKQ      VXDHXVOMXNVOWU  QYYXOGN         FJVI           
EIEIFFVJULN     : UWVBKTXXJHHCGNN JJNS            LXHXHR          HSIPDVDTIWKIAVE BYEWJAQIWFYL    JXAES           TSOOWPNUFRWH    GCFTUTPWGLTKVV 
IAMSIJV         : YOBNCTPXOCJ     KHYYOTSTFYYKXH  LFYBMKHSD       RFMFCDSFUPSKWR 
XPHGVRHAYVVDGB  : URTTIJMN        HSNRXJTPOJEMWQ  JEPHTOIOMRWCPJV
NIKYFXMWIM      : GLKIPK          ULIUCU          PESHMIEWUXCAJL  OIEHJABFMTF     IJLFFANLQVRXCFK
DWUY            : JJNS            EYGCTKNVNDMDBW  CFMCYQMLDY      GNRRUYMRCSUSOY  KQFDAV         
UOHDMBKPCILIRO  : CVQKCSSXOHYRDQ  OTVKICWPDSDUE   MAVPOW          MOKJBTRBUQMUK  
FWHHCHTC        : STBT           
JNUGLTJGKQMYUYO : HAHE            OJTKRCS         TWLCSNIMAOAY   
KBFCRCJPLQTULXM : UBHRGLRYK       CTNLXACMJMHAEM  LHKMKLVEBDGGF   STQMWTNG       
MHDABMGNGUN     : BWCMCHIKI       MUEQFAMH        NNMMRYGOYXYDLHR VUEFAJOC       
UEAFFGJXKSPYK   : GADXPAHAFFDUCIQ HBRCOJXLJMOR    OAGRIIEWYHXR   
TXKJ            : XBKCCJBBRMNYJSJ WDXUO           MMQDOHDUDUBDC   QRTRWIDFQSBEDFL ERDOMIAFWWNK    XICYFS          HWEUXOILTBTD   
YQXYUNHKTDXWXD  : GHHYRXEXCMBH    JKNNNWQ         XHRXBHHARHJBJ   DBHWF          
FKFO            : GEDFXBUD        QLYBNYEGVW      TBUVNNVGWFD     RIQAFIMLTDBC   
SHCRTONRB       : SMNITQNLBL      PBVOEYMMAVV     SLLXMRHCPRMJFUC JFKGNMUYMVOQCAC MAVPOW         
OAONY           : BFFAFL          IPWCCXRM        EDUFNKU         NWNUKI          XMSX            SYSHD           OVVUKMH        
BIVWLWVLAS      : LRFDAMFWRP      GYLAJUECENU    
MBFXTNCLJQBETB  : JJNS            SJBUKP          SVFKYAKMKXCOBG  RILAINKGVGWFGGF IDXQTJKDLAGMK   RGBTFOQ         KSTNUPERBBRYI  
TRIU            : UYUDMYDKG       HPTY            TDBGKQPIPTN     QGWHC          
JEYIRVEE        : FNEPBAVKL       UOMMMWWXHLU     RRTBYSJYXWUWHXC BDNYUIFFK      
AUNDBNWQPKC     : KAUBBBONMN      AJOAN           MJLGAAJWGVOJXJ  UUNOKC          MWBX            SLQCHRKLQBCCX   TWLCSNIMAOAY   
NGDOAAGIUJU     : UEBGTDJLVAB     EPTECLDJCKIHIII HRXESAPE        REMMVLJNBY      IXYSWFQT        GXALONODBHHOGY  WVGPV           NKXE           
LFTJMXI         : RLRYSVTX       
UXRX            : VAUIXBSUUOQDXE  VPWV            WWTR           
OQBBT           : NWWSCNKUBYLR    VQOBLU          AOQNP          
OAQECQMLN       : SYSWWCOFPXVB    HMOBOW          XNTLIJEHN       HIKIU           XOCSBWAARIOGE  
IPKNLTALEOGC    : XLXPMUHTHWTLWO  PRXVYHVPG       RPVKVMMNVBJM    DEBLWVIMIAHDUM  IHAPCQDYS      
HNWXRARER       : NSJQJOUOO       JTPATUOHED      MRAJQEFQNKT     IOMVDDSWD      
UXWLKICJQRTHDQH : TGNNJ           VOBOKS          OLLJ            MDTJLQOTY      
UYWXHENHF       : NFEHF           HQCUFDALRS      ULIUCU          TPPHLDAUDKKEWF  QGTRX          
HWKBRFYPTKAV    : HJIIU           FMELQO         
TPQBSHKJELGCT   : KVWJIWWGJR      JJEPBUNBVVU     IFNBESXVUQI    
QDSVMRIOMONEKX  : ELRSJYTUEHB     LEPTOQAMEUOUA  
IUAXNDQWQCBCKE  : FPQYJ           HLAYSGLRMHELOMH TUYO           
XWBSUONEDA      : HTDJPKXBBFMJPFY
SEHTKPONNE      : UYUDMYDKG       VXRYPFAITB      UJLQIDFMFJ      DTGA           
GBHICKUIKVHM    : EJALBAPOW      
DDEJIEG         : KMJPCEIRCISR    SIHEE           QCHX            FTAEJMFICURF    XNUSHHJH       
INUV            : XIRJWYP         GWWIJNWUP       RRTBYSJYXWUWHXC MMEUFEICIAJG   
LJSRA           : AFVCROPFNAIX    UDDFRBFKMYR    
SKLXWGG         : DRBMEKXUVFXR    WNPWB           KWBLFUBTCYQ     FSQPL          
CQVTVYXFHFN     : QWBNOWVQNSEQH   DDDFKKQ         AJOAN           HEKPLRMMP       VNBWCRW        
PDILIW          : ISSBPHVQNFEJ    LVBMJGIJYTH     IEEDNMJ        
DOXGKIRIFXQODJ  : TKTXNCQAXLW     GGIX            INITBCRPOWVVW  
YFKYMUEAIUF     : ULIUCU          GAQFN           CLBNPACYVA      KHYXSRGMAD      YJXYPFDKCYNQ    GTQSHQXVEBFEXD 
GPPES           : MDOGRQQWNJTFPAE YRIDBR          HMNGTSEVLEXVJ   DOIDYUPWGHJPGN  NHBQ            GNRRUYMRCSUSOY  XWRJR          
CYTMSETRW       : OVYOHYTAV       AVPMQX          HQCUFDALRS      KJAS           
WHTXMHWAEC      : UXDRQIAOUIYPC   SVOLNABFFOE     IRDOJ           FFYUAIOTAL      UOMMMWWXHLU    
MYIFHXXLT       : KPDJCOUTPQARGN  DRJWPRWKWYMPREB SBAGGDK         BTUDQQSCNAA    
PUBEOFXICJFJ    : UUDHRORXVB      WNLHRNYUGARJVR 
DWOCWSGBH       : WRXAKHD         BQIB           
JNPKLB          : BIBBROKRKRO     NRWQXAMNPJCACL  XOXGIKCAFWDXF   FFOGO          
STBT            : FWHHCHTC        AJBQJWDMSSYVP  
PYBXD           : YKWPINEC        TUTDPQWFOAJJNV  OGHBDOSX        LHYTKOLNNU     
FNRKMHPJAVM     : EJVKMANUCTSVGOL QKSNVMEGGEPWCIQ RAGFKYARKPL    
EWXTHLWNGSO     : TKSYOTSPYXGYJJK OVNE            HSNRXJTPOJEMWQ 
THDUFG          : LQYCT           PVCRM           UFKWOXDQPPLLK  
NTYAGG          : VELDLDENOVO     VURRG           MEICWCNUQEAFP  
RJOFTSERMNFLBL  : TKTXNCQAXLW     VJQSKAPFTAKRSB  RSUFRIOEGBGLHO 
RNYYQVHWDWTCWA  : YKIBYR          MUNKMJSYEJ      NDQLFQHOW      
PUUECOYGINTN    : SIHEE           WAALLS          JTUUHNBXI       UUXRATXVUVED   
WYEOOFQFBXEE    : OIDLHHOJWKGOMUW LOQFYDMFW       QULLGGAV        FQSWRR          BMAMYQWBEC      IWFSCJVYG      
XJTBULXP        : NGAVQMUPT       PESHMIEWUXCAJL  MCGVIA          DBHWF          
AGQIOEEEGDFMTT  : SVOLNABFFOE     XWMOWYO         WSFHCXAPLTYRLDK SMYQXHLOE       TPME           
KBVKFDFGMCHHNH  : HXBLVGATMISPNSN XGYMSXXJIRBQKKL RXNJT           GAUNWBKYMYFD    CCTHPEVLIG     
GHHYRXEXCMBH    : YQXYUNHKTDXWXD  BXMN           
UDTGESSJ        : SBWVDAHLJY      TRDMA           JEAB           
YRIDBR          : GPPES           XFAHHSRGYSR     WRIUNLUWGOGXGU  LWXXEBAFN       XJIOQECQFTVUOGH
IQYRAYJXF       : NNTDXOQDWI     
CTKJSGOP        : MKCUTDXJCEK    
SIHEE           : QINRJCLFPC      YWYJJIHPGHH     DDEJIEG         PUUECOYGINTN    GGQFXV          QSURKUSPFLV     RQXWPNPD        PIDTAOCGHXGXD  
SIHEE           : QLJDM          
WOLXGFHYGBYFL   : PLVEQNKC        TFRXTADMKEWK    MGMCH           SEIYNKTHPNSB    GXRKMJVX        YOGONR         
MUBGGMCOB       : QYWTTBRBSYMKLNC JNJQSQ          QKKHSHAQLUIYG   RXOCDCOOFJLCNLC DMRJJVVA       
FTCMXIXWWLVD    : SINLNRLVU       GDVNURHLUNSJ    UEQI            EUEMCFG        
FCAGDHTCUPF     : EDLWQLCCDRO     UQGCTSADBOWVKLM QAHWYNP         QLPC           
XRFOSYTODGOLGM  : EDLWQLCCDRO     MHFL            WGKROGAAACHNB   LBPJIB         
SINLNRLVU       : YWPSUNDLIRBRL   FTCMXIXWWLVD    UOAADXY         EYGCTKNVNDMDBW 
QYQGGVGXCUSDQHH : HWRKFAWEIG      HROWE          
YSGL            : YLYRUDJT        CQYUMAA        
YVRML           : KTJXERSKI      
BHHWXJP         : SUMVXT          TATTCFHE        GUBTBHPHUFF    
PLMQN           : GEVYMOEITXTRJC  CYRKEUGG       
JTATBASVIGAJCS  : RYHXW           JMJNNOHFYYIVLE  MEICWCNUQEAFP  
NFWWOTVAJCQVRJ  : AGLVNSIUJ       HSIPDVDTIWKIAVE NTAYLGG         EOTYIKDUTFBGH  
DSFGOGIJDQPF    : FQGDRXLMS       QKKHSBQH        JDOHOFPO        REMMVLJNBY      TMSWVGIHW       RCSCFHFHYWEVON  NJJXTGUK       
RAXHFVFWRBWCFPA : LSSXRDUJLKN     WJUAVF          VXBFJVEAGKLTNQ 
YNDUTLJCTTHM    : MCTPOYU         YTNABFTGI       ODTJUGSS        GKUMNTJHY       YDWHWRQILBX    
NMENM           : WINTGQE         IETWSDG         WXUAUHECEYKJTV  VQBOCUF         ANXBMMWYMNX     RSIDEMFPDAOFQQD QNBKIPGJRJCVW   DQII           
VISUBV          : SVLLIYULPCU     UYMCHCKTJ       KDKDPXL         SOPWEWKTBCV     GORPMYTPIF     
FCKHDLUGIORUT   : AGYRIKCTDXAYCVG PUTEEJAOWVLN    WURKE           AOQNP           CNITGXYDHKVVHU 
QBACQ           : ELSX            RQYUMVBIARFTHPC QYBOKJUIDAKBG   UIKBBGRN        UNDQPGMYVGETTV 
GHCWDKPANM      : XWLBPGJ         MHFL            HSNRXJTPOJEMWQ  XMKAUQ          BAPJFDCVXM     
UQGCTSADBOWVKLM : SAJEQJECLFYVVAA FCAGDHTCUPF     TATTCFHE        WLXPHGWKFSIIAUR AFVCROPFNAIX    DAVQFTHBSF      VPMWFWYLUOYJEL  RIDLBMLPBDJ    
LRFDAMFWRP      : CWOVDWILNPUBQU  TPMXUDYT        BIVWLWVLAS      AEXIUFJQGTDSX   OEVWLUNALOF     FWUFCBSQPJTEIW  KJAS            VURRG          
TGCOBUUGOPGTRWR : IQEKUIF        
IFFYSWEVYTBWN   : JYLUA           PWFNXWEDELUOLUP
MIAOYDJTLAKTU   : JIGGUAYP        VXDES          
ROVCTBBMA       : CQSRU           MBJOGRGK        GERPQCHHFHESD   PALQXGHD        NSKAQRYRF       JSWMOUOYOG     
LADMWRGJCIA     : NYNHDKTOQQQP    TMPWOIPHBM      JNJCQQMEQEX     HDQHHDGVFNBO   
OLUC            : DVYBNRQJYFT     CKUDFXSOILH    
HWINOYKSS       : OTXOXJKJILWKLBO MRAJQEFQNKT     WROIE           WJUE           
VIOFT           : UYUDMYDKG       LOTPJSDUSJCSO   LNSXLAEPFGGWAW  EAMIMJRFXTHGVY 
JIPDRBFABGQODT  : GFEMFWMNWSUCPA  GSJNARTGOHINGI  WAQNOVLYI      
NQLBHKLCGCAQQF  : KMFXKRMMXSTBYV  JLNLWQU         LNAV            XFGFKKX         JOXDENGFBRDITUI BAPJFDCVXM      HXPMFB         
JOUYRMAYPD      : PWGUP           UPGR            NDOMQSUYYMVB    NIDLLOWSSV      RQQVRQCFF       BXMN            WJAGFIXA       
ITNCVBUJEE      : CWOVDWILNPUBQU  GFVGQIDB        IMDVHLYJIFJ     CPFE           
SIDUIVNQ        : PLQQRORBPXVLXU  SFCMOJF        
WFDXASABIFJS    : JLUDYAVONNQBSQT RYUILUK        
WXUAUHECEYKJTV  : NMENM          
HMNGTSEVLEXVJ   : GPPES           TBXFFJXXSSBMWKC GAIQXEJKSF      UVDTAH         
PIIPGIKNOM      : MTEQA           FHTDOFCRRQE     NCTDINXKUDU    
QXDKVIUIVB      : GEGAAWKVIKTFT   VFTQ            SBAGGDK         IHAPCQDYS      
QGBFMYBWK       : YYINBNVEPLH     BVUUVSCOLBCCMQ  EIBYGFTJSOPJEH 
HSIPDVDTIWKIAVE : RHMUVMXHUHDFOB  EIEIFFVJULN     NFWWOTVAJCQVRJ  QYXUSO         
SMITR           : LOKXLNVYB      
CUFPVI          : HKCHAHVNPAXWCQ  JNJCQQMEQEX     AEQNJQ          JOXDENGFBRDITUI YSUJCBQJM      
GEVYMOEITXTRJC  : AUSSQEE         FCAAUJO         PLMQN           OBKVOSDO        OGIMMTKOUNMSLRO
HHFAVPVPPYK     : QKVRTRAQGP      GDVNURHLUNSJ   
QGGFOKDNYRRKM   : SDUQPCXDNIS     QJRX            LHYTKOLNNU     
EGCGCJPJLM      : GGSOTJQ         RPFQEQUP        TNONG           BMVIWUHQ        MFDFGAYWDXQ     LPTEYVEDTJR     IJRPAWDGYAN    
HEPGRPYAVEPIKDH : PPSYCLNXLPCB    CHCAW           UEPMTOFUGNAL    JATGW           YCVJOOQOTUR     UPGCJDARLRDVJM 
XRSQV           : TPMXUDYT        NPADLGSWQVFNIV  UEQI            TUYO            JIHYXE         
SFEEUNPJNWQGGIV : WURAHDNQG       WFXU            ERDOMIAFWWNK    XHAHSKP        
IRMXAWEJ        : XUKSMOTUAOCIU   IJMAVKWTNDJPJLK UMLKM           IGESOPVFDKTOMSE QTVRQLVTTD      MOKJBTRBUQMUK  
CEUUCVPHATFOLOE : LGOVYPFGIOM     LCYPUGOXYRO     PFWNU           LQTBQ           BVMDIVBG        XVVDCXBCNSFEQ  
HKQPGYYALYC     : EJDONNWWNLRD    QJFQKTD        
DMNHSKE         : XBBQDUCUEGN     BEYXQSJIVCJ     ISCCLERLKAEP    WXGFQKKPJ      
HTDJPKXBBFMJPFY : XWBSUONEDA      AWVLCHSLX       LFRWTBENBYTXIK  PYUXPLGEOXA     HJTR            XFAGSUMEQ      
EAYRAE          : IFVPFNJRO       MEUIKJRHT       UKBFFTIUEEL     FMEYYHPIREJ     JAXD           
FSQPL           : SKLXWGG         NBWU            VQLVJFXWEKBIQNT XWMOWYO         FYITQXJMHHNH    OCQIQQLYMXOS   
TGKQLUGVUKXA    : SVLLIYULPCU     JCHNPQ          OMLAXOOQTPNQJKV
HSEIRJ          : RVNGSTJEPS      TQVYQN          AQRASVSUADTAKI 
SDLWISPYIB      : TUTDPQWFOAJJNV  OLKWAVHRHHGDN   BVTBTUDGJRD     HAQWGLBHFASCIR  TUYO           
FKPX            : QBTL            DIPMKOECSU      UMCVDGYMUVRH    UOOHHDRON      
KESHOSK         : HKCHAHVNPAXWCQ  NWWSCNKUBYLR    KGBSFXUHUYT     NEAWFACPOB      QPMIFCVTOMJIROW
ADSKUETPHHN     : JCYAAF          ECMND           WTIC            SFIOGVNGRA      PCOLLNOSBPU     PTEJKXPOD      
BDQL            : CWOVDWILNPUBQU  WIBCAKWV       
VSRLQN          : RJJY            OAGRIIEWYHXR    AGOVQTYYTVHPLK 
XIFMBPDDUVORC   : DTPUMXR         PLETXXEDJ       LQHVUFA        
ILSVETBUHK      : MHVXNNXP        DMKKXQEJB       QGFXKEEX       
BCERSEPBMFFCI   : SYSWWCOFPXVB    DEHYAVSU       
AGYRIKCTDXAYCVG : EQPTNVSBQNAK    SXWUQKW         FCKHDLUGIORUT   IQWEIDITJI     
QJRX            : MOPOLGMRGW      PHMGXFXYPIGV    QGGFOKDNYRRKM   OBKVOSDO        UEMBK          
MCTPOYU         : YNDUTLJCTTHM    FYITQXJMHHNH    CHXF            AMEVELONELTMP  
JGTPFNARQWWQW   : OQHTQJ          RFNVWBXJ       
UUFKMOCKSQO     : AOWTHP          QITQLRM        
GEOCAYKTQRJRKAQ : YKQFTVPM        WBSIJRXTSIC     CJXMPCUTNLVHVP 
TPGOLLY         : ECMEKDOTSYE     RJBHFAOVQUWFWG  LGIKCLKLDR      HAMGRHAYOQ      BDNYUIFFK      
CDMVTBJBHXF     : QKVRTRAQGP      YTMERIWQSCHUMCN TTQFDLNCPTIDN  
YPDQHPKT        : TCJWSXPNSOMGKPC JNJCQQMEQEX     RILEMVTYAK      MOIBM          
DCJSK           : RYVLXVHTWWJDSJO FUVAC           KMBUW          
GVAGXE          : RTKSAXB         MCIC            QVAWRYALYW      MUNKMJSYEJ     
TXYFB           : LERMICAO        NORXBQBTHRXO    RJBHFAOVQUWFWG  UAEIS           HCHN            KOBGP          
GGQFXV          : SIHEE          
ILKCEP          : JNDSWVP         YRSSQTEL        RLYBPAXGNEUV    UEMBK           RGNSDMDVVBK     ABYR           
PLQQRORBPXVLXU  : SIDUIVNQ        MCIC            UOMMMWWXHLU     EETHPJSGITK     KBKRM           LPXXBJ         
AEXIUFJQGTDSX   : LGDH            QLTFS           LRFDAMFWRP      LJMILYRP        JUALOQKBL      
LHWWXQOPIRFIO   : NAFXJYJTTMYYDX  MBJOGRGK        VTUYKOWNXEUGCN  SEIYNKTHPNSB    XROYYY          PHFUDBJ        
GLKIPK          : KWIFLNKOERRWD   NIKYFXMWIM      XONVVHDF        DOIJNTN         UUJXHXEC        NIAGI           UDLGSLTHWXX    
MSDEBWJVUSHCR   : QJFXKWABGBNRN   SVFKYAKMKXCOBG  WNLHRNYUGARJVR  PMTKPG          GOHWP          
DIVUSPABG       : MTNFRKXF        ARUSAE          YKQFTVPM        QYADECSNNT      NMMAPNCGUS     
ISEQKQ          : XRTPCEFNB       WIKYRGUQJKT     LSJB            XAULVSD         EUVIFQCT       
XJPEKOPHMIQ     : SVOLNABFFOE     SFCMOJF         HGQWMDYLKRSMOXH BKYN           
CXTNVQGL        : KKOILXOHBCHCSFJ
ISMSLSLXJYVVO   : RYYRCLCGIPOWRN  BVUUVSCOLBCCMQ 
GERPQCHHFHESD   : ROVCTBBMA       RCOMFX          VRQMRARE        GUXELYVIXINSAXS QAHWYNP         UURXHKQLVYBOXXN JLUGCC         
BOOLH           : DRJWPRWKWYMPREB WVLLJNUIUFFXV   IKSTFR          UFJTEQLF        OFLXPPDLJO     
EUVSVHRTDIWMOOC : JYUJ            OYXSPSLEDVIY    PFAWDPQV        ISJQOCRNB      
RLRYSVTX        : MWDBEWKGJYSBY   LFTJMXI         FHUU            WQKMMLCNFPVVTNS WJPGCCR         VFMWBCBHTPHAFA 
UNHJWKPUIIQQCKT : YGQATRMRMOV     RSSWX           DJKJY          
JICYL           : RCOMFX          JEGGGJAVGWS     EGKHNAJAACLJROR
SYETUCNSUKIFV   : BKRKCFJC       
RMDBUVTAIPNSYR  : SSUTEHMHJNNPUX  CKON            INSDFGSAXLREGGD CEPHNBEVYGKVTX  POSKJJSGWEFDLTF CPFE           
MEMNK           : IUPYTEJXFX      VCAF           
IMVEKIO         : NATRTMAUBXFDN   QYWTTBRBSYMKLNC KGKTA           SLQCHRKLQBCCX  
FUJRAKOVGQFWEXX : JLKSAIG        
RMDEAOMLDKRNSGF : GVONDFFBHWV     FYHSLIDMQBRMSM  AILKWJPMIXCDRG  RYIPBJTDOH      GYLAJUECENU     ANXBMMWYMNX     QGFXKEEX        UWYXTA         
EPTECLDJCKIHIII : NGDOAAGIUJU     QDHHFMKKIUOJI  
ULIUCU          : NIKYFXMWIM      UYWXHENHF       YFKYMUEAIUF     IXPIBYYG       
IHAVCHEDLTYRVKU : RPFXDSDDDLVVIG  CQYTEFXSDAXUOLN YMLRRGPI       
PFRYPAHRWUAUXWD : FBGYKBUOBRP     BIBBROKRKRO     ULRHAIPBMRTHLD  IANE            QGXUOECGFJWQJT 
GEGJNKOYEPQ     : DUIQAOELHQW     FFYUAIOTAL      FDTHLBUQPGDNYHX
BOMQTFPKHYEFTHC : TGCPOOMB        SWOESYGMECRJ    PTFDLRGPO      
GFCNLJ          : XLXPMUHTHWTLWO  OWQUCHI         OTFTN          
YTNABFTGI       : JECRVF          YNDUTLJCTTHM    RYYRCLCGIPOWRN  JKNQN           JVIOGPMNYWKK   
SYEAQOIPV       : OYXSPSLEDVIY    KGBSFXUHUYT     CXGB            LQEUEKXPIOX    
MDRGL           : THTP            USTLMAXUCBQQUH  RUCHC           XFEOWTGHQB     
JYLUA           : WWQJSGGKFPFJLBX IFFYSWEVYTBWN   AVHHBOBRDPOVTQ  CCYIHXPY        PYDH            PXCEYQNES      
OPPRVJXETTGXTYP : MUEQFAMH        NORXBQBTHRXO    QEQWCTN        
PLVEQNKC        : WOLXGFHYGBYFL   YATGUTPOCTHN    QVAWRYALYW     
TEBOEPGUFAQOYWK : OYXSPSLEDVIY    OIDLHHOJWKGOMUW QMBOVHIBLLMC    RNQYDWRCQLTPDO  QGFXKEEX       
DJODBVUORYFIJJX : BDCGMPF         VVODF           RUCHC           BTRRCWIUKYC    
NBWU            : XNCWEQWBXNWG    FSQPL           RRTS            XNTLIJEHN       YOPJCXPOGDG    
DRWG            : MFDFGAYWDXQ     RKEVGWQHKC      FCWKTJFTWT     
NHFY            : OVYOHYTAV       EOKPCKQKRIQ     SEIYNKTHPNSB   
LKQONOJ         : IOUHYXGLHGC     GWWIJNWUP       GMQDGGK         KOFWQAABQ      
HIJPT           : MSXTFJKWW       GYGIDGKOQ       ALHPDLXC       
PALQXGHD        : DBKUEHVRLRLSBSM ROVCTBBMA       XBJVR           NWHKD           CICLOCXTVUSGP   LVJARFT         CQYUMAA         FYKXCG         
GJIUQPVUBI      : HCETOOOWQCYR    FBGDXEATWLWPD  
PVDBX           : TTQFDLNCPTIDN   NXYUCMOFG       UXMGXDPAFWE     BKKAPBJNGTVEXS 
LJCIERIPII      : HISBVBW         JRRR           
SOVY            : OOKDWKHF        MWXQOXJGWHXMB   DAVQFTHBSF      NRWRJJNYRLFFLTK
ETTWROXADQV     : FBGYKBUOBRP     NSJQJOUOO       VQPSOVHWWNRIDAX VEJAXLVNLSGID   PTOCXIUSJFLFLT  SGHSEQEFFKAUNX  QTTGJFIOEIE    
TVTGHWOMQYEAKD  : LJYOM           WKJETCWIQSFWK   JCYAAF          FVETYXGF       
BYRBGOWDGM      : OYXSPSLEDVIY    DPEEJR         
HRTF            : QMPQNQUFUAORGV  UEAKFBIWXGYB    UKBFFTIUEEL    
OEVWLUNALOF     : LRFDAMFWRP      PWGUP           KMBUW           NBTVUEJBTHU     GRPWQYRFDDP    
BKGCJBG         : AVPMQX          GEDAPPTOCSIETW  NNATHAWKGYDT    HLAYSGLRMHELOMH MDPIELOICUCYW  
PDWXRB          : GPRPVIQYVTTLR   IAHJRIKFAP     
KWNLNTJKHEAIQP  : CPXXYES         KYTXOUOL        GDLGTWBIXTHF    DDNHFTUBHV     
EQALVLOCEEH     : RGHUJLCWBH      VJHVBLJGJITD    QXLNGLLOIOJ     UCFMYKDPYR      NGAVQMUPT       WTJNSTLVLOFOJB  HFOAKQAM        SXJCLDNCQDO    
EQALVLOCEEH     : KDQHY          
EAEMM           : BQVJBAHBSSVRM   UDDFRBFKMYR     FMBPVQQ         MUVYS          
CAPXKDFODNFU    : RCDMQFEWNJCWMYB XPNFUB          SYMHCCESN      
KMFXKRMMXSTBYV  : NQLBHKLCGCAQQF  HJCQGUOWL       JAXD           
LIKPJANVDTK     : OGHBDOSX        IMML            IMMHY           DMMBR          
JSEPFSUDDORRMM  : FJCAPCDJQWDIPXK OYTPBGQOXEN     AUJRHETEMXBBJ  
OLKWAVHRHHGDN   : PLOJ            SDLWISPYIB      XXXDTCKVFXR     OCRXIAXODRNSNAR
PWLID           : TYBGYIEVPWAKBX  HTCQAB          HSNRXJTPOJEMWQ 
NWWSCNKUBYLR    : OQBBT           KESHOSK         PULX            CMGTEDYQRDBYJ   VNBWCRW        
XONVVHDF        : GLKIPK          WAALLS          VXDHXVOMXNVOWU  WQDJW          
IUPYTEJXFX      : MEMNK           OTFTN           UXMGXDPAFWE    
EQBSEXVD        : LGOVYPFGIOM     MGNSEYHH        AXGP            VRQMRARE        RFNVWBXJ       
NSICIEAQKHEUD   : YWURLRMXRJE     GGIX            BLUGDNEFJHHRUAH
TYBGYIEVPWAKBX  : SVOLNABFFOE     PWLID          
HITASXJYACLJGHO : ONLGBEDGYDW     GQMIFQ          WTIC            CXSALUGD        IBKXFVU         WJUAVF         
DOIJNTN         : HXHGWVGY        AUTRLDQSWLSBJ   EPGTNIPIGVWSM   GLKIPK          PJIQSDEE        GOJC           
JNMTOMAXUVB     : NFFOJXOJWEAUDQ  HAHE            OOVAB           WEAYQCFLTW     
VMRXODHWKWDQLNA : SVLLIYULPCU     SGKYYYVKQUJP    SFCBJOSVTL      PXLODNFLQMPGGQI QAHWYNP         HBAUUPLHBRIQOQ 
HQPQECMUPOT     : CLBNPACYVA      XVKOXVMCSOKBUUX
KUFIJWGXAOUNLAE : VCRCQRJR        VKQNDQM         PUTEEJAOWVLN    QSURKUSPFLV     PFHTVUVSHVMCA  
OGCVWSPDUCYMR   : BPJPKOKCGMCKDK  DDNCGYSKFYKV    WHNJT           LFMIFYL         FYKXCG         
CEPHNBEVYGKVTX  : RMDBUVTAIPNSYR  FMBTQ          
AYNHCLEUBIRGHFA : TFIYHH          MQIQQFPGQWRTRWQ
HGTQ            : BTMSBLDOUQ      WQXYEWJSI       SJTEEDLLCFVH    EUGCCANBRUUAJFE FDTHLBUQPGDNYHX FCWKTJFTWT     
UUSVBDR         : QMPQNQUFUAORGV  QBREVEOB        IBDOPAFVP       YKQFTVPM        HVGMQYF        
EOXDEFFQ        : LCLQCTO        
ARUSAE          : DIVUSPABG       YATUVRP         PCNKKNPTJUXWY   DEVFKR         
CIJJEAFB        : LLPVLPJXASDBJBI NJRRITNFTWTQD   UKLIJ           JEAMVGNNDF      MFCAPCUEMXTFTM 
XYXEQXIIW       : GGCCHIRT        OSDWJ          
METDQTXNO       : WLNUCOYSPWXQ    WRGFGGY         NVXPVULNJRK     QNEBGFXHC       STQMWTNG       
TQDEAMK         : SXBFTEPTVVPDNR 
RNWSM           : ARYUUAUAJCRGA   YWYJJIHPGHH     RYVLXVHTWWJDSJO GPCUAJSQEIGNQWW
WEVHM           : VVXRYSFKWGKHA   XJAMPOQYVSJ     XAULVSD         PQYDIFUVOIIHRH 
SBCMHUJHJAHFRKM : FQGDRXLMS       FSAIE           DEKWNJMVMYEEIF 
YWURLRMXRJE     : NSICIEAQKHEUD   AEQNJQ          FPQYJ           IKJCYGPWSR     
QSNLUPBE        : THADPBWGDPIS    WFPGRMSEJOVNML  DLRHYHBEIG      KGKTA           GGEL            KDQHY          
KLWKSECGQWF     : TURE            GEDAPPTOCSIETW  QTLHRA         
RYCJLCEUHUN     : VPMWFWYLUOYJEL 
KAUBBBONMN      : AUNDBNWQPKC     XHKYFWPANOU    
IRDOJ           : WLQJDEMTTONE    WHTXMHWAEC      TIUCDUOWP       XFGFKKX         AEQNJQ          UKLIJ          
TATTCFHE        : BHHWXJP         UQGCTSADBOWVKLM HXBXB           QHVIIOYEY      
DLGSORULSXNJL   : CQSRU           HMOBOW          ICBWNUHG        FFOGO          
WMIORWXTTAP     : HDKVHWTVMBXSGSX NSJQJOUOO       ACVELLXOKUMEWU  UKUYVYVNEH     
EUWLF           : MLXNISGNUICT    ARLRFEEWUHQ     YDWHWRQILBX     SUIXWMRVIYB    
WLVNFQAXRNJDN   : XNPURNMUR       SUVSHACLMVW     UAEIS          
RYVLXVHTWWJDSJO : DCJSK           RNWSM           MVHBFUK         UVDTAH         
LONJCTDCRURCAIK : EAINPW          BDCGMPF         BKCLKMVB        PQYDIFUVOIIHRH  NSJKVMOWMG     
HGGHFOCENN      : KGLMUUHMMGBNUM  VCAF            IEIUVKEMJCLO   
GWWIJNWUP       : INUV            LKQONOJ         AEQNJQ          XRTPCEFNB       BAPJFDCVXM      UNNBPFBQ       
XUKSMOTUAOCIU   : WSUBFMYJUUSLPUV IRMXAWEJ        IGWDAS          NUIB            WVIDNX          DVQWJREJM      
NLOTA           : BASGGUNQWUH     RNQYDWRCQLTPDO  CBPKGHFIQWN     VEOIC           PWGWRVAOLNWLD   WXGFQKKPJ      
CIABTLOQGG      : GADXPAHAFFDUCIQ BASGGUNQWUH     JLNLWQU         XRWXEPFXLXK     YAMAIFIYOS     
HBRCOJXLJMOR    : KDWILTEJIII     UEAFFGJXKSPYK   BLGMV          
BIXRCATGLVJFHA  : AHYNEIJLHFY     VTAAU           VPWV            HMOBOW          UKBFFTIUEEL     QAHWYNP         OVLKNYPRBTEQREH
QJFXKWABGBNRN   : MSDEBWJVUSHCR   MKCHPBMFGNNF   
MAHWYYBBU       : ELRSJYTUEHB     IEEDNMJ        
MRTR            : NMHWUNHNA       JUCWCIGD       
WNRGSRS         : BUDREQARIOS     HNFUTXENO       HXXTIKVBCFDPUC  IMHFKINQW      
UUBVKVLOIMXF    : PJIQSDEE        WWOWCHUU        VPIRGPMCWFLCG  
WGORQCL         : QGGKVCLOWDLGQPW WLQJDEMTTONE    YDQJLCTRRRM     MQIQQFPGQWRTRWQ ENICHCBNELPCPY 
VNMKHSFCNAYKEW  : MYMNMLGHRPEDUW  QKKHSHAQLUIYG   HXPMFB         
AILKWJPMIXCDRG  : RMDEAOMLDKRNSGF HVFYWDMTWWOKENG WQXYEWJSI       KMFYMPYYYE      KQFDAV         
HCETOOOWQCYR    : GJIUQPVUBI      WTIC            ODMCBMENE      
DOIDYUPWGHJPGN  : GPPES           VKUTQMANWJOJV  
AVHHBOBRDPOVTQ  : JYLUA           GWKCUWK         LCYPUGOXYRO     YJGI            XDADL           SPUKTCBEHUCD   
HTCQAB          : PWLID           IJWVWXDAFNEDWHP KDAOMERMOMB    
PATXKLGAEIYO    : MWRYXNQW        DMMBR           PCOLLNOSBPU     WVGPV          
ADSRIK          : URTTIJMN        YHMJYTTWN       PBVLYOXEPKEBS   EUGCCANBRUUAJFE VGDHA          
EEARMVTFXWUO    : QWME            XCTCTSWIUWXQV  
OOKDWKHF        : VKQNDQM         SOVY            JDSWFDFBODE     RHKNOAALVFWFHP  SRNLYLTJDUNCOSQ
XWLBPGJ         : RJJY            BEORRMGQEROKAN  THTP            GHCWDKPANM      JJEPBUNBVVU     NNTDXOQDWI      MBYNNHCELEUSBSP
PNIRHWP         : MCIC            IMMHY           LKIAKMPUS      
COBWDYOT        : SAQYFKMSEYDC   
RQVBXI          : KQKEKMBDDMQKBS  BFPRG           DRJWPRWKWYMPREB QUFIO          
UTDKCNOT        : RQKYEJR         TQMCDIJYEMWF    LVNSTHYOLAT     MHVXNNXP        JYNQGIL         ABDIIGWPIBK    
WLNUCOYSPWXQ    : METDQTXNO       FMBTQ           VQRRSWB         CLQXXJKQHNUIGK 
RAHKWKIHKDBO    : PKUB           
GEEAJ           : PFTXDPYYCKT     XAIFEAWB        PJIQSDEE        MVHBFUK        
MWXQOXJGWHXMB   : SOVY            XWXLBSQNGN      JLHJ            IQCCXVPV       
VLWGVERYIIQO    : NNVSATOK        NIAGI           PSXNJCX        
UOAADXY         : NFEHF           SINLNRLVU       OPSBSHYA        EBMQ            NSLSVB         
OYHUVQSKR       : DAYPUGOYTLWKC   ERDOMIAFWWNK    JIHYXE         
GFSMBAGCKQ      : OYXSPSLEDVIY    GEKYEHO         HAMGRHAYOQ      NIDLLOWSSV      PVEJOGRTSXGA   
BFPRG           : RQVBXI          OBPO            TIUCDUOWP       XJAMPOQYVSJ    
VGRTUQCPO       : MOPOLGMRGW     
LYNHHUCTWCDBOT  : BDVFNHF        
PCMIIFGQWALPE   : FJQSLNT         OHDQJK          AAITUYKRPYPWQME YJXYPFDKCYNQ   
GAQFN           : YFKYMUEAIUF     DUSTHGDBHVKHP   SAWV            SAQYFKMSEYDC    IQWEIDITJI     
OIDLHHOJWKGOMUW : WYEOOFQFBXEE    TEBOEPGUFAQOYWK NARXWEGOE      
DDNCGYSKFYKV    : YWPSUNDLIRBRL   NPADLGSWQVFNIV  OGCVWSPDUCYMR   TFIYHH          VHGUKJEPR       SWARUSQSUCKNT  
AWVLCHSLX       : YKISCV          PFTXDPYYCKT     HTDJPKXBBFMJPFY ABDIIGWPIBK     XJYACTK        
IJMAVKWTNDJPJLK : IRMXAWEJ        VELDLDENOVO     KEHPYHEXJJURK   KBDNRPBILRWUBHF XJFEHHGGPMABMFQ
QMHOVJLTUPEQC   : DVYBNRQJYFT     UBSOR          
UMLKM           : UHLDNUD         IRMXAWEJ        SKIJKTDGIISPM   QYABFI          AOKK            KLIJ           
WKGKPPCY        : DSLOHGQH        ARLRFEEWUHQ    
PUTEEJAOWVLN    : FCKHDLUGIORUT   KUFIJWGXAOUNLAE FDUGUIHBMONNW  
CRDAEQMRDJE     : HNPY            VOBOKS          WRGFGGY         YBQKSBUBBMRFYYC
VTAAU           : BIXRCATGLVJFHA  QTEMFCBTM       XNTLIJEHN       OHHWJOI         XJYACTK         MYETKWHIV       MNATHABPEOGVO  
PRXVYHVPG       : IPKNLTALEOGC    ABDIIGWPIBK    
BTUGLXGSR       : JKWKQDEPIPWFN   AKNWLAFIDBN     SBLFQRX         IGRFJMTUXQ      DEBLWVIMIAHDUM 
MUEQFAMH        : NYWHON          MHDABMGNGUN     OPPRVJXETTGXTYP MPPETEIDOARLS   OVNE            FTAEJMFICURF    JEPHTOIOMRWCPJV
JMSDM           : DQTXW           QCWVLGFARQAQANT XMCXTFLGHBWHW  
EVNT            : MILG            TURE           
IXYDENEMG       : DANXQEDGEXRGT   TCOAYLXLVMS     EJDONNWWNLRD    LHYTKOLNNU     
HSQLLXLAHNJWIOJ : KNJN            UNDQPGMYVGETTV 
TGNNJ           : UXWLKICJQRTHDQH TMPWOIPHBM      JJKCSVGLWBY     NXOW           
LIYRVDEEBLWUWK  : WRHK            PHROGSQDJE      AHFC            PAHM            EIBYGFTJSOPJEH 
KKFB            : KJAS            PFWNU           QYBOKJUIDAKBG  
CJLL            : GQGIG           CLMKBNY         BLHIKRBWLTMAP   WPXXGSXLU      
FTWUFUJOWBMCGTE : EYTTCUR         DMRJJVVA       
QBREVEOB        : OYXSPSLEDVIY    UUSVBDR         OVNE            WIKYRGUQJKT     RVJEIKWMTGRNAIV
LFRWTBENBYTXIK  : MYXWRXWTSSPHYUA HTDJPKXBBFMJPFY KYXSSEMMF       IJSGVFMYGR      DSIDMEU         NUWLRYTHK       RIDLBMLPBDJ    
KYXSSEMMF       : NYNHDKTOQQQP    LFRWTBENBYTXIK  SIQHALVXKJBM    KDQHY          
QDJHHQUMIRGK    : DRONI           GOJC            ENICHCBNELPCPY  VRMMTBTRROTTQTW
WNASLIFHUEHP    : SKKC            IGRFJMTUXQ      BJGPGPWIHJWXRB  EULV            EAMIMJRFXTHGVY  LQEUEKXPIOX    
NDOUHHASOHK     : LRHOHMU         JECYRHXDQDN    
USEDFFCS        : URTTIJMN        IJKNLDQUUCOSTS  RXJRN           BKCLKMVB       
UHPCQNJXDJ      : XLFLYLJ         KQGRIUJBSW      KILQLXIRSQPEC  
GAIOHIHXSTKP    : VPLWXBNTPDSDN   TPXBCRLMWFJK    SCNMND          RAGSCGTJGNYWM  
RSSWX           : UNHJWKPUIIQQCKT FUVAC           GYEOKWCKGTEYJ   BFQA           
EUVTXMHHMNSA    : QSURKUSPFLV     NFFOJXOJWEAUDQ  HIIT           
SKKC            : HJMMFRJAMLK     WNASLIFHUEHP    NIAGI          
SCNMND          : MDOGRQQWNJTFPAE GGVVVWOJIGX     GAIOHIHXSTKP    LJEIIIAMSPRMM   CFIDASHCA       JCHNPQ          LUTHH           FLQVPUNPNV     
HYXEWOKRKE      : TMAWGUKLSWI     MJLGAAJWGVOJXJ  WCFGDKDQAKOXGX  SWGPIFGKBSRGTU  IVGCTOBWPYGGHXE
YOBNCTPXOCJ     : IAMSIJV         WQKMMLCNFPVVTNS GUXELYVIXINSAXS SYYLBKFLLBIK   
WETNSJQVQPVW    : TSPRDFSNYDL     IWTSMKCMFFSKBHX SKTQYTYHHC      CFMCYQMLDY      RJHGSSXSD      
KHJUNBVEDL      : RTKSAXB         ASOOFOASLYVK    NFFOJXOJWEAUDQ  TSGIUXVVYL      VFGNODDOIJD    
YBHOFQHCUDPNOJ  : AKNWLAFIDBN     DSLOHGQH        DYLGVYYHO       TRLMOUWPXFINIB 
FBHEQRLAOCDM    : LOTPJSDUSJCSO   NORXBQBTHRXO    RADQVSWFNRFGBK  IHAPCQDYS       EMFJ           
IXPIBYYG        : ULIUCU          UEAKFBIWXGYB    VKOCHL          WQKMMLCNFPVVTNS PTFDLRGPO       YSUJCBQJM      
ILMMD           : UPSCCQY         RDPEO           NSLSVB          RSMHVUEHKTIEBIB BECAHIBGXL     
BMOJOXN         : WURAHDNQG       ICVP           
QCJHE           : VFKYHV          GUBTBHPHUFF     MEDADUEQAOJPPIA
UKVUCG          : SSUTEHMHJNNPUX  VAUIXBSUUOQDXE  PTRAARLOW       WVGEBUO         HIIT            XFGFKKX        
BHFSPQFCUKGJ    : JXAES           BXEVGBHNETERJC 
PAYD            : IRTKIFLSAVIR    CSONAASHHNCQJS  LHEDLLRQVPSCV  
RFQALGUYEPBK    : LDVRFIERUIBWUGM BMDWTJT         JXSCCXWBXADQGJN PYBCRNQJMBHNT  
FRUAHNGM        : SBYJQEJBNIYN    NHRJKOCG        WIJOQAISFKODW  
QSURKUSPFLV     : HLLHPXDV        YFKE            SIHEE           KUFIJWGXAOUNLAE EUVTXMHHMNSA    PHFUDBJ        
LJEIIIAMSPRMM   : YUXGJWPFTKSMGO  MWDBEWKGJYSBY   BCLYIBQOLNX     SCNMND          QUHRQVKWMFOXPS  GKHGMXNFLWIJGG  MFCAPCUEMXTFTM 
WAALLS          : EYTTCUR         PUUECOYGINTN    XONVVHDF        XJAMPOQYVSJ     EVNNONMIRIRLC  
GMQDGGK         : LKQONOJ         WLFRETQTBE      NWKW           
EJDONNWWNLRD    : HKQPGYYALYC     IXYDENEMG       MPPETEIDOARLS   RHMJXG          EIBYGFTJSOPJEH 
HRXESAPE        : AUTRLDQSWLSBJ   NGDOAAGIUJU     RUODNVIMUEXHN  
VMIOPO          : IRISBPNAW       DUNRYLGK       
BGCMLQABPYPCRU  : MEOHGE          HQXQGPYOK       UEVWQJD         SWGPIFGKBSRGTU  KRFXURAY        FHCRTRUQ       
YNFF            : IETWSDG         DSLOHGQH        VHGUKJEPR      
GWKCUWK         : AVPMQX          AVHHBOBRDPOVTQ  DIUNPD          XHKYFWPANOU     QLRGX          
OAGRIIEWYHXR    : UEAFFGJXKSPYK   VSRLQN          UWYXTA         
PTALBBBJIJRFVTC : UDDFRBFKMYR     UAEIS          
GLJIUETDKSFRSWY : HLJPADVX        JDSWFDFBODE     KNHX            DYALKCKGFOYSJ   KDAOMERMOMB     PUAQQFSAJRKBV   JEPHTOIOMRWCPJV
SBWVDAHLJY      : EQPTNVSBQNAK    VXRYPFAITB      UDTGESSJ        GJCBPLDJVACDIL  IQYP            EDOSCTRLQJC     DQII           
FUVAC           : DCJSK           RSSWX           MAVPOW         
LMHPGK          : DUIQAOELHQW     HKLWYVA         HSHSAXXJOCAOQ  
YRSSQTEL        : EIFAJMDCO       ILKCEP          ANXBMMWYMNX    
BIBBROKRKRO     : ONFWKKUT        JNPKLB          PFRYPAHRWUAUXWD QNWFMEFTN      
RSVDG           : ASFYXXRU        JXSCCXWBXADQGJN DMKKXQEJB       FGCFPGSINPMXOEG
TMPWOIPHBM      : ARYUUAUAJCRGA   LADMWRGJCIA     TGNNJ           LGQWUU          NJJXTGUK        YOPJCXPOGDG    
NKOVNRPE        : BXYRTBYQPVBPS   EIFAJMDCO       DWPCWRRPXX      NRWRJJNYRLFFLTK PRGGQ           OTFTN          
HPTY            : TRIU            ETBTMXWSUINDDY  KBEVASMJDYAKRD  PYUXPLGEOXA     JEAMVGNNDF     
NRWQXAMNPJCACL  : ONPWOQRLLHDQ    JNPKLB          GAIQXEJKSF     
OYPBPNQHDULN    : EIFAJMDCO       IHHUVHBVU       BIJRKVV        
FMNUEK          : YITWNN          LRHOHMU         HSMSONB         LJMILYRP        LHCGBE          ODMCBMENE      
FMBUDKWFMK      : LGOVYPFGIOM     GUFD           
DLYGBOWISSTIFBW : FQGDRXLMS       UTEDGPKUUVLLLKQ SCBUATSOBXT    
VDGJ            : ENICHCBNELPCPY  NIDLLOWSSV     
TKDYXCEMOOQANWD : LGOVYPFGIOM     BFWFQYK        
WLXPHGWKFSIIAUR : RLUDVRBCD       UQGCTSADBOWVKLM AVMDXUN         TTOFDRRPLAMAAEA
FWUFCBSQPJTEIW  : LRFDAMFWRP      HJCQGUOWL      
FLHW            : BVTBTUDGJRD     HFAJDSWYIST     MWRYXNQW        FGCFPGSINPMXOEG
PWGUP           : WINTGQE         JOUYRMAYPD      OEVWLUNALOF     TUCTJLGFS       WVIDNX          CCHECXHUOAIOUI 
DRJWPRWKWYMPREB : MYIFHXXLT       BOOLH           RQVBXI          ECFRHDTN        RNQYDWRCQLTPDO  PVCRM           CRUPFGIWBG     
IMJTTUBTPS      : GUXELYVIXINSAXS
VPINVBYUQSR     : DBHWF          
SSSKNWMYIBKCWHG : UHLDNUD         QQPJKJEH        PAHM            DEVFKR         
XBJVR           : PALQXGHD        WARFWVIVPCC    
LNVNKOGFSY      : NODJW           KQKEKMBDDMQKBS  GAIQXEJKSF      CCCEO           QLPC           
NKNNYPVCC       : RDCXAS          LNKOEFKDLOIKE   QFONTEPBP       MGSFCHNIBPY     RCSCFHFHYWEVON 
YKISKKEGEWUTUIE : PRGRYX          WIHBCSYE        FMBPVQQ         GLGSPIQV        UNNBPFBQ       
QJFQKTD         : HKQPGYYALYC     LKIAKMPUS       DHCYQPCOISULGV  YXGGRLAD        KRFXURAY       
HEPFGSHHDQC     : DPEEJR          WFTSYSJLQMIDPY  UNLHYPJHFGBYBBY
DHXJ            : XWMOWYO        
SFCBJOSVTL      : VMRXODHWKWDQLNA JPLQRLUFAKDAT   MHVXNNXP       
PQIWUBEDTOMYH   : AOENQKXP        YKQUWWTUXTX     BKWU            EETHPJSGITK     MKJUPI          LRMCCUUANAPJQ   CVUU            QEQWCTN        
QMBOVHIBLLMC    : TEBOEPGUFAQOYWK TPPHLDAUDKKEWF  CFIDASHCA       XRVPHS         
IWTSMKCMFFSKBHX : TOWKDKABO       GFEMFWMNWSUCPA  WETNSJQVQPVW    TUCTJLGFS       WNIFYSSLX       TAEICNOP       
OPSBSHYA        : DYGTPFBGH       UOAADXY         NFFOJXOJWEAUDQ  RYWAC           DHYE            OUVBHG         
AOENQKXP        : PQIWUBEDTOMYH   CSLD            MNATHABPEOGVO  
TFRXTADMKEWK    : WOLXGFHYGBYFL   XWMOWYO         ROWO            GRIMXFELMTEL    VFRHFBMNYPDRL  
LCYPUGOXYRO     : CGVYX           CEUUCVPHATFOLOE AVHHBOBRDPOVTQ  KKGPWPGAYCA     PRGGQ           MCGVIA          TUNNWAGOSTAKVR 
HHPHXWB         : UKJTQ           XCTJSKW         OGNSUVXGO       CVLSCIAXAFU    
RYYRCLCGIPOWRN  : ISMSLSLXJYVVO   YTNABFTGI       VOBOKS          VGOA            TOKBFWPVSYGRK   BFYEMFPYMD      WEAYQCFLTW     
PWFNXWEDELUOLUP : XLXPMUHTHWTLWO  IFFYSWEVYTBWN   VBBDYESALWLL    OMUKSQCNB       ETBTMXWSUINDDY 
MPPETEIDOARLS   : EJVKMANUCTSVGOL MUEQFAMH        EJDONNWWNLRD    GGIX            RBWQIWXMBETCBHA LHEFGIFXYSP     GTQSHQXVEBFEXD 
CKHIXF          : ECXELMOUWHX     JPDYR           GRYGWEVTUWVSK  
CKMPHBCCQUQ     : IUSEMP          LHYTKOLNNU     
LWDP            : EQFABNM         LFYBMKHSD       NDQLFQHOW       QBSDBKAQE       YGHBF           EAMIMJRFXTHGVY  DQTNTTKSAGUGP  
GGIX            : VVODF           DOXGKIRIFXQODJ  NSICIEAQKHEUD   MPPETEIDOARLS  
DIUNPD          : GWKCUWK         WVLLJNUIUFFXV   ENQHRA         
ULRHAIPBMRTHLD  : FBGYKBUOBRP     PFRYPAHRWUAUXWD FVANTEE         GKHGMXNFLWIJGG  YFJGQJ          SYMHCCESN       TONUMTB        
IIKQ            : OYXR           
RCOMFX          : AUTRLDQSWLSBJ   GERPQCHHFHESD   JICYL           HOMTHE          PCOLLNOSBPU     VHQMCCGBPU      MIEFQ          
TPPHLDAUDKKEWF  : DSXCKIREK       UYWXHENHF       QMBOVHIBLLMC    JPLQRLUFAKDAT   ERXAA          
EQFABNM         : LWDP            AAOYSPK        
EEWVSCVDV       : ROWO            SPUKTCBEHUCD    WPXXGSXLU      
UGYXIUBSF       : ADEX           
RKHXDNXFBL      : GGSOTJQ         UYGXYLUYD       TQKAKMDS        UCFMYKDPYR      OIEHJABFMTF    
IRWELY          : KLIJ            MRCJLPSJNUVDSE 
QXLNGLLOIOJ     : EQALVLOCEEH     UPGCJDARLRDVJM 
VBBDYESALWLL    : PWFNXWEDELUOLUP GUBTBHPHUFF     TCJWSXPNSOMGKPC QLFOERUXMALWAJP LUTHH           FIOYABXUSGA    
FKJSMLJKW       : TUQGMB          CUWBLKIYGNIJ   
QKKHSBQH        : IPWCCXRM        VCYFOFV         DSFGOGIJDQPF    URKX           
TKDUQX          : QYABFI          HUHMX          
DUIQAOELHQW     : THMCMMJDC       GEGJNKOYEPQ     LMHPGK          QKGPH           VGOA            QRTRWIDFQSBEDFL
DUSTHGDBHVKHP   : BGKTKDPPPUH     SRKK            GAQFN           PPSYCLNXLPCB    VGGPFDISHJYMJ   ARIKUQJT       
MKNKI           : EVBBDJPHAKQQU   DWPCWRRPXX      PWGWBMCRHKMJU   BVRVIJT         NNATHAWKGYDT   
GQMIFQ          : KMUTU           HITASXJYACLJGHO TUNNWAGOSTAKVR 
NHRJKOCG        : YGQATRMRMOV     FRUAHNGM        VXDHXVOMXNVOWU 
KJAS            : CYTMSETRW       LRFDAMFWRP      KKFB            VGOA           
MCWJOJWYRSHJF   : WRHK            JTRBYJGOGSM     ACNUEKGPQNLT    TCJWSXPNSOMGKPC WUCPBWF        
OVNE            : EWXTHLWNGSO     MUEQFAMH        QBREVEOB        UHCQUQQUNVWE    MEDADUEQAOJPPIA UTAOMEFJT      
HNPY            : CRDAEQMRDJE     YAGDOO          VQOBLU          RNGKOHLEEQDSDY 
VXDHXVOMXNVOWU  : KCPPCUWMTI      GEKYEHO         XONVVHDF        NHRJKOCG        QFONTEPBP       FDTHLBUQPGDNYHX
RNXBSO          : NEYNHBS         KHXLPAXLAXUKQ  
OCYTKMJJFHJJ    : UBHRGLRYK       PIGBYVSHCKQ     MHVXNNXP        HOMTHE          DEKWNJMVMYEEIF  WPXXGSXLU      
JHHVIURYUOPODOP : MASX            IAKTQNDP       
FJNIIHUXTGFDRQ  : ETBTMXWSUINDDY  LCLQCTO         IJGWUOFENBMWTAV TTJWJWNFVADLTR 
BYEWJAQIWFYL    : THTP            AGLVNSIUJ       EIEIFFVJULN     HMYCTDMBQGDV    UTAOMEFJT      
NDHSOUDXE       : WCKDHRWQVREBP   RMVAACNOAPB    
XAIFEAWB        : GEEAJ           WFTSYSJLQMIDPY  IGBMFIQCTUEU    CCYW           
XFAHHSRGYSR     : JCYAAF          YRIDBR          RDKHQHKMODSLMVJ
IUSEMP          : CKMPHBCCQUQ     VQRRSWB         JKNQN           WJYX            WRSEIBAWHOLL   
MUKKW           : WHRMOSBM       
PBVOEYMMAVV     : VCYFOFV         SHCRTONRB       MASX            WNJNCCHIP      
ODTJUGSS        : YNDUTLJCTTHM    PKUB            UKNKB           WVGPV          
WFPGRMSEJOVNML  : BKRKCFJC        QSNLUPBE        CFMCYQMLDY     
LXGNUDJL        : ADXA            RHWQYGXB        QITQLRM         PVWRGP          EAMIMJRFXTHGVY  ODMCBMENE      
FUDLPVLMDDT     : DMTSSHDSOLAC    RVJEIKWMTGRNAIV HDLSBRGYNCCPDG 
POBBDAOPLJCJP   : MRGQD           RCDMQFEWNJCWMYB JEAMVGNNDF     
GUBTBHPHUFF     : BHHWXJP         QCJHE           VBBDYESALWLL    RALKJYCSQ       ICYYP          
UJLQIDFMFJ      : SEHTKPONNE      BWJQVRIHW       MASX            CCCEO          
TBXFFJXXSSBMWKC : RDCXAS          HMNGTSEVLEXVJ   RILAINKGVGWFGGF JLHJ           
GKJOFUBXG       : SSUTEHMHJNNPUX  BMVIWUHQ        SXBFTEPTVVPDNR  NMMAPNCGUS     
DSLOHGQH        : WKGKPPCY        YBHOFQHCUDPNOJ  YNFF           
VQLVJFXWEKBIQNT : VJYXVJYVBBQVC   FSQPL           UOMMMWWXHLU     DSNVQTEECHUDJQP
URJSXPWSCL      : KFAWXR          SMYQXHLOE      
KEHXBXMYKRYJ    : DTPUMXR         GGEL            LWXXEBAFN      
KMGD            : TPBPQCKC        HEDTRABWK       PODVHMBHM      
CJVTUPTNOMRA    : GTTPVBACB       LBUDCHC         TONUMTB        
CHTCKUOJ        : HNFNTQRWHFC     WIJOQAISFKODW  
IJSGVFMYGR      : LFRWTBENBYTXIK  FGQTMIFTBOI     UURXHKQLVYBOXXN TUKKSSJLY       YJXYPFDKCYNQ   
FNGUIVLUNNKP    : KPDJCOUTPQARGN  XANJPBAJOV      BXLQTVJUFHPGJXO YLRS           
GUFD            : FMBUDKWFMK      GEIM            HLAYSGLRMHELOMH CCLNVXQYE      
PKUB            : RAHKWKIHKDBO    ODTJUGSS        MLOURABSJI      ONQQEG          BNEUWQJVIWE     UNNBPFBQ       
BWJQVRIHW       : UJLQIDFMFJ      MVYIUVBV        MOIBM          
QTEMFCBTM       : VTAAU           WURKE           WROIE          
QSNWWAOJUP      : HAMGRHAYOQ     
VOBOKS          : UXWLKICJQRTHDQH CRDAEQMRDJE     RYYRCLCGIPOWRN  IFQN           
USTLMAXUCBQQUH  : MDRGL           XWMOWYO         TGKRAEVYRJQFBN  RTMC            XDADL          
KGLMUUHMMGBNUM  : HGGHFOCENN      RYWAC           CLBNPACYVA     
UHCQUQQUNVWE    : GQLUOHEGSSKRI   OVNE            BJGPGPWIHJWXRB  UDLGSLTHWXX    
TOBGUMTSKD      : BXIKWKRFQ       CVLSCIAXAFU    
YJHNHVYCFDSAV   : VEHADNVVO       GMAMTDRDNLWWGXV
UKJTQ           : HHPHXWB         ARLRFEEWUHQ     VOUXXBPYGI      YOGONR         
PFAWDPQV        : WWQJSGGKFPFJLBX EUVSVHRTDIWMOOC AKMYRWBQHCKH    FJVI            WIBCAKWV       
TDBGKQPIPTN     : EPFUIHWDVN      TRIU            GEIM            IHAPCQDYS      
MPPALCKHSJ      : YAGDOO          HCPVN           NSYAQAXJYLRYFM  UNLHYPJHFGBYBBY
BLUGDNEFJHHRUAH : KBDSJSASCP      NSICIEAQKHEUD   SCBUATSOBXT    
QBTL            : FKPX            TUNNWAGOSTAKVR  BDNYUIFFK      
JDSWFDFBODE     : RRLTTHEM        OOKDWKHF        GLJIUETDKSFRSWY ACNUEKGPQNLT    WHNJT           ODBKU          
AMGPQNYAWR      : IXTXV           ERYFAEEEGHXULVO DDHCGJOASEDTR  
XBBQDUCUEGN     : JXSIVPRLEIQ     DMNHSKE         QITQWPWTUEMH    HVISYTLBP      
NSJQJOUOO       : TNONG           HNWXRARER       ETTWROXADQV     WMIORWXTTAP     RYBYCU         
UEAKFBIWXGYB    : SXWUQKW         HRTF            IXPIBYYG        PHVAOQGSLHNJVD 
EVBBDJPHAKQQU   : MKNKI           NHLB           
OJVXGCBSHCBFC   : TMAWGUKLSWI     EYTTCUR         LBDYPCRK        WVBVVUQSOIPCFA  XVKOXVMCSOKBUUX
GEIM            : QLNPS           GUFD            TDBGKQPIPTN     GXCIK           DAFWOVABXDN     UXMGXDPAFWE    
KNFTFMTQFNNKEY  : AKNWLAFIDBN     RQXWPNPD        MFDFGAYWDXQ     QGTRX           WQXYEWJSI       SFUJN          
CFIDASHCA       : QWBNOWVQNSEQH   SCNMND          QMBOVHIBLLMC    INKGJTOHUSWOEIH
LGQWUU          : WFXU            TMPWOIPHBM     
IBDOPAFVP       : UUSVBDR         NTAYLGG         LVBMJGIJYTH     MGSFCHNIBPY     MASX           
GTTPVBACB       : OIPJSHGKURPK    CJVTUPTNOMRA    HMYRCLCI        DMTSSHDSOLAC   
JFUVRDOQXKXHNDX : JNDSWVP         QPUCQUMNV       CVNMKOYCMGFPHRC KLIJ           
FFYUAIOTAL      : LVWNPHJQYDLODJ  BKRKCFJC        WHTXMHWAEC      GEGJNKOYEPQ     XRTPCEFNB       FSPVUQIPYLD    
CPXXYES         : LLPVLPJXASDBJBI KWNLNTJKHEAIQP  LPVUNRBMXSY     OTVWPGU        
XWMOWYO         : AGQIOEEEGDFMTT  FSQPL           DHXJ            TFRXTADMKEWK    USTLMAXUCBQQUH 
MTEQA           : PIIPGIKNOM      ABCM            UKNKB          
RULCKHCXE       : HDMJBHRPNY     
NFFOJXOJWEAUDQ  : BOJTTN          JNMTOMAXUVB     EUVTXMHHMNSA    KHJUNBVEDL      OPSBSHYA        WPUKE          
SKIJKTDGIISPM   : UMLKM           CXKJDK         
WTIC            : DIKOTOH         ADSKUETPHHN     HITASXJYACLJGHO HCETOOOWQCYR    PQXLIVV         XBEGLMENFU      WVGPV          
WNAMYYSYVVRAO   : KGBSFXUHUYT     MTFQHPPXLIEUQ  
IANE            : PFRYPAHRWUAUXWD QFIPT           NNTDXOQDWI      PGDKUWPPBW     
VMOQFBJEXRI     : FIHJMK          JXCERHDRUDBBHM  CCYIHXPY        RMVAACNOAPB     GKNOQACSIA      XHAHSKP        
QXYFWBXXWUP     : THMCMMJDC       QKGPH          
LRHOHMU         : ERTY            NDOUHHASOHK     FMNUEK          MLYGC          
BLVIOFMMYWMQU   : AVPMQX          OHJTHUN         NJRRITNFTWTQD   URKX           
VTOURMRJJF      : QGTXDUKWFPSK    ODMCBMENE      
RVNGSTJEPS      : HSEIRJ          LVBMJGIJYTH     RTMC            KQFDAV         
XHKYFWPANOU     : WRHK            KAUBBBONMN      GWKCUWK         NTQTYWC         GRIMXFELMTEL   
LOQFYDMFW       : WYEOOFQFBXEE   
SFCMOJF         : DBDHI           SIDUIVNQ        XJPEKOPHMIQ     ASWSRYNXGIQDD   MSLNOTSTEAYVW  
FFPPEUPW        : RMKOUHBJ        OGHBDOSX        NIAGI           HUHMX          
DLRHYHBEIG      : WKJETCWIQSFWK   QSNLUPBE        FXQYMXUJRLOWPA  WJYX           
NDCGIFV         : PMKU            NMSRIPSVCEW     WVGEBUO         NGAVQMUPT       FAHMNCLL       
OBHVGWLMTDJQGWJ : JNJCQQMEQEX     FMEYYHPIREJ    
VQTC            : LYEFNY         
AVMDXUN         : DQTXW           WLXPHGWKFSIIAUR OCEUNROQOCO     NMXFBHJ        
QKVRTRAQGP      : GFEMFWMNWSUCPA  HHFAVPVPPYK     CDMVTBJBHXF     IJWVWXDAFNEDWHP SOPWEWKTBCV    
JYCSYNLWEFAFFXT : AUSSQEE         PTOCXIUSJFLFLT  KQFDAV         
XOXGIKCAFWDXF   : LLPVLPJXASDBJBI JNPKLB          CHCAW           SWOESYGMECRJ    KLIJ            JLKSAIG         TNAJRT         
LOTPJSDUSJCSO   : PPFIXSCCBMXLRPD PWRMJFNXA       VIOFT           FBHEQRLAOCDM    PLETXXEDJ       OAQGJWXSQOEG   
SKTQYTYHHC      : ASFYXXRU        WETNSJQVQPVW    MLQU            IPDVKTDB        EJHUUK         
OBPO            : SJNUCHGUYR      BFPRG           WVIDNX          IMDVHLYJIFJ    
KAWGRHAUESEH    : GADXPAHAFFDUCIQ RACTHBK         KQKEKMBDDMQKBS 
UQIFNBHJBOQF    : RXJRN          
HGQWMDYLKRSMOXH : JXNJXSH         QQPJKJEH        XJPEKOPHMIQ     QLJDM           NIAGI          
HUQAFWPGEA      : FMELQO          RUODNVIMUEXHN   LFYBMKHSD       BNDAOLVXPRM    
USMYDURAJ       : SVLLIYULPCU     RWWQWBKWSWVG    TUCTJLGFS       CWVWDKDXV      
BVGUOSKOAGXWW   : NKKAFWQB        NTAYLGG        
CVQKCSSXOHYRDQ  : UOHDMBKPCILIRO  ELIUUS          CCCEO          
OMUKSQCNB       : PWFNXWEDELUOLUP
PHROGSQDJE      : DLTGVL          LIYRVDEEBLWUWK  LHLTIYAFJNRBUN  QAPWTKSLHY     
FYFTGE          : ONFWKKUT        FWLNBMUEY       MLQU            WJUAVF         
LVFBKCLGUNTX    : TCJMIEATTICSHW  VMCKNJF         TQVYQN         
KHYYOTSTFYYKXH  : YGQATRMRMOV     IAMSIJV         JNJCQQMEQEX    
ELRSJYTUEHB     : DLTGVL          QDSVMRIOMONEKX  MAHWYYBBU       LFYBMKHSD       BQIB            ALHPDLXC        CVLSCIAXAFU    
XUAFHH          : QSRSUMELLRROHP  XMSX            GIYE            DYWWRUF         UAEIS          
JXCERHDRUDBBHM  : IXTXV           LSSXRDUJLKN     VMOQFBJEXRI     SLQCHRKLQBCCX   NMMAPNCGUS     
CWUXTYGUBGRBN   : EVCKNDNKOBQHP   RRLDK           GKUVLOXIEGLQHE  IJRPAWDGYAN     FSRJXDVCLTJQ    LKIAKMPUS      
KVNJXTBFY       : ABCM            GOIOYKJRQDE     FBPMOQHCO       GKNOQACSIA     
ACVELLXOKUMEWU  : WMIORWXTTAP     YKQUWWTUXTX     RAGSCGTJGNYWM   RHXSSYI        
ABUBQWNMM       : GKUVLOXIEGLQHE  NUTPJGALNRPC    NSLSVB         
KGBSFXUHUYT     : MWDBEWKGJYSBY   KESHOSK         SYEAQOIPV       WNAMYYSYVVRAO  
YKQUWWTUXTX     : PQIWUBEDTOMYH   ACVELLXOKUMEWU  UEQI            BFWFQYK        
WPUKE           : NFFOJXOJWEAUDQ  TTQCEFOWLGE     GWIXTXEVYG      XJYACTK         IMDVHLYJIFJ    
KRONKVLHGGJAO   : SIRPGXR         RHCXEWE         YDAMRIM        
MHFL            : XRFOSYTODGOLGM  GHCWDKPANM      LAERCHNWK      
YGESHARYUDDE    : KCYM            JLKSAIG         RYBYCU         
UUDHRORXVB      : PUBEOFXICJFJ    VEHADNVVO       HEPBEQRHMCBKSUY
MLOURABSJI      : PKUB            ECXELMOUWHX     OIMNJREWIV     
QKGPH           : MLKHDYQVGDT     WWTTQPBE        DUIQAOELHQW     QXYFWBXXWUP     YATGUTPOCTHN    DJKJY           UCQSLFQIDXXY   
ULBSHE          : VJYXVJYVBBQVC   OTVKICWPDSDUE   OOLWRDGNWDG     EYGCTKNVNDMDBW  MWBX            GGEL            MUSKUJXMGJ     
BVTBTUDGJRD     : JXSCCXWBXADQGJN SDLWISPYIB      FLHW            BFQA           
RFVBPMTAVLJHH   : HHCQMYYJDEHRBYJ BTTLCD          HUVRB           FVBWW           TYTAKPPSNKRCPAJ
LAERCHNWK       : ERTY            MHFL            OGIMMTKOUNMSLRO RYBYCU         
TNQDHT          : YITWNN          QPUCQUMNV       WWTTQPBE        PVGYRNGKMR     
CBFFQRASP       : SWOESYGMECRJ    BNHCYQEX       
CXSALUGD        : HITASXJYACLJGHO HAMGRHAYOQ     
OTWYDQPTWWODYRK : BWCMCHIKI       NXKKTLGQI       LBSQXISMELKXD  
LFHEUSHSOJGJP   : EIGUFBAQYJMXH   VELDLDENOVO    
JEGGGJAVGWS     : JICYL           SUVSHACLMVW     YBQKSBUBBMRFYYC
CSONAASHHNCQJS  : DBKUEHVRLRLSBSM PAYD            RALKJYCSQ       TGQHQVUUODG     TNAJRT         
RDPEO           : IXTXV           ILMMD           FSPVUQIPYLD    
KXDWXYDWTCYMQOO : QQPJKJEH        HEDTRABWK       VXBFJVEAGKLTNQ  FLOXNMLEQPOB   
HXBXB           : TATTCFHE        JVOFJUEDSNHVGR 
JTRBYJGOGSM     : MCWJOJWYRSHJF   UPGCJDARLRDVJM 
PMKU            : NDCGIFV         TWDOAMABS      
FYITQXJMHHNH    : OQUAPUSWCWYERI  FSQPL           MCTPOYU         PCOFL          
HQHBSGKY        : NFEHF           GMCYVHEKBXAQELF SBCBQ          
RRLDK           : CWUXTYGUBGRBN   HAQWGLBHFASCIR  GAIQXEJKSF     
OHJTHUN         : BLVIOFMMYWMQU   IKJCYGPWSR      ECXYKLWNDMYEXL 
UYMCHCKTJ       : VISUBV          AAOYSPK         IGNTNJC        
BMVIWUHQ        : HJMMFRJAMLK     PPFIXSCCBMXLRPD ARLYPLBQYTNNDV  EGCGCJPJLM      GKJOFUBXG       YCLUECJRYUWHPJX
TUCTJLGFS       : MXBPGUTOMEE     PWGUP           IWTSMKCMFFSKBHX USMYDURAJ       JJEPBUNBVVU     NARXWEGOE       EJALBAPOW      
SUVSHACLMVW     : IXTXV           WLVNFQAXRNJDN   JEGGGJAVGWS     OGNSUVXGO       LHGSXOJOMUDWVQI
AJMKHK          : JYUJ            NNMMRYGOYXYDLHR BOHKLBUMTEYPKAR PFHTVUVSHVMCA  
ACNUEKGPQNLT    : MCWJOJWYRSHJF   JDSWFDFBODE    
GPCQRGE         : JKNTCV          YTSUOSBFGMVI    NXOW            EUVIFQCT       
ECXELMOUWHX     : GVONDFFBHWV     CKHIXF          MLOURABSJI     
WSFHCXAPLTYRLDK : AGQIOEEEGDFMTT  FPFAQUG         BIJRKVV        
JPLQRLUFAKDAT   : UXDRQIAOUIYPC   SFCBJOSVTL      TPPHLDAUDKKEWF  OCQXFTQEAFWB    SJLBRFMLTUIH    NFVXTCLCQIKINFS
BQVJBAHBSSVRM   : RHWQYGXB        EAEMM           OGNSUVXGO      
XANJPBAJOV      : FNGUIVLUNNKP    UUNOKC          JXRY            YKRNWSAMNWEF   
PITPCUQUTAVTJAM : HMYCTDMBQGDV    BFWFQYK         JFKISAG        
VHTFFTTOJWRS    : QSVREX          TGCPOOMB        NXRYQTBMEDOJJ   RXVUMEMP       
NJCXER          : QPGCRAWLSJNAHN  TUKKSSJLY       SWARUSQSUCKNT   ODMCBMENE       NAMJTRKAGFC    
BKWU            : KBDSJSASCP      PQIWUBEDTOMYH   IGESOPVFDKTOMSE
VPWV            : PHHJJXUKYV      UXRX            BIXRCATGLVJFHA  OCQXFTQEAFWB    LUTHH          
CTLVYSRUKBSCV   : LNAV           
RHJPLBRNLOKYM   : PLTHBMCYKVDWD   FHKLQYUK       
WIHBCSYE        : ONFWKKUT        YKISKKEGEWUTUIE CYRKEUGG        UVDTAH          JSWMOUOYOG      COXJLAMRQRGCFVS
QYWTTBRBSYMKLNC : OYXSPSLEDVIY    MUBGGMCOB       IMVEKIO         LHLTIYAFJNRBUN  TQVYQN          XPNFUB         
CSLD            : WGBGDYCCPLMXJOK AOENQKXP        EYEWQXOPJT      BXOLBBASA      
OCQXFTQEAFWB    : RTKSAXB         JPLQRLUFAKDAT   VPWV            KHYSTAEJK       MATNEQMNQ      
SVFKYAKMKXCOBG  : MBFXTNCLJQBETB  MSDEBWJVUSHCR   LBOKTKL         IVBRDHAUVBXIIOF
MMQDOHDUDUBDC   : TXKJ            VCAF            YVHL            HGUROBKHAFMCRGH
FHTDOFCRRQE     : PIIPGIKNOM      MLYGC           SQAGFYFLYBQXBK  KMFYMPYYYE     
TTQCEFOWLGE     : MXBPGUTOMEE     WPUKE           OOSSLKS         QWYLVUTKDDFYU  
DKLEPQHUXCAOJ   : UDNXFIWBDY      LYAXNBKBN       UMCPSDBDGLS     YWSEJJSQHHWP   
GDVNURHLUNSJ    : HDWUXLJOFDV     FTCMXIXWWLVD    HHFAVPVPPYK     DYLGVYYHO       KGBX            AKWHSBSIBELT    HOMTHE          IHAPCQDYS      
GDVNURHLUNSJ    : FDUGUIHBMONNW  
GPQXSBJA        : LYEFNY          CKWNVQLPHEWLJA 
AJOAN           : JIGGUAYP        AUNDBNWQPKC     CQVTVYXFHFN     HKLWYVA        
RYWAC           : TIUI            OPSBSHYA        KGLMUUHMMGBNUM  QKSNVMEGGEPWCIQ
NWNUKI          : BGKTKDPPPUH     OAONY           TUNNWAGOSTAKVR 
ETWMMOKHRUJLWT  : CKON            TPHO           
AJURJRRLMGLA    : BKRKCFJC        RILEMVTYAK     
VKOCHL          : JKWKQDEPIPWFN   IXPIBYYG        MLAQP           VYCQCDDCTIEBMBL UMCVDGYMUVRH   
VCAF            : MEMNK           HGGHFOCENN      MMQDOHDUDUBDC   JGXQR          
WRIUNLUWGOGXGU  : RLUDVRBCD       YRIDBR          CSIBYC          KNJN           
MGNSEYHH        : YYIJMFVDI       EYTTCUR         VTUYKOWNXEUGCN  EQBSEXVD        QYYXOGN         CQYTEFXSDAXUOLN WMHBIVPEKJFLLEI
UYGXYLUYD       : RKHXDNXFBL      CMGTEDYQRDBYJ   NVURKXPG        PCTKGE          HIBGXYEMRWSTMOX
VQPSOVHWWNRIDAX : WURAHDNQG       ETTWROXADQV     UIIRJSOFUKWJKRH
FYFOHAPNA       : LVBMJGIJYTH     PBVLYOXEPKEBS  
CUPFBLYSEPOLM   : OOLWRDGNWDG     XPNDGVMH        KBKRM          
CHXF            : MCTPOYU         SXBFTEPTVVPDNR  CQYTEFXSDAXUOLN
WDQVI           : HLLHPXDV        NJRRITNFTWTQD   PVXEN          
GKUVLOXIEGLQHE  : CWUXTYGUBGRBN   ABUBQWNMM       UUJXHXEC       
WVLLJNUIUFFXV   : SAJEQJECLFYVVAA BOOLH           DIUNPD          AFEKIQ          TXGDRRPWNY      IYMWV          
IEJSBIGP        : PUQYAVN         BNHCYQEX       
RUODNVIMUEXHN   : HRXESAPE        HUQAFWPGEA     
CXKJDK          : WBBOAERXX       SKIJKTDGIISPM   HXXTIKVBCFDPUC 
HSMSONB         : MTFOJTSICP      FMNUEK          OJTKRCS        
EKOBBUQXDD      : TCJMIEATTICSHW  TQKAKMDS        UNLHYPJHFGBYBBY
JECYRHXDQDN     : NDOUHHASOHK     LCLQCTO         XROYYY         
MJLGAAJWGVOJXJ  : AUNDBNWQPKC     HYXEWOKRKE      DYALKCKGFOYSJ   KGBX           
XOFS            : JLNLWQU         CXBXYQOPHANBFVQ OTXOXJKJILWKLBO YJGI            UMKKULCP        NRYIXISS       
JXBEHYJXFW      : MFDFGAYWDXQ     JQHLPH          BKYN            AOLMH          
RILAINKGVGWFGGF : IVMGXXYDPBFIUEF MBFXTNCLJQBETB  TBXFFJXXSSBMWKC DMKKXQEJB      
WLAWW           : CTNLXACMJMHAEM  EQNCCPVEQGTFA   XPNDGVMH        ISSBPHVQNFEJ    KIOOHXBUSJOQEAP CHGGBGQIPJHWNI  XJFEHHGGPMABMFQ DEVFKR         
XBHAKF          : RDFTSKTHX       EAMIMJRFXTHGVY 
KHYSTAEJK       : OCQXFTQEAFWB   
GSJNARTGOHINGI  : YKRNFLLWQIJ     JIPDRBFABGQODT  TFIYHH          MITUSHNOSUHSP  
IPPUXWHFWD      : GADXPAHAFFDUCIQ IETWSDG         SJLBRFMLTUIH    IAKTQNDP       
WHNJT           : OGCVWSPDUCYMR   JDSWFDFBODE    
CDHEWDN         : GKDVWA          QHPPTDMOCKFGNGD IGRFJMTUXQ      LSJB           
MVDTFQEWJBU     : OAIDICS         IFVPFNJRO       MVYIUVBV        NQTSJ          
JDFMECVRNPNQUX  : ENICHCBNELPCPY 
RDKHQHKMODSLMVJ : XFAHHSRGYSR     MNWHMWINHFGE   
FMBTQ           : TIUI            KBDSJSASCP      CEPHNBEVYGKVTX  WLNUCOYSPWXQ    VKUTQMANWJOJV  
PLTHBMCYKVDWD   : RHJPLBRNLOKYM   OTVKICWPDSDUE   TQBGPAFXL       LJBKLTH         OWQUCHI         RADQVSWFNRFGBK 
GPKUTDJIYSEH    : FWLNBMUEY       RCSCFHFHYWEVON 
IDXQTJKDLAGMK   : MBFXTNCLJQBETB  CFTOPWJJAJVFOI 
RHKNOAALVFWFHP  : BCLYIBQOLNX     OOKDWKHF        HNFNTQRWHFC     YLFQKOOUHJWJKX 
OWTR            : KMJPCEIRCISR    SKNWWAGCCKVDHS  JMJNNOHFYYIVLE  YSUJCBQJM      
KNHX            : GLJIUETDKSFRSWY XJAMPOQYVSJ     OGNSUVXGO       XVVDCXBCNSFEQ   NFVXTCLCQIKINFS
UXAIKGAR        : TSFCYRAD        RCDMQFEWNJCWMYB UOMMMWWXHLU     KIGIUDLPNWILQD  MNATHABPEOGVO  
QITQWPWTUEMH    : WMWIAWNDO       XBBQDUCUEGN     PJIQSDEE        XPNFUB          GORPMYTPIF      LPXXBJ          FHKLQYUK       
JDOHOFPO        : CLWXCTAPKYNCM   DSFGOGIJDQPF    ATPLXHWYMFCJ   
KMBUW           : SRXNBKPIMAFDP   JHFGURADYTPQC   DCJSK           OEVWLUNALOF     OMLAXOOQTPNQJKV NTIVTSLOTLHAHCT EUGCCANBRUUAJFE JMJNNOHFYYIVLE 
VQBOCUF         : NMENM           QPMIFCVTOMJIROW HSHSAXXJOCAOQ  
MEUIKJRHT       : GVONDFFBHWV     AVPMQX          EAYRAE         
YDLESADGOEBLNWF : ASOOFOASLYVK    TGKRAEVYRJQFBN 
LHLTIYAFJNRBUN  : XRHO            ECDOXVXXO       PHROGSQDJE      QYWTTBRBSYMKLNC QYAYOWFW        CUBLRFQNPB     
TQKAKMDS        : JKWKQDEPIPWFN   RKHXDNXFBL      EKOBBUQXDD      FPFAQUG         ISCCLERLKAEP    VRMMTBTRROTTQTW FLQVPUNPNV     
JTPATUOHED      : HNWXRARER       PWGWBMCRHKMJU  
OCEUNROQOCO     : AVMDXUN         WARFWVIVPCC     MKCUTDXJCEK    
SBLFQRX         : BTUGLXGSR       TWDOAMABS       HDLSBRGYNCCPDG 
DSIDMEU         : MILG            LFRWTBENBYTXIK  HGQBBKB         RIQAFIMLTDBC   
KXXACEWRXLIM    : ARLYPLBQYTNNDV  NVXPVULNJRK     TXVNYBUVHHPUK  
YAGDOO          : HNPY            MPPALCKHSJ     
IMML            : SJNUCHGUYR      LIKPJANVDTK     PJIQSDEE        HAQWGLBHFASCIR  IJGWUOFENBMWTAV
WRTDOQO         : MWBX            JWEEHLJ         BIEWQOLTMWTD    PTQF           
OOSSLKS         : PRGRYX          TTQCEFOWLGE     UFJTEQLF       
UHKTISYWHSHW    : UQCXY           UUJXHXEC        DNNCHXUUH      
UCFMYKDPYR      : HYVUHNONF       FOCXFFKWLT      EQALVLOCEEH     RKHXDNXFBL      RKEVGWQHKC      SAQYFKMSEYDC   
PKBBUTAPBMM     : EVCKNDNKOBQHP   IOUHYXGLHGC     RLYBPAXGNEUV    YCVJOOQOTUR     OTFTN          
GLIPHRMONRVASH  : EJVKMANUCTSVGOL MVHBFUK         TTOFDRRPLAMAAEA SUAADUSQYOPWSSH
IIXQYJRCGLDYOPL : WMWIAWNDO       JECRVF          JLKSAIG        
XYLQGEFXRYVTR   : TOKBFWPVSYGRK   IVGCR           CWVWDKDXV      
AAOYSPK         : YITWNN          EQFABNM         UYMCHCKTJ       FSKYE           PRGGQ           XFAGSUMEQ       GOHGJ          
RQXWPNPD        : SIHEE           KNFTFMTQFNNKEY  MUSKUJXMGJ     
PDAGL           : LGOVYPFGIOM     WUCPBWF         XWRJR           TSOOWPNUFRWH   
MLXNISGNUICT    : TKSYOTSPYXGYJJK EUWLF           FSPVUQIPYLD    
REMMVLJNBY      : NGDOAAGIUJU     DSFGOGIJDQPF    LJMILYRP        ICYYP           XMGE            VTYUQCKSYSJH   
PPWRXKYMWWBF    : WBBOAERXX       XALKWVAGBHK     CQYTEFXSDAXUOLN
HSNRXJTPOJEMWQ  : XPHGVRHAYVVDGB  EWXTHLWNGSO     GHCWDKPANM      PWLID           WUCPBWF        
XRVPHS          : NWINBBVMOSNBMA  QMBOVHIBLLMC    HNFUTXENO      
IEGWDGXI        : NGKTMXOLKI     
HBNAYAVRQFXFC   : FBGYKBUOBRP     RPFXDSDDDLVVIG  WVGEBUO         SIEQAU          NJRRITNFTWTQD   HUHMX          
HAHE            : SVOGY           JNUGLTJGKQMYUYO JNMTOMAXUVB     YDQJLCTRRRM     PEOQAIECNPKG    VRQMRARE        HMYCTDMBQGDV    JQRCNOLXDF     
QYABFI          : UMLKM           TKDUQX          NTQTYWC         RBWQIWXMBETCBHA KOBGP           OAQGJWXSQOEG   
IOWQPHUFJVF     : VVODF           RTTHMTTOBL      UDLGSLTHWXX    
PXLODNFLQMPGGQI : VMRXODHWKWDQLNA NJRRITNFTWTQD   KSVTCBH         OTVWPGU        
WRGFGGY         : METDQTXNO       CRDAEQMRDJE     IFNBESXVUQI    
PVGYRNGKMR      : TNQDHT          LBPJIB         
PIGBYVSHCKQ     : OCYTKMJJFHJJ    HUYICHISDCNCHM 
JIUQQD          : TPXBCRLMWFJK    LHEDLLRQVPSCV  
PULX            : IOUHYXGLHGC     NWWSCNKUBYLR    VTAL           
GLAQXURODX      : QBUWIBX         UTEDGPKUUVLLLKQ KHYJLVCMNRX    
CTNLXACMJMHAEM  : KBFCRCJPLQTULXM WLAWW           TQBGPAFXL       HFRUHJRKPVKTT  
VHGT            : LERMICAO        XOCSBWAARIOGE   WEAYQCFLTW      LBMMPWJDRGS    
MFDFGAYWDXQ     : EGCGCJPJLM      DRWG            KNFTFMTQFNNKEY  JXBEHYJXFW      HUVRB           QTTGJFIOEIE     BKKAPBJNGTVEXS 
TETUGXHP        : PDSRUUD         XVKOXVMCSOKBUUX
QSRDNNK         : INITBCRPOWVVW   LDYS            NRWOXXD        
JNJQSQ          : MUBGGMCOB      
TQVYQN          : JKWKQDEPIPWFN   HSEIRJ          LVFBKCLGUNTX    QYWTTBRBSYMKLNC
MTDHBBQSOH      : DNDFEDE         YOMUISBH       
GKDVWA          : CDHEWDN         NUTPJGALNRPC    PMTKPG          EUGCCANBRUUAJFE
MLYGC           : WINTGQE         LRHOHMU         FHTDOFCRRQE     JXRY            JTLFIRJNYLW     XLHCXEXCKQWOGB  PODVHMBHM      
CUWBLKIYGNIJ    : KQKEKMBDDMQKBS  FKJSMLJKW       WGSWN           QAEAG           CVLSCIAXAFU    
AFGH            : PDEQHLCVA       HWEUXOILTBTD   
NUWLRYTHK       : KWBLFUBTCYQ     LFRWTBENBYTXIK  BVUUVSCOLBCCMQ  MUVYS           TNAJRT          LQEUEKXPIOX    
NMSRIPSVCEW     : HXBLVGATMISPNSN NDCGIFV         PTEJKXPOD       VUEFAJOC       
RGUJGASN        : XBKCCJBBRMNYJSJ GKUMNTJHY       MWBX           
IKSTFR          : BOOLH           EJLBPQM         OTVWPGU         UXMGXDPAFWE    
MCIC            : GVAGXE          PLQQRORBPXVLXU  PNIRHWP         YDQJLCTRRRM     XMGE            XFREHLWLOIN     SSJUO          
ETBTMXWSUINDDY  : CKHWMCY         FIHJMK          HPTY            PWFNXWEDELUOLUP FJNIIHUXTGFDRQ  QDHHFMKKIUOJI   HRHIQKEC        RUCHC          
ETBTMXWSUINDDY  : SUIXWMRVIYB    
ERXAA           : YLYRUDJT        TPPHLDAUDKKEWF  WBTENASWJRIBAN  EVNNONMIRIRLC  
UUNOKC          : AUNDBNWQPKC     XANJPBAJOV     
VEJAXLVNLSGID   : ETTWROXADQV     OTXOXJKJILWKLBO FJDKOSQVULAF    LHEFGIFXYSP     QGXUOECGFJWQJT  QLPC           
MHVXNNXP        : SIRPGXR         ILSVETBUHK      UTDKCNOT        SFCBJOSVTL      OCYTKMJJFHJJ   
HKLWYVA         : FMELQO          LMHPGK          AJOAN           TSGIUXVVYL      EDOSCTRLQJC    
RGBTFOQ         : VJYXVJYVBBQVC   HLJPADVX        MBFXTNCLJQBETB  PYUXPLGEOXA    
CLBNPACYVA      : GOFBSPF         YFKYMUEAIUF     HQPQECMUPOT     KGLMUUHMMGBNUM  VGOA            YXGGRLAD        TTHF            KTJXERSKI      
JYEXIOJHPIJHCQK : APITKDEQWSCW    EBMQ            WTJNSTLVLOFOJB 
XCPS            : AKNWLAFIDBN     OGIMMTKOUNMSLRO AHVMPERV       
DVTSVXTRB       : TIUI            UAEIS          
ECMEKDOTSYE     : PTAKHNB         TPGOLLY         HIBGXYEMRWSTMOX
DWPCWRRPXX      : NKOVNRPE        MKNKI           LXDBHKBISXILKL 
UQKUNEVVI       : LNKOEFKDLOIKE   NEAWFACPOB      PLETXXEDJ      
LNKOEFKDLOIKE   : LYEFNY          NKNNYPVCC       UQKUNEVVI       JTWNMNXJFIHSG  
HVFYWDMTWWOKENG : AILKWJPMIXCDRG  ISJQOCRNB      
NTAYLGG         : NFWWOTVAJCQVRJ  IBDOPAFVP       BVGUOSKOAGXWW   TGKEQDGYYYX    
LTMUERG         : JECRVF          SJNUCHGUYR      EJNIDUJQG      
NNMMRYGOYXYDLHR : QCWVLGFARQAQANT MHDABMGNGUN     AJMKHK          RQYUMVBIARFTHPC DMMBR          
CUAPBGNNC       : SLFIQVKYTCBI   
IGRQ            : MBYNNHCELEUSBSP
IEIUVKEMJCLO    : HGGHFOCENN      YAMAIFIYOS     
VGOA            : LJYOM           RYYRCLCGIPOWRN  DUIQAOELHQW     KJAS            CLBNPACYVA      UYVGQEARKTCWGCW
RPFXDSDDDLVVIG  : IHAVCHEDLTYRVKU HBNAYAVRQFXFC  
QDYDHLMLAD      : JCYAAF          IFNUPNX        
XMSX            : CKON            OAONY           XUAFHH          HAQWGLBHFASCIR  BKCLKMVB       
KNSK            : IMMMRDGE       
NNVSATOK        : QVXCJSFRAAQTXUG VLWGVERYIIQO    UNBLFSJRO       PTOCXIUSJFLFLT  DMRJJVVA       
PDEQHLCVA       : AFGH            PHFUDBJ        
ABCM            : VFKYHV          MTEQA           KVNJXTBFY       HSTMEEFHBIDFX   IMHFKINQW       YKTHGEJINYPVULS
ACGPXTGNHDHJ    : PHHJJXUKYV      IOUBS           QVAWRYALYW      ISHOYJKEB       PESHMIEWUXCAJL  UIIRJSOFUKWJKRH
VTAL            : VVODF           UYUDMYDKG       OGHBDOSX        PULX            UOMMMWWXHLU     MOIBM           MUVYS           JFDCBJKCJ      
ECFRHDTN        : DRJWPRWKWYMPREB FPFAQUG         LFMIFYL         HOMTHE         
VQRRSWB         : PHEETVAHM       WLNUCOYSPWXQ    IUSEMP          CJXMPCUTNLVHVP 
WURKE           : FCKHDLUGIORUT   QTEMFCBTM       PMLPKC         
ROWO            : NRPNEXIH        GMCYVHEKBXAQELF TFRXTADMKEWK    EEWVSCVDV       PUQYAVN         AUJRHETEMXBBJ  
WCKDHRWQVREBP   : CWOVDWILNPUBQU  WLQJDEMTTONE    NDHSOUDXE      
VJQSKAPFTAKRSB  : SIRPGXR         RJOFTSERMNFLBL  RADQVSWFNRFGBK 
JLNLWQU         : NODJW           NQLBHKLCGCAQQF  CIABTLOQGG      XOFS            CYRKEUGG        BIEWQOLTMWTD   
PLMHSOYPKJG     : FBPSQNKWSX      NEYNHBS         YDTOYX          QDGDV           PTQF            XCTCTSWIUWXQV   AHIOVJRVESQ    
TIUCDUOWP       : RHMUVMXHUHDFOB  IRDOJ           BFPRG           UAXSYL          VXDES           BKKAPBJNGTVEXS 
LBDYPCRK        : OJVXGCBSHCBFC   ODBKU           NGLUIPDSJK      UKNKB          
HYGRRW          : ONQQEG          HFOAKQAM        WUCPBWF        
HHCQMYYJDEHRBYJ : DRBMEKXUVFXR    RFVBPMTAVLJHH   LQRNVJDKH       FBGDXEATWLWPD   QUHRQVKWMFOXPS  XOHBKUPQVAAUG   OGNSUVXGO       SYSHD          
BONQTHDNPC      : VOHCECWAAG      LJNCBQQAJQVFFA  RHXSSYI        
JTVC            : VQFPTQDLMOYJLEC JIHYXE         
FHUU            : IPWCCXRM        RLRYSVTX       
VELDLDENOVO     : NTYAGG          IJMAVKWTNDJPJLK LFHEUSHSOJGJP   YBQKSBUBBMRFYYC
LHYTKOLNNU      : JKWKQDEPIPWFN   PYBXD           QGGFOKDNYRRKM   IXYDENEMG       CKMPHBCCQUQ     OGIMMTKOUNMSLRO
JYNQGIL         : NODJW           KPPBXYOSOEF     UTDKCNOT        QFIPT           CCYIHXPY        CFMCYQMLDY     
FSAIE           : SBCMHUJHJAHFRKM LERMICAO        XFREHLWLOIN    
OTVKICWPDSDUE   : UOHDMBKPCILIRO  ULBSHE          PLTHBMCYKVDWD   UDGOJGMNLIYEWPG HIKIU           MFCAPCUEMXTFTM 
KBEVASMJDYAKRD  : HPTY            RSDKWGPYEVPKFRU JEPHTOIOMRWCPJV
XIKSHWDL        : ISSBPHVQNFEJ    WJUAVF          DHWCDV          OEAAOC         
VQOBLU          : OQBBT           HNPY            NJJXTGUK        DQII           
VVXRYSFKWGKHA   : WBBOAERXX       WEVHM           UTAOMEFJT       HIBGXYEMRWSTMOX
DAYPUGOYTLWKC   : MOPOLGMRGW      OYHUVQSKR      
YATUVRP         : BMDWTJT         ARUSAE          UEPMTOFUGNAL    PBVLYOXEPKEBS  
NWHKD           : LSSXRDUJLKN     PALQXGHD        UMCPSDBDGLS     POSKJJSGWEFDLTF GOHWP          
TFIYHH          : AYNHCLEUBIRGHFA DDNCGYSKFYKV    GSJNARTGOHINGI  LCLQCTO         RTTHMTTOBL      YJXYPFDKCYNQ   
DPEEJR          : WNPWB           BYRBGOWDGM      HEPFGSHHDQC     KDKDPXL         RDFTSKTHX      
WVBVVUQSOIPCFA  : OJVXGCBSHCBFC   VKUTQMANWJOJV   LQHVUFA        
KSJPBIALADBE    : SJRO            FNBQILSO        PUAQQFSAJRKBV  
NXKKTLGQI       : OTWYDQPTWWODYRK WVTE            HLAYSGLRMHELOMH
LWKBCPBQBVASA   : RPVKVMMNVBJM    PCNKKNPTJUXWY  
SLLXMRHCPRMJFUC : NPNUDYNU        SHCRTONRB       NCOJHY          KHYXSRGMAD      CSIBYC          MRJRAS          RYIPBJTDOH     
WNLHRNYUGARJVR  : PUBEOFXICJFJ    MSDEBWJVUSHCR   IMMMRDGE        ELIUUS         
QFIPT           : MWDBEWKGJYSBY   IANE            JYNQGIL         SLFIQVKYTCBI    LWXXEBAFN      
WWTR            : UXRX            ISDSCYGBWW      DSEUBKBUCCE    
FWJILGVYP       : PNVMYPLVGI      TPXBCRLMWFJK    UQCXY           HIYGCDNDVTFWO   NNATHAWKGYDT   
OOLWRDGNWDG     : THADPBWGDPIS    ULBSHE          CUPFBLYSEPOLM   GPCUAJSQEIGNQWW UPGCJDARLRDVJM 
NVXPVULNJRK     : METDQTXNO       KXXACEWRXLIM    QKSNVMEGGEPWCIQ
CXBXYQOPHANBFVQ : RCDMQFEWNJCWMYB XOFS            YWSEJJSQHHWP   
AXGP            : EQBSEXVD        NGAVQMUPT       XRMJVIWHICLGAM  TXGDRRPWNY      KFWOME         
EIRCTFLNSEPS    : EPNVHQBDGC      RLYBPAXGNEUV    PJIQSDEE       
OSAFK           : QBUWIBX         KVWJIWWGJR      VBHYAKW         QLRGX          
HAJMW           : VMNAPKIGWDX     XICYFS          SKOVLPAKQOKHJ  
QYAYOWFW        : SAJEQJECLFYVVAA LHLTIYAFJNRBUN 
JTUUHNBXI       : PUUECOYGINTN    AQAUNXTCLADO    QWYLVUTKDDFYU  
OBKVOSDO        : GEVYMOEITXTRJC  QJRX            DHCYQPCOISULGV  WWOWCHUU       
RNGKOHLEEQDSDY  : AKNWLAFIDBN     IETWSDG         DQFXHKYOLCLS    HNPY            JLUWOIFLKDC    
AHFC            : LIYRVDEEBLWUWK  XUMQEN         
OMVRXRGSUXY     : VFTQ            XNPURNMUR       GHBYOGLCJ       DBHWF          
LFYBMKHSD       : IAMSIJV         LWDP            HUQAFWPGEA      ELRSJYTUEHB     RSDKWGPYEVPKFRU
MGMCH           : VNGNORHPQWYW    WOLXGFHYGBYFL  
KLDYAY          : EPFUIHWDVN      SSJUO           RWOSJYKRK       UXMGXDPAFWE    
AQAUNXTCLADO    : GQLUOHEGSSKRI   JTUUHNBXI       BPSYDCCDLTBJA   SRSUA          
NVISLW          : GQLUOHEGSSKRI   SYYLBKFLLBIK   
ABJVLWYKYXEC    : NHBQ            XLVXTVFFWWGSQA 
EYGCTKNVNDMDBW  : DWUY            SINLNRLVU       ULBSHE          FQQXMNJMVRLLAQ 
OTXOXJKJILWKLBO : HWINOYKSS       XOFS            VEJAXLVNLSGID   PIDTAOCGHXGXD   DIPMKOECSU      LHEFGIFXYSP    
FNKHJWWFK       : CQCT            WNIFYSSLX      
UPGR            : ARYUUAUAJCRGA   VNGNORHPQWYW    SGAQ            JOUYRMAYPD      QTLHRA          JFDCBJKCJ      
UOMMMWWXHLU     : JEYIRVEE        WHTXMHWAEC      PLQQRORBPXVLXU  VQLVJFXWEKBIQNT UXAIKGAR        VTAL            IGBMFIQCTUEU    OCRXIAXODRNSNAR
UOMMMWWXHLU     : DQII           
WVGEBUO         : NYYEUIP         UKVUCG          NDCGIFV         HBNAYAVRQFXFC   BTRRCWIUKYC    
GOIOYKJRQDE     : KVNJXTBFY       DYWWRUF         OYTPBGQOXEN     SPUKTCBEHUCD   
TQBGPAFXL       : PLTHBMCYKVDWD   CTNLXACMJMHAEM 
RLYBPAXGNEUV    : ILKCEP          PKBBUTAPBMM     EIRCTFLNSEPS    HXXTIKVBCFDPUC  RRPJVKEANY      KFWOME         
WIEOCIUQCNTL    : DYGTPFBGH       FVANTEE         UVYCLIW         MITUSHNOSUHSP  
TSGIUXVVYL      : RLTT            SVTSNUPHNLYXKVX KHJUNBVEDL      HKLWYVA         XROYYY         
YTMERIWQSCHUMCN : BEORRMGQEROKAN  CDMVTBJBHXF     QULLGGAV        COXJLAMRQRGCFVS
RHCXEWE         : KRONKVLHGGJAO   BKYN            FPQYJ          
SFIOGVNGRA      : ADSKUETPHHN     CWHBW           NMMAPNCGUS      RDFTSKTHX       FFOGO           HIBGXYEMRWSTMOX
JKJCENJB        : EJVKMANUCTSVGOL VOUXXBPYGI      HLLUGRUUI       CQYUMAA         FHCRTRUQ       
LPTEYVEDTJR     : NODJW           EGCGCJPJLM      MLAQP           HVGMQYF        
OCFWXVDSVP      : BDCGMPF         ARHJASWECHMSOUC BECAHIBGXL      YKTHGEJINYPVULS
JCHNPQ          : TGKQLUGVUKXA    SCNMND          FPFAQUG         KEHPYHEXJJURK   CVVHQTXUIFGANP 
UDGOJGMNLIYEWPG : EPNVHQBDGC      HQCUFDALRS      OTVKICWPDSDUE   TRLMOUWPXFINIB  YPNVEUQBUL     
NHBQ            : GPPES           ABJVLWYKYXEC    JDVTQXI         XRTEYLLQNOWMKA  WRSEIBAWHOLL   
YJGI            : KQPMQ           AVHHBOBRDPOVTQ  XOFS            UKLIJ           YDWHWRQILBX    
NXDFPXKVOVE     : OAIDICS         AKQJFOIGGRPXJR  NJJXTGUK        USRQDTDVFYTHI  
LSKLYKBHPQQ     : FICGPPQPL       PEOQAIECNPKG    NUMMTWHN        RQQVRQCFF       LHGSXOJOMUDWVQI
KSRTADHPBKWQLJ  : MRGQD           JGXQR           QYBOKJUIDAKBG   UYVGQEARKTCWGCW
AFVCROPFNAIX    : GFNX            ABGIPJI         LJSRA           UQGCTSADBOWVKLM HUVRB           VGGPFDISHJYMJ   PHVAOQGSLHNJVD 
AOKK            : UMLKM           HDLSBRGYNCCPDG  RUCHC          
EGKHNAJAACLJROR : JICYL           VQQBIKONUVO    
SLFIQVKYTCBI    : CUAPBGNNC       QFIPT           GYGIDGKOQ       CRFOHUFHYBPY   
LSTTDBHGKKGN    : HLILBJMGUH      JEAB            BECAHIBGXL     
RHMJXG          : DANXQEDGEXRGT   AHYNEIJLHFY     QGIFF           EJDONNWWNLRD    INITBCRPOWVVW  
EQNCCPVEQGTFA   : WLAWW           IKAGPHLSWV      XFEOWTGHQB     
YDQJLCTRRRM     : WGORQCL         HAHE            MCIC            WIKYRGUQJKT    
FVANTEE         : ULRHAIPBMRTHLD  WIEOCIUQCNTL    KGBX           
GIYE            : XUAFHH          HISBVBW        
QKJVKY          : PMAIJCYVACQLU   RHXSSYI        
QPGCRAWLSJNAHN  : ONFWKKUT        KQPMQ           NJCXER          NGAVQMUPT       NWKW           
BTTLCD          : IMWDYKAWMJY     RFVBPMTAVLJHH  
ISDSCYGBWW      : DRBMEKXUVFXR    MTNFRKXF        MWDVKKCMPHL     WWTR            RADQVSWFNRFGBK  SWGPIFGKBSRGTU 
DYLGVYYHO       : VRHN            YBHOFQHCUDPNOJ  GDVNURHLUNSJ    MSLNOTSTEAYVW  
PEOQAIECNPKG    : SMNITQNLBL      HAHE            LSKLYKBHPQQ    
GKUMNTJHY       : YNDUTLJCTTHM    RGUJGASN       
UFJTEQLF        : PPFIXSCCBMXLRPD BOOLH           OOSSLKS         OAWOHPTCFA      SKOVLPAKQOKHJ  
PTXQFEU         : JNPEW           UCQSLFQIDXXY   
TGCPOOMB        : HJMMFRJAMLK     BOMQTFPKHYEFTHC VHTFFTTOJWRS    YTEUXASGQMG    
IMMHY           : VUPUQQBSCOJ     YFYHM           LIKPJANVDTK     PNIRHWP         VOLHLASCWBQJB   FPFAQUG         DOKDNIUAVQE    
PIDTAOCGHXGXD   : SIHEE           OTXOXJKJILWKLBO CKWNVQLPHEWLJA 
SYJBDYRTN       : AHYNEIJLHFY     TURE            TDJAP           UURXHKQLVYBOXXN
YVHL            : BOBKSORKQYOYWOY MMQDOHDUDUBDC   STQMWTNG       
HUVRB           : RFVBPMTAVLJHH   MFDFGAYWDXQ     AFVCROPFNAIX   
RRTBYSJYXWUWHXC : JEYIRVEE        INUV            VGDHA          
QWYLVUTKDDFYU   : TTQCEFOWLGE     JTUUHNBXI       RTTHMTTOBL     
TPBPQCKC        : KMGD            BOHKLBUMTEYPKAR TRLMOUWPXFINIB  HROWE           UOOHHDRON      
JAYIJWLRNK      : IGESOPVFDKTOMSE LXLWHLCGO      
AGOVQTYYTVHPLK  : NODJW           VSRLQN          OOVAB           RGNSDMDVVBK    
ENQHRA          : JXSIVPRLEIQ     DIUNPD          KOFWQAABQ      
QKSNVMEGGEPWCIQ : FNRKMHPJAVM     RYWAC           NVXPVULNJRK    
HMYRCLCI        : MIKSSWGBCIH     GTTPVBACB       RXVUMEMP        DJASXBGSLWUV   
PBYHDI          : GFEMFWMNWSUCPA  QCLR            BVMDIVBG        HSHSAXXJOCAOQ  
NDOMQSUYYMVB    : JOUYRMAYPD      DYWWRUF         EVNNONMIRIRLC   XICYFS         
MEDADUEQAOJPPIA : KFAWXR          QCJHE           OVNE            SEIYNKTHPNSB    JLUGCC          MMEUFEICIAJG   
TCJWSXPNSOMGKPC : PFTXDPYYCKT     YPDQHPKT        VBBDYESALWLL    MCWJOJWYRSHJF  
VHACFGS         : SITIISYH        LHEDLLRQVPSCV   JVOFJUEDSNHVGR 
VEWLP           : IVMGXXYDPBFIUEF CKUDFXSOILH     GOJC            LQHVUFA        
HJCQGUOWL       : WGBGDYCCPLMXJOK KMFXKRMMXSTBYV  FWUFCBSQPJTEIW  EOTYIKDUTFBGH  
NXRYQTBMEDOJJ   : VHTFFTTOJWRS    MWRYXNQW        PGMTJKTDFLGDHOB YLFQKOOUHJWJKX 
QFONTEPBP       : NKNNYPVCC       VXDHXVOMXNVOWU  DIPMKOECSU      YOGONR         
TWQKVC          : EVRDSKWMRIK     IVBRDHAUVBXIIOF
LBOKTKL         : SKHLYMOIXOOL    SVFKYAKMKXCOBG  FVBWW          
OOVAB           : JIGGUAYP        JNMTOMAXUVB     AGOVQTYYTVHPLK  YKRNWSAMNWEF    PGMTJKTDFLGDHOB
QGWHC           : TCOAYLXLVMS     TRIU            RYUILUK         HCHN            KTJXERSKI       FTAEJMFICURF   
WFTSYSJLQMIDPY  : YQJYITI         HEPFGSHHDQC     XAIFEAWB       
JJEPBUNBVVU     : IRTKIFLSAVIR    JXSCCXWBXADQGJN TPQBSHKJELGCT   XWLBPGJ         TUCTJLGFS       DQPKBXGPG       NXYUCMOFG      
VEHADNVVO       : YJHNHVYCFDSAV   UUDHRORXVB     
FBGR            : AKNWLAFIDBN     RACTHBK         HUHMX           QAEAG          
JJKCSVGLWBY     : IFNUPNX         TGNNJ          
XXXDTCKVFXR     : EDLWQLCCDRO     ERTY            OLKWAVHRHHGDN   LJBKLTH        
PJIQSDEE        : PLOJ            DOIJNTN         UUBVKVLOIMXF    GEEAJ           QITQWPWTUEMH    IMML            EIRCTFLNSEPS    ECVCUTCFDIMN   
PJIQSDEE        : AMEVELONELTMP  
OGIMMTKOUNMSLRO : GEVYMOEITXTRJC  LAERCHNWK       XCPS            LHYTKOLNNU      AENAOYGHBNE     SAQYFKMSEYDC   
CKUDFXSOILH     : KPPBXYOSOEF     YDTOYX          OLUC            VEWLP           PWGWRVAOLNWLD   UWYXTA         
PMBGSJSGFFUAUJ  : PUAQQFSAJRKBV   JFDCBJKCJ       BTRRCWIUKYC    
IBKXFVU         : HITASXJYACLJGHO NUTPJGALNRPC    BNEUWQJVIWE     RFNVWBXJ       
BUDREQARIOS     : YMOAV           WNRGSRS         KIPDQLNUPGTLLQI JLUDYAVONNQBSQT VCFCGDFRBGN    
HEKPLRMMP       : QINRJCLFPC      CQVTVYXFHFN     FSRJXDVCLTJQ   
IXYSWFQT        : NMHWUNHNA       NGDOAAGIUJU     JTLFIRJNYLW     ECCMJYSEGH      WPXXGSXLU       DOKDNIUAVQE     ETHVRDUTKGR    
RPVKVMMNVBJM    : IPKNLTALEOGC    LWKBCPBQBVASA  
PYBCRNQJMBHNT   : RFQALGUYEPBK    PVCRM           FFOGO          
UNBLFSJRO       : PPFIXSCCBMXLRPD NNVSATOK        LQRNVJDKH       RMVAACNOAPB     VWYIPURDTOMRY  
EETHPJSGITK     : XEWPE           PLQQRORBPXVLXU  PQIWUBEDTOMYH  
JBLXETMX        : NPYDTYBUTMYOHPW QUFIO           HCHN            UOOMCVDWTXQSGK 
HNFUTXENO       : WNRGSRS         XRVPHS          IAABRWRUUAROLYC
UVYCLIW         : WIEOCIUQCNTL    GRPWQYRFDDP    
RSEVDHI         : MTNFRKXF        YCVJOOQOTUR     QEQWCTN        
LERMICAO        : LVNSTHYOLAT     TXYFB           VHGT            FSAIE          
VOEMEJHAILNTJ   : RYIPBJTDOH      CPFE           
NCOJHY          : SLLXMRHCPRMJFUC
NMXFBHJ         : AVMDXUN        
XJAMPOQYVSJ     : PTRAARLOW       WEVHM           BFPRG           WAALLS          KNHX            IMMMRDGE        GAPSEPB        
JDVTQXI         : EFJIPMV         NHBQ            VTHL            QDHOEQAMIMLN    PHFUDBJ        
IJWVWXDAFNEDWHP : IVMGXXYDPBFIUEF HTCQAB          QKVRTRAQGP      CXAQHNSLFJ      GOUE           
VJNSEYFNDBHVBSY : TNUQYHSD        SJBUKP          BKRKCFJC       
CWHBW           : SFIOGVNGRA     
CCYIHXPY        : JYLUA           VMOQFBJEXRI     JYNQGIL         MKJUPI          XFAGSUMEQ       JIHYXE          SBCBQ          
MKCHPBMFGNNF    : PTAKHNB         QGIFF           QJFXKWABGBNRN  
IGBMFIQCTUEU    : THMCMMJDC       XAIFEAWB        UOMMMWWXHLU     RFTHYOV         MBYNNHCELEUSBSP
NUTPJGALNRPC    : ABUBQWNMM       GKDVWA          IBKXFVU         FJLTXN          MATNEQMNQ      
XPNDGVMH        : XGYMSXXJIRBQKKL EDKP            CUPFBLYSEPOLM   WLAWW           UOOMCVDWTXQSGK  RHXSSYI        
RQYUMVBIARFTHPC : MTNFRKXF        RACTHBK         QBACQ           NNMMRYGOYXYDLHR IAKTQNDP        MMOVNPEBPNCXIMP WJUE            UNDQPGMYVGETTV 
DPCUTATJPY      : BPAJJWTBUCYC    GGEL           
LNAV            : UPSCCQY         NQLBHKLCGCAQQF  CTLVYSRUKBSCV   MOKJBTRBUQMUK  
SXBFTEPTVVPDNR  : DQTXW           HLLHPXDV        TQDEAMK         GKJOFUBXG       CHXF           
SJRO            : XNCWEQWBXNWG    KSJPBIALADBE    CXGB            SSJUO           NWKW            OTFTN          
RKOHLHUAJSGCQJH : BVGSLEDQQMRAUQ  XCTJSKW         RSMHVUEHKTIEBIB YOPJCXPOGDG    
PAHM            : LIYRVDEEBLWUWK  SSSKNWMYIBKCWHG HQXQGPYOK       JEAMVGNNDF     
ARLRFEEWUHQ     : EUWLF           WKGKPPCY        UKJTQ           EEPIWFKKR       GRSTNLPTSTDNX   KILQLXIRSQPEC   HSHSAXXJOCAOQ  
YATGUTPOCTHN    : PLVEQNKC        QKGPH           MRLL            HFFMXCUV       
UDDFRBFKMYR     : SSUTEHMHJNNPUX  VAUIXBSUUOQDXE  SUMVXT          LJSRA           EAEMM           PTALBBBJIJRFVTC SJLBRFMLTUIH   
DRONI           : QDJHHQUMIRGK    LVJARFT        
MLQU            : KPDJCOUTPQARGN  SKTQYTYHHC      FYFTGE          JATGW           CQYUMAA        
MMWOGHEJ        : QWTOBMBNMCXIWP  HQCUFDALRS      PJUUUXWK       
JNJCQQMEQEX     : JXNJXSH         YITWNN          LADMWRGJCIA     CUFPVI          YPDQHPKT        OBHVGWLMTDJQGWJ KHYYOTSTFYYKXH  PMTKPG         
JNJCQQMEQEX     : EOTYIKDUTFBGH   DNNCHXUUH      
VOLHLASCWBQJB   : RVHBPPUHHFV     IMMHY           CAGVYWCAVUD    
RILEMVTYAK      : YPDQHPKT        AJURJRRLMGLA    LDYS            JQRCNOLXDF     
MQIQQFPGQWRTRWQ : SIRPGXR         AYNHCLEUBIRGHFA WGORQCL         EUBIMEQHWS      TYTAKPPSNKRCPAJ
NBTVUEJBTHU     : OEVWLUNALOF    
HIIT            : EUVTXMHHMNSA    UKVUCG          FPFAQUG        
RNQYDWRCQLTPDO  : KQKEKMBDDMQKBS  TEBOEPGUFAQOYWK NLOTA           DRJWPRWKWYMPREB GYLAJUECENU    
GJCBPLDJVACDIL  : AOWTHP          MEOHGE          SBWVDAHLJY      AGGWDOMNQTQL    TUKKSSJLY      
IFNBESXVUQI     : QGTXDUKWFPSK    TPQBSHKJELGCT   WRGFGGY         DQTNTTKSAGUGP  
HNFNTQRWHFC     : EMOIMC          CHTCKUOJ        RHKNOAALVFWFHP 
BDVFNHF         : LYNHHUCTWCDBOT  YAMAIFIYOS      XWGAPYKTGAG    
OSYSLYQ         : HIYGCDNDVTFWO  
QYYXOGN         : TUTDPQWFOAJJNV  GEKYEHO         MGNSEYHH        IGEDMRESHVKLG   PXCEYQNES      
XFGFKKX         : XANPJ           NQLBHKLCGCAQQF  IRDOJ           UKVUCG          CTYMDNQSU      
PTTEDYCRRCMDBEN : OBBTQDBRPC      GJIKBFEQYELHUV  FJQSLNT        
DMTSSHDSOLAC    : UTEDGPKUUVLLLKQ NKKAFWQB        FUDLPVLMDDT     GTTPVBACB       WARFWVIVPCC     OLSLNTJKWVXRJK 
YOMUISBH        : YYGEGHU         MTDHBBQSOH      GXTDNAXMJKSLCE  AKQJFOIGGRPXJR 
SBAGGDK         : QCWVLGFARQAQANT MYIFHXXLT       QXDKVIUIVB      QRTRWIDFQSBEDFL AJBQJWDMSSYVP  
APITKDEQWSCW    : JYEXIOJHPIJHCQK YTSUOSBFGMVI    WBTENASWJRIBAN  ALHPDLXC        AUJRHETEMXBBJ  
BXLQTVJUFHPGJXO : YKISCV          RRLTTHEM        FNGUIVLUNNKP   
KIPDQLNUPGTLLQI : VHMGHGQFXLQD    KPPBXYOSOEF     BUDREQARIOS     XJYACTK        
RWFLSRIYBXHLWWD : JNPEW          
FSKYE           : AAOYSPK         JUCWCIGD       
VWJRKUISKAPRNJ  : GHAEJOJL        RSMHVUEHKTIEBIB WJUE            NGLUIPDSJK     
VKLWT           : VTYUQCKSYSJH    IQCCXVPV        UNDQPGMYVGETTV 
VQCDYUQABTVADNK : SDUQPCXDNIS     VXDES          
XGNBV           : CGVYX           VTHL           
QHPPTDMOCKFGNGD : CDHEWDN         OIMNJREWIV      CYRKEUGG        GRIMXFELMTEL    CUXIPGKTHBUYV   YCVJOOQOTUR    
GGCCHIRT        : XYXEQXIIW       FQYVVOKDL       FLQVPUNPNV     
SAWV            : GAQFN          
CMGTEDYQRDBYJ   : NWWSCNKUBYLR    UYGXYLUYD      
GMAMTDRDNLWWGXV : YJHNHVYCFDSAV   IGWDAS          OMLAXOOQTPNQJKV VRFJFMRVOEOOQBO RXFXBYVJQGRWT   CVLSCIAXAFU     DJASXBGSLWUV   
WARFWVIVPCC     : JJNS            DSXCKIREK       XBJVR           OCEUNROQOCO     DMTSSHDSOLAC    XLVXTVFFWWGSQA 
CLMKBNY         : CJLL            LCLQCTO         ICYYP           YLHLXDQT        CCLNVXQYE       IVGCR          
SQAGFYFLYBQXBK  : DVYBNRQJYFT     FHTDOFCRRQE     LUTHH           NDKFWFG         BVJMNJXGAHLYRY 
XGOWXTYRVMEIP   : WMWIAWNDO       BKRKCFJC        BVGSLEDQQMRAUQ 
HMOBOW          : XLFLYLJ         OAQECQMLN       DLGSORULSXNJL   BIXRCATGLVJFHA  GSPWNMPSRA     
OCTP            : GRSTNLPTSTDNX   PTFDLRGPO       USRQDTDVFYTHI   NJYQSESN        RXVUMEMP       
MOHWUHG         : AHYNEIJLHFY     ETHVRDUTKGR    
GEDFXBUD        : RCDMQFEWNJCWMYB FKFO            OVMDBKJCKHF     DMMBR           XFAGSUMEQ      
KYTXOUOL        : CQCT            KWNLNTJKHEAIQP  BTOVXQLERNISNA  JTLFIRJNYLW     RAGSCGTJGNYWM   VXBFJVEAGKLTNQ 
FQYVVOKDL       : VPLWXBNTPDSDN   GGCCHIRT        BIVQ           
NTQTYWC         : XHKYFWPANOU     QYABFI          AHIOVJRVESQ    
AWCMHEIHSDWGIC  : EOKPCKQKRIQ     ECCMJYSEGH      GPCUAJSQEIGNQWW
JXTXKYMRMILJH   : QGGKVCLOWDLGQPW FIOYABXUSGA     AABYM          
LJMILYRP        : ABGIPJI         AEXIUFJQGTDSX   FMNUEK          REMMVLJNBY      XHRXBHHARHJBJ   LNGGWBGUYPLBSB  AAITUYKRPYPWQME
AKMYRWBQHCKH    : PFULWP          PFAWDPQV        MYETKWHIV       HXPMFB         
MVHBFUK         : TRBNTV          RYVLXVHTWWJDSJO GEEAJ           GLIPHRMONRVASH 
HXXTIKVBCFDPUC  : DSXCKIREK       WNRGSRS         CXKJDK          RLYBPAXGNEUV    TWDOAMABS      
RFABHN          : RJJY            HLJPADVX        RLYGATCYNRMLRJ 
WCFGDKDQAKOXGX  : HYXEWOKRKE      GPRPVIQYVTTLR   ETFAJUGL        IEEDNMJ        
CBPKGHFIQWN     : NLOTA          
BXIKWKRFQ       : TOBGUMTSKD      NSYAQAXJYLRYFM  UMCVDGYMUVRH   
IHHUVHBVU       : OYPBPNQHDULN    UMCTTOGMKG     
YKQFTVPM        : TNUQYHSD        GEOCAYKTQRJRKAQ DIVUSPABG       UUSVBDR        
GFVGQIDB        : ITNCVBUJEE     
IRISBPNAW       : MILG            VMIOPO          HUYICHISDCNCHM 
XRWXEPFXLXK     : CIABTLOQGG      RJHGSSXSD       RAGSCGTJGNYWM   IAHJRIKFAP     
ESHMJQPMTAH     : KPPBXYOSOEF     JKNNNWQ         GXCIK          
SITIISYH        : VHACFGS        
WHRMOSBM        : OCLXMNFADCU     MUKKW           SJTEEDLLCFVH    XVIAXI         
MSXTFJKWW       : HIJPT           UOOHHDRON      
WGKROGAAACHNB   : TNUQYHSD        SUMVXT          XRFOSYTODGOLGM  GRIMXFELMTEL    BKCLKMVB       
FPFAQUG         : DQFXHKYOLCLS    WSFHCXAPLTYRLDK TQKAKMDS        ECFRHDTN        JCHNPQ          IMMHY           HIIT           
NGAVQMUPT       : IPWCCXRM        XJTBULXP        EQALVLOCEEH     NDCGIFV         AXGP            QPGCRAWLSJNAHN  IJRPAWDGYAN     CLSPMNGAKNGHB  
VGMMNPMPRV      : EDLWQLCCDRO     WLQJDEMTTONE    RRPJVKEANY      AOQNP          
UMKKULCP        : PHIO            HDMJBHRPNY      XOFS           
HFAJDSWYIST     : HXBLVGATMISPNSN FLHW            FJLTXN          CAGVYWCAVUD    
BIVQ            : RIPQAUKLPW      SPOEOMAB        FQYVVOKDL       JOSQGBIDLPMIQGL BTWXJLWDI      
IGRFJMTUXQ      : WESKKXX         BTUGLXGSR       WNASLIFHUEHP    CDHEWDN         GHAEJOJL       
CICLOCXTVUSGP   : PALQXGHD        BOHKLBUMTEYPKAR
PQXLIVV         : WTIC            XHRXBHHARHJBJ  
QDBFAXFQGJA     : VRHN            KHXLPAXLAXUKQ   TLIAKO          GEDAPPTOCSIETW  JUALOQKBL      
VQMV            : BMNEUEYX        CIXYHMVLUS      MBTFTDIGKJHTQ  
KQGRIUJBSW      : RPKSOQ          UHPCQNJXDJ      ECCMJYSEGH     
RSDKWGPYEVPKFRU : XMCXTFLGHBWHW   KBEVASMJDYAKRD  LFYBMKHSD       IPDVKTDB        GHBYOGLCJ      
KHYXSRGMAD      : YFKYMUEAIUF     SLLXMRHCPRMJFUC
EWUPQNUBM       : WNJNCCHIP      
QLFOERUXMALWAJP : VBBDYESALWLL    AHVMPERV        VYCQCDDCTIEBMBL YDNISYEPTL     
REUUCB          : PPSYCLNXLPCB    VVCOPVHX        CPHXF          
WQKMMLCNFPVVTNS : YMOAV           RLRYSVTX        YOBNCTPXOCJ     IXPIBYYG        YKITPF         
DTGA            : ABKROKHT        AGLVNSIUJ       SEHTKPONNE      PCTKGE         
RRPJVKEANY      : RLYBPAXGNEUV    VGMMNPMPRV      EAOXYNPF       
FJLTXN          : QPUCQUMNV       NUTPJGALNRPC    HFAJDSWYIST    
DEHYAVSU        : MIKSSWGBCIH     BCERSEPBMFFCI   IGEDMRESHVKLG   VWYIPURDTOMRY   VTHL            UNNBPFBQ        CVVHQTXUIFGANP  NMLQDPLJNMQ    
DEHYAVSU        : UXMGXDPAFWE    
ODBKU           : JDSWFDFBODE     LBDYPCRK        JLKSAIG         PCOLLNOSBPU    
AEQNJQ          : CUFPVI          YWURLRMXRJE     IRDOJ           GWWIJNWUP       WPJFWJVBCXXFXR 
INITBCRPOWVVW   : UUCKCPIGTLLEV   DOXGKIRIFXQODJ  QSRDNNK         RHMJXG          PSXNJCX        
RRTS            : YWPSUNDLIRBRL   NBWU            OEAAOC         
YTSUOSBFGMVI    : GPCQRGE         APITKDEQWSCW    CAGVYWCAVUD     JQYSPAXLPBE    
LQRNVJDKH       : OYXSPSLEDVIY    HHCQMYYJDEHRBYJ UNBLFSJRO       OLLJ           
IGWDAS          : FQGDRXLMS       HKCHAHVNPAXWCQ  XUKSMOTUAOCIU   GMAMTDRDNLWWGXV LXLWHLCGO       IAHJRIKFAP      SUAADUSQYOPWSSH
ISSBPHVQNFEJ    : PDILIW          WLAWW           XIKSHWDL        EHNNV          
BVGSLEDQQMRAUQ  : QGGKVCLOWDLGQPW RKOHLHUAJSGCQJH XGOWXTYRVMEIP   JKSO           
UKBFFTIUEEL     : YYINBNVEPLH     KSVOH           EAYRAE          HRTF            BIXRCATGLVJFHA  NTIVTSLOTLHAHCT
JPDYR           : BASGGUNQWUH     CKHIXF          QDGDV           MUSKUJXMGJ     
IMMMRDGE        : KPDJCOUTPQARGN  CLWXCTAPKYNCM   KNSK            WNLHRNYUGARJVR  XJAMPOQYVSJ    
GBMLXYM         : WTCBKJRII       PDSRUUD         OGNSUVXGO      
EJLBPQM         : EUHOINHQIRX     IKSTFR          VRFJFMRVOEOOQBO JLUGCC          WAQNOVLYI       HWEUXOILTBTD   
CFMCYQMLDY      : QPUCQUMNV       DWUY            WETNSJQVQPVW    WFPGRMSEJOVNML  JYNQGIL        
JFKGNMUYMVOQCAC : NYNHDKTOQQQP    SHCRTONRB       XRTEYLLQNOWMKA  WJYX           
PUQYAVN         : IEJSBIGP        ROWO            RSMHVUEHKTIEBIB
UEQI            : IWNOIQQMHKHW    FTCMXIXWWLVD    XRSQV           YKQUWWTUXTX     DIPMKOECSU      GXCIK          
RMVAACNOAPB     : NDHSOUDXE       VMOQFBJEXRI     UNBLFSJRO       LHGSXOJOMUDWVQI JQYSPAXLPBE    
GRYGWEVTUWVSK   : CKHIXF          OFDEDQUFU       PDSRUUD        
PPSYCLNXLPCB    : UDNXFIWBDY      HEPGRPYAVEPIKDH DUSTHGDBHVKHP   REUUCB          QTVRQLVTTD     
CSIBYC          : YQJYITI         WRIUNLUWGOGXGU  SLLXMRHCPRMJFUC OFLXPPDLJO      NTIVTSLOTLHAHCT CCYW           
FBGDXEATWLWPD   : GJIUQPVUBI      HHCQMYYJDEHRBYJ VOVSFJIWEFDYCY  JLHJ            CAWJAYOHLKFS    SRSUA          
OFDEDQUFU       : CGVYX           GRYGWEVTUWVSK   PVXEN          
KNJN            : UPSCCQY         WPFBCRKX        HSQLLXLAHNJWIOJ WRIUNLUWGOGXGU  VFRFM          
MPSNXYLCYICMF   : VMCKNJF         GKHGMXNFLWIJGG 
PWGWBMCRHKMJU   : TSFCYRAD        MKNKI           JTPATUOHED     
SIQHALVXKJBM    : THMCMMJDC       KYXSSEMMF       DAVQFTHBSF      UMCVDGYMUVRH    HCAFGTYRCCBCRQ 
DYWWRUF         : XUAFHH          GOIOYKJRQDE     NDOMQSUYYMVB    YMLRRGPI        KRFXURAY        QXTQQEECDCM     IMHFKINQW      
XRTPCEFNB       : ISEQKQ          GWWIJNWUP       FFYUAIOTAL      FHCRTRUQ       
GLBQ            : NORXBQBTHRXO    TYTAKPPSNKRCPAJ GCFTUTPWGLTKVV 
OMLAXOOQTPNQJKV : UAAXFHGRT       TGKQLUGVUKXA    KMBUW           GMAMTDRDNLWWGXV
IOUBS           : TCJMIEATTICSHW  ACGPXTGNHDHJ   
IGESOPVFDKTOMSE : IRMXAWEJ        BKWU            JAYIJWLRNK      EBMQ           
JXRY            : QGGKVCLOWDLGQPW ECMND           XANJPBAJOV      MLYGC           QNEBGFXHC      
BMNEUEYX        : LJYOM           VQMV           
CIDGBSVWABKUQ   : JLUDYAVONNQBSQT WGSWN           LBUDCHC         CUBLRFQNPB     
PWYYWS          : HDMJBHRPNY      KDKDPXL         WQDJW           WPJFWJVBCXXFXR 
OVMDBKJCKHF     : CMMLMDHCKCPDTF  NPADLGSWQVFNIV  GEDFXBUD        RLKBHUSM        VURRG           DOKDNIUAVQE    
MNWHMWINHFGE    : IMWDYKAWMJY     RDKHQHKMODSLMVJ XICYFS          BFYEMFPYMD      IYMWV          
DFVBAV          : EMOIMC          NHLB           
WJUAVF          : EDUFNKU         RAXHFVFWRBWCFPA HITASXJYACLJGHO FYFTGE          XIKSHWDL       
GOJC            : KWBLFUBTCYQ     DOIJNTN         QDJHHQUMIRGK    VEWLP           BOHKLBUMTEYPKAR
XALKWVAGBHK     : OOYXFT          PPWRXKYMWWBF    IJRPAWDGYAN     HIKIU           IMDVHLYJIFJ    
KSTNUPERBBRYI   : RVHBPPUHHFV     MBFXTNCLJQBETB  NSYAQAXJYLRYFM  MDTJLQOTY      
GYGIDGKOQ       : FNEPBAVKL       KMUTU           HIJPT           SLFIQVKYTCBI    ABRFPSKKOL     
MRNNBBNL        : NAFXJYJTTMYYDX  CSUGDSDD        SWOESYGMECRJ    LQTBQ           GUXELYVIXINSAXS
HAQWGLBHFASCIR  : SDLWISPYIB      RRLDK           IMML            XMSX            PTEJKXPOD      
TURE            : LQEKU           KLWKSECGQWF     EVNT            SYJBDYRTN       JKNQN           WBGVKMGXM       QPMIFCVTOMJIROW
JOXDENGFBRDITUI : NQLBHKLCGCAQQF  CUFPVI         
IJKNLDQUUCOSTS  : VCRCQRJR        USEDFFCS        HDLSBRGYNCCPDG 
FJDKOSQVULAF    : DQTXW           VFTQ            VEJAXLVNLSGID   IQYP           
WNIFYSSLX       : XIRJWYP         RPKSOQ          IWTSMKCMFFSKBHX FNKHJWWFK       BNEUWQJVIWE    
GSPWNMPSRA      : HMOBOW          YCLUECJRYUWHPJX
FQQXMNJMVRLLAQ  : SGAQ            EYGCTKNVNDMDBW  CWVCEQBIXKIPT   JTWNMNXJFIHSG  
SMYQXHLOE       : AGQIOEEEGDFMTT  URJSXPWSCL      NJJXTGUK       
BVUUVSCOLBCCMQ  : QILLVWOI        QGBFMYBWK       ISMSLSLXJYVVO   NUWLRYTHK       QXTQQEECDCM    
GDLGTWBIXTHF    : KWNLNTJKHEAIQP 
XJKBGFVEABTN    : UAXSYL          FJVI           
VRQMRARE        : GERPQCHHFHESD   EQBSEXVD        HAHE            TWDOAMABS       NSKAQRYRF      
MDKWCEEH        : IJLFFANLQVRXCFK
ERYFAEEEGHXULVO : MTNFRKXF        AMGPQNYAWR     
LHEDLLRQVPSCV   : PAYD            JIUQQD          VHACFGS         PMLPKC         
RBWQIWXMBETCBHA : BFDQY           MPPETEIDOARLS   QYABFI          ECVCUTCFDIMN    HQKFFFEKSV      PEBH           
MLAQP           : VKOCHL          LPTEYVEDTJR     SRNLYLTJDUNCOSQ BMAMYQWBEC     
CHCAW           : HEPGRPYAVEPIKDH XOXGIKCAFWDXF   BVMDIVBG       
FVBWW           : RFVBPMTAVLJHH   LBOKTKL         DMMBR           QYBOKJUIDAKBG  
PFWNU           : RDCXAS          CEUUCVPHATFOLOE KKFB           
UQCXY           : UHKTISYWHSHW    FWJILGVYP      
ONQQEG          : PKUB            HYGRRW          BNEUWQJVIWE     YDWHWRQILBX     MSLNOTSTEAYVW  
JQHLPH          : WBBOAERXX       JXBEHYJXFW      DYALKCKGFOYSJ  
LKNKKESHTP      : PTRAARLOW       KKOILXOHBCHCSFJ
OIMNJREWIV      : ISQCMRVCGVIPSA  MLOURABSJI      QHPPTDMOCKFGNGD HAMGRHAYOQ     
RALKJYCSQ       : GUBTBHPHUFF     CSONAASHHNCQJS  WRXAKHD         XICYFS         
DGBNKTUHJFVS    : HVISYTLBP       TMSWVGIHW       PQYDIFUVOIIHRH 
LCLQCTO         : EOXDEFFQ        FJNIIHUXTGFDRQ  JECYRHXDQDN     TFIYHH          CLMKBNY        
NORXBQBTHRXO    : TXYFB           OPPRVJXETTGXTYP FBHEQRLAOCDM    GLBQ            YWMKBJNSUPOKQU  KPOKFUPRPNJ     RADQVSWFNRFGBK 
LBPJIB          : XRFOSYTODGOLGM  PVGYRNGKMR      XRTEYLLQNOWMKA  HIKIU           HVVBP           GKVDPOLALJSN    TTDFTYCABJ     
HVISYTLBP       : XBBQDUCUEGN     DGBNKTUHJFVS    JKNNNWQ        
HEPBEQRHMCBKSUY : UUDHRORXVB      RRERKJRGN       ABRFPSKKOL     
MIHNYOKJJL      : MDOGRQQWNJTFPAE ENICHCBNELPCPY  JRRR           
VOUXXBPYGI      : RHMUVMXHUHDFOB  UKJTQ           JKJCENJB       
PVWRGP          : LXGNUDJL        FNBQILSO        TUYO           
FMBPVQQ         : MYXWRXWTSSPHYUA EAEMM           YKISKKEGEWUTUIE NRYIXISS        XVIAXI         
DAVQFTHBSF      : EJTXXJ          YQJYITI         UQGCTSADBOWVKLM SOVY            SIQHALVXKJBM    HRHIQKEC        ETFAJUGL       
KGKTA           : SMNITQNLBL      IMVEKIO         QSNLUPBE        QGTRX           YOPJCXPOGDG    
PYUXPLGEOXA     : WESKKXX         PHHJJXUKYV      HTDJPKXBBFMJPFY HPTY            RGBTFOQ         MCGVIA         
PMLPKC          : VRHN            WURKE           LHEDLLRQVPSCV   YFJGQJ          FTAEJMFICURF   
HMYCTDMBQGDV    : BYEWJAQIWFYL    PITPCUQUTAVTJAM HAHE           
CQYTEFXSDAXUOLN : HDKVHWTVMBXSGSX KWBLFUBTCYQ     IHAVCHEDLTYRVKU MGNSEYHH        CHXF            PPWRXKYMWWBF   
QLJDM           : OHDQJK          PHEETVAHM       SIHEE           HGQWMDYLKRSMOXH IVBRDHAUVBXIIOF MOIBM          
WRXAKHD         : DWOCWSGBH       RALKJYCSQ       RVJEIKWMTGRNAIV RLHYFFFFXJTDBDH
HIYGCDNDVTFWO   : FWJILGVYP       OSYSLYQ         RIQAFIMLTDBC   
ICYYP           : ISQCMRVCGVIPSA  GUBTBHPHUFF     REMMVLJNBY      CLMKBNY        
ECVCUTCFDIMN    : DQTXW           PJIQSDEE        RBWQIWXMBETCBHA
NVURKXPG        : GPQU            UYGXYLUYD       EOTYIKDUTFBGH   AGGWDOMNQTQL    CWVWDKDXV      
MWBX            : FYHSLIDMQBRMSM  AUNDBNWQPKC     ULBSHE          WRTDOQO         RGUJGASN        NGKTMXOLKI      KFWOME         
CYRKEUGG        : PLMQN           WIHBCSYE        JLNLWQU         QHPPTDMOCKFGNGD
CIWI            : UWVBKTXXJHHCGNN YYIJMFVDI       OQHTQJ          LXHXHR          CSUGDSDD        RSUFRIOEGBGLHO 
LVJARFT         : GMCYVHEKBXAQELF WDXUO           PALQXGHD        DRONI           EUGCCANBRUUAJFE PGDKUWPPBW     
DJKJY           : UNHJWKPUIIQQCKT QKGPH           CTYMDNQSU      
MYMQXEBC        : TOWKDKABO       LQEKU           GPCUAJSQEIGNQWW
JKSO            : QITQLRM         BVGSLEDQQMRAUQ  SKAKQLVUBJYIAID
SWOESYGMECRJ    : BOMQTFPKHYEFTHC XOXGIKCAFWDXF   CBFFQRASP       MRNNBBNL       
CVNMKOYCMGFPHRC : SUMVXT          EQPTNVSBQNAK    ROKGWH          JFUVRDOQXKXHNDX MWLFIPHMCV     
GXTDNAXMJKSLCE  : YOMUISBH        BVMDIVBG       
HCPVN           : WNPWB           MPPALCKHSJ      UUJXHXEC        FIOYABXUSGA    
XRTEYLLQNOWMKA  : SGKYYYVKQUJP    NHBQ            JFKGNMUYMVOQCAC LBPJIB          CIXYHMVLUS     
NXOW            : TGNNJ           GPCQRGE        
JKNNNWQ         : YFYHM           YQXYUNHKTDXWXD  ESHMJQPMTAH     HVISYTLBP      
TGKRAEVYRJQFBN  : USTLMAXUCBQQUH  YDLESADGOEBLNWF
LQTBQ           : CEUUCVPHATFOLOE MRNNBBNL        FFOGO          
XCTJSKW         : KVWJIWWGJR      HHPHXWB         RKOHLHUAJSGCQJH LXLWHLCGO      
BCJJOBJUYIMLBS  : KWIFLNKOERRWD   NIDLLOWSSV     
PMAIJCYVACQLU   : QKJVKY          JNPEW           VGDHA          
KKGPWPGAYCA     : RVHBPPUHHFV     LCYPUGOXYRO     IPDVKTDB       
OLLJ            : VUPUQQBSCOJ     IFVPFNJRO       RPKSOQ          UXWLKICJQRTHDQH LQRNVJDKH       JCRTVYUQASL     PQYDIFUVOIIHRH 
DYALKCKGFOYSJ   : QSVREX          GLJIUETDKSFRSWY MJLGAAJWGVOJXJ  JQHLPH          JEAB           
GWIXTXEVYG      : RQKYEJR         WPUKE           UCYM            XAULVSD         KRFXURAY       
LXLWHLCGO       : JAYIJWLRNK      IGWDAS          XCTJSKW        
QQAAXPYTBCC     : BPJPKOKCGMCKDK  ISHOYJKEB       LQHVUFA         MDPIELOICUCYW  
MATNEQMNQ       : DANXQEDGEXRGT   OCQXFTQEAFWB    NUTPJGALNRPC    QNBKIPGJRJCVW   LQHVUFA        
LDYS            : TKTXNCQAXLW     QSRDNNK         RILEMVTYAK     
BCDQUWRUWHUQIY  : AHYNEIJLHFY     QAPWTKSLHY     
JLUDYAVONNQBSQT : GEGAAWKVIKTFT   BFFAFL          RGHUJLCWBH      WFDXASABIFJS    BUDREQARIOS     CIDGBSVWABKUQ   KRFXURAY       
RXNJT           : SOUWQRNTSFLXGV  XLFLYLJ         KBVKFDFGMCHHNH  WAQNOVLYI      
BOHKLBUMTEYPKAR : AJMKHK          TPBPQCKC        CICLOCXTVUSGP   GOJC            FGQTMIFTBOI    
QHVIIOYEY       : TATTCFHE        CPHXF          
FMEYYHPIREJ     : RYHXW           EAYRAE          OBHVGWLMTDJQGWJ YOGONR         
QGTRX           : UYWXHENHF       KNFTFMTQFNNKEY  KGKTA          
SRNLYLTJDUNCOSQ : OOKDWKHF        MLAQP           HISBVBW        
TRDMA           : JKNTCV          TMAWGUKLSWI     UDTGESSJ        BLGMV           FSRJXDVCLTJQ    CHGGBGQIPJHWNI  WGMPMSKX       
QKKHSHAQLUIYG   : MUBGGMCOB       VNMKHSFCNAYKEW  JGXQR           LQYCT           UMCVDGYMUVRH   
LBSQXISMELKXD   : OTWYDQPTWWODYRK TGQHQVUUODG     YKTHGEJINYPVULS
KDKDPXL         : YYIJMFVDI       RVHBPPUHHFV     VISUBV          DPEEJR          PWYYWS         
FNBQILSO        : KSJPBIALADBE    PVWRGP          OVVUKMH        
GRPWQYRFDDP     : TIUI            EDUFNKU         OEVWLUNALOF     UVYCLIW         RBLLVGOCBPMQSW  YAMAIFIYOS      HFRUHJRKPVKTT  
IFQN            : QGGKVCLOWDLGQPW PNSACROQAOFQ    VOBOKS         
TGQHQVUUODG     : RPKSOQ          CSONAASHHNCQJS  LBSQXISMELKXD  
UEPMTOFUGNAL    : HEPGRPYAVEPIKDH YATUVRP         JFKISAG         VRMMTBTRROTTQTW ARIKUQJT       
EVJWKCQSSYJQVEH : RLYGATCYNRMLRJ  AHIOVJRVESQ    
NRWRJJNYRLFFLTK : HKCHAHVNPAXWCQ  JXNJXSH         SOVY            NKOVNRPE       
PTOCXIUSJFLFLT  : QTDMDRUMXORYA   ETTWROXADQV     JYCSYNLWEFAFFXT NNVSATOK       
BNEUWQJVIWE     : VFKYHV          PKUB            IBKXFVU         WNIFYSSLX       ONQQEG          NHKRSC          JCRTVYUQASL    
IAABRWRUUAROLYC : HNFUTXENO       CWVWDKDXV      
LVBMJGIJYTH     : PDILIW          IBDOPAFVP       RVNGSTJEPS      FYFOHAPNA      
QLYBNYEGVW      : MBWOELU         RLTT            FKFO            DNNCHXUUH      
RYUILUK         : ECDOXVXXO       THADPBWGDPIS    WFDXASABIFJS    QGWHC           LWXXEBAFN      
IJGWUOFENBMWTAV : RWWQWBKWSWVG    FJNIIHUXTGFDRQ  IMML           
QVAWRYALYW      : ADXA            KIPOSDH         GVAGXE          PLVEQNKC        ACGPXTGNHDHJ   
MRJRAS          : SLLXMRHCPRMJFUC VGGPFDISHJYMJ   LHKMKLVEBDGGF   HWEUXOILTBTD   
XPNFUB          : DRQLLRMEPCNPPQG CAPXKDFODNFU    QYWTTBRBSYMKLNC QITQWPWTUEMH    FIOYABXUSGA     ABDIIGWPIBK     WROIE           LQHVUFA        
JBDLWBCSEYND    : JFDCBJKCJ       HFFMXCUV       
BEYXQSJIVCJ     : DMNHSKE        
TWDOAMABS       : ASFYXXRU        EVCKNDNKOBQHP   PMKU            SBLFQRX         HXXTIKVBCFDPUC  VRQMRARE       
BTOVXQLERNISNA  : ARLYPLBQYTNNDV  KYTXOUOL        WJAGFIXA       
WIKYRGUQJKT     : LYEFNY          ISEQKQ          QBREVEOB        YDQJLCTRRRM     UAXSYL         
MWRYXNQW        : YITWNN          PATXKLGAEIYO    FLHW            NXRYQTBMEDOJJ   UAXSYL         
HISBVBW         : SVTSNUPHNLYXKVX MRGQD           LJCIERIPII      GIYE            SRNLYLTJDUNCOSQ
BLGMV           : HBRCOJXLJMOR    TRDMA           FLOXNMLEQPOB   
GEDAPPTOCSIETW  : MYMNMLGHRPEDUW  BKGCJBG         KLWKSECGQWF     QDBFAXFQGJA    
QNEBGFXHC       : EPWFSXJDIXWAFYD NWINBBVMOSNBMA  METDQTXNO       JXRY           
LNSXLAEPFGGWAW  : VIOFT           WROIE          
VGGPFDISHJYMJ   : YWPSUNDLIRBRL   DUSTHGDBHVKHP   AFVCROPFNAIX    MRJRAS         
RTTHMTTOBL      : IOWQPHUFJVF     TFIYHH          QWYLVUTKDDFYU   BNHCYQEX       
HRVKPXGXGX      : SGAQ            GLGSPIQV       
JGXQR           : VCAF            KSRTADHPBKWQLJ  QKKHSHAQLUIYG  
GCHAXEHMXD      : SPUKTCBEHUCD    YNHOBJA        
BPAJJWTBUCYC    : BFDQY           DPCUTATJPY      NDQLFQHOW      
ENICHCBNELPCPY  : WGORQCL         QDJHHQUMIRGK    VDGJ            JDFMECVRNPNQUX  MIHNYOKJJL      VOKSKKDEACTYT  
PDSRUUD         : TETUGXHP        GBMLXYM         GRYGWEVTUWVSK   UOOMCVDWTXQSGK 
RYIPBJTDOH      : KWIFLNKOERRWD   RMDEAOMLDKRNSGF SLLXMRHCPRMJFUC VOEMEJHAILNTJ   DEBLWVIMIAHDUM  KILQLXIRSQPEC  
SOPWEWKTBCV     : VISUBV          QKVRTRAQGP      DQTNTTKSAGUGP  
RBLLVGOCBPMQSW  : VJYXVJYVBBQVC   YWPSUNDLIRBRL   GRPWQYRFDDP    
XNTLIJEHN       : OAQECQMLN       NBWU            VTAAU           FUPDUJ          XROYYY         
RKEVGWQHKC      : DRWG            UCFMYKDPYR      JTLFIRJNYLW     GOHGJ          
TTJWJWNFVADLTR  : FJNIIHUXTGFDRQ  LRMCCUUANAPJQ   NFVXTCLCQIKINFS NSJKVMOWMG     
FVETYXGF        : TVTGHWOMQYEAKD  YLHLXDQT        UCQSLFQIDXXY   
OFLXPPDLJO      : RLTT            BOOLH           CSIBYC          GKHGMXNFLWIJGG  HDQHHDGVFNBO   
VNXBJA          : WWQJSGGKFPFJLBX BDCGMPF         YSUJCBQJM      
UUXRATXVUVED    : PUUECOYGINTN    TTOFDRRPLAMAAEA
SIEQAU          : HBNAYAVRQFXFC  
MGLWEYXHJXOGUMA : OVYOHYTAV       CMKI            XHRXBHHARHJBJ   XVXAVYMIWNSVNDT
JATGW           : HEPGRPYAVEPIKDH MLQU           
JRRR            : FJCAPCDJQWDIPXK LJCIERIPII      MIHNYOKJJL      NOIXW          
LUTHH           : SCNMND          VBBDYESALWLL    VPWV            SQAGFYFLYBQXBK 
SGHSEQEFFKAUNX  : SSUTEHMHJNNPUX  AOWTHP          ETTWROXADQV     GGEL           
NUMMTWHN        : LSKLYKBHPQQ     GRSTNLPTSTDNX  
GYLAJUECENU     : BIVWLWVLAS      RMDEAOMLDKRNSGF RNQYDWRCQLTPDO  AUJRHETEMXBBJ  
FBPMOQHCO       : KVNJXTBFY      
RJBHFAOVQUWFWG  : TPGOLLY         TXYFB          
BJGPGPWIHJWXRB  : OQHTQJ          WNASLIFHUEHP    UHCQUQQUNVWE   
HUYICHISDCNCHM  : MTFOJTSICP      PIGBYVSHCKQ     IRISBPNAW       IAKTQNDP        BFYEMFPYMD     
JOSQGBIDLPMIQGL : JECRVF          BIVQ            ABDIIGWPIBK     DOKDNIUAVQE    
OHHWJOI         : QWUNNUTKEV      VTAAU           OLSLNTJKWVXRJK  DMMBR          
TMSWVGIHW       : DDVM            DSFGOGIJDQPF    DGBNKTUHJFVS    LDIODTWTKGRNE  
AFEKIQ          : BASGGUNQWUH     WVLLJNUIUFFXV   XWGAPYKTGAG     JKIKJFC         OUVBHG         
WBTENASWJRIBAN  : VJHVBLJGJITD    ERXAA           APITKDEQWSCW    RRERKJRGN       PGMTJKTDFLGDHOB DTQOIBCF        GAUNWBKYMYFD   
OJTKRCS         : AOWTHP          QBUWIBX         NWINBBVMOSNBMA  JNUGLTJGKQMYUYO HSMSONB         BLRNRGFJ       
HSTMEEFHBIDFX   : YKIBYR          OBBTQDBRPC      ABCM           
XUMQEN          : VFKYHV          AHFC            TXVNYBUVHHPUK  
RLKBHUSM        : OVMDBKJCKHF     SCBUATSOBXT     YNHOBJA         AABYM          
JTLFIRJNYLW     : MLYGC           IXYSWFQT        KYTXOUOL        RKEVGWQHKC     
QUHRQVKWMFOXPS  : TLIAKO          LJEIIIAMSPRMM   HHCQMYYJDEHRBYJ YWMKBJNSUPOKQU  YOGONR         
NNTDXOQDWI      : BYLVSPFHYQVNHSN IQYRAYJXF       XWLBPGJ         IANE           
LJBKLTH         : NRPNEXIH        PLTHBMCYKVDWD   XXXDTCKVFXR     HWRKFAWEIG     
NARXWEGOE       : NMHWUNHNA       OIDLHHOJWKGOMUW TUCTJLGFS       DNPXCXTW        SWARUSQSUCKNT  
HLLUGRUUI       : KHXLPAXLAXUKQ   JKJCENJB        SFUJN          
TTOFDRRPLAMAAEA : WLXPHGWKFSIIAUR GLIPHRMONRVASH  UUXRATXVUVED    IAKTQNDP        TTDFTYCABJ     
KIOOHXBUSJOQEAP : DNDFEDE         WLAWW           QWME            LPXXBJ         
TGGWXAMLA       : YKISCV          KHYJLVCMNRX    
LDIODTWTKGRNE   : TMSWVGIHW       QCKOCFAMMSS     QUFIO          
WSDD            : SVOLNABFFOE    
UEMBK           : QJRX            ILKCEP          ERDOMIAFWWNK    KMFYMPYYYE      OAQGJWXSQOEG   
BKYN            : XIRJWYP         XJPEKOPHMIQ     JXBEHYJXFW      RHCXEWE        
BBSKPXGPR       : CWOVDWILNPUBQU  ERTY            GRIMXFELMTEL   
XLHCXEXCKQWOGB  : MLYGC           TAKWIO         
QCLR            : NYYEUIP         PBYHDI          HFOAKQAM        WMHBIVPEKJFLLEI
BVRVIJT         : MKNKI           XROYYY          AKWHSBSIBELT   
BNHCYQEX        : CBFFQRASP       IEJSBIGP        RTTHMTTOBL      OLSLNTJKWVXRJK  RIDLBMLPBDJ    
CAGVYWCAVUD     : XGYMSXXJIRBQKKL VOLHLASCWBQJB   HFAJDSWYIST     YTSUOSBFGMVI   
MUNKMJSYEJ      : WWFRPWW         JXSCCXWBXADQGJN RNYYQVHWDWTCWA  GVAGXE         
RRERKJRGN       : HDWUXLJOFDV     HEPBEQRHMCBKSUY WBTENASWJRIBAN  NRWOXXD         QAEAG          
OLSLNTJKWVXRJK  : GJIKBFEQYELHUV  HLJPADVX        DMTSSHDSOLAC    OHHWJOI         BNHCYQEX       
SEIYNKTHPNSB    : QQPJKJEH        YITWNN          WOLXGFHYGBYFL   LHWWXQOPIRFIO   NHFY            MEDADUEQAOJPPIA IQEKUIF        
BOYSDRGQ        : NFEHF           NODJW          
QCKOCFAMMSS     : IIHR            QSRSUMELLRROHP  LDIODTWTKGRNE   FHKLQYUK        JEAMVGNNDF     
UJHOQWCLAJNPII  : WESKKXX         OTNF            TXGDRRPWNY      PVXEN          
AOLMH           : JXBEHYJXFW      HOMTHE          IJLFFANLQVRXCFK
WVTE            : NXKKTLGQI       AENAOYGHBNE     WBSIJRXTSIC    
JQRCNOLXDF      : KPDJCOUTPQARGN  HAHE            RILEMVTYAK      XLVXTVFFWWGSQA  BPSYDCCDLTBJA  
HQXQGPYOK       : BGCMLQABPYPCRU  PAHM           
EVNNONMIRIRLC   : FWLNBMUEY       WAALLS          ERXAA           NDOMQSUYYMVB    KTJXERSKI      
BQIB            : AKNWLAFIDBN     LYAXNBKBN       DWOCWSGBH       ELRSJYTUEHB     LRMCCUUANAPJQ  
PYDH            : JYLUA           MOIBM           WEAYQCFLTW      FGCFPGSINPMXOEG HIBGXYEMRWSTMOX
VPMWFWYLUOYJEL  : UHLDNUD         GJIKBFEQYELHUV  LLPVLPJXASDBJBI UQGCTSADBOWVKLM RYCJLCEUHUN    
YWMKBJNSUPOKQU  : NORXBQBTHRXO    QUHRQVKWMFOXPS 
NSKAQRYRF       : ROVCTBBMA       VRQMRARE       
GGEL            : QWTOBMBNMCXIWP  QSNLUPBE        KEHXBXMYKRYJ    ULBSHE          DPCUTATJPY      SGHSEQEFFKAUNX  SFMDQ           HIMAWTBOE      
YKRNWSAMNWEF    : VRHN            XANJPBAJOV      OOVAB          
UAEIS           : TXYFB           WLVNFQAXRNJDN   PTALBBBJIJRFVTC XUAFHH          DVTSVXTRB      
KLIJ            : UMLKM           IRWELY          JFUVRDOQXKXHNDX XOXGIKCAFWDXF   NGLUIPDSJK      QEQWCTN        
NGKTMXOLKI      : IEGWDGXI        MWBX            NCTDINXKUDU    
HEDTRABWK       : KMGD            KXDWXYDWTCYMQOO FUPDUJ          TPHO            QYADECSNNT     
YQHSHRGRE       : XJFEHHGGPMABMFQ TTQFDLNCPTIDN  
HKUDWUUKFDNMJ   : VCYFOFV         HCAFGTYRCCBCRQ 
ICRLBEIBUPV     : MLKHDYQVGDT     IKJCYGPWSR      RIDLBMLPBDJ    
JCVNMDX         : JKWKQDEPIPWFN   JSKLIEDLY      
JWEEHLJ         : TOWKDKABO       DDVM            WRTDOQO         DUNRYLGK       
ATPLXHWYMFCJ    : JDOHOFPO        BFWFQYK         TBUVNNVGWFD    
XOHBKUPQVAAUG   : PNSACROQAOFQ    HHCQMYYJDEHRBYJ ICEWKSJR        WBGVKMGXM      
FUPDUJ          : XNTLIJEHN       HEDTRABWK       CRFOHUFHYBPY    FLQVPUNPNV     
GHAEJOJL        : VWJRKUISKAPRNJ  IGRFJMTUXQ      QBBOQP         
JKNQN           : UDNXFIWBDY      YTNABFTGI       IUSEMP          TURE           
NDQLFQHOW       : TQMCDIJYEMWF    TMAWGUKLSWI     DLTGVL          RNYYQVHWDWTCWA  LWDP            BPAJJWTBUCYC   
JNPEW           : ONTYJMHLQKFAVE  PTXQFEU         RWFLSRIYBXHLWWD PMAIJCYVACQLU   CWVCEQBIXKIPT  
NHKRSC          : FIHJMK          BNEUWQJVIWE    
EBMQ            : MLKHDYQVGDT     UOAADXY         JYEXIOJHPIJHCQK IGESOPVFDKTOMSE
FGQTMIFTBOI     : EVCKNDNKOBQHP   IJSGVFMYGR      BOHKLBUMTEYPKAR UKUYVYVNEH      TTHF           
BTMSBLDOUQ      : HGTQ            VRCSMFCK       
NSLSVB          : UOAADXY         ILMMD           ABUBQWNMM       KIVUONA        
MGSFCHNIBPY     : PHEETVAHM       NKNNYPVCC       IBDOPAFVP       WVIDNX         
QDGDV           : FMELQO          PLMHSOYPKJG     JPDYR          
QCXMSGA         : PHMGXFXYPIGV   
UUJXHXEC        : GLKIPK          GKUVLOXIEGLQHE  UHKTISYWHSHW    HCPVN           UIIRJSOFUKWJKRH KRFXURAY       
HJTR            : HTDJPKXBBFMJPFY DISUSVABWW     
LQYCT           : DRBMEKXUVFXR    THDUFG          QKKHSHAQLUIYG   ANXBMMWYMNX    
FSPVUQIPYLD     : MWDVKKCMPHL     FFYUAIOTAL      RDPEO           MLXNISGNUICT    CWVCEQBIXKIPT   LHEFGIFXYSP    
GORPMYTPIF      : VISUBV          QITQWPWTUEMH   
ASWSRYNXGIQDD   : SFCMOJF        
NUIB            : YDTOYX          XUKSMOTUAOCIU  
FIOYABXUSGA     : VBBDYESALWLL    JXTXKYMRMILJH   HCPVN           XPNFUB          HVFRL           OCQIQQLYMXOS    UMCVDGYMUVRH    VYEKKFPBFQKF   
FIOYABXUSGA     : EUWJHTPKOFTMML 
ISCCLERLKAEP    : DMNHSKE         TQKAKMDS        AAITUYKRPYPWQME
NEAWFACPOB      : CMKI            KESHOSK         UQKUNEVVI       UMCTTOGMKG      LHEFGIFXYSP    
PCNKKNPTJUXWY   : ARUSAE          LWKBCPBQBVASA   WIJOQAISFKODW   CTQBBJCVTFA    
IJRPAWDGYAN     : EGCGCJPJLM      CWUXTYGUBGRBN   NGAVQMUPT       XALKWVAGBHK    
EEPIWFKKR       : JECRVF          ARLRFEEWUHQ     LRMCCUUANAPJQ   XAVLV          
AKQJFOIGGRPXJR  : NXDFPXKVOVE     YOMUISBH        WJPGCCR         UKLIJ           SWARUSQSUCKNT  
MAVPOW          : UOHDMBKPCILIRO  SHCRTONRB       FUVAC           VRMMTBTRROTTQTW
UMCTTOGMKG      : IHHUVHBVU       NEAWFACPOB     
DSEUBKBUCCE     : OBBTQDBRPC      WWTR            XJYACTK         ASSOFWKJWGHNYP 
BTWXJLWDI       : RMKOUHBJ        BIVQ            HCAFGTYRCCBCRQ 
ICEWKSJR        : XOHBKUPQVAAUG   UFKWOXDQPPLLK   NIDLLOWSSV      CVLSCIAXAFU    
PMTKPG          : MSDEBWJVUSHCR   GKDVWA          JNJCQQMEQEX    
NJRRITNFTWTQD   : CIJJEAFB        BLVIOFMMYWMQU   WDQVI           HBNAYAVRQFXFC   PXLODNFLQMPGGQI FTDLUOLOQUUET  
BLHIKRBWLTMAP   : LYEFNY          CJLL            CVLKXCCXVAQ     YOPJCXPOGDG    
QWME            : EEARMVTFXWUO    KIOOHXBUSJOQEAP TUNNWAGOSTAKVR 
FXQYMXUJRLOWPA  : AVPMQX          DLRHYHBEIG     
ANXBMMWYMNX     : IRTKIFLSAVIR    NMENM           RMDEAOMLDKRNSGF YRSSQTEL        LQYCT           MWLFIPHMCV     
MKJUPI          : TOWKDKABO       PQIWUBEDTOMYH   CCYIHXPY       
QULLGGAV        : WYEOOFQFBXEE    YTMERIWQSCHUMCN
RXJRN           : LVWNPHJQYDLODJ  QWTHFEOIITPIBE  UUCKCPIGTLLEV   RACTHBK         USEDFFCS        UQIFNBHJBOQF    XVIAXI         
UAXSYL          : TIUCDUOWP       XJKBGFVEABTN    WIKYRGUQJKT     MWRYXNQW        KBVJC           RXVUMEMP       
WQUKDRCLF       : WESKKXX         JNDSWVP         VFRFM          
ISHOYJKEB       : ACGPXTGNHDHJ    QQAAXPYTBCC    
NSYAQAXJYLRYFM  : NMHWUNHNA       MPPALCKHSJ      BXIKWKRFQ       KSTNUPERBBRYI  
IGNTNJC         : UYMCHCKTJ      
RSIDEMFPDAOFQQD : NMENM           HGQBBKB         DHCYQPCOISULGV  XFREHLWLOIN     LGIKCLKLDR     
QRTRWIDFQSBEDFL : CKON            TXKJ            DUIQAOELHQW     SBAGGDK        
XVAEIFVNINS     : ABDIIGWPIBK     BXMN            BTRRCWIUKYC    
EYEWQXOPJT      : CSLD           
ANXHQFS         : NMMAPNCGUS      MCGVIA         
DQPKBXGPG       : JJEPBUNBVVU     GKHGMXNFLWIJGG  BMAMYQWBEC     
KHYJLVCMNRX     : FCAAUJO         RGHUJLCWBH      GLAQXURODX      TGGWXAMLA       DDNHFTUBHV      NGLUIPDSJK      TTDFTYCABJ     
OAWOHPTCFA      : UFJTEQLF        WJPGCCR         BFQA           
VKUTQMANWJOJV   : DOIDYUPWGHJPGN  FMBTQ           WVBVVUQSOIPCFA  KTUCIBKMARTN   
NIAGI           : GLKIPK          VLWGVERYIIQO    SKKC            FFPPEUPW        HGQWMDYLKRSMOXH BRTX            VBHYAKW        
WIJOQAISFKODW   : FRUAHNGM        CHTCKUOJ        PCNKKNPTJUXWY   XWXLBSQNGN      RDFTSKTHX      
WQXYEWJSI       : HGTQ            AILKWJPMIXCDRG  KNFTFMTQFNNKEY  JKIKJFC        
HWRKFAWEIG      : RLUDVRBCD       QYQGGVGXCUSDQHH LJBKLTH         HIPYKCTQCCL     HROWE           CFTOPWJJAJVFOI  GXALONODBHHOGY  HCAFGTYRCCBCRQ 
BIEWQOLTMWTD    : WRTDOQO         JLNLWQU         QCHX           
SJTEEDLLCFVH    : HGTQ            WHRMOSBM       
SLQCHRKLQBCCX   : AUNDBNWQPKC     IMVEKIO         JXCERHDRUDBBHM  UEVWQJD         MWLFIPHMCV      WVGPV          
BRTX            : NIAGI           OSDWJ          
FSRJXDVCLTJQ    : CWUXTYGUBGRBN   HEKPLRMMP       TRDMA          
WJPGCCR         : BOBKSORKQYOYWOY BKRKCFJC        RLRYSVTX        AKQJFOIGGRPXJR  OAWOHPTCFA     
GUXELYVIXINSAXS : GERPQCHHFHESD   YOBNCTPXOCJ     IMJTTUBTPS      MRNNBBNL        UIKBBGRN       
VURRG           : NTYAGG          LRFDAMFWRP      OVMDBKJCKHF    
FFUWMYCETIBR    : NEVAH           LSSXRDUJLKN     GOHGJ          
NTIVTSLOTLHAHCT : KMBUW           UKBFFTIUEEL     CSIBYC          PUAQQFSAJRKBV  
KEHPYHEXJJURK   : IJMAVKWTNDJPJLK JCHNPQ         
GAIQXEJKSF      : BXYRTBYQPVBPS   EUHOINHQIRX     HMNGTSEVLEXVJ   NRWQXAMNPJCACL  LNVNKOGFSY      RRLDK           TAEICNOP       
CHGGBGQIPJHWNI  : WLAWW           TRDMA           EULV            CVVHQTXUIFGANP 
YDAMRIM         : KRONKVLHGGJAO   NOIXW          
YLHLXDQT        : CLMKBNY         FVETYXGF        IMDVHLYJIFJ    
YAMAIFIYOS      : CIABTLOQGG      IEIUVKEMJCLO    BDVFNHF         GRPWQYRFDDP     LQEUEKXPIOX    
DDHCGJOASEDTR   : AMGPQNYAWR      JMJNNOHFYYIVLE  IVGCTOBWPYGGHXE
FPQYJ           : HKCHAHVNPAXWCQ  EIGUFBAQYJMXH   IUAXNDQWQCBCKE  YWURLRMXRJE     RHCXEWE         FHKLQYUK       
XMKAUQ          : GHCWDKPANM      RAGFKYARKPL     OSDWJ           GHBYOGLCJ       XHAHSKP         CWVWDKDXV      
VHGUKJEPR       : OAIDICS         DDNCGYSKFYKV    YNFF            IEEDNMJ         VUEFAJOC       
GRIMXFELMTEL    : TFRXTADMKEWK    XHKYFWPANOU     QHPPTDMOCKFGNGD WGKROGAAACHNB   BBSKPXGPR      
CLSPMNGAKNGHB   : NGAVQMUPT       EULV           
LSJB            : ISEQKQ          CDHEWDN         IPDVKTDB       
DMMBR           : KIPOSDH         LIKPJANVDTK     PATXKLGAEIYO    NNMMRYGOYXYDLHR GEDFXBUD        FVBWW           OHHWJOI         QTTGJFIOEIE    
DMMBR           : MEICWCNUQEAFP  
OGNSUVXGO       : YWPSUNDLIRBRL   HHPHXWB         SUVSHACLMVW     BQVJBAHBSSVRM   KNHX            HHCQMYYJDEHRBYJ GBMLXYM         QNBKIPGJRJCVW  
OGNSUVXGO       : TAKWIO          HXPMFB         
UEVWQJD         : OVYOHYTAV       BGCMLQABPYPCRU  SLQCHRKLQBCCX  
MWLFIPHMCV      : GQLUOHEGSSKRI   CVNMKOYCMGFPHRC ANXBMMWYMNX     SLQCHRKLQBCCX  
VOHCECWAAG      : YKISCV          WNPWB           BONQTHDNPC      KOBGP          
PBVLYOXEPKEBS   : VVODF           ADSRIK          FYFOHAPNA       YATUVRP        
SCBUATSOBXT     : DLYGBOWISSTIFBW BLUGDNEFJHHRUAH RLKBHUSM        PSXNJCX        
WVIDNX          : ICVP            SAJEQJECLFYVVAA XUKSMOTUAOCIU   PWGUP           OBPO            MGSFCHNIBPY     MUVYS          
LKIAKMPUS       : PNIRHWP         QJFQKTD         CWUXTYGUBGRBN   QDHHFMKKIUOJI  
PGMTJKTDFLGDHOB : NXRYQTBMEDOJJ   OOVAB           WBTENASWJRIBAN  XVIAXI          INKGJTOHUSWOEIH
WGSWN           : QCWVLGFARQAQANT KSVOH           CUWBLKIYGNIJ    CIDGBSVWABKUQ  
HVFRL           : THTP            FIOYABXUSGA    
PESHMIEWUXCAJL  : NIKYFXMWIM      XJTBULXP        ACGPXTGNHDHJ   
QAHWYNP         : OIPJSHGKURPK    FCAGDHTCUPF     GERPQCHHFHESD   VMRXODHWKWDQLNA BIXRCATGLVJFHA 
EUGCCANBRUUAJFE : TMAWGUKLSWI     HGTQ            ADSRIK          KMBUW           GKDVWA          LVJARFT        
AENAOYGHBNE     : CGOPVYFASYXV    OGIMMTKOUNMSLRO WVTE            VFRFM          
CUXIPGKTHBUYV   : HJIIU           PFGHHL          TUTDPQWFOAJJNV  QHPPTDMOCKFGNGD HCHN            XRMJVIWHICLGAM  WROIE          
BFWFQYK         : TKDYXCEMOOQANWD YKQUWWTUXTX     PITPCUQUTAVTJAM ATPLXHWYMFCJ    JUALOQKBL       KRFXURAY       
ABDIIGWPIBK     : UTDKCNOT        AWVLCHSLX       PRXVYHVPG       XPNFUB          JOSQGBIDLPMIQGL XVAEIFVNINS    
JCRTVYUQASL     : OLLJ            BNEUWQJVIWE     MFCAPCUEMXTFTM 
BIJRKVV         : OYPBPNQHDULN    WSFHCXAPLTYRLDK
WBSIJRXTSIC     : GEOCAYKTQRJRKAQ WVTE            FJVB            XLUAB          
MVYIUVBV        : BWJQVRIHW       MVDTFQEWJBU     CRUPFGIWBG      FGCFPGSINPMXOEG
MASX            : GQGIG           JHHVIURYUOPODOP PBVOEYMMAVV     UJLQIDFMFJ      IBDOPAFVP      
KIGIUDLPNWILQD  : UXAIKGAR        GRSTNLPTSTDNX  
UIIRJSOFUKWJKRH : VQPSOVHWWNRIDAX ACGPXTGNHDHJ    UUJXHXEC        CUBLRFQNPB     
ERDOMIAFWWNK    : TXKJ            SFEEUNPJNWQGGIV OYHUVQSKR       UEMBK           SWARUSQSUCKNT  
SJLBRFMLTUIH    : JPLQRLUFAKDAT   IPPUXWHFWD      UDDFRBFKMYR    
RTMC            : BFDQY           USTLMAXUCBQQUH  RVNGSTJEPS     
QTTGJFIOEIE     : ETTWROXADQV     MFDFGAYWDXQ     DMMBR           GPRPVIQYVTTLR  
XWXLBSQNGN      : MWXQOXJGWHXMB   WIJOQAISFKODW  
QUFIO           : RQVBXI          JBLXETMX        LDIODTWTKGRNE   UFKWOXDQPPLLK  
MGKHCS          : JYUJ            EOKPCKQKRIQ     CCLNVXQYE      
HCHN            : TXYFB           QGWHC           JBLXETMX        CUXIPGKTHBUYV   YDWHWRQILBX     UDLGSLTHWXX    
LFMIFYL         : OGCVWSPDUCYMR   ECFRHDTN        FRKJRXJPQIFXKN  RQQVRQCFF      
RAGFKYARKPL     : QVXCJSFRAAQTXUG FNRKMHPJAVM     XMKAUQ          PCOLLNOSBPU    
XWGAPYKTGAG     : NPYDTYBUTMYOHPW YKRNFLLWQIJ     BDVFNHF         AFEKIQ          VEKHGN         
FTDLUOLOQUUET   : NJRRITNFTWTQD   KRFXURAY       
VEOIC           : GPQU            RDCXAS          NLOTA           UXMGXDPAFWE    
HIPYKCTQCCL     : HWRKFAWEIG      WXSGEROLUTQDGPL
VOVSFJIWEFDYCY  : FBGDXEATWLWPD  
RJHGSSXSD       : WESKKXX         WETNSJQVQPVW    XRWXEPFXLXK     JEAB            VXBFJVEAGKLTNQ 
MTFQHPPXLIEUQ   : WNAMYYSYVVRAO   IAKTQNDP        XAULVSD         IMDVHLYJIFJ    
CXGB            : FBPSQNKWSX      SYEAQOIPV       SJRO            DMRJJVVA       
HGUROBKHAFMCRGH : HKCHAHVNPAXWCQ  MMQDOHDUDUBDC   WEAYQCFLTW      BXMN           
QYBOKJUIDAKBG   : QBACQ           KKFB            KSRTADHPBKWQLJ  FVBWW          
EOTYIKDUTFBGH   : NFWWOTVAJCQVRJ  HJCQGUOWL       JNJCQQMEQEX     NVURKXPG       
PRGGQ           : LYEFNY          NKOVNRPE        LCYPUGOXYRO     AAOYSPK         VNBWCRW        
WETSOYSBACQF    : DMKKXQEJB      
KGBX            : GDVNURHLUNSJ    MJLGAAJWGVOJXJ  FVANTEE         XEAXWIQ        
XROYYY          : RIPQAUKLPW      LHWWXQOPIRFIO   JECYRHXDQDN     TSGIUXVVYL      XNTLIJEHN       BVRVIJT        
OSDWJ           : XNCWEQWBXNWG    XYXEQXIIW       BRTX            XMKAUQ         
TPHO            : ETWMMOKHRUJLWT  HEDTRABWK       BFYEMFPYMD     
GKHGMXNFLWIJGG  : SJBUKP          LJEIIIAMSPRMM   ULRHAIPBMRTHLD  MPSNXYLCYICMF   OFLXPPDLJO      DQPKBXGPG       NWKW           
XICYFS          : TXKJ            HAJMW           NDOMQSUYYMVB    MNWHMWINHFGE    RALKJYCSQ      
IPDVKTDB        : SKTQYTYHHC      RSDKWGPYEVPKFRU KKGPWPGAYCA     LSJB            UIKBBGRN        SFMDQ           BAPJFDCVXM     
JLKSAIG         : FUJRAKOVGQFWEXX XOXGIKCAFWDXF   YGESHARYUDDE    IIXQYJRCGLDYOPL ODBKU           SYSHD          
VFRFM           : OQHTQJ          KNJN            WQUKDRCLF       AENAOYGHBNE     HFFMXCUV        XJIOQECQFTVUOGH
JMJNNOHFYYIVLE  : UPSCCQY         JTATBASVIGAJCS  OWTR            KMBUW           DDHCGJOASEDTR  
NHLB            : PNSACROQAOFQ    NAFXJYJTTMYYDX  EVBBDJPHAKQQU   DFVBAV         
ECCMJYSEGH      : OGHBDOSX        IXYSWFQT        AWCMHEIHSDWGIC  KQGRIUJBSW      QLRGX          
RTOIHFRO        : YLYRUDJT        QYADECSNNT      SFMDQ           TSOOWPNUFRWH   
QYADECSNNT      : DIVUSPABG       HEDTRABWK       RTOIHFRO        EUEMCFG        
RVJEIKWMTGRNAIV : HWWSNDFOQNPG    QBREVEOB        FUDLPVLMDDT     WRXAKHD        
NNATHAWKGYDT    : BKGCJBG         MKNKI           FWJILGVYP       JUALOQKBL       CTQBBJCVTFA    
WBGVKMGXM       : PWRMJFNXA       TURE            XOHBKUPQVAAUG   QJSKGFPRR       DVQWJREJM      
RSMHVUEHKTIEBIB : IVMGXXYDPBFIUEF ILMMD           RKOHLHUAJSGCQJH VWJRKUISKAPRNJ  PUQYAVN        
OCQIQQLYMXOS    : LDVRFIERUIBWUGM FSQPL           FIOYABXUSGA     XAULVSD        
DNPXCXTW        : SBYJQEJBNIYN    NARXWEGOE       IOMVDDSWD      
CJXMPCUTNLVHVP  : RYHXW           FICGPPQPL       GEOCAYKTQRJRKAQ VQRRSWB         GOHWP          
HQKFFFEKSV      : PHIO            KHXLPAXLAXUKQ   RBWQIWXMBETCBHA AGGWDOMNQTQL    OAQGJWXSQOEG   
UVDTAH          : HMNGTSEVLEXVJ   RYVLXVHTWWJDSJO WIHBCSYE       
BTUDQQSCNAA     : RVHBPPUHHFV     MYIFHXXLT       VCFCGDFRBGN    
AHVMPERV        : XCPS            QLFOERUXMALWAJP
MRAJQEFQNKT     : HNWXRARER       HWINOYKSS      
IWDYSIOSIVT     : VTYUQCKSYSJH    TUNNWAGOSTAKVR 
UIKBBGRN        : QBACQ           GUXELYVIXINSAXS IPDVKTDB        PVEJOGRTSXGA   
SAQYFKMSEYDC    : EQPTNVSBQNAK    COBWDYOT        GAQFN           UCFMYKDPYR      OGIMMTKOUNMSLRO
EULV            : WNASLIFHUEHP    CHGGBGQIPJHWNI  CLSPMNGAKNGHB   XRMJVIWHICLGAM  FGCFPGSINPMXOEG
TRLMOUWPXFINIB  : JXSIVPRLEIQ     YBHOFQHCUDPNOJ  UDGOJGMNLIYEWPG TPBPQCKC       
YCVJOOQOTUR     : HEPGRPYAVEPIKDH PKBBUTAPBMM     RSEVDHI         QHPPTDMOCKFGNGD
RFTHYOV         : IGBMFIQCTUEU    FJVB           
DSNVQTEECHUDJQP : VQLVJFXWEKBIQNT DYNLCUB        
HGQBBKB         : DSIDMEU         RSIDEMFPDAOFQQD PVEJOGRTSXGA   
PVCRM           : YKIBYR          OIJEGR          THDUFG          DRJWPRWKWYMPREB PYBCRNQJMBHNT   AINLFQIH       
GRSTNLPTSTDNX   : ARLRFEEWUHQ     OCTP            NUMMTWHN        KIGIUDLPNWILQD 
GPRPVIQYVTTLR   : PDWXRB          WCFGDKDQAKOXGX  QTTGJFIOEIE     GAUNWBKYMYFD    IFCBTTN        
DEBLWVIMIAHDUM  : IOUHYXGLHGC     IPKNLTALEOGC    BTUGLXGSR       RYIPBJTDOH     
UCYM            : WWFRPWW         KBDSJSASCP      GWIXTXEVYG      WXSGEROLUTQDGPL
OIEHJABFMTF     : QGIFF           NIKYFXMWIM      RKHXDNXFBL      XVKOXVMCSOKBUUX XJIOQECQFTVUOGH
AGGWDOMNQTQL    : MLKHDYQVGDT     RPFQEQUP        GJCBPLDJVACDIL  NVURKXPG        HQKFFFEKSV      GAPSEPB        
HIKIU           : OAQECQMLN       OTVKICWPDSDUE   XALKWVAGBHK     LBPJIB         
YFJGQJ          : HDMJBHRPNY      ULRHAIPBMRTHLD  PMLPKC         
VXDES           : YKISCV          ECMND           MIAOYDJTLAKTU   TIUCDUOWP       VQCDYUQABTVADNK HOMTHE         
KBDNRPBILRWUBHF : NEVAH           UBSOR           IJMAVKWTNDJPJLK VPIRGPMCWFLCG  
DMKKXQEJB       : ILSVETBUHK      RSVDG           RILAINKGVGWFGGF WETSOYSBACQF    CPHXF          
IGEDMRESHVKLG   : MBWOELU         QYYXOGN         DEHYAVSU        BLRNRGFJ       
FDTHLBUQPGDNYHX : ARYUUAUAJCRGA   GEGJNKOYEPQ     HGTQ            VXDHXVOMXNVOWU  RQQVRQCFF      
KILQLXIRSQPEC   : UUCKCPIGTLLEV   UBSOR           UHPCQNJXDJ      ARLRFEEWUHQ     RYIPBJTDOH      LXDBHKBISXILKL  CVUU           
DHCYQPCOISULGV  : QJFQKTD         OBKVOSDO        RSIDEMFPDAOFQQD YOGONR         
GYEOKWCKGTEYJ   : RSSWX           CRUPFGIWBG     
DIPMKOECSU      : FKPX            OTXOXJKJILWKLBO QFONTEPBP       UEQI            GXCIK           GKVDPOLALJSN   
LPVUNRBMXSY     : TMAWGUKLSWI     ABKROKHT        CPXXYES        
UMCPSDBDGLS     : JXSIVPRLEIQ     QMPQNQUFUAORGV  DKLEPQHUXCAOJ   NWHKD           QAEAG          
XJYACTK         : AKLXF           AWVLCHSLX       VTAAU           WPUKE           KIPDQLNUPGTLLQI DSEUBKBUCCE     MIEFQ          
LJNCBQQAJQVFFA  : BONQTHDNPC      IAKTQNDP       
XDADL           : UFMLHLPAKQB     AVHHBOBRDPOVTQ  USTLMAXUCBQQUH  RXFXBYVJQGRWT   BDGBWNUUPLUSFRQ
VEKHGN          : XWGAPYKTGAG    
CXAQHNSLFJ      : IJWVWXDAFNEDWHP IFCBTTN        
QCHX            : DDEJIEG         BIEWQOLTMWTD   
HUHMX           : TKDUQX          FFPPEUPW        HBNAYAVRQFXFC   FBGR           
XMGE            : LJYOM           REMMVLJNBY      MCIC            GOUE           
NMMAPNCGUS      : DIVUSPABG       GKJOFUBXG       JXCERHDRUDBBHM  SFIOGVNGRA      ANXHQFS        
IAKTQNDP        : JHHVIURYUOPODOP IPPUXWHFWD      RQYUMVBIARFTHPC HUYICHISDCNCHM  TTOFDRRPLAMAAEA MTFQHPPXLIEUQ   LJNCBQQAJQVFFA 
KMFYMPYYYE      : AILKWJPMIXCDRG  FHTDOFCRRQE     UEMBK           MRLL           
OQLOIYRQW       : BXYRTBYQPVBPS   SVOLNABFFOE    
RFMFCDSFUPSKWR  : IAMSIJV         XWRJR          
NRWOXXD         : QSRDNNK         RRERKJRGN       GPCUAJSQEIGNQWW MUVYS          
JUALOQKBL       : AEXIUFJQGTDSX   QDBFAXFQGJA     BFWFQYK         NNATHAWKGYDT   
NQTSJ           : WBBOAERXX       MVDTFQEWJBU     KOBGP           KOFWQAABQ      
QBSDBKAQE       : LVNSTHYOLAT     LWDP           
FCWKTJFTWT      : TCJMIEATTICSHW  DRWG            HGTQ            CVLKXCCXVAQ     CCLNVXQYE       DBHWF          
HUXBKOVG        : PCOFL          
VYCQCDDCTIEBMBL : VKOCHL          QLFOERUXMALWAJP
MRCJLPSJNUVDSE  : WURAHDNQG       YYIJMFVDI       EVRDSKWMRIK     IRWELY          MOKJBTRBUQMUK  
QDHHFMKKIUOJI   : EPTECLDJCKIHIII ETBTMXWSUINDDY  LKIAKMPUS       MDTJLQOTY      
VQFPTQDLMOYJLEC : BXYRTBYQPVBPS   JTVC            CIXYHMVLUS      BTRRCWIUKYC    
KSVTCBH         : KWIFLNKOERRWD   PXLODNFLQMPGGQI YTEUXASGQMG     QGXUOECGFJWQJT 
LRMCCUUANAPJQ   : WGBGDYCCPLMXJOK PQIWUBEDTOMYH   TTJWJWNFVADLTR  BQIB            EEPIWFKKR      
UFKWOXDQPPLLK   : THDUFG          ICEWKSJR        QUFIO           ABYR            VBHYAKW        
PTFDLRGPO       : BOMQTFPKHYEFTHC IXPIBYYG        OCTP            RSUFRIOEGBGLHO 
PEBH            : NEVAH           KQHXL           JSKLIEDLY       RBWQIWXMBETCBHA EAMIMJRFXTHGVY 
TDJAP           : SYJBDYRTN       LBMMPWJDRGS     QBBOQP         
QPMIFCVTOMJIROW : KESHOSK         VQBOCUF         TURE            YDNISYEPTL     
UMCVDGYMUVRH    : FKPX            VKOCHL          BXIKWKRFQ       SIQHALVXKJBM    QKKHSHAQLUIYG   FIOYABXUSGA    
HROWE           : UAAXFHGRT       QYQGGVGXCUSDQHH TPBPQCKC        HWRKFAWEIG      SYYLBKFLLBIK   
FJVB            : WBSIJRXTSIC     RFTHYOV         CPHXF          
IKJCYGPWSR      : ADXA            YWURLRMXRJE     OHJTHUN         ICRLBEIBUPV    
XAULVSD         : ISEQKQ          WEVHM           GWIXTXEVYG      MTFQHPPXLIEUQ   OCQIQQLYMXOS   
QNWFMEFTN       : PHIO            BIBBROKRKRO     INKGJTOHUSWOEIH GFUDLXAQXFNMB  
UNLHYPJHFGBYBBY : HEPFGSHHDQC     MPPALCKHSJ      EKOBBUQXDD      TNAJRT         
OWQUCHI         : PRSPFBFBCWHI    GFCNLJ          PLTHBMCYKVDWD  
PWGWRVAOLNWLD   : NLOTA           CKUDFXSOILH     XLVXTVFFWWGSQA 
SKOVLPAKQOKHJ   : TSPRDFSNYDL     OWLRMOOS        HAJMW           UFJTEQLF       
PTQF            : XLFLYLJ         WRTDOQO         PLMHSOYPKJG     WJYX            MSLNOTSTEAYVW  
YCLUECJRYUWHPJX : SBYJQEJBNIYN    BMVIWUHQ        GSPWNMPSRA      GFUDLXAQXFNMB  
UOOHHDRON       : FKPX            TPBPQCKC        MSXTFJKWW       AABYM           XLUAB          
EJALBAPOW       : OVYOHYTAV       GBHICKUIKVHM    TUCTJLGFS      
RGNSDMDVVBK     : WTCBKJRII       HQCUFDALRS      ILKCEP          AGOVQTYYTVHPLK  YKITPF         
RYBYCU          : NSJQJOUOO       YGESHARYUDDE    LAERCHNWK       KFWOME         
RCSCFHFHYWEVON  : DSFGOGIJDQPF    NKNNYPVCC       GPKUTDJIYSEH    KTUCIBKMARTN   
JSWMOUOYOG      : CGOPVYFASYXV    DDDFKKQ         ROVCTBBMA       WIHBCSYE       
PGDKUWPPBW      : CGOPVYFASYXV    IANE            LVJARFT        
HEYEKUUAEETDRIY : BKCLKMVB        RUCHC          
KPOKFUPRPNJ     : MIKSSWGBCIH     JXSCCXWBXADQGJN NORXBQBTHRXO   
QGFXKEEX        : ILSVETBUHK      RMDEAOMLDKRNSGF TEBOEPGUFAQOYWK
YXGGRLAD        : QJFQKTD         CLBNPACYVA      BPSYDCCDLTBJA  
GPCUAJSQEIGNQWW : RNWSM           OOLWRDGNWDG     AWCMHEIHSDWGIC  MYMQXEBC        NRWOXXD         TXVNYBUVHHPUK   UPNYMSKOBKJG   
XJFEHHGGPMABMFQ : HWWSNDFOQNPG    IJMAVKWTNDJPJLK WLAWW           YQHSHRGRE       UPGCJDARLRDVJM 
UURXHKQLVYBOXXN : LGDH            GERPQCHHFHESD   IJSGVFMYGR      SYJBDYRTN      
IVBRDHAUVBXIIOF : SVFKYAKMKXCOBG  TWQKVC          QLJDM           CKWNVQLPHEWLJA  DYNLCUB        
MYETKWHIV       : VTAAU           AKMYRWBQHCKH    RXOCDCOOFJLCNLC TXGDRRPWNY      AINLFQIH       
WTJNSTLVLOFOJB  : EQALVLOCEEH     JYEXIOJHPIJHCQK
HLAYSGLRMHELOMH : IUAXNDQWQCBCKE  BKGCJBG         GUFD            NXKKTLGQI       MBTFTDIGKJHTQ  
MEICWCNUQEAFP   : NTYAGG          JTATBASVIGAJCS  DMMBR          
WYOYAHI         : APCKFXYYLMNG    EUWJHTPKOFTMML  UYVGQEARKTCWGCW
YWSEJJSQHHWP    : LLPYVEAMNR      DKLEPQHUXCAOJ   CXBXYQOPHANBFVQ RXFXBYVJQGRWT  
TUYO            : DIRC            MEOHGE          IUAXNDQWQCBCKE  XRSQV           SDLWISPYIB      PVWRGP         
FQSWRR          : WYEOOFQFBXEE    NXYUCMOFG      
IQYP            : SBWVDAHLJY      FJDKOSQVULAF   
NRYIXISS        : OVYOHYTAV       OVIPODJIA       XOFS            FMBPVQQ         GKNOQACSIA      AUJRHETEMXBBJ  
ABYR            : ILKCEP          UFKWOXDQPPLLK   FYKXCG          PVXEN          
UOOMCVDWTXQSGK  : JBLXETMX        XPNDGVMH        PDSRUUD         TTHF            MUVYS          
YLFQKOOUHJWJKX  : WSUBFMYJUUSLPUV RHKNOAALVFWFHP  NXRYQTBMEDOJJ   OAQGJWXSQOEG   
ASSOFWKJWGHNYP  : CQSRU           YFKE            RVHBPPUHHFV     DSEUBKBUCCE    
TOKBFWPVSYGRK   : BPJPKOKCGMCKDK  PPFIXSCCBMXLRPD RYYRCLCGIPOWRN  XYLQGEFXRYVTR   SYMHCCESN       JFKISAG        
POSKJJSGWEFDLTF : TIUI            RMDBUVTAIPNSYR  NWHKD          
RBSCCACSWUTFOFX : ALHPDLXC        WRSEIBAWHOLL   
TTQFDLNCPTIDN   : CDMVTBJBHXF     PVDBX           YQHSHRGRE       VGDHA          
HFOAKQAM        : EQALVLOCEEH     HYGRRW          QCLR           
YJGEAN          : XEWPE           EPGTNIPIGVWSM   TPME           
GHBYOGLCJ       : USRRAFJ         OMVRXRGSUXY     RSDKWGPYEVPKFRU XMKAUQ         
VRFJFMRVOEOOQBO : HXHGWVGY        OIPJSHGKURPK    GMAMTDRDNLWWGXV EJLBPQM         TXVNYBUVHHPUK  
JUCWCIGD        : MRTR            FSKYE           UTAOMEFJT      
UKUYVYVNEH      : LNFMAFQWRBWEP   WMIORWXTTAP     FGQTMIFTBOI     SPUKTCBEHUCD    EUEMCFG        
SYSHD           : OAONY           HHCQMYYJDEHRBYJ JLKSAIG        
XVKOXVMCSOKBUUX : ROKGWH          HQPQECMUPOT     OJVXGCBSHCBFC   TETUGXHP        OIEHJABFMTF    
RADQVSWFNRFGBK  : FBHEQRLAOCDM    PLTHBMCYKVDWD   VJQSKAPFTAKRSB  ISDSCYGBWW      NORXBQBTHRXO    XLUAB           GTQSHQXVEBFEXD 
AJBQJWDMSSYVP   : STBT            SBAGGDK         OYTOLYRBL       TAKWIO         
WWOWCHUU        : AGRKSBJJBMTUDGD UUBVKVLOIMXF    OBKVOSDO        WVGPV          
AKWHSBSIBELT    : XNCWEQWBXNWG    XLFLYLJ         GDVNURHLUNSJ    BVRVIJT        
JXAES           : GFPCWVASLCSSQI  EIEIFFVJULN     BHFSPQFCUKGJ   
CIXYHMVLUS      : EIFAJMDCO       VQMV            XRTEYLLQNOWMKA  VQFPTQDLMOYJLEC NWKW           
CTQBBJCVTFA     : RHWQYGXB        PCNKKNPTJUXWY   NNATHAWKGYDT    VPIRGPMCWFLCG  
AQRASVSUADTAKI  : XGYMSXXJIRBQKKL HSEIRJ          DNNCHXUUH      
XFREHLWLOIN     : MCIC            FSAIE           RSIDEMFPDAOFQQD
CVLKXCCXVAQ     : BLHIKRBWLTMAP   FCWKTJFTWT      DUYHSMAU       
BVMDIVBG        : CEUUCVPHATFOLOE PBYHDI          CHCAW           GXTDNAXMJKSLCE  VFRHFBMNYPDRL  
UKLIJ           : CIJJEAFB        IRDOJ           YJGI            AKQJFOIGGRPXJR 
XRMJVIWHICLGAM  : URTTIJMN        AXGP            CUXIPGKTHBUYV   EULV           
SNUGQDETLHPX    : RHMUVMXHUHDFOB  VRCSMFCK       
XHRXBHHARHJBJ   : YUXGJWPFTKSMGO  KCPPCUWMTI      YQXYUNHKTDXWXD  LJMILYRP        PQXLIVV         MGLWEYXHJXOGUMA TYTAKPPSNKRCPAJ
JLHJ            : QBUWIBX         MWXQOXJGWHXMB   TBXFFJXXSSBMWKC FBGDXEATWLWPD   FJMPHREP        GXRKMJVX       
WGMPMSKX        : TRDMA          
CWVCEQBIXKIPT   : FQQXMNJMVRLLAQ  JNPEW           FSPVUQIPYLD    
SFMDQ           : GGEL            IPDVKTDB        RTOIHFRO       
OVVUKMH         : UXDRQIAOUIYPC   OAONY           FNBQILSO        IAHJRIKFAP      AHQJAUVMFG     
YGHBF           : LWDP            GKNOQACSIA     
FJVI            : GEKYEHO         PFAWDPQV        XJKBGFVEABTN   
VVCOPVHX        : JXNJXSH         REUUCB         
MOIBM           : ADXA            YPDQHPKT        BWJQVRIHW       VTAL            QLJDM           PYDH            XAVLV          
WXSGEROLUTQDGPL : NPXVHKOKVAL     HIPYKCTQCCL     UCYM            DHYE            FHCRTRUQ       
LJFC            : HJMMFRJAMLK     HMTHID         
BMAMYQWBEC      : WYEOOFQFBXEE    MLAQP           DQPKBXGPG       HIBGXYEMRWSTMOX
EWGIPVTMR       : TUTDPQWFOAJJNV 
PXCEYQNES       : IPWCCXRM        JYLUA           QYYXOGN         MOKJBTRBUQMUK  
HFRUHJRKPVKTT   : CTNLXACMJMHAEM  GRPWQYRFDDP     GXRKMJVX       
CLQXXJKQHNUIGK  : WLNUCOYSPWXQ   
YDWHWRQILBX     : YNDUTLJCTTHM    EUWLF           YJGI            ONQQEG          HCHN            GNRRUYMRCSUSOY  YTEUXASGQMG    
NREIVPATPLHGUU  : FQGDRXLMS       RXFXBYVJQGRWT   MOKJBTRBUQMUK  
EDOSCTRLQJC     : SBWVDAHLJY      HKLWYVA        
XFAGSUMEQ       : HTDJPKXBBFMJPFY AAOYSPK         CCYIHXPY        GEDFXBUD       
GNRRUYMRCSUSOY  : DWUY            GPPES           YDWHWRQILBX     RSUFRIOEGBGLHO 
GLGSPIQV        : YKISKKEGEWUTUIE HRVKPXGXGX     
WQDJW           : RQKYEJR         VKQNDQM         XONVVHDF        PWYYWS         
NDKFWFG         : SQAGFYFLYBQXBK 
WLFRETQTBE      : PTAKHNB         GMQDGGK         FLQVPUNPNV     
TUKKSSJLY       : OCLXMNFADCU     IJSGVFMYGR      NJCXER          GJCBPLDJVACDIL  PSXNJCX        
JVIOGPMNYWKK    : NEVAH           ABKROKHT        YTNABFTGI       IQWEIDITJI     
CQYUMAA         : GMCYVHEKBXAQELF YSGL            PALQXGHD        JKJCENJB        MLQU            TYTAKPPSNKRCPAJ
VWYIPURDTOMRY   : WFXU            UNBLFSJRO       DEHYAVSU       
AOQNP           : SRXNBKPIMAFDP   OTNF            OQBBT           FCKHDLUGIORUT   VGMMNPMPRV     
XCTCTSWIUWXQV   : EEARMVTFXWUO    PLMHSOYPKJG     OYTOLYRBL      
YLRS            : EPGTNIPIGVWSM   FNGUIVLUNNKP    EUBIMEQHWS     
LHEFGIFXYSP     : MPPETEIDOARLS   VEJAXLVNLSGID   OTXOXJKJILWKLBO FSPVUQIPYLD     NEAWFACPOB     
SSJUO           : MCIC            KLDYAY          SJRO           
SWARUSQSUCKNT   : DDNCGYSKFYKV    NJCXER          NARXWEGOE       AKQJFOIGGRPXJR  ERDOMIAFWWNK    WJYX           
XBEGLMENFU      : WLQJDEMTTONE    YKRNFLLWQIJ     WTIC           
YPNVEUQBUL      : MOPOLGMRGW      QITQLRM         UDGOJGMNLIYEWPG
PCTKGE          : EIGUFBAQYJMXH   TPMXUDYT        UYGXYLUYD       DTGA            BECAHIBGXL     
BFYEMFPYMD      : RYYRCLCGIPOWRN  MNWHMWINHFGE    HUYICHISDCNCHM  TPHO            STQMWTNG       
JIHYXE          : XRSQV           OYHUVQSKR       JTVC            CCYIHXPY       
SWGPIFGKBSRGTU  : HYXEWOKRKE      BGCMLQABPYPCRU  ISDSCYGBWW     
SBCBQ           : TNUQYHSD        HQHBSGKY        CCYIHXPY       
NWKW            : GMQDGGK         QPGCRAWLSJNAHN  SJRO            GKHGMXNFLWIJGG  CIXYHMVLUS     
RXFXBYVJQGRWT   : RGHUJLCWBH      GMAMTDRDNLWWGXV XDADL           YWSEJJSQHHWP    NREIVPATPLHGUU  RUCHC          
QNBKIPGJRJCVW   : EPFUIHWDVN      NMENM           MATNEQMNQ       OGNSUVXGO       WIBCAKWV       
IVGCTOBWPYGGHXE : HYXEWOKRKE      DDHCGJOASEDTR   IEEDNMJ         BXOLBBASA       CVLSCIAXAFU    
RWOSJYKRK       : VPLWXBNTPDSDN   YQJYITI         KLDYAY          MIEFQ          
BNDAOLVXPRM     : BFDQY           HUQAFWPGEA     
OCRXIAXODRNSNAR : QWUNNUTKEV      OLKWAVHRHHGDN   UOMMMWWXHLU     CCTHPEVLIG     
RDFTSKTHX       : XBHAKF          DPEEJR          SFIOGVNGRA      WIJOQAISFKODW  
HOMTHE          : RCOMFX          OCYTKMJJFHJJ    GDVNURHLUNSJ    ECFRHDTN        AOLMH           VXDES          
CCHECXHUOAIOUI  : PWGUP           AAITUYKRPYPWQME
XOCSBWAARIOGE   : OOYXFT          OAQECQMLN       VHGT           
KDAOMERMOMB     : LNFMAFQWRBWEP   HTCQAB          GLJIUETDKSFRSWY PVXEN          
WPJFWJVBCXXFXR  : PPFIXSCCBMXLRPD AEQNJQ          PWYYWS          APCKFXYYLMNG   
OYTOLYRBL       : AJBQJWDMSSYVP   XCTCTSWIUWXQV  
SYMHCCESN       : CAPXKDFODNFU    ULRHAIPBMRTHLD  TOKBFWPVSYGRK   TNAJRT         
RAGSCGTJGNYWM   : FJCAPCDJQWDIPXK GAIOHIHXSTKP    ACVELLXOKUMEWU  KYTXOUOL        XRWXEPFXLXK    
LBUDCHC         : MIKSSWGBCIH     CJVTUPTNOMRA    CIDGBSVWABKUQ  
IQEKUIF         : SYSWWCOFPXVB    PHEETVAHM       MDOGRQQWNJTFPAE TGCOBUUGOPGTRWR SEIYNKTHPNSB   
TWLCSNIMAOAY    : JNUGLTJGKQMYUYO AUNDBNWQPKC     BXEVGBHNETERJC 
PUAQQFSAJRKBV   : GLJIUETDKSFRSWY KSJPBIALADBE    PMBGSJSGFFUAUJ  NTIVTSLOTLHAHCT
VGDHA           : LXHXHR          ADSRIK          RRTBYSJYXWUWHXC PMAIJCYVACQLU   TTQFDLNCPTIDN   JFKISAG        
SFUJN           : KNFTFMTQFNNKEY  HLLUGRUUI       HAHJTXRHTXAOA   IMDVHLYJIFJ     NXYUCMOFG       LPXXBJ          MRLL           
JFKISAG         : VAUIXBSUUOQDXE  PITPCUQUTAVTJAM UEPMTOFUGNAL    TOKBFWPVSYGRK   VGDHA           IAHJRIKFAP     
SYYLBKFLLBIK    : YITWNN          YOBNCTPXOCJ     NVISLW          HROWE           BFQA           
NRJQLOLW        : WIBCAKWV       
TGKEQDGYYYX     : YYGEGHU         NTAYLGG         NAMJTRKAGFC    
KBKRM           : YKWPINEC        PLQQRORBPXVLXU  CUPFBLYSEPOLM  
SXJCLDNCQDO     : MEOHGE          EQALVLOCEEH    
KIVUONA         : QSVREX          NSLSVB          XLVXTVFFWWGSQA 
OYTPBGQOXEN     : JSEPFSUDDORRMM  GOIOYKJRQDE     NKXE           
EYUPCIU         : DNDFEDE        
NJJXTGUK        : DSFGOGIJDQPF    TMPWOIPHBM      VQOBLU          NXDFPXKVOVE     SMYQXHLOE      
VFMWBCBHTPHAFA  : RLRYSVTX       
EUVIFQCT        : ISEQKQ          GPCQRGE        
OTVWPGU         : DYGTPFBGH       CPXXYES         PXLODNFLQMPGGQI IKSTFR          UXMGXDPAFWE    
LHKMKLVEBDGGF   : KBFCRCJPLQTULXM MRJRAS          RIDLBMLPBDJ     ETFAJUGL       
MCGVIA          : QWTHFEOIITPIBE  XJTBULXP        LCYPUGOXYRO     PYUXPLGEOXA     ANXHQFS         WIBCAKWV       
EAOXYNPF        : RRPJVKEANY     
DTQOIBCF        : HJMMFRJAMLK     EDUFNKU         VJHVBLJGJITD    FOCXFFKWLT      WBTENASWJRIBAN 
GKNOQACSIA      : VMOQFBJEXRI     KVNJXTBFY       NRYIXISS        YGHBF           COXJLAMRQRGCFVS
IAHJRIKFAP      : PDWXRB          XRWXEPFXLXK     IGWDAS          OVVUKMH         JFKISAG        
EJHUUK          : SKTQYTYHHC      WRSEIBAWHOLL    CVLSCIAXAFU    
CRFOHUFHYBPY    : SLFIQVKYTCBI    FUPDUJ         
YBQKSBUBBMRFYYC : LLPYVEAMNR      LOKXLNVYB       CRDAEQMRDJE     JEGGGJAVGWS     VELDLDENOVO     NOIXW          
JAXD            : ABGIPJI         EAYRAE          KMFXKRMMXSTBYV 
MKCUTDXJCEK     : FVKUCX          CTKJSGOP        OCEUNROQOCO    
UWYXTA          : BXYRTBYQPVBPS   RMDEAOMLDKRNSGF OAGRIIEWYHXR    CKUDFXSOILH     GXALONODBHHOGY 
HRHIQKEC        : VMNAPKIGWDX     ETBTMXWSUINDDY  DAVQFTHBSF     
CFTOPWJJAJVFOI  : TKSYOTSPYXGYJJK PFTXDPYYCKT     IDXQTJKDLAGMK   HWRKFAWEIG     
LGIKCLKLDR      : CKHWMCY         TPGOLLY         RSIDEMFPDAOFQQD IWFSCJVYG      
WEAYQCFLTW      : JNMTOMAXUVB     RYYRCLCGIPOWRN  VHGT            PYDH            HGUROBKHAFMCRGH
FJMPHREP        : DRQLLRMEPCNPPQG JLHJ           
RXOCDCOOFJLCNLC : ARLYPLBQYTNNDV  MUBGGMCOB       MYETKWHIV       BFQA            URKX           
QJSKGFPRR       : YYGEGHU         FWLNBMUEY       WBGVKMGXM      
YMLRRGPI        : RPFQEQUP        IHAVCHEDLTYRVKU DYWWRUF         MSLNOTSTEAYVW  
SKAKQLVUBJYIAID : JKSO           
RIDLBMLPBDJ     : UQGCTSADBOWVKLM LFRWTBENBYTXIK  BNHCYQEX        ICRLBEIBUPV     LHKMKLVEBDGGF  
USRQDTDVFYTHI   : OHDQJK          NXDFPXKVOVE     OCTP           
PLETXXEDJ       : XIFMBPDDUVORC   LOTPJSDUSJCSO   UQKUNEVVI       KQJIWOES       
QUWRAHYXCQQHLT  : ISQCMRVCGVIPSA  SKNWWAGCCKVDHS  DHWCDV         
SUAADUSQYOPWSSH : GLIPHRMONRVASH  IGWDAS          WMHBIVPEKJFLLEI TUNNWAGOSTAKVR 
JEAB            : UDTGESSJ        LSTTDBHGKKGN    DYALKCKGFOYSJ   RJHGSSXSD      
HAHJTXRHTXAOA   : EFJIPMV         OQHTQJ          UXDRQIAOUIYPC   SFUJN           YSUJCBQJM      
TUVL            : WPFBCRKX        TBUVNNVGWFD    
MBTFTDIGKJHTQ   : MLKHDYQVGDT     VQMV            HLAYSGLRMHELOMH
BDGBWNUUPLUSFRQ : UBHRGLRYK       QMPQNQUFUAORGV  SVTSNUPHNLYXKVX XDADL           IMHFKINQW      
MDTJLQOTY       : UXWLKICJQRTHDQH KSTNUPERBBRYI   QDHHFMKKIUOJI  
DISUSVABWW      : PNSACROQAOFQ    HJTR           
TTHF            : CLBNPACYVA      FGQTMIFTBOI     UOOMCVDWTXQSGK 
CNITGXYDHKVVHU  : FCKHDLUGIORUT  
KDQHY           : VJYXVJYVBBQVC   EQALVLOCEEH     QSNLUPBE        KYXSSEMMF      
HAMGRHAYOQ      : TPGOLLY         GFSMBAGCKQ      QSNWWAOJUP      CXSALUGD        OIMNJREWIV      VHQMCCGBPU     
CAWJAYOHLKFS    : FBGDXEATWLWPD  
DEKWNJMVMYEEIF  : KQPMQ           SBCMHUJHJAHFRKM OCYTKMJJFHJJ   
XVIAXI          : OVIPODJIA       WHRMOSBM        FMBPVQQ         RXJRN           PGMTJKTDFLGDHOB
XHAHSKP         : SFEEUNPJNWQGGIV VMOQFBJEXRI     XMKAUQ         
RSUFRIOEGBGLHO  : RJOFTSERMNFLBL  CIWI            PTFDLRGPO       GNRRUYMRCSUSOY  ARHJASWECHMSOUC
MMOVNPEBPNCXIMP : WESKKXX         RQYUMVBIARFTHPC
HKRMDDDJJHPUOH  : OQHTQJ         
ETFAJUGL        : SXWUQKW         WCFGDKDQAKOXGX  DAVQFTHBSF      LHKMKLVEBDGGF   JVOFJUEDSNHVGR 
TPME            : AGQIOEEEGDFMTT  YJGEAN         
CCLNVXQYE       : UFMLHLPAKQB     GUFD            CLMKBNY         MGKHCS          FCWKTJFTWT     
JLUGCC          : GERPQCHHFHESD   MEDADUEQAOJPPIA EJLBPQM         XBWJWTJM       
GXCIK           : GEIM            ESHMJQPMTAH     UEQI            DIPMKOECSU      EUWJHTPKOFTMML 
OVLKNYPRBTEQREH : BIXRCATGLVJFHA 
IMDVHLYJIFJ     : ITNCVBUJEE      OBPO            WPUKE           XALKWVAGBHK     YLHLXDQT        MTFQHPPXLIEUQ   SFUJN          
QTLHRA          : KLWKSECGQWF     UPGR           
FYKXCG          : QSVREX          PALQXGHD        OGCVWSPDUCYMR   ABYR            DAFWOVABXDN    
TXGDRRPWNY      : WVLLJNUIUFFXV   AXGP            UJHOQWCLAJNPII  MYETKWHIV      
MITUSHNOSUHSP   : GSJNARTGOHINGI  WIEOCIUQCNTL   
TAKWIO          : YKWPINEC        XLHCXEXCKQWOGB  OGNSUVXGO       AJBQJWDMSSYVP  
HVVBP           : LBPJIB         
YDNISYEPTL      : QLFOERUXMALWAJP QPMIFCVTOMJIROW
IHAPCQDYS       : IPKNLTALEOGC    QXDKVIUIVB      FBHEQRLAOCDM    TDBGKQPIPTN     GDVNURHLUNSJ   
VCFQLBMMSBLV    : RHWQYGXB        KCYM            PNVMYPLVGI     
VQQBIKONUVO     : MLKHDYQVGDT     EGKHNAJAACLJROR
BFQA            : RSSWX           BVTBTUDGJRD     OAWOHPTCFA      SYYLBKFLLBIK    RXOCDCOOFJLCNLC PODVHMBHM      
GXALONODBHHOGY  : NGDOAAGIUJU     HWRKFAWEIG      UWYXTA         
WROIE           : HWINOYKSS       QTEMFCBTM       XPNFUB          LNSXLAEPFGGWAW  CUXIPGKTHBUYV  
VYEKKFPBFQKF    : FMELQO          FIOYABXUSGA    
VTHL            : JDVTQXI         XGNBV           DEHYAVSU       
IUGYBHMBYDJDJFD : VAUIXBSUUOQDXE  XNCWEQWBXNWG    EIBYGFTJSOPJEH 
SPUKTCBEHUCD    : CSUGDSDD        AVHHBOBRDPOVTQ  EEWVSCVDV       GOIOYKJRQDE     GCHAXEHMXD      UKUYVYVNEH     
PCOLLNOSBPU     : ADSKUETPHHN     PATXKLGAEIYO    RCOMFX          ODBKU           RAGFKYARKPL    
BAPJFDCVXM      : YWPSUNDLIRBRL   GMCYVHEKBXAQELF GHCWDKPANM      NQLBHKLCGCAQQF  GWWIJNWUP       IPDVKTDB       
COXJLAMRQRGCFVS : VUPUQQBSCOJ     WIHBCSYE        YTMERIWQSCHUMCN GKNOQACSIA     
WJUE            : HWINOYKSS       RQYUMVBIARFTHPC VWJRKUISKAPRNJ 
XVVDCXBCNSFEQ   : BOBKSORKQYOYWOY IFVPFNJRO       CEUUCVPHATFOLOE KNHX           
PTEJKXPOD       : GVONDFFBHWV     JXSCCXWBXADQGJN ADSKUETPHHN     NMSRIPSVCEW     HAQWGLBHFASCIR 
HDLSBRGYNCCPDG  : FUDLPVLMDDT     SBLFQRX         AOKK            IJKNLDQUUCOSTS 
QYXUSO          : HSIPDVDTIWKIAVE
MUVYS           : EAEMM           NUWLRYTHK       VTAL            WVIDNX          NRWOXXD         UOOMCVDWTXQSGK 
NXYUCMOFG       : RWWQWBKWSWVG    PVDBX           JJEPBUNBVVU     FQSWRR          SFUJN          
EUBIMEQHWS      : EPGTNIPIGVWSM   MQIQQFPGQWRTRWQ YLRS            BXMN           
RLYGATCYNRMLRJ  : JPNVC           RFABHN          EVJWKCQSSYJQVEH JFDCBJKCJ      
GAUNWBKYMYFD    : KBVKFDFGMCHHNH  WBTENASWJRIBAN  GPRPVIQYVTTLR  
DVQWJREJM       : XUKSMOTUAOCIU   WBGVKMGXM       NAFRHSVDXQO    
ICBWNUHG        : DLGSORULSXNJL  
HDQHHDGVFNBO    : LADMWRGJCIA     OFLXPPDLJO      GTQSHQXVEBFEXD 
AHQJAUVMFG      : UPSCCQY         AUTRLDQSWLSBJ   OVVUKMH        
IEEDNMJ         : PDILIW          MAHWYYBBU       WCFGDKDQAKOXGX  VHGUKJEPR       IVGCTOBWPYGGHXE
QAEAG           : AUTRLDQSWLSBJ   CUWBLKIYGNIJ    FBGR            RRERKJRGN       UMCPSDBDGLS    
VNBWCRW         : NRPNEXIH        CQVTVYXFHFN     NWWSCNKUBYLR    PRGGQ          
IJLFFANLQVRXCFK : DQTXW           NIKYFXMWIM      MDKWCEEH        AOLMH          
DDNHFTUBHV      : ERTY            QPUCQUMNV       XNPURNMUR       KWNLNTJKHEAIQP  KHYJLVCMNRX     WIBCAKWV        IVGCR          
LPXXBJ          : PLQQRORBPXVLXU  QITQWPWTUEMH    KIOOHXBUSJOQEAP SFUJN          
IOMVDDSWD       : HNWXRARER       DNPXCXTW        NGLUIPDSJK      LHCGBE          EUWJHTPKOFTMML 
DQII            : ECDOXVXXO       SJNUCHGUYR      SVTSNUPHNLYXKVX NMENM           SBWVDAHLJY      VQOBLU          UOMMMWWXHLU     NMLQDPLJNMQ    
VRCSMFCK        : SGKYYYVKQUJP    BTMSBLDOUQ      SNUGQDETLHPX   
QDHOEQAMIMLN    : PTAKHNB         JDVTQXI         KMTVOKUOCGGLKGA
GKVDPOLALJSN    : GJIKBFEQYELHUV  EPNVHQBDGC      LBPJIB          DIPMKOECSU      KOBGP          
HSHSAXXJOCAOQ   : LMHPGK          VQBOCUF         PBYHDI          ARLRFEEWUHQ    
ECXYKLWNDMYEXL  : XBKCCJBBRMNYJSJ OHJTHUN         YOGONR         
LNGGWBGUYPLBSB  : EQPTNVSBQNAK    LJMILYRP       
DHYE            : OPSBSHYA        WXSGEROLUTQDGPL RLHYFFFFXJTDBDH
KRFXURAY        : ISQCMRVCGVIPSA  BFFAFL          BGCMLQABPYPCRU  QJFQKTD         DYWWRUF         GWIXTXEVYG      JLUDYAVONNQBSQT UUJXHXEC       
KRFXURAY        : BFWFQYK         FTDLUOLOQUUET   ADEX           
LXDBHKBISXILKL  : DWPCWRRPXX      KILQLXIRSQPEC  
NGLUIPDSJK      : LBDYPCRK        VWJRKUISKAPRNJ  KLIJ            KHYJLVCMNRX     IOMVDDSWD       VTYUQCKSYSJH   
FDUGUIHBMONNW   : PUTEEJAOWVLN    GDVNURHLUNSJ   
NFVXTCLCQIKINFS : JPLQRLUFAKDAT   KNHX            TTJWJWNFVADLTR 
BXEVGBHNETERJC  : QGGKVCLOWDLGQPW SDUQPCXDNIS     TLIAKO          BHFSPQFCUKGJ    TWLCSNIMAOAY    JFDCBJKCJ       GLTYMPRFR      
WJYX            : QSRSUMELLRROHP  IUSEMP          DLRHYHBEIG      JFKGNMUYMVOQCAC PTQF            SWARUSQSUCKNT   QTVRQLVTTD     
ELIUUS          : YUXGJWPFTKSMGO  QQPJKJEH        CVQKCSSXOHYRDQ  WNLHRNYUGARJVR 
KBVJC           : UUCKCPIGTLLEV   UAXSYL         
NAFRHSVDXQO     : MXBPGUTOMEE     DVQWJREJM      
TONUMTB         : XEWPE           ULRHAIPBMRTHLD  CJVTUPTNOMRA   
CVUU            : PQIWUBEDTOMYH   KILQLXIRSQPEC  
GVAR            : MFCAPCUEMXTFTM 
WIBCAKWV        : UBHRGLRYK       YEHGEP          BDQL            PFAWDPQV        QNBKIPGJRJCVW   NRJQLOLW        MCGVIA          DDNHFTUBHV     
WMHBIVPEKJFLLEI : MTFOJTSICP      GMCYVHEKBXAQELF MGNSEYHH        QCLR            SUAADUSQYOPWSSH
GOHGJ           : LDVRFIERUIBWUGM AAOYSPK         RKEVGWQHKC      FFUWMYCETIBR   
FRKJRXJPQIFXKN  : LFMIFYL        
ARHJASWECHMSOUC : MBWOELU         OCFWXVDSVP      RSUFRIOEGBGLHO 
BVJMNJXGAHLYRY  : HDKVHWTVMBXSGSX EOJOSJKPTNI     SQAGFYFLYBQXBK 
TTDFTYCABJ      : HDWUXLJOFDV     LBPJIB          TTOFDRRPLAMAAEA KHYJLVCMNRX    
VBHYAKW         : OSAFK           NIAGI           UFKWOXDQPPLLK  
XLVXTVFFWWGSQA  : ABJVLWYKYXEC    WARFWVIVPCC     JQRCNOLXDF      PWGWRVAOLNWLD   KIVUONA        
XVXAVYMIWNSVNDT : WMWIAWNDO       MGLWEYXHJXOGUMA AAITUYKRPYPWQME
DHWCDV          : GEGAAWKVIKTFT   EVRDSKWMRIK     XIKSHWDL        QUWRAHYXCQQHLT 
ISJQOCRNB       : YKWPINEC        EUVSVHRTDIWMOOC HVFYWDMTWWOKENG
LBMMPWJDRGS     : GOFBSPF         VHGT            TDJAP          
CUBLRFQNPB      : HDKVHWTVMBXSGSX NEYNHBS         LHLTIYAFJNRBUN  CIDGBSVWABKUQ   UIIRJSOFUKWJKRH
BRXDLLECWIQJAP  : TUQGMB         
EIBYGFTJSOPJEH  : QGBFMYBWK       LIYRVDEEBLWUWK  EJDONNWWNLRD    IUGYBHMBYDJDJFD
NIDLLOWSSV      : DIRC            TUQGMB          JOUYRMAYPD      GFSMBAGCKQ      VDGJ            BCJJOBJUYIMLBS  ICEWKSJR        CKWNVQLPHEWLJA 
JFDCBJKCJ       : VTAL            UPGR            PMBGSJSGFFUAUJ  JBDLWBCSEYND    RLYGATCYNRMLRJ  BXEVGBHNETERJC 
IFCBTTN         : MWDBEWKGJYSBY   ONTYJMHLQKFAVE  EJTXXJ          GPRPVIQYVTTLR   CXAQHNSLFJ     
BXOLBBASA       : OCLXMNFADCU     CSLD            IVGCTOBWPYGGHXE
LWXXEBAFN       : TCAVYTOMXHH     YRIDBR          KEHXBXMYKRYJ    QFIPT           RYUILUK        
IWFSCJVYG       : RLUDVRBCD       WYEOOFQFBXEE    LGIKCLKLDR     
AHIOVJRVESQ     : GJIKBFEQYELHUV  EFJIPMV         PLMHSOYPKJG     NTQTYWC         EVJWKCQSSYJQVEH
RQQVRQCFF       : AUSSQEE         JOUYRMAYPD      LSKLYKBHPQQ     LFMIFYL         FDTHLBUQPGDNYHX GXRKMJVX       
EMFJ            : BGKTKDPPPUH     VNGNORHPQWYW    FBHEQRLAOCDM   
BKCLKMVB        : TPXBCRLMWFJK    LONJCTDCRURCAIK USEDFFCS        XMSX            WGKROGAAACHNB   HEYEKUUAEETDRIY
HVGMQYF         : QTDMDRUMXORYA   UUSVBDR         LPTEYVEDTJR    
PVEJOGRTSXGA    : GFSMBAGCKQ      UIKBBGRN        HGQBBKB        
CCTHPEVLIG      : MIKSSWGBCIH     KBVKFDFGMCHHNH  OCRXIAXODRNSNAR VFGNODDOIJD     VIJRISXDRKKMAW 
GOHWP           : KIPOSDH         MSDEBWJVUSHCR   NWHKD           CJXMPCUTNLVHVP 
FHKLQYUK        : RHJPLBRNLOKYM   QITQWPWTUEMH    QCKOCFAMMSS     FPQYJ          
NJYQSESN        : WNPWB           OCTP           
KTJXERSKI       : YVRML           CLBNPACYVA      QGWHC           EVNNONMIRIRLC  
HXPMFB          : SYSWWCOFPXVB    NQLBHKLCGCAQQF  VNMKHSFCNAYKEW  AKMYRWBQHCKH    OGNSUVXGO      
XAVLV           : EEPIWFKKR       MOIBM          
WUCPBWF         : MCWJOJWYRSHJF   PDAGL           HSNRXJTPOJEMWQ  HYGRRW          XBWJWTJM       
HCAFGTYRCCBCRQ  : SIQHALVXKJBM    HKUDWUUKFDNMJ   BTWXJLWDI       HWRKFAWEIG      KOBGP          
URKX            : HWWSNDFOQNPG    QKKHSBQH        BLVIOFMMYWMQU   RXOCDCOOFJLCNLC
VTYUQCKSYSJH    : ABGIPJI         REMMVLJNBY      VKLWT           IWDYSIOSIVT     NGLUIPDSJK     
KOBGP           : HJIIU           TXYFB           QYABFI          VOHCECWAAG      NQTSJ           GKVDPOLALJSN    HCAFGTYRCCBCRQ 
JTWNMNXJFIHSG   : LNKOEFKDLOIKE   FQQXMNJMVRLLAQ 
TBUVNNVGWFD     : FKFO            ATPLXHWYMFCJ    TUVL           
VHQMCCGBPU      : ONTYJMHLQKFAVE  RCOMFX          HAMGRHAYOQ     
PHVAOQGSLHNJVD  : UEAKFBIWXGYB    AFVCROPFNAIX    XLUAB           PFHTVUVSHVMCA  
EAMIMJRFXTHGVY  : OOYXFT          VIOFT           WNASLIFHUEHP    LWDP            LXGNUDJL        XBHAKF          PEBH           
MRLL            : CGVYX           CKHWMCY         YATGUTPOCTHN    KMFYMPYYYE      SFUJN          
CCYW            : GFEMFWMNWSUCPA  RLUDVRBCD       XAIFEAWB        CSIBYC         
IKAGPHLSWV      : EQNCCPVEQGTFA  
INKGJTOHUSWOEIH : CFIDASHCA       PGMTJKTDFLGDHOB QNWFMEFTN      
MIEFQ           : XCXLXESTVEOKAPD RCOMFX          XJYACTK         RWOSJYKRK      
FAHMNCLL        : HQCUFDALRS      NDCGIFV         CTYMDNQSU      
TYTAKPPSNKRCPAJ : PHMGXFXYPIGV    RDCXAS          RFVBPMTAVLJHH   MQIQQFPGQWRTRWQ GLBQ            XHRXBHHARHJBJ   CQYUMAA        
OTFTN           : GFCNLJ          IUPYTEJXFX      NKOVNRPE        PKBBUTAPBMM     SJRO           
YNHOBJA         : GCHAXEHMXD      RLKBHUSM        ALHPDLXC       
TUNNWAGOSTAKVR  : YDTOYX          LCYPUGOXYRO     GQMIFQ          QBTL            NWNUKI          QWME            IWDYSIOSIVT     SUAADUSQYOPWSSH
IQCCXVPV        : VKQNDQM         MIKSSWGBCIH     MWXQOXJGWHXMB   VKLWT          
FFOGO           : INSDFGSAXLREGGD JNPKLB          DLGSORULSXNJL   SFIOGVNGRA      PYBCRNQJMBHNT   LQTBQ          
UKNKB           : ODTJUGSS        MTEQA           LBDYPCRK        XNUSHHJH       
LHCGBE          : OTNF            FYHSLIDMQBRMSM  FMNUEK          IOMVDDSWD       AUJRHETEMXBBJ  
WXGFQKKPJ       : FWQBYMJQSHFW    DMNHSKE         NLOTA          
LHGSXOJOMUDWVQI : TSFCYRAD        JXSIVPRLEIQ     SUVSHACLMVW     LSKLYKBHPQQ     RMVAACNOAPB    
UPGCJDARLRDVJM  : UBHRGLRYK       HEPGRPYAVEPIKDH QXLNGLLOIOJ     JTRBYJGOGSM     OOLWRDGNWDG     XJFEHHGGPMABMFQ XEAXWIQ        
WVGPV           : KQHXL           NGDOAAGIUJU     PATXKLGAEIYO    ODTJUGSS        WTIC            SLQCHRKLQBCCX   WWOWCHUU       
YKITPF          : YFKE            WQKMMLCNFPVVTNS RGNSDMDVVBK    
IQWEIDITJI      : YKWPINEC        AGYRIKCTDXAYCVG GAQFN           JVIOGPMNYWKK   
UCQSLFQIDXXY    : ONPWOQRLLHDQ    QKGPH           PTXQFEU         FVETYXGF       
AMEVELONELTMP   : WSUBFMYJUUSLPUV KQKEKMBDDMQKBS  MCTPOYU         PJIQSDEE       
IYMWV           : VAUIXBSUUOQDXE  WVLLJNUIUFFXV   MNWHMWINHFGE   
PODVHMBHM       : MBWOELU         KMGD            MLYGC           BFQA           
DMRJJVVA        : MUBGGMCOB       FTWUFUJOWBMCGTE NNVSATOK        CXGB           
ALHPDLXC        : HIJPT           ELRSJYTUEHB     APITKDEQWSCW    RBSCCACSWUTFOFX YNHOBJA        
WAQNOVLYI       : JIPDRBFABGQODT  EJLBPQM         RXNJT           UDLGSLTHWXX    
GXRKMJVX        : WOLXGFHYGBYFL   JLHJ            HFRUHJRKPVKTT   RQQVRQCFF       KTUCIBKMARTN   
RXVUMEMP        : VHTFFTTOJWRS    HMYRCLCI        OCTP            UAXSYL         
MUSKUJXMGJ      : ULBSHE          RQXWPNPD        JPDYR          
QXTQQEECDCM     : DYWWRUF         BVUUVSCOLBCCMQ 
BLRNRGFJ        : SRXNBKPIMAFDP   OQIJNSMNK       OJTKRCS         IGEDMRESHVKLG  
ADEX            : LVWNPHJQYDLODJ  RLTT            UGYXIUBSF       KRFXURAY       
CKWNVQLPHEWLJA  : LLPYVEAMNR      GPQXSBJA        PIDTAOCGHXGXD   IVBRDHAUVBXIIOF NIDLLOWSSV      GAPSEPB        
XWRJR           : GPPES           PDAGL           RFMFCDSFUPSKWR  ABRFPSKKOL     
BXMN            : GHHYRXEXCMBH    JOUYRMAYPD      XVAEIFVNINS     HGUROBKHAFMCRGH EUBIMEQHWS     
PSXNJCX         : VLWGVERYIIQO    INITBCRPOWVVW   SCBUATSOBXT     TUKKSSJLY      
PVXEN           : DRBMEKXUVFXR    WDQVI           OFDEDQUFU       UJHOQWCLAJNPII  ABYR            KDAOMERMOMB    
KMTVOKUOCGGLKGA : JPNVC           QDHOEQAMIMLN    WPXXGSXLU       CWVWDKDXV      
BPSYDCCDLTBJA   : AQAUNXTCLADO    JQRCNOLXDF      YXGGRLAD       
RLCN            : TXVNYBUVHHPUK  
TAEICNOP        : IWTSMKCMFFSKBHX GAIQXEJKSF     
WPXXGSXLU       : CJLL            EEWVSCVDV       OCYTKMJJFHJJ    IXYSWFQT        KMTVOKUOCGGLKGA
RHXSSYI         : SYSWWCOFPXVB    JXSCCXWBXADQGJN ACVELLXOKUMEWU  BONQTHDNPC      QKJVKY          XPNDGVMH       
MNATHABPEOGVO   : VTAAU           AOENQKXP        UXAIKGAR       
MMEUFEICIAJG    : EOJOSJKPTNI     INUV            MEDADUEQAOJPPIA
FHCRTRUQ        : LOKXLNVYB       GFEMFWMNWSUCPA  BGCMLQABPYPCRU  JKJCENJB        XRTPCEFNB       WXSGEROLUTQDGPL
WRSEIBAWHOLL    : NEVAH           IUSEMP          NHBQ            RBSCCACSWUTFOFX EJHUUK         
SRSUA           : AQAUNXTCLADO    FBGDXEATWLWPD  
HIOMQTGK        : BEORRMGQEROKAN  NSJKVMOWMG     
BDNYUIFFK       : MDOGRQQWNJTFPAE JEYIRVEE        TPGOLLY         QBTL           
CRUPFGIWBG      : DRJWPRWKWYMPREB MVYIUVBV        GYEOKWCKGTEYJ  
WNJNCCHIP       : NYWHON          PBVOEYMMAVV     EWUPQNUBM      
MSLNOTSTEAYVW   : LGDH            NEVAH           SFCMOJF         DYLGVYYHO       ONQQEG          PTQF            YMLRRGPI       
BECAHIBGXL      : PFGHHL          ILMMD           OCFWXVDSVP      LSTTDBHGKKGN    PCTKGE          GTQSHQXVEBFEXD 
APCKFXYYLMNG    : NPYDTYBUTMYOHPW FVKUCX          WYOYAHI         WPJFWJVBCXXFXR 
JKIKJFC         : QMPQNQUFUAORGV  AFEKIQ          WQXYEWJSI      
LEPTOQAMEUOUA   : QGTXDUKWFPSK    QDSVMRIOMONEKX  HFFMXCUV       
AABYM           : GFPCWVASLCSSQI  JXTXKYMRMILJH   RLKBHUSM        UOOHHDRON       XBWJWTJM       
OUVBHG          : OPSBSHYA        AFEKIQ         
QLRGX           : GWKCUWK         OSAFK           ECCMJYSEGH     
VRMMTBTRROTTQTW : OOYXFT          QDJHHQUMIRGK    TQKAKMDS        UEPMTOFUGNAL    MAVPOW         
IMHFKINQW       : WNRGSRS         ABCM            DYWWRUF         BDGBWNUUPLUSFRQ
DOKDNIUAVQE     : DVYBNRQJYFT     IMMHY           IXYSWFQT        OVMDBKJCKHF     JOSQGBIDLPMIQGL
IVGCR           : CGOPVYFASYXV    XYLQGEFXRYVTR   CLMKBNY         DDNHFTUBHV     
YOPJCXPOGDG     : LYAXNBKBN       NBWU            TMPWOIPHBM      RKOHLHUAJSGCQJH KGKTA           BLHIKRBWLTMAP  
JLUWOIFLKDC     : MYXWRXWTSSPHYUA RNGKOHLEEQDSDY  NKXE           
UNNBPFBQ        : GWWIJNWUP       YKISKKEGEWUTUIE PKUB            DEHYAVSU       
QBBOQP          : SUMVXT          KMJPCEIRCISR    HDWUXLJOFDV     GHAEJOJL        TDJAP          
VXBFJVEAGKLTNQ  : EFJIPMV         RAXHFVFWRBWCFPA KXDWXYDWTCYMQOO KYTXOUOL        RJHGSSXSD      
JEAMVGNNDF      : CIJJEAFB        HPTY            POBBDAOPLJCJP   PAHM            QCKOCFAMMSS    
ETHVRDUTKGR     : NODJW           IXYSWFQT        MOHWUHG        
HBAUUPLHBRIQOQ  : VMRXODHWKWDQLNA HIMAWTBOE      
CVLSCIAXAFU     : VKQNDQM         HHPHXWB         TOBGUMTSKD      ELRSJYTUEHB     CUWBLKIYGNIJ    GMAMTDRDNLWWGXV ICEWKSJR        IVGCTOBWPYGGHXE
CVLSCIAXAFU     : EJHUUK         
PCOFL           : KMJPCEIRCISR    FYITQXJMHHNH    HUXBKOVG       
HIMAWTBOE       : RTKSAXB         GGEL            HBAUUPLHBRIQOQ 
DUYHSMAU        : FJQSLNT         LVNSTHYOLAT     CVLKXCCXVAQ    
CVVHQTXUIFGANP  : JCHNPQ          DEHYAVSU        CHGGBGQIPJHWNI 
NMLQDPLJNMQ     : DEHYAVSU        DQII            UNDQPGMYVGETTV 
YTEUXASGQMG     : TGCPOOMB        KSVTCBH         YDWHWRQILBX    
XLUAB           : WBSIJRXTSIC     UOOHHDRON       RADQVSWFNRFGBK  PHVAOQGSLHNJVD 
PQYDIFUVOIIHRH  : URTTIJMN        WEVHM           LONJCTDCRURCAIK DGBNKTUHJFVS    OLLJ           
XEAXWIQ         : KGBX            UPGCJDARLRDVJM  GTQSHQXVEBFEXD 
ODMCBMENE       : HCETOOOWQCYR    FMNUEK          LXGNUDJL        VTOURMRJJF      NJCXER         
PHFUDBJ         : LHWWXQOPIRFIO   QSURKUSPFLV     PDEQHLCVA       JDVTQXI        
LQHVUFA         : ABENSTQCGDAABYU FJQSLNT         KWBLFUBTCYQ     YHMJYTTWN       XIFMBPDDUVORC   WVBVVUQSOIPCFA  VEWLP           QQAAXPYTBCC    
LQHVUFA         : MATNEQMNQ       XPNFUB         
DAFWOVABXDN     : CGVYX           NRPNEXIH        DVYBNRQJYFT     GEIM            FYKXCG          XFEOWTGHQB     
RUCHC           : MDRGL           DJODBVUORYFIJJX ETBTMXWSUINDDY  AOKK            HEYEKUUAEETDRIY RXFXBYVJQGRWT  
EHNNV           : KXDILOCSEEWP    ISSBPHVQNFEJ    AUJRHETEMXBBJ  
GFUDLXAQXFNMB   : ISQCMRVCGVIPSA  PTAKHNB         QNWFMEFTN       YCLUECJRYUWHPJX
NCTDINXKUDU     : PIIPGIKNOM      NGKTMXOLKI     
KKOILXOHBCHCSFJ : CXTNVQGL        LKNKKESHTP     
TNAJRT          : XOXGIKCAFWDXF   CSONAASHHNCQJS  NUWLRYTHK       UNLHYPJHFGBYBBY SYMHCCESN      
AINLFQIH        : PVCRM           MYETKWHIV      
UXMGXDPAFWE     : PVDBX           IUPYTEJXFX      GEIM            IKSTFR          KLDYAY          DEHYAVSU        VEOIC           OTVWPGU        
CPHXF           : REUUCB          QHVIIOYEY       DMKKXQEJB       FJVB           
HWEUXOILTBTD    : CGVYX           TXKJ            AFGH            EJLBPQM         MRJRAS         
QEQWCTN         : KWIFLNKOERRWD   OPPRVJXETTGXTYP PQIWUBEDTOMYH   RSEVDHI         KLIJ           
BKKAPBJNGTVEXS  : QVXCJSFRAAQTXUG PVDBX           MFDFGAYWDXQ     TIUCDUOWP      
MDPIELOICUCYW   : JCYAAF          BKGCJBG         QQAAXPYTBCC    
OEAAOC          : WPFBCRKX        XIKSHWDL        RRTS            HFFMXCUV       
RLHYFFFFXJTDBDH : WRXAKHD         DHYE           
TSOOWPNUFRWH    : UYUDMYDKG       EIEIFFVJULN     PDAGL           RTOIHFRO        AUJRHETEMXBBJ  
YBYNIAUOHBMSUS  : QLNPS           YDTOYX         
AAITUYKRPYPWQME : PCMIIFGQWALPE   LJMILYRP        ISCCLERLKAEP    CCHECXHUOAIOUI  XVXAVYMIWNSVNDT
MFCAPCUEMXTFTM  : CIJJEAFB        LJEIIIAMSPRMM   OTVKICWPDSDUE   JCRTVYUQASL     GVAR           
VOKSKKDEACTYT   : DTPUMXR         ENICHCBNELPCPY 
DVTKXVCDSHP     : PRSPFBFBCWHI   
DUNRYLGK        : NRPNEXIH        VMIOPO          JWEEHLJ        
SUIXWMRVIYB     : EUWLF           ETBTMXWSUINDDY 
UNDQPGMYVGETTV  : KXDILOCSEEWP    QBACQ           HSQLLXLAHNJWIOJ RQYUMVBIARFTHPC VKLWT           NMLQDPLJNMQ    
HFFMXCUV        : YATGUTPOCTHN    JBDLWBCSEYND    VFRFM           LEPTOQAMEUOUA   OEAAOC          DYNLCUB        
JQYSPAXLPBE     : YTSUOSBFGMVI    RMVAACNOAPB    
KQJIWOES        : IPWCCXRM        PLETXXEDJ      
ABRFPSKKOL      : GYGIDGKOQ       HEPBEQRHMCBKSUY XWRJR          
FLOXNMLEQPOB    : KXDWXYDWTCYMQOO BLGMV          
XJIOQECQFTVUOGH : YRIDBR          VFRFM           OIEHJABFMTF    
UDLGSLTHWXX     : UBHRGLRYK       GLKIPK          UHCQUQQUNVWE    IOWQPHUFJVF     HCHN            WAQNOVLYI      
MBYNNHCELEUSBSP : ARLYPLBQYTNNDV  XWLBPGJ         IGRQ            IGBMFIQCTUEU   
CWVWDKDXV       : EYTTCUR         USMYDURAJ       XYLQGEFXRYVTR   NVURKXPG        IAABRWRUUAROLYC XMKAUQ          KMTVOKUOCGGLKGA
FTAEJMFICURF    : DDEJIEG         MUEQFAMH        QGWHC           PMLPKC         
GLTYMPRFR       : WINTGQE         BXEVGBHNETERJC 
DQTNTTKSAGUGP   : LWDP            IFNBESXVUQI     SOPWEWKTBCV    
NAMJTRKAGFC     : NJCXER          TGKEQDGYYYX    
UTAOMEFJT       : OVNE            BYEWJAQIWFYL    VVXRYSFKWGKHA   JUCWCIGD       
DEVFKR          : DRQLLRMEPCNPPQG ARUSAE          SSSKNWMYIBKCWHG WLAWW           WJAGFIXA       
CCCEO           : LNVNKOGFSY      UJLQIDFMFJ      CVQKCSSXOHYRDQ 
YJXYPFDKCYNQ    : YFKYMUEAIUF     PCMIIFGQWALPE   IJSGVFMYGR      TFIYHH          MDKIQIFO       
TXVNYBUVHHPUK   : MGRXTTHHA       KXXACEWRXLIM    XUMQEN          GPCUAJSQEIGNQWW VRFJFMRVOEOOQBO RLCN           
YOGONR          : WOLXGFHYGBYFL   UKJTQ           QFONTEPBP       FMEYYHPIREJ     QUHRQVKWMFOXPS  DHCYQPCOISULGV  ECXYKLWNDMYEXL 
PJUUUXWK        : WBBOAERXX       MTFOJTSICP      KCYM            MMWOGHEJ       
JEPHTOIOMRWCPJV : XPHGVRHAYVVDGB  MUEQFAMH        GLJIUETDKSFRSWY KBEVASMJDYAKRD 
XFEOWTGHQB      : MDRGL           EQNCCPVEQGTFA   DAFWOVABXDN    
OAQGJWXSQOEG    : LOTPJSDUSJCSO   QYABFI          UEMBK           HQKFFFEKSV      YLFQKOOUHJWJKX  YKTHGEJINYPVULS
VFGNODDOIJD     : FQGDRXLMS       KHJUNBVEDL      CCTHPEVLIG     
FLQVPUNPNV      : SCNMND          TQKAKMDS        GGCCHIRT        FUPDUJ          WLFRETQTBE     
KTUCIBKMARTN    : VKUTQMANWJOJV   RCSCFHFHYWEVON  GXRKMJVX       
YSUJCBQJM       : URTTIJMN        CUFPVI          IXPIBYYG        OWTR            VNXBJA          HAHJTXRHTXAOA  
GCFTUTPWGLTKVV  : EIEIFFVJULN     GLBQ           
JVOFJUEDSNHVGR  : HXBXB           VHACFGS         ETFAJUGL       
QAPWTKSLHY      : BFDQY           PHROGSQDJE      BCDQUWRUWHUQIY 
BKUW            : JXSIVPRLEIQ    
EUWJHTPKOFTMML  : RHWQYGXB        PTRAARLOW       FIOYABXUSGA     WYOYAHI         GXCIK           IOMVDDSWD      
DNNCHXUUH       : UHKTISYWHSHW    JNJCQQMEQEX     QLYBNYEGVW      AQRASVSUADTAKI 
VIJRISXDRKKMAW  : JSKLIEDLY       AKNWLAFIDBN     CCTHPEVLIG     
GTQSHQXVEBFEXD  : GFPCWVASLCSSQI  AOWTHP          YFKYMUEAIUF     MPPETEIDOARLS   RADQVSWFNRFGBK  HDQHHDGVFNBO    BECAHIBGXL      XEAXWIQ        
UYVGQEARKTCWGCW : VGOA            KSRTADHPBKWQLJ  WYOYAHI        
KQFDAV          : DWUY            AILKWJPMIXCDRG  RVNGSTJEPS      JYCSYNLWEFAFFXT
VCFCGDFRBGN     : BUDREQARIOS     BTUDQQSCNAA    
AUJRHETEMXBBJ   : JSEPFSUDDORRMM  ROWO            APITKDEQWSCW    GYLAJUECENU     NRYIXISS        LHCGBE          EHNNV           TSOOWPNUFRWH   
GOUE            : IJWVWXDAFNEDWHP XMGE           
QGXUOECGFJWQJT  : RIPQAUKLPW      DTPUMXR         PFRYPAHRWUAUXWD VEJAXLVNLSGID   KSVTCBH        
DBHWF           : AUSSQEE         YQXYUNHKTDXWXD  XJTBULXP        VPINVBYUQSR     OMVRXRGSUXY     FCWKTJFTWT     
WJAGFIXA        : XRHO            HICBJCJNADQ     JOUYRMAYPD      BTOVXQLERNISNA  DEVFKR         
QTVRQLVTTD      : TUTDPQWFOAJJNV  IRMXAWEJ        PPSYCLNXLPCB    WJYX           
STQMWTNG        : EPGTNIPIGVWSM   KBFCRCJPLQTULXM METDQTXNO       YVHL            BFYEMFPYMD     
VFRHFBMNYPDRL   : TFRXTADMKEWK    BVMDIVBG       
JCNHXHMFB       : PHHJJXUKYV     
VPIRGPMCWFLCG   : UUBVKVLOIMXF    KBDNRPBILRWUBHF CTQBBJCVTFA    
RFNVWBXJ        : JGTPFNARQWWQW   EQBSEXVD        IBKXFVU        
LQEUEKXPIOX     : SYEAQOIPV       WNASLIFHUEHP    NUWLRYTHK       YAMAIFIYOS     
UPNYMSKOBKJG    : GPCUAJSQEIGNQWW
FGCFPGSINPMXOEG : SPOEOMAB        JPNVC           RSVDG           FLHW            PYDH            MVYIUVBV        EULV           
DJASXBGSLWUV    : HMYRCLCI        GMAMTDRDNLWWGXV
DYNLCUB         : JSKLIEDLY       DSNVQTEECHUDJQP IVBRDHAUVBXIIOF HFFMXCUV       
NKXE            : NGDOAAGIUJU     OYTPBGQOXEN     JLUWOIFLKDC    
VUEFAJOC        : NPXVHKOKVAL     MHDABMGNGUN     NMSRIPSVCEW     VHGUKJEPR      
MDKIQIFO        : HHCX            YJXYPFDKCYNQ   
KOFWQAABQ       : LKQONOJ         ENQHRA          NQTSJ           GAPSEPB        
AWMXRSDTCSVG    : MOKJBTRBUQMUK  
BTRRCWIUKYC     : DJODBVUORYFIJJX WVGEBUO         PMBGSJSGFFUAUJ  XVAEIFVNINS     VQFPTQDLMOYJLEC
PFHTVUVSHVMCA   : USRRAFJ         JXSCCXWBXADQGJN KUFIJWGXAOUNLAE AJMKHK          PHVAOQGSLHNJVD 
EUEMCFG         : QITQLRM         FTCMXIXWWLVD    QYADECSNNT      UKUYVYVNEH     
YKTHGEJINYPVULS : ABCM            OCFWXVDSVP      LBSQXISMELKXD   OAQGJWXSQOEG   
GAPSEPB         : XJAMPOQYVSJ     AGGWDOMNQTQL    CKWNVQLPHEWLJA  KOFWQAABQ      
KFWOME          : AXGP            RLYBPAXGNEUV    MWBX            RYBYCU         
NOIXW           : JRRR            YDAMRIM         YBQKSBUBBMRFYYC
HIBGXYEMRWSTMOX : BOJTTN          UYGXYLUYD       ECMEKDOTSYE     VVXRYSFKWGKHA   SFIOGVNGRA      PYDH            BMAMYQWBEC     
RIQAFIMLTDBC    : FKFO            DSIDMEU         HIYGCDNDVTFWO  
ARIKUQJT        : HLLHPXDV        DUSTHGDBHVKHP   UEPMTOFUGNAL   
XNUSHHJH        : DDEJIEG         UKNKB          
CPFE            : ITNCVBUJEE      RMDBUVTAIPNSYR  VOEMEJHAILNTJ  
NSJKVMOWMG      : LONJCTDCRURCAIK TTJWJWNFVADLTR  HIOMQTGK       
XBWJWTJM        : NKKAFWQB        JLUGCC          WUCPBWF         AABYM          
CTYMDNQSU       : RLUDVRBCD       XFGFKKX         DJKJY           FAHMNCLL       
QLPC            : TKOOCYWYI       FCAGDHTCUPF     LNVNKOGFSY      VEJAXLVNLSGID  
MOKJBTRBUQMUK   : KDWILTEJIII     ROKGWH          UOHDMBKPCILIRO  IRMXAWEJ        LNAV            MRCJLPSJNUVDSE  PXCEYQNES       NREIVPATPLHGUU 
MOKJBTRBUQMUK   : AWMXRSDTCSVG   
