DNEEGBYLGGCNC   : TYOQJ           FFNB           
VCESABOPFLTPA   : JYDDAYOA        CDQGJO          SGJLFUDDOPGG   
JQCMHISNJTYRDDF : KWMTSN          KPCEWUNGADF     RYXFQBNUQGBE    SUQHLSBXGJFMC   OPDGTNMMYYDHJDE ENNVEHB         ATDKQD         
LBJPVM          : ETGOJARJLD      PYIJAWXWETJUTH  JGPKPQOYP      
MCVYXLBLWSPMAXF : GRBYHGOYHCOSBRV KXHRKMPKDBE     TVOREPLT        LOFLKSQSWJGRHYV XHCKCBUPFKCYQJ 
JCOC            : VGYUSUM         HQUISDIPMUR     KRJXJ           QVEA            KOXD            EAESBWOBNR      CEIJGK          LQQBMIKFNJ     
JCOC            : EVEL           
RJMFNWUJLNY     : QNUMAQFBDYXBDM  MCUEFSIHLDUS    RFNSEPEBU      
LANXBBWTQJVQP   : TPIRDNUYCELH    NWTDEYPQJNFQF   QVYEO          
ARCC            : EQKOHVIYHSSNP   WNMIRLJYMXEMBXT PWEV            VJQETJQ         JOHVOQRTWYA     HDBCBBPTHIUG    XLRGAH          QMDWWIRSHVCR   
WOLC            : CRHAUKPSHXY     GFJLIEOCPBOT    DUAOAU          NHFUKCJURCMOM   NTKKKKSDOT      PEDWWWDDGYTQRNA
KANVNMLAMBAO    : GYWE            MAXVGCK         MGOLYV          TANIKTQLRFMQRR 
WKSHJJYWMS      : WNPCHSYQNACV    YXAMIQGQW       PEWM            PVFBAOQ        
QRBFFD          : HNXTXBUHI       WFBKACLFH      
SFVQVKDVAEXOJWB : BAKFOKYYL       DWGCJUIEXQN     QSFSGTBDQW      GOWOLQBQTWD    
EKOFKBXOTRPAAUJ : BPVLOUPSUQPLFFI FGMLLB          QYEOISLD        PJPAYB          YWVJFSMTOOVG    RLMLPL          GGKRGGARS      
BHLWUQUU        : HMYFWOEHACK     AGSLUYKNSYPCK   PGCJBPEL        NNYDJVWO        KPCLFMTHYSY    
SJHPMJWAACKD    : FROYDVEKY       SSIVOOUWAQX     UKMXENNXTC      JLODCOHVNDEFHX  ABDVMVWIH       FRWEVETSRNXXNG 
BXWQAWLJRO      : MQNYMHX         KXKKDNOVYW      WLAMUEWLAYKFU  
ELOWIJUB        : FFOYUG          MPUMSXHH        EYQFF           TBRREL          LBDPGRDYIENTRU 
CTHOS           : DQQGUVXHMAYLRJT JXUCUERTRUMYX  
OWTU            : REBFQJUHMFY     WBATFAR         PKGTKXN         TPRVMUGIX      
USANU           : WJQBUBHEIIDYIW  NPUROSJ         SWPVWHHHOAE     CLVVX           JUWREWAWIJLIR  
AERQAXFOUNA     : CRCIMJNPF       VNSIRBADSUPWL   RYYLXRLAY       ECAHQLJDKVTJ   
RUULF           : CLEMYDJFFRH     KMEAIHKN        TVOREPLT        KNXLI           SMBEMOQAFDLSL   GMRW            RHJUDUFFLUI    
GMBDJVGGQGULF   : VNRUIPFGKVWY    KLIE            QYTCFDYTNHQLNU  IUYABAWA        LNVMNDMWLA     
RYNSYSJUH       : CHDRF           VKXEQDAPAM      JDYOVWYQNMPXD   UCQIEDDWFNIV   
NBHKOMU         : MIEQGVAHYOMPOJ  XSKCKOS         CJJOCLYNJ       DVJDOAL        
CXXNVG          : IXVLNCEFJYYHM   OLAIXCH         CJMUITTUX      
MMQAU           : WAMPNTRGJOHJQWM RFVAGOGHPO      JURWIDVNVLQQUX  HXDIVMCA       
RTEMTYYQILGJSQ  : IHGRYSDTYIPDH   IXMWHTF        
INSMLTAHAVVPNVK : IDXXYYP         IBYJDPYHLHBHB   UUPQKI          EUJIH          
QGHFAHE         : WKUPCLYBDLU     QYEOISLD        IYUCXQMJBFFDW   RTSBWPYPHMFHWS 
PPYALSAVGVIUP   : BTCA            PDWTOHNCPQSR    JGGKWXGCYVVX    KPCLFMTHYSY    
ERGBHVYTAPBHVD  : JMIXOEOPL      
CWJUXLIQLEAH    : JQHTLV          MLGE            QNWLNFQOX      
UYYYRHCBECVE    : KCEVRFOUV       QXRUTX          SVUBJTPOYQWPLU  TVQXJIJHH       DCUFRRFEIVOKQ   DKWGWWHSBCW    
WNPCHSYQNACV    : WKSHJJYWMS      EBNX           
PCSXQPYRRQ      : PWKJLHDLOQDVF   MTGUIVNXSKBXOU  ULQHPQAFGM      TGHDRHFSSLKED  
TSFXQLQPAIR     : LUYCB           OIJR            PJPAYB          OHCIRFOGO      
BTAQTEMMVQI     : POSIALRPIMOQEMP
HXVYRMBMHGMASD  : PSPCBSEAJUTUY   ABYKHO          EXLPMKDLF       CGQCL          
UOKEPEGJAMXMI   : ISEHU           KKSOVDHYB      
WFWVDYPP        : IIYYDCXBVPMNU   YIFWYNTGCC      GOITHXWAIXT     AVSOVRRP        PDREACKYF       OLAIXCH         FMIPJJVR        EUEQ           
CAIPABUSX       : XYVLSYOUJE      VGVEXK          CKHMVXIQCWOGFX  FSPVC           AXJMWR         
DECJKNJY        : YUJNWSNIGCBR    WVGVQ          
XKBVRBTUA       : MHRPMTQHXFYA    QKACT           SSUMEPYDBDQN   
KCOMMGPQDIO     : QFCRXEQEKESJ    TQMJBQACERGGNP 
NTTWGHI         : WSELYVMIJSSVYXA HSFGOUQ         JAYJRUCGTNB     OHQQFMAB        EKOKAMJ         BMOWP          
UGSWE           : DVXE            SLJITCXDTOYETWT SGOEYN         
XAFA            : WSED            MDLHTNIRUAPJMYJ ERPUYPGFLS      DXDPS           REDSLMOKMYWP   
REBFQJUHMFY     : OWTU            SPXKNKJLMGX     KOXD            RSPU            GMRW            BNTLB          
SSXRBHAJ        : CRPGDEYGBFGUG   AKXOIGKF        MHRYFVCAP       WDQG            XKYDYCSTGRMTJ   MJKK           
ICCPMCPTCCMI    : RBRBFRKNOJEUJY  ECIBBLFOUPIVJ   XGQILGQFVKAJUPD GJGAAGAHG      
TYOQJ           : DNEEGBYLGGCNC   BLAFHT          UQVGIDIX        YFKFF          
VIIQDJ          : MVXPYPFOFHWRJ   IWGAD           ODTOMVU         ORXNXQTQMBIFYS 
EQKQVU          : LSNRRKSCIVL    
XKIADCEFQMLKO   : BVFQRAGPCPNJIX  HYFWME          YHOFCKWAAKVHF   RFQDXQROMG     
BAEYINRNWCTPOK  : OPDDCAYRMEYTD   FYRNAUBAOMCVIS  RCEBETVMVSY     BXWXES          XHCKCBUPFKCYQJ 
MGKWONC         : KXJGBSECFYBWNVQ DPWCMKRNTDXHI   KEQUKD          JBRNOGGDQWCR    RCEBETVMVSY     NXYENKVPAMDJ   
RIKHVWVVBVDAG   : YWMLFMRROKWP    JCASPMYNJAJFNK  VVPERDOIAJX     HXRWGL          BVOFSHWVWKLETI 
UTRWPHOBVB      : QAHKVDJLPYI     KYFUQYYFXRV     EGEYEBXNR       RIBRL           NRTEPRDFLNOKJ  
JAXWDSONDVJBTH  : YXDHVJR         EAYBTAQQIE      ADBNR          
PMGXFBRWBK      : LFMJMVLDD       ILQKYTIVTFKUNLW
PLDQ            : GJGAAGAHG       LXNHSP         
MSUJVPBJ        : QOQNMFEB       
YUWTDBL         : TTVKGJ          FRWEVETSRNXXNG 
JKXLEWMOEECKWYW : SEAQPNW         PVVPITAHIRDW    NTCP            FUJO           
VJMMM           : OUKFMNCVCQISL   QYEOISLD        HSTMLWONCWA     OYLCX           EGEYEBXNR       VARSGQU         REKIOQDOOJR    
INTHHYKVQTG     : VGINUTXUS       RKNSW           AKIYAKWKMVXNPT 
FMMTC           : CEGDUAQTXNW     ALJTS           BOBD            MFTJQE         
XEDUGDNCMAQBAY  : OUKFMNCVCQISL   TTGBV           RVHBV           IFOOTF         
VGYUSUM         : JCOC            WSED            OQJXSJSLXSYHUL  YNOAWLE        
DDSPRPTLP       : QIHIULEUYPQL    JWMM            ULBAVSEF       
OLHRBLGBDHDE    : VHHFCRBPR       VYBC           
ANXWGSJTXPPP    : PVLWDRTLMQTARNF URYYRGQN        NEVTSGVLFJ     
FKUULKIUEJGLMLU : OEXJXF          GWXRYLMAHQRLE   OLAIXCH         FDIVHLROMN     
STSIRPOMCL      : EAMTLML         IMEDDMMLKASH    WEOVNDUCQLDJH   LFPULYXHJ       HSWCVALHHLEJ   
TDDBKNWFYJQVNC  : BQYBI           OXYRLRO         FCIVJGBK        YRPEMFPBH       BKMO            POSGXHXGJF     
YRQWK           : CRLLQP          FOYBEYMSX       AXJMWR          MGKAPNJBJOTAY   BIGUFG         
QFTLU           : MCXPPP          PXLIIKOQQFGND   BWKUPPWVXXJITQ  EVOWFX         
XYVLSYOUJE      : CAIPABUSX       GEAL           
RFFK            : KFXSXTVKVUQ     HIKEFRFRSJDXT   UDTVBSDSXQ     
SOFUGXRSLKXFVV  : BXDEEOAWGDRJURI XNQOKE          VROOLBWYMUXNYA  OHCIRFOGO       CGQCL           MGXXJNXXMBOBN  
WUOKO           : LTSNKALBOUOLPD  YQFBNG          OUHJJDQ        
BLAFHT          : TYOQJ           BSBRPOVIXYQAAI  OKHPGELSKVGV   
MENFTUCCTVVFHVN : EBWTRIXOS       JBHIBEIY        VYBC           
RGCNUMELNPMUWGH : BRIDKCSQOYWL    VOBNHCGPLDXWM   DMXMRC          NDSQYXNDQVP    
NUQJQTLMPJTYIHF : LFMJMVLDD       XSKCKOS         MQGCOPVVQU      GEJHXKKOX       FLVFBPLYNYPHXA 
NHPLW           : XYYXGSW         QYTCFDYTNHQLNU  RSUCLPKC       
WKJJIISP        : KUJYO           CRWXEPHQN      
GLLPEHDQYPK     : SUETKLIWYRSIS   JGGKWXGCYVVX    NRMBLVARSHTFPGL YPWCXTGVVMF     HGUDKOW        
XUEAKNSVKMTXY   : PEFK            FWOLP          
GHXVCEJ         : SSIVOOUWAQX     PFKWJSY         WXMMTDMWRBHJPN 
VNWCEVT         : BGVWPFH         LEVAYMNKS       JDYORG          CNAPLBFRXTIXBXY BKMO            QNCYMEBHAG     
WTODTYRMVECPC   : HSTMLWONCWA     JBHIBEIY        QMDXIAFE        UGYUYIVDIKBTYO  EMGBLYT        
UKKTHOASEY      : WLVJACOLG       IGCLIRWYW       EBNHSDQY        VJCSJ          
BDNAWFWQT       : FOTCMGCQJLFU    KMERD           LRMSQGIVE       CEWFVLHHKSHTPF  GJRNIHNEX       FDPDQXLFR       NXQCNXXJFIFHX   LBDPGRDYIENTRU 
MTSCRYEJCHEMRA  : LKHSU           VDGRHJLELUF     KCWWN           RNXBQD          JDYOVWYQNMPXD  
HDPNEYPHMR      : JBWBOXJGKV      QEUFPTSBPXNGYB  FJKDJVJIV       EAYBTAQQIE      HCJJTC          MYBM            GFPYKEFEJPNAG   UEDTN          
UOUORJKML       : HLTCWRICFKQI    NGQMYUMBSUMG    XPSOKPHLJXTQNGH
MPNO            : AGSLUYKNSYPCK   EYBMNJXVO       RXIODPUNBBD     SBRQGHP        
UDRWCYATMGU     : FROYDVEKY       LAEJMILSERWMB   OEMHI           SNAFO          
NHVRC           : KPBNCKUADGY     QFHVCAQAPNJUWOC YRVXOB         
OTFYGSKLFDB     : DWGCJUIEXQN     JFFSOAJI       
CVBTVFUXBIFV    : KPCEWUNGADF     CJJOCLYNJ       OUHJJDQ         YLFTWDIV       
SENNIDCEIDLD    : BAKFOKYYL       QVPI            OUKFMNCVCQISL   NIGOIMISKTWHKMM
YKVCIXBKSW      : LDLC            NUACGFUXBGUGS   WIHNSIDFPGDS   
NUTXAPPTVFH     : QENMQFHNPIVU    HYSB            OARMAYDEGUHNHK 
ILLSRW          : UQVGIDIX        KDPYSSDLQGX     ECLRDQXRLBR    
KXJGBSECFYBWNVQ : MGKWONC         RGQPCJISJUW     RIRSCEGHE       DVFKVKBAURNBLPV LXPBCFJV        NDXLC           IDWKXB         
WJDSFI          : XLRGAH         
MQNYMHX         : BXWQAWLJRO      WBJRXXVSUXYKN   AHVNG          
RWUAANFE        : ODFXFNEHQKGTC   PBRDRX          JLDGP           RKILDEYHROGI    KEIDFDAMAUEVJ   SADLQYPC        XNAXWHSACO     
GFSTBLKAUNSDYUR : IHWWOEXSQHG     VGINUTXUS       TCCT            YTINNF         
LQESRPN         : YUBAJ           WFBKACLFH       VIEIOFFYLG      IMOXBBMMQAYAUI 
LNSBUWWCEPXH    : KLIE            UBMKKYJE        HSWCVALHHLEJ   
IIYYDCXBVPMNU   : WFWVDYPP        QYTCFDYTNHQLNU  UKSCUDQOO       XEBSTROTSK      PCBXHRULKJAIC   NLKEDSDOYGPO   
HKWXXNQAIPWMTM  : HVTLK           AGFHPW         
BPVLOUPSUQPLFFI : EKOFKBXOTRPAAUJ SGAFDYRTQPHDSLK RMAONTPC        YWVRYBBN        QLQWONTLSATR    LFCERTMULYVV   
MSMKRADRKSOXO   : NNSNVTBFCTEGVJB EBWTRIXOS       QBJA            LBDPGRDYIENTRU 
LPSHC           : MVXPYPFOFHWRJ   BWHHBJSTUA      SXQLWPJAGK      JUWREWAWIJLIR   XAADQBNKG      
FTBCKSNRXVGKRSW : GCYO            TSXC            RKKYDFR         WDQG           
UADGUTGJYRCRB   : IHHBSAHLG       SHAXFAX         JQNVD           XDGHJTNC       
CIXGLKYYCXX     : QAEFUYNE        YTINNF          TBRREL          EJEVDLJOUKN    
IPEIDBIGJGCPP   : QBLFEPCDJNNSWNL
HRWLXAT         : RKLEDUCMRKCYAPC VCQBFMGVUSAPH   GJGTHJBNI      
IFKJHMHHXSYEBC  : HCFQGAUEWS      CEHYYKSDC       PIMFRNPUH       HWTLJPPDADJE    QFFAUNA        
LKRRMHKRRC      : VEWKPGSOUULVDQN BJDKRCDJY       MCSN            XNAXWHSACO     
DBQWBYFMJMBSTB  : GCEQSUC         OEITXRUOTFQ     DBUQUFQRYYSJXKJ
SHQUPDF         : CSYFPDHRGDUGN   XGCIYWSFRUQT    JXEXQV         
WTQHN           : WBVSOELHGALEI   HCSDWTVSRKDF    MITTCJJWSUBML   CKGOHNMPIYK    
KCLNTLQUQD      : SUSAIJAVBP      WQBMPVEAVPBIOR  BFEXRGYCOD      RHJUDUFFLUI     LFRJSYKOINVNTWW
DHAYIN          : POGCNJMENTM     BSBRPOVIXYQAAI  JGGKWXGCYVVX   
QFQIKXRHRIRHRCJ : KSSCF           GWXRYLMAHQRLE   YFOAYW         
RFQK            : OSULFFDTARKK    XNQOKE          QVEA            MFTJQE          GYHXYLURTRAJ    UHDPHGLYKVYD   
HOJMVJNGA       : GTKJAPOISVHSC   LUJSL           LSNRRKSCIVL     OARMAYDEGUHNHK 
YHXHTVYDPIUWCY  : DBYLGULLKQUFYAC PBRDRX          MOSGFVDMSBRO    IGUWDNLPSUOWN   HSUYTJGGOARIFPR QNKCPYNPBATJGE 
JQQBET          : OHMEDGRKHC      BIAFOTXJWL      XGVFMIPMVKGWACT OGHR            XSTY            KRVGRSUAI      
SEAQPNW         : JKXLEWMOEECKWYW UJVOFFBV       
XYYXGSW         : NHPLW           QBJA            SMAJHYKAWEN     SUIQ            BUHVXHFTMBW     YQYMLRWWG      
WOSROURXGKQHOL  : ODFMCMKHRHBUVPQ
JPUCFKCXKBWJJQI : AXTBDNGR        LVBVFLSNBUFT    YJANA           QLQWONTLSATR   
PWKJLHDLOQDVF   : PCSXQPYRRQ      EYIORXXPAKFNH   LDEXXYJW       
SRGPVLBXJNBJY   : CGQCL          
CHDRF           : RYNSYSJUH       CAEIBQNDYE     
BSVFFK          : XGCIYWSFRUQT    LKYEBC          WFST            IOLUAYNDYEEWS  
IJDYCWFSTSVTFJV : KBQCRVTBXQNN    XSKCKOS         QSFSGTBDQW      NTCP            FXJYTBYXBOSLLPP GLSOTCKWAUPLPGF
LHQSKIXYLRVSY   : DITFQVDJB       UYSMNONLY       WYLNOA          SGJLFUDDOPGG    LIKTQIO        
QJRUIUTPPNINI   : LEVAYMNKS       AJLLRJYM        CEHYYKSDC       BNOMOIP        
YEEKLWEX        : KOMIAPOOCQS     WOOCXCYHWIIBIWK NVMXYTNWBKLLS   QIPIARXNP       MYBM           
EXTXVOWEGIY     : GNXHKOC         SKXURGAJ       
QVWILLT         : OHIUUKCMDYKF    TTEHPGRDSDCGCD 
VJACQLP         : XAVV            ABGVAPMF        PSCTGEHMRRCOOQM
RNVXN           : LTCTWICRQYXQJ   DECPKQ          LLFMLWSFPCCBGV  JJFLIOVTBC      CEWFVLHHKSHTPF  FOQCQL          FIGQRWKMUGXDBED
WJGVQMFPPXL     : KIEGMRVRK       DBJWWKSJDMCXC   MQWQGOTRFBGGBLK JPPALWBXEBFVF  
JYDDAYOA        : VCESABOPFLTPA   FOOCLYFND       ABNGNNLX        RGMMSADU        EBRD            QYNQLIMJGROXXXP MJKK           
FNSVFGREWL      : HFXA            BTPVAHUOP      
GRBYHGOYHCOSBRV : MCVYXLBLWSPMAXF EHJN            WGFEWGMDEGRWGX 
SMEVSROQAXKEU   : JDPKDYTT       
JDPKDYTT        : SMEVSROQAXKEU   WYLNOA          OLJIWOATBFFPJ   SLJITCXDTOYETWT MQWQGOTRFBGGBLK
DWPVXKTCFGGCBX  : RASCEPAPTQBYP   QYTCFDYTNHQLNU 
RASCEPAPTQBYP   : DWPVXKTCFGGCBX  EALYJGFRVTOPG   QXQTWHFQ        CCAAA           UCTDMXGOBIEU   
SQARJVSVRUBX    : XPXDVPHWFMIO    LMWUQEYKEXDYPB  RNVAOOUXAO      JOCJJRFOU       BKBTVANJRSSV    XQKHHSWU        FHVWY          
FADBTEVYKMY     : TEITY           SMCQYTCFN       PAMSXWUDBUXJLCI QHNVIH          GLAL           
IPEHIBCYD       : VJQETJQ         OTKLFHBDSKJ    
KBNGSKKQNPSQSP  : KWMTSN          HSWA            ODFMCMKHRHBUVPQ
POGCNJMENTM     : DHAYIN          CFJIO           LIEYRT          BQML            UHLKUSDIBOJUH  
XNTUBUKHNUTGKK  : SDLM            LENICEJ         JEKWII          XLRGAH         
CFRY            : JCASPMYNJAJFNK  NPMIHIAQX      
GHYTQLAEHOUGFOB : HSWCVALHHLEJ    STQDTBPVSFCQAV 
JOPYLKIW        : FTMBMBHURWY     RVJJOXXF        IMEDDMMLKASH    HJAYYDSCNC      CCAAA          
KBCCAXKKY       : WOAVLH          YQYMLRWWG       RLMLPL          DCUFRRFEIVOKQ  
BLJGSXDYFSDLETC : FXUKRDWIFQLKXH  MVIV            MLGE            YGMCUCWEJB     
FOOCLYFND       : JYDDAYOA        BSCJEPOFMRGXMHS XTVNAXF         TWVSNWGFSXOLO  
NNSNVTBFCTEGVJB : MSMKRADRKSOXO   ESWPEHAGRT      DAMJUY          RSGQHBHXX       AHVNCOVWMDLBM  
XHUCNCQCFE      : DVGV            UQRIHBG        
MTGUIVNXSKBXOU  : PCSXQPYRRQ      UURMRTB         DNUJ            GTGTM           EYQFF           JOHVOQRTWYA    
WSQXT           : UNVRMQEAHRNGSFF EBGSUNEQP       TYOOWEUJ        HRNRMXHAGI     
IQSVT           : UMYHC           VLHDBXTOQIDE    JGGKWXGCYVVX    BXWXES          TWCHHXKP       
BBPEN           : OUKFMNCVCQISL   TKTARQ          HYSB            FLVFBPLYNYPHXA 
LJTJYTCJUBBSH   : MDPWLCULMMNLDVR KYEWV           MLNJLLGQFVBYNT  LRWJPRXO       
LXYGOHWH        : SRSFPNWEDCSOY  
SUETKLIWYRSIS   : GLLPEHDQYPK     YWJFN          
LFKOGDXEPWDXLMW : SMAJHYKAWEN     NYQSWVXPGFBKCUO WKUPCLYBDLU     DXDPS          
QQQWKC          : SABQUJJACP      EJULEO          DCMMRJ         
SBJMTSGJGLU     : UYLB            UFMXCYX         WLLSHUBADYKW    NXYENKVPAMDJ   
TAUXRR          : UIQDLRBMQQLQJMU FQLORKBLACQRK   DCRF            DCUFRRFEIVOKQ   FEYRWFAYY      
RGQPCJISJUW     : KXJGBSECFYBWNVQ NIXQKLDEWB     
QAEFUYNE        : CIXGLKYYCXX     WBXVEMCSLHCQOTA CEAXYJGLN       PSCTGEHMRRCOOQM XEBSTROTSK      QYQVHOJF        ULBAVSEF       
BBCUEYVVR       : BJSG           
OAUGCFQWQ       : AUBRTTXKYFJSOSR PARD            LDEXXYJW        XFVPTRYTBPEE   
UMEUQKRPAY      : RHMIMLMSIHJ     NDGMS           QIHIULEUYPQL    HDKVMBET       
CCBWGBSFUWVUSCW : IYKYWIKULE      CKHMVXIQCWOGFX  LNVMNDMWLA     
UVQISDPO        : UKMXENNXTC      MMRLVCOUCNYX    JUBRMIKCKCKQ   
CIOCJOEMPESQY   : PPCSLY          PURLBRYIUFTKPX  WBCSDJ          UYYYQSVYH       KFACNEHQ       
LWTIPX          : WDSCQQURUABTOR  VGGAISJ         BNKIEUC         RVHBV          
PUCIEULVLKXWCAG : FKLQJN          AGSLUYKNSYPCK   XGSHPNYMJHUVLN  APJYEXOXJML    
HSGLOAMONJLWYL  : NQUYSPSHBIU     KMERD           TOPRNLV        
QHGYNENLRXJQAL  : YMPDDPVDMU     
SUSAIJAVBP      : KCLNTLQUQD      EJAIKIYCIYTIMC  TQWFVU          UQVGIDIX        ILQKYTIVTFKUNLW LDLC            XIOENVYTMT      UDWBYJWUPFKW   
SUSAIJAVBP      : JXCUAMOJBKK    
OMHAPXJXXYENK   : SVLMBL          LACEOUCX        UUPQKI         
LVPO            : TCSMS           QCGR           
PHFLJQWL        : WKUPCLYBDLU     LGMQCUHQPDH     GCMYUFOLQYSXQTL PHSV           
XCTMOD          : JMMUDNEOJ      
GCBHCB          : OHMEDGRKHC      DNUJ           
PNMDMFTWWC      : WLXCIBOL        CXJNBXQKJ       PYIJAWXWETJUTH  YSXOR           HDBCBBPTHIUG    UMWGXIYVL      
INUIAJGEEVS     : AKXOIGKF        TAYIR           SIEHDVIVYTXBUCL PCSQHJERDC      WYPLIEAE       
NCLOJPR         : MLGKUBG         IGUWDNLPSUOWN  
HIMNURHT        : WQBMPVEAVPBIOR  MHRYFVCAP       YPWCXTGVVMF    
LXAAT           : DCJYNG          KTMLGHCSCPFL    SQXWLQX         HSWCVALHHLEJ   
CDQGJO          : VCESABOPFLTPA   WSLK            WEOVNDUCQLDJH   LQQAUG          IOFVTUKFDJE    
TCDHTOXLOHTBUQ  : YUPVDASCJMW     JMMUDNEOJ       CUTIELIXVPON   
FKLQJN          : PUCIEULVLKXWCAG PCBXHRULKJAIC   DMXMRC         
FXUKRDWIFQLKXH  : BLJGSXDYFSDLETC HVTLK           MITTCJJWSUBML  
XSQIPTDI        : FBNQDPXALFJOBBI EPYOQCJ         CLVVX           FPEKVBWJVLHYT  
ITECFUUMSQYMTVV : YIFWYNTGCC      RSCVROYEWNNY    SLAAAPEQQHWKCQK ERNGNGFAJ       BOBD           
OJMPQQNLJVD     : TCDRMTFFDOTIMWN KNSVPGRNVIHJI   ATDKQD          WPQCNN         
CMVMI           : LVEOJLPHCEGWH   WBRSR          
QNUMAQFBDYXBDM  : RJMFNWUJLNY     TSOBCHARETSLA   ROEK            OIOBWX          FSMQHKCGKP      NTHYEFUWVKTW   
REFIURRSWWUJS   : BAKFOKYYL       GCMMWBOCUN      GOBLCIWUFITJER 
TSBHQPJHULMULOX : XADSXNWIXMYRB   IYUCXQMJBFFDW   NPJTBGIHI       FQQQMX         
DRFJAA          : PEFK            BMJHNWXE        XYLNNOUFNOPNR   KNAEFUIHCITE    QGFSDNYQFG     
RSAOQMH         : PGTGHRRHM       YHOFCKWAAKVHF   GBFNWD          GDQSFUNUCAABSLK
GCEQSUC         : DBQWBYFMJMBSTB  YXDHVJR         EYBMNJXVO       DNUJ            HEDAIWBAUVFXMHT
PNPMBGMCJEHU    : UKJILBURVNFOH   DVGV           
JXXCYOSNXVTB    : YSBKMPNBQXWTC   JLPFCNNH        YQBEI           IQRUUVH         HXDIVMCA        RHJUDUFFLUI    
MVXPYPFOFHWRJ   : VIIQDJ          LPSHC           IDBW           
WSED            : XAFA            VGYUSUM         DIWNNVBFLJHB    FOYBEYMSX       ETOPFJOBAKA     DCMMRJ          PGDN           
CEGDUAQTXNW     : FMMTC           CNAPLBFRXTIXBXY NLGWECGWF       XEVVOIMPIGIHBX  OUHJJDQ        
AUBRTTXKYFJSOSR : OAUGCFQWQ       LRDSMWONK       ISOEWANUSKXGV   CYPRFE         
WVLYCRDWTVSUJ   : JQMCOXITDCTWOG  RIEBSVCGXOE     PNGCAXRFBNGBXOO
XMLCEHV         : WKXI            JEKWII          SHAXFAX        
UWJEPAWIJTG     : SRVKI           PCBXHRULKJAIC  
VKPYHJWBGHSFVGH : TCDRMTFFDOTIMWN PGCTAOP         UVCXOUBFERBDJE  JOCJJRFOU       WAMJMONT        FYVOJPVQFYEG    RTSANE         
OFHJEQPTRNE     : JNSJCYNRSJTATV  HEJJRWCF        FXPTEU          YTFKCMSD       
HMYFWOEHACK     : BHLWUQUU        AXTBDNGR       
LFMJMVLDD       : PMGXFBRWBK      NUQJQTLMPJTYIHF OHMEDGRKHC      FTNGGEKDXDCSQNM ELMRO           MGGVUMQRRN     
OHMEDGRKHC      : JQQBET          GCBHCB          LFMJMVLDD       FNTBRX          UMIMDTDLQ       MUCHPKMEMRUHSVL EGEYEBXNR       RGGEFFMEPSNWM  
OHMEDGRKHC      : MYBM           
IHWWOEXSQHG     : GFSTBLKAUNSDYUR NDEXVFG         KLHVGGARPLIBIC  UYXDGGMTM       UAKVHGYS       
TPIRDNUYCELH    : LANXBBWTQJVQP   CUDTVQHGSA      UAKWATU        
RBRBFRKNOJEUJY  : ICCPMCPTCCMI    DDDCGAIF        IDUAA           RYNMKA          VVJFQSOLVLTC   
QFJMW           : OHIUUKCMDYKF    HDECPS         
ECIBBLFOUPIVJ   : ICCPMCPTCCMI    PBVJOMKNSO      XADSXNWIXMYRB   MPSJMHXGQXJSXY 
EBWTRIXOS       : MENFTUCCTVVFHVN MSMKRADRKSOXO   FYHRC           VEDHOKADNGH    
CLEMYDJFFRH     : RUULF           BAFRIFOMCIM     EAESBWOBNR     
FOACEJBOXFRUYK  : PLIDN           STQDTBPVSFCQAV 
WBXVEMCSLHCQOTA : QAEFUYNE        OTKDLWHCN       IEESKJCGGWCUDHT EKWLECPW        YLFTWDIV       
CPBE            : IVMOYRLHFLR     IDLSGQT         VUWVSJJWPQ      AXBUFBDXJCYUP   PPFPQTVYNKLYCW 
MFKKKD          : GYSOVWO         DYVGQCHHL       IJTYEHMCPF      PVLWDRTLMQTARNF
LPMKQN          : ECGLKXENUWMCGYP FBMPCFSV        YWXAQXNS        ISEHU           QLCMQTEVBRJPE  
WAMPNTRGJOHJQWM : MMQAU           VNRUIPFGKVWY    FEWPCUMDW       HMSW            BGMPKJNJDXAXFV  PYSGJCBADWJH   
SYFELRJ         : EWAXIVAMAI      QIHIULEUYPQL    WBENPEWJM       MDLHTNIRUAPJMYJ UDTVBSDSXQ     
EYIORXXPAKFNH   : PWKJLHDLOQDVF   NNTJWNPSKGQVQA 
TSOBCHARETSLA   : QNUMAQFBDYXBDM  QIHIULEUYPQL    VKXEQDAPAM      VWDJCQFJS       QHNVIH         
EJAIKIYCIYTIMC  : SUSAIJAVBP      CJVFQJOJ        XTVNAXF         GMHKVEXCURPGE   OAWCESUDQIIJHAY XWYSXBYYLXQ    
TCSMS           : LVPO           
QAWIGSCSUJYE    : KWMTSN          UNVRMQEAHRNGSFF YGMCUCWEJB     
HQUISDIPMUR     : JCOC            VNRUIPFGKVWY    IYTOATPKH       JISY            INSA            UCCKTOFSFDSM   
OTDDOCTOYFWT    : KNTAICOKDTRYE   NHMVMA          BHDHOM          XIPFXYLLTX      FMTCOGBQ        BVOFSHWVWKLETI 
ROSQ            : CGGADUE         ALRWNKQGOOA     OSFSJWDGGON     ANKU            INUJVKFWBUN     KGHTNIQWUN      OPDGTNMMYYDHJDE
EALYJGFRVTOPG   : RASCEPAPTQBYP   CTGACGPCBM      UYLB            NPJTBGIHI      
JMIXOEOPL       : ERGBHVYTAPBHVD  BDJOIKQQI       CTWVQVLRA       UDBO            LJWNYYKL       
JUGXPAUUAIVJOB  : MTCLG           GJWSOBDK        KFACNEHQ       
NWTDEYPQJNFQF   : LANXBBWTQJVQP   PYKFV           UDBO           
CTGACGPCBM      : EALYJGFRVTOPG   LCFGTHHML       TNQTWYSTRS      KMIWXXSIFCFQTK  SRSFPNWEDCSOY  
JJQA            : VLVOCSROFWWAVMX SRVKI           PEDWWWDDGYTQRNA THQANJBP       
UNKQROQHHCWMSEJ : SVLMBL          YXXWS           RRWLOFEGEEB    
XPXDVPHWFMIO    : SQARJVSVRUBX    MGOKGDMPKKOXAD  YQCMGFK         UVQEWKCQVLF     AERIB           TSXJBRF        
IDBW            : MVXPYPFOFHWRJ   QLUYREEUVYJHWIU RAWATQLEWPIRT  
ROEK            : QNUMAQFBDYXBDM  VMTSSKCFA       XLTF            LWXQVOENG      
LNUAICJI        : PYKFV           XGVFMIPMVKGWACT WXNJ           
YIFWYNTGCC      : WFWVDYPP        ITECFUUMSQYMTVV KNTAICOKDTRYE   VGTINLCIF       DTOUQO         
GNXHKOC         : EXTXVOWEGIY     BSBRPOVIXYQAAI  SOIITGUPWDYL    CJNMSPTLPHXN    OCHB           
UMYHC           : IQSVT           YQHBMEL        
HNXTXBUHI       : QRBFFD          XNGMJUSQFJVOYMY SVCDDG          BYUUWM          BPESO           MHJKAGIMI       GCGRFGBWY       DCUFRRFEIVOKQ  
HNXTXBUHI       : EEECI          
IVMOYRLHFLR     : CPBE            QBLQJPGW        ITHKTMFOCCASUQP GLSOTCKWAUPLPGF LVGGDUDABTCGYI 
ATSVITFNPODQIBT : FEKUPYGUPPTX    HIKFE           RACCXWR         TNDMULJKSMCWY  
ICWQY           : HLTCWRICFKQI    XJOHPKBGETEVFD  FLEGUBWOWT      KLVK           
HADSJKFBCFUU    : TKTARQ          WDNSKQS        
GOITHXWAIXT     : WFWVDYPP        BCWMJQBAOCOA    EFGAJV         
JVJCWXK         : VWDJCQFJS       SBRQGHP         BQML           
BDJOIKQQI       : JMIXOEOPL       NKHWVDPGRO      AEMVHG          DRNTOYUCBSO    
VOFFKOFHONHID   : MLGE            KNSVPGRNVIHJI  
FOTCMGCQJLFU    : BDNAWFWQT       AGSLUYKNSYPCK  
XNGMJUSQFJVOYMY : HNXTXBUHI       KLIE            FVHCSISIVL     
RROGN           : AUOFPUA         WMBGYEBUACTPCJ 
TTVKGJ          : YUWTDBL         LRDSMWONK       JOLWIYJT        XSKCKOS         SBAOL          
BJNOQDAN        : KXKKDNOVYW      RSUCLPKC        MGRQCYJYESOQME  DSORJMHKABY    
RVHPKGELQVEF    : OIOBWX          RNVAOOUXAO      LIKTQIO         WOVPKK         
RYYOWLUIBXSQOL  : VMUERFMQHWAFOBY NCJAXFKDU       JDXQTFJ         XXJOHE          XEWMEQLXAXGFHP 
OYVIUEYIMF      : LPYONGYWPKQDAS  IYKYWIKULE      RSXS            TYEMMOOHUWIEXA 
FCALHUMGJM      : ECKORDVGAR      BVWTKGKLJLSRETF XGSHPNYMJHUVLN  OAWCESUDQIIJHAY WLLSHUBADYKW    NYRRAMYFEINPKA 
GWUERNUDM       : YIDOAHYDBWGRIX  KKOWQVYVP       HXDIVMCA        WKNDPKRFHI      HRTIX          
DIUXMVICBDHFDUM : RUIMWXRGLMETRN  LISKWPSQIUF     IFOOTF         
KUJYO           : WKJJIISP        CKRJHQMKJP      JVYRTN          JOWRK           HPYXJVUKX      
VLVOCSROFWWAVMX : JJQA            UMLFSYMVN       YQBEI           HKYKFYNXBUTJ    JDYOVWYQNMPXD  
QBJA            : MSMKRADRKSOXO   XYYXGSW         WUWKMINWSY      GFJLIEOCPBOT   
PVVPITAHIRDW    : JKXLEWMOEECKWYW VPIDFLSH        KRVGRSUAI       SUFXGDA         GEJHXKKOX       CCQBESNKH      
TYJOPOLMQ       : SLWKCCKHQTPAO   LUYCB           MYTDXF          RMHSSQUIBBYJN  
BOQTQAUARQV     : LISS           
BPIIB           : UAWU            YUJNWSNIGCBR    MVIV            LFPULYXHJ       NTHYEFUWVKTW   
NASKYD          : VMTSSKCFA       PBRDRX          SSTWXDWLIRMJNX  GQFXWTCDOEKG    PGQKERXXEBQF    MGOLYV         
OTKDLWHCN       : WBXVEMCSLHCQOTA SOIITGUPWDYL    TWWMBE          OPDGTNMMYYDHJDE EKOKAMJ        
SPVSIORQR       : YWMLFMRROKWP    QBSFW           RDLAAUQWOXL    
BAKFOKYYL       : SFVQVKDVAEXOJWB SENNIDCEIDLD    REFIURRSWWUJS   FOYBEYMSX       TAUMYIBCRRT     CEHYYKSDC       AWUTQKL         XLRGAH         
ACAMILJROYS     : EYXKRYGGBPDU    YXSKKTVOLMM     VARSGQU         NJFTNW         
PRDAIWSBETDRB   : DMVSQUCDNCUB   
ECUSGUWHIFUTWL  : XMTAQIMDC       WVHK            DKMYPBEWX      
SVLMBL          : OMHAPXJXXYENK   UNKQROQHHCWMSEJ PNJWXSK         IGPSRJJURTYTH   PVFBAOQ         TIHNBSHHARSDA   AHCKYLJQFM      PYSGJCBADWJH   
SVLMBL          : LNIHAOP        
XEAEAEXDAFGVX   : XHAAC           CTWVQVLRA       FUKEEQQOWE      THQANJBP       
SWVDDTXCFTW     : SGYARDYIQXGVLOT ILMX            CGQW           
FLGSLGYLLBR     : BFPKNRPOJCYEWC  WNMIRLJYMXEMBXT HRTIX          
ESQKQ           : DVNHNPBKL       WKNDPKRFHI     
AJOXPTTN        : YDAUOORYRAWQP   GFJLIEOCPBOT    TSXVKGUEXAHJE  
CJVFQJOJ        : EJAIKIYCIYTIMC  EKHPNYMA        DIWNNVBFLJHB    GJEVXQ          GPKTSEV        
UKJILBURVNFOH   : PNPMBGMCJEHU    WJQBUBHEIIDYIW  DXIV            ULQHPQAFGM      OJRXXTFDNWIF   
BVFQRAGPCPNJIX  : XKIADCEFQMLKO   QAHKVDJLPYI     DIPPJHBESGAERQ  JCCUCLF        
TUVEEERIBLG     : OJLHOY          OAGFBGV         XWINR           DTDEVPFMJCDQK  
QVYXWWEPO       : XGQILGQFVKAJUPD PPFPQTVYNKLYCW 
VGINUTXUS       : INTHHYKVQTG     GFSTBLKAUNSDYUR WFBKACLFH       NTKKKKSDOT     
PQVWUPFYBLQ     : VFQQSUUWUGQ     WNMIRLJYMXEMBXT GJWSOBDK       
JPSI            : RAILOF         
YXDHVJR         : JAXWDSONDVJBTH  GCEQSUC         PXKQCNBSHXHFNV 
GMJBHBTXYQSOXRS : XNDB            UDGSSTRBCLOI    ITHKTMFOCCASUQP EAESBWOBNR     
KNTAICOKDTRYE   : OTDDOCTOYFWT    YIFWYNTGCC      YRQTWCKIEY      FJKDJVJIV       OJIRJUVJ       
LMWUQEYKEXDYPB  : SQARJVSVRUBX    KGUSQ           BVOFSHWVWKLETI 
KMEAIHKN        : RUULF           WNMIRLJYMXEMBXT
UQSNRWADLW      : VMTSSKCFA       VWHSI           NXIMN           IOKVEFJRYLK     TYEMMOOHUWIEXA 
CDCMJ           : PGDBYGAVTT      KNXLI           DTFNIJCROJUCU   DCMMRJ          LHWYRIUIVPP     OPNMBQEF       
RIRSCEGHE       : KXJGBSECFYBWNVQ WXTQATVCHMTTQY  EQBUEGFDGEAGDG 
OPEMMUFAPEASQ   : JFFSOAJI        GKECLFYNLO     
VSEX            : QPHEOEHAXGXT    YXSKKTVOLMM    
NBAWUVYAEIGUWX  : HYSVQTJAU       DBJWWKSJDMCXC   CCBUCNPALLGOIE 
KLWPNMUQILREG   : MRDIEA          JYSOLCVXVTS    
FQMIRLFPN       : WOOCXCYHWIIBIWK OXBRJFCNNFTSF   XVMJXWWPPWG    
TVOOTOOEAOV     : WLELD           FCIVJGBK        AWUTQKL        
BQHJEYQLXXCLG   : LTCTWICRQYXQJ   IHGRYSDTYIPDH   XXJOHE          FNFEHIFFJVBUJ   VQTPOSOJRRIS   
WLLKTHJKWDYNJCC : JFFSOAJI        HWRKDCSJJSV     UJVOFFBV       
SGYARDYIQXGVLOT : SWVDDTXCFTW     RKLEDUCMRKCYAPC CYDAMMEFCJRU   
BGVWPFH         : VNWCEVT         KGVEB           JPPALWBXEBFVF   PUAFJJJRPHE    
KIDTKHBDNADIGD  : NFHIOIELKPDCOMX PSPCBSEAJUTUY   NPCSYRMRLAYQD   TSXC            QBLFEPCDJNNSWNL SHQPGTGENA     
YDAUOORYRAWQP   : AJOXPTTN        VVPERDOIAJX    
XFMHIIRRKV      : DSIORTO         NJOBBBF         RIGC            XVWFUEFWRAOOTO 
MBQUGHUJJRABJ   : DPKEPFJAEYNAA   PKGTKXN         XHPXQIBNIQMD    JVNYQIJWCWBQON 
SLWKCCKHQTPAO   : TYJOPOLMQ       KUXFBNIFN       OFIV            KEAEVMCNGIKQST 
MMPBNIYUQVGCP   : IDLSGQT         JQHTLV          XDHXK           KAERKCUS        GBFNWD         
DCJYNG          : LXAAT           CRHAUKPSHXY     ITPWJCAGV       YTINNF          BVWTKGKLJLSRETF CWYEBNFABQF     PDIBGPRLDHEK    LUJSL          
DCJYNG          : TKNXLHOW       
PKXWCSO         : JQCA            PTBK            XAADQBNKG      
HYSVQTJAU       : NBAWUVYAEIGUWX  BIRMESJWYPF     EXLPMKDLF       ABFPGUYHVOYAH  
QQLUHUYJEA      : GRMMMECIEU      IJTYEHMCPF      BRNFMSA         XHRWLQBEGOIGGAX VOBYQOMB        LFRJSYKOINVNTWW
MLNXJMAECGN     : XGQILGQFVKAJUPD WLXCIBOL        HQINNCBC        XBUQNGMLWYXKGJV RHACGRVMEJGEOD  BMOWP          
YJRUTRQA        : USERD           RKILDEYHROGI    UVCAEMJ         EMGBLYT        
HNIQIJ          : TYGJVH          FUJO            OPNMBQEF       
MJXAUNAG        : MDPWLCULMMNLDVR UKJCB           MUFBGMC         FJVUKLCLNDHBHU 
ANEGBHHL        : KBQCRVTBXQNN    OCNFKI          BFEGDQKOM       BEQOSRGUXDSGR  
CFVSHHDVRTEBUTK : QWSIKQMDT       RIGC           
VHKVPMXDT       : ECKORDVGAR      UIAE            GIFRUYDSJI      OJESMQC         CYSNOKNCHQD    
FBNQDPXALFJOBBI : XSQIPTDI        VFUBVKW         UAFCKRUFMT     
CFEO            : OHCIRFOGO       EHJN            SUQHLSBXGJFMC   WKLDPNLI       
CVMALAXPTEUW    : FYRNAUBAOMCVIS  CNAPLBFRXTIXBXY UIIBYJO         BEQOSRGUXDSGR  
NDJLDUSOLURU    : TYGJVH          UHWK            FSVJSPLYIOMD   
TCLIFNG         : CKGUPB          EBRNAVSLFK      JLPFCNNH        LCKVM           MLSYWSB        
NRTNJPRGN       : QBLQJPGW        KIEGMRVRK       KPBNCKUADGY     MUFBGMC         HKJBGQXTPPRCLLL CYDAMMEFCJRU    CWQJPNVIXPBHWBB
TQWFVU          : SUSAIJAVBP      HFXA            QFRSFPBXOJS     MBGSIMAFC       BNWLINGIYNAGM   CYSNOKNCHQD    
KGVEB           : BGVWPFH         LBOBHJEWJIY     GPMRBVB         LEMDEUWQLKHJAS  PAXX           
XGQILGQFVKAJUPD : ICCPMCPTCCMI    QVYXWWEPO       MLNXJMAECGN     MBJEEAEXNH      SHQPGTGENA     
FQXXNDTI        : YQBEI           GFIVVJDWHPSJABF NPMIHIAQX       VFVECB          KDWBXEKBJHDU   
GPCKSHKYAU      : GLFKYNUTYXAASQ  VYHAER          KAERKCUS        DSORJMHKABY     PHTRFHUQQQGYJE 
GLSCWU          : NJHQKDTVRJL     BYUUWM          WNQOQJ          LKHSU           KGUSQ           ROVODWNAP       SHQPGTGENA     
TMOUSHSQV       : EOUOVD          QKQNVVUUEFR     CQTHJFQGQVUUJ   PORWNLLW        RWUYHQCFTDQ    
NGFTVKHRTRS     : IPPMOQJTRHF     VJPUQBJAMTBT    PEIPYXDDUQHNJIL EHJN            PHSV           
PGDBYGAVTT      : CDCMJ           MPUAESAHBHHFEO  PGCTAOP         JXEXQV         
LRDSMWONK       : AUBRTTXKYFJSOSR TTVKGJ          OJLHOY          NDEXVFG         GHPSEGAVGOYCGIV LQQAUG          SCDJLXHNWHC    
VGTINLCIF       : YIFWYNTGCC      YMBJGNJBLXIG    QYQVHOJF        YWVRYBBN       
XNDB            : GMJBHBTXYQSOXRS PDIBGPRLDHEK    PQBWBADFFG      BNTLB          
JCKDXS          : BCWMJQBAOCOA    KRVGRSUAI      
PYKFV           : NWTDEYPQJNFQF   LNUAICJI        TVOREPLT        KEUWQRFN       
SGWQMRYDFE      : PPCSLY          TCCT            YMPDDPVDMU      WLDFWGJVPEKVM   VHBXLAHSXDNWEFF
MDLAG           : LAQBYJOVKNJC    LHJFJKQAICPSE  
ORQBXPWOHVYM    : ONYUYGPUPOUBSG  QPJNDDKTOFUHR  
YIXXYMRBRXFFMIQ : PBVJOMKNSO      UQRIHBG         FUTTQUPGOWPL   
RGELWIJM        : CCHWXLGYAKXRY   JNSJCYNRSJTATV  ILFJPTCN        OFIXUIOHATK     SSFWBNQUFX      FYTTC          
YUBAJ           : LQESRPN         OJLHOY          YIDOAHYDBWGRIX  FSVJSPLYIOMD    PUVIPIVUAOKGK  
BTSAVHRWAR      : FMTS            BXDEEOAWGDRJURI MNUHTYIQ        IQRUUVH        
FFOYUG          : ELOWIJUB        TPORVYAX        WBJRXXVSUXYKN  
BSCJEPOFMRGXMHS : FOOCLYFND       WCCEQJGYFTPVSME
HQPCPRVTWDI     : COSIVQQN        KPLKLKQBFIQALLI WOOCXCYHWIIBIWK
APDCKGNQXF      : CPDNQBWFXFJIDON IBYJDPYHLHBHB   XIVCJSLKSJACGI  EOCFDMHMKV      RAWATQLEWPIRT  
MWDMKMFR        : EVPMHLVUNC      SVCDDG          CPBGRHTEFXRC    EWJUEC         
XJBNBWH         : CFXQ            YWMLFMRROKWP    RKILDEYHROGI   
BQYBI           : TDDBKNWFYJQVNC  HFXA            CUDTVQHGSA     
FULTL           : YURNGYDKYRJCE   CXJNDAM         TRTEFNAXDWUE   
BKAXNMK         : GFRMPB          JJFLIOVTBC      XADSXNWIXMYRB   NXYENKVPAMDJ   
UFASOBHQXQR     : YLPXMTKGLFDNDWA JPGSR           JGPKPQOYP       POBCWEUPJPF    
HSFRVMOJIBUJL   : DGJPIEMOEHT     DBWVKM         
ICIUFDAFXPIFIG  : BTCA            BVOFSHWVWKLETI 
CKGUPB          : TCLIFNG         YBHIIBQ         GBHIVBRJNUYNI   NHMVMA          IFCAFWVIIO      WOAVLH          EPYOQCJ         JCASPMYNJAJFNK 
CKGUPB          : NDGMS          
CPDNQBWFXFJIDON : APDCKGNQXF      IWGAD           JCCUCLF         YRPEMFPBH       OKAGVOCFIVUMMN  JVNYQIJWCWBQON 
VMUERFMQHWAFOBY : RYYOWLUIBXSQOL  THCQKQ          PXQWOF          YMQEWT         
QEHKFERGMBOPRDU : YHDVICRNC       GICFDSJH        LVIABCSNFNIAB  
PSTJXGBIGDN     : DPWCMKRNTDXHI   NCBBDDXUQYJH    FYYGECWHF       EMGBLYT        
EOQUSXH         : CPBGRHTEFXRC    JOLWIYJT        JOEJ            LSSXWRBNWIMPKB  QBSFW           NVKAXIXGMITWTM  CKGOHNMPIYK    
FYHRC           : EBWTRIXOS       HVTLK           BQKRRI          JXUCUERTRUMYX   QFCRXEQEKESJ    LRWJPRXO       
JTBEJQWFBXOEG   : NTKKKKSDOT      THFNBMAUBYJADXE
HVTLK           : HKWXXNQAIPWMTM  FXUKRDWIFQLKXH  FYHRC           DQWXQRJOSL      SGOEYN          NGQMYUMBSUMG    QVYEO           MGXXJNXXMBOBN  
IDLSGQT         : CPBE            MMPBNIYUQVGCP   BQKRRI          KMLTEVCTELPEPI 
KWMTSN          : JQCMHISNJTYRDDF KBNGSKKQNPSQSP  QAWIGSCSUJYE    PIFBUDSLMK      AVIPVGUQJ       LBOBHJEWJIY     KDWBXEKBJHDU   
FHAMKX          : NYNLNHGXWNEI    MGFLGSSLN       SCVMDRTJOOEBTHY
OGXXCSLMEVS     : MHRJVMH         WDFMOYGT       
OBJJRTIEQDTTIBT : GBHIVBRJNUYNI   YFOAYW          RWKWBVVWMXREI   ODFMCMKHRHBUVPQ
LUYCB           : TSFXQLQPAIR     TYJOPOLMQ       XLTRIKHXSNG     OHCIRFOGO      
AGSLUYKNSYPCK   : BHLWUQUU        MPNO            PUCIEULVLKXWCAG FOTCMGCQJLFU    POBCWEUPJPF     RSAOPIEBNASHV  
YUNPYJJJLFH     : ECKORDVGAR      INSA            DAMJUY          NXIMN          
AJCEJEKESF      : KXKKDNOVYW      HDKRYSKPEAP     EJULEO          VWDJCQFJS       THSSWWRPV      
DVXE            : UGSWE           NTEOWIUNKRWOLIL
DPWCMKRNTDXHI   : MGKWONC         PSTJXGBIGDN     BMSPUWAVTJBV    QPXVABDR        SESERULDFTD     IHSAALODIB      QQWQG          
HJQL            : WVJVMSIR        FUJIGHY        
CRCIMJNPF       : AERQAXFOUNA     VJQETJQ         NPMIHIAQX       OTPQJQREMDFIUO 
UURMRTB         : MTGUIVNXSKBXOU  PNWUGM          PEFK            LACEOUCX       
LPYONGYWPKQDAS  : OYVIUEYIMF      BBFPPWG         EJULEO          FBPSKN          FPEKVBWJVLHYT  
ECKORDVGAR      : FCALHUMGJM      VHKVPMXDT       YUNPYJJJLFH     HIKEFRFRSJDXT   QAFYXM          FBHNSXVDFVAQ   
MJRPOFFNVUVV    : QPPGGGFMXYS     DQWXQRJOSL      KWAL           
OIJR            : TSFXQLQPAIR     DBYLGULLKQUFYAC JKSSAT          IOKVEFJRYLK     BJBBJ          
CRPGDEYGBFGUG   : SSXRBHAJ        DITFQVDJB       KLIE            YFQFEIHCBITFSGG QIPIARXNP       QEXIAM         
EAKSGQIENFCGT   : VFVECB          QIPIARXNP       NIAU           
PNWUGM          : UURMRTB         WXTQATVCHMTTQY  BWAA            WYPLIEAE        MKQRMWL        
LTCTWICRQYXQJ   : RNVXN           BQHJEYQLXXCLG   QPQDW           BCWBRSSNAVKEPVN
WCCEQJGYFTPVSME : BSCJEPOFMRGXMHS XDHXK           CLTGPDOCQ       XBUQNGMLWYXKGJV
PPCSLY          : CIOCJOEMPESQY   SGWQMRYDFE      FNTBRX          IPPMOQJTRHF     PSTQ            JPGSR           JNHDQV         
NSTM            : LRMSQGIVE       SUKOTGTKRKE     MLGE            ABDVMVWIH      
KXKKDNOVYW      : BXWQAWLJRO      BJNOQDAN        AJCEJEKESF      IYUCXQMJBFFDW   REDSLMOKMYWP   
FTMBMBHURWY     : JOPYLKIW        GJHYXNA         MHRYFVCAP       VCQBFMGVUSAPH  
KXPX            : YIDOAHYDBWGRIX  MBJEEAEXNH      XIHXA           LFRJSYKOINVNTWW
JMKVMUGPKWN     : JHWVCOJXY       MTJSSMCOS      
ULRQ            : EEHBKGVKQ       EYXKRYGGBPDU    PIMFRNPUH      
UDCCBVBAILBXLTJ : QTSBTGOHSDS     UDBO            RFQDXQROMG     
EFKCMDMLQY      : SHGKVAIJMVJQ    KUAMTEBTF       HCJJTC          TNDMULJKSMCWY   MGGVUMQRRN      LBDPGRDYIENTRU 
CSYFPDHRGDUGN   : SHQUPDF         FFMNKJAL        HDKVMBET       
HLTCWRICFKQI    : UOUORJKML       ICWQY           ANKU            MEARPGUCDUMXERL RLMLPL          FVIS            TVFWMXPVMURJSE  HAISIOHMNSMQPN 
DBYLGULLKQUFYAC : YHXHTVYDPIUWCY  OIJR           
NLPB            : IXVLNCEFJYYHM   HMSW           
RXACAHNTPNWSOKY : YHDVICRNC       XIOENVYTMT      VHJNC           GBFNWD         
XMYQHEPHIXUT    : WLXCIBOL        PDBKD           TSXVKGUEXAHJE  
VCHTEJW         : KJRWOWMJRNU     KPLKLKQBFIQALLI GYWE            ANKU           
WQBMPVEAVPBIOR  : KCLNTLQUQD      HIMNURHT        YQWWQNTKARQ     FYYGECWHF       JNSJCYNRSJTATV 
UIAE            : VHKVPMXDT       NQUYSPSHBIU     ALRWNKQGOOA     LDWFPCTT        QSADTIIYFC      UADMUUVJO       KFMSIEVYODQSW  
XAVV            : VJACQLP         QIHWILJU        FJWEQJLXFY     
DSIORTO         : XFMHIIRRKV      COSIVQQN        JQNVD          
WBATFAR         : OWTU            UNVRMQEAHRNGSFF MISVKEWCGLB    
DCMVUIGXOO      : GBHIVBRJNUYNI   IGKC            EUCHPTYVXT      WOVPKK          YGSNHSG        
OKTTPMC         : YIDK            FGFGSPYOCFOH    JRWDYWSCNKX     LFRJSYKOINVNTWW
GYSOVWO         : MFKKKD          YTNTJYT         IOLUAYNDYEEWS  
CRHAUKPSHXY     : WOLC            DCJYNG          ODSBBQEYW       LFPULYXHJ       NOSYHPTN       
OPDDCAYRMEYTD   : BAEYINRNWCTPOK  ULIMDKVBXE      QIPIARXNP       TWCHHXKP       
KBQCRVTBXQNN    : IJDYCWFSTSVTFJV ANEGBHHL        JXUCUERTRUMYX   ABNR            ODFMCMKHRHBUVPQ FXGFTDSTJSHWWQ 
XNLDCCJ         : OLAIXCH         QNWLNFQOX      
GJHYXNA         : FTMBMBHURWY     KTNUETDRO      
QTFSNJMJ        : SFWSTXN         LFPULYXHJ      
PJVGXIE         : XKPISUJEUAJB    CFJIO           CFFRDKJH        DQWXQRJOSL      OFQQDKMFEVTJBFU CHAA           
WJQBUBHEIIDYIW  : USANU           UKJILBURVNFOH   RKNSW           JRXCTOTUPME     PGCJBPEL        QXMYNTOAWDUH    HWRKDCSJJSV    
FEKUPYGUPPTX    : ATSVITFNPODQIBT PEFK            DUTFLJBJMBXVAX 
EEEBPWC         : RXJWXAWJIRV     MLNJLLGQFVBYNT  RGLRR          
XKPISUJEUAJB    : PJVGXIE         KSSCF           LXPBCFJV        YSJXCNYXJYHNB   ADBNR          
GRMMMECIEU      : QQLUHUYJEA      KRVGRSUAI       HSWA            XHPXQIBNIQMD   
IYQXXT          : NWKIF           EDWJAJIEEVOWL   DQNVU          
XGCIYWSFRUQT    : SHQUPDF         BSVFFK          RMAONTPC        XWINR           NJAALBFEKDFRY   LXYYMYMLDL     
WLVJACOLG       : UKKTHOASEY      UGOYVYFNGQNKPD  XWINR           FIGQRWKMUGXDBED
BQKRRI          : FYHRC           IDLSGQT         ABFIDYI         MFTJQE         
DITFQVDJB       : LHQSKIXYLRVSY   CRPGDEYGBFGUG   UAYQO          
GSQOPEM         : KCEVRFOUV       QVEA           
HPQUXCVPMNHW    : THCQKQ          EFGAJV          RIEBSVCGXOE    
KFXSXTVKVUQ     : RFFK            DQNVU           RWUYHQCFTDQ     XWYSXBYYLXQ     VUIPL          
OHIUUKCMDYKF    : QVWILLT         QFJMW           JEKWII          OOJDPQXB       
CRLLQP          : YRQWK           ETGOJARJLD      BRIRKFVJJPM     HCPUGAWMDTO     MKQRMWL        
VNRUIPFGKVWY    : GMBDJVGGQGULF   WAMPNTRGJOHJQWM HQUISDIPMUR     WKXI            CXJNDAM         QTSBTGOHSDS     FHVWY          
FUBQYNV         : XWQICXOVO       QYLP            VJTHHFWUNB     
ACVDVH          : EBIQHAJTUS      DIPPJHBESGAERQ 
NYNLNHGXWNEI    : FHAMKX          VEBWRDWUYSLRF   DARUFTEGXAUQOCC RJFWUAJLQSYTY   RRKG           
BJSG            : BBCUEYVVR       WXNJ           
TYGJVH          : HNIQIJ          NDJLDUSOLURU    NDMOBPRVG       OEITXRUOTFQ     SKNSV          
ADQX            : FROYDVEKY       OEITXRUOTFQ     EEECI           DVDSYRV        
ILMX            : SWVDDTXCFTW     JWOIGWXE        JESXWK          FKXBPFU         PHTRFHUQQQGYJE 
CGGADUE         : ROSQ            CIDDBCTFSFN     WDSCQQURUABTOR  ONNYWAM         BEQOSRGUXDSGR   HOFUVDWNNRXJJ  
HFXA            : FNSVFGREWL      TQWFVU          BQYBI           OGHR           
EVPMHLVUNC      : MWDMKMFR        JOTJAS          LIEYRT          UGTANCOJQYNKR   XNDJWWIYC       NYLQ           
MPUAESAHBHHFEO  : PGDBYGAVTT      OVJLMARVUDB     KLVK           
LTSNKALBOUOLPD  : WUOKO           LVXUTQLCRNGTNHD MCUEFSIHLDUS    YKQPUL          HRPAPIGHJFRL    QDCHYR          FQQQMX         
CRFYRJU         : KLCM           
SVCDDG          : HNXTXBUHI       MWDMKMFR        XDPPOBPNXAGGB   KFHLNNWBGHCT   
YTNTJYT         : GYSOVWO         MGXXJNXXMBOBN   LNIHAOP        
ALRQWHTKMNRN    : KUDMMRMYGUQT    WNKPWVTDGMDGPL  LISS           
BIBWHDAML       : UYLB            RIEBSVCGXOE     GJGTHJBNI       UHLKUSDIBOJUH  
NFHIOIELKPDCOMX : KIDTKHBDNADIGD  QKYBPWQOJHFEH   ONNYWAM         BKMO           
BMSPUWAVTJBV    : DPWCMKRNTDXHI   ECRRLSW         LGRLPUGAF       WVJVMSIR       
MPMTYWKKEVUV    : GIEQKOQHW       HQMOXBNJPITCVG  PNJWXSK         NOSYHPTN        PYSGJCBADWJH   
YLPXMTKGLFDNDWA : UFASOBHQXQR     ETGOJARJLD      NPMIHIAQX       HCJC            GLAL            GBSPURALAQHQKH 
UYSMNONLY       : LHQSKIXYLRVSY   DDDCGAIF        QQMINEUEGT      ANKU            RNXBQD         
PWVLAUY         : OEITXRUOTFQ    
UMLFSYMVN       : VLVOCSROFWWAVMX
UNVRMQEAHRNGSFF : WSQXT           QAWIGSCSUJYE    WBATFAR         DDDCGAIF        HXYTIVDUJNXSI  
TFLSAHF         : KPQPOUOWCFWORL  NODGDQD        
MANCXBTSQSM     : CPBGRHTEFXRC    XIPFXYLLTX      UQXW            GMHXLSTBPTUUG   OCPRDJO        
JQHTLV          : CWJUXLIQLEAH    MMPBNIYUQVGCP   JDYORG          BDEGMIH         LWXQVOENG      
EBGSUNEQP       : WSQXT           TCXQXDCHGLWJMUJ LEMDEUWQLKHJAS 
VEBWRDWUYSLRF   : NYNLNHGXWNEI    PXLYAWWWAT     
EWAXIVAMAI      : SYFELRJ         KEYGO           UMWGXIYVL      
WYLNOA          : LHQSKIXYLRVSY   JDPKDYTT        UTOGBTOINEY     HCBBEQGVOTPS   
SDLM            : XNTUBUKHNUTGKK  CNJNPVEU        FQLORKBLACQRK   JGPVLMQNEBSYXK  KFACNEHQ        PYPJJJRLNE     
IHHBSAHLG       : UADGUTGJYRCRB   HPNTDUVIKIWEAL  KLEQV           YTFKCMSD       
MGOKGDMPKKOXAD  : XPXDVPHWFMIO    XWUXKGYGKASDBQT GPKTSEV         WBRSR           HQINNCBC        WLAMUEWLAYKFU   HKJBGQXTPPRCLLL
OYDALLLTTMOV    : GVTCRRCUCPAVC   DCRF           
DECPKQ          : RNVXN           SLMGHRVSFNBH    VJGYDUU        
QVPI            : SENNIDCEIDLD    ONNYWAM         FVHCSISIVL      MGGVUMQRRN     
CYHEFHT         : KSHLVFPS        BPEFACHLDOXDMT  QQMINEUEGT      LACEOUCX        WHECJWVFFNOHWM 
LVRYHLS         : YQHBMEL         BWAA           
DQQGUVXHMAYLRJT : CTHOS           PKQAYDAFSG      DJHXR           TUNEMJCMCBXFVHN TVQXJIJHH       BCWBRSSNAVKEPVN
JBBOLUUYQMXY    : LUJSL           WKNCNLTFWGSFST  PGQKERXXEBQF    SHQPGTGENA     
TVGMOMIKMRAMSL  : SSTWXDWLIRMJNX 
DFDOJEFU        : BCWMJQBAOCOA    MISVKEWCGLB    
AVSOVRRP        : WFWVDYPP        DXBVXHTRF       PYPJJJRLNE     
XDEMNP          : WUWKMINWSY      MKMPFSRISBMR    PIMXLLFLLYLYSQ  MAXVGCK         KDWBXEKBJHDU   
FROYDVEKY       : SJHPMJWAACKD    UDRWCYATMGU     ADQX            VEXS            OLHDULINQRWKEM 
VEXS            : FROYDVEKY       NLPNGSUUDKVAIYG ROHDDJIYSK      PVFBAOQ         KWAL           
AOXQLRJDHJIO    : QPQDW           MBHJVYVQGEF     BNWLINGIYNAGM  
VGVEXK          : CAIPABUSX       HCFQGAUEWS      UAEVOG          BJDKRCDJY       KFOCRCD        
DGJPIEMOEHT     : HSFRVMOJIBUJL   XOQMNSSMJMYT    XEWMEQLXAXGFHP  ANMHOLGK       
WUWKMINWSY      : QBJA            XDEMNP          OJRXXTFDNWIF    FYVOJPVQFYEG    TWCHHXKP       
PURLBRYIUFTKPX  : CIOCJOEMPESQY   OCQFNANCHSTF    TJGADS          NPCTWBP         MLSYWSB        
EEHBKGVKQ       : ULRQ            IKVMERXUA       AJLLRJYM        JIJHMPBBRWVT   
SGJLFUDDOPGG    : VCESABOPFLTPA   LHQSKIXYLRVSY   RHMIMLMSIHJ     STPASXGH        WHANNTISLL      ADUPGVGMQDP    
PBVJOMKNSO      : ECIBBLFOUPIVJ   YIXXYMRBRXFFMIQ NPCSYRMRLAYQD   MTJSSMCOS      
TCDRMTFFDOTIMWN : OJMPQQNLJVD     VKPYHJWBGHSFVGH NCBBDDXUQYJH   
OUKFMNCVCQISL   : VJMMM           XEDUGDNCMAQBAY  SENNIDCEIDLD    BBPEN           XMOOCNSY       
PGCTAOP         : VKPYHJWBGHSFVGH PGDBYGAVTT      TBHVQTP         HQMOXBNJPITCVG  UAYQO           PVLWDRTLMQTARNF DSNNGSNXBHEY   
VSUPEHP         : QWSIKQMDT      
KEQUKD          : MGKWONC         HCRQDKCVXCQA    XMTAQIMDC       UJTDKHFTVGGX   
OCNFKI          : ANEGBHHL        FBMPCFSV        SUKOTGTKRKE     IHYVQRXH        MVFNNR         
KYYMUADMHAIC    : KIJD            JBWBOXJGKV      WXRDVYGIN       QBLFEPCDJNNSWNL SSFWBNQUFX     
OLJIWOATBFFPJ   : JDPKDYTT        FTNGGEKDXDCSQNM ULIMDKVBXE      CJMUITTUX      
WUCPHDPWXRANY   : LDEXXYJW        JGPKPQOYP       CKGOHNMPIYK    
VEWKPGSOUULVDQN : LKRRMHKRRC      SHAXFAX         MHKNJU          UIJAXMJVCN      GBFNWD         
MKJPBTSSQ       : SWUFQQE         SNJAAM          IUQYSHEWL      
KSHLVFPS        : CYHEFHT         LNKFXDINWHS     UIOQUYDPRYOP    ANBSNGXCAKIX   
IYKYWIKULE      : CCBWGBSFUWVUSCW OYVIUEYIMF      UKSCUDQOO       KDPYSSDLQGX     VYUMMKPPVJ      QPGNKEA        
AQVMGY          : LAEJMILSERWMB   CIDDBCTFSFN     XAADQBNKG      
CRWXEPHQN       : WKJJIISP        KMERD           EJOHFOA         DCRF           
GIEQKOQHW       : MPMTYWKKEVUV    LRMSQGIVE       FLEGUBWOWT      EMIGGBK         ORXNXQTQMBIFYS  PUAFJJJRPHE    
EKHPNYMA        : CJVFQJOJ        RFNSEPEBU       DSNNGSNXBHEY    LOETBKGKTORHPFO
NGLGFJKWSBLFKTL : KXYOING         NYRRAMYFEINPKA 
EBRNAVSLFK      : TCLIFNG         PJHRRFIWSH      TAOTCARUQBXUQ   APYLVMTA        FKXBPFU         VPHWRYJTVOO    
EYBMNJXVO       : MPNO            GCEQSUC         DVFKVKBAURNBLPV KEXKFB          SFXPB          
GLFKYNUTYXAASQ  : GPCKSHKYAU      QUCIYDV         JJEBYVHOM      
QJOVVRBVSPJ     : NDGNUVIDJERNV   BDTJGFEVNQKGWY  GMHXLSTBPTUUG   ISQIEFLGTYWQNUP QMDWWIRSHVCR   
PFSCNGIXGVU     : TYOOWEUJ        MACHNO          RRKWO          
UVCXOUBFERBDJE  : VKPYHJWBGHSFVGH NMQLQSXPTM      KOXD            FHGHLE         
CVKGOPBQFHBGP   : MDMTPLCB        NLKEDSDOYGPO    IHCPHVSPDBJEMCY
BRUWWUN         : KLIE            WYKVSOIBCNW     QQWQG          
VSYNWCWDBBAN    : XLCATHALBSB     HXYTIVDUJNXSI   OULTBTQLJ       XVWFUEFWRAOOTO 
QDMHKTJQ        : PWEV            LEMPLLIALPOGGLE
IUED            : OHRCNM         
DXIV            : UKJILBURVNFOH   WKNDPKRFHI     
DWJC            : SQXWLQX         QLQWONTLSATR   
IGCLIRWYW       : UKKTHOASEY      RYNMKA          CRJDUWPELMXX    AIEACJMRIGO    
IHGRYSDTYIPDH   : RTEMTYYQILGJSQ  BQHJEYQLXXCLG   IGPLVUXUHQV     YXXNHARXNR     
BFEXRGYCOD      : KCLNTLQUQD      LVEOJLPHCEGWH   SXVMF           AWUTQKL         UCTDMXGOBIEU   
YUNXRAJBG       : QTSBTGOHSDS     QVEA            LRWJPRXO       
ABGVAPMF        : VJACQLP         JOLWIYJT        JWOIGWXE        SEOREORAWRD     MOJQSHPMRU      SYFSGDAGGAAR    JJEBYVHOM       RTSANE         
ABGVAPMF        : BJBBJ           JVNYQIJWCWBQON 
MIEQGVAHYOMPOJ  : NBHKOMU         JLDGP           CUTIELIXVPON    BJDKRCDJY      
ODFXFNEHQKGTC   : RWUAANFE        VEDHOKADNGH     UVYSYCN         MFJPY           UEWWFIVLU       UHDPHGLYKVYD   
YBHIIBQ         : CKGUPB          KFNKXWYBBMXU    VLATV           LFRJSYKOINVNTWW
BBFPPWG         : LPYONGYWPKQDAS  OQJXSJSLXSYHUL  WBJRXXVSUXYKN   GDGYQQL         RCKR            WCKXYG         
DVFKVKBAURNBLPV : KXJGBSECFYBWNVQ EYBMNJXVO       KUHJW           ASMYBF          EKWLECPW        PFXPRJKSVMIW   
RFVAGOGHPO      : MMQAU           ALRWNKQGOOA     BUHVXHFTMBW     HFCGXM          EOCFDMHMKV     
GLGIQ           : DDCLMBRDQQ      RUCFJ           TGHDRHFSSLKED  
NCBBDDXUQYJH    : PSTJXGBIGDN     TCDRMTFFDOTIMWN RKLEDUCMRKCYAPC AHVNCOVWMDLBM   NIAU           
WBCSDJ          : CIOCJOEMPESQY   TQWKCSJDIAA     XEBSTROTSK      PFKWJSY         JRRSUPKQSRDXP  
JQCA            : PKXWCSO         KEYGO           HRXPBVXV        TQMJBQACERGGNP 
IMASDEIHFLKJJ   : VEXUFTQWACEGDP  MHRPMTQHXFYA    YRPEMFPBH       WDQWSSVPCOSEFED
CKRJHQMKJP      : KUJYO           ARFVPPJXCWT     RGMMSADU        WYUBVHXDHIEDWH 
UCMWCGHQGAUM    : SEGHRMNEWSW    
ESWPEHAGRT      : NNSNVTBFCTEGVJB FFMNKJAL        BRIRKFVJJPM     DCMMRJ         
CKHMVXIQCWOGFX  : CAIPABUSX       CCBWGBSFUWVUSCW QXRUTX          BRIKL          
NYUBMY          : UJTNEMCNGLIMWU  LCUUGFNBFOSAXE  NVKAXIXGMITWTM  QNWLNFQOX      
JQASQI          : JYENNYPGSDFWDJ  RIEBSVCGXOE     FDPDQXLFR       MHKSMOLDPRTL    QFFAUNA        
MDPWLCULMMNLDVR : LJTJYTCJUBBSH   MJXAUNAG        DBIOVX          FCIVJGBK        YPWCXTGVVMF    
THCQKQ          : VMUERFMQHWAFOBY HPQUXCVPMNHW    UIOQUYDPRYOP    FDPDQXLFR       SHGKVAIJMVJQ    EKWLECPW        KFACNEHQ       
GBHIVBRJNUYNI   : CKGUPB          OBJJRTIEQDTTIBT DCMVUIGXOO     
ITPWJCAGV       : DCJYNG          NVMXYTNWBKLLS  
CFITQAKWDTGYWA  : SEOREORAWRD     UJJWGGGKUFP     BTPVAHUOP       GJGTHJBNI      
NWIBG           : NIXQKLDEWB      BRIKL          
LAEJMILSERWMB   : UDRWCYATMGU     AQVMGY         
DDDCGAIF        : RBRBFRKNOJEUJY  UYSMNONLY       UNVRMQEAHRNGSFF MMKTXQOTECRL   
KOMIAPOOCQS     : YEEKLWEX        YMPDDPVDMU      RLMLPL          XDGHJTNC        QMHW           
DCBXITVWWOAA    : CIDDBCTFSFN     LKHSU           LDWFPCTT        SKXURGAJ        NEVTSGVLFJ     
DIWNNVBFLJHB    : WSED            CJVFQJOJ        AUGSUWJANVNWKO  MGRQCYJYESOQME  EJOHFOA         MRYJT           OIKNGJYCWVNQBX 
VFQQSUUWUGQ     : PQVWUPFYBLQ     PBRDRX          UOAQT           YWVRYBBN       
DPKEPFJAEYNAA   : MBQUGHUJJRABJ   XGSHPNYMJHUVLN  LVIABCSNFNIAB   DMVSQUCDNCUB   
LLEPLAUDTQXON   : HCJJTC          TPRVMUGIX      
UGOYVYFNGQNKPD  : WLVJACOLG       YCAHANRUJJWLXAA PUNLHXBD        GSPFDL         
SBYEFOQI        : SEOREORAWRD     ISOEWANUSKXGV  
TCCT            : GFSTBLKAUNSDYUR SGWQMRYDFE      HPNTDUVIKIWEAL  DTOUQO          MBGSIMAFC      
PQQV            : ODDTFYT         FYRNAUBAOMCVIS  GPMEWKIIMBPW   
PRGWHMN         : JUOWAEQTJQ      YIDK            BPESO           VYDWVJATX       KPVXY           LXYYMYMLDL     
WFBKACLFH       : QRBFFD          LQESRPN         VGINUTXUS       WMSRQLJRJUGIMYY HQINNCBC       
XRNT            : JLSENRBU        WSLK            NPMIHIAQX       BOBD            OHEEJUUTTMEEWN 
QPPGGGFMXYS     : MJRPOFFNVUVV    LIJMHIJRRXDCQA  VDGRHJLELUF     NPMIHIAQX       LIEYRT          KBLATUOE        QKACT           IOKVEFJRYLK    
QPPGGGFMXYS     : KFMSIEVYODQSW  
HIKEFRFRSJDXT   : RFFK            ECKORDVGAR      PNJWXSK         CYPRFE          EOCFDMHMKV     
XLTRIKHXSNG     : LUYCB           PBTQIIQKGNFJVA  ODSBBQEYW       WRPN           
CEAXYJGLN       : QAEFUYNE        LFPULYXHJ      
DVGV            : XHUCNCQCFE      PNPMBGMCJEHU    MAXVGCK        
JVYRTN          : KUJYO           PTKBMLMFVD      UKSCUDQOO       HCRQDKCVXCQA    ERPUYPGFLS      DVQCOCNIVDQK    PONTLUIRBOJ    
LVXUTQLCRNGTNHD : LTSNKALBOUOLPD  AXBUFBDXJCYUP   DHJCVULQTAG     SESERULDFTD     UURL            ADBNR           XIUMRCQI       
SSIVOOUWAQX     : SJHPMJWAACKD    GHXVCEJ         GTGTM           GMRW           
NLFBHD          : DOIFPVHCYHJJ    MHJKAGIMI       PPKTGKXMFEV    
DWIFQXLMMSPIN   : ULPNVDOB        FDPDQXLFR       ULESQAXVRJ     
SMAJHYKAWEN     : XYYXGSW         LFKOGDXEPWDXLMW KFQOGSVQQTEYERB PVFBAOQ        
KPQPOUOWCFWORL  : TFLSAHF         FQLORKBLACQRK   PJPAYB          YFKFF           HEJJRWCF        VLATV           MPFMNEOS       
JWXUPMWA        : DOKMBRX         FCIVJGBK        YRVXOB         
VMTSSKCFA       : ROEK            NASKYD          UQSNRWADLW      LIJMHIJRRXDCQA  UCTDMXGOBIEU    FIGQRWKMUGXDBED
XOQMNSSMJMYT    : DGJPIEMOEHT     POSGXHXGJF     
VTTNGQPCM       : RSUCLPKC        QENMQFHNPIVU    LDEXXYJW       
XHXIKDKGBBYQO   : FSPVC           PXLIIKOQQFGND   JDXQTFJ         KRVGRSUAI       PKGTKXN         DCRF           
LEEXD           : UCOWHHF         FMTS            MFJPY           HSUYTJGGOARIFPR AHCKYLJQFM     
WBVSOELHGALEI   : WTQHN           ECGLKXENUWMCGYP XVPWNSEKDCCNL  
PSPCBSEAJUTUY   : HXVYRMBMHGMASD  KIDTKHBDNADIGD  BPEFACHLDOXDMT  NHMVMA          KVURY           QLUYREEUVYJHWIU ERNGNGFAJ       FUTTQUPGOWPL   
PSPCBSEAJUTUY   : HRNRMXHAGI     
VEXUFTQWACEGDP  : IMASDEIHFLKJJ  
LCFGTHHML       : CTGACGPCBM      IBOIQYDWAJSLE   VWMD            SSUMEPYDBDQN   
YHDVICRNC       : QEHKFERGMBOPRDU RXACAHNTPNWSOKY CNJNPVEU        FQLORKBLACQRK   SHFIROJEWSDMINE JEKWII          GSRR           
UYGRYIXILQVYUB  : JKSSAT          QTSBTGOHSDS    
OIOBWX          : QNUMAQFBDYXBDM  RVHPKGELQVEF    QMDXIAFE        YQFBNG          UCQIEDDWFNIV   
GCYO            : FTBCKSNRXVGKRSW MMKNJLKTNNXSIMF
QCII            : ITHKTMFOCCASUQP YLUUIPI         NLKEDSDOYGPO    WJCGHPXEAPVAHG 
JOTJAS          : EVPMHLVUNC      ALRWNKQGOOA     BRLTMBRSWPHGEW  FWIO           
NLPNGSUUDKVAIYG : VEXS            UWEN            TBRREL          KWAL           
AVSQAEC         : WMSRQLJRJUGIMYY
NQUYSPSHBIU     : HSGLOAMONJLWYL  UIAE           
BPEFACHLDOXDMT  : CYHEFHT         PSPCBSEAJUTUY   OIKNGJYCWVNQBX 
OXYRLRO         : TDDBKNWFYJQVNC 
LEGSHPNQ        : PSCTGEHMRRCOOQM DUAOAU          MPSJMHXGQXJSXY  RGLRR          
FWAIYIT         : PPKTGKXMFEV    
YTINNF          : GFSTBLKAUNSDYUR CIXGLKYYCXX     DCJYNG          LKHSU           SOIITGUPWDYL    MACHNO         
LEVAYMNKS       : VNWCEVT         QJRUIUTPPNINI   BICGFETATKFJ    BKMO           
DALSSFXPHGRRCWS : DNUJ            DTFNIJCROJUCU   HXRWGL         
FGMLLB          : EKOFKBXOTRPAAUJ YUJNWSNIGCBR    QAFYXM          CFLKHXCTAYLB    ATGY            MMKNJLKTNNXSIMF
JBQWODPKGSWB    : AXBUFBDXJCYUP   YQYMLRWWG       ALJTS           OJIRJUVJ       
ECGLKXENUWMCGYP : LPMKQN          WBVSOELHGALEI   EAMTLML         DPJWVG          PUAFJJJRPHE    
CIDDBCTFSFN     : CGGADUE         AQVMGY          DCBXITVWWOAA    CLSJHKOXI       MGKAPNJBJOTAY   SNAFO          
CPBGRHTEFXRC    : MWDMKMFR        EOQUSXH         MANCXBTSQSM     FOYBEYMSX       UNSIAKTTDTLYGEQ KEYGO           FQBNF          
GFEI            : DARUFTEGXAUQOCC RFNSEPEBU      
AKFDOHG         : BDTJGFEVNQKGWY  OKHPGELSKVGV   
OBPCOTTPCNAWSFU : PCSQHJERDC     
KUTRBCMB        : LRMSQGIVE       LBJACFIXCRNIN   YLFTWDIV       
UHDCNOS         : CYSNOKNCHQD    
GUHBRYF         : TUNEMJCMCBXFVHN GPMRBVB         UDWBYJWUPFKW    RFQDXQROMG     
YCAHANRUJJWLXAA : UGOYVYFNGQNKPD  LLFMLWSFPCCBGV  OLHDULINQRWKEM  TBRREL         
HGWWWPNDN       : ALRWNKQGOOA     UFKYIIWTWARFEBW VJCSJ          
GFWMMVONFQ      : TAOTCARUQBXUQ  
YMMILXJLA       : POSIALRPIMOQEMP LIKTQIO         KDPYSSDLQGX     PGTGHRRHM       XXDRDNWEJVUGU  
VGCSDTJ         : OYFNYRROQPOG    LVBVFLSNBUFT    SXVMF          
HGRODECCVRHOUHB : IDHVAIPEMK      XAISAHLDEMG    
ROHDDJIYSK      : VEXS            EWCFPWMTC       ANBSNGXCAKIX    SBXYFO          UIJAXMJVCN      PNFPKFL         EBEKASNHMR     
VEDHOKADNGH     : EBWTRIXOS       ODFXFNEHQKGTC   VFCKH           GTGTM           HDBRSL         
EYCTV           : GBQOVO          CFXQ            QJYTPRC         QPGNKEA        
WFFMOJRYRSRE    : GLPBF           MBGSIMAFC       HEJJRWCF        RIBRL           JXCUAMOJBKK    
PKQAYDAFSG      : DQQGUVXHMAYLRJT EKOKAMJ        
LNOPHMBESGQJ    : EUCHPTYVXT     
KIJD            : KYYMUADMHAIC    VJGYDUU         JDYOVWYQNMPXD  
NSUB            : YQHBMEL        
UCOWHHF         : LEEXD           MMMAMPLTMGSTT   SLFGNMAGVWDEGSK WKNCNLTFWGSFST 
USNKACLFUUX     : GIFRUYDSJI      LAQBYJOVKNJC    OXHU            SKXURGAJ       
KJRWOWMJRNU     : VCHTEJW         VHJNC          
QJLXRQ          : GEVID           QFTPNQCDV      
MMMAMPLTMGSTT   : UCOWHHF         NPMIHIAQX      
OSULFFDTARKK    : RFQK            MYTDXF         
KEXKSKWS        : MFTJQE          CKGOHNMPIYK    
OHRCNM          : IUED            DDCLMBRDQQ      BXWXES         
JQMCOXITDCTWOG  : WVLYCRDWTVSUJ   PXQWOF          UBUEICJ         IHOWU           KHBQAKPXSNJU    ORXNXQTQMBIFYS 
YMBJGNJBLXIG    : VGTINLCIF       MPFMNEOS        APPPGXXUEOV    
YSBKMPNBQXWTC   : JXXCYOSNXVTB    MTCLG           LNLKLKJVNWF     ALJTS          
RSCVROYEWNNY    : ITECFUUMSQYMTVV OSFS            QIHWILJU        SEGHRMNEWSW     XOUHU           WKLDPNLI       
NJHQKDTVRJL     : GLSCWU          JFFTBR          AUOFPUA         VWSHQSHSEVTHDD 
ALRWNKQGOOA     : ROSQ            UIAE            RFVAGOGHPO      JOTJAS          HGWWWPNDN       TSXC            MITTCJJWSUBML   WLDFWGJVPEKVM  
ALRWNKQGOOA     : IYUCXQMJBFFDW   QYQVHOJF        NYLQ           
OGDEVEFKO       : HTUA            RSPU           
BYUUWM          : HNXTXBUHI       GLSCWU          HYFWME          CPDU            GOWOLQBQTWD     TTNVYLERVMN    
IHJTBGJNY       : RVJJOXXF        KGHTNIQWUN     
DNUJ            : MTGUIVNXSKBXOU  GCBHCB          GCEQSUC         DALSSFXPHGRRCWS WDSCQQURUABTOR  IDHVAIPEMK      SBESOTDH        RTSANE         
DNUJ            : DBWFRVAHSHWHRDU XHPXQIBNIQMD   
BMKXRQIGILH     : WOOCXCYHWIIBIWK GTGTM           RKKYDFR        
GFRMPB          : BKAXNMK         NPCSYRMRLAYQD   XLTF            TOWIPDYGJ      
KCEVRFOUV       : UYYYRHCBECVE    GSQOPEM         DXOKSEXGSLTMV   QVTDKUP         AFLJQHLKTBHQNII
EAMTLML         : STSIRPOMCL      ECGLKXENUWMCGYP JISY            IYREJSC         HWRKDCSJJSV     RLRLXLCLKHXI   
UTOGBTOINEY     : WYLNOA          VYFYPA         
CLSJHKOXI       : CIDDBCTFSFN     RSUCLPKC        NBVJKWF         HWILPIWNLOMHHDN LNIHAOP        
JOLWIYJT        : TTVKGJ          EOQUSXH         ABGVAPMF        BIAFOTXJWL      KFVTULWEEQ     
HPTPRNHCBL      : LYBMXTWOYGXOD  
RNMKWWWO        : QVTDKUP        
HYFWME          : XKIADCEFQMLKO   BYUUWM          IDXXYYP         MLGE           
NPCSYRMRLAYQD   : KIDTKHBDNADIGD  PBVJOMKNSO      GFRMPB          BKBTVANJRSSV    PNGCAXRFBNGBXOO CXIRDGKGEEWLTYD GJGTHJBNI       QNCYMEBHAG     
RUAHHAEHQBOPI   : GIFRUYDSJI      CPDU            YSJXCNYXJYHNB   FEQXJVDOYSQO   
FMTS            : BTSAVHRWAR      LEEXD           VDGRHJLELUF     JMWL            HGUDKOW        
XMERYVGCUWFHODK : YWMLFMRROKWP    JNHDQV         
KMERD           : BDNAWFWQT       HSGLOAMONJLWYL  CRWXEPHQN      
JUOWAEQTJQ      : PRGWHMN         AXYWHQSF        YNOAWLE         DXDPS          
PJJMPLJMT       : HQMOXBNJPITCVG  JRWDYWSCNKX     QYITFL         
DWGCJUIEXQN     : SFVQVKDVAEXOJWB OTFYGSKLFDB     LXQQPLCOKKAHSF 
IKVMERXUA       : EEHBKGVKQ       QPDXEWE         TSXJBRF        
GJEVXQ          : CJVFQJOJ        NWKIF           IGKC           
RKQQSS          : WDSCQQURUABTOR 
NDGNUVIDJERNV   : QJOVVRBVSPJ     WBENPEWJM       KFED            HPYXJVUKX      
KXHRKMPKDBE     : MCVYXLBLWSPMAXF UFMXCYX         VWECARBJWQWPTSM
RUIMWXRGLMETRN  : DIUXMVICBDHFDUM CQNVVDAOIW      VXYWJC          EAESBWOBNR      BKMO           
JBWBOXJGKV      : HDPNEYPHMR      KYYMUADMHAIC    MPUMSXHH        SXJXPWQGPAY    
UYYYQSVYH       : CIOCJOEMPESQY   EMIGGBK         PHSV            DEFEBGAKH      
WADKMIEFVFQAFS  : CWVBYWHYYWOJWG  PCBXHRULKJAIC   GDGYQQL         UAKVHGYS       
FEWPCUMDW       : WAMPNTRGJOHJQWM OHCIRFOGO       FHGHLE         
TPJSXGRA        : EAESBWOBNR      KFHPYLXEEY      PAXX           
COSIVQQN        : HQPCPRVTWDI     DSIORTO         UELNSNKTYSKSLAS
VIHBMESOCF      : ATQIPBPCOBMC    PUKHVCLM        EHXON           UAFCKRUFMT     
YSLQCG          : SMCQYTCFN       GJWSOBDK        PNSOP          
IXQUCGNMCFDPXB  : PVMENPVOOMFPEUS EAYBTAQQIE      XKYDYCSTGRMTJ  
GCMMWBOCUN      : REFIURRSWWUJS   FAQPVS          PDAYJGCPE       EUTPFPLQN      
GFYOVKMPFQVVEAD : HMCJCRF        
QBLQJPGW        : IVMOYRLHFLR     NRTNJPRGN       CQMKIUTKMRTC   
JLPFCNNH        : JXXCYOSNXVTB    TCLIFNG         KGHTNIQWUN      XEKV           
DFYRUHLS        : WKUPCLYBDLU     XWYSXBYYLXQ    
PTKBMLMFVD      : JVYRTN          HYOG            LXYYMYMLDL     
UQVGIDIX        : TYOQJ           ILLSRW          SUSAIJAVBP      TRTEFNAXDWUE    JLKSXBBDUETVWY 
RNVAOOUXAO      : SQARJVSVRUBX    RVHPKGELQVEF    PXXV            QDCHYR          PAXX           
RKNSW           : INTHHYKVQTG     WJQBUBHEIIDYIW  BHDHOM          EAYBTAQQIE      YQYIFHGL        PYPJJJRLNE     
GEAL            : XYVLSYOUJE      IGKC            WOAVLH         
UCODMROLKGYHG   : LOFLKSQSWJGRHYV ANMHOLGK       
XEOXUTRFKKEMSIO : LDWFPCTT        QLUYREEUVYJHWIU EBNHSDQY        HVTIMXO         XDPPOBPNXAGGB   BMOWP          
BLIROVJ         : MCXPPP          JLDGP           UPWJHHLLN       XBQILDMB       
JWOIGWXE        : ILMX            ABGVAPMF        WXRDVYGIN       FIGQRWKMUGXDBED
OEXJXF          : FKUULKIUEJGLMLU
KLIE            : GMBDJVGGQGULF   LNSBUWWCEPXH    XNGMJUSQFJVOYMY CRPGDEYGBFGUG   BRUWWUN         ICWNXR          SHAXFAX        
WKXI            : XMLCEHV         VNRUIPFGKVWY    EKWLECPW       
QYTCFDYTNHQLNU  : GMBDJVGGQGULF   NHPLW           IIYYDCXBVPMNU   DWPVXKTCFGGCBX  LHRTDBCDHU      KBLATUOE        SHQPGTGENA      YGSNHSG        
TUMRBIDMQJJN    : AGFHPW         
IXRYYLBGQDCE    : ODSBBQEYW       RJFWUAJLQSYTY   XWYSXBYYLXQ     OIVELEABQMDRPM 
VSBQVUNINOQSEJC : INSA            KEXKFB         
YXXWS           : UNKQROQHHCWMSEJ JEKWII          VOBNHCGPLDXWM   EBNHSDQY       
XGBFX           : UCVIYKYDJYV     YFKFF           ATSI            IIWGFWJGGOYIGV  TVFWMXPVMURJSE 
HCSDWTVSRKDF    : WTQHN           KLHVGGARPLIBIC  QTSBTGOHSDS     KRVGRSUAI       SYFSGDAGGAAR    IMJKUJNCYGUT   
VXFFCVEATDUTCC  : JUWREWAWIJLIR   RYRIMFFHJ      
HCFQGAUEWS      : IFKJHMHHXSYEBC  VGVEXK          XDHXK           HNWNC          
ODDTFYT         : PQQV            SPTFIWKR        RACCXWR        
FVIJ            : IYHSSUBIV       EJEVDLJOUKN    
FNTBRX          : OHMEDGRKHC      PPCSLY          LAQBYJOVKNJC   
BAFRIFOMCIM     : CLEMYDJFFRH     NCJAXFKDU       XKJKDRMYLB      KGHTNIQWUN      NRROMWDAPEUPU  
LRMSQGIVE       : BDNAWFWQT       NSTM            GIEQKOQHW       KUTRBCMB        HCRQDKCVXCQA    JNSJCYNRSJTATV  LNYJMOVIRKHMLQ  DXDPS          
IDXXYYP         : INSMLTAHAVVPNVK HYFWME          SEGHRMNEWSW     PYQLNGY         BRIKL          
YQBEI           : JXXCYOSNXVTB    VLVOCSROFWWAVMX FQXXNDTI        BOBD           
KXYOING         : NGLGFJKWSBLFKTL VPIDFLSH        HDVQQ           FWIO           
FSPVC           : CAIPABUSX       XHXIKDKGBBYQO   CFJIO           WHDBELYRSGEO    GOBLCIWUFITJER  RJBWOYPEXFFIU   FLUUEP         
UIQDLRBMQQLQJMU : TAUXRR          NPUROSJ        
YHRXWALFWSAOO   : LNLKLKJVNWF     FVYAO           JMMUDNEOJ       INFFBDDLWKUEK   KWAL            GXGEXPQKKSXT   
OJLHOY          : TUVEEERIBLG     LRDSMWONK       YUBAJ           TJQGH           HSTMLWONCWA     KYMOWKVWR      
POSIALRPIMOQEMP : BTAQTEMMVQI     YMMILXJLA       YMQEWT          XMTAQIMDC       HVTIMXO        
AUGSUWJANVNWKO  : DIWNNVBFLJHB    KEYGO          
BDTJGFEVNQKGWY  : QJOVVRBVSPJ     AKFDOHG         YNNIHBMI        GPKTSEV        
GBQOVO          : EYCTV           DTDEVPFMJCDQK   HYSB            WFDP           
FOYBEYMSX       : YRQWK           WSED            BAKFOKYYL       CPBGRHTEFXRC    OJHMUBDMSQYOK   GTHMNBCMAQQ    
YRBFYFBMX       : MEARPGUCDUMXERL JHFMTXR         WOVPKK          DXBVXHTRF       NTLEHCA         EVOWFX         
TVOREPLT        : MCVYXLBLWSPMAXF RUULF           PYKFV           LYMN            UAYQO           QSADTIIYFC     
AFSQHUWGJPG     : MRMA            YJANA           ULIMDKVBXE     
QAAVYIYLGMHEBA  : ECRRLSW        
SLFGNMAGVWDEGSK : UCOWHHF         ODSBBQEYW       MLSYWSB         EFEI            MGGVUMQRRN     
MKJILRI         : FAEWXTDY        OLAIXCH        
BWHHBJSTUA      : LPSHC           LYBMXTWOYGXOD   JOEJ            GSPFDL         
KNDQ            : MVRJITNI        GHPSEGAVGOYCGIV NPCTWBP         EVOWFX         
ATQIPBPCOBMC    : VIHBMESOCF      BPESO           JESXWK          UEWWFIVLU      
UAWU            : BPIIB           JHFMTXR         AAXLNCYIKQ     
GVTCRRCUCPAVC   : OYDALLLTTMOV    RPMHGTI        
PUKHVCLM        : VIHBMESOCF      QIJIOEDPXKQKQEW QUCIYDV        
YPCVRBQEHMYJH   : XQYOYXTCFUQCPD  WDFMOYGT        VCMF            OPNMBQEF       
MCUEFSIHLDUS    : RJMFNWUJLNY     LTSNKALBOUOLPD  BGMPKJNJDXAXFV  NLKEDSDOYGPO    RYRIMFFHJ      
YFQFEIHCBITFSGG : CRPGDEYGBFGUG   TSXC            CADGCUCMIFJN    EBIQHAJTUS      JXUCUERTRUMYX   EAESBWOBNR     
NYQSWVXPGFBKCUO : LFKOGDXEPWDXLMW SESERULDFTD     JMMUDNEOJ      
CFJIO           : POGCNJMENTM     PJVGXIE         FSPVC           EFGAJV          YJANA          
KPCEWUNGADF     : JQCMHISNJTYRDDF CVBTVFUXBIFV    OKAGVOCFIVUMMN 
VCOVSVETGG      : VLCJWRCVV       MYTDXF          TWWMBE          KFHPYLXEEY      ANMHOLGK       
UKSCUDQOO       : IIYYDCXBVPMNU   IYKYWIKULE      JVYRTN          FMIPJJVR       
SUIQ            : XYYXGSW         FWNFCVBOABI    
OQMTHKWWHRSNNBT : IBYJDPYHLHBHB   FNFEHIFFJVBUJ   RGGEFFMEPSNWM   VOBYQOMB       
XHAAC           : XEAEAEXDAFGVX   LYMN            YYYPRY          CQNVVDAOIW      QQMINEUEGT     
RSUCLPKC        : NHPLW           BJNOQDAN        VTTNGQPCM       CLSJHKOXI       XNIDUYKLLEM     AILA            LNIHAOP        
YUPVDASCJMW     : TCDHTOXLOHTBUQ  JDXQTFJ         DMXMRC         
AATH            : LRVDOA          RIBRL          
BIAFOTXJWL      : JQQBET          JOLWIYJT        BKBTVANJRSSV    WDSCQQURUABTOR 
JOCJJRFOU       : SQARJVSVRUBX    VKPYHJWBGHSFVGH CWYEBNFABQF     ROVODWNAP       YYQAUIGNPFLMRY 
SEOREORAWRD     : ABGVAPMF        CFITQAKWDTGYWA  SBYEFOQI        RXIODPUNBBD    
UKVQIHP         : NDGMS           YWXAQXNS        HKYKFYNXBUTJ    SAPNYRTVXMR    
IAKLLWFQNASJHHB : EHXON           GSHGEGKPH      
XVPWNSEKDCCNL   : WBVSOELHGALEI   IPPMOQJTRHF     ETOPFJOBAKA    
JURWIDVNVLQQUX  : MMQAU           IVFBFYOVSJRCDH  MRJETELKVQT     FUKEEQQOWE     
WLYSBXIV        : DDFMIP          OGHR           
TBHVQTP         : PGCTAOP         PDWTOHNCPQSR   
QKYBPWQOJHFEH   : NFHIOIELKPDCOMX EUEQ            HKJBGQXTPPRCLLL
BUHVXHFTMBW     : XYYXGSW         RFVAGOGHPO      RGJHSVI         AXJMWR          RYYLXRLAY       RXCJGQPQMQ      NRTEPRDFLNOKJ  
WNQOQJ          : GLSCWU          CKGAWIE        
PKRPDGYLNDSVH   : DTOUQO          HJAYYDSCNC      RIVSLAGKMBRWS   LXNHSP          XVMJXWWPPWG    
FFMNKJAL        : CSYFPDHRGDUGN   ESWPEHAGRT      UKJCB           DQNVU           SVUBJTPOYQWPLU  YJSKKJGNMJDGEXL
WKUPCLYBDLU     : QGHFAHE         LFKOGDXEPWDXLMW PHFLJQWL        DFYRUHLS        EQKOHVIYHSSNP   UVQXGEK        
PBRDRX          : RWUAANFE        YHXHTVYDPIUWCY  NASKYD          VFQQSUUWUGQ     EWJUEC         
NHMVMA          : OTDDOCTOYFWT    CKGUPB          PSPCBSEAJUTUY   PIFBUDSLMK      XWINR          
AJLLRJYM        : QJRUIUTPPNINI   EEHBKGVKQ       PEPKESENDEX     SPXKNKJLMGX     VWMD            PNSOP          
BXDEEOAWGDRJURI : SOFUGXRSLKXFVV  BTSAVHRWAR      QYEOISLD        IFCAFWVIIO      OOJDPQXB        EBNX            PSWITVKDPI     
YUJNWSNIGCBR    : DECJKNJY        BPIIB           FGMLLB          UVQXGEK         NVMXYTNWBKLLS   ISQIEFLGTYWQNUP DTFNIJCROJUCU   QXRUTX         
YUJNWSNIGCBR    : XNPFQBWIXYOHJAA
NTEOWIUNKRWOLIL : DVXE            DUAOAU          SCVMDRTJOOEBTHY MCXFYOKOVQAC   
QYEOISLD        : EKOFKBXOTRPAAUJ QGHFAHE         VJMMM           BXDEEOAWGDRJURI MNUHTYIQ        GMTXQPOP       
UKMXENNXTC      : SJHPMJWAACKD    UVQISDPO        JXEXQV          WOAVLH          ODQORHMMJMJKS  
DYNNRKEFSS      : NPUROSJ         PYODOULA        LAYTE          
MRNBBIM         : NNTJWNPSKGQVQA  KEXKFB          SKXURGAJ        LHWYRIUIVPP    
TJQGH           : OJLHOY          FUKEEQQOWE      MHRJVMH         FYJJXCS        
WXTQATVCHMTTQY  : RIRSCEGHE       PNWUGM          KQLPGPXPJA      LCKVM          
LKYEBC          : BSVFFK          KQLPGPXPJA      HKVXNHHLAGGWW   TCATP          
LPLFBDOL        : ETOPFJOBAKA     LCUUGFNBFOSAXE  YPWCXTGVVMF    
LJUELOBNXN      : RMHSSQUIBBYJN   JRRSUPKQSRDXP   WTHCOWCBHPS     HKJBGQXTPPRCLLL ORXNXQTQMBIFYS 
RGJHSVI         : BUHVXHFTMBW     KKPOSMJYWDIDWQ  PGTGHRRHM       HNWNC          
WLELD           : TVOOTOOEAOV     KRJXJ           EPYOQCJ         TQMJBQACERGGNP 
QEUFPTSBPXNGYB  : HDPNEYPHMR      EPYOQCJ         YMTVNQQLXMKACHD DCUFRRFEIVOKQ   TJIBW          
ONYUYGPUPOUBSG  : ORQBXPWOHVYM    YFOAYW          QXJTV          
NWKIF           : IYQXXT          GJEVXQ          MGFLGSSLN       RSATJMDDJIDPMDP LASEJVNWHXSPII 
FAEWXTDY        : MKJILRI         PDWTOHNCPQSR    ARQTTUYMSPBSCJB
KPLKLKQBFIQALLI : HQPCPRVTWDI     VCHTEJW         XEBSTROTSK      YQYMLRWWG       FNFEHIFFJVBUJ  
YIDK            : OKTTPMC         PRGWHMN         FBECIQRWMVMNMFP SIEHDVIVYTXBUCL
IPPMOQJTRHF     : NGFTVKHRTRS     PPCSLY          XVPWNSEKDCCNL   JJEBYVHOM      
SPTFIWKR        : ODDTFYT         CCHWXLGYAKXRY   HTUA           
NDEXVFG         : IHWWOEXSQHG     LRDSMWONK      
RVJJOXXF        : JOPYLKIW        IHJTBGJNY       LHHSFYOWFYVSKLQ GJGTHJBNI      
SWQXHL          : RWMSI           CADGCUCMIFJN   
DQADER          : FTNGGEKDXDCSQNM BRIDKCSQOYWL    RSPU            RJBWOYPEXFFIU  
TXYRVFBYWWK     : KMLTEVCTELPEPI  GLSOTCKWAUPLPGF
LKHSU           : MTSCRYEJCHEMRA  GLSCWU          DCBXITVWWOAA    YTINNF          UOAQT           UEWWFIVLU      
SLAAAPEQQHWKCQK : ITECFUUMSQYMTVV YQHBMEL         ROVODWNAP       VVPERDOIAJX     EFEI            EVOWFX         
LIJMHIJRRXDCQA  : QPPGGGFMXYS     VMTSSKCFA       KUKNMGYCYUCQ    ODFMCMKHRHBUVPQ
LLFMLWSFPCCBGV  : RNVXN           YCAHANRUJJWLXAA OFQQDKMFEVTJBFU ARFVPPJXCWT    
KHWVVEHHYBFEDY  : PRWKYGFXVJKL    CCBUCNPALLGOIE  LXQQPLCOKKAHSF  CYDAMMEFCJRU   
IKRNYGKTLBXPE   : QIHIULEUYPQL    RFQDXQROMG      FSVJSPLYIOMD   
NRRWQOSVVBWWGB  : NLKEDSDOYGPO   
HHLUYYVFLQSOQLU : OHCIRFOGO       UYXDGGMTM       VGGAISJ         WDFMOYGT       
YNQWGFPED       : HSBQPBARH       UVQXGEK         ITHKTMFOCCASUQP YQFBNG          CYPRFE         
BCCE            : LGRLPUGAF       ROVODWNAP      
JLSENRBU        : XRNT            EMIGGBK        
TQWKCSJDIAA     : WBCSDJ          MOJQSHPMRU      VVPERDOIAJX     SXJXPWQGPAY     APSP            UELNSNKTYSKSLAS
HSTMLWONCWA     : VJMMM           WTODTYRMVECPC   OJLHOY          KJXEVXFCC       XDGHJTNC        EVEL           
PEFK            : XUEAKNSVKMTXY   DRFJAA          UURMRTB         FEKUPYGUPPTX    FHGHLE         
BSBRPOVIXYQAAI  : BLAFHT          DHAYIN          GNXHKOC         ERNGNGFAJ      
UCVIYKYDJYV     : XGBFX           HVYOICVS       
FBMPCFSV        : LPMKQN          OCNFKI          UYLB           
HRGHRYHTHQO     : WVBFAKRTCVJTO   ULESQAXVRJ      RVXQNE          DKWGWWHSBCW    
OYLCX           : VJMMM           GOWOLQBQTWD     HDKVMBET       
LYMN            : TVOREPLT        XHAAC           RKKYDFR        
OAWSHPRDXJ      : YBANPOMKCGUES   JUWREWAWIJLIR   VHBXLAHSXDNWEFF IFOOTF         
HDKRYSKPEAP     : AJCEJEKESF     
CNJNPVEU        : SDLM            YHDVICRNC       DXOKSEXGSLTMV   EDWJAJIEEVOWL   LBOBHJEWJIY     CFLKHXCTAYLB    VHSDF          
ETGOJARJLD      : LBJPVM          CRLLQP          YLPXMTKGLFDNDWA IBOIQYDWAJSLE   OFIXUIOHATK     SCDJLXHNWHC    
PNLOIVHNVW      : DTOUQO         
XMOOCNSY        : OUKFMNCVCQISL   LEMPLLIALPOGGLE
YSINDIH         : PYODOULA        MDHJVBRJN      
UMIMDTDLQ       : OHMEDGRKHC      CWVBYWHYYWOJWG  THQANJBP       
BMJHNWXE        : DRFJAA          HOFUVDWNNRXJJ  
LYBMXTWOYGXOD   : HPTPRNHCBL      BWHHBJSTUA      AAXLNCYIKQ      FUJIGHY        
YRQTWCKIEY      : KNTAICOKDTRYE   UVQXGEK         UFMXCYX         JUWREWAWIJLIR  
NMQLQSXPTM      : UVCXOUBFERBDJE  KFNKXWYBBMXU   
PJHRRFIWSH      : EBRNAVSLFK      UYLB            JUWREWAWIJLIR   LXIDWQ         
JBOOL           : PFKWJSY         KKPOSMJYWDIDWQ  ULPNVDOB        WEOVNDUCQLDJH  
UNSIAKTTDTLYGEQ : CPBGRHTEFXRC    DGWLVOXGRCBXEHR PGDN            THQANJBP       
LIKTQIO         : LHQSKIXYLRVSY   RVHPKGELQVEF    YMMILXJLA       ILQKYTIVTFKUNLW SXQLWPJAGK     
YBANPOMKCGUES   : OAWSHPRDXJ      PDIBGPRLDHEK    DGFFRGOUIWDI    HGFWPQHBWA      EJEVDLJOUKN    
AXJMWR          : CAIPABUSX       YRQWK           BUHVXHFTMBW     TAYIR           PNNSRXJPVMVDSVN PEDWWWDDGYTQRNA
NKHWVDPGRO      : BDJOIKQQI       ICWNXR          VIEIOFFYLG      LUJSL          
SRVKI           : UWJEPAWIJTG     JJQA            BVWTKGKLJLSRETF MPFMNEOS       
WMSRQLJRJUGIMYY : WFBKACLFH       AVSQAEC         DQNVU           YSXOR           RYRIMFFHJ       KFVTULWEEQ     
IXVLNCEFJYYHM   : CXXNVG          NLPB           
UJTNEMCNGLIMWU  : NYUBMY          KUDMMRMYGUQT   
VUWVSJJWPQ      : CPBE            FBECIQRWMVMNMFP KFNKXWYBBMXU    GJGTHJBNI      
QPQDW           : LTCTWICRQYXQJ   AOXQLRJDHJIO    OULTBTQLJ      
PSCTGEHMRRCOOQM : VJACQLP         QAEFUYNE        LEGSHPNQ        HEJJRWCF       
PIFBUDSLMK      : KWMTSN          NHMVMA          GICFDSJH        SMPMGTRVVQASNGI KWAL           
DPBR            : IQRUUVH        
WVBFAKRTCVJTO   : HRGHRYHTHQO     PJPAYB          FDIVHLROMN      IHSAALODIB     
GFJLIEOCPBOT    : WOLC            QBJA            AJOXPTTN        QYLP            OJHMUBDMSQYOK   DJHXR          
GXBOUWRAYDTSHS  : TAYIR           RKILDEYHROGI    AAXLNCYIKQ     
BHDHOM          : OTDDOCTOYFWT    RKNSW          
XSKCKOS         : NBHKOMU         NUQJQTLMPJTYIHF IJDYCWFSTSVTFJV TTVKGJ          LYMNDLAMCJMSTV 
VYFYPA          : UTOGBTOINEY     QAFYXM          XFJISCTLEJBF    RFQDXQROMG     
ICWNXR          : KLIE            NKHWVDPGRO      LAGDVFM         CBODRDLON      
QYWYC           : PDREACKYF       SMCQYTCFN       NDMOBPRVG       JYSOLCVXVTS     XAISAHLDEMG     GLSQFRVFOOJEBK 
NQCNLNPVCI      : VFCKH           WHANNTISLL      JGPKPQOYP      
AKIYAKWKMVXNPT  : INTHHYKVQTG     YQYMLRWWG       DCMMRJ         
OSFS            : RSCVROYEWNNY    XCIRD           YJANA           PTBK           
VLCJWRCVV       : VCOVSVETGG      QQCFIWMDUBBTL   DCRF           
YVWKWAUT        : GJGAAGAHG       YDGFRTHNJHBWPRK MDHJVBRJN      
KRJXJ           : JCOC            WLELD           SNJAAM          FSVJSPLYIOMD   
EYXKRYGGBPDU    : ACAMILJROYS     ULRQ            SRSFPNWEDCSOY   WDNSKQS        
YQHBMEL         : UMYHC           LVRYHLS         NSUB            SLAAAPEQQHWKCQK PBTQIIQKGNFJVA  AXTBDNGR        HXDIVMCA       
GIFRUYDSJI      : VHKVPMXDT       USNKACLFUUX     RUAHHAEHQBOPI   EUJIH          
IGKC            : DCMVUIGXOO      GJEVXQ          GEAL            MMKTXQOTECRL    SABQUJJACP     
QIJIOEDPXKQKQEW : PUKHVCLM        SHQPGTGENA     
PEPKESENDEX     : AJLLRJYM        RSGQHBHXX       RHACGRVMEJGEOD  KEAEVMCNGIKQST 
OCQFNANCHSTF    : PURLBRYIUFTKPX  MCOWRMU        
NPUROSJ         : USANU           UIQDLRBMQQLQJMU DYNNRKEFSS      XDHXK           ULIMDKVBXE     
KUXFBNIFN       : SLWKCCKHQTPAO   PORWNLLW        RXCJGQPQMQ     
VPIDFLSH        : PVVPITAHIRDW    KXYOING         FRWEVETSRNXXNG 
MCXPPP          : QFTLU           BLIROVJ         WYSAW           EBIQHAJTUS     
JFFTBR          : NJHQKDTVRJL     LENICEJ         JRQVMJ          KUHJW           PTBK           
BWROHYEYUVKAC   : QSFSGTBDQW      HQINNCBC        NYRRAMYFEINPKA 
ULQHPQAFGM      : PCSXQPYRRQ      UKJILBURVNFOH   USERD           ATSI           
NUNQOE          : LDLVLNYQNUBVLPH XMTAQIMDC       WDFMOYGT       
MVIV            : BLJGSXDYFSDLETC BPIIB           BEQOSRGUXDSGR  
MVRJITNI        : KNDQ            VJTHHFWUNB      MCNHCFANL      
YYYPRY          : XHAAC           PXKQCNBSHXHFNV  AVIPVGUQJ       AHVNG          
XNQOKE          : SOFUGXRSLKXFVV  RFQK            TWCHHXKP       
AKXOIGKF        : SSXRBHAJ        INUIAJGEEVS     IMEDDMMLKASH    FTJRATNNFKWAVUX DBWFRVAHSHWHRDU
IYHSSUBIV       : FVIJ            EMOJT           YVAPKBNTHWDTFCM
JLRILSVCJJJQJVQ : LBJACFIXCRNIN   FWIO           
FAKKVTKD        : NMXYUYNGROJ     SNQTUVHQ        GJGAAGAHG      
FAQPVS          : GCMMWBOCUN      LDIFLNMYT       FFNB            XLLCH           QMHW           
KLHVGGARPLIBIC  : IHWWOEXSQHG     HCSDWTVSRKDF    SBGHQLVRX       ERPUYPGFLS     
NCJAXFKDU       : RYYOWLUIBXSQOL  BAFRIFOMCIM     RLRLXLCLKHXI    FKJUKEDJMFLFG   HGUDKOW        
DLGBEILRPJAXMRN : GJRNIHNEX       DTDEVPFMJCDQK   KJOWECVD       
DOIFPVHCYHJJ    : NLFBHD         
ECRRLSW         : BMSPUWAVTJBV    QAAVYIYLGMHEBA  JJFLIOVTBC      TTFKQLYOYCLBU   FXJYTBYXBOSLLPP
FQLORKBLACQRK   : TAUXRR          SDLM            KPQPOUOWCFWORL  YHDVICRNC       PGTGHRRHM       UDWBYJWUPFKW   
JJFLIOVTBC      : RNVXN           BKAXNMK         ECRRLSW         EOUOVD          SXQLWPJAGK      EVOWFX         
SUKOTGTKRKE     : NSTM            OCNFKI          AOXIRGNVC       GMHKVEXCURPGE   WJCGHPXEAPVAHG 
OSFSJWDGGON     : ROSQ            KTMLGHCSCPFL    WGFEWGMDEGRWGX 
WFST            : BSVFFK          ODQORHMMJMJKS   IOKVEFJRYLK     QEXIAM         
USERD           : YJRUTRQA        ULQHPQAFGM      XCIRD           HCJJTC          PUAFJJJRPHE    
NJOBBBF         : XFMHIIRRKV      BWKUPPWVXXJITQ  JPVHRDNJSAO    
PXLIIKOQQFGND   : QFTLU           XHXIKDKGBBYQO   JYENNYPGSDFWDJ  DTYLLSJMVYFWQWY
GYWE            : KANVNMLAMBAO    VCHTEJW         QBSFW           RXCJGQPQMQ     
BVWTKGKLJLSRETF : FCALHUMGJM      DCJYNG          SRVKI          
CPDU            : BYUUWM          RUAHHAEHQBOPI   UXKTGRRPXAFA   
JDYORG          : VNWCEVT         JQHTLV          JXUCUERTRUMYX  
OKHPGELSKVGV    : BLAFHT          AKFDOHG         AJNLNVIW        WMBGYEBUACTPCJ 
CQNVVDAOIW      : RUIMWXRGLMETRN  XHAAC           UYXDGGMTM       WGFEWGMDEGRWGX 
TAYIR           : INUIAJGEEVS     AXJMWR          GXBOUWRAYDTSHS  OJIRJUVJ       
XIPFXYLLTX      : OTDDOCTOYFWT    MANCXBTSQSM     LAGDVFM         PGDN           
DUTFLJBJMBXVAX  : FEKUPYGUPPTX    PWEV            WHMLB          
AXBUFBDXJCYUP   : CPBE            LVXUTQLCRNGTNHD JBQWODPKGSWB    FYRNAUBAOMCVIS  XNAXWHSACO     
TCXQXDCHGLWJMUJ : EBGSUNEQP      
MKMPFSRISBMR    : XDEMNP          SQXWLQX         KUKNMGYCYUCQ    YAPAH          
FMRHL           : JWXNWCVBYXNI    MMRLVCOUCNYX    WLAMUEWLAYKFU   VEWDIVGJNGH    
HQMOXBNJPITCVG  : MPMTYWKKEVUV    PGCTAOP         PJJMPLJMT       KYEWV           OULTBTQLJ      
LNKFXDINWHS     : KSHLVFPS        HFEWGSVI        EBNX           
BCWMJQBAOCOA    : GOITHXWAIXT     JCKDXS          DFDOJEFU        EMUYRTNYCWEDJMR XDPPOBPNXAGGB   ATDKQD          MDHJVBRJN      
YTWUCMJ         : XXSBWX         
WOOCXCYHWIIBIWK : YEEKLWEX        FQMIRLFPN       HQPCPRVTWDI     BMKXRQIGILH     ABNR            XWYSXBYYLXQ    
YMPDDPVDMU      : QHGYNENLRXJQAL  SGWQMRYDFE      KOMIAPOOCQS     QGFSDNYQFG     
OHJHGYVKYAJI    : KEIDFDAMAUEVJ   JHWVCOJXY       NJFTNW         
TSXC            : FTBCKSNRXVGKRSW KIDTKHBDNADIGD  ALRWNKQGOOA     YFQFEIHCBITFSGG
KDPYSSDLQGX     : ILLSRW          IYKYWIKULE      YMMILXJLA       VYDWVJATX       CDBSYPXY        BNOMOIP         NNYDJVWO        SSUMEPYDBDQN   
EOUOVD          : TMOUSHSQV       JJFLIOVTBC      SBGHQLVRX       DTOUQO          AXYWHQSF        YXAMIQGQW      
TNQTWYSTRS      : CTGACGPCBM      RNXBQD          VWECARBJWQWPTSM EEECI           KWAL           
IFCAFWVIIO      : CKGUPB          BXDEEOAWGDRJURI QYITFL         
IDUAA           : RBRBFRKNOJEUJY  MFJPY           QFFAUNA         XPSOKPHLJXTQNGH
XEBSTROTSK      : IIYYDCXBVPMNU   QAEFUYNE        WBCSDJ          KPLKLKQBFIQALLI BCAFHRMYKKX     KIXLG          
LDLVLNYQNUBVLPH : NUNQOE          HPSVY           XPSOKPHLJXTQNGH
MHRYFVCAP       : SSXRBHAJ        HIMNURHT        FTMBMBHURWY     RGJERHKOQEBMTP  QOWGWPGG        WXMMTDMWRBHJPN 
PJPAYB          : EKOFKBXOTRPAAUJ TSFXQLQPAIR     KPQPOUOWCFWORL  WVBFAKRTCVJTO   CCHWXLGYAKXRY  
LAQBYJOVKNJC    : MDLAG           USNKACLFUUX     FNTBRX          PIMFRNPUH       UGYUYIVDIKBTYO 
BPESO           : HNXTXBUHI       PRGWHMN         ATQIPBPCOBMC    VLHDBXTOQIDE    NNTJWNPSKGQVQA  XDGHJTNC       
QQMINEUEGT      : UYSMNONLY       CYHEFHT         XHAAC           OULTBTQLJ       QNCYMEBHAG     
LHJFJKQAICPSE   : MDLAG           ULPNVDOB        UELNSNKTYSKSLAS
TVQOKF          : HXBAANJ         LNIHAOP        
ETNRXIXEFIR     : YYUANHRNGBA     VPHWRYJTVOO     GQFXWTCDOEKG    VWECARBJWQWPTSM FYTTC          
RYXFQBNUQGBE    : JQCMHISNJTYRDDF BYNQYRNARLQC    HJKGVIFFQFW     XIHWVBYPKRLI   
XWQICXOVO       : FUBQYNV         KSSCF           WXRDVYGIN       XEKV            WDQG           
VYHAER          : GPCKSHKYAU      LNIHAOP        
TMTRRMUF        : RIGC            QQMSJCVIGAK     LAGDVFM         MGKAPNJBJOTAY  
MOJQSHPMRU      : ABGVAPMF        TQWKCSJDIAA     QYVN            VAXEMJVKCR      NKIVXHA        
HSBQPBARH       : YNQWGFPED       SXQLWPJAGK      ODTOMVU        
MBHJVYVQGEF     : AOXQLRJDHJIO    OVJLMARVUDB     SXBTWFUBHVBJIU  WFDP           
PXQWOF          : VMUERFMQHWAFOBY JQMCOXITDCTWOG  OCHB            WJCGHPXEAPVAHG 
JRXCTOTUPME     : WJQBUBHEIIDYIW  DJHXR           NEVTSGVLFJ      NOBK           
BIRMESJWYPF     : HYSVQTJAU       SQXWLQX         TYOOWEUJ        XCIRD           PTBK           
FDRCRWSDORII    : QFRSFPBXOJS     EJULEO          LFCERTMULYVV   
CFXQ            : XJBNBWH         EYCTV           KIEGMRVRK       PHTRFHUQQQGYJE 
KSSCF           : QFQIKXRHRIRHRCJ XKPISUJEUAJB    XWQICXOVO      
UQXW            : MANCXBTSQSM     WLXCIBOL        IEESKJCGGWCUDHT TSXVKGUEXAHJE  
DVNHNPBKL       : ESQKQ           IHOWU           PWEV            MHRPMTQHXFYA    IGPSRJJURTYTH   MDHJVBRJN      
BFPKNRPOJCYEWC  : FLGSLGYLLBR     JXEXQV          GJGAAGAHG       OPDGTNMMYYDHJDE
VYDWVJATX       : PRGWHMN         KDPYSSDLQGX     UWEN            FXJYTBYXBOSLLPP YRPEMFPBH       GYHXYLURTRAJ    UHLKUSDIBOJUH  
HPNTDUVIKIWEAL  : IHHBSAHLG       TCCT            CCAAA          
FMTCOGBQ        : OTDDOCTOYFWT   
XOUAJUKSLXPQUN  : ABFIDYI         VVPERDOIAJX     BMOWP           AFLJQHLKTBHQNII EWJUEC         
FVYJXM          : XDHXK           OCPRDJO         LEMDEUWQLKHJAS 
DYVGQCHHL       : MFKKKD          FTNGGEKDXDCSQNM OVJLMARVUDB     RPMHGTI         PYIJAWXWETJUTH  WCKXYG          BJBBJ          
VHHFCRBPR       : OLHRBLGBDHDE    ODSBBQEYW       YLFTWDIV       
JOEJ            : EOQUSXH         BWHHBJSTUA      HIKFE           QQMSJCVIGAK    
CKGAWIE         : WNQOQJ          KCWWN           YLFTWDIV       
EMOJT           : IYHSSUBIV       QFHVCAQAPNJUWOC VJTHHFWUNB      HQINNCBC        DAMJUY          UAFCKRUFMT     
UBUEICJ         : JQMCOXITDCTWOG  JHFMTXR         YCLI            CYDAMMEFCJRU    OPNMBQEF       
DBWVKM          : HSFRVMOJIBUJL   FVYAO           HQINNCBC       
VIEIOFFYLG      : LQESRPN         NKHWVDPGRO      UYLB            XEVVOIMPIGIHBX  UHDPHGLYKVYD   
XUPTTMWQT       : OJHMUBDMSQYOK   FJWEQJLXFY      OUHJJDQ         EWJUEC         
UFKYIIWTWARFEBW : HGWWWPNDN       CUDTVQHGSA      VGGAISJ         LFCERTMULYVV   
IVWOEUMTOGJNYDT : MGOLYV         
KGUSQ           : LMWUQEYKEXDYPB  GLSCWU          JYENNYPGSDFWDJ  VJCSJ           LBPTRJSCWPL    
MNUHTYIQ        : BTSAVHRWAR      QYEOISLD        VLHDBXTOQIDE    ELMRO           JXUCUERTRUMYX   MCNHCFANL       RSATJMDDJIDPMDP
SOIITGUPWDYL    : GNXHKOC         OTKDLWHCN       YTINNF          PODJXUPMP       HWILPIWNLOMHHDN
EHXON           : VIHBMESOCF      IAKLLWFQNASJHHB KFQOGSVQQTEYERB SPITOYJCUPMSFT 
IHOWU           : JQMCOXITDCTWOG  DVNHNPBKL      
EQKOHVIYHSSNP   : ARCC            WKUPCLYBDLU     SGAFDYRTQPHDSLK VCULUGPTTHOFEQA EHJN           
KUKXYOFYGVUODLL : IJTYEHMCPF      VWHSI           JDYOVWYQNMPXD   BKMO            PYSGJCBADWJH    EKOKAMJ        
UQRIHBG         : XHUCNCQCFE      YIXXYMRBRXFFMIQ SHQPGTGENA     
ANKU            : ROSQ            HLTCWRICFKQI    VCHTEJW         UYSMNONLY       WJJBRLYXABC     IQKKCVFWXX      EBNHSDQY        UVNQ           
CGQW            : SWVDDTXCFTW     WYKVSOIBCNW     VJQETJQ        
OXHU            : USNKACLFUUX     EUTPFPLQN       NQUHMOJNMVVVYLS
NQSEVFQ         : IMEDDMMLKASH    MLGE            DVQCOCNIVDQK    PORWNLLW        EBNX            PLIDN          
CJNMSPTLPHXN    : GNXHKOC         UIRSBLXLL       OJESMQC         XVJLAIXGDWJEMID
BTCA            : PPYALSAVGVIUP   ICIUFDAFXPIFIG  IMJKUJNCYGUT   
QYVN            : MOJQSHPMRU      NIGOIMISKTWHKMM VARSGQU        
MGRQCYJYESOQME  : BJNOQDAN        DIWNNVBFLJHB    LVEOJLPHCEGWH   CRETMR         
XWUXKGYGKASDBQT : MGOKGDMPKKOXAD  OAGFBGV         CHAA            MSAFOG         
DARUFTEGXAUQOCC : NYNLNHGXWNEI    GFEI            JWMM            FXPTEU         
YWMLFMRROKWP    : RIKHVWVVBVDAG   SPVSIORQR       XJBNBWH         XMERYVGCUWFHODK VPHWRYJTVOO     EJULEO         
QRHRL           : LDWFPCTT       
YFKFF           : TYOQJ           KPQPOUOWCFWORL  XGBFX           HLCLC           SXBTWFUBHVBJIU 
CWYEBNFABQF     : DCJYNG          JOCJJRFOU       HQXAN          
KYEWV           : LJTJYTCJUBBSH   HQMOXBNJPITCVG  LENICEJ         ATSI            OULTBTQLJ       UELNSNKTYSKSLAS
YNNIHBMI        : BDTJGFEVNQKGWY  NIGOIMISKTWHKMM LHRTDBCDHU      TDSTLFJU        HRTIX          
WNMIRLJYMXEMBXT : ARCC            FLGSLGYLLBR     PQVWUPFYBLQ     KMEAIHKN        YMTVNQQLXMKACHD ARFVPPJXCWT     WKLDPNLI        TSXVKGUEXAHJE  
ISUG            : CWVBYWHYYWOJWG  FJWEQJLXFY      PDBKD           BKMO           
SHFIROJEWSDMINE : YHDVICRNC       JYENNYPGSDFWDJ 
XDHXK           : MMPBNIYUQVGCP   WCCEQJGYFTPVSME HCFQGAUEWS      NPUROSJ         FVYJXM          FRKFWDLDD       DPJWVG         
YKQPUL          : LTSNKALBOUOLPD  SGTDUFNOUVQ    
DDFMIP          : WLYSBXIV        TFYPAT          BTPVAHUOP      
WYKVSOIBCNW     : BRUWWUN         CGQW            OJRXXTFDNWIF    ATDFEFTYLQUVEN  HOFUVDWNNRXJJ  
SGAFDYRTQPHDSLK : BPVLOUPSUQPLFFI EQKOHVIYHSSNP   TOPRNLV         SVHXBGHT        KFACNEHQ       
TAOTCARUQBXUQ   : EBRNAVSLFK      GFWMMVONFQ      WSLK            PGCJBPEL        RVXQNE         
XLCATHALBSB     : VSYNWCWDBBAN    WNKPWVTDGMDGPL 
YWVJFSMTOOVG    : EKOFKBXOTRPAAUJ IFIBJAYVLAW    
MHJKAGIMI       : HNXTXBUHI       NLFBHD         
GPKTSEV         : CJVFQJOJ        MGOKGDMPKKOXAD  BDTJGFEVNQKGWY  PHTRFHUQQQGYJE  PXLYAWWWAT      CVBHTKQHNPVY    DTDEVPFMJCDQK   XBQILDMB       
DUAOAU          : WOLC            LEGSHPNQ        NTEOWIUNKRWOLIL HKOKFPVQB       BNSUJDVR        QGXJTQDVNLEJNP 
VJPUQBJAMTBT    : NGFTVKHRTRS     NLGWECGWF       UEWWFIVLU      
PENXWXRPEPVJKY  : KVURY           PORWNLLW        RSAOPIEBNASHV  
MTCLG           : JUGXPAUUAIVJOB  YSBKMPNBQXWTC  
GWXRYLMAHQRLE   : FKUULKIUEJGLMLU QFQIKXRHRIRHRCJ EWSDTBUKHPXQH   MEARPGUCDUMXERL UVCAEMJ        
IFIBJAYVLAW     : YWVJFSMTOOVG    TTGBV           YWXAQXNS       
UYLB            : SBJMTSGJGLU     EALYJGFRVTOPG   BIBWHDAML       FBMPCFSV        PJHRRFIWSH      VIEIOFFYLG      MAXVGCK         YDGFRTHNJHBWPRK
TAUMYIBCRRT     : BAKFOKYYL      
YMQEWT          : VMUERFMQHWAFOBY POSIALRPIMOQEMP QPDXEWE         RRMG            NODGDQD        
WSLK            : CDQGJO          XRNT            TAOTCARUQBXUQ   XKWPGFT         INFFBDDLWKUEK  
ILQKYTIVTFKUNLW : PMGXFBRWBK      SUSAIJAVBP      LIKTQIO         KFNKXWYBBMXU    CQTHJFQGQVUUJ   HRXPBVXV       
FTNGGEKDXDCSQNM : LFMJMVLDD       OLJIWOATBFFPJ   DQADER          DYVGQCHHL       ETRI            YQFBNG          PRERXGVTVJMY    XVWFUEFWRAOOTO 
FTNGGEKDXDCSQNM : KHAFRBHE       
YFOAYW          : QFQIKXRHRIRHRCJ OBJJRTIEQDTTIBT ONYUYGPUPOUBSG  AHVNCOVWMDLBM   KFOCRCD        
UDGSSTRBCLOI    : GMJBHBTXYQSOXRS ATSI            JGPKPQOYP      
UVYSYCN         : ODFXFNEHQKGTC   BQML           
PBTQIIQKGNFJVA  : XLTRIKHXSNG     YQHBMEL         FVIS           
QSFSGTBDQW      : SFVQVKDVAEXOJWB IJDYCWFSTSVTFJV BWROHYEYUVKAC   TKTARQ          MCLFAMECPTVC    SPITOYJCUPMSFT 
JXEXQV          : SHQUPDF         PGDBYGAVTT      UKMXENNXTC      BFPKNRPOJCYEWC  MPUMSXHH        EJJJGFM         RHACGRVMEJGEOD  IOKVEFJRYLK    
KMLTEVCTELPEPI  : IDLSGQT         TXYRVFBYWWK     AIEACJMRIGO     XAADQBNKG      
VDGRHJLELUF     : MTSCRYEJCHEMRA  QPPGGGFMXYS     FMTS            UHUUPVOS        SRSFPNWEDCSOY   QHNVIH         
UVQXGEK         : WKUPCLYBDLU     YUJNWSNIGCBR    YNQWGFPED       YRQTWCKIEY      AJTFFASAB       LHHSFYOWFYVSKLQ VLATV           FMHOGJCQ       
KIEGMRVRK       : WJGVQMFPPXL     NRTNJPRGN       CFXQ           
OIKWCRGNY       : MQWQGOTRFBGGBLK
LENICEJ         : XNTUBUKHNUTGKK  JFFTBR          KYEWV           CAEIBQNDYE      HKJBGQXTPPRCLLL EJJJGFM        
KTNUETDRO       : GJHYXNA         QCINDDFJQKBALYO
JYJAHVXLO       : PNMODBJRSNEK    UCQIEDDWFNIV   
APYLVMTA        : EBRNAVSLFK      QJYTPRC         IVFBFYOVSJRCDH  LCUUGFNBFOSAXE  EHJN            XIHXA           UKAROGND       
DKEY            : BXWXES          MYBM            GBSPURALAQHQKH 
CEWFVLHHKSHTPF  : BDNAWFWQT       RNVXN           GJRNIHNEX       HRNRMXHAGI      UHWK           
GMHXLSTBPTUUG   : MANCXBTSQSM     QJOVVRBVSPJ     TEITY           TKNXLHOW        DBUQUFQRYYSJXKJ
WHDBELYRSGEO    : FSPVC           ULPNVDOB        CNAPLBFRXTIXBXY MHKSMOLDPRTL   
XGVFMIPMVKGWACT : JQQBET          LNUAICJI        KNAEFUIHCITE    NYRRAMYFEINPKA 
KVURY           : PSPCBSEAJUTUY   PENXWXRPEPVJKY  ELMRO           JWMM           
XKWPGFT         : WSLK            OCHB            YQFBNG         
UTDS            : PYVYNIICTTUSMHM
PDREACKYF       : WFWVDYPP        QYWYC           UDWOEIHFYKI     GLAL           
TFYPAT          : DDFMIP          ROVODWNAP       XIOENVYTMT      NIXQKLDEWB      GCMYUFOLQYSXQTL
XRCWK           : CRJDUWPELMXX    YQFBNG         
CEHYYKSDC       : IFKJHMHHXSYEBC  QJRUIUTPPNINI   BAKFOKYYL       MCXFYOKOVQAC    ENNVEHB        
UGVYS           : MFJPY           QQCFIWMDUBBTL   VUIPL          
GJRNIHNEX       : BDNAWFWQT       DLGBEILRPJAXMRN CEWFVLHHKSHTPF 
WAMJMONT        : VKPYHJWBGHSFVGH FWNFCVBOABI     WXMMTDMWRBHJPN  URYYRGQN       
OGHR            : JQQBET          HFXA            WLYSBXIV        QSADTIIYFC      CGQCL           AGCBEGMICRVLHR 
FOQCQL          : RNVXN          
YURNGYDKYRJCE   : FULTL           LACEOUCX        UAFCKRUFMT     
OVJLMARVUDB     : MPUAESAHBHHFEO  MBHJVYVQGEF     DYVGQCHHL       JDXQTFJ        
VFCKH           : VEDHOKADNGH     NQCNLNPVCI      GHPSEGAVGOYCGIV SEGHRMNEWSW    
FYRNAUBAOMCVIS  : BAEYINRNWCTPOK  CVMALAXPTEUW    PQQV            AXBUFBDXJCYUP  
TEITY           : FADBTEVYKMY     GMHXLSTBPTUUG   PWEV            IHOITHDBKL     
OCHB            : GNXHKOC         PXQWOF          XKWPGFT         IHSAALODIB     
PFKWJSY         : GHXVCEJ         WBCSDJ          JBOOL          
IBYJDPYHLHBHB   : INSMLTAHAVVPNVK APDCKGNQXF      OQMTHKWWHRSNNBT FTJRATNNFKWAVUX YQYIFHGL       
PWEV            : ARCC            QDMHKTJQ        DUTFLJBJMBXVAX  DVNHNPBKL       TEITY           SYFSGDAGGAAR   
IGPLVUXUHQV     : IHGRYSDTYIPDH   PNSBOFXSE       FEQXJVDOYSQO   
CXJNDAM         : FULTL           VNRUIPFGKVWY    LDEXXYJW        WDQG           
NVMXYTNWBKLLS   : YEEKLWEX        ITPWJCAGV       YUJNWSNIGCBR    AERIB           KEUWQRFN       
WOAVLH          : KBCCAXKKY       CKGUPB          GEAL            UKMXENNXTC     
ISQIEFLGTYWQNUP : QJOVVRBVSPJ     YUJNWSNIGCBR    DTFNIJCROJUCU  
IOLUAYNDYEEWS   : BSVFFK          GYSOVWO         WDSCQQURUABTOR  AJNLNVIW        RHACGRVMEJGEOD 
LDIFLNMYT       : FAQPVS          YWXAQXNS        NVKAXIXGMITWTM 
YQYMLRWWG       : XYYXGSW         KBCCAXKKY       JBQWODPKGSWB    KPLKLKQBFIQALLI AKIYAKWKMVXNPT 
RHMIMLMSIHJ     : UMEUQKRPAY      SGJLFUDDOPGG   
KRDXFPX         : EPYOQCJ         XIVCJSLKSJACGI 
YYUANHRNGBA     : ETNRXIXEFIR     ATSI            CBODRDLON      
KMIWXXSIFCFQTK  : CTGACGPCBM      XNPFQBWIXYOHJAA
CDOEEPYE        : IIWGFWJGGOYIGV  VKXEQDAPAM      GLSOTCKWAUPLPGF
IYTOATPKH       : HQUISDIPMUR     YCYEXCNNHXRO    SIEHDVIVYTXBUCL RVXQNE          DKWGWWHSBCW     BVOFSHWVWKLETI 
JHXCSGGXYBKPFNF : LYMNDLAMCJMSTV  DJHXR           APPPGXXUEOV    
RWKWBVVWMXREI   : OBJJRTIEQDTTIBT KUDMMRMYGUQT    TURYYYFADHXS   
FRKFWDLDD       : XDHXK           GMRW           
GOBLCIWUFITJER  : REFIURRSWWUJS   FSPVC           ECLRDQXRLBR     WJCGHPXEAPVAHG 
QPXVABDR        : DPWCMKRNTDXHI   JRRSUPKQSRDXP   HMNROWBENDIKJG 
IQRUUVH         : JXXCYOSNXVTB    BTSAVHRWAR      DPBR            JKSSAT          WDFMOYGT        ODFMCMKHRHBUVPQ
KKPOSMJYWDIDWQ  : RGJHSVI         JBOOL           LHRTDBCDHU      XJOHPKBGETEVFD 
MPUMSXHH        : ELOWIJUB        JBWBOXJGKV      JXEXQV         
XADSXNWIXMYRB   : TSBHQPJHULMULOX ECIBBLFOUPIVJ   BKAXNMK         BOBD            MLNJLLGQFVBYNT  DFWVFUIM       
SYODCMTYBLTO    : MDMTPLCB        WDSCQQURUABTOR  HGFWPQHBWA     
RXOBVOGRMTQ     : ECLRDQXRLBR    
UDWOEIHFYKI     : PDREACKYF       KPVXY           KFMSIEVYODQSW  
GHPSEGAVGOYCGIV : LRDSMWONK       KNDQ            VFCKH           RSATJMDDJIDPMDP UGYUYIVDIKBTYO 
EMUYRTNYCWEDJMR : BCWMJQBAOCOA    TDVSF           ETRI            TWVSNWGFSXOLO  
WJJBRLYXABC     : ANKU            QXJTV           AGFHPW          VYOXRLTAJ      
JYENNYPGSDFWDJ  : JQASQI          PXLIIKOQQFGND   KGUSQ           SHFIROJEWSDMINE WYSAW           XWINR          
MYTDXF          : TYJOPOLMQ       OSULFFDTARKK    VCOVSVETGG      IMEDDMMLKASH    COBUOPB         VNKCXXFAFUOYXME
BWAA            : PNWUGM          LVRYHLS         OYFNYRROQPOG    WDNSKQS        
DDCLMBRDQQ      : GLGIQ           OHRCNM          WGFEWGMDEGRWGX 
WLXCIBOL        : PNMDMFTWWC      MLNXJMAECGN     XMYQHEPHIXUT    UQXW            UFMXCYX        
PHTNNLOKNQKQ    : BTPVAHUOP       PRERXGVTVJMY    GCMYUFOLQYSXQTL WKNDPKRFHI      DMVSQUCDNCUB   
MFJPY           : ODFXFNEHQKGTC   LEEXD           IDUAA           UGVYS           SXBTWFUBHVBJIU  FWIO            BJBBJ           PNFPKFL        
GSHGEGKPH       : IAKLLWFQNASJHHB FYJPJGL         RAWATQLEWPIRT  
DXOKSEXGSLTMV   : KCEVRFOUV       CNJNPVEU        JCASPMYNJAJFNK  DJHXR          
JKSSAT          : OIJR            UYGRYIXILQVYUB  IQRUUVH         HLCLC           EWCFPWMTC      
IMROTXA         : JHROSN          DIPPJHBESGAERQ  SXJXPWQGPAY     VBJIJS         
IBOIQYDWAJSLE   : LCFGTHHML       ETGOJARJLD      WTHCOWCBHPS     SHGKVAIJMVJQ   
JRQVMJ          : JFFTBR          JVAQHSANCUTHQBJ LFCERTMULYVV    WVJVMSIR       
GTGTM           : MTGUIVNXSKBXOU  SSIVOOUWAQX     VEDHOKADNGH     BMKXRQIGILH     MQGCOPVVQU     
NMXYUYNGROJ     : FAKKVTKD        UIOQUYDPRYOP   
OTICXP          : BRIDKCSQOYWL    IYGXPQLIPH     
RGJERHKOQEBMTP  : MHRYFVCAP       MOSGFVDMSBRO    PEDWWWDDGYTQRNA
SLJITCXDTOYETWT : UGSWE           JDPKDYTT        VEWDIVGJNGH    
QCTUVB          : MUFBGMC         SXJXPWQGPAY     UGYUYIVDIKBTYO  GEJHXKKOX       RXCJGQPQMQ      VOBYQOMB       
KTMLGHCSCPFL    : LXAAT           OSFSJWDGGON    
JLODCOHVNDEFHX  : SJHPMJWAACKD    MHKSMOLDPRTL    PBCQQMBUJGJHMIV STQDTBPVSFCQAV 
DBIOVX          : MDPWLCULMMNLDVR LXQQPLCOKKAHSF  VWMD           
EFGAJV          : GOITHXWAIXT     HPQUXCVPMNHW    CFJIO           DGWLVOXGRCBXEHR PNMODBJRSNEK    MGIWDOPUJ      
WHQIYTLPDJDIN   : CCHWXLGYAKXRY   NDXLC          
PNNSRXJPVMVDSVN : AXJMWR          VPHWRYJTVOO     TRTEFNAXDWUE   
BKBTVANJRSSV    : SQARJVSVRUBX    NPCSYRMRLAYQD   BIAFOTXJWL      JDXQTFJ         QAXBXWJ        
JISY            : HQUISDIPMUR     EAMTLML         LBJACFIXCRNIN  
OSWAISM         : XBUQNGMLWYXKGJV PSWITVKDPI      LQQBMIKFNJ     
YIDOAHYDBWGRIX  : GWUERNUDM       YUBAJ           KXPX            KUHJW           ELMRO          
ETOPFJOBAKA     : WSED            XVPWNSEKDCCNL   LPLFBDOL        JVAQHSANCUTHQBJ QVYEO          
STPASXGH        : SGJLFUDDOPGG    GEJHXKKOX      
NIGOIMISKTWHKMM : SENNIDCEIDLD    QYVN            YNNIHBMI        VPKUFUBKTSW     PHSV           
EPYOQCJ         : XSQIPTDI        CKGUPB          WLELD           QEUFPTSBPXNGYB  KRDXFPX         OHCIRFOGO       JMWL            NJAALBFEKDFRY  
RMHSSQUIBBYJN   : TYJOPOLMQ       LJUELOBNXN      RFNSEPEBU       VBJIJS         
FBECIQRWMVMNMFP : YIDK            VUWVSJJWPQ     
RKKYDFR         : FTBCKSNRXVGKRSW BMKXRQIGILH     LYMN            OCPRDJO        
NTCP            : JKXLEWMOEECKWYW IJDYCWFSTSVTFJV AXYWHQSF        SCBHAMAYYWG     XHKJUCLIIAD    
PXKQCNBSHXHFNV  : YXDHVJR         YYYPRY          PRWKYGFXVJKL   
ULPNVDOB        : DWIFQXLMMSPIN   JBOOL           LHJFJKQAICPSE   WHDBELYRSGEO    QIHWILJU        QVYEO          
HCBBEQGVOTPS    : WYLNOA         
SNQTUVHQ        : FAKKVTKD        CEOHQMQYJOKWMT  VJTHHFWUNB      KFHLNNWBGHCT   
CFFRDKJH        : PJVGXIE         WXMMTDMWRBHJPN  JGPKPQOYP      
QJYTPRC         : EYCTV           APYLVMTA        CLTGPDOCQ       HQMMGWO        
IVFBFYOVSJRCDH  : JURWIDVNVLQQUX  APYLVMTA        XLLCH           FKJUKEDJMFLFG   BIGUFG         
KPBNCKUADGY     : NHVRC           NRTNJPRGN       IEESKJCGGWCUDHT
XQYOYXTCFUQCPD  : YPCVRBQEHMYJH   MDMTPLCB        KFED            TMNLPXPJEWNLCA  NOGBEEF         AIEACJMRIGO    
RIEBSVCGXOE     : WVLYCRDWTVSUJ   HPQUXCVPMNHW    BIBWHDAML       JQASQI          VWDJCQFJS      
RMAONTPC        : BPVLOUPSUQPLFFI XGCIYWSFRUQT    HRPAPIGHJFRL    GKECLFYNLO     
PXXV            : RNVAOOUXAO      RIVSLAGKMBRWS   GLSQFRVFOOJEBK 
QXJTV           : ONYUYGPUPOUBSG  WJJBRLYXABC     DGFFRGOUIWDI    RUCFJ          
CCHWXLGYAKXRY   : RGELWIJM        SPTFIWKR        PJPAYB          WHQIYTLPDJDIN  
GMTXQPOP        : QYEOISLD        IWGAD           JLSDSO         
MLGKUBG         : NCLOJPR         RGMMSADU        LBVIAHQQC       JVNYQIJWCWBQON 
FJKDJVJIV       : HDPNEYPHMR      KNTAICOKDTRYE   QAFYXM          PEIPYXDDUQHNJIL SCDJLXHNWHC    
INUJVKFWBUN     : ROSQ            FJWEQJLXFY     
KAERKCUS        : MMPBNIYUQVGCP   GPCKSHKYAU      GOWOLQBQTWD    
CEOHQMQYJOKWMT  : SNQTUVHQ        ODSBBQEYW      
WYSAW           : MCXPPP          JYENNYPGSDFWDJ  RSPU           
TJGADS          : PURLBRYIUFTKPX 
XNIDUYKLLEM     : RSUCLPKC        NNULLBJ        
SWUFQQE         : MKJPBTSSQ       OJIRJUVJ        PYSGJCBADWJH    XAADQBNKG      
LHRTDBCDHU      : QYTCFDYTNHQLNU  YNNIHBMI        KKPOSMJYWDIDWQ 
HKOKFPVQB       : DUAOAU          FFNB           
EWSDTBUKHPXQH   : GWXRYLMAHQRLE   SJLVXDCVRNY     HQXAN          
TKTARQ          : BBPEN           HADSJKFBCFUU    QSFSGTBDQW      JGPKPQOYP      
ABYKHO          : HXVYRMBMHGMASD  JUWREWAWIJLIR   SSUMEPYDBDQN    TCATP           ENNVEHB        
APIGOEKIHHUQ    : HMSW            UIRSBLXLL       PFXPRJKSVMIW   
SIGMESI         : PYPJJJRLNE     
LYMNDLAMCJMSTV  : XSKCKOS         JHXCSGGXYBKPFNF PDBKD           ORXNXQTQMBIFYS 
XGSHPNYMJHUVLN  : PUCIEULVLKXWCAG FCALHUMGJM      DPKEPFJAEYNAA   LNVMNDMWLA      YXXNHARXNR     
SBGHQLVRX       : KLHVGGARPLIBIC  EOUOVD          MRYJT           XNDJWWIYC      
BNSUJDVR        : DUAOAU          PRWKYGFXVJKL    UBWYDGNHDQFI   
DHJCVULQTAG     : LVXUTQLCRNGTNHD UFMXCYX         UEPBYQGTWACTMV 
UKJCB           : MJXAUNAG        FFMNKJAL        MMRLVCOUCNYX    KUKNMGYCYUCQ    PKDMWSRMPDM    
XSTY            : JQQBET         
JRRSUPKQSRDXP   : WBCSDJ          LJUELOBNXN      QPXVABDR        HXRWGL          FMHOGJCQ       
LGRLPUGAF       : BMSPUWAVTJBV    BCCE            WBJRXXVSUXYKN   HAISIOHMNSMQPN 
DBJWWKSJDMCXC   : WJGVQMFPPXL     NBAWUVYAEIGUWX  IDWKXB          QBLFEPCDJNNSWNL
RXJWXAWJIRV     : EEEBPWC         FJWEQJLXFY      WDNSKQS        
MEARPGUCDUMXERL : HLTCWRICFKQI    YRBFYFBMX       GWXRYLMAHQRLE   RFYC            VCULUGPTTHOFEQA TJIBW           RDTTQ          
SPXKNKJLMGX     : REBFQJUHMFY     AJLLRJYM       
XTVNAXF         : FOOCLYFND       EJAIKIYCIYTIMC  PNGCAXRFBNGBXOO
EDWJAJIEEVOWL   : IYQXXT          CNJNPVEU        DPLGSQKNESDN    ILFJPTCN       
JCASPMYNJAJFNK  : RIKHVWVVBVDAG   CFRY            CKGUPB          DXOKSEXGSLTMV   MCLFAMECPTVC   
UFMXCYX         : SBJMTSGJGLU     KXHRKMPKDBE     YRQTWCKIEY      WLXCIBOL        DHJCVULQTAG    
HERD            : YWXAQXNS        IYREJSC        
OQJXSJSLXSYHUL  : VGYUSUM         BBFPPWG         HMSW            VLATV          
IXXF            : HVYOICVS        MMRLVCOUCNYX    WGFEWGMDEGRWGX 
MGFLGSSLN       : FHAMKX          NWKIF           PODJXUPMP      
HCRQDKCVXCQA    : KEQUKD          JVYRTN          LRMSQGIVE       KLEQV          
LLBVJY          : JMMUDNEOJ       EJULEO          SWPVWHHHOAE    
MMKTXQOTECRL    : DDDCGAIF        IGKC            VWSHQSHSEVTHDD  CCBUCNPALLGOIE  IYREJSC         LNVMNDMWLA      LOFLKSQSWJGRHYV
JEKWII          : XNTUBUKHNUTGKK  XMLCEHV         OHIUUKCMDYKF    YHDVICRNC       YXXWS           THSSWWRPV      
KCWWN           : MTSCRYEJCHEMRA  CKGAWIE         NVKAXIXGMITWTM 
XMTAQIMDC       : ECUSGUWHIFUTWL  KEQUKD          POSIALRPIMOQEMP NUNQOE          VLHDBXTOQIDE    VVPERDOIAJX     VARSGQU        
TTGBV           : XEDUGDNCMAQBAY  IFIBJAYVLAW     DPLGSQKNESDN    TURYYYFADHXS    QPGNKEA         PUAFJJJRPHE    
MDMTPLCB        : CVKGOPBQFHBGP   SYODCMTYBLTO    XQYOYXTCFUQCPD  UVNQ            PNGECYFBBCMYL  
NDGMS           : UMEUQKRPAY      CKGUPB          UKVQIHP         FPEKVBWJVLHYT  
KFNKXWYBBMXU    : YBHIIBQ         NMQLQSXPTM      VUWVSJJWPQ      ILQKYTIVTFKUNLW RWMSI          
YTXNYL          : VLFG            IMKVTQM         OEMHI           XFVPTRYTBPEE    NRTEPRDFLNOKJ  
RWMSI           : SWQXHL          KFNKXWYBBMXU    MBJEEAEXNH      HCJJTC          YRVXOB         
VROOLBWYMUXNYA  : SOFUGXRSLKXFVV 
YWXAQXNS        : LPMKQN          UKVQIHP         IFIBJAYVLAW     LDIFLNMYT       HERD           
XKJKDRMYLB      : BAFRIFOMCIM     PDWTOHNCPQSR    GEVID          
WCMW            : ABDVMVWIH       VWECARBJWQWPTSM IHYVQRXH       
KUHJW           : DVFKVKBAURNBLPV JFFTBR          YIDOAHYDBWGRIX  VFUBVKW        
KUJKNIAGTASD    : LISKWPSQIUF     JDYOVWYQNMPXD   TPRVMUGIX      
VXYWJC          : RUIMWXRGLMETRN  IRWUAWMRTI     
HFCGXM          : RFVAGOGHPO     
HXYTIVDUJNXSI   : UNVRMQEAHRNGSFF VSYNWCWDBBAN    NTKKKKSDOT      PYIJAWXWETJUTH  MQWQGOTRFBGGBLK
LNLKLKJVNWF     : YSBKMPNBQXWTC   YHRXWALFWSAOO   EUTPFPLQN       IOFVTUKFDJE    
CLUOODNPWXLCV   : IDWKXB          GLSOTCKWAUPLPGF UJTDKHFTVGGX   
QTSBTGOHSDS     : UDCCBVBAILBXLTJ VNRUIPFGKVWY    YUNXRAJBG       UYGRYIXILQVYUB  HCSDWTVSRKDF   
BICGFETATKFJ    : LEVAYMNKS       KGHTNIQWUN      MIPOGOBJUQFL    PYPJJJRLNE     
EJOHFOA         : CRWXEPHQN       DIWNNVBFLJHB    QIHWILJU        YLUUIPI         SABQUJJACP      BFEGDQKOM      
JDXQTFJ         : RYYOWLUIBXSQOL  XHXIKDKGBBYQO   YUPVDASCJMW     OVJLMARVUDB     BKBTVANJRSSV    DPLGSQKNESDN   
AOXIRGNVC       : SUKOTGTKRKE    
RNXBQD          : MTSCRYEJCHEMRA  UYSMNONLY       TNQTWYSTRS      LGMQCUHQPDH     JHROSN          FRWEVETSRNXXNG 
HMSW            : WAMPNTRGJOHJQWM NLPB            APIGOEKIHHUQ    OQJXSJSLXSYHUL 
UIRSBLXLL       : CJNMSPTLPHXN    APIGOEKIHHUQ   
ALJTS           : FMMTC           JBQWODPKGSWB    YSBKMPNBQXWTC   KUDMMRMYGUQT    HKYKFYNXBUTJ    JUBRMIKCKCKQ    WVHK           
QWSIKQMDT       : CFVSHHDVRTEBUTK VSUPEHP         KUKNMGYCYUCQ    WDQG           
LISKWPSQIUF     : DIUXMVICBDHFDUM KUJKNIAGTASD    UCQIEDDWFNIV   
IQKKCVFWXX      : ANKU            GEJHXKKOX      
QIHIULEUYPQL    : DDSPRPTLP       UMEUQKRPAY      SYFELRJ         TSOBCHARETSLA   IKRNYGKTLBXPE  
GGGRDNDNEPYIN   : MHKNJU          ANMHOLGK       
IMEDDMMLKASH    : STSIRPOMCL      JOPYLKIW        AKXOIGKF        NQSEVFQ         MYTDXF          FEYRWFAYY      
IXMWHTF         : RTEMTYYQILGJSQ  FCIVJGBK        UUDJCIRIOTYSKDA
WSELYVMIJSSVYXA : NTTWGHI         NDXLC           VFVECB          DCMMRJ          BQML           
KNXLI           : RUULF           CDCMJ           HIKFE          
MQGCOPVVQU      : NUQJQTLMPJTYIHF GTGTM          
UIOQUYDPRYOP    : KSHLVFPS        THCQKQ          NMXYUYNGROJ     MRGWMK          TQMJBQACERGGNP 
FDPDQXLFR       : BDNAWFWQT       JQASQI          THCQKQ          DWIFQXLMMSPIN   IYGXPQLIPH     
HIKFE           : ATSVITFNPODQIBT JOEJ            KNXLI           HMCJCRF         JNSJCYNRSJTATV  UAEVOG          PGDN            WYUBVHXDHIEDWH 
DTYLLSJMVYFWQWY : PXLIIKOQQFGND   PLIDN          
COBUOPB         : MYTDXF         
KKOWQVYVP       : GWUERNUDM       NTHYEFUWVKTW    VYBC            KJOWECVD        IUQYSHEWL       IHSAALODIB     
HDVQQ           : KXYOING         SMCQYTCFN       ENNVEHB         OEMHI          
SXQLWPJAGK      : LPSHC           LIKTQIO         JJFLIOVTBC      HSBQPBARH       ECAHQLJDKVTJ   
VAXEMJVKCR      : MOJQSHPMRU     
XJOHPKBGETEVFD  : ICWQY           KKPOSMJYWDIDWQ  MVWQWHWKBQFKSYS GBSPURALAQHQKH 
ODSBBQEYW       : CRHAUKPSHXY     XLTRIKHXSNG     IXRYYLBGQDCE    SLFGNMAGVWDEGSK VHHFCRBPR       CEOHQMQYJOKWMT  PYODOULA       
KUDMMRMYGUQT    : ALRQWHTKMNRN    UJTNEMCNGLIMWU  RWKWBVVWMXREI   ALJTS           YRPEMFPBH       TGHDRHFSSLKED   EBEKASNHMR     
WXRDVYGIN       : KYYMUADMHAIC    JWOIGWXE        XWQICXOVO       XXSBWX          WBRSR           EEECI           FEYRWFAYY      
DQNVU           : IYQXXT          KFXSXTVKVUQ     FFMNKJAL        WMSRQLJRJUGIMYY DQWXQRJOSL      LBOBHJEWJIY     PGQKERXXEBQF   
UOAQT           : VFQQSUUWUGQ     LKHSU           CUDTVQHGSA     
FLEGUBWOWT      : ICWQY           GIEQKOQHW       OJESMQC         GQFXWTCDOEKG    UHLKUSDIBOJUH  
QYLP            : FUBQYNV         GFJLIEOCPBOT    KPWQUPFJHPVIMN 
VFUBVKW         : FBNQDPXALFJOBBI KUHJW           WRPN            GLAL           
BRIDKCSQOYWL    : RGCNUMELNPMUWGH DQADER          OTICXP          VYUMMKPPVJ      WVGVQ           UKAROGND       
UAYQO           : DITFQVDJB       PGCTAOP         TVOREPLT        LDEXXYJW       
QAFYXM          : ECKORDVGAR      FGMLLB          VYFYPA          FJKDJVJIV       UQOYTVIMI      
YIGVCJQKN       : WRPN            APJYEXOXJML     FLUUEP         
PGTGHRRHM       : RSAOQMH         YMMILXJLA       RGJHSVI         FQLORKBLACQRK  
GFIVVJDWHPSJABF : FQXXNDTI       
LXPBCFJV        : KXJGBSECFYBWNVQ XKPISUJEUAJB   
QPDXEWE         : IKVMERXUA       YMQEWT          DIHTASORJIP    
GCGRFGBWY       : HNXTXBUHI       UAEVOG         
WDSCQQURUABTOR  : LWTIPX          CGGADUE         DNUJ            RKQQSS          BIAFOTXJWL      IOLUAYNDYEEWS   SYODCMTYBLTO    JDYOVWYQNMPXD  
WDSCQQURUABTOR  : HGUDKOW        
TPORVYAX        : FFOYUG          NTHYEFUWVKTW   
RFNSEPEBU       : RJMFNWUJLNY     EKHPNYMA        GFEI            RMHSSQUIBBYJN   QMDXIAFE        QYLAWWVWFQNIT   ADBNR          
GLPBF           : WFFMOJRYRSRE    WLDFWGJVPEKVM  
DIHTASORJIP     : QPDXEWE         RHJUDUFFLUI    
INSA            : HQUISDIPMUR     YUNPYJJJLFH     VSBQVUNINOQSEJC TOPRNLV         WLMBBUWGOIKSI   FBHNSXVDFVAQ    KYMOWKVWR       YYQAUIGNPFLMRY 
INSA            : RRKWO          
IUYABAWA        : GMBDJVGGQGULF   SVHXBGHT        KWAL           
KQLPGPXPJA      : WXTQATVCHMTTQY  LKYEBC          RRWLOFEGEEB    
ATSI            : XGBFX           ULQHPQAFGM      KYEWV           UDGSSTRBCLOI    YYUANHRNGBA     JCODT          
DQWXQRJOSL      : HVTLK           MJRPOFFNVUVV    PJVGXIE         DQNVU           HJKGVIFFQFW     ULBAVSEF        JLKSXBBDUETVWY 
VJQETJQ         : ARCC            IPEHIBCYD       CRCIMJNPF       CGQW            ONSHH          
PIMFRNPUH       : IFKJHMHHXSYEBC  ULRQ            LAQBYJOVKNJC   
DTOUQO          : YIFWYNTGCC      TCCT            PKRPDGYLNDSVH   PNLOIVHNVW      EOUOVD          WYPLIEAE       
LACEOUCX        : OMHAPXJXXYENK   UURMRTB         CYHEFHT         YURNGYDKYRJCE   NLGWECGWF       HQXAN          
HTUA            : OGDEVEFKO       SPTFIWKR        CDBSYPXY        XFVPTRYTBPEE    UVCAEMJ        
MITTCJJWSUBML   : WTQHN           FXUKRDWIFQLKXH  ALRWNKQGOOA     PIMXLLFLLYLYSQ  QNKCPYNPBATJGE 
ECLRDQXRLBR     : ILLSRW          GOBLCIWUFITJER  RXOBVOGRMTQ     JCCUCLF        
KLVK            : ICWQY           MPUAESAHBHHFEO 
ISOEWANUSKXGV   : AUBRTTXKYFJSOSR SBYEFOQI        ITHKTMFOCCASUQP VYUMMKPPVJ      WXMMTDMWRBHJPN 
MBJEEAEXNH      : XGQILGQFVKAJUPD KXPX            RWMSI           ILFJPTCN        IDWKXB         
MRDIEA          : KLWPNMUQILREG   NPJTBGIHI       PYQLNGY         IHCPHVSPDBJEMCY
YQWWQNTKARQ     : WQBMPVEAVPBIOR  PPFPQTVYNKLYCW 
PDAYJGCPE       : GCMMWBOCUN      RCEBETVMVSY    
XXDRDNWEJVUGU   : YMMILXJLA       LWPQKBIDXWAL    RTSANE         
VOYWIPVXUVXG    : LVBVFLSNBUFT    MCSN           
AVIPVGUQJ       : KWMTSN          YYYPRY          CRETMR         
NNULLBJ         : XNIDUYKLLEM     DTDEVPFMJCDQK  
AXYWHQSF        : JUOWAEQTJQ      EOUOVD          NTCP            QMDXIAFE        GJGAAGAHG      
QFRSFPBXOJS     : TQWFVU          FDRCRWSDORII    JHROSN         
SGUJBGWFRW      : DFWVFUIM        SNAFO          
QVEA            : JCOC            RFQK            GSQOPEM         YUNXRAJBG       DCRF           
WHANNTISLL      : SGJLFUDDOPGG    NQCNLNPVCI      BOBD            RLMLPL          XIUMRCQI       
AUOFPUA         : RROGN           NJHQKDTVRJL     BCAFHRMYKKX     CWQJPNVIXPBHWBB
WJXCBUJTSN      : IMOXBBMMQAYAUI  GDGYQQL         HEJHTCRYCSXI    QFHTPF         
HMCJCRF         : GFYOVKMPFQVVEAD HIKFE           QYITFL         
KRVGRSUAI       : JQQBET          PVVPITAHIRDW    JCKDXS          GRMMMECIEU      XHXIKDKGBBYQO   HCSDWTVSRKDF    VLHDBXTOQIDE    NXQCNXXJFIFHX  
KRVGRSUAI       : HKVXNHHLAGGWW  
CKMLI           : MLGE            BMOWP          
PGCJBPEL        : BHLWUQUU        WJQBUBHEIIDYIW  TAOTCARUQBXUQ  
IWGAD           : VIIQDJ          CPDNQBWFXFJIDON GMTXQPOP        KEIDFDAMAUEVJ   UGYUYIVDIKBTYO 
MUQSOJP         : TVQXJIJHH       MLNJLLGQFVBYNT  XDPPOBPNXAGGB   XHPXQIBNIQMD   
SGTDUFNOUVQ     : YKQPUL          AJTFFASAB       HSWA           
AJNLNVIW        : OKHPGELSKVGV    IOLUAYNDYEEWS   WHMLB          
NPMIHIAQX       : CFRY            FQXXNDTI        CRCIMJNPF       YLPXMTKGLFDNDWA XRNT            QPPGGGFMXYS     MMMAMPLTMGSTT   LBDPGRDYIENTRU 
LGMQCUHQPDH     : PHFLJQWL        RNXBQD         
FSMQHKCGKP      : QNUMAQFBDYXBDM  NXQCNXXJFIFHX   HPSVY          
ABFIDYI         : BQKRRI          XOUAJUKSLXPQUN  GKECLFYNLO     
MRJETELKVQT     : JURWIDVNVLQQUX  FHGHLE          VYBC           
WNKPWVTDGMDGPL  : ALRQWHTKMNRN    XLCATHALBSB    
SMCQYTCFN       : FADBTEVYKMY     YSLQCG          QYWYC           HDVQQ           MOSGFVDMSBRO    KYHM           
QAHKVDJLPYI     : UTRWPHOBVB      BVFQRAGPCPNJIX  ROVODWNAP      
VNSIRBADSUPWL   : AERQAXFOUNA     ANIQYW          YMTVNQQLXMKACHD
QOWGWPGG        : MHRYFVCAP       QENMQFHNPIVU    VWHSI          
CJJOCLYNJ       : NBHKOMU         CVBTVFUXBIFV    IRQJABONDG      IJTYEHMCPF     
ITHKTMFOCCASUQP : IVMOYRLHFLR     GMJBHBTXYQSOXRS QCII            YNQWGFPED       ISOEWANUSKXGV  
QIHWILJU        : XAVV            RSCVROYEWNNY    ULPNVDOB        EJOHFOA         KBLATUOE        PNGCAXRFBNGBXOO KYMOWKVWR       JDYOVWYQNMPXD  
LIEYRT          : POGCNJMENTM     EVPMHLVUNC      QPPGGGFMXYS    
LDWFPCTT        : UIAE            DCBXITVWWOAA    XEOXUTRFKKEMSIO QRHRL           SESERULDFTD     LBVIAHQQC      
VOBNHCGPLDXWM   : RGCNUMELNPMUWGH YXXWS           KIXLG           GICFDSJH        KJOWECVD       
CADGCUCMIFJN    : YFQFEIHCBITFSGG SWQXHL          ABNGNNLX       
NJOTGFUVMYECKH  : SHAXFAX         WLAMUEWLAYKFU   LRWJPRXO       
JWXNWCVBYXNI    : FMRHL           JOWRK          
YXAMIQGQW       : WKSHJJYWMS      EOUOVD          YLFTWDIV        QMDWWIRSHVCR   
OJESMQC         : VHKVPMXDT       CJNMSPTLPHXN    FLEGUBWOWT      QNWLNFQOX      
BYNQYRNARLQC    : RYXFQBNUQGBE    IRWUAWMRTI      EKWLECPW        VJMXOKQFCOTDHNT IYGXPQLIPH     
PARD            : OAUGCFQWQ       XHKJUCLIIAD    
JLDGP           : RWUAANFE        MIEQGVAHYOMPOJ  BLIROVJ         HSUYTJGGOARIFPR RGGEFFMEPSNWM   QVTDKUP         PHGQXOCBBGE    
PVMENPVOOMFPEUS : IXQUCGNMCFDPXB  TWWMBE         
HJAYYDSCNC      : JOPYLKIW        PKRPDGYLNDSVH   FXPTEU         
RKILDEYHROGI    : RWUAANFE        YJRUTRQA        XJBNBWH         GXBOUWRAYDTSHS  RXCJGQPQMQ     
SQXWLQX         : LXAAT           DWJC            MKMPFSRISBMR    BIRMESJWYPF    
AXTBDNGR        : JPUCFKCXKBWJJQI HMYFWOEHACK     YQHBMEL         LBPTRJSCWPL    
WLDFWGJVPEKVM   : SGWQMRYDFE      ALRWNKQGOOA     GLPBF           QMDXIAFE       
ODQORHMMJMJKS   : UKMXENNXTC      WFST            PHTRFHUQQQGYJE  EWCFPWMTC       MACHNO          CWQJPNVIXPBHWBB
QKQNVVUUEFR     : TMOUSHSQV       HCPUGAWMDTO     GPMEWKIIMBPW   
JESXWK          : ILMX            ATQIPBPCOBMC    ADUPGVGMQDP    
PYVYNIICTTUSMHM : UTDS            HQMMGWO         TMNLPXPJEWNLCA  QLCMQTEVBRJPE   WVJVMSIR       
FKXBPFU         : ILMX            EBRNAVSLFK     
OYFNYRROQPOG    : VGCSDTJ         BWAA            QOQNMFEB        CLVVX          
YLUUIPI         : QCII            EJOHFOA        
CNAPLBFRXTIXBXY : VNWCEVT         CEGDUAQTXNW     CVMALAXPTEUW    WHDBELYRSGEO    REKIOQDOOJR    
RPMHGTI         : GVTCRRCUCPAVC   DYVGQCHHL      
HDBRSL          : VEDHOKADNGH     HGFWPQHBWA      TPRVMUGIX      
XYLNNOUFNOPNR   : DRFJAA          FTDTVSXAFB      CUTIELIXVPON    PSWITVKDPI     
MLGE            : CWJUXLIQLEAH    BLJGSXDYFSDLETC VOFFKOFHONHID   NSTM            HYFWME          NQSEVFQ         CKMLI           YSJXCNYXJYHNB  
MLGE            : PONTLUIRBOJ    
QLUYREEUVYJHWIU : IDBW            PSPCBSEAJUTUY   XEOXUTRFKKEMSIO
VLHDBXTOQIDE    : IQSVT           BPESO           MNUHTYIQ        XMTAQIMDC       KRVGRSUAI       PXLYAWWWAT     
IDHVAIPEMK      : HGRODECCVRHOUHB DNUJ            GXOYGO         
OTKLFHBDSKJ     : IPEHIBCYD       RCKR            RJFWUAJLQSYTY   ATGY            OJIRJUVJ        URYYRGQN        JPVHRDNJSAO     FUJO           
LDLC            : YKVCIXBKSW      SUSAIJAVBP      ARFVPPJXCWT    
RIGC            : XFMHIIRRKV      CFVSHHDVRTEBUTK TMTRRMUF        LYYAYGRNDK      QFHTPF         
QXMYNTOAWDUH    : WJQBUBHEIIDYIW  PIMXLLFLLYLYSQ  UEWWFIVLU      
CQTHJFQGQVUUJ   : TMOUSHSQV       ILQKYTIVTFKUNLW NUACGFUXBGUGS   MGOLYV          YWJFN          
DSORJMHKABY     : BJNOQDAN        GPCKSHKYAU      CUDTVQHGSA     
XEWHXBXTJJYC    : XEKV            XIHEDEQBW       SMBEMOQAFDLSL  
RYNMKA          : RBRBFRKNOJEUJY  IGCLIRWYW       FVIS            RWUYHQCFTDQ     RFQDXQROMG     
DOKMBRX         : JWXUPMWA        IYREJSC         GPMRBVB         AERIB           EJJJGFM        
SYFSGDAGGAAR    : ABGVAPMF        HCSDWTVSRKDF    PWEV           
CUDTVQHGSA      : TPIRDNUYCELH    BQYBI           UFKYIIWTWARFEBW UOAQT           DSORJMHKABY    
HKYKFYNXBUTJ    : VLVOCSROFWWAVMX UKVQIHP         ALJTS           HQINNCBC        HRTIX          
VPHWRYJTVOO     : EBRNAVSLFK      ETNRXIXEFIR     YWMLFMRROKWP    PNNSRXJPVMVDSVN ALCHGDR         JXCUAMOJBKK    
HXBAANJ         : TVQOKF          FMIPJJVR        WLAMUEWLAYKFU   NJAALBFEKDFRY  
OTPQJQREMDFIUO  : CRCIMJNPF      
MPSJMHXGQXJSXY  : ECIBBLFOUPIVJ   LEGSHPNQ        MCLFAMECPTVC    JGPKPQOYP      
KOXD            : JCOC            REBFQJUHMFY     UVCXOUBFERBDJE  QXRUTX          MRGWMK         
HVYOICVS        : UCVIYKYDJYV     IXXF            CCAAA           TWCHHXKP        WYUBVHXDHIEDWH 
KBLATUOE        : QPPGGGFMXYS     QYTCFDYTNHQLNU  QIHWILJU        FYYGECWHF      
VWSHQSHSEVTHDD  : NJHQKDTVRJL     MMKTXQOTECRL    XBUQNGMLWYXKGJV FGFGSPYOCFOH    TDSTLFJU        HOFUVDWNNRXJJ  
ERNGNGFAJ       : ITECFUUMSQYMTVV PSPCBSEAJUTUY   BSBRPOVIXYQAAI  QMDXIAFE        KHBQAKPXSNJU   
BGMPKJNJDXAXFV  : WAMPNTRGJOHJQWM MCUEFSIHLDUS    SFWSTXN         UAEVOG          LUJSL           FDIVHLROMN     
DPLGSQKNESDN    : EDWJAJIEEVOWL   TTGBV           JDXQTFJ         XEKV           
EYQFF           : ELOWIJUB        MTGUIVNXSKBXOU  UUPQKI         
WRPN            : XLTRIKHXSNG     VFUBVKW         YIGVCJQKN       NLGWECGWF       HEJHTCRYCSXI   
ULESQAXVRJ      : DWIFQXLMMSPIN   HRGHRYHTHQO     JGCA           
LBOBHJEWJIY     : KGVEB           KWMTSN          CNJNPVEU        DQNVU           QGFSDNYQFG     
PEIPYXDDUQHNJIL : NGFTVKHRTRS     FJKDJVJIV       FTDTVSXAFB     
CXJNBXQKJ       : PNMDMFTWWC      SHQPGTGENA     
ISEHU           : UOKEPEGJAMXMI   LPMKQN          PUNLHXBD        TNDMULJKSMCWY   PNSOP          
NDMOBPRVG       : TYGJVH          QYWYC          
MRMA            : AFSQHUWGJPG     SCDJLXHNWHC     RDTTQ          
OAGFBGV         : TUVEEERIBLG     XWUXKGYGKASDBQT FTJRATNNFKWAVUX MPFMNEOS       
PRWKYGFXVJKL    : KHWVVEHHYBFEDY  PXKQCNBSHXHFNV  BNSUJDVR        CTWVQVLRA      
CFLKHXCTAYLB    : FGMLLB          CNJNPVEU        PNGECYFBBCMYL   REDSLMOKMYWP   
QENMQFHNPIVU    : NUTXAPPTVFH     VTTNGQPCM       QOWGWPGG        TWCHHXKP       
SESERULDFTD     : DPWCMKRNTDXHI   LVXUTQLCRNGTNHD NYQSWVXPGFBKCUO LDWFPCTT       
PDIBGPRLDHEK    : DCJYNG          XNDB            YBANPOMKCGUES   PDWTOHNCPQSR    RLRLXLCLKHXI   
SABQUJJACP      : QQQWKC          IGKC            EJOHFOA         YCYEXCNNHXRO    VVPERDOIAJX     SXVMF          
YCYEXCNNHXRO    : IYTOATPKH       SABQUJJACP      DIPPJHBESGAERQ  LHWYRIUIVPP    
LCUUGFNBFOSAXE  : NYUBMY          LPLFBDOL        APYLVMTA        WVJVMSIR       
CWVBYWHYYWOJWG  : WADKMIEFVFQAFS  UMIMDTDLQ       ISUG            WKNDPKRFHI      WPQCNN         
MUCHPKMEMRUHSVL : OHMEDGRKHC      HTGCJB         
XIVCJSLKSJACGI  : APDCKGNQXF      KRDXFPX        
TDGD            : WVJVMSIR        JCODT          
QQCFIWMDUBBTL   : VLCJWRCVV       UGVYS           JLSDSO          GLAL           
XVPJGKUIOCRSXWY : WBENPEWJM       QBLFEPCDJNNSWNL
SSTWXDWLIRMJNX  : NASKYD          TVGMOMIKMRAMSL  MOSGFVDMSBRO    AHVNCOVWMDLBM  
LVBVFLSNBUFT    : JPUCFKCXKBWJJQI VGCSDTJ         VOYWIPVXUVXG   
FVYAO           : YHRXWALFWSAOO   DBWVKM          QFCRXEQEKESJ   
XMXU            : VLFG            NQUHMOJNMVVVYLS
JMMUDNEOJ       : XCTMOD          TCDHTOXLOHTBUQ  YHRXWALFWSAOO   NYQSWVXPGFBKCUO LLBVJY         
MOSGFVDMSBRO    : YHXHTVYDPIUWCY  RGJERHKOQEBMTP  SMCQYTCFN       SSTWXDWLIRMJNX  CYSNOKNCHQD     LBVIAHQQC       FHVWY          
SFWSTXN         : QTFSNJMJ        BGMPKJNJDXAXFV  HWTLJPPDADJE   
HCJC            : YLPXMTKGLFDNDWA LFPULYXHJ      
WIWJP           : MDLHTNIRUAPJMYJ XIHXA           HSWA           
AJTFFASAB       : UVQXGEK         SGTDUFNOUVQ     SBXYFO          KFACNEHQ       
QFHVCAQAPNJUWOC : NHVRC           EMOJT           JEBONBNW       
WBENPEWJM       : SYFELRJ         NDGNUVIDJERNV   XVPJGKUIOCRSXWY DGFFRGOUIWDI    APJYEXOXJML    
JHFMTXR         : YRBFYFBMX       UAWU            UBUEICJ         DPWQMXKIGAMAF   EUEQ            QXQTWHFQ       
UWEN            : NLPNGSUUDKVAIYG VYDWVJATX       GPMEWKIIMBPW   
WBJRXXVSUXYKN   : MQNYMHX         FFOYUG          BBFPPWG         LGRLPUGAF       JGGKWXGCYVVX   
JYSOLCVXVTS     : KLWPNMUQILREG   QYWYC           RTSBWPYPHMFHWS 
QPHEOEHAXGXT    : VSEX            JWMM            EHJN            QPGNKEA         PLIDN           AILA           
VRDGHJQHEHSGF   : PSWITVKDPI      PAXX           
EBNHSDQY        : UKKTHOASEY      XEOXUTRFKKEMSIO YXXWS           ANKU           
UHUUPVOS        : VDGRHJLELUF     KUKNMGYCYUCQ   
JVAQHSANCUTHQBJ : JRQVMJ          ETOPFJOBAKA     SUFXGDA         XAISAHLDEMG     JPPALWBXEBFVF  
KEIDFDAMAUEVJ   : RWUAANFE        OHJHGYVKYAJI    IWGAD           FTJRATNNFKWAVUX
PSTQ            : PPCSLY          GSRR            HSUYTJGGOARIFPR NNTJWNPSKGQVQA  RTSBWPYPHMFHWS  FJVUKLCLNDHBHU 
ELMRO           : LFMJMVLDD       MNUHTYIQ        KVURY           YIDOAHYDBWGRIX  IATD            RACCXWR        
OXBRJFCNNFTSF   : FQMIRLFPN       HJKGVIFFQFW     KNAEFUIHCITE    TIHNBSHHARSDA  
VAPRLNK         : ABDVMVWIH       IMOXBBMMQAYAUI  JUBRMIKCKCKQ   
JBRNOGGDQWCR    : MGKWONC         XNDJWWIYC       LFPULYXHJ      
NXQCNXXJFIFHX   : BDNAWFWQT       KRVGRSUAI       FSMQHKCGKP      RFQDXQROMG      PHSV            CKWMDLOQ       
SNJAAM          : MKJPBTSSQ       KRJXJ           UVFPVQJDW       BFEGDQKOM       TTEHPGRDSDCGCD  MTJSSMCOS       FWIO           
PCBXHRULKJAIC   : IIYYDCXBVPMNU   FKLQJN          UWJEPAWIJTG     WADKMIEFVFQAFS  RVXQNE          HWILPIWNLOMHHDN SKNSV          
XCCHHKMQLOMB    : GOWOLQBQTWD     TTFKQLYOYCLBU   BNOMOIP        
MDLHTNIRUAPJMYJ : XAFA            SYFELRJ         WIWJP          
CLTGPDOCQ       : WCCEQJGYFTPVSME QJYTPRC         LASEJVNWHXSPII  WIHNSIDFPGDS    WGFEWGMDEGRWGX 
PHTRFHUQQQGYJE  : GPCKSHKYAU      ILMX            CFXQ            GPKTSEV         ODQORHMMJMJKS   YCLI           
YNOAWLE         : VGYUSUM         JUOWAEQTJQ      DRNTOYUCBSO     PGDN           
HLCLC           : YFKFF           JKSSAT          NVKAXIXGMITWTM  BRLTMBRSWPHGEW 
EJULEO          : QQQWKC          AJCEJEKESF      LPYONGYWPKQDAS  FDRCRWSDORII    YWMLFMRROKWP    LLBVJY          YHMBVGTVJPETO   NOBK           
NLKEDSDOYGPO    : IIYYDCXBVPMNU   CVKGOPBQFHBGP   QCII            MCUEFSIHLDUS    NRRWQOSVVBWWGB 
PNJWXSK         : SVLMBL          MPMTYWKKEVUV    HIKEFRFRSJDXT  
GMHKVEXCURPGE   : EJAIKIYCIYTIMC  SUKOTGTKRKE     HYOG            GMRW            TYUVWIXLWN      DCUFRRFEIVOKQ   UEPBYQGTWACTMV 
LYYAYGRNDK      : RIGC            CQMKIUTKMRTC    KFOCRCD         ULBAVSEF       
OHCIRFOGO       : TSFXQLQPAIR     SOFUGXRSLKXFVV  CFEO            LUYCB           FEWPCUMDW       HHLUYYVFLQSOQLU EPYOQCJ         PQBWBADFFG     
EUCHPTYVXT      : DCMVUIGXOO      LNOPHMBESGQJ    WEOVNDUCQLDJH   UIJAXMJVCN     
ASMYBF          : DVFKVKBAURNBLPV GXOYGO         
HPSVY           : LDLVLNYQNUBVLPH FSMQHKCGKP     
GQFXWTCDOEKG    : NASKYD          ETNRXIXEFIR     FLEGUBWOWT      WKNCNLTFWGSFST  LOETBKGKTORHPFO RIFTWEGIH      
KEYGO           : EWAXIVAMAI      JQCA            CPBGRHTEFXRC    AUGSUWJANVNWKO  JIJHMPBBRWVT    VWDJCQFJS      
BCAFHRMYKKX     : XEBSTROTSK      AUOFPUA         FJWEQJLXFY      UOVEETUOUIW    
TOPRNLV         : HSGLOAMONJLWYL  SGAFDYRTQPHDSLK INSA           
CAEIBQNDYE      : CHDRF           LENICEJ         KYHM           
AGFHPW          : HKWXXNQAIPWMTM  TUMRBIDMQJJN    WJJBRLYXABC     SRSFPNWEDCSOY   CCAAA          
OJHMUBDMSQYOK   : FOYBEYMSX       GFJLIEOCPBOT    XUPTTMWQT       LFRJSYKOINVNTWW
QQMSJCVIGAK     : TMTRRMUF        JOEJ            JPGSR          
HSFGOUQ         : NTTWGHI         VHSDF           QEXIAM         
HNWNC           : HCFQGAUEWS      RGJHSVI        
EBIQHAJTUS      : ACVDVH          YFQFEIHCBITFSGG MCXPPP         
SBESOTDH        : DNUJ            BWKUPPWVXXJITQ  FDIVHLROMN     
JXUCUERTRUMYX   : CTHOS           FYHRC           KBQCRVTBXQNN    YFQFEIHCBITFSGG JDYORG          MNUHTYIQ        HKJBGQXTPPRCLLL
RFYC            : MEARPGUCDUMXERL DJHXR          
TWWMBE          : OTKDLWHCN       VCOVSVETGG      PVMENPVOOMFPEUS
PXLYAWWWAT      : VEBWRDWUYSLRF   GPKTSEV         VLHDBXTOQIDE    GIWKJOXIE       TNDMULJKSMCWY   RRKG           
ROVODWNAP       : GLSCWU          JOCJJRFOU       SLAAAPEQQHWKCQK BCCE            TFYPAT          QAHKVDJLPYI     GJGAAGAHG       LQQAUG         
CTWVQVLRA       : JMIXOEOPL       XEAEAEXDAFGVX   PRWKYGFXVJKL    TTFKQLYOYCLBU  
JBHIBEIY        : MENFTUCCTVVFHVN WTODTYRMVECPC   CLVVX           UHDPHGLYKVYD   
CDBSYPXY        : KDPYSSDLQGX     HTUA           
BOBD            : FMMTC           ITECFUUMSQYMTVV XRNT            YQBEI           XADSXNWIXMYRB   WHANNTISLL      CCAAA          
ABDVMVWIH       : SJHPMJWAACKD    NSTM            WCMW            VAPRLNK         NPJTBGIHI       ARQTTUYMSPBSCJB
PQBWBADFFG      : XNDB            OHCIRFOGO       ILFJPTCN       
FYYGECWHF       : PSTJXGBIGDN     WQBMPVEAVPBIOR  KBLATUOE        YKQYIWGSOSISRWT UJTDKHFTVGGX   
HJKGVIFFQFW     : RYXFQBNUQGBE    DQWXQRJOSL      OXBRJFCNNFTSF   TYUVWIXLWN     
GTKJAPOISVHSC   : HOJMVJNGA       JIJHMPBBRWVT    CCQBESNKH       AIEACJMRIGO    
UYXDGGMTM       : IHWWOEXSQHG     HHLUYYVFLQSOQLU CQNVVDAOIW     
ERPUYPGFLS      : XAFA            JVYRTN          KLHVGGARPLIBIC  OLHDULINQRWKEM 
NLGWECGWF       : CEGDUAQTXNW     VJPUQBJAMTBT    LACEOUCX        WRPN           
UGTANCOJQYNKR   : EVPMHLVUNC      LDEXXYJW       
JHROSN          : IMROTXA         RNXBQD          QFRSFPBXOJS     NHFUKCJURCMOM  
HYOG            : PTKBMLMFVD      GMHKVEXCURPGE   NTHYEFUWVKTW    DAMJUY         
QMDXIAFE        : WTODTYRMVECPC   OIOBWX          RFNSEPEBU       AXYWHQSF        WLDFWGJVPEKVM   ERNGNGFAJ       LQQBMIKFNJ     
SGOEYN          : UGSWE           HVTLK           KVPD           
JFFSOAJI        : OTFYGSKLFDB     OPEMMUFAPEASQ   WLLKTHJKWDYNJCC QNJYUDWLOOHNFG  ULBAVSEF       
RRMG            : YMQEWT          DFWVFUIM       
PAMSXWUDBUXJLCI : FADBTEVYKMY    
WTHCOWCBHPS     : LJUELOBNXN      IBOIQYDWAJSLE   IGUWDNLPSUOWN   SKXURGAJ       
CCBUCNPALLGOIE  : NBAWUVYAEIGUWX  KHWVVEHHYBFEDY  MMKTXQOTECRL    QOQNMFEB        WLAMUEWLAYKFU   YPWCXTGVVMF    
UJJWGGGKUFP     : CFITQAKWDTGYWA  CYPRFE          PNSBOFXSE       NNYDJVWO       
MHRPMTQHXFYA    : XKBVRBTUA       IMASDEIHFLKJJ   DVNHNPBKL       DPJWVG          JGPKPQOYP      
KGHTNIQWUN      : ROSQ            IHJTBGJNY       JLPFCNNH        BAFRIFOMCIM     BICGFETATKFJ    MLSYWSB        
BTPVAHUOP       : FNSVFGREWL      CFITQAKWDTGYWA  DDFMIP          PHTNNLOKNQKQ    NBNOFQONAOPIY   QNJYUDWLOOHNFG 
FCIVJGBK        : TDDBKNWFYJQVNC  TVOOTOOEAOV     MDPWLCULMMNLDVR JWXUPMWA        IXMWHTF         IHOITHDBKL      BNKIEUC         DRNTOYUCBSO    
FCIVJGBK        : QVPGELKS       
VVPERDOIAJX     : RIKHVWVVBVDAG   YDAUOORYRAWQP   SLAAAPEQQHWKCQK TQWKCSJDIAA     XOUAJUKSLXPQUN  XMTAQIMDC       SABQUJJACP      DVDSYRV        
MRYJT           : DIWNNVBFLJHB    SBGHQLVRX       PHSV            UELNSNKTYSKSLAS
GJWSOBDK        : JUGXPAUUAIVJOB  PQVWUPFYBLQ     YSLQCG         
JOWRK           : KUJYO           JWXNWCVBYXNI   
HQMMGWO         : QJYTPRC         PYVYNIICTTUSMHM BRNFMSA        
UVFPVQJDW       : SNJAAM          VWDJCQFJS       KUAMTEBTF      
CRJDUWPELMXX    : IGCLIRWYW       XRCWK           CGQCL          
IRWUAWMRTI      : VXYWJC          BYNQYRNARLQC    QVYEO           RIFTWEGIH       ATDKQD         
JGPVLMQNEBSYXK  : SDLM            HRPAPIGHJFRL    QYNQLIMJGROXXXP LFRJSYKOINVNTWW
LXGLIOD         : FWIO            IHSAALODIB     
LDEXXYJW        : PWKJLHDLOQDVF   OAUGCFQWQ       WUCPHDPWXRANY   VTTNGQPCM       CXJNDAM         UAYQO           UGTANCOJQYNKR   WLLSHUBADYKW   
PNGCAXRFBNGBXOO : WVLYCRDWTVSUJ   NPCSYRMRLAYQD   XTVNAXF         QIHWILJU        QYLAWWVWFQNIT   JRWDYWSCNKX    
UAGJGQWL        : UUDJCIRIOTYSKDA
VJTHHFWUNB      : FUBQYNV         MVRJITNI        EMOJT           SNQTUVHQ        BCKADBD        
LVEOJLPHCEGWH   : CMVMI           BFEXRGYCOD      MGRQCYJYESOQME 
INFFBDDLWKUEK   : YHRXWALFWSAOO   WSLK            IIWGFWJGGOYIGV  JLSDSO         
SLMGHRVSFNBH    : DECPKQ          EXNRYKEBFYNLH  
JGCA            : ULESQAXVRJ      UVQEWKCQVLF    
RIVSLAGKMBRWS   : PKRPDGYLNDSVH   PXXV            XDPPOBPNXAGGB   EVEL           
LISS            : BOQTQAUARQV     ALRQWHTKMNRN    RJBWOYPEXFFIU   BQML           
OOJDPQXB        : OHIUUKCMDYKF    BXDEEOAWGDRJURI FKJUKEDJMFLFG  
ABNR            : KBQCRVTBXQNN    WOOCXCYHWIIBIWK WLMBBUWGOIKSI  
JMWL            : FMTS            EPYOQCJ        
IYUCXQMJBFFDW   : QGHFAHE         TSBHQPJHULMULOX KXKKDNOVYW      ALRWNKQGOOA    
MCLFAMECPTVC    : QSFSGTBDQW      JCASPMYNJAJFNK  MPSJMHXGQXJSXY  KFHLNNWBGHCT   
IYREJSC         : EAMTLML         HERD            MMKTXQOTECRL    DOKMBRX         CIRNGIHX        QLQWONTLSATR    QFTPNQCDV       RQOEVDL        
QSADTIIYFC      : UIAE            TVOREPLT        OGHR            ADAGDQAQV      
JNSJCYNRSJTATV  : OFHJEQPTRNE     RGELWIJM        WQBMPVEAVPBIOR  LRMSQGIVE       HIKFE          
YHMBVGTVJPETO   : EJULEO          PGQKERXXEBQF    FKJUKEDJMFLFG  
VCULUGPTTHOFEQA : EQKOHVIYHSSNP   MEARPGUCDUMXERL IDWKXB         
LBJACFIXCRNIN   : KUTRBCMB        JLRILSVCJJJQJVQ JISY            QNWLNFQOX       ABFPGUYHVOYAH  
WLGTWBBOWWWN    : UEQUMQHRSJFW   
DGFFRGOUIWDI    : YBANPOMKCGUES   QXJTV           WBENPEWJM      
XVJLAIXGDWJEMID : CJNMSPTLPHXN    QCGR            KYMOWKVWR      
XIOENVYTMT      : SUSAIJAVBP      RXACAHNTPNWSOKY TFYPAT          TOWIPDYGJ      
JWMM            : DDSPRPTLP       DARUFTEGXAUQOCC KVURY           QPHEOEHAXGXT   
KYHM            : SMCQYTCFN       CAEIBQNDYE      EXLPMKDLF       SUQHLSBXGJFMC   BWKUPPWVXXJITQ 
FUKEEQQOWE      : XEAEAEXDAFGVX   JURWIDVNVLQQUX  TJQGH           XDPPOBPNXAGGB  
FUTTQUPGOWPL    : YIXXYMRBRXFFMIQ PSPCBSEAJUTUY   CYDAMMEFCJRU   
FJWEQJLXFY      : XAVV            XUPTTMWQT       ISUG            INUJVKFWBUN     RXJWXAWJIRV     BCAFHRMYKKX     GCMYUFOLQYSXQTL
LRVDOA          : AATH           
UVNQ            : ANKU            MDMTPLCB        QVYEO          
IGUWDNLPSUOWN   : YHXHTVYDPIUWCY  NCLOJPR         WTHCOWCBHPS    
ILFJPTCN        : RGELWIJM        EDWJAJIEEVOWL   MBJEEAEXNH      PQBWBADFFG      OCPRDJO        
QOQNMFEB        : MSUJVPBJ        OYFNYRROQPOG    CCBUCNPALLGOIE  LVIABCSNFNIAB   HOFUVDWNNRXJJ  
LWPQKBIDXWAL    : XXDRDNWEJVUGU   WDNWUBBNWA      KFOCRCD        
KYFUQYYFXRV     : UTRWPHOBVB      PFXPRJKSVMIW   
GIWKJOXIE       : PXLYAWWWAT      TDVSF           UVCAEMJ        
SHAXFAX         : UADGUTGJYRCRB   XMLCEHV         VEWKPGSOUULVDQN KLIE            NJOTGFUVMYECKH  QVTDKUP        
XLTF            : ROEK            GFRMPB         
LHHSFYOWFYVSKLQ : RVJJOXXF        UVQXGEK         ATGY            TBRREL          XLRGAH         
PIMXLLFLLYLYSQ  : XDEMNP          MITTCJJWSUBML   QXMYNTOAWDUH   
GXOYGO          : IDHVAIPEMK      ASMYBF          CBODRDLON       NUTPFQLKVY      IYGXPQLIPH     
DVQCOCNIVDQK    : JVYRTN          NQSEVFQ         YQCMGFK        
EXLPMKDLF       : HXVYRMBMHGMASD  HYSVQTJAU       KYHM           
TOWIPDYGJ       : GFRMPB          XIOENVYTMT     
WLMBBUWGOIKSI   : INSA            ABNR           
JUIMHPLDEJNU    : MBGSIMAFC       EQBUEGFDGEAGDG  RFQDXQROMG      WMSV           
NDXLC           : KXJGBSECFYBWNVQ WHQIYTLPDJDIN   WSELYVMIJSSVYXA
XEKV            : JLPFCNNH        XWQICXOVO       XEWHXBXTJJYC    DPLGSQKNESDN    JCCUCLF         AHCKYLJQFM      EBEKASNHMR     
RKLEDUCMRKCYAPC : HRWLXAT         SGYARDYIQXGVLOT NCBBDDXUQYJH    RACCXWR        
YQCMGFK         : XPXDVPHWFMIO    DVQCOCNIVDQK    ARQTTUYMSPBSCJB
HWTLJPPDADJE    : IFKJHMHHXSYEBC  SFWSTXN         APPPGXXUEOV    
LSSXWRBNWIMPKB  : EOQUSXH         CKWMDLOQ       
PORWNLLW        : TMOUSHSQV       KUXFBNIFN       NQSEVFQ         PENXWXRPEPVJKY  PKGTKXN         QPJNDDKTOFUHR   EVEL           
BDEGMIH         : JQHTLV          VWDJCQFJS      
EAYBTAQQIE      : JAXWDSONDVJBTH  HDPNEYPHMR      IXQUCGNMCFDPXB  RKNSW           PVFBAOQ        
SHGKVAIJMVJQ    : EFKCMDMLQY      THCQKQ          IBOIQYDWAJSLE  
MUFBGMC         : MJXAUNAG        NRTNJPRGN       QCTUVB         
MCNHCFANL       : MVRJITNI        MNUHTYIQ        UAEVOG         
GSRR            : YHDVICRNC       PSTQ            JIJHMPBBRWVT   
SCBHAMAYYWG     : NTCP           
DTFNIJCROJUCU   : CDCMJ           DALSSFXPHGRRCWS YUJNWSNIGCBR    ISQIEFLGTYWQNUP SMBEMOQAFDLSL  
KNAEFUIHCITE    : DRFJAA          XGVFMIPMVKGWACT OXBRJFCNNFTSF   QYNQLIMJGROXXXP AILA           
VCQBFMGVUSAPH   : HRWLXAT         FTMBMBHURWY    
KLEQV           : IHHBSAHLG       HCRQDKCVXCQA    VGGAISJ        
SBAOL           : TTVKGJ          WLRVYYO         RQOEVDL        
SUFXGDA         : PVVPITAHIRDW    JVAQHSANCUTHQBJ DRNTOYUCBSO     HDECPS         
EHJN            : GRBYHGOYHCOSBRV CFEO            NGFTVKHRTRS     EQKOHVIYHSSNP   APYLVMTA        QPHEOEHAXGXT   
HGFWPQHBWA      : YBANPOMKCGUES   SYODCMTYBLTO    HDBRSL          YFSODAE         MHKNJU          YJSKKJGNMJDGEXL
RSATJMDDJIDPMDP : NWKIF           MNUHTYIQ        GHPSEGAVGOYCGIV RWUYHQCFTDQ     NQUHMOJNMVVVYLS
MBGSIMAFC       : TQWFVU          TCCT            WFFMOJRYRSRE    JUIMHPLDEJNU    EJJJGFM        
OFQQDKMFEVTJBFU : PJVGXIE         LLFMLWSFPCCBGV  VCMF            SSFWBNQUFX      FLVFBPLYNYPHXA 
VHJNC           : RXACAHNTPNWSOKY KJRWOWMJRNU     GFPYKEFEJPNAG  
OJRXXTFDNWIF    : UKJILBURVNFOH   WUWKMINWSY      WYKVSOIBCNW     FMIPJJVR        UCQIEDDWFNIV   
NPCTWBP         : PURLBRYIUFTKPX  KNDQ            GYHXYLURTRAJ    SBRQGHP        
CVBHTKQHNPVY    : GPKTSEV         WVGVQ           DEFEBGAKH      
VWECARBJWQWPTSM : KXHRKMPKDBE     TNQTWYSTRS      ETNRXIXEFIR     WCMW           
JUYHYIBLCIYRGAE : SIEHDVIVYTXBUCL
XIHXA           : KXPX            APYLVMTA        WIWJP           UEQUMQHRSJFW   
JAYJRUCGTNB     : NTTWGHI         JUWREWAWIJLIR   DCUFRRFEIVOKQ   DXDPS          
UAEVOG          : VGVEXK          HIKFE           GCGRFGBWY       BGMPKJNJDXAXFV  MCNHCFANL       HKJBGQXTPPRCLLL SVHXBGHT       
NBNOFQONAOPIY   : BTPVAHUOP       QPJNDDKTOFUHR   SBXYFO         
JIJHMPBBRWVT    : EEHBKGVKQ       KEYGO           GTKJAPOISVHSC   GSRR            BWKUPPWVXXJITQ 
UIIBYJO         : CVMALAXPTEUW    UCCKTOFSFDSM   
OHEEJUUTTMEEWN  : XRNT            MMRLVCOUCNYX    AFLJQHLKTBHQNII
OQUGOSDQNNBRM   : LNVMNDMWLA     
IEESKJCGGWCUDHT : WBXVEMCSLHCQOTA UQXW            KPBNCKUADGY     GEJHXKKOX      
DJHXR           : DQQGUVXHMAYLRJT GFJLIEOCPBOT    JRXCTOTUPME     JHXCSGGXYBKPFNF DXOKSEXGSLTMV   RFYC            PGDN            HOFUVDWNNRXJJ  
SUQHLSBXGJFMC   : JQCMHISNJTYRDDF CFEO            KYHM            YQYIFHGL        WFDP           
VFVECB          : FQXXNDTI        EAKSGQIENFCGT   WSELYVMIJSSVYXA
HKVXNHHLAGGWW   : LKYEBC          KRVGRSUAI      
IRQJABONDG      : CJJOCLYNJ       TGHDRHFSSLKED   QQWQG           TANIKTQLRFMQRR 
KFQOGSVQQTEYERB : SMAJHYKAWEN     EHXON           HXRWGL         
XXJOHE          : RYYOWLUIBXSQOL  BQHJEYQLXXCLG   UEWWFIVLU       UAKWATU        
SEGHRMNEWSW     : UCMWCGHQGAUM    RSCVROYEWNNY    IDXXYYP         VFCKH           VJMXOKQFCOTDHNT
BRIRKFVJJPM     : CRLLQP          ESWPEHAGRT     
OLHDULINQRWKEM  : FROYDVEKY       YCAHANRUJJWLXAA ERPUYPGFLS     
DIPPJHBESGAERQ  : BVFQRAGPCPNJIX  ACVDVH          IMROTXA         YCYEXCNNHXRO   
NHFUKCJURCMOM   : WOLC            JHROSN          HEDAIWBAUVFXMHT
DGWLVOXGRCBXEHR : UNSIAKTTDTLYGEQ EFGAJV         
BFEGDQKOM       : ANEGBHHL        EJOHFOA         SNJAAM          LXIDWQ         
QBSFW           : SPVSIORQR       EOQUSXH         GYWE            RSGQHBHXX       EVEL           
NTKKKKSDOT      : WOLC            VGINUTXUS       JTBEJQWFBXOEG   HXYTIVDUJNXSI   OAWCESUDQIIJHAY
TDVSF           : EMUYRTNYCWEDJMR GIWKJOXIE       WHECJWVFFNOHWM  JDYOVWYQNMPXD   BRIKL           HRTIX          
ANIQYW          : VNSIRBADSUPWL  
DPJWVG          : ECGLKXENUWMCGYP XDHXK           MHRPMTQHXFYA    PSWITVKDPI      UHDPHGLYKVYD   
LCKVM           : TCLIFNG         WXTQATVCHMTTQY  JGGKWXGCYVVX    KPWQUPFJHPVIMN 
QRKMVGQTA       : YSXOR           OEITXRUOTFQ     FEYRWFAYY       SNAFO          
YCLI            : UBUEICJ         PHTRFHUQQQGYJE 
KHBQAKPXSNJU    : JQMCOXITDCTWOG  ERNGNGFAJ       MGKAPNJBJOTAY   EBRD           
IJTYEHMCPF      : MFKKKD          QQLUHUYJEA      KUKXYOFYGVUODLL CJJOCLYNJ       CEIJGK         
PDWTOHNCPQSR    : PPYALSAVGVIUP   TBHVQTP         FAEWXTDY        XKJKDRMYLB      PDIBGPRLDHEK    VVJFQSOLVLTC   
KPVXY           : PRGWHMN         UDWOEIHFYKI    
VJCSJ           : UKKTHOASEY      HGWWWPNDN       KGUSQ           LXNHSP          RACCXWR         XHCKCBUPFKCYQJ 
CXIRDGKGEEWLTYD : NPCSYRMRLAYQD   CIWEVCDHPDSE    LVIABCSNFNIAB   BRNFMSA         APPPGXXUEOV    
TUNEMJCMCBXFVHN : DQQGUVXHMAYLRJT GUHBRYF         YGMCUCWEJB      MAWIMEJSSTAYUMI
HWRKDCSJJSV     : WLLKTHJKWDYNJCC WJQBUBHEIIDYIW  EAMTLML         YXSKKTVOLMM     POSGXHXGJF     
TYOOWEUJ        : WSQXT           PFSCNGIXGVU     BIRMESJWYPF    
XXSBWX          : YTWUCMJ         WXRDVYGIN       MWKKNW          VNKCXXFAFUOYXME
GOWOLQBQTWD     : SFVQVKDVAEXOJWB BYUUWM          OYLCX           KAERKCUS        XCCHHKMQLOMB    PKDMWSRMPDM     WPQCNN         
PYIJAWXWETJUTH  : LBJPVM          PNMDMFTWWC      DYVGQCHHL       HXYTIVDUJNXSI   PGQKERXXEBQF   
WEOVNDUCQLDJH   : STSIRPOMCL      CDQGJO          JBOOL           EUCHPTYVXT     
MMRLVCOUCNYX    : UVQISDPO        FMRHL           UKJCB           IXXF            OHEEJUUTTMEEWN  MRGWMK          NTLEHCA         OFIXUIOHATK    
MMRLVCOUCNYX    : NYRRAMYFEINPKA 
TTFKQLYOYCLBU   : ECRRLSW         XCCHHKMQLOMB    CTWVQVLRA      
HEJJRWCF        : OFHJEQPTRNE     KPQPOUOWCFWORL  WFFMOJRYRSRE    PSCTGEHMRRCOOQM UQILJA         
ETRI            : FTNGGEKDXDCSQNM EMUYRTNYCWEDJMR
THFNBMAUBYJADXE : JTBEJQWFBXOEG   VWDJCQFJS       SADLQYPC        JPGSR           XBQILDMB       
XNDJWWIYC       : EVPMHLVUNC      SBGHQLVRX       JBRNOGGDQWCR    MLSYWSB         SIEHDVIVYTXBUCL CKWMDLOQ        EWJUEC         
FYVOJPVQFYEG    : VKPYHJWBGHSFVGH WUWKMINWSY      SPITOYJCUPMSFT  GLAL           
FHGHLE          : UVCXOUBFERBDJE  FEWPCUMDW       PEFK            MRJETELKVQT     VKXEQDAPAM     
JEBONBNW        : QFHVCAQAPNJUWOC RXIODPUNBBD     PEDWWWDDGYTQRNA TCATP           QEXIAM         
QCGR            : LVPO            XVJLAIXGDWJEMID PNMODBJRSNEK    DXBVXHTRF      
WBRSR           : CMVMI           MGOKGDMPKKOXAD  WXRDVYGIN       VYBC            LVGGDUDABTCGYI 
RXIODPUNBBD     : MPNO            SEOREORAWRD     JEBONBNW        DXBVXHTRF       KPCLFMTHYSY    
HFEWGSVI        : LNKFXDINWHS     IDWKXB         
YQFBNG          : WUOKO           OIOBWX          YNQWGFPED       FTNGGEKDXDCSQNM XKWPGFT         XRCWK          
IATD            : ELMRO           WVJVMSIR       
CRETMR          : MGRQCYJYESOQME  AVIPVGUQJ       ENNVEHB         MJKK           
PVLWDRTLMQTARNF : ANXWGSJTXPPP    MFKKKD          PGCTAOP         WKNCNLTFWGSFST  ORXNXQTQMBIFYS  WVHK           
BNOMOIP         : QJRUIUTPPNINI   KDPYSSDLQGX     XCCHHKMQLOMB    WKNCNLTFWGSFST 
MHRJVMH         : OGXXCSLMEVS     TJQGH           UMWGXIYVL       RRKWO          
KUKNMGYCYUCQ    : LIJMHIJRRXDCQA  MKMPFSRISBMR    UKJCB           QWSIKQMDT       UHUUPVOS        GYFFDVYSLBTDXX  LXYYMYMLDL     
IMOXBBMMQAYAUI  : LQESRPN         WJXCBUJTSN      VAPRLNK        
HRNRMXHAGI      : WSQXT           PSPCBSEAJUTUY   CEWFVLHHKSHTPF 
GDGYQQL         : BBFPPWG         WADKMIEFVFQAFS  WJXCBUJTSN      RAILOF         
PNGECYFBBCMYL   : MDMTPLCB        CFLKHXCTAYLB    OFIV            WXMMTDMWRBHJPN 
ODTOMVU         : VIIQDJ          HSBQPBARH      
ADAGDQAQV       : QSADTIIYFC      REDSLMOKMYWP    CJMUITTUX      
GEVID           : QJLXRQ          XKJKDRMYLB     
MEFBFQHTV       : DCRF            HGUDKOW        
IIWGFWJGGOYIGV  : XGBFX           CDOEEPYE        INFFBDDLWKUEK  
MAXVGCK         : KANVNMLAMBAO    XDEMNP          DVGV            UYLB           
JLSDSO          : GMTXQPOP        QQCFIWMDUBBTL   INFFBDDLWKUEK   FHVWY          
UXKTGRRPXAFA    : CPDU           
NVKAXIXGMITWTM  : EOQUSXH         NYUBMY          LDIFLNMYT       KCWWN           HLCLC          
PDBKD           : XMYQHEPHIXUT    ISUG            LYMNDLAMCJMSTV  NBVJKWF        
GJGAAGAHG       : ICCPMCPTCCMI    PLDQ            YVWKWAUT        FAKKVTKD        BFPKNRPOJCYEWC  AXYWHQSF        ROVODWNAP      
UEWWFIVLU       : ODFXFNEHQKGTC   ATQIPBPCOBMC    LKHSU           VJPUQBJAMTBT    QXMYNTOAWDUH    XXJOHE         
FTDTVSXAFB      : XYLNNOUFNOPNR   PEIPYXDDUQHNJIL
LNVMNDMWLA      : GMBDJVGGQGULF   CCBWGBSFUWVUSCW XGSHPNYMJHUVLN  MMKTXQOTECRL    OQUGOSDQNNBRM   NOBK           
QYQVHOJF        : QAEFUYNE        VGTINLCIF       ALRWNKQGOOA     ATDFEFTYLQUVEN 
RYYLXRLAY       : AERQAXFOUNA     BUHVXHFTMBW     NUACGFUXBGUGS   XCIRD           UQOYTVIMI       EOCFDMHMKV     
PKDMWSRMPDM     : UKJCB           GOWOLQBQTWD    
VLATV           : YBHIIBQ         KPQPOUOWCFWORL  UVQXGEK         OQJXSJSLXSYHUL 
EBNX            : WNPCHSYQNACV    BXDEEOAWGDRJURI LNKFXDINWHS     NQSEVFQ         MCSN           
OLAIXCH         : CXXNVG          WFWVDYPP        FKUULKIUEJGLMLU XNLDCCJ         MKJILRI        
SRSFPNWEDCSOY   : LXYGOHWH        CTGACGPCBM      EYXKRYGGBPDU    VDGRHJLELUF     AGFHPW          KNSVPGRNVIHJI  
QUCIYDV         : GLFKYNUTYXAASQ  PUKHVCLM        YKQYIWGSOSISRWT RIFTWEGIH       LNIHAOP        
IMJKUJNCYGUT    : HCSDWTVSRKDF    BTCA            XFVPTRYTBPEE   
MHKSMOLDPRTL    : JQASQI          WHDBELYRSGEO    JLODCOHVNDEFHX  CYPRFE          ALCHGDR        
FKADKIQVTL      : ATDKQD         
HQINNCBC        : MLNXJMAECGN     MGOKGDMPKKOXAD  WFBKACLFH       BWROHYEYUVKAC   EMOJT           DBWVKM          HKYKFYNXBUTJ    GLAL           
NUACGFUXBGUGS   : YKVCIXBKSW      CQTHJFQGQVUUJ   RYYLXRLAY       XNPFQBWIXYOHJAA
KFED            : NDGNUVIDJERNV   XQYOYXTCFUQCPD  OHQQFMAB        NODGDQD         DEFEBGAKH      
XQKHHSWU        : SQARJVSVRUBX   
XWINR           : TUVEEERIBLG     XGCIYWSFRUQT    WLVJACOLG       NHMVMA          JYENNYPGSDFWDJ  KEUWQRFN       
SAPNYRTVXMR     : UKVQIHP         DFWVFUIM        MCOWRMU        
SWPVWHHHOAE     : USANU           LLBVJY         
XFJISCTLEJBF    : VYFYPA          FTJRATNNFKWAVUX
UCCKTOFSFDSM    : HQUISDIPMUR     UIIBYJO         LNYJMOVIRKHMLQ  EOCFDMHMKV     
ABNGNNLX        : JYDDAYOA        CADGCUCMIFJN    QEXIAM         
HCPUGAWMDTO     : CRLLQP          QKQNVVUUEFR     KVPD           
EKWLECPW        : WBXVEMCSLHCQOTA DVFKVKBAURNBLPV THCQKQ          WKXI            BYNQYRNARLQC   
CYPRFE          : AUBRTTXKYFJSOSR HIKEFRFRSJDXT   YNQWGFPED       UJJWGGGKUFP     MHKSMOLDPRTL    REKIOQDOOJR    
RCEBETVMVSY     : BAEYINRNWCTPOK  MGKWONC         PDAYJGCPE      
NPJTBGIHI       : TSBHQPJHULMULOX EALYJGFRVTOPG   MRDIEA          ABDVMVWIH      
EWCFPWMTC       : ROHDDJIYSK      JKSSAT          ODQORHMMJMJKS  
XIHEDEQBW       : XEWHXBXTJJYC   
FMIPJJVR        : WFWVDYPP        UKSCUDQOO       HXBAANJ         OJRXXTFDNWIF    THQANJBP       
FRWEVETSRNXXNG  : SJHPMJWAACKD    YUWTDBL         VPIDFLSH        RNXBQD         
RLMLPL          : EKOFKBXOTRPAAUJ KBCCAXKKY       HLTCWRICFKQI    KOMIAPOOCQS     WHANNTISLL     
UBMKKYJE        : LNSBUWWCEPXH    TANIKTQLRFMQRR 
QXRUTX          : UYYYRHCBECVE    CKHMVXIQCWOGFX  YUJNWSNIGCBR    KOXD           
PPFPQTVYNKLYCW  : CPBE            QVYXWWEPO       YQWWQNTKARQ    
YXSKKTVOLMM     : ACAMILJROYS     VSEX            HWRKDCSJJSV    
JJEBYVHOM       : GLFKYNUTYXAASQ  ABGVAPMF        IPPMOQJTRHF     ATDKQD          DEFEBGAKH      
MLSYWSB         : TCLIFNG         PURLBRYIUFTKPX  SLFGNMAGVWDEGSK KGHTNIQWUN      XNDJWWIYC       DKWGWWHSBCW    
XBUQNGMLWYXKGJV : MLNXJMAECGN     WCCEQJGYFTPVSME OSWAISM         VWSHQSHSEVTHDD 
LUJSL           : HOJMVJNGA       DCJYNG          JBBOLUUYQMXY    NKHWVDPGRO      BGMPKJNJDXAXFV 
XAISAHLDEMG     : HGRODECCVRHOUHB QYWYC           JVAQHSANCUTHQBJ VEWDIVGJNGH     LRWJPRXO       
FVIS            : HLTCWRICFKQI    PBTQIIQKGNFJVA  RYNMKA         
FTJRATNNFKWAVUX : AKXOIGKF        IBYJDPYHLHBHB   OAGFBGV         KEIDFDAMAUEVJ   XFJISCTLEJBF    HDECPS         
FQBNF           : CPBGRHTEFXRC   
TTNVYLERVMN     : BYUUWM          TCATP          
EQBUEGFDGEAGDG  : RIRSCEGHE       JUIMHPLDEJNU    UPWJHHLLN       SHQPGTGENA     
GTHMNBCMAQQ     : FOYBEYMSX       SFXPB          
OFIV            : SLWKCCKHQTPAO   PNGECYFBBCMYL   HGUDKOW        
YXHFEOKNULTARVG : EJJJGFM        
DTDEVPFMJCDQK   : TUVEEERIBLG     GBQOVO          DLGBEILRPJAXMRN GPKTSEV         NNULLBJ        
DMXMRC          : RGCNUMELNPMUWGH FKLQJN          YUPVDASCJMW     MFTJQE          YTFKCMSD       
DPWQMXKIGAMAF   : JHFMTXR         MGXXJNXXMBOBN  
YXXNHARXNR      : IHGRYSDTYIPDH   XGSHPNYMJHUVLN 
ARQTTUYMSPBSCJB : FAEWXTDY        ABDVMVWIH       YQCMGFK         NNTJWNPSKGQVQA  NBVJKWF        
XCIRD           : OSFS            USERD           BIRMESJWYPF     RYYLXRLAY       KYMOWKVWR      
RSPU            : REBFQJUHMFY     OGDEVEFKO       DQADER          WYSAW          
PKGTKXN         : OWTU            MBQUGHUJJRABJ   XHXIKDKGBBYQO   PORWNLLW        TQMJBQACERGGNP  FWIO            XLLCH          
SIEHDVIVYTXBUCL : INUIAJGEEVS     YIDK            IYTOATPKH       JUYHYIBLCIYRGAE XNDJWWIYC       PEWM           
HTGCJB          : MUCHPKMEMRUHSVL UUDJCIRIOTYSKDA PUVIPIVUAOKGK  
CLVVX           : USANU           XSQIPTDI        OYFNYRROQPOG    JBHIBEIY       
LFPULYXHJ       : STSIRPOMCL      BPIIB           CRHAUKPSHXY     QTFSNJMJ        CEAXYJGLN       HCJC            JBRNOGGDQWCR   
IDWKXB          : KXJGBSECFYBWNVQ DBJWWKSJDMCXC   CLUOODNPWXLCV   MBJEEAEXNH      VCULUGPTTHOFEQA HFEWGSVI       
MISVKEWCGLB     : WBATFAR         DFDOJEFU        SCVMDRTJOOEBTHY MVWQWHWKBQFKSYS
LXQQPLCOKKAHSF  : DWGCJUIEXQN     KHWVVEHHYBFEDY  DBIOVX         
FGFGSPYOCFOH    : OKTTPMC         VWSHQSHSEVTHDD  WCKXYG         
CIRNGIHX        : IYREJSC         BJDKRCDJY       UVCAEMJ         ANMHOLGK        NIAU           
JOHVOQRTWYA     : ARCC            MTGUIVNXSKBXOU  ONSHH           PEWM            YPWCXTGVVMF     XPSOKPHLJXTQNGH
HVTIMXO         : XEOXUTRFKKEMSIO POSIALRPIMOQEMP SVHXBGHT        UEQUMQHRSJFW    KKSOVDHYB      
FBHNSXVDFVAQ    : ECKORDVGAR      INSA            LRWJPRXO       
HPYXJVUKX       : KUJYO           NDGNUVIDJERNV   FXJYTBYXBOSLLPP
SVUBJTPOYQWPLU  : UYYYRHCBECVE    FFMNKJAL        YHOFCKWAAKVHF   DCUFRRFEIVOKQ   LOETBKGKTORHPFO
RCKR            : BBFPPWG         OTKLFHBDSKJ     UBWYDGNHDQFI   
UAKWATU         : TPIRDNUYCELH    XXJOHE         
HSWA            : KBNGSKKQNPSQSP  GRMMMECIEU      SGTDUFNOUVQ     WIWJP          
UDBO            : JMIXOEOPL       NWTDEYPQJNFQF   UDCCBVBAILBXLTJ PPKTGKXMFEV    
PNMODBJRSNEK    : JYJAHVXLO       EFGAJV          QCGR           
YMTVNQQLXMKACHD : QEUFPTSBPXNGYB  WNMIRLJYMXEMBXT VNSIRBADSUPWL   LFCERTMULYVV    JPGSR          
VYUMMKPPVJ      : IYKYWIKULE      BRIDKCSQOYWL    ISOEWANUSKXGV   WDNWUBBNWA      UCQIEDDWFNIV   
KNSVPGRNVIHJI   : OJMPQQNLJVD     VOFFKOFHONHID   SRSFPNWEDCSOY  
VKXEQDAPAM      : RYNSYSJUH       TSOBCHARETSLA   CDOEEPYE        FHGHLE          DSNNGSNXBHEY   
MFTJQE          : FMMTC           RFQK            BQKRRI          KEXKSKWS        DMXMRC         
HXRWGL          : RIKHVWVVBVDAG   DALSSFXPHGRRCWS JRRSUPKQSRDXP   KFQOGSVQQTEYERB
EUTPFPLQN       : GCMMWBOCUN      OXHU            LNLKLKJVNWF    
HSUYTJGGOARIFPR : YHXHTVYDPIUWCY  LEEXD           JLDGP           PSTQ            JPPALWBXEBFVF  
JQNVD           : UADGUTGJYRCRB   DSIORTO        
SXJXPWQGPAY     : JBWBOXJGKV      TQWKCSJDIAA     IMROTXA         QCTUVB         
CUTIELIXVPON    : TCDHTOXLOHTBUQ  MIEQGVAHYOMPOJ  XYLNNOUFNOPNR  
AEMVHG          : BDJOIKQQI      
HRPAPIGHJFRL    : LTSNKALBOUOLPD  RMAONTPC        JGPVLMQNEBSYXK  MHKNJU          GJGTHJBNI       HSWCVALHHLEJ    BNTLB          
NTHYEFUWVKTW    : QNUMAQFBDYXBDM  BPIIB           KKOWQVYVP       TPORVYAX        HYOG           
JUBRMIKCKCKQ    : UVQISDPO        ALJTS           VAPRLNK        
VWDJCQFJS       : TSOBCHARETSLA   JVJCWXK         AJCEJEKESF      RIEBSVCGXOE     KEYGO           UVFPVQJDW       BDEGMIH         THFNBMAUBYJADXE
VWDJCQFJS       : CYDAMMEFCJRU   
QPJNDDKTOFUHR   : ORQBXPWOHVYM    PORWNLLW        NBNOFQONAOPIY   GUWNDAMEUXHQD   CKWMDLOQ       
TVQXJIJHH       : UYYYRHCBECVE    DQQGUVXHMAYLRJT MUQSOJP        
RJFWUAJLQSYTY   : NYNLNHGXWNEI    IXRYYLBGQDCE    OTKLFHBDSKJ     PYQLNGY        
NNTJWNPSKGQVQA  : EYIORXXPAKFNH   MRNBBIM         BPESO           PSTQ            ARQTTUYMSPBSCJB ODFMCMKHRHBUVPQ
XOUHU           : RSCVROYEWNNY    KHAFRBHE        RSAOPIEBNASHV  
EUEQ            : WFWVDYPP        QKYBPWQOJHFEH   JHFMTXR         NKIVXHA         GEJHXKKOX       DEFEBGAKH      
APJYEXOXJML     : PUCIEULVLKXWCAG YIGVCJQKN       WBENPEWJM       HEJHTCRYCSXI    YRPEMFPBH       IFOOTF         
FXJYTBYXBOSLLPP : IJDYCWFSTSVTFJV ECRRLSW         VYDWVJATX       HPYXJVUKX       TBRREL         
UGYUYIVDIKBTYO  : WTODTYRMVECPC   LAQBYJOVKNJC    GHPSEGAVGOYCGIV QCTUVB          IWGAD          
FNFEHIFFJVBUJ   : BQHJEYQLXXCLG   OQMTHKWWHRSNNBT KPLKLKQBFIQALLI WCKXYG         
LSNRRKSCIVL     : EQKQVU          HOJMVJNGA      
YFSODAE         : HGFWPQHBWA      WMSV           
GLSOTCKWAUPLPGF : IJDYCWFSTSVTFJV IVMOYRLHFLR     TXYRVFBYWWK     CDOEEPYE        CLUOODNPWXLCV  
QYLAWWVWFQNIT   : RFNSEPEBU       PNGCAXRFBNGBXOO VYOXRLTAJ       NQUHMOJNMVVVYLS GDQSFUNUCAABSLK QKMYYBSNATUNY  
SADLQYPC        : RWUAANFE        THFNBMAUBYJADXE
PYODOULA        : DYNNRKEFSS      YSINDIH         ODSBBQEYW       OARMAYDEGUHNHK 
MLNJLLGQFVBYNT  : LJTJYTCJUBBSH   EEEBPWC         XADSXNWIXMYRB   MUQSOJP        
THSSWWRPV       : AJCEJEKESF      JEKWII          UOVEETUOUIW     UKAROGND       
SMBEMOQAFDLSL   : RUULF           XEWHXBXTJJYC    DTFNIJCROJUCU   QVYEO          
XIHWVBYPKRLI    : RYXFQBNUQGBE    WKNCNLTFWGSFST  BGKJKT         
DAMJUY          : NNSNVTBFCTEGVJB YUNPYJJJLFH     EMOJT           HYOG            FEQXJVDOYSQO   
ANBSNGXCAKIX    : KSHLVFPS        ROHDDJIYSK      VWMD           
QXQTWHFQ        : RASCEPAPTQBYP   JHFMTXR         RHACGRVMEJGEOD 
PFXPRJKSVMIW    : DVFKVKBAURNBLPV APIGOEKIHHUQ    KYFUQYYFXRV     PUVIPIVUAOKGK  
VGGAISJ         : LWTIPX          HHLUYYVFLQSOQLU UFKYIIWTWARFEBW KLEQV          
LAGDVFM         : ICWNXR          XIPFXYLLTX      TMTRRMUF        PBCQQMBUJGJHMIV VYOXRLTAJ       XEVVOIMPIGIHBX  RFQDXQROMG     
VHSDF           : CNJNPVEU        HSFGOUQ         QNJYUDWLOOHNFG  MSAFOG         
WOVPKK          : RVHPKGELQVEF    DCMVUIGXOO      YRBFYFBMX      
JUWREWAWIJLIR   : USANU           LPSHC           VXFFCVEATDUTCC  OAWSHPRDXJ      YRQTWCKIEY      PJHRRFIWSH      ABYKHO          JAYJRUCGTNB    
JUWREWAWIJLIR   : KLCM           
HXDIVMCA        : MMQAU           JXXCYOSNXVTB    GWUERNUDM       YQHBMEL        
MWKKNW          : XXSBWX          LNIHAOP        
NGQMYUMBSUMG    : UOUORJKML       HVTLK           TGHDRHFSSLKED  
FWNFCVBOABI     : SUIQ            WAMJMONT        OJIRJUVJ        AWUTQKL        
YSXOR           : PNMDMFTWWC      WMSRQLJRJUGIMYY QRKMVGQTA       QGXJTQDVNLEJNP  BVOFSHWVWKLETI 
EXNRYKEBFYNLH   : SLMGHRVSFNBH    YIHWGGUTRGNHQH  FUJO           
KUAMTEBTF       : EFKCMDMLQY      UVFPVQJDW      
JGGKWXGCYVVX    : PPYALSAVGVIUP   GLLPEHDQYPK     DHAYIN          IQSVT           WBJRXXVSUXYKN   LCKVM           QGFSDNYQFG     
CBODRDLON       : ICWNXR          YYUANHRNGBA     GXOYGO         
RBAV            : NJAALBFEKDFRY   HAISIOHMNSMQPN 
WDQG            : SSXRBHAJ        FTBCKSNRXVGKRSW XWQICXOVO       CXJNDAM         QWSIKQMDT       PHGQXOCBBGE    
YSJXCNYXJYHNB   : XKPISUJEUAJB    RUAHHAEHQBOPI   MLGE            PSWITVKDPI      GLAL           
RUCFJ           : GLGIQ           QXJTV           XHCKCBUPFKCYQJ 
NDSQYXNDQVP     : RGCNUMELNPMUWGH MGGVUMQRRN     
PYPTNOR         : URYYRGQN       
OCPRDJO         : MANCXBTSQSM     FVYJXM          RKKYDFR         ILFJPTCN        LWXQVOENG       WYPLIEAE       
OAWCESUDQIIJHAY : EJAIKIYCIYTIMC  FCALHUMGJM      NTKKKKSDOT      WKNCNLTFWGSFST 
APSP            : TQWKCSJDIAA     YIHWGGUTRGNHQH 
MQWQGOTRFBGGBLK : WJGVQMFPPXL     JDPKDYTT        OIKWCRGNY       HXYTIVDUJNXSI   GBSPURALAQHQKH 
GPMRBVB         : KGVEB           GUHBRYF         DOKMBRX         OEITXRUOTFQ    
UADMUUVJO       : UIAE           
BWKUPPWVXXJITQ  : QFTLU           NJOBBBF         SBESOTDH        KYHM            JIJHMPBBRWVT    BWKCBEDUOLPD   
GKECLFYNLO      : OPEMMUFAPEASQ   RMAONTPC        ABFIDYI         WGFEWGMDEGRWGX 
GMRW            : RUULF           REBFQJUHMFY     SSIVOOUWAQX     FRKFWDLDD       GMHKVEXCURPGE   WVHK           
UUPQKI          : INSMLTAHAVVPNVK OMHAPXJXXYENK   EYQFF          
IGPSRJJURTYTH   : SVLMBL          DVNHNPBKL      
UURL            : LVXUTQLCRNGTNHD XHKJUCLIIAD    
BXWXES          : BAEYINRNWCTPOK  IQSVT           OHRCNM          DKEY           
VLFG            : YTXNYL          XMXU           
ONSHH           : VJQETJQ         JOHVOQRTWYA     FEYRWFAYY      
SCVMDRTJOOEBTHY : FHAMKX          NTEOWIUNKRWOLIL MISVKEWCGLB    
FFNB            : DNEEGBYLGGCNC   FAQPVS          HKOKFPVQB       BGKJKT         
YGMCUCWEJB      : BLJGSXDYFSDLETC QAWIGSCSUJYE    TUNEMJCMCBXFVHN HDECPS         
NYLQ            : EVPMHLVUNC      ALRWNKQGOOA    
FDIVHLROMN      : FKUULKIUEJGLMLU WVBFAKRTCVJTO   BGMPKJNJDXAXFV  SBESOTDH       
UBWYDGNHDQFI    : BNSUJDVR        RCKR            EBRD           
IHOITHDBKL      : TEITY           FCIVJGBK       
RYRIMFFHJ       : VXFFCVEATDUTCC  MCUEFSIHLDUS    WMSRQLJRJUGIMYY
IMKVTQM         : YTXNYL          DONN            HYSB           
BNKIEUC         : LWTIPX          FCIVJGBK        JCODT          
XEWMEQLXAXGFHP  : RYYOWLUIBXSQOL  DGJPIEMOEHT    
PEWM            : WKSHJJYWMS      SIEHDVIVYTXBUCL JOHVOQRTWYA     VYOXRLTAJ       NJFTNW          MVWQWHWKBQFKSYS
PBCQQMBUJGJHMIV : JLODCOHVNDEFHX  LAGDVFM        
YKQYIWGSOSISRWT : FYYGECWHF       QUCIYDV         MACHNO         
YVAPKBNTHWDTFCM : IYHSSUBIV       UUDJCIRIOTYSKDA
MGIWDOPUJ       : EFGAJV         
NBVJKWF         : CLSJHKOXI       PDBKD           ARQTTUYMSPBSCJB
NRMBLVARSHTFPGL : GLLPEHDQYPK     DVJDOAL        
DRNTOYUCBSO     : BDJOIKQQI       YNOAWLE         FCIVJGBK        SUFXGDA        
QVYEO           : LANXBBWTQJVQP   HVTLK           ETOPFJOBAKA     ULPNVDOB        IRWUAWMRTI      UVNQ            SMBEMOQAFDLSL  
HCJJTC          : HDPNEYPHMR      EFKCMDMLQY      LLEPLAUDTQXON   USERD           RWMSI          
NKIVXHA         : MOJQSHPMRU      EUEQ            LQQAUG         
WVGVQ           : DECJKNJY        BRIDKCSQOYWL    CVBHTKQHNPVY    ULIMDKVBXE      RQOEVDL         CJMUITTUX      
YJANA           : JPUCFKCXKBWJJQI AFSQHUWGJPG     CFJIO           OSFS            SPITOYJCUPMSFT 
MGKAPNJBJOTAY   : YRQWK           CIDDBCTFSFN     TMTRRMUF        KHBQAKPXSNJU   
VYOXRLTAJ       : WJJBRLYXABC     QYLAWWVWFQNIT   LAGDVFM         PEWM            KFACNEHQ       
LJWNYYKL        : JMIXOEOPL       NJAALBFEKDFRY  
WLAMUEWLAYKFU   : BXWQAWLJRO      MGOKGDMPKKOXAD  FMRHL           NJOTGFUVMYECKH  HXBAANJ         CCBUCNPALLGOIE 
TTEHPGRDSDCGCD  : QVWILLT         SNJAAM          SSFWBNQUFX      REDSLMOKMYWP   
PNSBOFXSE       : IGPLVUXUHQV     UJJWGGGKUFP    
UDWBYJWUPFKW    : SUSAIJAVBP      GUHBRYF         FQLORKBLACQRK   LOFLKSQSWJGRHYV
PRERXGVTVJMY    : FTNGGEKDXDCSQNM PHTNNLOKNQKQ    NNYDJVWO        WLRVYYO         ADBNR          
RWUYHQCFTDQ     : TMOUSHSQV       KFXSXTVKVUQ     RYNMKA          RSATJMDDJIDPMDP XNPFQBWIXYOHJAA
AHVNG           : MQNYMHX         YYYPRY          EVATNEHCQ       JNHDQV         
DXBVXHTRF       : AVSOVRRP        YRBFYFBMX       QCGR            RXIODPUNBBD    
EGEYEBXNR       : UTRWPHOBVB      VJMMM           OHMEDGRKHC     
ULIMDKVBXE      : OPDDCAYRMEYTD   OLJIWOATBFFPJ   AFSQHUWGJPG     NPUROSJ         WVGVQ           PTBK           
CCAAA           : RASCEPAPTQBYP   JOPYLKIW        HPNTDUVIKIWEAL  HVYOICVS        AGFHPW          BOBD            JLKSXBBDUETVWY 
TURYYYFADHXS    : RWKWBVVWMXREI   TTGBV           MHKNJU          PTBK            LBVIAHQQC      
DONN            : IMKVTQM        
SXBTWFUBHVBJIU  : MBHJVYVQGEF     YFKFF           MFJPY          
ATGY            : FGMLLB          OTKLFHBDSKJ     LHHSFYOWFYVSKLQ
GEJHXKKOX       : NUQJQTLMPJTYIHF PVVPITAHIRDW    QCTUVB          STPASXGH        IQKKCVFWXX      IEESKJCGGWCUDHT EUEQ           
RSXS            : OYVIUEYIMF      WCKXYG          TQMJBQACERGGNP 
UAKVHGYS        : IHWWOEXSQHG     WADKMIEFVFQAFS  XBQILDMB       
VARSGQU         : VJMMM           ACAMILJROYS     QYVN            XMTAQIMDC      
XEVVOIMPIGIHBX  : CEGDUAQTXNW     VIEIOFFYLG      LAGDVFM        
BJDKRCDJY       : LKRRMHKRRC      VGVEXK          MIEQGVAHYOMPOJ  CIRNGIHX       
BRLTMBRSWPHGEW  : JOTJAS          HLCLC          
KIXLG           : XEBSTROTSK      VOBNHCGPLDXWM   GUWNDAMEUXHQD  
MRGWMK          : UIOQUYDPRYOP    KOXD            MMRLVCOUCNYX    BCWBRSSNAVKEPVN
VJGYDUU         : DECPKQ          KIJD            GPMEWKIIMBPW   
VPKUFUBKTSW     : NIGOIMISKTWHKMM FWOLP           VMEJCRFVJKMV    TQMJBQACERGGNP  YLFTWDIV       
SJLVXDCVRNY     : EWSDTBUKHPXQH   PHSV           
YHOFCKWAAKVHF   : XKIADCEFQMLKO   RSAOQMH         SVUBJTPOYQWPLU  LQQBMIKFNJ     
TBRREL          : ELOWIJUB        CIXGLKYYCXX     NLPNGSUUDKVAIYG YCAHANRUJJWLXAA LHHSFYOWFYVSKLQ FXJYTBYXBOSLLPP
RJBWOYPEXFFIU   : FSPVC           DQADER          LISS            NIXQKLDEWB     
MHKNJU          : VEWKPGSOUULVDQN GGGRDNDNEPYIN   HGFWPQHBWA      HRPAPIGHJFRL    TURYYYFADHXS   
QCINDDFJQKBALYO : KTNUETDRO       LRWJPRXO       
OULTBTQLJ       : VSYNWCWDBBAN    QPQDW           HQMOXBNJPITCVG  QQMINEUEGT      KYEWV           RRWLOFEGEEB    
VWHSI           : UQSNRWADLW      KUKXYOFYGVUODLL QOWGWPGG       
UQOYTVIMI       : QAFYXM          RYYLXRLAY      
NTLEHCA         : YRBFYFBMX       MMRLVCOUCNYX    MTJSSMCOS      
XDPPOBPNXAGGB   : SVCDDG          XEOXUTRFKKEMSIO BCWMJQBAOCOA    MUQSOJP         RIVSLAGKMBRWS   FUKEEQQOWE      WGFEWGMDEGRWGX  EMGBLYT        
ARFVPPJXCWT     : CKRJHQMKJP      LLFMLWSFPCCBGV  WNMIRLJYMXEMBXT LDLC           
DCRF            : TAUXRR          OYDALLLTTMOV    CRWXEPHQN       XHXIKDKGBBYQO   VLCJWRCVV       QVEA            MEFBFQHTV       ENNVEHB        
DCRF            : BRIKL          
QIPIARXNP       : YEEKLWEX        CRPGDEYGBFGUG   EAKSGQIENFCGT   OPDDCAYRMEYTD   MGXXJNXXMBOBN  
VYBC            : OLHRBLGBDHDE    MENFTUCCTVVFHVN KKOWQVYVP       MRJETELKVQT     WBRSR           YAPAH          
UHWK            : NDJLDUSOLURU    CEWFVLHHKSHTPF 
GICFDSJH        : QEHKFERGMBOPRDU PIFBUDSLMK      VOBNHCGPLDXWM   QKMYYBSNATUNY  
QFFAUNA         : IFKJHMHHXSYEBC  JQASQI          IDUAA           LHWYRIUIVPP    
MPFMNEOS        : KPQPOUOWCFWORL  YMBJGNJBLXIG    SRVKI           OAGFBGV         BNTLB          
JCCUCLF         : BVFQRAGPCPNJIX  CPDNQBWFXFJIDON ECLRDQXRLBR     XEKV            MGXEH          
QKACT           : XKBVRBTUA       QPPGGGFMXYS     YRPEMFPBH      
TYUVWIXLWN      : GMHKVEXCURPGE   HJKGVIFFQFW     HRXPBVXV        KFHLNNWBGHCT   
KDWBXEKBJHDU    : FQXXNDTI        KWMTSN          XDEMNP          SKXURGAJ        WYPLIEAE       
KLCM            : CRFYRJU         JUWREWAWIJLIR  
WCKXYG          : BBFPPWG         DYVGQCHHL       FGFGSPYOCFOH    FNFEHIFFJVBUJ   RSXS           
HEJHTCRYCSXI    : WJXCBUJTSN      WRPN            APJYEXOXJML    
YRPEMFPBH       : TDDBKNWFYJQVNC  CPDNQBWFXFJIDON IMASDEIHFLKJJ   VYDWVJATX       KUDMMRMYGUQT    APJYEXOXJML     QKACT          
RGGEFFMEPSNWM   : OHMEDGRKHC      OQMTHKWWHRSNNBT JLDGP           OKAGVOCFIVUMMN 
QNWLNFQOX       : CWJUXLIQLEAH    XNLDCCJ         NYUBMY          OJESMQC         LBJACFIXCRNIN   ECAHQLJDKVTJ   
TMNLPXPJEWNLCA  : XQYOYXTCFUQCPD  PYVYNIICTTUSMHM RXCJGQPQMQ     
RSGQHBHXX       : NNSNVTBFCTEGVJB PEPKESENDEX     QBSFW           GONJOAARKBCKXWG
LEMDEUWQLKHJAS  : KGVEB           EBGSUNEQP       FVYJXM         
WHECJWVFFNOHWM  : CYHEFHT         TDVSF          
QBLFEPCDJNNSWNL : IPEIDBIGJGCPP   KIDTKHBDNADIGD  KYYMUADMHAIC    DBJWWKSJDMCXC   XVPJGKUIOCRSXWY YCOSPMAXRWCTXX  NOSYHPTN        SBRQGHP        
NUTPFQLKVY      : GXOYGO          SNAFO          
FWOLP           : XUEAKNSVKMTXY   VPKUFUBKTSW     KEUWQRFN       
YWVRYBBN        : BPVLOUPSUQPLFFI VGTINLCIF       VFQQSUUWUGQ    
VMEJCRFVJKMV    : VPKUFUBKTSW    
LWXQVOENG       : ROEK            JQHTLV          OCPRDJO        
KEXKFB          : EYBMNJXVO       VSBQVUNINOQSEJC MRNBBIM         HDKVMBET        FQQQMX         
VWMD            : LCFGTHHML       AJLLRJYM        DBIOVX          ANBSNGXCAKIX   
PUNLHXBD        : UGOYVYFNGQNKPD  ISEHU           BCKADBD        
MCXFYOKOVQAC    : NTEOWIUNKRWOLIL CEHYYKSDC       EVOWFX          DEFEBGAKH      
MIPOGOBJUQFL    : BICGFETATKFJ   
OJIRJUVJ        : KNTAICOKDTRYE   JBQWODPKGSWB    TAYIR           SWUFQQE         OTKLFHBDSKJ     FWNFCVBOABI     QNCYMEBHAG     
WXMMTDMWRBHJPN  : GHXVCEJ         MHRYFVCAP       WAMJMONT        CFFRDKJH        ISOEWANUSKXGV   PNGECYFBBCMYL  
SXVMF           : BFEXRGYCOD      VGCSDTJ         SABQUJJACP      WLRVYYO         CYDAMMEFCJRU   
RTSANE          : VKPYHJWBGHSFVGH ABGVAPMF        DNUJ            XXDRDNWEJVUGU  
LNYJMOVIRKHMLQ  : LRMSQGIVE       UCCKTOFSFDSM   
DFWVFUIM        : XADSXNWIXMYRB   SGUJBGWFRW      RRMG            SAPNYRTVXMR    
CIWEVCDHPDSE    : CXIRDGKGEEWLTYD YAPAH          
ONNYWAM         : CGGADUE         NFHIOIELKPDCOMX QVPI            EKOKAMJ        
YRVXOB          : NHVRC           JWXUPMWA        RWMSI           BLWDTDFVM      
YPWCXTGVVMF     : GLLPEHDQYPK     HIMNURHT        MDPWLCULMMNLDVR LPLFBDOL        CCBUCNPALLGOIE  JOHVOQRTWYA    
PYQLNGY         : IDXXYYP         MRDIEA          RJFWUAJLQSYTY   UDTVBSDSXQ     
EAESBWOBNR      : JCOC            CLEMYDJFFRH     GMJBHBTXYQSOXRS RUIMWXRGLMETRN  TPJSXGRA        YFQFEIHCBITFSGG WKNDPKRFHI      AFLJQHLKTBHQNII
OHQQFMAB        : NTTWGHI         KFED            YCOSPMAXRWCTXX 
MGXEH           : JCCUCLF         TJIBW           MVWQWHWKBQFKSYS
RVXQNE          : HRGHRYHTHQO     TAOTCARUQBXUQ   IYTOATPKH       PCBXHRULKJAIC  
TWVSNWGFSXOLO   : FOOCLYFND       EMUYRTNYCWEDJMR
YQYIFHGL        : RKNSW           IBYJDPYHLHBHB   SUQHLSBXGJFMC  
WDNWUBBNWA      : LWPQKBIDXWAL    VYUMMKPPVJ      FJVUKLCLNDHBHU 
QNJYUDWLOOHNFG  : JFFSOAJI        BTPVAHUOP       VHSDF           EVATNEHCQ      
NOGBEEF         : XQYOYXTCFUQCPD  GFPYKEFEJPNAG  
DCUFRRFEIVOKQ   : UYYYRHCBECVE    KBCCAXKKY       TAUXRR          HNXTXBUHI       QEUFPTSBPXNGYB  GMHKVEXCURPGE   JAYJRUCGTNB     SVUBJTPOYQWPLU 
HDKVMBET        : UMEUQKRPAY      CSYFPDHRGDUGN   OYLCX           KEXKFB          ATDFEFTYLQUVEN 
RIGSOMA         : IOFVTUKFDJE     YWJFN          
PEDWWWDDGYTQRNA : WOLC            JJQA            AXJMWR          RGJERHKOQEBMTP  JEBONBNW       
BWKCBEDUOLPD    : BWKUPPWVXXJITQ  VOBYQOMB       
QLQWONTLSATR    : BPVLOUPSUQPLFFI JPUCFKCXKBWJJQI DWJC            IYREJSC         MMKNJLKTNNXSIMF
MMKNJLKTNNXSIMF : GCYO            FGMLLB          QLQWONTLSATR   
RFQDXQROMG      : XKIADCEFQMLKO   UDCCBVBAILBXLTJ GUHBRYF         IKRNYGKTLBXPE   VYFYPA          RYNMKA          NXQCNXXJFIFHX   JUIMHPLDEJNU   
RFQDXQROMG      : LAGDVFM         QAXBXWJ        
MACHNO          : PFSCNGIXGVU     YTINNF          ODQORHMMJMJKS   YKQYIWGSOSISRWT AHVNCOVWMDLBM  
DXDPS           : XAFA            LFKOGDXEPWDXLMW JUOWAEQTJQ      LRMSQGIVE       JAYJRUCGTNB    
DSNNGSNXBHEY    : PGCTAOP         EKHPNYMA        VKXEQDAPAM      OFIXUIOHATK    
VNKCXXFAFUOYXME : MYTDXF          XXSBWX         
HYSB            : NUTXAPPTVFH     BBPEN           GBQOVO          IMKVTQM        
GJGTHJBNI       : HRWLXAT         BIBWHDAML       CFITQAKWDTGYWA  NPCSYRMRLAYQD   RVJJOXXF        VUWVSJJWPQ      HRPAPIGHJFRL   
KYMOWKVWR       : OJLHOY          INSA            QIHWILJU        XVJLAIXGDWJEMID XCIRD          
LQQAUG          : CDQGJO          LRDSMWONK       ROVODWNAP       NKIVXHA        
VBJIJS          : IMROTXA         RMHSSQUIBBYJN  
ECAHQLJDKVTJ    : AERQAXFOUNA     SXQLWPJAGK      QNWLNFQOX       REKIOQDOOJR     JNHDQV          KVPD           
QGXJTQDVNLEJNP  : DUAOAU          YSXOR          
WKLDPNLI        : CFEO            RSCVROYEWNNY    WNMIRLJYMXEMBXT
WLLSHUBADYKW    : SBJMTSGJGLU     FCALHUMGJM      LDEXXYJW        FPEKVBWJVLHYT  
PVFBAOQ         : WKSHJJYWMS      SVLMBL          VEXS            SMAJHYKAWEN     EAYBTAQQIE      BRNFMSA        
IOFVTUKFDJE     : CDQGJO          LNLKLKJVNWF     RIGSOMA        
XWYSXBYYLXQ     : EJAIKIYCIYTIMC  KFXSXTVKVUQ     DFYRUHLS        IXRYYLBGQDCE    WOOCXCYHWIIBIWK POSGXHXGJF     
TVFWMXPVMURJSE  : HLTCWRICFKQI    XGBFX           BGKJKT          URYYRGQN        TGHDRHFSSLKED  
VQTPOSOJRRIS    : BQHJEYQLXXCLG   UVQEWKCQVLF     FJVUKLCLNDHBHU  YTFKCMSD       
HKJBGQXTPPRCLLL : NRTNJPRGN       MGOKGDMPKKOXAD  QKYBPWQOJHFEH   LJUELOBNXN      LENICEJ         JXUCUERTRUMYX   UAEVOG         
QDCHYR          : LTSNKALBOUOLPD  RNVAOOUXAO      BIGUFG         
TIHNBSHHARSDA   : SVLMBL          OXBRJFCNNFTSF  
EVATNEHCQ       : AHVNG           QNJYUDWLOOHNFG  TDSTLFJU        GXGEXPQKKSXT   
UVQEWKCQVLF     : XPXDVPHWFMIO    JGCA            VQTPOSOJRRIS   
EMIGGBK         : GIEQKOQHW       UYYYQSVYH       JLSENRBU       
LOFLKSQSWJGRHYV : MCVYXLBLWSPMAXF UCODMROLKGYHG   MMKTXQOTECRL    UDWBYJWUPFKW    NNYDJVWO       
MAWIMEJSSTAYUMI : TUNEMJCMCBXFVHN
BNWLINGIYNAGM   : TQWFVU          AOXQLRJDHJIO    DVJDOAL         XNAXWHSACO      JLKSXBBDUETVWY 
MYBM            : HDPNEYPHMR      YEEKLWEX        OHMEDGRKHC      DKEY           
NQUHMOJNMVVVYLS : OXHU            XMXU            RSATJMDDJIDPMDP QYLAWWVWFQNIT   FKJUKEDJMFLFG   HOFUVDWNNRXJJ   EUJIH          
UJTDKHFTVGGX    : KEQUKD          CLUOODNPWXLCV   FYYGECWHF       GGKRGGARS      
UJVOFFBV        : SEAQPNW         WLLKTHJKWDYNJCC
OIKNGJYCWVNQBX  : DIWNNVBFLJHB    BPEFACHLDOXDMT  PGQKERXXEBQF   
HRXPBVXV        : JQCA            ILQKYTIVTFKUNLW TYUVWIXLWN      NOBK           
WKNCNLTFWGSFST  : JBBOLUUYQMXY    UCOWHHF         GQFXWTCDOEKG    PVLWDRTLMQTARNF BNOMOIP         XIHWVBYPKRLI    OAWCESUDQIIJHAY YGSNHSG        
PSWITVKDPI      : BXDEEOAWGDRJURI OSWAISM         XYLNNOUFNOPNR   VRDGHJQHEHSGF   DPJWVG          YSJXCNYXJYHNB   XHKJUCLIIAD    
QFTPNQCDV       : QJLXRQ          IYREJSC        
ORXNXQTQMBIFYS  : VIIQDJ          GIEQKOQHW       JQMCOXITDCTWOG  LJUELOBNXN      LYMNDLAMCJMSTV  PVLWDRTLMQTARNF XFYVXSNYPPOTV  
WDFMOYGT        : OGXXCSLMEVS     YPCVRBQEHMYJH   HHLUYYVFLQSOQLU NUNQOE          IQRUUVH        
VJMXOKQFCOTDHNT : BYNQYRNARLQC    SEGHRMNEWSW    
QFCRXEQEKESJ    : KCOMMGPQDIO     FYHRC           FVYAO          
OFIXUIOHATK     : RGELWIJM        ETGOJARJLD      MMRLVCOUCNYX    DSNNGSNXBHEY   
NNYDJVWO        : BHLWUQUU        KDPYSSDLQGX     UJJWGGGKUFP     PRERXGVTVJMY    LOFLKSQSWJGRHYV FSVJSPLYIOMD   
OPDGTNMMYYDHJDE : JQCMHISNJTYRDDF ROSQ            OTKDLWHCN       BFPKNRPOJCYEWC  LQQBMIKFNJ     
RLRLXLCLKHXI    : EAMTLML         NCJAXFKDU       PDIBGPRLDHEK   
OIVELEABQMDRPM  : IXRYYLBGQDCE    CEIJGK          XHRWLQBEGOIGGAX
SSUMEPYDBDQN    : XKBVRBTUA       LCFGTHHML       KDPYSSDLQGX     ABYKHO         
QVPGELKS        : FCIVJGBK        QHNVIH          RGLRR          
LVIABCSNFNIAB   : QEHKFERGMBOPRDU DPKEPFJAEYNAA   QOQNMFEB        CXIRDGKGEEWLTYD
PCSQHJERDC      : INUIAJGEEVS     OBPCOTTPCNAWSFU
JHWVCOJXY       : JMKVMUGPKWN     OHJHGYVKYAJI    EFEI           
ABFPGUYHVOYAH   : HYSVQTJAU       LBJACFIXCRNIN   ODFMCMKHRHBUVPQ
HSWCVALHHLEJ    : STSIRPOMCL      LNSBUWWCEPXH    GHYTQLAEHOUGFOB LXAAT           HRPAPIGHJFRL    LAYTE          
NJAALBFEKDFRY   : XGCIYWSFRUQT    EPYOQCJ         HXBAANJ         RBAV            LJWNYYKL       
SCDJLXHNWHC     : LRDSMWONK       ETGOJARJLD      FJKDJVJIV       MRMA           
QNKCPYNPBATJGE  : YHXHTVYDPIUWCY  MITTCJJWSUBML   HQXAN           CCQBESNKH      
LXNHSP          : PLDQ            PKRPDGYLNDSVH   VJCSJ           ANMHOLGK       
DCMMRJ          : QQQWKC          WSED            CDCMJ           ESWPEHAGRT      AKIYAKWKMVXNPT  WSELYVMIJSSVYXA LFRJSYKOINVNTWW
TQMJBQACERGGNP  : KCOMMGPQDIO     JQCA            WLELD           UIOQUYDPRYOP    PKGTKXN         RSXS            VPKUFUBKTSW    
TCATP           : LKYEBC          ABYKHO          JEBONBNW        TTNVYLERVMN     PODJXUPMP      
NIXQKLDEWB      : RGQPCJISJUW     NWIBG           TFYPAT          RJBWOYPEXFFIU   LFCERTMULYVV    QEXIAM         
PPKTGKXMFEV     : NLFBHD          FWAIYIT         UDBO            OARMAYDEGUHNHK 
TKNXLHOW        : DCJYNG          GMHXLSTBPTUUG   MTJSSMCOS      
WXNJ            : LNUAICJI        BJSG           
SPITOYJCUPMSFT  : EHXON           QSFSGTBDQW      FYVOJPVQFYEG    YJANA          
BNTLB           : REBFQJUHMFY     XNDB            HRPAPIGHJFRL    MPFMNEOS       
YIHWGGUTRGNHQH  : EXNRYKEBFYNLH   APSP            RIBRL          
PTBK            : PKXWCSO         OSFS            JFFTBR          BIRMESJWYPF     ULIMDKVBXE      TURYYYFADHXS    HDBCBBPTHIUG   
PGQKERXXEBQF    : NASKYD          JBBOLUUYQMXY    DQNVU           YHMBVGTVJPETO   PYIJAWXWETJUTH  OIKNGJYCWVNQBX  RVHBV          
AERIB           : XPXDVPHWFMIO    NVMXYTNWBKLLS   DOKMBRX        
AHCKYLJQFM      : SVLMBL          LEEXD           XEKV            FEYRWFAYY      
REKIOQDOOJR     : VJMMM           CNAPLBFRXTIXBXY CYPRFE          ECAHQLJDKVTJ   
OEITXRUOTFQ     : DBQWBYFMJMBSTB  TYGJVH          ADQX            PWVLAUY         QRKMVGQTA       GPMRBVB         STQDTBPVSFCQAV 
GFPYKEFEJPNAG   : HDPNEYPHMR      VHJNC           NOGBEEF         WDQWSSVPCOSEFED
RXCJGQPQMQ      : BUHVXHFTMBW     KUXFBNIFN       GYWE            QCTUVB          RKILDEYHROGI    TMNLPXPJEWNLCA  QYNQLIMJGROXXXP THQANJBP       
KFHPYLXEEY      : TPJSXGRA        VCOVSVETGG     
KFVTULWEEQ      : JOLWIYJT        WMSRQLJRJUGIMYY
GCMYUFOLQYSXQTL : PHFLJQWL        TFYPAT          PHTNNLOKNQKQ    FJWEQJLXFY      BEQOSRGUXDSGR   FEQXJVDOYSQO   
XRPRDUN         : VEWDIVGJNGH    
SBXYFO          : ROHDDJIYSK      AJTFFASAB       NBNOFQONAOPIY  
NRROMWDAPEUPU   : BAFRIFOMCIM    
ENNVEHB         : JQCMHISNJTYRDDF CEHYYKSDC       ABYKHO          HDVQQ           CRETMR          DCRF            VHBXLAHSXDNWEFF
UDTVBSDSXQ      : RFFK            SYFELRJ         PYQLNGY        
RIBRL           : UTRWPHOBVB      WFFMOJRYRSRE    AATH            YIHWGGUTRGNHQH  DKMYPBEWX       FLVFBPLYNYPHXA 
HQXAN           : CWYEBNFABQF     EWSDTBUKHPXQH   LACEOUCX        QNKCPYNPBATJGE 
EEECI           : HNXTXBUHI       ADQX            TNQTWYSTRS      WXRDVYGIN       YCOSPMAXRWCTXX  LBVIAHQQC      
EJJJGFM         : JXEXQV          LENICEJ         DOKMBRX         MBGSIMAFC       YXHFEOKNULTARVG FWIO           
LFCERTMULYVV    : BPVLOUPSUQPLFFI FDRCRWSDORII    UFKYIIWTWARFEBW JRQVMJ          YMTVNQQLXMKACHD NIXQKLDEWB     
WVHK            : ECUSGUWHIFUTWL  ALJTS           PVLWDRTLMQTARNF GMRW           
LOETBKGKTORHPFO : EKHPNYMA        GQFXWTCDOEKG    SVUBJTPOYQWPLU  PONTLUIRBOJ    
KJOWECVD        : DLGBEILRPJAXMRN KKOWQVYVP       VOBNHCGPLDXWM  
PAXX            : KGVEB           TPJSXGRA        RNVAOOUXAO      VRDGHJQHEHSGF   QGFSDNYQFG     
ALCHGDR         : VPHWRYJTVOO     MHKSMOLDPRTL   
PODJXUPMP       : SOIITGUPWDYL    MGFLGSSLN       TCATP          
VEWDIVGJNGH     : FMRHL           SLJITCXDTOYETWT XAISAHLDEMG     XRPRDUN         BLWDTDFVM      
SKXURGAJ        : EXTXVOWEGIY     DCBXITVWWOAA    USNKACLFUUX     MRNBBIM         WTHCOWCBHPS     KDWBXEKBJHDU   
RACCXWR         : ATSVITFNPODQIBT ODDTFYT         ELMRO           RKLEDUCMRKCYAPC VJCSJ          
MTJSSMCOS       : JMKVMUGPKWN     PBVJOMKNSO      SNJAAM          NTLEHCA         TKNXLHOW       
DBUQUFQRYYSJXKJ : DBQWBYFMJMBSTB  GMHXLSTBPTUUG   FPEKVBWJVLHYT  
OKAGVOCFIVUMMN  : CPDNQBWFXFJIDON KPCEWUNGADF     RGGEFFMEPSNWM  
RRWLOFEGEEB     : UNKQROQHHCWMSEJ KQLPGPXPJA      OULTBTQLJ      
EOCFDMHMKV      : APDCKGNQXF      RFVAGOGHPO      HIKEFRFRSJDXT   RYYLXRLAY       UCCKTOFSFDSM   
RGMMSADU        : JYDDAYOA        CKRJHQMKJP      MLGKUBG        
UUDJCIRIOTYSKDA : IXMWHTF         UAGJGQWL        HTGCJB          YVAPKBNTHWDTFCM
RHACGRVMEJGEOD  : MLNXJMAECGN     PEPKESENDEX     JXEXQV          IOLUAYNDYEEWS   QXQTWHFQ       
JXCUAMOJBKK     : SUSAIJAVBP      WFFMOJRYRSRE    VPHWRYJTVOO    
UPWJHHLLN       : BLIROVJ         EQBUEGFDGEAGDG 
HAISIOHMNSMQPN  : HLTCWRICFKQI    LGRLPUGAF       RBAV           
FYJPJGL         : GSHGEGKPH       QYNQLIMJGROXXXP DVDSYRV        
FWIO            : JOTJAS          KXYOING         JLRILSVCJJJQJVQ MFJPY           SNJAAM          LXGLIOD         PKGTKXN         EJJJGFM        
VCMF            : YPCVRBQEHMYJH   OFQQDKMFEVTJBFU
WYPLIEAE        : INUIAJGEEVS     PNWUGM          DTOUQO          OCPRDJO         KDWBXEKBJHDU    MDHJVBRJN      
SVHXBGHT        : SGAFDYRTQPHDSLK IUYABAWA        UAEVOG          HVTIMXO        
PHSV            : PHFLJQWL        NGFTVKHRTRS     UYYYQSVYH       NIGOIMISKTWHKMM NXQCNXXJFIFHX   MRYJT           SJLVXDCVRNY     EMGBLYT        
DKMYPBEWX       : ECUSGUWHIFUTWL  RIBRL           MGXXJNXXMBOBN  
MKQRMWL         : PNWUGM          CRLLQP          PLIDN          
SSFWBNQUFX      : RGELWIJM        KYYMUADMHAIC    OFQQDKMFEVTJBFU TTEHPGRDSDCGCD 
BEQOSRGUXDSGR   : ANEGBHHL        CVMALAXPTEUW    CGGADUE         MVIV            GCMYUFOLQYSXQTL LVGGDUDABTCGYI 
WLRVYYO         : SBAOL           PRERXGVTVJMY    SXVMF           KEAEVMCNGIKQST 
FLUUEP          : FSPVC           YIGVCJQKN      
EFEI            : SLFGNMAGVWDEGSK SLAAAPEQQHWKCQK JHWVCOJXY       EVOWFX         
UEPBYQGTWACTMV  : DHJCVULQTAG     GMHKVEXCURPGE  
LVGGDUDABTCGYI  : IVMOYRLHFLR     WBRSR           BEQOSRGUXDSGR  
ADUPGVGMQDP     : SGJLFUDDOPGG    JESXWK         
YCOSPMAXRWCTXX  : QBLFEPCDJNNSWNL OHQQFMAB        EEECI          
GYHXYLURTRAJ    : RFQK            VYDWVJATX       NPCTWBP         SNAFO          
GYFFDVYSLBTDXX  : KUKNMGYCYUCQ   
XVWFUEFWRAOOTO  : XFMHIIRRKV      VSYNWCWDBBAN    FTNGGEKDXDCSQNM OQUTHLTVQNUV    BLWDTDFVM      
GUWNDAMEUXHQD   : QPJNDDKTOFUHR   KIXLG          
ODFMCMKHRHBUVPQ : WOSROURXGKQHOL  KBNGSKKQNPSQSP  OBJJRTIEQDTTIBT KBQCRVTBXQNN    LIJMHIJRRXDCQA  IQRUUVH         NNTJWNPSKGQVQA  ABFPGUYHVOYAH  
NXIMN           : UQSNRWADLW      YUNPYJJJLFH    
OARMAYDEGUHNHK  : NUTXAPPTVFH     HOJMVJNGA       PYODOULA        PPKTGKXMFEV    
RTSBWPYPHMFHWS  : QGHFAHE         JYSOLCVXVTS     PSTQ            FKJUKEDJMFLFG   YTFKCMSD       
KJXEVXFCC       : HSTMLWONCWA    
WMBGYEBUACTPCJ  : RROGN           OKHPGELSKVGV    SKNSV          
QPGNKEA         : IYKYWIKULE      EYCTV           TTGBV           QPHEOEHAXGXT   
CGQCL           : HXVYRMBMHGMASD  SOFUGXRSLKXFVV  SRGPVLBXJNBJY   OGHR            CRJDUWPELMXX   
FYTTC           : RGELWIJM        ETNRXIXEFIR    
UHDPHGLYKVYD    : RFQK            ODFXFNEHQKGTC   VIEIOFFYLG      JBHIBEIY        DPJWVG         
FSVJSPLYIOMD    : NDJLDUSOLURU    YUBAJ           IKRNYGKTLBXPE   KRJXJ           NNYDJVWO       
NYRRAMYFEINPKA  : FCALHUMGJM      NGLGFJKWSBLFKTL BWROHYEYUVKAC   XGVFMIPMVKGWACT MMRLVCOUCNYX   
JDYOVWYQNMPXD   : RYNSYSJUH       MTSCRYEJCHEMRA  VLVOCSROFWWAVMX KIJD            KUKXYOFYGVUODLL KUJKNIAGTASD    WDSCQQURUABTOR  QIHWILJU       
JDYOVWYQNMPXD   : TDVSF          
EBRD            : JYDDAYOA        KHBQAKPXSNJU    UBWYDGNHDQFI    DBWFRVAHSHWHRDU
KFHLNNWBGHCT    : SVCDDG          SNQTUVHQ        MCLFAMECPTVC    TYUVWIXLWN     
FVHCSISIVL      : XNGMJUSQFJVOYMY QVPI           
BRNFMSA         : QQLUHUYJEA      HQMMGWO         CXIRDGKGEEWLTYD PVFBAOQ         LQQBMIKFNJ      PXBEYODHRCX    
BKMO            : TDDBKNWFYJQVNC  VNWCEVT         NFHIOIELKPDCOMX LEVAYMNKS       RUIMWXRGLMETRN  KUKXYOFYGVUODLL ISUG           
JPGSR           : UFASOBHQXQR     PPCSLY          QQMSJCVIGAK     THFNBMAUBYJADXE YMTVNQQLXMKACHD
LAYTE           : DYNNRKEFSS      HSWCVALHHLEJ   
CYDAMMEFCJRU    : SGYARDYIQXGVLOT NRTNJPRGN       KHWVVEHHYBFEDY  UBUEICJ         FUTTQUPGOWPL    VWDJCQFJS       SXVMF          
QVTDKUP         : KCEVRFOUV       RNMKWWWO        JLDGP           SHAXFAX        
DKWGWWHSBCW     : UYYYRHCBECVE    HRGHRYHTHQO     IYTOATPKH       MLSYWSB        
FXPTEU          : OFHJEQPTRNE     DARUFTEGXAUQOCC HJAYYDSCNC      NOBK           
NOSYHPTN        : CRHAUKPSHXY     MPMTYWKKEVUV    QBLFEPCDJNNSWNL
QFHTPF          : WJXCBUJTSN      RIGC           
OEMHI           : UDRWCYATMGU     YTXNYL          HDVQQ          
FLVFBPLYNYPHXA  : NUQJQTLMPJTYIHF BBPEN           OFQQDKMFEVTJBFU RIBRL          
TNDMULJKSMCWY   : ATSVITFNPODQIBT EFKCMDMLQY      ISEHU           PXLYAWWWAT      AWUTQKL        
FQQQMX          : TSBHQPJHULMULOX LTSNKALBOUOLPD  KEXKFB         
FJVUKLCLNDHBHU  : MJXAUNAG        PSTQ            WDNWUBBNWA      VQTPOSOJRRIS   
UELNSNKTYSKSLAS : COSIVQQN        TQWKCSJDIAA     LHJFJKQAICPSE   KYEWV           MRYJT          
HDECPS          : QFJMW           SUFXGDA         FTJRATNNFKWAVUX YGMCUCWEJB     
BGKJKT          : XIHWVBYPKRLI    FFNB            TVFWMXPVMURJSE 
IOKVEFJRYLK     : UQSNRWADLW      OIJR            QPPGGGFMXYS     WFST            JXEXQV         
EVOWFX          : QFTLU           YRBFYFBMX       KNDQ            SLAAAPEQQHWKCQK JJFLIOVTBC      MCXFYOKOVQAC    EFEI           
LASEJVNWHXSPII  : NWKIF           CLTGPDOCQ      
FMHOGJCQ        : UVQXGEK         JRRSUPKQSRDXP  
GPMEWKIIMBPW    : PQQV            QKQNVVUUEFR     UWEN            VJGYDUU         QYITFL         
DVJDOAL         : NBHKOMU         NRMBLVARSHTFPGL BNWLINGIYNAGM  
CQMKIUTKMRTC    : QBLQJPGW        LYYAYGRNDK     
XBQILDMB        : BLIROVJ         GPKTSEV         THFNBMAUBYJADXE UAKVHGYS       
MGXXJNXXMBOBN   : SOFUGXRSLKXFVV  HVTLK           YTNTJYT         DPWQMXKIGAMAF   QIPIARXNP       DKMYPBEWX      
WHMLB           : DUTFLJBJMBXVAX  AJNLNVIW        POBCWEUPJPF    
PHGQXOCBBGE     : JLDGP           WDQG            REDSLMOKMYWP   
MCOWRMU         : OCQFNANCHSTF    SAPNYRTVXMR    
PLIDN           : FOACEJBOXFRUYK  NQSEVFQ         DTYLLSJMVYFWQWY QPHEOEHAXGXT    MKQRMWL         AILA           
MCSN            : LKRRMHKRRC      VOYWIPVXUVXG    EBNX            QLCMQTEVBRJPE  
IUQYSHEWL       : MKJPBTSSQ       KKOWQVYVP      
DBWFRVAHSHWHRDU : DNUJ            AKXOIGKF        EBRD           
PYSGJCBADWJH    : WAMPNTRGJOHJQWM SVLMBL          MPMTYWKKEVUV    KUKXYOFYGVUODLL SWUFQQE         TDSTLFJU       
URYYRGQN        : ANXWGSJTXPPP    WAMJMONT        OTKLFHBDSKJ     PYPTNOR         TVFWMXPVMURJSE  SFXPB           MGGVUMQRRN     
XHPXQIBNIQMD    : MBQUGHUJJRABJ   GRMMMECIEU      DNUJ            MUQSOJP        
VHBXLAHSXDNWEFF : SGWQMRYDFE      OAWSHPRDXJ      ENNVEHB        
UOVEETUOUIW     : BCAFHRMYKKX     THSSWWRPV      
WDNSKQS         : HADSJKFBCFUU    EYXKRYGGBPDU    BWAA            RXJWXAWJIRV     SNAFO           WPQCNN         
SBRQGHP         : MPNO            JVJCWXK         NPCTWBP         QBLFEPCDJNNSWNL TGHDRHFSSLKED  
OUHJJDQ         : WUOKO           CVBTVFUXBIFV    CEGDUAQTXNW     XUPTTMWQT      
YLFTWDIV        : CVBTVFUXBIFV    WBXVEMCSLHCQOTA KUTRBCMB        VHHFCRBPR       CKGAWIE         YXAMIQGQW       VPKUFUBKTSW     TANIKTQLRFMQRR 
XPSOKPHLJXTQNGH : UOUORJKML       IDUAA           LDLVLNYQNUBVLPH JOHVOQRTWYA    
OQUTHLTVQNUV    : XVWFUEFWRAOOTO  HGUDKOW        
QEXIAM          : CRPGDEYGBFGUG   WFST            HSFGOUQ         JEBONBNW        ABNGNNLX        NIXQKLDEWB     
RVHBV           : XEDUGDNCMAQBAY  LWTIPX          PGQKERXXEBQF   
TJIBW           : QEUFPTSBPXNGYB  MEARPGUCDUMXERL MGXEH          
TRTEFNAXDWUE    : FULTL           UQVGIDIX        PNNSRXJPVMVDSVN
BCWBRSSNAVKEPVN : LTCTWICRQYXQJ   DQQGUVXHMAYLRJT MRGWMK         
SMPMGTRVVQASNGI : PIFBUDSLMK     
IHSAALODIB      : DPWCMKRNTDXHI   WVBFAKRTCVJTO   OCHB            KKOWQVYVP       LXGLIOD         UEQUMQHRSJFW   
AWUTQKL         : BAKFOKYYL       TVOOTOOEAOV     BFEXRGYCOD      FWNFCVBOABI     TNDMULJKSMCWY  
SFXPB           : EYBMNJXVO       GTHMNBCMAQQ     URYYRGQN        RDTTQ          
PVEVE           : IHCPHVSPDBJEMCY
GONJOAARKBCKXWG : RSGQHBHXX      
JRWDYWSCNKX     : OKTTPMC         PJJMPLJMT       PNGCAXRFBNGBXOO
IFOOTF          : XEDUGDNCMAQBAY  DIUXMVICBDHFDUM OAWSHPRDXJ      APJYEXOXJML    
KHAFRBHE        : FTNGGEKDXDCSQNM XOUHU          
GLSQFRVFOOJEBK  : QYWYC           PXXV            ULBAVSEF       
JPPALWBXEBFVF   : WJGVQMFPPXL     BGVWPFH         JVAQHSANCUTHQBJ HSUYTJGGOARIFPR
AHVNCOVWMDLBM   : NNSNVTBFCTEGVJB NCBBDDXUQYJH    YFOAYW          SSTWXDWLIRMJNX  MACHNO         
CYSNOKNCHQD     : VHKVPMXDT       TQWFVU          UHDCNOS         MOSGFVDMSBRO   
UIJAXMJVCN      : VEWKPGSOUULVDQN ROHDDJIYSK      EUCHPTYVXT     
XKYDYCSTGRMTJ   : SSXRBHAJ        IXQUCGNMCFDPXB 
JNHDQV          : PPCSLY          XMERYVGCUWFHODK AHVNG           ECAHQLJDKVTJ    WDQWSSVPCOSEFED
CHAA            : PJVGXIE         XWUXKGYGKASDBQT NJFTNW          POBCWEUPJPF     BMOWP          
LXYYMYMLDL      : XGCIYWSFRUQT    PRGWHMN         PTKBMLMFVD      KUKNMGYCYUCQ   
XFVPTRYTBPEE    : OAUGCFQWQ       YTXNYL          HTUA            IMJKUJNCYGUT   
CEIJGK          : JCOC            IJTYEHMCPF      OIVELEABQMDRPM 
RIFTWEGIH       : GQFXWTCDOEKG    IRWUAWMRTI      QUCIYDV        
XFYVXSNYPPOTV   : ORXNXQTQMBIFYS 
XDGHJTNC        : UADGUTGJYRCRB   KOMIAPOOCQS     HSTMLWONCWA     BPESO          
UVCAEMJ         : YJRUTRQA        GWXRYLMAHQRLE   HTUA            GIWKJOXIE       CIRNGIHX       
LRWJPRXO        : LJTJYTCJUBBSH   FYHRC           YUNXRAJBG       NJOTGFUVMYECKH  XAISAHLDEMG     FBHNSXVDFVAQ    QCINDDFJQKBALYO
PGDN            : WSED            UNSIAKTTDTLYGEQ XIPFXYLLTX      HIKFE           YNOAWLE         DJHXR           POSGXHXGJF     
BQML            : POGCNJMENTM     JVJCWXK         UVYSYCN         WSELYVMIJSSVYXA LISS           
GBFNWD          : RSAOQMH         MMPBNIYUQVGCP   RXACAHNTPNWSOKY VEWKPGSOUULVDQN
WJCGHPXEAPVAHG  : QCII            SUKOTGTKRKE     PXQWOF          GOBLCIWUFITJER  SNAFO          
NJFTNW          : ACAMILJROYS     OHJHGYVKYAJI    PEWM            CHAA           
YAPAH           : MKMPFSRISBMR    VYBC            CIWEVCDHPDSE    JGPKPQOYP      
WMSV            : JUIMHPLDEJNU    YFSODAE         FXGFTDSTJSHWWQ 
WFDP            : GBQOVO          MBHJVYVQGEF     SUQHLSBXGJFMC  
JPVHRDNJSAO     : NJOBBBF         OTKLFHBDSKJ    
PNSOP           : YSLQCG          AJLLRJYM        ISEHU          
QYNQLIMJGROXXXP : JYDDAYOA        JGPVLMQNEBSYXK  KNAEFUIHCITE    RXCJGQPQMQ      FYJPJGL         HRTIX          
IHYVQRXH        : OCNFKI          WCMW           
NXYENKVPAMDJ    : MGKWONC         SBJMTSGJGLU     BKAXNMK        
NRTEPRDFLNOKJ   : UTRWPHOBVB      BUHVXHFTMBW     YTXNYL         
EKOKAMJ         : NTTWGHI         OTKDLWHCN       PKQAYDAFSG      KUKXYOFYGVUODLL ONNYWAM        
DVDSYRV         : ADQX            VVPERDOIAJX     FYJPJGL        
QLCMQTEVBRJPE   : LPMKQN          PYVYNIICTTUSMHM MCSN           
WIHNSIDFPGDS    : YKVCIXBKSW      CLTGPDOCQ      
CKWMDLOQ        : NXQCNXXJFIFHX   LSSXWRBNWIMPKB  XNDJWWIYC       QPJNDDKTOFUHR  
KWAL            : MJRPOFFNVUVV    VEXS            NLPNGSUUDKVAIYG YHRXWALFWSAOO   PIFBUDSLMK      TNQTWYSTRS      IUYABAWA       
LBVIAHQQC       : MLGKUBG         LDWFPCTT        MOSGFVDMSBRO    TURYYYFADHXS    EEECI          
THQANJBP        : JJQA            XEAEAEXDAFGVX   UMIMDTDLQ       UNSIAKTTDTLYGEQ FMIPJJVR        RXCJGQPQMQ     
ADBNR           : JAXWDSONDVJBTH  XKPISUJEUAJB    LVXUTQLCRNGTNHD RFNSEPEBU       PRERXGVTVJMY   
RDTTQ           : MEARPGUCDUMXERL MRMA            SFXPB          
FUJO            : JKXLEWMOEECKWYW HNIQIJ          OTKLFHBDSKJ     EXNRYKEBFYNLH   GGKRGGARS      
QHNVIH          : FADBTEVYKMY     TSOBCHARETSLA   VDGRHJLELUF     QVPGELKS       
YJSKKJGNMJDGEXL : FFMNKJAL        HGFWPQHBWA      UCQIEDDWFNIV   
RDLAAUQWOXL     : SPVSIORQR      
GSPFDL          : UGOYVYFNGQNKPD  BWHHBJSTUA      FBPSKN         
PUAFJJJRPHE     : BGVWPFH         GIEQKOQHW       ECGLKXENUWMCGYP USERD           TTGBV          
BJBBJ           : OIJR            ABGVAPMF        DYVGQCHHL       MFJPY          
RGLRR           : EEEBPWC         LEGSHPNQ        QVPGELKS       
XNPFQBWIXYOHJAA : YUJNWSNIGCBR    KMIWXXSIFCFQTK  NUACGFUXBGUGS   RWUYHQCFTDQ    
JGPKPQOYP       : LBJPVM          UFASOBHQXQR     WUCPHDPWXRANY   NQCNLNPVCI      UDGSSTRBCLOI    CFFRDKJH        TKTARQ          MPSJMHXGQXJSXY 
JGPKPQOYP       : MHRPMTQHXFYA    YAPAH           AGCBEGMICRVLHR 
HDBCBBPTHIUG    : ARCC            PNMDMFTWWC      PTBK           
TGHDRHFSSLKED   : PCSXQPYRRQ      GLGIQ           KUDMMRMYGUQT    IRQJABONDG      NGQMYUMBSUMG    TVFWMXPVMURJSE  SBRQGHP         TANIKTQLRFMQRR 
UCTDMXGOBIEU    : RASCEPAPTQBYP   BFEXRGYCOD      VMTSSKCFA       FKJUKEDJMFLFG  
MSAFOG          : XWUXKGYGKASDBQT VHSDF          
RAWATQLEWPIRT   : IDBW            APDCKGNQXF      GSHGEGKPH      
WGFEWGMDEGRWGX  : GRBYHGOYHCOSBRV OSFSJWDGGON     CQNVVDAOIW      DDCLMBRDQQ      IXXF            CLTGPDOCQ       GKECLFYNLO      XDPPOBPNXAGGB  
PNFPKFL         : ROHDDJIYSK      MFJPY          
TSXJBRF         : XPXDVPHWFMIO    IKVMERXUA      
PONTLUIRBOJ     : JVYRTN          MLGE            LOETBKGKTORHPFO
UHLKUSDIBOJUH   : POGCNJMENTM     BIBWHDAML       VYDWVJATX       FLEGUBWOWT     
GLAL            : FADBTEVYKMY     YLPXMTKGLFDNDWA PDREACKYF       VFUBVKW         QQCFIWMDUBBTL   FYVOJPVQFYEG    HQINNCBC        YSJXCNYXJYHNB  
RAILOF          : JPSI            GDGYQQL        
GGKRGGARS       : EKOFKBXOTRPAAUJ UJTDKHFTVGGX    FUJO           
MVFNNR          : OCNFKI         
UCQIEDDWFNIV    : RYNSYSJUH       OIOBWX          JYJAHVXLO       LISKWPSQIUF     OJRXXTFDNWIF    VYUMMKPPVJ      YJSKKJGNMJDGEXL
FEYRWFAYY       : TAUXRR          IMEDDMMLKASH    WXRDVYGIN       QRKMVGQTA       ONSHH           AHCKYLJQFM     
XLRGAH          : ARCC            WJDSFI          XNTUBUKHNUTGKK  BAKFOKYYL       LHHSFYOWFYVSKLQ
KFACNEHQ        : CIOCJOEMPESQY   JUGXPAUUAIVJOB  SDLM            THCQKQ          SGAFDYRTQPHDSLK AJTFFASAB       VYOXRLTAJ      
MGOLYV          : KANVNMLAMBAO    NASKYD          IVWOEUMTOGJNYDT CQTHJFQGQVUUJ  
ANMHOLGK        : DGJPIEMOEHT     UCODMROLKGYHG   VCOVSVETGG      GGGRDNDNEPYIN   CIRNGIHX        LXNHSP         
UEQUMQHRSJFW    : WLGTWBBOWWWN    XIHXA           HVTIMXO         IHSAALODIB     
YDGFRTHNJHBWPRK : YVWKWAUT        UYLB           
CWQJPNVIXPBHWBB : NRTNJPRGN       AUOFPUA         ODQORHMMJMJKS  
EJEVDLJOUKN     : CIXGLKYYCXX     FVIJ            YBANPOMKCGUES   EWJUEC         
FYJJXCS         : TJQGH          
QQWQG           : DPWCMKRNTDXHI   BRUWWUN         IRQJABONDG      ATDKQD         
AGCBEGMICRVLHR  : OGHR            JGPKPQOYP      
UEDTN           : HDPNEYPHMR     
UQILJA          : HEJJRWCF       
AILA            : RSUCLPKC        QPHEOEHAXGXT    KNAEFUIHCITE    PLIDN          
NEVTSGVLFJ      : ANXWGSJTXPPP    DCBXITVWWOAA    JRXCTOTUPME    
WKNDPKRFHI      : GWUERNUDM       ESQKQ           DXIV            PHTNNLOKNQKQ    CWVBYWHYYWOJWG  EAESBWOBNR     
STQDTBPVSFCQAV  : GHYTQLAEHOUGFOB FOACEJBOXFRUYK  JLODCOHVNDEFHX  OEITXRUOTFQ    
XHCKCBUPFKCYQJ  : MCVYXLBLWSPMAXF BAEYINRNWCTPOK  VJCSJ           RUCFJ          
HEDAIWBAUVFXMHT : GCEQSUC         NHFUKCJURCMOM  
GDQSFUNUCAABSLK : RSAOQMH         QYLAWWVWFQNIT  
QNCYMEBHAG      : VNWCEVT         NPCSYRMRLAYQD   QQMINEUEGT      OJIRJUVJ       
POBCWEUPJPF     : UFASOBHQXQR     AGSLUYKNSYPCK   WHMLB           CHAA            TSXVKGUEXAHJE  
RHJUDUFFLUI     : RUULF           KCLNTLQUQD      JXXCYOSNXVTB    DIHTASORJIP    
HMNROWBENDIKJG  : QPXVABDR        IYGXPQLIPH     
VVJFQSOLVLTC    : RBRBFRKNOJEUJY  PDWTOHNCPQSR   
QKMYYBSNATUNY   : QYLAWWVWFQNIT   GICFDSJH       
XLLCH           : FAQPVS          IVFBFYOVSJRCDH  PKGTKXN        
NODGDQD         : TFLSAHF         YMQEWT          KFED           
KFOCRCD         : VGVEXK          YFOAYW          LYYAYGRNDK      LWPQKBIDXWAL   
FXGFTDSTJSHWWQ  : KBQCRVTBXQNN    WMSV           
KFMSIEVYODQSW   : UIAE            QPPGGGFMXYS     UDWOEIHFYKI    
XNAXWHSACO      : RWUAANFE        LKRRMHKRRC      AXBUFBDXJCYUP   BNWLINGIYNAGM   YGSNHSG        
WVJVMSIR        : HJQL            BMSPUWAVTJBV    JRQVMJ          PYVYNIICTTUSMHM LCUUGFNBFOSAXE  TDGD            IATD           
BCKADBD         : VJTHHFWUNB      PUNLHXBD       
WDQWSSVPCOSEFED : IMASDEIHFLKJJ   GFPYKEFEJPNAG   JNHDQV         
PYPJJJRLNE      : SDLM            AVSOVRRP        RKNSW           SIGMESI         BICGFETATKFJ   
SHQPGTGENA      : KIDTKHBDNADIGD  XGQILGQFVKAJUPD GLSCWU          JBBOLUUYQMXY    QYTCFDYTNHQLNU  QIJIOEDPXKQKQEW UQRIHBG         CXJNBXQKJ      
SHQPGTGENA      : EQBUEGFDGEAGDG 
FEQXJVDOYSQO    : RUAHHAEHQBOPI   IGPLVUXUHQV     DAMJUY          GCMYUFOLQYSXQTL
AAXLNCYIKQ      : UAWU            LYBMXTWOYGXOD   GXBOUWRAYDTSHS 
QMHW            : KOMIAPOOCQS     FAQPVS         
HWILPIWNLOMHHDN : CLSJHKOXI       SOIITGUPWDYL    PCBXHRULKJAIC  
DMVSQUCDNCUB    : PRDAIWSBETDRB   DPKEPFJAEYNAA   PHTNNLOKNQKQ   
TDSTLFJU        : YNNIHBMI        VWSHQSHSEVTHDD  EVATNEHCQ       PYSGJCBADWJH   
XIUMRCQI        : LVXUTQLCRNGTNHD WHANNTISLL     
VUIPL           : KFXSXTVKVUQ     UGVYS          
TPRVMUGIX       : OWTU            LLEPLAUDTQXON   KUJKNIAGTASD    HDBRSL         
CKGOHNMPIYK     : WTQHN           EOQUSXH         WUCPHDPWXRANY   KEXKSKWS       
RSAOPIEBNASHV   : AGSLUYKNSYPCK   PENXWXRPEPVJKY  XOUHU          
CCQBESNKH       : PVVPITAHIRDW    GTKJAPOISVHSC   QNKCPYNPBATJGE 
XVMJXWWPPWG     : FQMIRLFPN       PKRPDGYLNDSVH  
FKJUKEDJMFLFG   : NCJAXFKDU       IVFBFYOVSJRCDH  OOJDPQXB        YHMBVGTVJPETO   NQUHMOJNMVVVYLS RTSBWPYPHMFHWS  UCTDMXGOBIEU   
ATDKQD          : JQCMHISNJTYRDDF OJMPQQNLJVD     BCWMJQBAOCOA    IRWUAWMRTI      FKADKIQVTL      JJEBYVHOM       QQWQG          
EMGBLYT         : WTODTYRMVECPC   YJRUTRQA        PSTJXGBIGDN     XDPPOBPNXAGGB   PHSV           
FBPSKN          : LPYONGYWPKQDAS  GSPFDL         
RQOEVDL         : IYREJSC         SBAOL           WVGVQ          
ULBAVSEF        : DDSPRPTLP       QAEFUYNE        DQWXQRJOSL      LYYAYGRNDK      JFFSOAJI        GLSQFRVFOOJEBK 
SNAFO           : UDRWCYATMGU     CIDDBCTFSFN     SGUJBGWFRW      QRKMVGQTA       NUTPFQLKVY      GYHXYLURTRAJ    WDNSKQS         WJCGHPXEAPVAHG 
PUVIPIVUAOKGK   : YUBAJ           HTGCJB          PFXPRJKSVMIW   
RRKG            : NYNLNHGXWNEI    PXLYAWWWAT     
LEMPLLIALPOGGLE : QDMHKTJQ        XMOOCNSY       
BMOWP           : NTTWGHI         MLNXJMAECGN     XEOXUTRFKKEMSIO XOUAJUKSLXPQUN  CKMLI           CHAA           
JVNYQIJWCWBQON  : MBQUGHUJJRABJ   CPDNQBWFXFJIDON ABGVAPMF        MLGKUBG        
APPPGXXUEOV     : YMBJGNJBLXIG    JHXCSGGXYBKPFNF HWTLJPPDADJE    CXIRDGKGEEWLTYD
FUJIGHY         : HJQL            LYBMXTWOYGXOD  
XHRWLQBEGOIGGAX : QQLUHUYJEA      OIVELEABQMDRPM 
YWJFN           : SUETKLIWYRSIS   CQTHJFQGQVUUJ   RIGSOMA        
YTFKCMSD        : OFHJEQPTRNE     IHHBSAHLG       DMXMRC          VQTPOSOJRRIS    RTSBWPYPHMFHWS 
SKNSV           : TYGJVH          PCBXHRULKJAIC   WMBGYEBUACTPCJ 
TANIKTQLRFMQRR  : KANVNMLAMBAO    IRQJABONDG      UBMKKYJE        YLFTWDIV        TGHDRHFSSLKED  
ATDFEFTYLQUVEN  : WYKVSOIBCNW     QYQVHOJF        HDKVMBET        NIAU           
LHWYRIUIVPP     : CDCMJ           MRNBBIM         YCYEXCNNHXRO    QFFAUNA        
IHCPHVSPDBJEMCY : CVKGOPBQFHBGP   MRDIEA          PVEVE          
HOFUVDWNNRXJJ   : CGGADUE         BMJHNWXE        WYKVSOIBCNW     VWSHQSHSEVTHDD  QOQNMFEB        DJHXR           NQUHMOJNMVVVYLS
TSXVKGUEXAHJE   : AJOXPTTN        XMYQHEPHIXUT    UQXW            WNMIRLJYMXEMBXT POBCWEUPJPF    
MGGVUMQRRN      : LFMJMVLDD       EFKCMDMLQY      QVPI            SLFGNMAGVWDEGSK NDSQYXNDQVP     URYYRGQN       
FIGQRWKMUGXDBED : RNVXN           WLVJACOLG       VMTSSKCFA       JWOIGWXE       
LNIHAOP         : SVLMBL          YTNTJYT         CLSJHKOXI       RSUCLPKC        TVQOKF          VYHAER          QUCIYDV         MWKKNW         
LNIHAOP         : WYUBVHXDHIEDWH 
JCODT           : ATSI            TDGD            BNKIEUC        
LBPTRJSCWPL     : KGUSQ           AXTBDNGR       
VOBYQOMB        : QQLUHUYJEA      OQMTHKWWHRSNNBT QCTUVB          BWKCBEDUOLPD    QGFSDNYQFG     
OPNMBQEF        : CDCMJ           HNIQIJ          YPCVRBQEHMYJH   UBUEICJ        
LQQBMIKFNJ      : JCOC            OSWAISM         QMDXIAFE        YHOFCKWAAKVHF   OPDGTNMMYYDHJDE BRNFMSA        
YGSNHSG         : DCMVUIGXOO      QYTCFDYTNHQLNU  WKNCNLTFWGSFST  XNAXWHSACO     
FHVWY           : SQARJVSVRUBX    VNRUIPFGKVWY    MOSGFVDMSBRO    JLSDSO         
LBDPGRDYIENTRU  : ELOWIJUB        BDNAWFWQT       MSMKRADRKSOXO   EFKCMDMLQY      NPMIHIAQX      
BRIKL           : CKHMVXIQCWOGFX  NWIBG           IDXXYYP         TDVSF           DCRF           
REDSLMOKMYWP    : XAFA            KXKKDNOVYW      CFLKHXCTAYLB    ADAGDQAQV       TTEHPGRDSDCGCD  PHGQXOCBBGE    
MVWQWHWKBQFKSYS : XJOHPKBGETEVFD  MISVKEWCGLB     PEWM            MGXEH          
KPWQUPFJHPVIMN  : QYLP            LCKVM          
CJMUITTUX       : CXXNVG          OLJIWOATBFFPJ   ADAGDQAQV       WVGVQ           UAFCKRUFMT     
AIEACJMRIGO     : IGCLIRWYW       KMLTEVCTELPEPI  XQYOYXTCFUQCPD  GTKJAPOISVHSC  
LXIDWQ          : PJHRRFIWSH      BFEGDQKOM      
KEUWQRFN        : PYKFV           NVMXYTNWBKLLS   XWINR           FWOLP          
BLWDTDFVM       : YRVXOB          VEWDIVGJNGH     XVWFUEFWRAOOTO 
PXBEYODHRCX     : BRNFMSA        
MDHJVBRJN       : YSINDIH         YVWKWAUT        BCWMJQBAOCOA    DVNHNPBKL       WYPLIEAE       
UKAROGND        : APYLVMTA        BRIDKCSQOYWL    THSSWWRPV      
EBEKASNHMR      : ROHDDJIYSK      KUDMMRMYGUQT    XEKV            TYEMMOOHUWIEXA 
AFLJQHLKTBHQNII : KCEVRFOUV       XOUAJUKSLXPQUN  OHEEJUUTTMEEWN  EAESBWOBNR     
QYITFL          : PJJMPLJMT       IFCAFWVIIO      HMCJCRF         GPMEWKIIMBPW    FPEKVBWJVLHYT  
POSGXHXGJF      : TDDBKNWFYJQVNC  XOQMNSSMJMYT    HWRKDCSJJSV     XWYSXBYYLXQ     PGDN           
TWCHHXKP        : IQSVT           OPDDCAYRMEYTD   WUWKMINWSY      XNQOKE          HVYOICVS        QENMQFHNPIVU   
XAADQBNKG       : LPSHC           PKXWCSO         AQVMGY          KMLTEVCTELPEPI  SWUFQQE         KPCLFMTHYSY    
KVPD            : SGOEYN          HCPUGAWMDTO     ECAHQLJDKVTJ   
QMDWWIRSHVCR    : ARCC            QJOVVRBVSPJ     YXAMIQGQW      
MJKK            : SSXRBHAJ        JYDDAYOA        CRETMR          KKSOVDHYB      
KPCLFMTHYSY     : BHLWUQUU        PPYALSAVGVIUP   RXIODPUNBBD     XAADQBNKG      
WPQCNN          : OJMPQQNLJVD     CWVBYWHYYWOJWG  GOWOLQBQTWD     WDNSKQS        
HGUDKOW         : GLLPEHDQYPK     FMTS            NCJAXFKDU       WDSCQQURUABTOR  MEFBFQHTV       OFIV            OQUTHLTVQNUV   
XHKJUCLIIAD     : NTCP            PARD            UURL            PSWITVKDPI     
BVOFSHWVWKLETI  : RIKHVWVVBVDAG   OTDDOCTOYFWT    LMWUQEYKEXDYPB  ICIUFDAFXPIFIG  IYTOATPKH       YSXOR          
GXGEXPQKKSXT    : YHRXWALFWSAOO   EVATNEHCQ      
YYQAUIGNPFLMRY  : JOCJJRFOU       INSA           
NIAU            : EAKSGQIENFCGT   NCBBDDXUQYJH    CIRNGIHX        ATDFEFTYLQUVEN 
IYGXPQLIPH      : OTICXP          FDPDQXLFR       BYNQYRNARLQC    GXOYGO          HMNROWBENDIKJG 
QGFSDNYQFG      : DRFJAA          YMPDDPVDMU      LBOBHJEWJIY     JGGKWXGCYVVX    PAXX            VOBYQOMB       
TYEMMOOHUWIEXA  : OYVIUEYIMF      UQSNRWADLW      EBEKASNHMR     
JLKSXBBDUETVWY  : UQVGIDIX        DQWXQRJOSL      CCAAA           BNWLINGIYNAGM  
EVEL            : JCOC            HSTMLWONCWA     RIVSLAGKMBRWS   PORWNLLW        QBSFW          
QAXBXWJ         : BKBTVANJRSSV    RFQDXQROMG     
UMWGXIYVL       : PNMDMFTWWC      EWAXIVAMAI      MHRJVMH        
BIGUFG          : YRQWK           IVFBFYOVSJRCDH  QDCHYR         
KKSOVDHYB       : UOKEPEGJAMXMI   HVTIMXO         MJKK           
WYUBVHXDHIEDWH  : CKRJHQMKJP      HIKFE           HVYOICVS        LNIHAOP        
FPEKVBWJVLHYT   : XSQIPTDI        LPYONGYWPKQDAS  NDGMS           WLLSHUBADYKW    DBUQUFQRYYSJXKJ QYITFL         
DEFEBGAKH       : UYYYQSVYH       CVBHTKQHNPVY    KFED            JJEBYVHOM       EUEQ            MCXFYOKOVQAC   
RRKWO           : PFSCNGIXGVU     INSA            MHRJVMH        
EUJIH           : INSMLTAHAVVPNVK GIFRUYDSJI      NQUHMOJNMVVVYLS
LFRJSYKOINVNTWW : KCLNTLQUQD      QQLUHUYJEA      KXPX            OKTTPMC         YBHIIBQ         OJHMUBDMSQYOK   JGPVLMQNEBSYXK  DCMMRJ         
KEAEVMCNGIKQST  : SLWKCCKHQTPAO   PEPKESENDEX     WLRVYYO        
GBSPURALAQHQKH  : YLPXMTKGLFDNDWA DKEY            XJOHPKBGETEVFD  MQWQGOTRFBGGBLK
HRTIX           : GWUERNUDM       FLGSLGYLLBR     YNNIHBMI        HKYKFYNXBUTJ    TDVSF           QYNQLIMJGROXXXP
UAFCKRUFMT      : FBNQDPXALFJOBBI VIHBMESOCF      EMOJT           YURNGYDKYRJCE   CJMUITTUX      
NOBK            : JRXCTOTUPME     EJULEO          LNVMNDMWLA      HRXPBVXV        FXPTEU         
EWJUEC          : MWDMKMFR        PBRDRX          XOUAJUKSLXPQUN  XUPTTMWQT       XNDJWWIYC       EJEVDLJOUKN    
