PGUPBGKNYFUNIH  : YDCHPR          NHPL            WIFDVNXPEX      HPQNKQULFIJEO   LUUEVJ         
YKFAYIXPNO      : DMENNGJGNJAYAE  UCYQTEURAMKUJQP AXWTGECYSOOJJRN
ADSLVIUS        : OGCEQDLCWWB     JTESUPTFPU      FERS            EQRMAUVLR      
XYILA           : SWWKDJRLLA      HILLLJ          MSHTTLH        
HOYOY           : VGDBG           MXSJDGMXXKDYU   YUPJHBVTCXGVX   AYYBUOW        
BEAAMXPAPMCUFP  : OGLAYIVOO       AYYBUOW        
OKJMIKX         : SIXUDDYSHJ      RVGWYQDQE      
LOEAPUYPVFRX    : YYRRNWQNCL      NSNI            PHMVKL          XUVWLXUHGUJJH  
SPTICX          : EWPCQLRDBETBH   LXUGWVLFWMHIG   OTHJLVJFDSKOME  QBSIBHTVWEKLL   KADTJA         
KNWBYGPHRN      : VAIMDEWYOALTE   WTTOCASCNVEKO   DSKFKLWDBUJLXAO
DEIFVD          : KDYDEN          FQUWTNEF        CRSNFISYUBXSLV  FHWCCBHX        GSAYPWLQAWYQB   JDOEVGK        
LBLGY           : BVSDOGFVUCD     RRISKJ          YPGGRWNIWIA     PTHUARX        
YPYJTWO         : HBAHCNTEOBEPY   REBTFPXBDPMIEY  HLRJBEBK        CPEEBXPLJJDVTK  AGRSWFTUMQNQ   
KLHLUX          : LBKRTVWMW       XWQJJUCKVWWMJT  XNNAKTSKAX     
MLARSLWOQ       : SXRPIVQT        WDKDRMGKGRFVHD  MDOUHHIGIYIT    BEENQQW         IBOXLUBOTWE    
DUOJVVKLWV      : POSBRV          SATVR           TMAJOMAULFER   
TKOGY           : TNRWKDERNWIUHR  EBBAACE         BSQFEFOCPC     
UTUQIISABGWSAAX : UUTTDMOHDDMNC   ILWGEBGVUNGK   
QJQM            : AKEXFMJQCN      QHIIGCN        
FJRNFECNDYKYTBH : DIEOJLYUQPPJ    HAAMHNKTBKC    
UHGDEBDGYXYIPNE : NPLUDB          GKIC            EFEACVK         PBEWKEOBRS     
YVKGBMU         : GMPSMX          EQWH            QCEJPHWQPMCU    DMSMVYGDXDEV    TFHKKJFUJWFNG  
OFGKJNPGXYJEAN  : GUDXHGVK        WRLXB           NRKMYNVUWJYOY  
CNMK            : QGUOWGTPPKME   
BRCANMHQCEXS    : HQRMRYS         IKPMUXNPOATJIA  DKFMJYNVBAHDN   QTYSFESXAJXRGVB WUCETKR        
EDUTTBRUNWWD    : SDMDVLQ         XGLGUSOYVBJPJ   MEBVXTMLLJ      XEXGMWBO        XYHWFXUXCYI     GGANY          
YQWMW           : POSBRV          HGRWRUDAIRNH    OEDDAYLF        LSMN            NGOT           
EBBTOILSOJ      : VBLAHESI        SSHYDPTCMMBCJ   DRORTHSVTYFQP   TQXNJK         
APOVJK          : GBESPAX         MBMCMQGEKFHVH   NKPQUXYWNH      IVILRV          OEPTHRJTY       JGOPP           CRLCYDIIXCF    
EHODFRNEJMSINW  : OGHDKVGCOE      FRMREPTJHSPHTU 
OTAY            : IVKUMCCHAPL     ADGQHT          HXYPXUITLIJYMN  YRXKULL         XSVRNLCKWLYIVU  FUMQJOCLT      
UNQGP           : FXMM            EVKVYFWVTRMIFAA TQXNJK         
XNTKNXSCDAW     : LWLGYVKKE      
GIGAQVYCKSFLAA  : BGVFUFDY        SOWEYT          TMLCGYYR        HLEOORCLCYBBC  
QJQYJHTTWTO     : YIWVMQE         JPPQVCYCP       QDCARR          JQQJMHYBK      
XOXQXGYXYUWEHSJ : CUPHGPH         QEEGRCLSWYEHBB  XAANQTKM        FLPKDGFIU      
SLVKWPLGWHD     : NGVTKKCNW       ERICOGFQFDN     OKTN            FWWEVNVYSHWI   
CRUCJVUHCUHCRGI : QIMWLGQ         FLMBGDSYBW      CXYUXIOBTJYRIW  EQWH            LLBHIQSFOLTOW   SRGHDXR         TJAELVWFTPE     IGQUHQGEHNMRJXA
YRUS            : QWYPOWVHJGECAY  GFIJKEDOGRANCM  NJGBBVVOIFWQ    QBLRWLADQK      FLPKDGFIU      
TFDLSLIBOEFJBHU : IKNWLTHPIRC     FPTMMB          GGWVOVCVGNGMS   OTSXVJMHJQ     
EECBLGTTOVTIS   : ESGHGSSP        SXIKT           LEGJWEBOTFUDA   JDOEVGK        
NOTSAMHKPVOUH   : OERJRSRT        UODHIKNCPCFXJJ  APJWVHXOHILPIWT ODAQMKRG        UGXCMVROMHAOB  
ECPJGRKTXGO     : ORXWFFPJ        ERICOGFQFDN     YQMXNWLWBLUDTTA IXRHOY          XXRYEALWVFULV  
EKWXYNOUGPH     : EPQGNQEWNDOCTWX IMDVEJVRPMVLJTY GPVP           
AAMPU           : FRQTAWLAQNP     DTFLORO         BIDEMY         
ICYALHSX        : IBJY            AEDOJQGLKHAAEYD XIABFLLTWQAHAT  LLBHIQSFOLTOW  
SHUILFFLGSB     : HLHHLBLIT       IUFCK          
CSKRSKGKID      : IHHP           
KEVXNQXTJFORT   : ALJTJICBTFUORP  GMNMWPQWU       IBOTMAQMRMKUWBQ VBIWAGIV        YGHAXJCUHYLLR  
AHESKFW         : KWILBK          RWSDBRMDS       YWSIPIDPXWFNTK 
QRWDXJL         : GPNTLLJ         DWCXCYYKXDJ     DUIDEAXDIRAWJ  
FXJDXXTWTFEL    : OPASV           WWQCVKXURY     
XJAIOUSTS       : YKDK            RJRXPU          RENFJJSCDXVET  
MKVSKFGOMFXPDX  : HHVKKPQAOQWW    DOFTQACJ       
CUPHGPH         : XOXQXGYXYUWEHSJ GHWAVJVHTEJWQI  DGRIRCAKVPWWPWM RCVNLJLTYOVVBKN GXQOISLQVLLY    WDNIDHOC        MOAGJRFIT       XFIMS          
CUPHGPH         : ACELCJOGNCW     KFVECGG         MTOWNEFDO      
PPGM            : MPEWX           DYHCREDG        IVSBV           RECSCB          NYDSUN         
BFIPREIDLPRY    : LDWUGSMSPLDXXSE FIJSU           QJPNNI          BAIISUEQLDS     TSEFTMMHGOLNWXD
ROCSBHNS        : NHEXVPFHCAMY    GBESPAX         WYUXLL          IKPMUXNPOATJIA  GNNISANFTV     
VIXN            : AGBCFOSF        QVNGGTGRXRBQC   GWEGHMSO        NYFSDWGTRUGBR   XGVJBYVPWGH     DTDTO          
QUMCXUKN        : BTIKCYVLGNW    
QYPCQJDPCSTW    : RHTIWFTHEOISGK  PMEOCOLL        OWBQTUSYPMRVRX  NHKSNWSNECOVK  
BMORIWSXYJSL    : XDMQRVYBPHFSG   EQTMYFGKNGFUKR  QRPUOQEAMX      UWTQESGJNJIVPPM
QGAH            : XTCO            EQUBXW          IVVGDWNTN      
QGLUYV          : TMXC            SAJHLFEWLGBXIOC DGUYQAENNCWKX  
OATIWPMJGE      : XCWWHIK         XSVRNLCKWLYIVU  ESIIGWEGQL      YVBD           
FWREINRVGB      : XIRGNOQ         KIXGHLJSMF      XIFSCLLCIRKRR   JAJJXEHKQT     
NWOVIKWGLLG     : GMPSMX          NSNI            TRXDUJNXUHMQB   RYGIQUJE        YRYKAKJ         IHEBPKXLBUPY    NJGBBVVOIFWQ   
WFWJQFPMKNFO    : ALJTJICBTFUORP  PCXJITTFUACS    UYOVJKXLQWJWVYU
UIUBJSRIINR     : TCHPCDUJX       IFCFQSKXNXVLQ   DKPBIFWTBSP     VEPGRNAQACB     WBODQI          EHEV           
LAGYHN          : BBSFYPXFV       WWYLOHTXQRH     HDAHEJPTCMFPN   RUHYRJDUTBNP    BLGCQVBSOT     
OMHGRXSCNASNUB  : DQVJOFLAKUAPQEB XIGUULIFV      
WNEO            : KIRSROCLIIS     SWGIEFTOPX      WWEXUPKD       
OERJRSRT        : NOTSAMHKPVOUH   QUKTA           RWIBSVOEHXAB   
FRQTAWLAQNP     : AAMPU           GPNTLLJ         QROOBCFDAOYWTW  ILWGEBGVUNGK   
IDOLONBUEA      : RCVNLJLTYOVVBKN DJKVLJHSWWJ     IBOXLUBOTWE     BDHSGNPGSCF     EQRMAUVLR       WFEXNC         
IRUDKOWMVOEP    : ENUFGDLJUQOTWO  IVCDSFRABICFUJB IGWPDAWS        KSIOHYRHHMKMQ   JAJYKCLKSDKCJ   GBVXROVMJTQE   
DDQTSINBMCOD    : DKBF            UYOVJKXLQWJWVYU FJTFFWTBUYJCQED
QXVQJEK         : LFLE            EQUBXW          WKGQEE          NBEULC          XUVEYEKP        JBPLXXLQHWPYG  
JXUGKS          : TICGQHG         BGIKOUUBLSRNGPD SAXUGWJX        NXKRTP         
QIMWLGQ         : CRUCJVUHCUHCRGI CEDHMUURFJIYV   RFSKWJCQ        ELYMHKQNJD      XADS           
OGHDKVGCOE      : EHODFRNEJMSINW  RYSCJRQO        SWYP           
FPFSV           : IWTWJT          TRWFPXRPQG      UTAPAJPJXRNLQA 
QSVDLTWVITJQMP  : DILY            FQBHUA         
TWLEVS          : MYVITJC         EMBLNLUUDUBHD  
KYHSPMLLECHC    : JBGDJXQGYHCBO   OUDQDIL         EVKVYFWVTRMIFAA
SVERGX          : NNJCFCPEVYDFBR  TKKUH           QYUNUMGX       
XLTGHSTNO       : YPVDFOTBHLEBGYB ERUNQBJIGKKYTLF UAVLQQUAN       UNMTGABVARF    
WCMFUETIRXM     : ANHIIAOXNRHR    AUTPMK          UFJTOIJLDUDIO   FRDSKYKGA       PMALPXGB        YRIAOEQXHN     
ATUXYMFWPF      : UADJNS         
JNRDHGRWDVLKQPF : OSSIQRLS        TCFBBQKV       
JDNJG           : CFFDF           FQBHUA         
GEJS            : IJSMCVRCHDMAVN  QDQWNKHBJ      
IISTUGNXQVRP    : JMVK            SCBMSLNRPEYDBN  BEFNWWVTBKSAHW 
OBMHSRJCXWN     : JOAOWFCGDTWY    JYTDJPJFATSKJG  KREYYNUXVI     
HTKQO           : ODFRL           XTTWYWXLEGEPT   TJJLXVCPW      
AAPTUY          : LMBYKOXUQY      SJIDXIST       
SPGMFGBIUJBNS   : XEMIP           FRVSE           DQUYNCYKIPBN    AGUGFLVPASQGEL  BIAEKTG         AVPCPGW        
NRTRAPEQF       : MJRBORWOBMKWYJC TAPWATDVHASW    PJVRPJPA        GISY            YIFDCENJIO      WVWDTALVEHM    
QHTM            : RQDJHXDLRUKY   
SWWKDJRLLA      : XYILA           WEXO            PWIGAJV         GVMQ            VGUEQQQYBMD     HBYXBVD         FUXAAKDNFONHT  
WDVPIJHEDJWI    : SBBDAVCVYRFD   
CLTJHJNAGKMLVE  : RWPU            MOUGVVNH        MBWAHDKEJLVD    CVRE           
HGHELEVWPGD     : UQLKSDHWOMCK    XTVN            HMXRQYWMAXQF    UGFHVIGGCB      CTWPLGHC       
PAGSERPP        : POSBRV          CAVCOGTT        EPQGNQEWNDOCTWX
YDCHPR          : PGUPBGKNYFUNIH  NBEULC          OUDURDC        
MXRT            : SVJSOBBGCVKIALL VDDBONRPGEGJ    NXKRTP         
BBSFYPXFV       : LAGYHN          DYSAEUDQ        PBIUPOOMR       DEDRXUHI        RCPRKTITYRXQVTM GNNISANFTV      TTDPW           MPYRWXDPBDGB   
BBSFYPXFV       : BLOFQ          
XVASBTIQV       : XTVN            WDTFD           GGANY           MOXTHKKXRMQFWM  XRLJEPKUUUPULM  UJPVP          
WBQMSJYQDVXFYR  : YCAXBMDX        QQHLOSEGJYS     MTBRHIUEKBQFRSV PEGMOTVQQ       SGRSPNYX       
XJKGHGGEGYHDKAY : SRPAOM          WYUXLL          MBWAHDKEJLVD    HTBQA          
WALKUWLMDJMI    : HNTUIV          SGDW            WKGQEE          YYDMYLPXLHO     FERS            PAMVGIJWUJT    
EWHQI           : TEEEUMSPGO      WNFXMYWAQLWRP   XIABFLLTWQAHAT  ENSEEWIESKVWO   JQTANLDQLK      NRGHGMNBDP     
XOVEXWLBHO      : KYPP            PWNMTARR       
ELFRXAOMOTVCCF  : LOUQUPRY        SHFBRDEWGXQDDIE WMUXUPPJNLP     SOEYYKWJ       
COYM            : DECIRCUNC       BBSMPXDJ        HRYUTHTUYWKGG   GBKFXMNP        BQKXFMIV       
ADCGB           : DFXSPVRBAFUTV   TKMNELU         DHJOFTOPVBWCE   IKPMUXNPOATJIA  JVNSNOMHOGR    
UELJJP          : WHEGD           AVYNAJYVVAIBGLF EOSTQWCKJY      PMCFUKR        
OJVQAKGUGIYN    : KARJB           SWYP            PRKMATG         IGQUHQGEHNMRJXA
BESN            : NBEULC          VNXAK           PRMKYKQLTXPSXOQ
UROB            : HDAHEJPTCMFPN   JWCSYODEAPEC    OVYVHSSEH       CHRLIXMSOOQJL   EDLVEUQ         VOXQD          
QXCCHLTF        : QILA            TGLOUSHA        DGRYBOMU       
DDQDNWAVH       : UPUTHKYL        GIOVWUIOXHKFBBP FMHGWWALIV      XLDAM          
KYBOTRCOLQRG    : LHHEYRXBNJCA    GMPSMX          LGCAPL         
QILA            : QXCCHLTF        BKLFPHBWGYUWHS  EAMYHCPUPGSBLB  DSUOQ           YVGVYVA        
HHVKKPQAOQWW    : MKVSKFGOMFXPDX  EBBTVTCEQYCASQF NDOWAK          NCFJUMBQBDE     ANNUWAKDKRNXBY  QTYSFESXAJXRGVB CPNJAXKR       
JXWARO          : PEKVTXJPRXCG    VPHAOISSTWYC   
IATCI           : QBPNLJIWUANPCFL NIOCKGYSKI      ONCPKIG         WTTOCASCNVEKO  
UTPVNWFMK       : CJRQQHMY        NKDEJ           PXLWRHXYCQNG    VLKPJR          TKLALLFTIFKJLB 
CDSQ            : IJSMCVRCHDMAVN  NTAYTTAVLIQIV   SSAXTXTCXRJIAHT RUHYRJDUTBNP    EFEACVK         JIOCOC         
RNPDLOEFDG      : CGSENVHQYOGMXHF KLONNJ          OUDURDC         TPKTFHIFXOF     VEMEKDXWEEEO    KGVATQTU        VCFSJER        
FCSPGNJXLAWR    : WJCUCWMBDUUBHBM NFVLVROXKIMCT   GPVP            BOGSQX          ATXGGEKWVEHQ   
JKQMDHLXXDBLR   : FFYJWLWLM       TAQL            YWRBGTVEAH      XLCCJNFPPGSXXUX SAHTNXBGX      
TWOJESCTBQEYCG  : UJNKGSBCHFPWPJA BMVUVNUD        JTESUPTFPU      YPVDFOTBHLEBGYB NVOXOGYJ        NEHQBDJPBUV     GXSXYYJBALVQH  
TUIEL           : AGUGFLVPASQGEL  PJFN           
KUJKUOLHGTDFKM  : XIILXWECCTOQE   PQKPWWIAFPWYQSR
FPDHIJI         : HYEUB           QFNWROYLGKPOMF  VGEDDDDU        DGUYQAENNCWKX  
PHJKQPX         : EWYDIEBYGHPEL   HRNGQCKJTCIBF   VPHAOISSTWYC    FEJTR          
ATCM            : UTAPAJPJXRNLQA  AHYAJSE         IMHURXYPEKQXJED
QYXWU           : QGUOWGTPPKME    NKDEJ           RFSKWJCQ        SGRSPNYX        VSNSTAE         QJAXVLJWKYXVNM  BUICYSGFXAKITE 
CHQNOI          : RXGRTRTXW       NMKWSK          NMQYGJVFQWGUY   XVGVHST         PNISKOMULTRB   
VSDFFUOOIHHGXJ  : WLXDOAWKJHPYJPY ACELCJOGNCW     CRVCJIKUHCS     BQQLFELWBS      XXRYEALWVFULV  
AWTQXRP         : OLEHXSA        
XTCO            : QGAH            OUHWIHEMWQ      WWQCVKXURY     
QYYPR           : XDORJ           EEVHVEWY        JNXPUHEADUP     CJDCSMKWO      
WWYLOHTXQRH     : LAGYHN         
SEMLC           : PWIGAJV         IRLTX           MBDMKWLYGR      TORCEBYPAX     
CWFVBVGUUHKM    : XEXGMWBO        NXUGKMMCIYJCQ  
HLMSCW          : HNTUIV          OTCURHDCNAEFN   ALII           
ANHIIAOXNRHR    : WCMFUETIRXM     JXEWIKBQVE     
MQSK            : YQMXNWLWBLUDTTA MYWEEEXC        EFHNYSQMKQRXK  
NHEXVPFHCAMY    : ROCSBHNS        KHWLP           AGWSOHYLAIA    
OOWYXYOVMI      : IPKROPRHPTPMDWA MEMMMAFVDNVOS   EKDG            JAJYKCLKSDKCJ  
FYRVRESFLWFHO   : DTFLORO         DMNMQNG         XFIMS           ETPVVUXU        KIDKBRGBD       XSWDUUQA       
QSNDSDSHAT      : KSJOVTHHFOMIKL  EHWQSC          DYPYYYO        
YIDLQISQCQ      : XDORJ           TYEUGXGCJFHWDUE GYWJ            QFIUYCW         JUFQCAOCJ       NAYOTSGEMLNWRL  PWNMTARR       
GLQRKVYYJQSWV   : UPEDJES         PWEJLG          BVVIVWNNL       GVVYQHVOPBLGVYX
CQWCLFDTKQNT    : WFQRWIT         RTYF            TFKCCBM         YKBYKJCSUYTMBB 
GVDQFPJWAGWAR   : AGWSOHYLAIA     CDVML           UFCA            BTIKCYVLGNW     GSAYPWLQAWYQB  
UQLKSDHWOMCK    : HGHELEVWPGD     RBDHRGVAMXJOO   DHCOVMEADHQSB   PEKVTXJPRXCG    DNFMSAVR        PXCESCBF        RHLPNTCMQLHG   
SXTFGR          : YYVYNWHWJWPTUJP ACFQ            JBPLXXLQHWPYG  
XWBHWBPTDJJAA   : GPOIXWVPTLOGHLS WBODQI         
KUASRO          : QOAV            NYFSDWGTRUGBR   QSDPEHRXDFEQFF 
TCHPCDUJX       : UIUBJSRIINR     FYBERTVDO       FBBLKLKSHJAN   
JWHSTL          : OXDAUWKGJTDCXUD BWRYXWV         REYICCPMVSOQQTA AQYEADL        
POSBRV          : DUOJVVKLWV      YQWMW           PAGSERPP        WFNIPMYGJ       KFGRGA          DTDTO          
CQYULQFFSMWUQU  : GGOFMPC         MCEB           
QBPNLJIWUANPCFL : IATCI           CIWLPXESOFYCWA  RYSCJRQO        MMXAUFYOLYHH   
IFCFQSKXNXVLQ   : UIUBJSRIINR     LGFEOMDYRRABETX QJPNNI          JRIUFMDTWRI     GAGPKEKTULDOI   UAIDKIHQOIGB    AVPCPGW        
RHTIWFTHEOISGK  : QYPCQJDPCSTW    LOUQUPRY        ENUFGDLJUQOTWO  CJRQQHMY        VOCECM          VQJV            DQOLKDCFG      
UNKAPQSLDQ      : NRJOV           LUNVXKPTM       HDOMCDYMRG      RMNUQDIIS       BEJX           
DMMVFFF         : OUDQDIL         DDIHJTJEWLEAIW  SDLUNFMDES     
PDHJKMASHGDHDSU : HKXOSTJIYCV     PAQKCSAINV      TDSVINGJ        XFBGDT         
LLVYQPAU        : SPDSRMBBS       YIWVMQE         PLFIYBXYSXH     ODAQMKRG        AOYVFGBMOGDXVSL HCLDCROQ        UJPVP          
PQKW            : IFTSHOWMY       IGEGIDEUMFNC    BORHSRQTQC     
MMCTVMIXGRELC   : AGJCDHSAPQRGDI  XCWWHIK         ABXVWNNONNL     GPCDYDYC       
HWNSKMRBCTXIJR  : ASRDRCYJQEY     JDOEVGK         VBFWUAFIKMVGMCL
GQHUS           : RBDHRGVAMXJOO   AGRSWFTUMQNQ   
SFMQNHXCJIJGXC  : WOEAIYBLFDH     PJJBEWNGA       EMRLKHWDEYBTASM XDVA           
KVTO            : OMVJIFCDMYEBXMD IBTSDRWQQT     
SXCKSKBBITHBB   : MNWBPFFF        ORXWFFPJ        HYEUB           BCWLI           LATFWDHBVEO    
SPDSRMBBS       : LLVYQPAU        WYTPWBK         UOKGUXFCTTSYQDC VFFQRJE         DRWUUEPY       
FLMBGDSYBW      : CRUCJVUHCUHCRGI SBQXCKFUKIACVI  HUTRKH          CNHPURUFGC     
WKMASGHVJ       : RTGIDPCAWGFERTX
OYHJSV          : FORKOSLUHNVG    DKPBIFWTBSP     LHMEULMDXLKGJO  AXFFQUISO       JIOCOC          NXSJPBHDS      
VPMBBYEJCAIGYT  : ESGHGSSP        OKIXH           LLBHIQSFOLTOW   GPHH            EKSETK         
LGFEOMDYRRABETX : IFCFQSKXNXVLQ   NRSO            GWCYKX         
RPBTSCADHALPC   : PWIGAJV         BOLXXGXGLPKF    NCBLWKTIVEWGE   FTYXUJYUVSYGKM  FOOYPGAOHGCMDII LJSXKGFCXECOOW 
UNOAUGOXHIR     : VBQIAHBVRKUVI   NQCCQYEHYA      HNTUIV          PJESAT          YGHAXJCUHYLLR   NTINDLS        
KVFILXAORSTTV   : RJQUMEFEJ       UXKWQDHGLINVDYV IANDPOFQJ       TISLXFOXPIL     OQUOYDEWERHPMGD
WKUYSPMJRHRIFY  : UJCVFOA         HKWYBBHCKTGADKN FLRJHASFBMRUT  
AJBVO           : CGKFRI          CONKLEBOD       QVYCK          
JOLBGHUDDAAP    : WIFDVNXPEX      JPHJCIS         QJPNNI          DDIA           
YIML            : QYMBKX          YWRBGTVEAH      ODHRYFNOSAXTK   FATLOCKB       
GVMODOHDAJAQWLG : WFEUY           OPNGUHDYRIEHC   IBTSDRWQQT      XLDAM           HRPGCUJIPKNFC  
MOQJRV          : TNESIPVFKSGEXYB NNIFNBV         VWXGDV          JBPLXXLQHWPYG  
RMGQWU          : AFTIFNULKAUJML  NWKODXKJYCXKM   DMSMVYGDXDEV    HAAMHNKTBKC    
RBDHRGVAMXJOO   : UQLKSDHWOMCK    GQHUS           QFCIOSKSQQRL    DXWOTYGKV       OIDTWYFGBVQ    
AUTPMK          : WCMFUETIRXM     SBBDAVCVYRFD    RCPRKTITYRXQVTM GPBVI           IMHURXYPEKQXJED NAOEYEHSDDES   
EJLY            : WIULDDWNKWAA    CHBM            ADRTWJQRORKE   
TPUPW           : FJERCSSDA       EETORMOX        JWIGSVKPVKJQRKU
QAWJJUJXSUMJFOH : HURGEBDPY       FSIPVROY        WKWLNTEKG       PRMKYKQLTXPSXOQ
ETKEXVRWTLPRB   : PVXEAUXMRNQK    UUTTDMOHDDMNC   LEGJWEBOTFUDA   EKIWUAYCFTHDTG 
HURGEBDPY       : QAWJJUJXSUMJFOH JEEOTXDIAMEKQ  
MNFRCMRHIFNHB   : FLDSULUVAOXFBKS FFHNABMYI       IHEBPKXLBUPY    XPOTWM         
GXQXPU          : NVKTM           UGQAGOWVFQVLYK 
YPHFVIIL        : IEYUEPU         KMMTCWM         OJCWBDSTUECU    KTVGJMTXWBYVY   FIGVPJBGGM     
GAYNTBDMKLTX    : BEHVEHWV        FYBEJFTFRVVG    SFTSAPABQEKVAQ  SNVYNCLLAAWSAU  AKAOTVGAB      
WFEUY           : GVMODOHDAJAQWLG OPFXLGQL        XLDAM          
MTTLJB          : YYVYNWHWJWPTUJP HBDMUK          NBEULC         
FLDSULUVAOXFBKS : MNFRCMRHIFNHB   YRDDJMSWRHT     BFLK            YAFSGG          CGEDMSJ        
LOUQUPRY        : ELFRXAOMOTVCCF  RHTIWFTHEOISGK  WDLOQLG        
LTSWUM          : BGVFUFDY        XYEANVBHFTVRIV  KGGH            VXYHVIBT        JQQJMHYBK      
HRYEETBGJBNMLGK : RXGRTRTXW       TJAELVWFTPE     SOEYYKWJ       
WFQRWIT         : CQWCLFDTKQNT    MKAV            HDOMCDYMRG      DNFMSAVR       
WPXVKMBTEABK    : QVYPTIQOFJNNVA  UNUYOYMKXSBVBH 
ESGHGSSP        : EECBLGTTOVTIS   VPMBBYEJCAIGYT  KKNWULEFKEDWC   QFIUYCW         XBGPEIMYVWTF    HXDOFBCQOXYME  
SMKJHKT         : NXCFTVFYUUQG    MEVNWBIQW       TKKUH           ODIXSAEEVDPEW  
OSQM            : MCCCD           SMWMUY          TWFGVQVPWG      GXSXYYJBALVQH  
DYSAEUDQ        : BBSFYPXFV       QXFU            BDLFWL          WMUXUPPJNLP    
HKXOSTJIYCV     : PDHJKMASHGDHDSU QJAPR           IRRNYUBN        QVYPTIQOFJNNVA 
NFWKILDYY       : CGEPTHOYOE      XMHTQK          RWSDBRMDS       TGVRTWJXCJ      WXXMSNXIVGKHO   SCPHIIIRKG      VOXQD          
EXLEEH          : DKBF            QILTJXFURGQMHNO QTYSFESXAJXRGVB VMROMDNICKFUM  
VBQIAHBVRKUVI   : UNOAUGOXHIR     WSNLSVSPEHWX    SOODIBEWDYEIHXT
MPEWX           : PPGM            VRRBBX         
CYRVDPJKWSTU    : LSRJWTACRGSW    FNTHTA          FOUKFXBP        AFYKVVSHFIHS    ELSIWP          ATAQUJQIVWJB   
LDWUGSMSPLDXXSE : BFIPREIDLPRY    RAYQXQQJULIVCV  EBPBFDYIYSKPS   KSKFWGBBMFJUPG 
QWYPOWVHJGECAY  : YRUS            ENUFGDLJUQOTWO  HOIITEBWYLXG    DRORTHSVTYFQP   UWDGMYX         KLDVOSHMQ      
NEVJKQX         : FHWCCBHX        RVGWYQDQE      
HLHHLBLIT       : SHUILFFLGSB     NXCFTVFYUUQG   
KKAH            : XHDOEQBXSKVUNQA EMRLKHWDEYBTASM XTYHJK          QITKNERAPSPLTP  AIHCMFSJLR     
HSOLVOMWFQTOCKO : FRVXAPHDNPC     TDIWUW          XEVTMFOHO      
RBPBMSN         : RYGIQUJE        RECSCB          PXLWRHXYCQNG    KYPP           
NYIAYRIHL       : REBTFPXBDPMIEY  QISPJKNIQWAY    EBEQTJWWSGV     GJIELTLVOQRHH   RQSGSRGMDV     
UJNKGSBCHFPWPJA : TWOJESCTBQEYCG  EQUBXW          IJSMCVRCHDMAVN  UFCA            HGRWRUDAIRNH    CNMNX          
LMBYKOXUQY      : AAPTUY          DWKGFKQOFJITNVF QQHLOSEGJYS     HJJXDC          XMILYTEB       
YIYV            : REBTFPXBDPMIEY  IHEBPKXLBUPY   
KKQQFT          : UODHIKNCPCFXJJ  THUTXFEOHQMW    BEENQQW         EFHNYSQMKQRXK  
NCLMRU          : DJTNXA         
AGBCFOSF        : VIXN            JTWIFGPLYJOR    YRXKULL         XRKGKWRV       
KHWLP           : NHEXVPFHCAMY    XVKPOYB         FEOAYYUTEEVBYBS
IVKUMCCHAPL     : OTAY            PMLAXFUCGECMD   RHLPNTCMQLHG    VPHAOISSTWYC   
EDGSG           : LUQRQAWTG      
WIULDDWNKWAA    : EJLY           
KWIHLKJUKCGX    : NPLGBPKHW      
MEESTBDPOGSNWFK : SJNYIRXTRRJGA   LXUGWVLFWMHIG   BSQFEFOCPC      BFSYXCEGQDGC    GNNISANFTV      WIBO           
FILE            : QIVYWMBTSWMP    EHWQSC         
SQDENPIUNRHRXC  : NMVBDM          JRIXL          
YFEPL           : QOAV            QMSYIOEOPWKCQF  BOLXXGXGLPKF    GOJBVELXUXYVCM 
DIEOJLYUQPPJ    : FJRNFECNDYKYTBH QITKNERAPSPLTP  OIEIKDEKLAH     DLYEYLBICQBHAWM
WWKFRXYBRWDE    : QJREOX          KSLTJEXQUUBJFDE UAYMCTGIVMI     GJIELTLVOQRHH   TISLXFOXPIL    
IKNWLTHPIRC     : TFDLSLIBOEFJBHU EBBTVTCEQYCASQF SXWGPLBQSLUM    WDKS            OLEHXSA         KYRKBHO        
MUYDET          : UODHIKNCPCFXJJ  JYTDJPJFATSKJG  VHNDFMGTD       HQSPLCNBBUKDOV  UGQAGOWVFQVLYK 
BEHVEHWV        : GAYNTBDMKLTX    MHPREYHCT       XMYWWQRLG      
DDFNNUKAOSRYMV  : SQCVJASJVSQ     DFRLSYD         AVBGKXPJH      
YQJEUFGYJQU     : JUJIEPJNNE      WEBSLJLKB       IIPTOVKTJOCOOPO MDOUHHIGIYIT    QJJVFEW        
ATMGWPNNDJXFAS  : KIRSROCLIIS     XQWKRMVLQOIG    YIFDCENJIO     
AFTIFNULKAUJML  : RMGQWU          RXNH            YKFVWNVAJGG     NDGRHBC         TXGGO           QYOSMUQNSWJKELY
CLBORA          : OXLALCBEQHVKRNY CSHKBABQLGD     EBPBFDYIYSKPS   VFFQRJE         VSNSTAE         AXFFQUISO      
IPKROPRHPTPMDWA : OOWYXYOVMI      GWCYKX          IUSPWWQRH      
IKADWOQD        : WEXO            RBYHE           UUTTDMOHDDMNC   BRHYFDTRKEK    
CGGWJLF         : XUVWLXUHGUJJH   GVAFK          
XWNNQXELNSQKSQ  : KVOLXRELBKSYKXW RVGUVDRIJDCOI   HEOEHFKPOA      YEITJDVUBGL     KREYYNUXVI     
DSBAIRGAUMIRXV  : HNSEHOWJNHAUMET EMPEDDOULFCI    HQRMRYS         TORCEBYPAX      UIHQK           KXGWXKQAV      
XTVN            : HGHELEVWPGD     XVASBTIQV       OUDQDIL         YEITJDVUBGL     CPDB           
MLOAB           : XBDYQISGVKILI   VOWLLCRJVBSHOH  NKXILYAILRK     YFDH           
QNCJJHDKK       : XEJAQSEJQF      QACAXPCVTGYCBK 
CQPYFX          : SVJSOBBGCVKIALL SSAXTXTCXRJIAHT
EWPCQLRDBETBH   : SPTICX          RUHWFNN         VEPGRNAQACB     ANMWYKWQLADPBD  CTHXJHHPAECHKSA
UVFGFN          : KVOLXRELBKSYKXW WMEBUXYEVU      KPTRYDYNRJBF    ERHR            VCRT            HDOMCDYMRG      MWTRGGCYLC     
RAYVQOVXPOCO    : QIRH            RYSCJRQO        UKQXRILQH       GNOSSKDYVVG     QVVFSHOSKYBDG  
GHQYLTFFXOJSKO  : EAXM            YYIXJYQBP       DMSMVYGDXDEV    OCCKXRFRTK     
RENLEMIWEEXVS   : NIOCKGYSKI      IHEBPKXLBUPY   
KAJRTKF         : LNSHLEXT        CGSENVHQYOGMXHF SFTSAPABQEKVAQ  JMKQPIWEM      
RLLGUGTLINSVAYK : JLPRKUO         MSORKAPXBFJQE   ASRDRCYJQEY     XUVEYEKP        WIBO           
YOOWMJYWKIREUW  : OEFAHKB         TAQL           
OKIXH           : VPMBBYEJCAIGYT  PFWDGKKQDX      WTTOCASCNVEKO   IEVJIMPUBU     
RTYF            : CQWCLFDTKQNT   
WFNIPMYGJ       : POSBRV          XDORJ           KQCLCXYK       
QJNDTFJRFDG     : DUJKGAUYQ       CIWYBHQJ       
NEAFXTEEKELXO   : OQKNUFQCIWFOY   FQWSDOW         LUNVXKPTM       KOBAX           NQXVFH          NXJNMYFUIOJYPN 
NPIWEBISEF      : AGJCDHSAPQRGDI  DMYYY           YIEWLUN        
PWHTFAHMAMKVTQ  : EBBAACE         MVXPNUBGYSOHBYC
ADGQHT          : OTAY            ODHRYFNOSAXTK  
RTNTCIAJ        : FUMQJOCLT       XATVTHWSQT     
QISMQSVDSLPQ    : OXLALCBEQHVKRNY FRXXEX          NKOBUP          UYIDDKGLLJHHWL  HRKESOTOHPI    
HWHMDAVAGNTV    : ANQXDOFLQWP     EVOPCIYGMDP     JTWMFVQ        
XEMIP           : SPGMFGBIUJBNS   UQINDK          DCURTJAOQEPK   
QIRH            : RAYVQOVXPOCO    EYILSDOJDUJT    ANQXDOFLQWP     TSKCLWPSAYCKPFY VMROMDNICKFUM  
NMVBDM          : SQDENPIUNRHRXC  OVRHPEW         TBYO           
MJRBORWOBMKWYJC : NRTRAPEQF       VOWLLCRJVBSHOH  DKFMJYNVBAHDN  
RRQKCIUDXJYAO   : MIXEKTLQAGETW   XIWFYIE         NWES            VHWNSKM         AMMGVXAPIFJGRUK VXYHVIBT       
KDYDEN          : DEIFVD          CDBTB           UFCA            QVVFSHOSKYBDG   KGGH            NKOBUP          PEGMOTVQQ      
DFXSPVRBAFUTV   : ADCGB           QIKOCJXNVEPOYS  DQOLKDCFG       LNXHJOLSOLTDWVS
VGDBG           : HOYOY           VTYY            KQCLCXYK       
CGEPTHOYOE      : NFWKILDYY       XAANQTKM        VWQGSWIXJYVH    SUVU            BUMVTUBXIHJ     OOPV           
TJUMCSGDULYOHHM : RADY            OHDDXFCFNWKDFRN YGYG           
MNWBPFFF        : SXCKSKBBITHBB   RXGRTRTXW       GGYAAJHBBQNGX   MEVNWBIQW       EURQDDGU       
PVXEAUXMRNQK    : ETKEXVRWTLPRB   PBGM            GDMBV          
TFIUVREI        : OJREWQIPTB      DECIRCUNC       FPLVGHXIMND     HRYUTHTUYWKGG  
QXFU            : DYSAEUDQ        FFXSSNDNTYFX    RCTB           
MCUMRSKXSH      : REQIHRUFCFFLOSU TXCNCVBJTXH     AIHRSXHH        CTHXJHHPAECHKSA
HYMXLIUSQPQ     : CHBM            YKCOKLOASP      UADJNS         
WYTPWBK         : SPDSRMBBS       ACFSROYNFN      FJLPHLAKA       SUYATTARMAPD   
NNJCFCPEVYDFBR  : SVERGX          IVSBV           ETRQUKGTNP     
MABITSYFPBB     : GBESPAX         SBQCEBCWAVQHEFG SAJHLFEWLGBXIOC XLDAM           TVHDHAQA        QCITBUKHY      
AEQNTGWWOAOSX   : LIIPXJRTGVW     PGGDDSFENCGV    SHIVXRSNGNFIJQK JBGDJXQGYHCBO   KMLDFIGRRDYRI  
XDORJ           : QYYPR           YIDLQISQCQ      WFNIPMYGJ       EMRLKHWDEYBTASM SYTSFIMYYL      MMXAUFYOLYHH   
TKMNELU         : ADCGB           XRDISL          PIOGBHKSK       KVQYSPKFAPO    
OXEPEVFYE       : EPQGNQEWNDOCTWX HUKJVSYBEXUXM   HGNDE          
XSEMNEALKPFTTA  : XIGUULIFV       IUHWPSKDQOE     XXRYEALWVFULV   PFTAVGGHQ      
GPNTLLJ         : QRWDXJL         FRQTAWLAQNP     KARJB           QOAV            CUOKWW          KPTRYDYNRJBF    UJBFMGN        
QBQOGRSKPM      : MRABIKIV        TDHAUVYTBFAYJ  
CAVCOGTT        : PAGSERPP        QISPJKNIQWAY    KSIOHYRHHMKMQ   TQIUNRVPE      
NVKTM           : GXQXPU          LRSVNFBJCPV     FQTGAICT        VQBQEOHQXRFAB   BIDEMY          GGYAAJHBBQNGX  
OXLALCBEQHVKRNY : CLBORA          QISMQSVDSLPQ    HYAHQFNWJT      EBEQTJWWSGV     WEWNOKP        
PBIUPOOMR       : BBSFYPXFV       FRDSKYKGA       BMMRJ           BELLWAXUA       ADNSN          
IEYUEPU         : YPHFVIIL        ALJTJICBTFUORP  DQVJOFLAKUAPQEB YFAOKQKICEBDD   FRVXAPHDNPC    
PJUSNMAM        : TWBC           
UAAGSBOPTEG     : LGXXLIGUEQNMV   PALVQDRH        RXNH            TVKFDQOTHCH     TPKTFHIFXOF    
XLSDLQ          : JABSVYGLKT      RVGWYQDQE      
DNATWXONMPA     : KGGH            RKSLDYSOTLTL    NNCVPEVBD      
MCNSUQKKKQR     : OPFXLGQL        ILTNTDWQMBNY    GHQV            AGACVQB        
ODOTQFEUSGQSEF  : NDTULOVPOTRADAF OYPQNWEHBPD     FCXKDUWQ       
QWIELKTFGL      : JGOPP           TLHHRYAMCUQ     BVVIVWNNL      
SXIKT           : EECBLGTTOVTIS   MQHFLOETWRNPBQJ
QITJPXGKEW      : MXNTGPQNYK      FWUQH           ALJTJICBTFUORP  TDHAUVYTBFAYJ   QOVYHOYKOQOQBS 
LFLE            : QXVQJEK         TUVCRVSTTKYDLHQ JRCNPSYSJLBHF   EKCEDTDJQTYELD 
TLQHFXNSPIRAV   : PEKIBCRIIWDNC   BLGCQVBSOT      XUVWLXUHGUJJH  
BMVUVNUD        : TWOJESCTBQEYCG  WSNLSVSPEHWX   
CCENJPTQMFH     : QMBYRXKOM       MTBRHIUEKBQFRSV VOBRW          
LHHEYRXBNJCA    : KYBOTRCOLQRG    YMLXQV          JIOCOC         
AYUUEVYG        : FSIPVROY        YVCINDOUXIJKFHF WOLSM           BEFNWWVTBKSAHW  AXWTGECYSOOJJRN
OSRJJEOSXCA     : RKSLDYSOTLTL    YLBCMV          QOVYHOYKOQOQBS 
HBAHCNTEOBEPY   : YPYJTWO         WYLPNDCWF       XJVURMS        
TWBC            : PJUSNMAM        SDOKLSO         PXGTSFQVO       TTDPW          
QWOAGVQBTTDCD   : BRGQFSSECRNFAYQ DGTILKASLYEDE   CFCO            FJLPHLAKA      
CKGR            : SOIOMER         DFGT           
LIIPXJRTGVW     : AEQNTGWWOAOSX   IPYKYWNEB       TJJLXVCPW      
MTTODPHEMBIOG   : KIRSROCLIIS     IVILRV          YPGGRWNIWIA     XEHYGTDJXJVW   
STVMXHVIYT      : LSDGGGNCSPPG    UHRQWJ          DCRVLRPULL      FMRSSXQGHHCTBA 
TOXPNDEJASMR    : IRBCHKQVSP      TRXDUJNXUHMQB   BXTL            CHRLIXMSOOQJL   CRSIXG         
TEEEUMSPGO      : EWHQI           GNOSSKDYVVG     RTCVV           UTNSOPBGXLL    
HXYPXUITLIJYMN  : OTAY            KGWWJX          AHYAJSE         LJSXKGFCXECOOW 
MIXEKTLQAGETW   : RRQKCIUDXJYAO   TMLOAOVE        KFGRKNFYQPQK    WKWLNTEKG      
KARJB           : OJVQAKGUGIYN    GPNTLLJ         TGLOUSHA        ALJTJICBTFUORP  KREYYNUXVI     
JVUD            : FWUQH           YIFUMBSPPLA     BVSDOGFVUCD     HJMOYIB        
DMJRCSGMTNWP    : FRVXAPHDNPC    
QQHUME          : WEXO            YNBLBEMEWBTUFDF KLHHTTVHVFIHJ  
WGCGHMPGHUOM    : JTCMRRB        
XFLTLXPYVHAM    : OQKNUFQCIWFOY   SSHYDPTCMMBCJ   RXTMSOBMHEG     NYSIFOSHLTXRKHL
IJMMQKVSSFHL    : ALII            WXXMSNXIVGKHO  
OGCEQDLCWWB     : ADSLVIUS        HYIX           
YYVYNWHWJWPTUJP : SXTFGR          MTTLJB          XCWWHIK         SIXUDDYSHJ      LSPUYH          UBOGWON         EQWH            GLYJHJQIXA     
SDOKLSO         : TWBC            RUHYRJDUTBNP    BFSYXCEGQDGC    YAOJROYS       
VAFUYIJXHI      : CJRQQHMY        QWDUKILFSUPYDOJ LSDGGGNCSPPG   
UFJTOIJLDUDIO   : WCMFUETIRXM     YMWMXSXHNC      UHEJRDCHT      
YYRRNWQNCL      : LOEAPUYPVFRX    LBLMYBLT        XEHYGTDJXJVW    SSACX          
MXNTGPQNYK      : QITJPXGKEW      PALVQDRH        MOUGVVNH       
KTPPPSXEBWDTPSS : GKWYKEXWJQI     XGLGUSOYVBJPJ   ACELCJOGNCW    
IWTWJT          : FPFSV           TCQDGQOJ       
DACT            : ORUCI           YFNWMBT        
EGSQAIGREFV     : XRDISL          TSEDYQ          SATVR           KXIUEFSVNOFKRU  EKIWUAYCFTHDTG 
EBBTVTCEQYCASQF : HHVKKPQAOQWW    IKNWLTHPIRC     XOBUFDGTIDDX    GSJEECHUYUHIVS  INGYERHI        LUUEVJ         
VBLAHESI        : EBBTOILSOJ      XJWMWT         
YATGYYLCBHY     : ERUNQBJIGKKYTLF AOYVFGBMOGDXVSL WXJPJEBXGB      HBHQNLL        
MDOLHOGYWCUXOW  : PNDEFXQFCHI     BIVCAH          SRDUEXHCR       NVOXOGYJ        WOLSM          
UPQKQQGXRGJUJST : WOEAIYBLFDH     AYAXKNYH        AMMGVXAPIFJGRUK CONKLEBOD      
FWUQH           : QITJPXGKEW      JVUD            PCXGLSHCG       QPQUF           YHQH            GXQOISLQVLLY    MQAIMTPJPI     
AGJCDHSAPQRGDI  : MMCTVMIXGRELC   NPIWEBISEF      TXMKJNURN       XTPSSUERGMT     FMRSSXQGHHCTBA 
KIRSROCLIIS     : WNEO            ATMGWPNNDJXFAS  MTTODPHEMBIOG   VEPGRNAQACB     WIDDFSADPP     
GMPSMX          : YVKGBMU         NWOVIKWGLLG     KYBOTRCOLQRG    MLJUAXQSF       DBELOCFHDF      OLNNUDEIGAXMX  
QBLKD           : XTWCMBBBLAKBRMS SYTSFIMYYL      XKSLGSIWTMPTHLR UBCYO           OHYIQWQ        
DWKGFKQOFJITNVF : LMBYKOXUQY      YBXY            QHEKNVJHACJGQFK AOWFTNJJJOPOW  
PNDEFXQFCHI     : MDOLHOGYWCUXOW  DGEDWRVBIQFIPN  NYDSUN          PXCESCBF       
TNRWKDERNWIUHR  : TKOGY           RCPRKTITYRXQVTM JQXCWVM         LESVGE          DLYEYLBICQBHAWM OOBCFWKF       
UPUTHKYL        : DDQDNWAVH       IVICYPCCVJ      REBTFPXBDPMIEY  IJNPBVVSQGLAM  
WCYYMHPGUHEFMK  : AFKT            UNOXK           KSKFWGBBMFJUPG  AKAOTVGAB       SMURNYWJW      
DHIX            : NRSO            DEDRXUHI        HNDNFSVUHSJAPK 
APMRMIAYINQH    : YYPUHLT         MMXAUFYOLYHH    YVGVYVA         GVTKTQXSAVLID   GILSSU         
PHFYYLTG        : GKWYKEXWJQI     EETORMOX        UPFREODKXIU     RAKBBT          QVNRGJJH       
BVCBYK          : XMHTQK          YQMXNWLWBLUDTTA FHWCCBHX       
WYLPNDCWF       : HBAHCNTEOBEPY   YIFUMBSPPLA     AEKJ            CDEXGXM         YLXTIHBEGM      BWEWBHJTSY     
FVUMONVTMUHJE   : REBTFPXBDPMIEY  EMPEDDOULFCI    CHFXHXTTOEPMN   BQKXFMIV       
KCCNBMWAOK      : PCXGLSHCG       BCWLI           AIHRSXHH       
EQUBXW          : QGAH            QXVQJEK         UJNKGSBCHFPWPJA LLJSSYERLVLXD   SYTSFIMYYL      BUCELSQA       
TTXKHVEUR       : SXWGPLBQSLUM    YLXTIHBEGM      SCBMSLNRPEYDBN 
EXOQAS          : VULMIPUHK       TTCITLKJRRKJ   
DGEDWRVBIQFIPN  : PNDEFXQFCHI     YWEEIXHKFR      GHNCSGYEDPXURW  PRMKYKQLTXPSXOQ
JLPRKUO         : RLLGUGTLINSVAYK QBQAVWNKOL      TICGQHG         SBQXCKFUKIACVI  HYLQAX         
LUCANESUHBCMXT  : CGDV            EUMXHWTODSUQODG UTUMF          
CEDHMUURFJIYV   : QIMWLGQ         SETKIQWBPE      CGFGHR         
PAQKCSAINV      : PDHJKMASHGDHDSU WEBSLJLKB       QVNGGTGRXRBQC   XQQP            EVKVYFWVTRMIFAA KYKGPRWXOKU    
RXGRTRTXW       : CHQNOI          HRYEETBGJBNMLGK MNWBPFFF        LVQMGOOIVD      AMIAGDO        
MSBFAKPB        : KFEWRWMTQN      QSSSK           FRMREPTJHSPHTU  VCFSJER        
UQINDK          : XEMIP           OXDAUWKGJTDCXUD RVGUVDRIJDCOI   RSJP           
DUVBMNY         : XPFEFCGNRWSHUK  VEVTBPTUQGC     FYBERTVDO       NCVLYUNMEEJ     PSAKPBOFAXTM   
IUMCUM          : AKEXFMJQCN      NLJJILGVABCCEA 
IHHP            : CSKRSKGKID      KOBAX          
TFKCCBM         : CQWCLFDTKQNT    XTWCMBBBLAKBRMS BTIKCYVLGNW     DWCXCYYKXDJ     PBQXJTGUWTI     QBJBXFNQC       VDFKNUAITWNFPR  ALKOT          
GWALTVNIMODUMSY : KJVRGBKPLUUNFFF LUDK            FQXGBW          NJLSIWGIERWP    NXJNMYFUIOJYPN 
FHPMQFVMMGQOJDG : TLQFJYPJHCY     DEAOWMI         RJJFEAVWJJTO    UKQLEJISCNUPNT 
CGDV            : LUCANESUHBCMXT  DHJOFTOPVBWCE   MDOUHHIGIYIT   
SETKIQWBPE      : CEDHMUURFJIYV   LVQMGOOIVD      GYGMBUYHOV      XJWMWT          RBHR            NEHQBDJPBUV    
AUUQCS          : BDBECHHVA       EOHMRTBYYY      UAIDKIHQOIGB   
RYWIIBRADXD     : SEUIGRVO        PPRFVXXDBCRIB  
FYGYJQPG        : KLVE            AGCTCVGDRQFAHMH HYLQAX         
IKCIHYBMRHE     : AIGNQVOWKVWMQU  ONCPKIG         CMIBHSDC        MPYRWXDPBDGB    BOGSQX         
FOBGGB          : NOVEMVGCTKI     VQJV            FGYCMGFRLKP     YRCCCVSQW      
HHNMGUOPNGXIOKM : EXGSS           YOYXUHFYOWGRHG  BTIKCYVLGNW     XIFSCLLCIRKRR   CTHXJHHPAECHKSA
UODHIKNCPCFXJJ  : NOTSAMHKPVOUH   KKQQFT          MUYDET          MLWHJSISS       LWXOPTEEM      
SQXFYUVQLDOTTY  : OACSDHNFA       OSSIQRLS        BVSDOGFVUCD    
VTYY            : VGDBG           XVRFU           UTNSOPBGXLL     MQAIMTPJPI      WGVFGVJVA      
IJSMCVRCHDMAVN  : GEJS            CDSQ            UJNKGSBCHFPWPJA VOCECM          TKBWRV         
UKELVJCR        : NOVEMVGCTKI     WKUESGXGMA      HYLQAX         
EBBAACE         : TKOGY           PWHTFAHMAMKVTQ  WDKDRMGKGRFVHD  BELALEKKTKYLF   BORHSRQTQC      CPEEBXPLJJDVTK 
OWWQU           : FVDXJJMUSKKHRWF GPCDYDYC        BKMJK           PBEWKEOBRS     
SEUIGRVO        : RYWIIBRADXD     PCXGLSHCG       WOEAIYBLFDH     YATJNKCHPSSHSU  EJQLF           VOXQD          
GUBFGFWLJXP     : FPQSCMPMSAEYC   YFNWMBT         GLLXHL         
BRQNGPLYNFU     : FVYJST          XCUDQDWAF       VMHF           
CDBTB           : KDYDEN          VRDUBXYCJ       LUQRQAWTG       XHDOEQBXSKVUNQA SJQVHJQGFMF     WXXMSNXIVGKHO   XCTCJYXXGGJEBO 
JJMMOUTMGEMXQPS : YDKBBEJPIKR     QCEJPHWQPMCU    JRIXL           FOOYPGAOHGCMDII EHEV           
EBYRBOWVH       : DKQVVGXJCKLEVO  OYPQNWEHBPD    
BIVCAH          : MDOLHOGYWCUXOW  VQBQEOHQXRFAB   HUKJVSYBEXUXM  
OTBJPPR         : SNCFWEVIXQ      CMIBHSDC        YQMXNWLWBLUDTTA NKXILYAILRK    
EQMULVBMXSNM    : BRGQFSSECRNFAYQ BLSIAMHHAYQBFTN UOKGUXFCTTSYQDC PRKMATG         IUFCK           UGXCMVROMHAOB  
LVQMGOOIVD      : RXGRTRTXW       SETKIQWBPE      NMKWSK          CYMKVHP         CLUQ            UMJMGVU         UNPENAJQ       
RGIIVBE         : FYKJKCGLPRQIGBO BIDEMY         
TRWFPXRPQG      : FPFSV           DGTILKASLYEDE   ASRDRCYJQEY     CFNBRQVBLHWF    FPTVGYUEOQFW    KSKFWGBBMFJUPG  QMJYCQRDA      
IRBCHKQVSP      : TOXPNDEJASMR    SVJSOBBGCVKIALL UJMUIH         
SHFBRDEWGXQDDIE : ELFRXAOMOTVCCF  UJSPWL         
YWEEIXHKFR      : DGEDWRVBIQFIPN  ERHR            LHXWVOILYJME    ALKOT          
ENUFGDLJUQOTWO  : IRUDKOWMVOEP    RHTIWFTHEOISGK  QWYPOWVHJGECAY  OEPTHRJTY      
DSVHQUEWYOWGBFB : SGQAAUV         TJFE            UQNVYW         
JOAOWFCGDTWY    : OBMHSRJCXWN     XJQLLTUBO      
OMVJIFCDMYEBXMD : KVTO            UCVWH           DLCGEANAQJDAJI 
NIOCKGYSKI      : IATCI           RENLEMIWEEXVS   QIKOCJXNVEPOYS  GLXISREMVA      HAAMHNKTBKC     CHFXHXTTOEPMN  
GHWAVJVHTEJWQI  : CUPHGPH         GUDXHGVK       
RJQUMEFEJ       : KVFILXAORSTTV   BQBMLNKIVRK     WNLTX          
KKNWULEFKEDWC   : ESGHGSSP        JABSVYGLKT      EURQDDGU       
QGUOWGTPPKME    : CNMK            QYXWU           TDHAUVYTBFAYJ   TCROJYVQKYJIH   UTNSOPBGXLL     CTHXJHHPAECHKSA
SIBLULY         : BPHN            HBDMUK          IFWBPLYWE       PMALPXGB        TSDVBJGJTUWM    YLXTIHBEGM     
JMYOWDRTHDL     : YCNHV           ELUQXKINHPEB    QIKOCJXNVEPOYS  DCUMSGNG        AGACVQB        
YCNHV           : JMYOWDRTHDL     DUJKGAUYQ       XEKHFCWAYU     
WHSBBLMCYJPAEY  : NXAPQC          XAKSOUNXAYSTEA  YKCOKLOASP      QHBH            RXMFSEXUKXGXSIF
DPJIIG          : RCVNLJLTYOVVBKN NHKSNWSNECOVK  
NRJOV           : UNKAPQSLDQ      JUJIEPJNNE      DBELOCFHDF      HCXLBLQEPEOBQ   RKSLDYSOTLTL   
VRDUBXYCJ       : CDBTB           EMHREVDHQPDWRO  YBXY           
GKWYKEXWJQI     : KTPPPSXEBWDTPSS PHFYYLTG        WBBRIKOJC       EOHMRTBYYY      PEKVTXJPRXCG    COTD           
BONOIWEGTCB     : MHPREYHCT       CVRE            OQMCQF          UKQLEJISCNUPNT 
XCWWHIK         : OATIWPMJGE      MMCTVMIXGRELC   YYVYNWHWJWPTUJP SWGLKTPRMSXVKBT YWSIPIDPXWFNTK 
SHOD            : CRSNFISYUBXSLV 
PCXGLSHCG       : FWUQH           KCCNBMWAOK      SEUIGRVO        DBWMMPROAGJK    KJVRGBKPLUUNFFF BDLFWL         
LFERBHSDFXAEHL  : UUMNPFIYLFQEHAU GKIKMMIX        CNMNX          
WEXO            : SWWKDJRLLA      IKADWOQD        QQHUME          IPYKYWNEB       OYPQNWEHBPD     HHCTEDCELFQXDLM
MEMMMAFVDNVOS   : OOWYXYOVMI      OTCURHDCNAEFN   FORKOSLUHNVG    MTOWNEFDO       IJNPBVVSQGLAM  
IVICYPCCVJ      : UPUTHKYL        EWAKQMKU        FOOYPGAOHGCMDII
KITKYEYDTL      : PJFN            CUABYR         
TSPWGMLBNWXXYY  : RYGIQUJE        JQXCWVM         HNDNFSVUHSJAPK 
DBLOOVWJIWNI    : VHNLQYFNI       BEJX            XWJDJBRMSUVJ   
HTWENMBVBP      : IBTSDRWQQT     
OMAON           : HURMAQF         XAKSOUNXAYSTEA  XWANEIJMR       YTWJNFR        
EQBPFPNE        : ONCPKIG         TJFE            KTJHUCILVTG     AHYAJSE        
WDRHIBDHFQVHPXW : HYAHQFNWJT      DFPKN           EPWHOMP         GBXR           
OJREWQIPTB      : TFIUVREI        ONCPKIG        
MQBNNFFWPJB     : DETYTKDT        ECDDSFVIPDKFS   XRKVR           HEOEHFKPOA     
OTSVJQUBGEUM    : LNTTIPQUHMG    
MUSGXPUPRJ      : DCURTJAOQEPK    PRKMATG         SQGURUOMDVYOJX 
YQDOA           : YYMIRMDHU       CDSOWWBQ        NNGCOGBBNEAP    YGPSNJ          KSIOHYRHHMKMQ   XLCCJNFPPGSXXUX
NPAIN           : DRWUUEPY       
AJNIPJUTXRMGS   : SGQAAUV         GNOSSKDYVVG     TJFE           
CIWLPXESOFYCWA  : QBPNLJIWUANPCFL IVCDSFRABICFUJB TAQNVDXYVHIGP   QIVYWMBTSWMP   
KMMTCWM         : YPHFVIIL        WWRGWTEJTTJ     QBSIBHTVWEKLL   YQBGHDVKW       EHWQSC          JMKQPIWEM       VCFSJER        
TGLOUSHA        : QXCCHLTF        KARJB           UDMQBAG        
RYKHWODLTEP     : TWCCUJKIHA      IYTQLEUGDSSB   
GBESPAX         : APOVJK          ROCSBHNS        MABITSYFPBB     QBQAVWNKOL      YBXY            OGLAYIVOO      
MLJUAXQSF       : GMPSMX          VWQGSWIXJYVH    XKSLGSIWTMPTHLR FWRELTODTYH     VNGKTKFLSLHCO   CXASOSJRNBXMA  
RYSCJRQO        : OGHDKVGCOE      QBPNLJIWUANPCFL RAYVQOVXPOCO    YBXY            BKCTDKFD       
NSVGAYMUPNUF    : HPBGGSTMJWXUAW 
HOVHNOCUJ       : BDUYP           GHNCSGYEDPXURW  QFIUYCW        
WEXGWOUDENBNPB  : YDKBBEJPIKR     GGWVOVCVGNGMS   HYLQAX          VGCASNU         HTBQA          
NSNI            : LOEAPUYPVFRX    NWOVIKWGLLG     RSSJFWRSAHO     OACSDHNFA       NTAYTTAVLIQIV   UCVWH           CONKLEBOD      
QROOBCFDAOYWTW  : FRQTAWLAQNP     MGNMJJX         OANPSFQW        BMMONUIH        JQXCWVM         ODHRYFNOSAXTK  
QOAV            : KUASRO          YFEPL           GPNTLLJ         AWHUFMJX        YWSIPIDPXWFNTK 
PWIGAJV         : SWWKDJRLLA      SEMLC           RPBTSCADHALPC   BNGHIX          DHGJVHNWQVE    
YGSPB           : XAKSOUNXAYSTEA 
ECMLIMBJLUJQNX  : XIIQOAH         ENSEEWIESKVWO   CVRE            EWAKQMKU        AIHCMFSJLR     
JUJIEPJNNE      : YQJEUFGYJQU     NRJOV           IFTSHOWMY       VUIKJPEAYKPOSUU HKWYBBHCKTGADKN FQWSDOW         QOVYHOYKOQOQBS  VOXQD          
TXFUG           : BQBMLNKIVRK     KFBQG           STUSCVBCLIH    
ASXIIYRV        : NQVMUGPOUXYCQG  PEKIBCRIIWDNC   NMQYGJVFQWGUY  
BPJBI           : TMDTUL          JVHS           
YRDDJMSWRHT     : FLDSULUVAOXFBKS CDVML          
OQXB            : XOBUFDGTIDDX    KNGH           
SBBDAVCVYRFD    : WDVPIJHEDJWI    AUTPMK          AMHILSGDJEPRT   FBDARLGAYCQFX   DYJJKRYVUB      AWBWQYTYYQCN   
ACSDFCSACMHX    : SIEMBF          HMKWDGXCFNLG    WHEGD           EVOPCIYGMDP     DATSPXJROWFMU   UQWPWAJR        LSDGGGNCSPPG   
WOEAIYBLFDH     : SFMQNHXCJIJGXC  UPQKQQGXRGJUJST SEUIGRVO        RUHWFNN         QWDUKILFSUPYDOJ
BHBGKBIMVN      : GLRXLBFXRV      YXJXFOJWK       BLBO           
BGVFUFDY        : GIGAQVYCKSFLAA  LTSWUM          CSHKBABQLGD     NCUX            XNNAKTSKAX      DDIA            UAIDKIHQOIGB   
TFECFHQKKXTL    : XBIINQUJLXSWQN  PEKIBCRIIWDNC   XQDHYGKRVQQJN  
UTRXEGWSCABX    : LJIYWSJPTSP     KOYCDW          BYTP            TXCNCVBJTXH     OMNKRF          XSEKR          
WGKVKEE         : IPBUDEEBCD      JBGDJXQGYHCBO   GPVP            REYICCPMVSOQQTA BLBO           
JJYAVKAPX       : FRWQSOW         LQEJVLYPJOH    
MUCKBLJTNJV     : OYPQNWEHBPD     CGKFRI          QAJC            QAXEEKB        
QUUBSF          : NIVXO           OTALUVNQCPBJPO  YWSIPIDPXWFNTK 
WWRGWTEJTTJ     : KMMTCWM         WMEBUXYEVU      ESUYMV          ATAQUJQIVWJB   
IGHVI           : BQBMLNKIVRK     ESJOCTCBNNIYU   OUHWIHEMWQ      SCBMSLNRPEYDBN 
FEIR            : OACSDHNFA       AYAXKNYH        QGQYQGMYRG      FNHSLITVHL      OHLAKHGPRTLTEF 
YIWVMQE         : QJQYJHTTWTO     LLVYQPAU        MYLQBGYBYSK     XYIDRO          LYMB           
NDOWAK          : HHVKKPQAOQWW    SXRPIVQT        DGHWPGEVNSQFPJ 
LGXXLIGUEQNMV   : UAAGSBOPTEG     PJJBEWNGA       UGMVPDAMEYMNBB  AOWFTNJJJOPOW  
EAXM            : GHQYLTFFXOJSKO  RUEU            QGQYQGMYRG      HROEPH          TWFGVQVPWG      IATDR          
VBQAVEEMDGWH    : BDUYP          
EHURPBMUSCHQ    : FNWMOYDGQBJWKJG YMGIWBNCB      
NQCCQYEHYA      : UNOAUGOXHIR     CYMKVHP         XEVTMFOHO      
FPTMMB          : TFDLSLIBOEFJBHU SOWEYT          MXSJDGMXXKDYU   KGGH            XKSLGSIWTMPTHLR ILWGEBGVUNGK   
SIEMBF          : ACSDFCSACMHX    WVUIMGCIKBJR    KOYCDW          LQABHHMNNAF    
XADFSGUMIWDJB   : XSSLPTOV        IKOIAIWXMVNOEWJ XTTWYWXLEGEPT   IHFPLWGM        VHWNSKM         RIGW            MKDRNWY         FNDBJGBOHOYSPV 
JEEOTXDIAMEKQ   : HURGEBDPY       UJMUIH         
LYUJBXQUGLJR    : GJCCRGQDDXD    
MBMCMQGEKFHVH   : APOVJK          HIMYJVPS        XMHTQK         
ARPSG           : QSOSDNSOGYD     AIHRSXHH       
NRSO            : LGFEOMDYRRABETX DHIX            PMCFUKR        
PUYYOKNQXQF     : NNIFNBV         TWFGVQVPWG      CAUPSGKUNWMBYI 
YJCETXN         : VQBQEOHQXRFAB   IPBUDEEBCD      ROMW            CHFXHXTTOEPMN   MQHFLOETWRNPBQJ
XIIQOAH         : ECMLIMBJLUJQNX  HJFWDFBJGAI     XPOTWM          PRHKNGPRIWH    
UVTKQVLGGYYERE  : WMUXUPPJNLP    
ROVX            : VEAS            YYIXJYQBP       HRPGCUJIPKNFC   XSHKYRJSBROPPQQ
TMDTUL          : BPJBI           KWLGDXYLMGD    
LNTTIPQUHMG     : OTSVJQUBGEUM    LEMVEHHFOMJ     LWXOPTEEM       JBPLXXLQHWPYG  
SGQAAUV         : DSVHQUEWYOWGBFB AJNIPJUTXRMGS   TGVRTWJXCJ      FUXAAKDNFONHT   NAYOTSGEMLNWRL  HWEDGNO        
LRSVNFBJCPV     : NVKTM           VBIWAGIV        YQBMCHXSTESAWDG
DQJO            : OLKF            WCQYVPXOR       JKNYSKPB        AKAOTVGAB      
CJRQQHMY        : UTPVNWFMK       RHTIWFTHEOISGK  VAFUYIJXHI      NFVLVROXKIMCT   NGJMJAXPHO      YYIXJYQBP      
MYVITJC         : TWLEVS          ESUYMV          IAMDANWJXOAYF   FHVYRJTHFAEACK  NYDSUN          WFEXNC         
IRTJBVYYLFRWTBC : AIJDWTOHTGPMLS  QITKNERAPSPLTP 
SSTB            : KIDKBRGBD       XPOMDO         
UBVUYGQJIFRCY   : SDMDVLQ         URVFVTKIFB      AEDOJQGLKHAAEYD LTVIITLMSAEFLSW
DWDFKIWHC       : QYJXW           IPBUDEEBCD      GVMQ            JMVK            MUVCPIXRHTTMTT 
LFRHCUOWX       : FMHGWWALIV      MFQEQHLGIF      VXYHVIBT       
TXRKJDPBFQELN   : YRUHAMQIMRRUQD  WCQYVPXOR       GBKFXMNP        KLHHTTVHVFIHJ  
SXRPIVQT        : MLARSLWOQ       NDOWAK          PHMVKL          YQBGHDVKW       MQNYWWMSCGLKAV 
IBGFSFFGCDA     : AEKJ            GBVXROVMJTQE    CPNJAXKR       
ODFRL           : HTKQO          
YYMIRMDHU       : YQDOA           NPLGBPKHW       YVJSUNJJIWIVWN  GNNISANFTV      GJCCRGQDDXD    
XRDISL          : TKMNELU         EGSQAIGREFV     FUTPTIWEWIGUXNK HQRMRYS         OIBQYV         
LTVTV           : XDNEGCASA       TQXNJK         
UKQXRILQH       : RAYVQOVXPOCO    LUCORKKMHQNBW   OWBQTUSYPMRVRX  YFPWEXBCBHA    
FSERVOPUMHB     : VQBQEOHQXRFAB   BRHYFDTRKEK     RAYQXQQJULIVCV  AWBWQYTYYQCN    OCCKXRFRTK     
CMNQGJKELFPEG   : HROEPH          KFGRKNFYQPQK    SIWKTDFTWWFRBS 
ORXWFFPJ        : ECPJGRKTXGO     SXCKSKBBITHBB   KTRYEXBQCLCGGPV
NXNINWJNY       : WEBSLJLKB      
BPHN            : SIBLULY         DXATRMJPTJE     XDVA            UNPENAJQ       
MBICHOLV        : GLXISREMVA      BWRYXWV         TQXNJK         
MSORKAPXBFJQE   : RLLGUGTLINSVAYK PJVRPJPA        BLSIAMHHAYQBFTN CQQS           
EEVHVEWY        : QYYPR           NVUOXUEAQCVG    HPQNKQULFIJEO   ALII            WDLOQLG        
XIWFYIE         : RRQKCIUDXJYAO   AAUTNETCFSJPQIR TMSWNYYSOXGR    STUSCVBCLIH     GAGPKEKTULDOI   HJGTFWTAWQMIVAH GILSSU          HHCTEDCELFQXDLM
UYYPKCHKDNVVTT  : AOXLMNRN        AWIAIJ          GVAFK           UJPVP          
APJWVHXOHILPIWT : NOTSAMHKPVOUH   HNAQ            UJYOYWAGQBB     FVWFTFCCO       VHNLQYFNI      
RSSJFWRSAHO     : NSNI            FVDXJJMUSKKHRWF IUJRDQHPLVBYKLF LSMN           
BIXCYJB         : OCJMLFH         FOUKFXBP       
QYMBKX          : YIML            NPLGBPKHW       UNUYOYMKXSBVBH 
UUMNPFIYLFQEHAU : LFERBHSDFXAEHL  DDFRMQUDRMBOAW  XSWDUUQA       
CGFGHR          : CEDHMUURFJIYV   OVRHPEW         XUVWLXUHGUJJH  
EKIQLSRENOQEGW  : NCHKQLO         GTTXBXQFYIDXQAE
IKWBQECLMETTKBL : DECIRCUNC       AVBGKXPJH      
GWCYKX          : LGFEOMDYRRABETX IPKROPRHPTPMDWA NFVLVROXKIMCT   YNBLBEMEWBTUFDF DNKETV          IDON            UWTQESGJNJIVPPM
PNGGTODJW       : ELYMHKQNJD      BGHLN          
GYGMBUYHOV      : SETKIQWBPE      JPFOUVLRRYWABL  AVYNAJYVVAIBGLF BXTL            KIDKBRGBD       CJIPEPYHW       VNGKTKFLSLHCO  
SJNYIRXTRRJGA   : MEESTBDPOGSNWFK RJXFFSNLYPPG    DGTILKASLYEDE   NTFCQYPIW      
AOXLMNRN        : UYYPKCHKDNVVTT  NXCFTVFYUUQG    UBNJCHSD        EGWNNMGTIDE     CNMNX          
FQTGAICT        : NVKTM           DKLTA           KQCLCXYK        SDLUNFMDES     
OJCWBDSTUECU    : YPHFVIIL        INVYENNLFGRGP   WAJBMLVQEYWVQG 
ELUQXKINHPEB    : JMYOWDRTHDL     DEDRXUHI       
GMBAPRJUPN      : NPLUDB          HBYXBVD         QUKTA          
KJSPNPMR        : NCFJUMBQBDE     BCWLI           XKSLGSIWTMPTHLR YOCEFNS         EMOMDRDHQHOM   
HKCRVPC         : ESGRHCVIWCA     TEMYTKXFTE      HLRJBEBK       
WDKDRMGKGRFVHD  : MLARSLWOQ       EBBAACE         DGTILKASLYEDE  
SXWGPLBQSLUM    : IKNWLTHPIRC     TTXKHVEUR       HKWYBBHCKTGADKN
NQVMUGPOUXYCQG  : ASXIIYRV        RUHWFNN        
ALJTJICBTFUORP  : KEVXNQXTJFORT   WFWJQFPMKNFO    IEYUEPU         QITJPXGKEW      KARJB           XAFXOVIROUEU    FNDBJGBOHOYSPV 
BDUYP           : HOVHNOCUJ       VBQAVEEMDGWH    YQBMCHXSTESAWDG YGSKOOFY        KJMPENXJCAM    
GIHDIIFB        : TSDVBJGJTUWM    YTWJNFR        
ICBRXNDAOWG     : YRISXI          QVYCK          
OACSDHNFA       : SQXFYUVQLDOTTY  NSNI            FEIR           
NKPQUXYWNH      : APOVJK          XJVURMS         BFLK            UBNJCHSD       
RBYHE           : IKADWOQD        XWANEIJMR      
VEJKSLOLRVBW    : LKYNOVEYUERIC   QIKOCJXNVEPOYS  LATFWDHBVEO    
HMKWDGXCFNLG    : ACSDFCSACMHX    EHWQSC          LNXHJOLSOLTDWVS
PHMVKL          : LOEAPUYPVFRX    SXRPIVQT        QMSYIOEOPWKCQF  ONOPMRJLNUEYYPF BHVD            DJVDPEWYH       FCCEPNAOXG      PJCRKNJB       
WVUIMGCIKBJR    : SIEMBF          SATVR           IXGKWTQDTLF     YPGGRWNIWIA    
VRRCPVHFKP      : IUJRDQHPLVBYKLF TFDOLUG         NQXVFH         
AYAXKNYH        : UPQKQQGXRGJUJST FEIR            PCXJITTFUACS    XFFLH           HRNGQCKJTCIBF  
TRXDUJNXUHMQB   : NWOVIKWGLLG     TOXPNDEJASMR    TMXC            IHXPMEMWFWGLWW  IUJGILQUXT     
TSEDYQ          : EGSQAIGREFV     MUVCPIXRHTTMTT 
MSUORFDQO       : WMEBUXYEVU      DSXTXKLXCQGX    CPDB           
MHPREYHCT       : BEHVEHWV        BONOIWEGTCB     YDKBBEJPIKR     OIEIKDEKLAH    
QMSYIOEOPWKCQF  : YFEPL           PHMVKL          CTWPLGHC        RWIBSVOEHXAB   
INVYENNLFGRGP   : OJCWBDSTUECU    CFCO            BIAEKTG        
CHNODNXRTMHQWLJ : AHXD            XQDHYGKRVQQJN   JWIGSVKPVKJQRKU SRDUEXHCR      
ERTDSYSH        : QHBH            GYTS            LWLGYVKKE      
XPFEFCGNRWSHUK  : DUVBMNY         AKXJ            NKGYCARLN       LEGJWEBOTFUDA  
JTWIFGPLYJOR    : AGBCFOSF        DCGQANIXLO      DKPBIFWTBSP    
HYAHQFNWJT      : OXLALCBEQHVKRNY WDRHIBDHFQVHPXW WHEGD           CPLAPYA        
DTFLORO         : AAMPU           FYRVRESFLWFHO   MXJNPGMSTJFARJK NHHN           
LLJSSYERLVLXD   : EQUBXW          HCJYBQLV        UAIDKIHQOIGB   
XNEFBDQVR       : CXYUXIOBTJYRIW  KADTJA         
RYGIQUJE        : NWOVIKWGLLG     RBPBMSN         TSPWGMLBNWXXYY  CYOH            LQABHHMNNAF     ESIIGWEGQL     
TYEUGXGCJFHWDUE : YIDLQISQCQ      IGNVBMILSVLJFF 
WJCUCWMBDUUBHBM : FCSPGNJXLAWR    TAPWATDVHASW    GBQIVN          GKIC           
DQVJOFLAKUAPQEB : OMHGRXSCNASNUB  IEYUEPU         YSLVPX          TJFE           
NEKPBYTHTOI     : FJERCSSDA       KNGH            RUHYRJDUTBNP    PWHKTPVOVYRJWRN UYOVJKXLQWJWVYU
RUEU            : EAXM            BIDEMY         
DECIRCUNC       : COYM            TFIUVREI        IKWBQECLMETTKBL HBDMUK          VQBQEOHQXRFAB   QHEKNVJHACJGQFK RGHDTLP         RWMKCF         
GIOVWUIOXHKFBBP : DDQDNWAVH       QPQUF           YJTBUQYANM      QCITBUKHY      
TMLOAOVE        : MIXEKTLQAGETW   ERHR            EMPEDDOULFCI    MXSJDGMXXKDYU  
PJVFNJL         : VRRBBX          PEKVTXJPRXCG    HCJYBQLV        XFALTXROXBJKLLG RJJFEAVWJJTO   
XJVURMS         : HBAHCNTEOBEPY   NKPQUXYWNH      XTWCMBBBLAKBRMS SEWQWIJYKXWNRMG
XBDYQISGVKILI   : MLOAB           AUAOXERF        FVWFTFCCO       PWAJQPIOT       VKFTN          
MXYJEMSRJS      : HNTUIV          DKBF            VFFQRJE        
HNTUIV          : WALKUWLMDJMI    HLMSCW          UNOAUGOXHIR     MXYJEMSRJS      KFEWRWMTQN      PFTAVGGHQ       OWEPWHPXB      
JYTDJPJFATSKJG  : OBMHSRJCXWN     MUYDET          QJAPR          
IPOVKHHDLRQ     : IBJY            HOIITEBWYLXG    HQRMRYS         EJMGO           FQXGBW         
MBDHLCBQLSARU   : SRDUEXHCR      
KFGSQOIF        : OSSIQRLS        WHAU            ONMNBLD         AIVQ           
SOWVAOOIBS      : DNKETV          QYLTD           UIHGOLSQRCFSAX 
KEQNUCHW        : DNKETV          HEOEHFKPOA      TLHHRYAMCUQ     UMJMGVU         UHRQWJ          UAAAKXOOCCMW   
CSHKBABQLGD     : CLBORA          BGVFUFDY       
XAFXOVIROUEU    : ALJTJICBTFUORP  NCHKQLO         GYJELJSID       YYIXJYQBP      
SRPAOM          : XJKGHGGEGYHDKAY QNKNXOKFG       DKLTA           DDIA            NAATWKEF       
KVOLXRELBKSYKXW : XWNNQXELNSQKSQ  UVFGFN          RVGUVDRIJDCOI   XVAGARHHQM     
TGVJDBEQTWG     : LGCAPL          YIJWVKHHYR      VULMIPUHK       FVWFTFCCO      
NUCAQROR        : XNNAKTSKAX     
SDMDVLQ         : EDUTTBRUNWWD    UBVUYGQJIFRCY   GJQSM           QMBYRXKOM       GILSSU         
LUQRQAWTG       : EDGSG           CDBTB           FRVXAPHDNPC     SFTBGYBXKOJRLBI JQTANLDQLK     
NFVLVROXKIMCT   : FCSPGNJXLAWR    CJRQQHMY        GWCYKX          CEJYTGQI        LMXFCTT        
GHNCSGYEDPXURW  : DGEDWRVBIQFIPN  HOVHNOCUJ       NCUX           
AMHILSGDJEPRT   : SBBDAVCVYRFD    EDPT            WIJMNNTBIAFJW   TKBHXXJWO      
MEBVTFOB        : PXGTSFQVO       LBKRTVWMW       GSAYPWLQAWYQB   YWSIPIDPXWFNTK  CIWYBHQJ       
VEVTBPTUQGC     : DUVBMNY         BNLOVMDLIJI     DMNMQNG        
RUHWFNN         : EWPCQLRDBETBH   WOEAIYBLFDH     NQVMUGPOUXYCQG  WCSVMNTVPPPX    WFVR           
HILLLJ          : XYILA           BFLK            SFTSAPABQEKVAQ  PWFAKPAV        QILTJXFURGQMHNO LBALBMOHWAHPDHT
QYJXW           : DWDFKIWHC       XHDOEQBXSKVUNQA GLRXLBFXRV      JRIMHMTUDHJR    GBQIVN         
VQTMMOFTQI      : XHQWLKT         LOKNB           NTFCQYPIW       BQVNGNXYDRDG    XSWDUUQA        AOSNYOQJQY     
NPLUDB          : UHGDEBDGYXYIPNE GMBAPRJUPN      XPYFIASJMLCGSXH JXEWIKBQVE      TSKCLWPSAYCKPFY
LJIYWSJPTSP     : UTRXEGWSCABX    JXEWIKBQVE      FBNMTI          WIDDFSADPP      EKCEDTDJQTYELD 
LMJHBWXIQ       : LBDDNRNYNU      CNHPURUFGC      YTWJNFR        
QEEGRCLSWYEHBB  : XOXQXGYXYUWEHSJ MIONUIYYBIC    
KTVGJMTXWBYVY   : YPHFVIIL        BHYR            QSDPEHRXDFEQFF 
OPASV           : FXJDXXTWTFEL    XQWKRMVLQOIG    VWQGSWIXJYVH    UIGOUPV         HGDEQ           YUCVVDEBGIIWRQ 
LXUGWVLFWMHIG   : SPTICX          MEESTBDPOGSNWFK BAIISUEQLDS     TLHHRYAMCUQ    
OSSIQRLS        : JNRDHGRWDVLKQPF SQXFYUVQLDOTTY  KFGSQOIF        DKRRINQDLB      BGIKOUUBLSRNGPD
MCCCD           : OSQM            XFKDKGCDBQV     OEPTHRJTY       WITWHFTXKYKLDJ 
ANLBKRAH        : GOROQQUTJGEUQ   UDEXTJHLKOYYHY  FQBHUA          DGUYQAENNCWKX  
HEQROYVFR       : DLCGEANAQJDAJI  HUTRKH          QWDUKILFSUPYDOJ
PJJBEWNGA       : SFMQNHXCJIJGXC  LGXXLIGUEQNMV   RCPRKTITYRXQVTM OOFXMBXTG       TTJFCDKANCMMUYI FPQSCMPMSAEYC  
LAUALVKDXTHGYAX : TDSVINGJ        ONMNBLD         QMJYCQRDA      
BVVVMLHVPL      : LGCAPL          SUUMUHHGUAYN    MSHTTLH         AGUGFLVPASQGEL  QSSSK           SIWKTDFTWWFRBS  EKSETK         
FRXXEX          : QISMQSVDSLPQ    GGOFMPC         BLSIAMHHAYQBFTN AGUGFLVPASQGEL  CJDCSMKWO      
GJQSM           : SDMDVLQ         QILTJXFURGQMHNO BGHLN          
NVUOXUEAQCVG    : EEVHVEWY        FRVXAPHDNPC    
DCGQANIXLO      : JTWIFGPLYJOR   
GUHYOUOC        : MQRKMODCCHMY    TTCITLKJRRKJ   
LSRJWTACRGSW    : CYRVDPJKWSTU    RVGUVDRIJDCOI  
BNLOVMDLIJI     : VEVTBPTUQGC     TVKFDQOTHCH     XMHTQK          IGWPDAWS        GKIKMMIX        CEJYTGQI        AFKT           
LWNCB           : DOFTQACJ        DKLTA           CRBNKLIXOHQ     WWQCVKXURY     
NTAYTTAVLIQIV   : CDSQ            NSNI            KSLTJEXQUUBJFDE OTALUVNQCPBJPO 
XIGUULIFV       : OMHGRXSCNASNUB  XSEMNEALKPFTTA  IOUS            OYPQNWEHBPD    
XJQLLTUBO       : JOAOWFCGDTWY    XHDOEQBXSKVUNQA LNSHLEXT        VUWCMN          BWEGHCHPGBHX    KOBAX           YJGREW          TXGGO          
XJQLLTUBO       : JQQJMHYBK      
BKRBGF          : UPEDJES         EYUS            DCUMSGNG        TFIKGMO        
YQIQOSYLNL      : PBEIUQWRFSUCK   XEXGMWBO        LLBHIQSFOLTOW   LWLGYVKKE      
UJNTSGF         : RELTTKLJY       AWBWQYTYYQCN    IMHURXYPEKQXJED NAATWKEF        KKNL            TQIUNRVPE      
ACFQ            : SXTFGR          OOFXMBXTG       DTDTO           UYOVJKXLQWJWVYU
IDRJ            : SELSFSGFB      
YXKRGBHYBUO     : ETBJMMJSV       LQYMKJFIRW     
RJXFFSNLYPPG    : SJNYIRXTRRJGA   FCYAWSVBG       RXMFSEXUKXGXSIF
PPKJBWJY        : YNBLBEMEWBTUFDF GJVCBVE         AMMGVXAPIFJGRUK PBEWKEOBRS     
BFLK            : FLDSULUVAOXFBKS NKPQUXYWNH      HILLLJ          DYHCREDG        XVGVHST         UAAAKXOOCCMW   
OGUD            : BMMONUIH        HUTRKH          PSAKPBOFAXTM   
HDFMVSAUI       : HYCKLAWHXN      RIGW            MBDMKWLYGR      YHUSOBWUSHMH   
BRGQFSSECRNFAYQ : QWOAGVQBTTDCD   EQMULVBMXSNM    HNGJ            SARYRWWBLUMG    QVNRGJJH        WXRJKOOBQOQVAGS
NWES            : RRQKCIUDXJYAO   SWWDHLMLUMVPS   CTIGLQFEAXHFQXU XJWMWT          NAXQUU          DDIA            TJLCKVF        
NVCAR           : QJPNNI          BGIKOUUBLSRNGPD VDDBONRPGEGJ    OUDURDC        
DOFTQACJ        : MKVSKFGOMFXPDX  LWNCB           OEFAHKB         SYTSFIMYYL      QTBHXFNYWQECP  
UCLYWYFY        : KDFDS           OWBQTUSYPMRVRX  BWEWBHJTSY      HRPGCUJIPKNFC  
XHQWLKT         : VQTMMOFTQI      CDVML           CXYUXIOBTJYRIW  QVVFSHOSKYBDG   BQVNGNXYDRDG   
IVCDSFRABICFUJB : IRUDKOWMVOEP    CIWLPXESOFYCWA  AUAOXERF        HBYXBVD         DUIDEAXDIRAWJ   KYEYIK         
UCVWH           : OMVJIFCDMYEBXMD NSNI            MPMJJBT         DEKMWVJXUVL    
XHDOEQBXSKVUNQA : KKAH            CDBTB           QYJXW           XJQLLTUBO       VXNBFDWRVUHWV   WVWDTALVEHM    
TDSVINGJ        : PDHJKMASHGDHDSU LAUALVKDXTHGYAX IBYXIWGHB      
BOLXXGXGLPKF    : RPBTSCADHALPC   YFEPL           FYBERTVDO       CYMKVHP         HROEPH          WDELJYHREEBDOH  RJRXPU         
LXDJSSB         : FBDARLGAYCQFX   TBUJKH          GLYJHJQIXA     
BWXVS           : WHEGD           HROEPH          XEXGMWBO       
JBSVFJHFHQE     : SWGIEFTOPX      OTUFPRHTDUOGLSM
ETBJMMJSV       : YXKRGBHYBUO     AGCTCVGDRQFAHMH GSJEECHUYUHIVS 
NYYQVYMRIVSDU   : IDVGDA         
MEGTWMKE        : ELYMHKQNJD      SXXB           
LPUAAPXEEX      : OCJMLFH         IAXSQGNPWAHCO  
UVFKNN          : HURMAQF         UNOXK          
JQDLDKRAJG      : QSCRDNXUXBUE    GGOFMPC         VFWU            QHBH            JQLBTW          QJMYYIUQBR      XFBGDT          YMGIWBNCB      
NOVEMVGCTKI     : FOBGGB          UKELVJCR        CGEDMSJ         YVBD           
QGQYQGMYRG      : FEIR            EAXM            PWBHH           OTUFPRHTDUOGLSM XSWDUUQA        QAJC            HHHLKI         
GLRXLBFXRV      : BHBGKBIMVN      QYJXW           IPBUDEEBCD      BTIKCYVLGNW     VDFKNUAITWNFPR 
XIRGNOQ         : FWREINRVGB      XBGPEIMYVWTF    YFQMHQJTLNAXY  
KKCD            : DHCOVMEADHQSB   CJJELKXAIO      GRSESFWNSM      BORHSRQTQC     
UMXUGGCMSTLGWSF : PWEJLG          CPDB            JHUMXCYKBXB    
QBQAVWNKOL      : JLPRKUO         GBESPAX         YKFVWNVAJGG     LVJNWGDYDYYQTYD LUUEVJ         
BQBMLNKIVRK     : RJQUMEFEJ       TXFUG           IGHVI           XSVRNLCKWLYIVU  PBQXJTGUWTI    
MGWSERXUICM     : OANPSFQW        XVGVHST         TCROJYVQKYJIH   YAJQAKW        
XJXIAMHDDI      : OKUJCJSTFE      PRKMATG        
OXDAUWKGJTDCXUD : JWHSTL          UQINDK          TONO            UPFREODKXIU    
DHJOFTOPVBWCE   : ADCGB           CGDV            NYFSDWGTRUGBR   DYJJKRYVUB      YKOCURTETAGVTBX UADJNS         
RVGUVDRIJDCOI   : XWNNQXELNSQKSQ  UQINDK          KVOLXRELBKSYKXW LSRJWTACRGSW    XWJDJBRMSUVJ   
JNXPUHEADUP     : QYYPR           ELYMHKQNJD      ADNSN          
WMEBUXYEVU      : UVFGFN          WWRGWTEJTTJ     MSUORFDQO       UJSPWL          NAXQUU          YUCVVDEBGIIWRQ  OCCKXRFRTK     
NGVTKKCNW       : SLVKWPLGWHD     KADTJA          UHRQWJ          OBHTPMVT        WFEXNC          OOBCFWKF       
NMKWSK          : CHQNOI          LVQMGOOIVD      RSJP           
NCHKQLO         : EKIQLSRENOQEGW  XAFXOVIROUEU    YUOQTWUACFFGVD  RFSKWJCQ        NYSIFOSHLTXRKHL
LNSHLEXT        : KAJRTKF         XJQLLTUBO       XSKHKEXDUS     
RELTTKLJY       : UJNTSGF         FBBLKLKSHJAN    AIVQ            SELSFSGFB       YHUSOBWUSHMH   
JRIMHMTUDHJR    : QYJXW           XMKXYGUJMAC     CFNBRQVBLHWF    KPYBXRAIPKHNT   HCXLBLQEPEOBQ   WVBLIEJJTTI     UWTQESGJNJIVPPM
YKDK            : XJAIOUSTS       TNESIPVFKSGEXYB TDIWUW         
BERULFOFPAR     : MLWHJSISS       DXWOTYGKV       OPFXLGQL        SXMWVOKKWNXCTN 
XBIINQUJLXSWQN  : TFECFHQKKXTL    IDBCNKYCUDPHQPV OOBCFWKF       
DSLUVPNQDSFL    : DHCOVMEADHQSB   DGJJ            FCYAWSVBG       DJTNXA         
HDAHEJPTCMFPN   : LAGYHN          UROB            FVIFNRSICQPCOC 
MGNMJJX         : QROOBCFDAOYWTW  TMXC            KNYK            YFQMHQJTLNAXY   YRHKELVXVNP     BAKN            NYSIFOSHLTXRKHL
FQUWTNEF        : DEIFVD          HTEEQQ          VIXHBDP         NGDPIYKBY      
MKAV            : WFQRWIT         TBYO           
LOKNB           : VQTMMOFTQI      HNGJ           
DQPRWE          : RKWQ            HCLDCROQ        RHODCTKXRKEJLY  SMURNYWJW      
JPFOUVLRRYWABL  : GYGMBUYHOV      PGGDDSFENCGV    EXWMRKIYOY     
DHCOVMEADHQSB   : UQLKSDHWOMCK    KKCD            DSLUVPNQDSFL    DNFMSAVR       
YFAOKQKICEBDD   : IEYUEPU         EJFUYGE        
EONJYPXW        : SOODIBEWDYEIHXT GMNMWPQWU       HJVYC           WSNOQAXFIUDMI   IBOXLUBOTWE    
EYILSDOJDUJT    : QIRH            JXEWIKBQVE      GBVXROVMJTQE   
CGSENVHQYOGMXHF : RNPDLOEFDG      KAJRTKF         LSUOAGCTGTVPVR  MOAGJRFIT       MFSKP           TJSKDJGJEXSSEOR
EKDG            : OOWYXYOVMI      EGLUQGTQBUJHB   TLQFJYPJHCY     HXDOFBCQOXYME  
RYVGIBDTXN      : XYPAHWNFBHYCY   HQUB            PUPUCIONM       YDOGXASN       
EICRELJDARPBBU  : QTBHXFNYWQECP   WAJBMLVQEYWVQG  NILJVQMKXBDXXWL HRPGCUJIPKNFC  
FFHNABMYI       : MNFRCMRHIFNHB   CUKRJFMMN       KDFDS           IANDPOFQJ       YNGXYXTTYKNOXES
ANQXDOFLQWP     : HWHMDAVAGNTV    QIRH            NGDPIYKBY      
IUFCLGD         : KSCKMVHRMNPAFF  NEHQBDJPBUV    
ILQSYQTMPELS    : CTIGLQFEAXHFQXU DFGT           
DSXTXKLXCQGX    : MSUORFDQO       DGTILKASLYEDE   MTBRHIUEKBQFRSV DSUOQ           KYRKBHO        
JLFOV           : GPOIXWVPTLOGHLS FYBEJFTFRVVG    EGLUQGTQBUJHB   IGEGIDEUMFNC    NAQKAHOVFOKYP  
AMIAGDO         : RXGRTRTXW       VYJHDTUDUA      XYIDRO         
HASCFMB         : FYLFPELFQCBL    TUVCRVSTTKYDLHQ
MNNKRGTREFDJT   : LESVGE          EQNKWOKPDVYIRUS EJFUYGE         WGUNPAYHGTEYHVC
CUOKWW          : GPNTLLJ         YOYXUHFYOWGRHG  KYRKBHO        
NXAPQC          : WHSBBLMCYJPAEY  JXEWIKBQVE      APGEYRMXLHUGJS  FWQVQART       
FFXSSNDNTYFX    : QXFU            VOCECM          XTYHJK          SXEUYRD         NILURWMBKN     
LKYNOVEYUERIC   : VEJKSLOLRVBW    IPYKYWNEB       XSTAITJXBH      BELLWAXUA      
AUTVDAVVUJ      : RAYQXQQJULIVCV  MYLQBGYBYSK     VMVPESGIWYCFIFE SUQS           
KFBQG           : TXFUG           FPTVGYUEOQFW    VHNLQYFNI       IDON           
ESGRHCVIWCA     : HKCRVPC         HJJXDC         
ERICOGFQFDN     : SLVKWPLGWHD     ECPJGRKTXGO     EDJSWYJL        JIOCOC         
GYWJ            : YIDLQISQCQ      TAPWATDVHASW    SSAXTXTCXRJIAHT HTUGSWYGWRVQAW  OTALUVNQCPBJPO  VBFWUAFIKMVGMCL TQIUNRVPE      
FRVXAPHDNPC     : HSOLVOMWFQTOCKO IEYUEPU         DMJRCSGMTNWP    LUQRQAWTG       NVUOXUEAQCVG    FIGVPJBGGM      FJTFFWTBUYJCQED
SMWMUY          : OSQM            GSJEECHUYUHIVS  RCTB           
DGTILKASLYEDE   : QWOAGVQBTTDCD   TRWFPXRPQG      SJNYIRXTRRJGA   WDKDRMGKGRFVHD  DSXTXKLXCQGX    LBDDNRNYNU      FSIPVROY        SQGURUOMDVYOJX 
DGTILKASLYEDE   : AIHCMFSJLR      NYSIFOSHLTXRKHL
BEYQLCEDG       : WDKS            TISLXFOXPIL    
XSSLPTOV        : XADFSGUMIWDJB   WUQAS           AXWTGECYSOOJJRN
LEMVEHHFOMJ     : LNTTIPQUHMG     TSSJ            CYMKVHP         YNGXYXTTYKNOXES DNFMSAVR       
NPLGBPKHW       : KWIHLKJUKCGX    YYMIRMDHU       QYMBKX          BDBECHHVA       GJVCBVE         SJUFBIVBHIL    
FRDSKYKGA       : WCMFUETIRXM     PBIUPOOMR       PJVRPJPA        TSDVBJGJTUWM   
KPTRYDYNRJBF    : UVFGFN          GPNTLLJ         RECSCB          GHQV           
OLDFXMEITXLPILA : IANDPOFQJ       UDMQBAG         PWHKTPVOVYRJWRN GBFBSRCOINPTVW  BMILHVRGEUJR    KHNTXDFO       
NXCFTVFYUUQG    : SMKJHKT         HLHHLBLIT       AOXLMNRN        JDIRGUIRPDGW    WITWHFTXKYKLDJ 
XINJN           : CPNJAXKR       
JABSVYGLKT      : XLSDLQ          KKNWULEFKEDWC   FYLFPELFQCBL    TJSKDJGJEXSSEOR HAAMHNKTBKC    
BKLFPHBWGYUWHS  : QILA            FQWSDOW        
PGGDDSFENCGV    : AEQNTGWWOAOSX   JPFOUVLRRYWABL  YPGGRWNIWIA     VHNLQYFNI      
QSCRDNXUXBUE    : JQDLDKRAJG      OOFXMBXTG       IBOTMAQMRMKUWBQ
PEKIBCRIIWDNC   : TLQHFXNSPIRAV   ASXIIYRV        TFECFHQKKXTL    DKBF            QQHLOSEGJYS    
PIOGBHKSK       : TKMNELU         UUTTDMOHDDMNC   JUXMLPXXXEV     VHYHLJJBIWXJ   
SIXUDDYSHJ      : OKJMIKX         YYVYNWHWJWPTUJP DEDRXUHI        WVBLIEJJTTI    
IOUS            : XIGUULIFV       TONO            GBGLGPJ         LEOJITHR       
UXKWQDHGLINVDYV : KVFILXAORSTTV   CRBNKLIXOHQ     HQJOOLTRD      
HURMAQF         : OMAON           UVFKNN          GGVHP           KTRYEXBQCLCGGPV
DKRRINQDLB      : OSSIQRLS        XVGVHST         BLBO           
DGJJ            : DSLUVPNQDSFL    IMDVEJVRPMVLJTY
RWPU            : CLTJHJNAGKMLVE  QVNGGTGRXRBQC   VEVXQA          LEGJWEBOTFUDA   YGYG           
OTHJLVJFDSKOME  : SPTICX          HOIITEBWYLXG    IHFPLWGM       
AUAOXERF        : XBDYQISGVKILI   IVCDSFRABICFUJB LPPEGIGJVJITYQY HJVIRTSTMV      IUFCK           XYLWJHGADUPTF   VMROMDNICKFUM  
DYHCREDG        : PPGM            BFLK            EBJOEU         
MRMJBTMVEBIKAL  : TJFE            QNLSOJPNAFDN   
CAEGTLTWMDBG    : TONO            JKLLVW          JULUJPUIQ       PMLAXFUCGECMD   IQPOBBLHHOODLEJ
EMHREVDHQPDWRO  : VRDUBXYCJ       XQXD            LTHDWC         
TAPWATDVHASW    : NRTRAPEQF       WJCUCWMBDUUBHBM GYWJ            VWXGDV          HWKGSSWB        WXRJKOOBQOQVAGS
VDNDQWUWTX      : ONMNBLD         CMXFJQFO        QVNRGJJH        YBNJHDSYJ      
MPMJJBT         : UCVWH           KWILBK          QAPA            SAJHLFEWLGBXIOC OQMCQF         
DKBF            : DDQTSINBMCOD    EXLEEH          MXYJEMSRJS      PEKIBCRIIWDNC   CSJSLSSPHQV     FWKMCJIF       
GBQIVN          : WJCUCWMBDUUBHBM QYJXW           TQIUNRVPE      
SQCVJASJVSQ     : DDFNNUKAOSRYMV  CRBNKLIXOHQ     IUJWV           UTUMF          
IFTSHOWMY       : PQKW            JUJIEPJNNE      SWWDHLMLUMVPS   APGEYRMXLHUGJS 
SHIVXRSNGNFIJQK : AEQNTGWWOAOSX   YKHXJTTOJU      GJCCRGQDDXD     WVBLIEJJTTI    
AGWSOHYLAIA     : NHEXVPFHCAMY    GVDQFPJWAGWAR   DNKETV         
WBBRIKOJC       : GKWYKEXWJQI     HQRMRYS         PDSXVN          DCRVLRPULL      RWIBSVOEHXAB    SWEQX          
WKUESGXGMA      : UKELVJCR        LUXLTSMF        DXWOTYGKV       NYFSDWGTRUGBR   YWRBGTVEAH      QUQFWRVX       
JTESUPTFPU      : ADSLVIUS        TWOJESCTBQEYCG  OIEIKDEKLAH     SCBMSLNRPEYDBN 
SWWDHLMLUMVPS   : NWES            IFTSHOWMY       SBQXCKFUKIACVI  IRLTX           QOUQUIRDQOPOT   YKUMW           VDDBONRPGEGJ   
XQWKRMVLQOIG    : ATMGWPNNDJXFAS  OPASV           DNFMSAVR       
PXGTSFQVO       : TWBC            MEBVTFOB        EVKVYFWVTRMIFAA EHWQSC          GILSSU          VDIFM          
LAWXXOQQ        : GGYAAJHBBQNGX   RECSCB          SSACX           UJPVP          
KOYCDW          : UTRXEGWSCABX    SIEMBF          CDSOWWBQ        WUQAS          
TMXC            : QGLUYV          TRXDUJNXUHMQB   MGNMJJX         OVRHPEW         BKCTDKFD        TTCITLKJRRKJ   
NCFJUMBQBDE     : HHVKKPQAOQWW    KJSPNPMR        TECIUM          FIDL           
DEDRXUHI        : BBSFYPXFV       DHIX            ELUQXKINHPEB    SIXUDDYSHJ      NODAPAYLHNMNV   TTJFCDKANCMMUYI
IKOIAIWXMVNOEWJ : XADFSGUMIWDJB   NKGYCARLN       PWEJLG          DRORTHSVTYFQP  
ACSEJX          : PPRFVXXDBCRIB   KTCKN           CONKLEBOD       GKBGDVLQLXURFDM
NCBLWKTIVEWGE   : RPBTSCADHALPC   LWXOPTEEM       OCCKXRFRTK      YEDLF          
DETYTKDT        : MQBNNFFWPJB     YHUSOBWUSHMH    ADJEK          
UTAPAJPJXRNLQA  : FPFSV           ATCM            UAVLQQUAN       OLNNUDEIGAXMX  
YVMXETHHXDHUNKO : CMXFJQFO        EFLWCHPAWBLOYT  LSMN           
HIMYJVPS        : MBMCMQGEKFHVH   DCURTJAOQEPK    IJNOALWAYSBRIY  KSJOVTHHFOMIKL  AYGUCXHADVLB   
JIIBJO          : YVJSUNJJIWIVWN  OHIKEBAFJCQYUQ  WWVCWJMKUETOV   IYDSWLGUEE     
HBDMUK          : MTTLJB          SIBLULY         DECIRCUNC       ICJFAHDDVGWIQWJ
VQBQEOHQXRFAB   : NVKTM           BIVCAH          YJCETXN         FSERVOPUMHB     DECIRCUNC       YVJSUNJJIWIVWN  HJGQGYUW        QDQWNKHBJ      
VQBQEOHQXRFAB   : VULMIPUHK       UIHGOLSQRCFSAX 
RWABFICQ        : GPVP           
HYCKLAWHXN      : HDFMVSAUI       ASRDRCYJQEY     LUCORKKMHQNBW  
QUAXNA          : IDQIFOQFV       PAMVGIJWUJT    
SATVR           : DUOJVVKLWV      EGSQAIGREFV     WVUIMGCIKBJR    BDLFWL          IXRHOY         
XVAGARHHQM      : KVOLXRELBKSYKXW TGVRTWJXCJ      UYOVJKXLQWJWVYU OWEPWHPXB      
EMRLKHWDEYBTASM : SFMQNHXCJIJGXC  KKAH            XDORJ           ERHR            OHDDXFCFNWKDFRN RVGWYQDQE       SIWKTDFTWWFRBS  NXKRTP         
MLWHJSISS       : UODHIKNCPCFXJJ  BERULFOFPAR     QPQUF           HYIX           
CDSOWWBQ        : YQDOA           KOYCDW          DKFMJYNVBAHDN  
NBKQFLT         : DMENNGJGNJAYAE  TXCNCVBJTXH     HWKGSSWB        YAEH           
NNOQCCPMOIUJDUL : VNKV            VMVPESGIWYCFIFE QJJVFEW        
PBGM            : PVXEAUXMRNQK    IPYKYWNEB       WTTOCASCNVEKO   KSKFWGBBMFJUPG  EQRMAUVLR      
WYUXLL          : ROCSBHNS        XJKGHGGEGYHDKAY OCJMLFH        
XIILXWECCTOQE   : KUJKUOLHGTDFKM  QFDEXYPJAL     
AIGNQVOWKVWMQU  : IKCIHYBMRHE     XEJAQSEJQF      YQMXNWLWBLUDTTA
CDVML           : GVDQFPJWAGWAR   YRDDJMSWRHT     XHQWLKT         TGVRTWJXCJ      AIJDWTOHTGPMLS 
KLONNJ          : RNPDLOEFDG     
GPOIXWVPTLOGHLS : XWBHWBPTDJJAA   JLFOV           YYIXJYQBP      
JTCMRRB         : WGCGHMPGHUOM    BEFNWWVTBKSAHW 
CMRR            : UOBJO          
DWKSNSTK        : WHAU            TBUJKH          LQYMKJFIRW     
LGCAPL          : KYBOTRCOLQRG    TGVJDBEQTWG     BVVVMLHVPL      NIVXO          
KLVE            : FYGYJQPG        YIEWLUN         YRUHAMQIMRRUQD 
KWILBK          : AHESKFW         MPMJJBT         VLQT            TSAFEBNMQRXJCWY
UFCA            : GVDQFPJWAGWAR   UJNKGSBCHFPWPJA KDYDEN          FFYJWLWLM       PRKMATG         UAAAKXOOCCMW   
OVRHPEW         : NMVBDM          CGFGHR          TMXC            YCAXBMDX        VEMEKDXWEEEO   
LBDDNRNYNU      : LMJHBWXIQ       DGTILKASLYEDE  
YRXKULL         : OTAY            AGBCFOSF        RTCVV           JWIGSVKPVKJQRKU
QPQUF           : FWUQH           GIOVWUIOXHKFBBP MLWHJSISS       XSVRNLCKWLYIVU  BDYAW          
OOESNJEPNHDFXE  : UQWPWAJR        GDJARTIHWL      VNXAK          
SUUMUHHGUAYN    : BVVVMLHVPL      FORKOSLUHNVG   
VUIKJPEAYKPOSUU : JUJIEPJNNE      YIEWLUN         AIJDWTOHTGPMLS  LHMEULMDXLKGJO  WTPPDKWGUTJ    
YSLVPX          : DQVJOFLAKUAPQEB OTCURHDCNAEFN   GGANY          
WHAU            : KFGSQOIF        DWKSNSTK        HGDEQ          
AKEXFMJQCN      : QJQM            IUMCUM          OHYIQWQ         FEJTR          
EXGSS           : HHNMGUOPNGXIOKM FHVYRJTHFAEACK 
PLFIYBXYSXH     : LLVYQPAU        KIDKBRGBD       EHWQSC          LVJNWGDYDYYQTYD HUDXJLAUQ      
URVFVTKIFB      : UBVUYGQJIFRCY   MQRKMODCCHMY    YQBGHDVKW       BGVVQOHGTPMH    BKMJK           LNFCH          
UUTTDMOHDDMNC   : UTUQIISABGWSAAX ETKEXVRWTLPRB   IKADWOQD        PIOGBHKSK       XTYHJK          QVVFSHOSKYBDG   DDFRMQUDRMBOAW  JTWMFVQ        
OCJMLFH         : BIXCYJB         LPUAAPXEEX      WYUXLL          FXMM            SMURNYWJW      
DMYYY           : NPIWEBISEF      XVGVHST         KKQQREQLPXYV    BUCELSQA        NEHQBDJPBUV    
FCYAWSVBG       : RJXFFSNLYPPG    DSLUVPNQDSFL    TJFE            TXWACW          HTBQA          
ILQUBUKPWVEK    : NUDJ            DEPVBQWCPVWFB   QTBHXFNYWQECP  
NNGCOGBBNEAP    : YQDOA           OTUFPRHTDUOGLSM NILJVQMKXBDXXWL VKFTN          
VOCECM          : RHTIWFTHEOISGK  IJSMCVRCHDMAVN  FFXSSNDNTYFX    HAQFG           CLUQ            ABXVWNNONNL     PYEGV          
UJSPWL          : SHFBRDEWGXQDDIE WMEBUXYEVU     
SPAWGQDIFLM     : GWEGHMSO        TMAJOMAULFER   
BQJTTHIYL       : WHEGD           YDOGXASN       
LDHVVWS         : YDKBBEJPIKR     JKLLVW          TMLCGYYR        BOGSQX         
ONCPKIG         : IATCI           IKCIHYBMRHE     EQBPFPNE        OJREWQIPTB      DGHWPGEVNSQFPJ  TSDVBJGJTUWM    TTDPW           YFPWEXBCBHA    
SNCFWEVIXQ      : OTBJPPR         TFMHTXNS        OPTWVRXL        HCJYBQLV       
IPBUDEEBCD      : WGKVKEE         YJCETXN         DWDFKIWHC       GLRXLBFXRV      GCVUUNQXIOJGC   XYPAHWNFBHYCY   SAHTNXBGX       HARFH          
IPBUDEEBCD      : QJAXVLJWKYXVNM 
MSIOIU          : XBGPEIMYVWTF    RKWQ            WIBO           
QJREOX          : WWKFRXYBRWDE    XYPAHWNFBHYCY   KKQQREQLPXYV    TFDOLUG         XWJDJBRMSUVJ   
SVJSOBBGCVKIALL : MXRT            CQPYFX          IRBCHKQVSP      QUKTA           PSAKPBOFAXTM   
IAXSQGNPWAHCO   : LPUAAPXEEX      TEMYTKXFTE      VIXHBDP        
FJERCSSDA       : TPUPW           NEKPBYTHTOI     NKGYCARLN       TQVQTDRKTT      KSIGHAKNDKEGIRU GLYJHJQIXA     
BMGDXRIITHBK    : MSHTTLH         VOWLLCRJVBSHOH  MDDIJASDYCPNLAI CIDQYJVG        NGDPIYKBY      
RCPRKTITYRXQVTM : BBSFYPXFV       AUTPMK          TNRWKDERNWIUHR  PJJBEWNGA       QTBHXFNYWQECP  
TICGQHG         : JXUGKS          JLPRKUO         IRTI            UIHGOLSQRCFSAX 
PPFYSSPKU       : BMMONUIH        DTDTO          
CHBM            : EJLY            HYMXLIUSQPQ     KGGLPDDR        YLBCMV         
AGCTCVGDRQFAHMH : FYGYJQPG        ETBJMMJSV       LESVGE          MWTRGGCYLC     
FYBERTVDO       : TCHPCDUJX       DUVBMNY         BOLXXGXGLPKF    CSJSLSSPHQV     FEJTR          
HYEUB           : FPDHIJI         SXCKSKBBITHBB   NYAIGKFHMLSTR  
BDBECHHVA       : AUUQCS          NPLGBPKHW       FIDL            SUFOEVLOO       NAATWKEF        VLKPJR         
WHEGD           : UELJJP          ACSDFCSACMHX    HYAHQFNWJT      BWXVS           BQJTTHIYL       GJVCBVE         QVNRGJJH       
FEOWXM          : QSSSK           SXMWVOKKWNXCTN  KSKFWGBBMFJUPG 
OQKNUFQCIWFOY   : NEAFXTEEKELXO   XFLTLXPYVHAM    WEPRT           VPGDFGEIR      
YUOQTWUACFFGVD  : NCHKQLO         QSOSDNSOGYD     ETPVVUXU        KQCLCXYK       
IFWBPLYWE       : SIBLULY         QQHLOSEGJYS     IYTQLEUGDSSB    TJJLXVCPW      
IBJY            : ICYALHSX        IPOVKHHDLRQ     MIONUIYYBIC     FLPKDGFIU      
XAANQTKM        : XOXQXGYXYUWEHSJ CGEPTHOYOE      FNDBJGBOHOYSPV  SEFH            GBXR           
OTCURHDCNAEFN   : HLMSCW          MEMMMAFVDNVOS   YSLVPX          GLXISREMVA      IQPOBBLHHOODLEJ
FSIPVROY        : QAWJJUJXSUMJFOH AYUUEVYG        DGTILKASLYEDE   BRHYFDTRKEK    
PBEIUQWRFSUCK   : YQIQOSYLNL      QFNWROYLGKPOMF  YKUMW           UIHQK           UTUMF          
FNTHTA          : CYRVDPJKWSTU    GYJELJSID       TLQFJYPJHCY     PDSXVN          PIKCT           CRSIXG         
YHQH            : FWUQH          
OANPSFQW        : QROOBCFDAOYWTW  MGWSERXUICM     HGRWRUDAIRNH    LUJGUGYCCHMIG   LBLMYBLT        PAMVGIJWUJT    
OPNGUHDYRIEHC   : GVMODOHDAJAQWLG OKUJCJSTFE      KPYBXRAIPKHNT   DSCJ           
BELALEKKTKYLF   : EBBAACE         WAJBMLVQEYWVQG  BHNDLYSR        OWEPWHPXB      
DCURTJAOQEPK    : XEMIP           MUSGXPUPRJ      HIMYJVPS        RUHYRJDUTBNP    EMRGHVJ         XYOQX          
TSSJ            : LEMVEHHFOMJ    
AVYNAJYVVAIBGLF : UELJJP          GYGMBUYHOV      DIFNBFRF       
FYLFPELFQCBL    : HASCFMB         JABSVYGLKT     
KIXGHLJSMF      : FWREINRVGB      QVNGGTGRXRBQC   ONOPMRJLNUEYYPF FIDL            NJGBBVVOIFWQ   
MPPTDUXIVLQ     : TSDVBJGJTUWM    ECDDSFVIPDKFS   INGYERHI        HHCTEDCELFQXDLM
REQIHRUFCFFLOSU : MCUMRSKXSH      UJCVFOA         UNOXK          
GCVUUNQXIOJGC   : IPBUDEEBCD      PEGMOTVQQ      
RTGIDPCAWGFERTX : WKMASGHVJ       GKIKMMIX        YVCINDOUXIJKFHF CGKFRI         
DGRYBOMU        : QXCCHLTF        NDGRHBC         JWCSYODEAPEC    APSMNUFKL      
WLXDOAWKJHPYJPY : VSDFFUOOIHHGXJ  XJWMWT          YJGREW         
WDKS            : IKNWLTHPIRC     BEYQLCEDG       PQKPWWIAFPWYQSR DMENNGJGNJAYAE  NTINDLS        
YVJSUNJJIWIVWN  : YYMIRMDHU       JIIBJO          VQBQEOHQXRFAB   LSPUYH          EJMGO           UTUTSHDP       
AKXJ            : XPFEFCGNRWSHUK  LLBHIQSFOLTOW   PEKVTXJPRXCG    EMRGHVJ         OTALUVNQCPBJPO 
NKDEJ           : UTPVNWFMK       QYXWU           ECOIHPTO        PIWULWYFOOPJBEV FUXAAKDNFONHT  
DPIWSJSDFQQOCYL : KNIHYT         
WLBKLMIWGVH     : XSKHKEXDUS      WWOBCSXTTWNDI  
CTIGLQFEAXHFQXU : NWES            ILQSYQTMPELS    AEKJ           
YIJWVKHHYR      : TGVJDBEQTWG     IBTSDRWQQT      MFQEQHLGIF      TQXNJK         
GNOSSKDYVVG     : RAYVQOVXPOCO    TEEEUMSPGO      AJNIPJUTXRMGS   GTACOCSTEYD     TUVCRVSTTKYDLHQ FOPSWKLDYMHWJ   TBLJPTQRIA     
XEKGXIDTKN      : HCLDCROQ        EYRUH           MUVCPIXRHTTMTT 
JKPSTPKYXA      : VFWU            FVDXJJMUSKKHRWF QENWFLPG        EVDGGAYQAYD     RWMKCF          UIHQK           FOOYPGAOHGCMDII
SSAXTXTCXRJIAHT : CDSQ            CQPYFX          GYWJ            DEKMWVJXUVL    
DGRIRCAKVPWWPWM : CUPHGPH         LTVIITLMSAEFLSW HDDTYDBXF      
SOIOMER         : CKGR            YIFUMBSPPLA     KBUB            WXRJKOOBQOQVAGS WUQAS          
YBXY            : DWKGFKQOFJITNVF VRDUBXYCJ       GBESPAX         RYSCJRQO        HRYUTHTUYWKGG   VXDNBTKKABT    
TDPAUXRWXE      : RQSGSRGMDV      RQDJHXDLRUKY    RBHR            AOSNYOQJQY     
QBSIBHTVWEKLL   : SPTICX          KMMTCWM         BDYAW           FWRELTODTYH     AFBNK           HHCTEDCELFQXDLM
YKHXJTTOJU      : SHIVXRSNGNFIJQK QENWFLPG        YOCEFNS         VMROMDNICKFUM   WFEXNC          PRMKYKQLTXPSXOQ GXSXYYJBALVQH  
HOIITEBWYLXG    : QWYPOWVHJGECAY  IPOVKHHDLRQ     OTHJLVJFDSKOME  XFKDKGCDBQV     BXTL           
TFMHTXNS        : SNCFWEVIXQ     
XSVRNLCKWLYIVU  : OTAY            OATIWPMJGE      BQBMLNKIVRK     QPQUF           STUSCVBCLIH     EURQDDGU       
WSNLSVSPEHWX    : VBQIAHBVRKUVI   BMVUVNUD        KMLDFIGRRDYRI   UHBVSGIF       
MQRKMODCCHMY    : GUHYOUOC        URVFVTKIFB      XTYHJK          TJJLXVCPW      
NHPL            : PGUPBGKNYFUNIH  EWHJP           XQCFLCYLOQT    
OGLAYIVOO       : BEAAMXPAPMCUFP  GBESPAX         NIVXO           XDNEGCASA      
NMLBFDNRTQTVX   : OLEHXSA         XQXD           
XTYHJK          : KKAH            FFXSSNDNTYFX    UUTTDMOHDDMNC   MQRKMODCCHMY    VMVPESGIWYCFIFE
ASRDRCYJQEY     : HWNSKMRBCTXIJR  RLLGUGTLINSVAYK TRWFPXRPQG      HYCKLAWHXN      AMMGVXAPIFJGRUK AYJRLCQIDX     
PALVQDRH        : UAAGSBOPTEG     MXNTGPQNYK      BRHYFDTRKEK     JQXCWVM         VXNBFDWRVUHWV   GDJARTIHWL      WWEXUPKD        FRMREPTJHSPHTU 
QIKOCJXNVEPOYS  : DFXSPVRBAFUTV   NIOCKGYSKI      JMYOWDRTHDL     VEJKSLOLRVBW   
DTUWBTCQWNO     : GOJBVELXUXYVCM  TDHAUVYTBFAYJ  
THUTXFEOHQMW    : KKQQFT          PUPUCIONM       FJLPHLAKA      
TNESIPVFKSGEXYB : MOQJRV          YKDK            YXJXFOJWK       TBTSVTTAA      
OOFXMBXTG       : PJJBEWNGA       ACFQ            QSCRDNXUXBUE    MRABIKIV        XRLJEPKUUUPULM 
CYBBNUOTPAJM    : QISPJKNIQWAY   
VHNDFMGTD       : MUYDET          BKCTDKFD        HUTRKH          HJVIRTSTMV      BQQLFELWBS      GDJARTIHWL     
YDKBBEJPIKR     : JJMMOUTMGEMXQPS WEXGWOUDENBNPB  MHPREYHCT       LDHVVWS         RSQTIV          GYCVGWUTOTQK    INED           
XOBUFDGTIDDX    : EBBTVTCEQYCASQF OQXB           
LNMF            : OLKF            YRUHAMQIMRRUQD  DATSPXJROWFMU   HJVIRTSTMV      AXTBFXX         YGHAXJCUHYLLR  
KGWWJX          : HXYPXUITLIJYMN  KTCKN           HNAQ            RWIBSVOEHXAB   
SOODIBEWDYEIHXT : VBQIAHBVRKUVI   EONJYPXW       
CRSNFISYUBXSLV  : DEIFVD          SHOD            SOEYYKWJ       
GMNMWPQWU       : KEVXNQXTJFORT   EONJYPXW        PWBHH          
BDYAW           : QPQUF           QBSIBHTVWEKLL   IGSCYQHVDPHKIEA CFCO            HXICVOJCQMGVTLW
ERHR            : UVFGFN          YWEEIXHKFR      TMLOAOVE        EMRLKHWDEYBTASM
PMALPXGB        : WCMFUETIRXM     SIBLULY         TECIUM         
FIJSU           : BFIPREIDLPRY    PJVRPJPA        QQQNPUNWF       RVGWYQDQE       QDCARR         
KNGH            : OQXB            NEKPBYTHTOI    
HNGJ            : BRGQFSSECRNFAYQ LOKNB           GUDXHGVK        EKCEDTDJQTYELD 
UPEDJES         : GLQRKVYYJQSWV   BKRBGF          PHMYRTXTCMBUPX  KYEYIK         
GGOFMPC         : CQYULQFFSMWUQU  FRXXEX          JQDLDKRAJG      GOJBVELXUXYVCM  KNIHYT          ABXVWNNONNL    
ANNUWAKDKRNXBY  : HHVKKPQAOQWW    XAKSOUNXAYSTEA  QSSSK           DKQVVGXJCKLEVO  FNDBJGBOHOYSPV  SEFH           
VRRBBX          : MPEWX           PJVFNJL         WKWLNTEKG       HAAMHNKTBKC    
AEDOJQGLKHAAEYD : ICYALHSX        UBVUYGQJIFRCY   MOUGVVNH        SUYATTARMAPD   
FNHSLITVHL      : FEIR            YGPSNJ          MDOUHHIGIYIT    OUHWIHEMWQ     
IPNFPSLGECOQOV  : OUHWIHEMWQ     
RDRUSWICRT      : JDIRGUIRPDGW    VDDBONRPGEGJ    PYEGV          
ORUCI           : DACT            XYEANVBHFTVRIV  MFSKP           OPMM            DSCJ           
RXNH            : AFTIFNULKAUJML  UAAGSBOPTEG     SUFOEVLOO       YVGVYVA         DIFNBFRF       
YPVDFOTBHLEBGYB : XLTGHSTNO       TWOJESCTBQEYCG  XDMQRVYBPHFSG  
CUKRJFMMN       : FFHNABMYI       FHVYRJTHFAEACK  UTUTSHDP        OGNGKJXHNUKRPNA
ENHOFGEDLJRGLB  : CFNBRQVBLHWF    CEJYTGQI       
REBTFPXBDPMIEY  : YPYJTWO         NYIAYRIHL       YIYV            UPUTHKYL        FVUMONVTMUHJE   FUXAAKDNFONHT   HRPGCUJIPKNFC  
XGLGUSOYVBJPJ   : EDUTTBRUNWWD    KTPPPSXEBWDTPSS
SBQXCKFUKIACVI  : FLMBGDSYBW      JLPRKUO         SWWDHLMLUMVPS   GGYAAJHBBQNGX   BORHSRQTQC     
WIFDVNXPEX      : PGUPBGKNYFUNIH  JOLBGHUDDAAP    UYOVJKXLQWJWVYU EQDALYS        
HJGQGYUW        : VQBQEOHQXRFAB   ANMWYKWQLADPBD  UNUYOYMKXSBVBH 
YKFVWNVAJGG     : AFTIFNULKAUJML  QBQAVWNKOL      VXDNBTKKABT     XSEKR          
ONMNBLD         : KFGSQOIF        LAUALVKDXTHGYAX VDNDQWUWTX      IUHWPSKDQOE     KGVATQTU       
LSPUYH          : YYVYNWHWJWPTUJP YVJSUNJJIWIVWN  NYFSDWGTRUGBR   NXJNMYFUIOJYPN 
YCAXBMDX        : WBQMSJYQDVXFYR  OVRHPEW        
TVKFDQOTHCH     : UAAGSBOPTEG     BNLOVMDLIJI     WSNOQAXFIUDMI   XAFHN           VMHF            IVVGDWNTN      
NMQYGJVFQWGUY   : CHQNOI          ASXIIYRV        NRKMYNVUWJYOY  
XMKXYGUJMAC     : JRIMHMTUDHJR    XPYFIASJMLCGSXH XVRFU          
TJFE            : DSVHQUEWYOWGBFB EQBPFPNE        AJNIPJUTXRMGS   DQVJOFLAKUAPQEB MRMJBTMVEBIKAL  FCYAWSVBG       RADY            WCQYVPXOR      
UQNVYW          : DSVHQUEWYOWGBFB
HPQNKQULFIJEO   : PGUPBGKNYFUNIH  EEVHVEWY       
NDGRHBC         : AFTIFNULKAUJML  DGRYBOMU        CLUQ            GVTKTQXSAVLID  
HYIX            : OGCEQDLCWWB     MLWHJSISS       KTJHUCILVTG     TISLXFOXPIL    
EAMYHCPUPGSBLB  : QILA            UMLLNJGURILQ    BLOFQ          
PPRFVXXDBCRIB   : RYWIIBRADXD     ACSEJX          ICJFAHDDVGWIQWJ
JPHJCIS         : JOLBGHUDDAAP    YNBLBEMEWBTUFDF LUCORKKMHQNBW  
XPYFIASJMLCGSXH : NPLUDB          XMKXYGUJMAC     DEKMWVJXUVL     GRSESFWNSM      CGEDMSJ         CIWYBHQJ       
DKUUVVXF        : AXFFQUISO      
HQSPLCNBBUKDOV  : MUYDET          JMQLNHYBDPKUDM 
CXYUXIOBTJYRIW  : CRUCJVUHCUHCRGI XNEFBDQVR       XHQWLKT        
WEPRT           : OQKNUFQCIWFOY   FLPKDGFIU       WBODQI         
UJCVFOA         : WKUYSPMJRHRIFY  REQIHRUFCFFLOSU IUJRDQHPLVBYKLF
LUXLTSMF        : WKUESGXGMA     
PBTO            : QYLTD          
CNRYR           : ESIIGWEGQL      QMJYCQRDA      
QNKNXOKFG       : SRPAOM          YRIAOEQXHN      EWYDIEBYGHPEL   MKNBOS          QUKTA          
BRHYFDTRKEK     : IKADWOQD        FSERVOPUMHB     FSIPVROY        PALVQDRH        UCNKIJOQQOPJOPO IATDR          
XYEANVBHFTVRIV  : LTSWUM          ORUCI           DXWOTYGKV       OMWBF           CRVCJIKUHCS     CRSIXG         
UBNJCHSD        : AOXLMNRN        NKPQUXYWNH      XDXYRYNE       
VYJHDTUDUA      : AMIAGDO         EDPT            ULRQBTDCI       SDLUNFMDES      YEDLF          
KXIUEFSVNOFKRU  : EGSQAIGREFV     DUKXECJUBICTPRM GPCDYDYC        SJUFBIVBHIL     RHLPNTCMQLHG    TJLCKVF        
TEMYTKXFTE      : HKCRVPC         IAXSQGNPWAHCO   VFWU            LUCORKKMHQNBW   XRKGKWRV       
PJVRPJPA        : NRTRAPEQF       MSORKAPXBFJQE   FRDSKYKGA       FIJSU           QVNGGTGRXRBQC   OIMDTOWG        CLUQ            QAPA           
PJVRPJPA        : QUQFWRVX       
VFWU            : JQDLDKRAJG      JKPSTPKYXA      TEMYTKXFTE      NAXQUU          AOSNYOQJQY     
NCFFXYBENA      : SUFOEVLOO       PTHUARX        
YAFSGG          : FLDSULUVAOXFBKS OUDQDIL         HRYUTHTUYWKGG   HARFH          
QFCIOSKSQQRL    : RBDHRGVAMXJOO   FVDXJJMUSKKHRWF RSJP            YJGREW          DQOLKDCFG      
FORKOSLUHNVG    : OYHJSV          MEMMMAFVDNVOS   SUUMUHHGUAYN    IJNOALWAYSBRIY  GYCVGWUTOTQK    GVTKTQXSAVLID  
DBWMMPROAGJK    : PCXGLSHCG       BHYR            TWLDHXJDX      
BBSMPXDJ        : COYM            PCIDROOJUEFEV  
RCVNLJLTYOVVBKN : CUPHGPH         IDOLONBUEA      DPJIIG          FDANJG          FJLPHLAKA       JBPLXXLQHWPYG  
YNBLBEMEWBTUFDF : QQHUME          GWCYKX          PPKJBWJY        JPHJCIS        
IBOTMAQMRMKUWBQ : KEVXNQXTJFORT   QSCRDNXUXBUE    IHXPMEMWFWGLWW  LUUEVJ         
QTJRYXYVAS      : BLSIAMHHAYQBFTN UWTQESGJNJIVPPM
FYBEJFTFRVVG    : GAYNTBDMKLTX    JLFOV           HKWYBBHCKTGADKN UXWPPADJXPJD   
KTJHUCILVTG     : EQBPFPNE        HYIX            XYPAHWNFBHYCY   XFIMS          
SFTSAPABQEKVAQ  : GAYNTBDMKLTX    KAJRTKF         HILLLJ          XMILYTEB        DLYEYLBICQBHAWM
YMWMXSXHNC      : UFJTOIJLDUDIO   DDIA            QJBELO          BWEDJ          
CYMKVHP         : LVQMGOOIVD      NQCCQYEHYA      BOLXXGXGLPKF    LEMVEHHFOMJ     XAHJWPBAJWPYE   HMXRQYWMAXQF    UQWPWAJR        JPWDV          
CPHC            : FPTVGYUEOQFW    JVNSNOMHOGR     PFWDGKKQDX     
YIEWLUN         : NPIWEBISEF      KLVE            VUIKJPEAYKPOSUU TLHHRYAMCUQ    
KNYK            : MGNMJJX        
XTWCMBBBLAKBRMS : QBLKD           TFKCCBM         XJVURMS         FDANJG          DFGT           
QMBYRXKOM       : CCENJPTQMFH     SDMDVLQ         ECDDSFVIPDKFS  
BCWLI           : SXCKSKBBITHBB   KCCNBMWAOK      KJSPNPMR        LUJGUGYCCHMIG  
IHYUID          : KQCLCXYK        TXCNCVBJTXH     EMBLNLUUDUBHD  
TDIWUW          : HSOLVOMWFQTOCKO YKDK            RMNUQDIIS       MBDMKWLYGR      EJQLF          
WNFXMYWAQLWRP   : EWHQI           OKUJCJSTFE      PDSXVN          JHUMXCYKBXB     NYPYWQUIJLSW   
GXQOISLQVLLY    : CUPHGPH         FWUQH           EDJSWYJL        IUJGILQUXT     
IVSBV           : PPGM            NNJCFCPEVYDFBR  UIGOUPV        
HTUGSWYGWRVQAW  : GYWJ            YNGXYXTTYKNOXES BMILHVRGEUJR    AYJRLCQIDX     
QFDEXYPJAL      : XIILXWECCTOQE   NKTELBSQQXRFC  
XEVTMFOHO       : HSOLVOMWFQTOCKO NQCCQYEHYA      COTD            KJMPENXJCAM    
HNSEHOWJNHAUMET : DSBAIRGAUMIRXV  EFEACVK         TXWACW          RJRXPU          OQUOYDEWERHPMGD
VDPHAONWIAE     : UGFHVIGGCB      MKDRNWY         PJFN           
KSLTJEXQUUBJFDE : WWKFRXYBRWDE    NTAYTTAVLIQIV   CLRMJK          KGGH            YUBAPIFQ       
KAKGGAQ         : UQWPWAJR        DSUOQ           EURQDDGU       
OEFAHKB         : YOOWMJYWKIREUW  DOFTQACJ        QBJBXFNQC       NXKRTP         
DMNMQNG         : FYRVRESFLWFHO   VEVTBPTUQGC     NAYOTSGEMLNWRL  XSWDUUQA        TFIKGMO        
IHXPMEMWFWGLWW  : TRXDUJNXUHMQB   IBOTMAQMRMKUWBQ JPPQVCYCP       OIBQYV         
ODAQMKRG        : NOTSAMHKPVOUH   LLVYQPAU       
FVDXJJMUSKKHRWF : OWWQU           RSSJFWRSAHO     JKPSTPKYXA      QFCIOSKSQQRL    CMIBHSDC        UDMQBAG        
VNKV            : NNOQCCPMOIUJDUL KLHHTTVHVFIHJ  
EMPEDDOULFCI    : DSBAIRGAUMIRXV  FVUMONVTMUHJE   TMLOAOVE        LAPEFXBPNE      UHEJRDCHT      
BRVNM           : CFNBRQVBLHWF    UMLLNJGURILQ   
BAXS            : LWXOPTEEM       KFGRGA         
FRVSE           : SPGMFGBIUJBNS   OTSXVJMHJQ      ODIXSAEEVDPEW  
FIGVPJBGGM      : YPHFVIIL        FRVXAPHDNPC    
LWXOPTEEM       : UODHIKNCPCFXJJ  LNTTIPQUHMG     NCBLWKTIVEWGE   BAXS            OHLAKHGPRTLTEF  XNNAKTSKAX      FLRJHASFBMRUT  
GLXISREMVA      : NIOCKGYSKI      MBICHOLV        OTCURHDCNAEFN   GYJELJSID       FPTVGYUEOQFW    AWBWQYTYYQCN   
HGRWRUDAIRNH    : YQWMW           UJNKGSBCHFPWPJA OANPSFQW        IYDSWLGUEE     
CYOH            : RYGIQUJE        MDOUHHIGIYIT    JCIECU          XKWPVGVNSQIPJF 
BMMONUIH        : QROOBCFDAOYWTW  OGUD            PPFYSSPKU      
WEBSLJLKB       : YQJEUFGYJQU     PAQKCSAINV      NXNINWJNY      
NEQHRYAUXQEERQR : TCQDGQOJ        JTLKAVBFJ       EQTMYFGKNGFUKR 
GOROQQUTJGEUQ   : ANLBKRAH        YQBGHDVKW       JXEWIKBQVE      LPPEGIGJVJITYQY UNFG            LEGJWEBOTFUDA   XCUDQDWAF       OIBQYV         
GOROQQUTJGEUQ   : BHNDLYSR       
EGLUQGTQBUJHB   : EKDG            JLFOV           GVMQ            SMURNYWJW       HTBQA           YUBAPIFQ       
XSKHKEXDUS      : LNSHLEXT        WLBKLMIWGVH     UOKGUXFCTTSYQDC
FBDARLGAYCQFX   : SBBDAVCVYRFD    LXDJSSB         GBVXROVMJTQE    WVBLIEJJTTI    
IUSPWWQRH       : IPKROPRHPTPMDWA QMJYCQRDA      
CMXFJQFO        : VDNDQWUWTX      YVMXETHHXDHUNKO YQMXNWLWBLUDTTA ADRTWJQRORKE    TPUCWCESD      
IRLTX           : SEMLC           SWWDHLMLUMVPS   NCVLYUNMEEJ     HXDOFBCQOXYME   FCCEPNAOXG     
TCFBBQKV        : JNRDHGRWDVLKQPF DYJJKRYVUB      OTUFPRHTDUOGLSM BPVSJRACOVBT   
CSJSLSSPHQV     : DKBF            FYBERTVDO       CTFHJOHGMBBBII 
JBGDJXQGYHCBO   : KYHSPMLLECHC    AEQNTGWWOAOSX   WGKVKEE         GPHH           
CFNBRQVBLHWF    : TRWFPXRPQG      JRIMHMTUDHJR    ENHOFGEDLJRGLB  BRVNM           IDBCNKYCUDPHQPV PAPAMCWSQB     
EXVV            : WUQAS          
WDNIDHOC        : CUPHGPH         WCQYVPXOR       XIFSCLLCIRKRR  
SGDW            : WALKUWLMDJMI    AFYKVVSHFIHS    SSHYDPTCMMBCJ   EMRGHVJ         SOYGAJP        
KMLDFIGRRDYRI   : AEQNTGWWOAOSX   WSNLSVSPEHWX    GTTXBXQFYIDXQAE KSCKMVHRMNPAFF  DRORTHSVTYFQP   BGHLN           EJQLF          
NGJMJAXPHO      : CJRQQHMY       
XIABFLLTWQAHAT  : ICYALHSX        EWHQI           GJIELTLVOQRHH  
FUTPTIWEWIGUXNK : XRDISL          XSTAITJXBH      ATSCLWMBNL      KYRKBHO        
LSUOAGCTGTVPVR  : CGSENVHQYOGMXHF
BMMRJ           : PBIUPOOMR       XSTAITJXBH      RHLPNTCMQLHG   
OPTWVRXL        : SNCFWEVIXQ      TFDOLUG        
SWYP            : OGHDKVGCOE      OJVQAKGUGIYN    YWRBGTVEAH      CUHHIHYAGMGSC   GBGLGPJ         HNAQ           
YYPUHLT         : APMRMIAYINQH    GBVXROVMJTQE    QYOSMUQNSWJKELY
HLRJBEBK        : YPYJTWO         HKCRVPC         NBBNNICDB       VDDBONRPGEGJ   
RAYQXQQJULIVCV  : LDWUGSMSPLDXXSE FSERVOPUMHB     AUTVDAVVUJ      EJFUYGE        
BLSIAMHHAYQBFTN : EQMULVBMXSNM    MSORKAPXBFJQE   FRXXEX          QTJRYXYVAS      AWIAIJ         
NNIFNBV         : MOQJRV          PUYYOKNQXQF    
YIFUMBSPPLA     : JVUD            WYLPNDCWF       SOIOMER         ELYMHKQNJD     
AHYAJSE         : ATCM            HXYPXUITLIJYMN  EQBPFPNE        DQUYNCYKIPBN    YQMXNWLWBLUDTTA NHHN            GILSSU          NRGHGMNBDP     
AHYAJSE         : EKCEDTDJQTYELD 
MRABIKIV        : QBQOGRSKPM      OOFXMBXTG       QQHLOSEGJYS     KKQQREQLPXYV    AKAOTVGAB       NYPYWQUIJLSW   
GVMQ            : SWWKDJRLLA      DWDFKIWHC       EGLUQGTQBUJHB   QSDPEHRXDFEQFF  MYWEEEXC        EEGCR           RGHDTLP        
KDFDS           : UCLYWYFY        FFHNABMYI       KWLGDXYLMGD     QDWOLHMFARBNX   TKBHXXJWO      
QSOSDNSOGYD     : ARPSG           YUOQTWUACFFGVD  XIIDGKBKLCV     NKTKLTSUG       EWHJP           KYKGPRWXOKU    
RFYAPHXGPTS     : SJIDXIST       
XFKDKGCDBQV     : MCCCD           HOIITEBWYLXG    IVILRV          UAIDKIHQOIGB   
ERUNQBJIGKKYTLF : XLTGHSTNO       YATGYYLCBHY     XQDHYGKRVQQJN   PWFAKPAV        QAJC            QYOSMUQNSWJKELY
HAQFG           : VOCECM          DBELOCFHDF      LRUWOAKRY       AQWBWJV        
ISKMWNDSUKMR    : BHYR            SDLUNFMDES     
ESJOCTCBNNIYU   : IGHVI           BWRYXWV         NBEULC         
QDQWNKHBJ       : GEJS            VQBQEOHQXRFAB   AXTBFXX        
EETORMOX        : TPUPW           PHFYYLTG        HQRMRYS         IUJWV          
XMHTQK          : NFWKILDYY       BVCBYK          MBMCMQGEKFHVH   BNLOVMDLIJI     NIVXO           CVRE           
GSJEECHUYUHIVS  : EBBTVTCEQYCASQF ETBJMMJSV       SMWMUY         
DXATRMJPTJE     : BPHN            XDXYRYNE       
EVOPCIYGMDP     : HWHMDAVAGNTV    ACSDFCSACMHX    WNLTX          
CLRMJK          : KSLTJEXQUUBJFDE BAKN           
OKUJCJSTFE      : XJXIAMHDDI      OPNGUHDYRIEHC   WNFXMYWAQLWRP   QIUUMILFHDIMW   KLHHTTVHVFIHJ   EJQLF          
HKWYBBHCKTGADKN : WKUYSPMJRHRIFY  JUJIEPJNNE      SXWGPLBQSLUM    FYBEJFTFRVVG    IUHWPSKDQOE     DDFRMQUDRMBOAW 
XAKSOUNXAYSTEA  : WHSBBLMCYJPAEY  OMAON           YGSPB           ANNUWAKDKRNXBY  PWBHH           VPGDFGEIR       UNFG            LSMN           
OKTN            : SLVKWPLGWHD     QFIUYCW         LHMEULMDXLKGJO 
VWQGSWIXJYVH    : CGEPTHOYOE      MLJUAXQSF       OPASV           VGEDDDDU       
IANDPOFQJ       : KVFILXAORSTTV   FFHNABMYI       OLDFXMEITXLPILA YXJXFOJWK      
XJWMWT          : VBLAHESI        SETKIQWBPE      NWES            WLXDOAWKJHPYJPY GBFBSRCOINPTVW 
KPYBXRAIPKHNT   : JRIMHMTUDHJR    OPNGUHDYRIEHC   MOUGVVNH        XYLWJHGADUPTF  
VUWCMN          : XJQLLTUBO       YFLMI           GBFBSRCOINPTVW  IIMXHGVBDTJT    GHQV           
GYJELJSID       : XAFXOVIROUEU    FNTHTA          GLXISREMVA      LRUWOAKRY       LVVFG           PSAKPBOFAXTM   
SUVU            : CGEPTHOYOE      NYDSUN          FERS           
PWBHH           : QGQYQGMYRG      GMNMWPQWU       XAKSOUNXAYSTEA  KTCKN           JMQLNHYBDPKUDM  CPNJAXKR        XDXYRYNE       
VCRT            : UVFGFN          BKCTDKFD        MXSJDGMXXKDYU   GGWVOVCVGNGMS  
QVNGGTGRXRBQC   : VIXN            PAQKCSAINV      RWPU            KIXGHLJSMF      PJVRPJPA       
NUDJ            : ILQUBUKPWVEK   
XYPAHWNFBHYCY   : RYVGIBDTXN      IPBUDEEBCD      QJREOX          KTJHUCILVTG     ESIIGWEGQL      XJWYQLNGVRMTNFM
QHEKNVJHACJGQFK : DWKGFKQOFJITNVF DECIRCUNC       NRGHGMNBDP     
YKCOKLOASP      : HYMXLIUSQPQ     WHSBBLMCYJPAEY  RSJP           
RSJP            : UQINDK          NMKWSK          QFCIOSKSQQRL    YKCOKLOASP      FOPSWKLDYMHWJ   PWNMTARR       
QVVFSHOSKYBDG   : RAYVQOVXPOCO    KDYDEN          XHQWLKT         UUTTDMOHDDMNC  
FFYJWLWLM       : JKQMDHLXXDBLR   UFCA            XYHWFXUXCYI    
DUKXECJUBICTPRM : KXIUEFSVNOFKRU  NKXILYAILRK     OTALUVNQCPBJPO 
SPHYENGD        : IUJRDQHPLVBYKLF
FQWSDOW         : NEAFXTEEKELXO   JUJIEPJNNE      BKLFPHBWGYUWHS  JLBRYBS         IQPOBBLHHOODLEJ
BWEGHCHPGBHX    : XJQLLTUBO       WXJPJEBXGB      YGSKOOFY       
MSHTTLH         : XYILA           BVVVMLHVPL      BMGDXRIITHBK   
QHIIGCN         : QJQM            NYAIGKFHMLSTR  
YOYXUHFYOWGRHG  : HHNMGUOPNGXIOKM CUOKWW          ALVXWWVSIBYCVXR PCXJITTFUACS   
TAQNVDXYVHIGP   : CIWLPXESOFYCWA  GKIC            LHXWVOILYJME    WRLXB          
UMLLNJGURILQ    : EAMYHCPUPGSBLB  BRVNM           YQBMCHXSTESAWDG
DXWOTYGKV       : RBDHRGVAMXJOO   BERULFOFPAR     WKUESGXGMA      XYEANVBHFTVRIV  HIWXLOYMFQIL   
IUJRDQHPLVBYKLF : RSSJFWRSAHO     VRRCPVHFKP      UJCVFOA         SPHYENGD       
FPTVGYUEOQFW    : TRWFPXRPQG      KFBQG           CPHC            GLXISREMVA     
DILY            : QSVDLTWVITJQMP  VFFQRJE         TKKUH           YUPJHBVTCXGVX  
DEKMWVJXUVL     : UCVWH           SSAXTXTCXRJIAHT XPYFIASJMLCGSXH LLBHIQSFOLTOW  
DQUYNCYKIPBN    : SPGMFGBIUJBNS   AHYAJSE         SEFH           
FRWQSOW         : JJYAVKAPX       GPCDYDYC        EMHCBXLWAGQX   
ALVXWWVSIBYCVXR : YOYXUHFYOWGRHG  MXJNPGMSTJFARJK KGGH            QBJBXFNQC      
YEGOHW          : PJFN           
MOAGJRFIT       : CUPHGPH         CGSENVHQYOGMXHF TMEC            NAXQUU          CQQS           
HROEPH          : EAXM            CMNQGJKELFPEG   BOLXXGXGLPKF    BWXVS          
QISPJKNIQWAY    : NYIAYRIHL       CAVCOGTT        CYBBNUOTPAJM    BIAEKTG         VEPGRNAQACB    
DNKETV          : GWCYKX          SOWVAOOIBS      KEQNUCHW        AGWSOHYLAIA     MFNWVYKFIW     
YGPSNJ          : YQDOA           FNHSLITVHL      BDKDXXGALK     
TAQL            : JKQMDHLXXDBLR   YOOWMJYWKIREUW  VNGKTKFLSLHCO   YVQXXNHMAES     PRMKYKQLTXPSXOQ
AEKJ            : WYLPNDCWF       IBGFSFFGCDA     CTIGLQFEAXHFQXU KGGLPDDR        UWDGMYX        
YRIXRJTXXGCT    : HJGTFWTAWQMIVAH
XVKPOYB         : KHWLP           YDOGXASN       
UBOGWON         : YYVYNWHWJWPTUJP XFBGDT         
XHISRIMCCKCK    : BWRYXWV         NKTKLTSUG       SOYGAJP         SDLUNFMDES      TKLALLFTIFKJLB  BEFNWWVTBKSAHW 
XMOTAEKYGIV     : PWTXTWVF        NILJVQMKXBDXXWL
XFIMS           : CUPHGPH         FYRVRESFLWFHO   KTJHUCILVTG     YEDLF          
NADITMWVQKACY   : PBQXJTGUWTI     SDLUNFMDES     
QOUQUIRDQOPOT   : SWWDHLMLUMVPS   EEGCR           FERS            EFHNYSQMKQRXK  
EOSTQWCKJY      : UELJJP          DQOLKDCFG      
CJJELKXAIO      : KKCD            YQBGHDVKW       VCEBFULBX      
QHBH            : WHSBBLMCYJPAEY  ERTDSYSH        JQDLDKRAJG      YEITJDVUBGL    
SYTSFIMYYL      : XDORJ           QBLKD           EQUBXW          DOFTQACJ       
JWCSYODEAPEC    : UROB            DGRYBOMU        ECDDSFVIPDKFS   IAMDANWJXOAYF   EKSETK         
SBQCEBCWAVQHEFG : MABITSYFPBB     YVBD            GLLXHL         
QJPNNI          : BFIPREIDLPRY    IFCFQSKXNXVLQ   JOLBGHUDDAAP    NVCAR           EGWNNMGTIDE     VBIWAGIV       
ENSEEWIESKVWO   : EWHQI           ECMLIMBJLUJQNX  IMHURXYPEKQXJED MWTRGGCYLC     
AOYVFGBMOGDXVSL : LLVYQPAU        YATGYYLCBHY     WWOBCSXTTWNDI   YFLMI           FMRSSXQGHHCTBA 
HQUB            : RYVGIBDTXN      NGDPIYKBY       YEDLF          
BAIISUEQLDS     : BFIPREIDLPRY    LXUGWVLFWMHIG   HTBQA          
EOHMRTBYYY      : AUUQCS          GKWYKEXWJQI     KFEWRWMTQN     
TMEC            : MOAGJRFIT       QNLSOJPNAFDN    CHRLIXMSOOQJL   EJQLF          
CFFDF           : JDNJG           TTJFCDKANCMMUYI PWTXTWVF        HBHQNLL        
LBKRTVWMW       : KLHLUX          MEBVTFOB        LUJGUGYCCHMIG   TTDPW          
DEPVBQWCPVWFB   : ILQUBUKPWVEK    QQHLOSEGJYS     XRKVR           LQYMKJFIRW     
KFGRKNFYQPQK    : MIXEKTLQAGETW   CMNQGJKELFPEG  
QYLTD           : SOWVAOOIBS      PBTO            JDIRGUIRPDGW    MQNYWWMSCGLKAV  JTWMFVQ        
KBUB            : SOIOMER         VJEJLCPHE      
XTTWYWXLEGEPT   : HTKQO           XADFSGUMIWDJB  
OLEHXSA         : AWTQXRP         IKNWLTHPIRC     NMLBFDNRTQTVX   YVCINDOUXIJKFHF YDOGXASN        XFBGDT          PSAKPBOFAXTM   
GUDXHGVK        : OFGKJNPGXYJEAN  GHWAVJVHTEJWQI  HNGJ            NIVXO           IRSCBJAE       
VEAS            : ROVX            RWSDBRMDS       HJMOYIB        
ASTGY           : INGYERHI        BVVIVWNNL       XQXD           
VULMIPUHK       : EXOQAS          TGVJDBEQTWG     VQBQEOHQXRFAB   EXWMRKIYOY      GGANY           JCMU            CPDB           
HQRMRYS         : BRCANMHQCEXS    DSBAIRGAUMIRXV  XRDISL          IPOVKHHDLRQ     WBBRIKOJC       EETORMOX        WXRJKOOBQOQVAGS
MYLQBGYBYSK     : YIWVMQE         AUTVDAVVUJ     
SGWETGWQNHLW    : TGVRTWJXCJ      OUHWIHEMWQ      UTUMF          
GJSFEITDTN      : YUBAPIFQ       
CMIBHSDC        : IKCIHYBMRHE     OTBJPPR         FVDXJJMUSKKHRWF HDOMCDYMRG      IMHURXYPEKQXJED
AGUGFLVPASQGEL  : SPGMFGBIUJBNS   TUIEL           BVVVMLHVPL      FRXXEX          GYTS            LEOJITHR       
IVILRV          : APOVJK          MTTODPHEMBIOG   XFKDKGCDBQV     TOPPIGT         HIWXLOYMFQIL   
TKBWRV          : IJSMCVRCHDMAVN  UPFREODKXIU    
TWCCUJKIHA      : RYKHWODLTEP     GFBAQRQ         SUYATTARMAPD    FIEJRNQXWKHX   
BSQFEFOCPC      : TKOGY           MEESTBDPOGSNWFK BDLFWL         
LUNVXKPTM       : UNKAPQSLDQ      NEAFXTEEKELXO   PGIIBH          GLLXHL         
TONO            : OXDAUWKGJTDCXUD IOUS            CAEGTLTWMDBG    SAXUGWJX        OHIKEBAFJCQYUQ  PWTXTWVF       
AWIAIJ          : UYYPKCHKDNVVTT  BLSIAMHHAYQBFTN JGOCXBIFIUFU    EYUS            VGGBGG          VDDBONRPGEGJ    KTQCOFMRB       DDJKLSY        
YQBGHDVKW       : KMMTCWM         SXRPIVQT        URVFVTKIFB      GOROQQUTJGEUQ   CJJELKXAIO      YHUSOBWUSHMH    XKWPVGVNSQIPJF 
FMHGWWALIV      : DDQDNWAVH       LFRHCUOWX       DRWUUEPY        GILSSU         
YKBYKJCSUYTMBB  : CQWCLFDTKQNT    CDEXGXM         VNGKTKFLSLHCO  
GWEGHMSO        : VIXN            SPAWGQDIFLM     VGGBGG          OQMCQF          IDON            QRPUOQEAMX      SWGLKTPRMSXVKBT
SOWEYT          : GIGAQVYCKSFLAA  FPTMMB         
XEJAQSEJQF      : QNCJJHDKK       AIGNQVOWKVWMQU  MIONUIYYBIC     GGVHP          
DGHWPGEVNSQFPJ  : NDOWAK          ONCPKIG         WEWNOKP        
MOUGVVNH        : CLTJHJNAGKMLVE  MXNTGPQNYK      AEDOJQGLKHAAEYD KPYBXRAIPKHNT   EXWMRKIYOY     
EBEQTJWWSGV     : NYIAYRIHL       OXLALCBEQHVKRNY IGQUHQGEHNMRJXA
MCEB            : CQYULQFFSMWUQU  CYLBBTPUYWWVTXP GVTKTQXSAVLID  
UIMHEAXYGVUTE   : QDWOLHMFARBNX   KGVATQTU       
BHYR            : KTVGJMTXWBYVY   DBWMMPROAGJK    ISKMWNDSUKMR    CRBNKLIXOHQ    
JQXCWVM         : TNRWKDERNWIUHR  TSPWGMLBNWXXYY  QROOBCFDAOYWTW  PALVQDRH        SELSFSGFB       QJAXVLJWKYXVNM  YWSIPIDPXWFNTK 
YQMXNWLWBLUDTTA : ECPJGRKTXGO     MQSK            BVCBYK          OTBJPPR         AIGNQVOWKVWMQU  CMXFJQFO        AHYAJSE         NQWJXBONGSYLP  
YQMXNWLWBLUDTTA : SCBMSLNRPEYDBN  IRSCBJAE       
XVRFU           : VTYY            XMKXYGUJMAC     IIPTOVKTJOCOOPO IXCSIXMXYQM    
IGEGIDEUMFNC    : PQKW            JLFOV           XAHJWPBAJWPYE   TMSWNYYSOXGR    KSIGHAKNDKEGIRU
EBPBFDYIYSKPS   : LDWUGSMSPLDXXSE CLBORA         
JXEWIKBQVE      : ANHIIAOXNRHR    NPLUDB          LJIYWSJPTSP     EYILSDOJDUJT    NXAPQC          GOROQQUTJGEUQ   TCROJYVQKYJIH  
QTBHXFNYWQECP   : DOFTQACJ        EICRELJDARPBBU  ILQUBUKPWVEK    RCPRKTITYRXQVTM FEOAYYUTEEVBYBS OCCKXRFRTK     
BKCTDKFD        : RYSCJRQO        TMXC            VHNDFMGTD       VCRT            IGWPDAWS        WXJPJEBXGB     
DLCGEANAQJDAJI  : OMVJIFCDMYEBXMD HEQROYVFR       MXJNPGMSTJFARJK STUSCVBCLIH    
IHFPLWGM        : XADFSGUMIWDJB   OTHJLVJFDSKOME  YUCVVDEBGIIWRQ 
IIPTOVKTJOCOOPO : YQJEUFGYJQU     XVRFU           VAIMDEWYOALTE   YVGVYVA        
BTIKCYVLGNW     : QUMCXUKN        GVDQFPJWAGWAR   TFKCCBM         HHNMGUOPNGXIOKM GLRXLBFXRV      VXNBFDWRVUHWV   VLKPJR         
TLPFWIBLGNHPDJ  : GBGLGPJ         VXNBFDWRVUHWV   CPEEBXPLJJDVTK  NEHQBDJPBUV    
TCWCDQN         : NTINDLS        
UOKGUXFCTTSYQDC : SPDSRMBBS       EQMULVBMXSNM    XSKHKEXDUS      UHBVSGIF        YFQMHQJTLNAXY   WXJPJEBXGB      TORCEBYPAX      EDUNEXC        
JQLBTW          : JQDLDKRAJG      DEAOWMI        
NYFSDWGTRUGBR   : VIXN            KUASRO          DHJOFTOPVBWCE   WKUESGXGMA      LSPUYH          RMLIDTTY        PSAKPBOFAXTM   
GTACOCSTEYD     : GNOSSKDYVVG     IBTSDRWQQT      BVVIVWNNL       DYPYYYO        
MFSKP           : CGSENVHQYOGMXHF ORUCI           UWTQESGJNJIVPPM
LUCORKKMHQNBW   : UKQXRILQH       HYCKLAWHXN      JPHJCIS         TEMYTKXFTE     
UAYMCTGIVMI     : WWKFRXYBRWDE    CHRLIXMSOOQJL  
TBUJKH          : LXDJSSB         DWKSNSTK        OHDDXFCFNWKDFRN NAYOTSGEMLNWRL 
OXYBLLICBLCWHC  : DRORTHSVTYFQP  
VGUEQQQYBMD     : SWWKDJRLLA      DBELOCFHDF      EFLWCHPAWBLOYT  XDXYRYNE       
VPGDFGEIR       : OQKNUFQCIWFOY   XAKSOUNXAYSTEA  RKSLDYSOTLTL    PEGMOTVQQ      
RWSDBRMDS       : AHESKFW         NFWKILDYY       VEAS            FQKUGPDR        FTYXUJYUVSYGKM  TRGAYR         
LPPEGIGJVJITYQY : AUAOXERF        GOROQQUTJGEUQ  
ADRTWJQRORKE    : EJLY            CMXFJQFO        KTRYEXBQCLCGGPV
FQKUGPDR        : RWSDBRMDS      
OPFXLGQL        : WFEUY           MCNSUQKKKQR     BERULFOFPAR     EWYDIEBYGHPEL  
QQHLOSEGJYS     : WBQMSJYQDVXFYR  LMBYKOXUQY      PEKIBCRIIWDNC   IFWBPLYWE       MRABIKIV        DEPVBQWCPVWFB  
XAHJWPBAJWPYE   : CYMKVHP         IGEGIDEUMFNC    YAOJROYS        UYOVJKXLQWJWVYU
NKGYCARLN       : XPFEFCGNRWSHUK  IKOIAIWXMVNOEWJ FJERCSSDA       VDFKNUAITWNFPR 
ETRQUKGTNP      : NNJCFCPEVYDFBR  HJGTFWTAWQMIVAH PFTAVGGHQ      
KGGLPDDR        : CHBM            AEKJ            OIBQYV         
SFTBGYBXKOJRLBI : LUQRQAWTG       MYLQLUQOHIJRHCD ELYMHKQNJD      PTHUARX        
LQABHHMNNAF     : SIEMBF          RYGIQUJE        YRIAOEQXHN     
DWCXCYYKXDJ     : QRWDXJL         TFKCCBM        
TSEFTMMHGOLNWXD : BFIPREIDLPRY    UPFREODKXIU     UBCYO          
XIIDGKBKLCV     : QSOSDNSOGYD     GOJBVELXUXYVCM  YUAANJL         OBHTPMVT       
FHWCCBHX        : DEIFVD          NEVJKQX         BVCBYK          BAKN            UTUTSHDP       
VHWNSKM         : RRQKCIUDXJYAO   XADFSGUMIWDJB  
PBQXJTGUWTI     : TFKCCBM         BQBMLNKIVRK     NADITMWVQKACY   SELSFSGFB       RWIBSVOEHXAB   
RUHYRJDUTBNP    : LAGYHN          CDSQ            SDOKLSO         NEKPBYTHTOI     DCURTJAOQEPK    DCQKVQTJL       FHVYRJTHFAEACK 
KFEWRWMTQN      : MSBFAKPB        HNTUIV          EOHMRTBYYY      BLGCQVBSOT      EYRUH          
KTCKN           : ACSEJX          KGWWJX          PWBHH           GKBGDVLQLXURFDM IUJGILQUXT     
KFGRGA          : POSBRV          BAXS            WDELJYHREEBDOH  TVHDHAQA       
JUXMLPXXXEV     : PIOGBHKSK       VHNLQYFNI      
DKLTA           : FQTGAICT        SRPAOM          LWNCB          
HUTRKH          : FLMBGDSYBW      HEQROYVFR       OGUD            VHNDFMGTD       YFDH            IGNVBMILSVLJFF 
SNVYNCLLAAWSAU  : GAYNTBDMKLTX    SUFOEVLOO       UAIDKIHQOIGB    JQQJMHYBK      
ESIIGWEGQL      : OATIWPMJGE      RYGIQUJE        CNRYR           XYPAHWNFBHYCY  
MDOUHHIGIYIT    : MLARSLWOQ       YQJEUFGYJQU     CGDV            FNHSLITVHL      CYOH            UADJNS          YGSKOOFY       
LUJGUGYCCHMIG   : OANPSFQW        BCWLI           LBKRTVWMW       LTHDWC         
QWDUKILFSUPYDOJ : VAFUYIJXHI      WOEAIYBLFDH     HEQROYVFR      
BUWM            : QCEJPHWQPMCU    IMXOFRLSLRAEM   AFBNK          
RTCVV           : TEEEUMSPGO      YRXKULL         GBKFXMNP        WGVFGVJVA      
IGSCYQHVDPHKIEA : BDYAW           FTYXUJYUVSYGKM 
IRTI            : TICGQHG         TKKUH           SJUFBIVBHIL    
QFIUYCW         : YIDLQISQCQ      ESGHGSSP        HOVHNOCUJ       OKTN            DUIDEAXDIRAWJ   VPHAOISSTWYC   
ALII            : HLMSCW          IJMMQKVSSFHL    EEVHVEWY        PXLWRHXYCQNG    SNWODYGMXTL    
KJVRGBKPLUUNFFF : GWALTVNIMODUMSY PCXGLSHCG       OVYVHSSEH      
NDTULOVPOTRADAF : ODOTQFEUSGQSEF  OMWBF           DNHTAHK         KYRKBHO        
JDIRGUIRPDGW    : NXCFTVFYUUQG    RDRUSWICRT      QYLTD           PHMYRTXTCMBUPX  GBGLGPJ        
NAXQUU          : NWES            WMEBUXYEVU      VFWU            MOAGJRFIT       PUPUCIONM       VBIWAGIV        CUABYR         
JQTANLDQLK      : EWHQI           LUQRQAWTG       UTUMF          
XQQP            : PAQKCSAINV      ANMWYKWQLADPBD 
LAPEFXBPNE      : EMPEDDOULFCI   
FYKJKCGLPRQIGBO : RGIIVBE         BYTP            NHKSNWSNECOVK   OHYIQWQ        
TGVRTWJXCJ      : NFWKILDYY       SGQAAUV         XVAGARHHQM      CDVML           SGWETGWQNHLW    MEVNWBIQW       VBFWUAFIKMVGMCL
SWGIEFTOPX      : WNEO            JBSVFJHFHQE     IUJGILQUXT     
DPOVXWAOBTWAL   : DGUYQAENNCWKX   IGNVBMILSVLJFF 
YWRBGTVEAH      : JKQMDHLXXDBLR   YIML            WKUESGXGMA      SWYP            OAMUPPR         YRCCCVSQW      
HBYXBVD         : SWWKDJRLLA      GMBAPRJUPN      IVCDSFRABICFUJB
NAQKAHOVFOKYP   : JLFOV           RADY            VEVXQA         
QQQNPUNWF       : FIJSU           GYCVGWUTOTQK    GGWVOVCVGNGMS  
AHXD            : CHNODNXRTMHQWLJ KOSMWHDLOSUC    BWRYXWV        
BVSDOGFVUCD     : LBLGY           JVUD            SQXFYUVQLDOTTY  OOPV           
MEBVXTMLLJ      : EDUTTBRUNWWD    GGYAAJHBBQNGX   TRMG            TTDPW          
IPYKYWNEB       : LIIPXJRTGVW     WEXO            LKYNOVEYUERIC   PBGM            TECIUM         
XEXGMWBO        : EDUTTBRUNWWD    CWFVBVGUUHKM    YQIQOSYLNL      BWXVS           UHRQWJ         
ODHRYFNOSAXTK   : YIML            ADGQHT          QROOBCFDAOYWTW  EQDALYS        
VVOUJTVVTBVA    : IRSCBJAE       
UDEXTJHLKOYYHY  : ANLBKRAH        BDLFWL          JPWDV           VDFKNUAITWNFPR 
DKPBIFWTBSP     : UIUBJSRIINR     OYHJSV          JTWIFGPLYJOR    XCUDQDWAF      
VOWLLCRJVBSHOH  : MLOAB           MJRBORWOBMKWYJC BMGDXRIITHBK    MKDRNWY         RQSGSRGMDV      CEJYTGQI       
PQKPWWIAFPWYQSR : KUJKUOLHGTDFKM  WDKS            IUFCK           HARFH          
OIMDTOWG        : PJVRPJPA        XNNAKTSKAX      WUQAS           JBPLXXLQHWPYG  
BYTP            : UTRXEGWSCABX    FYKJKCGLPRQIGBO KOSMWHDLOSUC    QVYCK          
CFCO            : QWOAGVQBTTDCD   INVYENNLFGRGP   BDYAW           LHXWVOILYJME   
BLGCQVBSOT      : LAGYHN          TLQHFXNSPIRAV   KFEWRWMTQN     
CLUQ            : LVQMGOOIVD      VOCECM          NDGRHBC         PJVRPJPA        IATDR          
QFNWROYLGKPOMF  : FPDHIJI         PBEIUQWRFSUCK  
QSSSK           : MSBFAKPB        BVVVMLHVPL      FEOWXM          ANNUWAKDKRNXBY  PMEOCOLL       
VFFQRJE         : SPDSRMBBS       CLBORA          MXYJEMSRJS      DILY            XYIDRO          JJRJBN         
CUHHIHYAGMGSC   : SWYP            YGHAXJCUHYLLR  
HJJXDC          : LMBYKOXUQY      ESGRHCVIWCA     VIXHBDP         SGRSPNYX       
PUPUCIONM       : RYVGIBDTXN      THUTXFEOHQMW    NAXQUU          AJAFJOFWYYI     JKNYSKPB        OMGCJF         
PHMYRTXTCMBUPX  : UPEDJES         JDIRGUIRPDGW    QNLSOJPNAFDN    CDEXGXM        
BIDEMY          : AAMPU           NVKTM           RGIIVBE         RUEU            DWGVXKDLJ      
KOSMWHDLOSUC    : AHXD            BYTP            LNXHJOLSOLTDWVS
MXSJDGMXXKDYU   : HOYOY           FPTMMB          TMLOAOVE        VCRT            DQTIGQH        
GKIC            : UHGDEBDGYXYIPNE WJCUCWMBDUUBHBM TAQNVDXYVHIGP  
YXJXFOJWK       : BHBGKBIMVN      TNESIPVFKSGEXYB IANDPOFQJ       YHUSOBWUSHMH    PWTXTWVF        MDDIJASDYCPNLAI UCYQTEURAMKUJQP
BFSYXCEGQDGC    : MEESTBDPOGSNWFK SDOKLSO         OOPV           
IYTQLEUGDSSB    : RYKHWODLTEP     IFWBPLYWE       SNWODYGMXTL    
HMXRQYWMAXQF    : HGHELEVWPGD     CYMKVHP         JUFQCAOCJ      
IKPMUXNPOATJIA  : BRCANMHQCEXS    ROCSBHNS        ADCGB           OAMUPPR         JJRJBN         
DBELOCFHDF      : GMPSMX          NRJOV           HAQFG           VGUEQQQYBMD     NRGHGMNBDP     
DFPKN           : WDRHIBDHFQVHPXW JDOEVGK        
UDMQBAG         : TGLOUSHA        OLDFXMEITXLPILA FVDXJJMUSKKHRWF TXWACW          BQKXFMIV       
ACELCJOGNCW     : CUPHGPH         VSDFFUOOIHHGXJ  KTPPPSXEBWDTPSS PJESAT          YAEH            YEITJDVUBGL     AYGUCXHADVLB   
IGWPDAWS        : IRUDKOWMVOEP    BNLOVMDLIJI     BKCTDKFD        YFPWEXBCBHA     QFMMYWPCIDPBCND
KSIOHYRHHMKMQ   : IRUDKOWMVOEP    CAVCOGTT        YQDOA           WXXMSNXIVGKHO  
OAMUPPR         : YWRBGTVEAH      IKPMUXNPOATJIA  DEAOWMI         PRKMATG         KADTJA          XTPSSUERGMT    
XBGPEIMYVWTF    : ESGHGSSP        XIRGNOQ         MSIOIU          DDIHJTJEWLEAIW 
BGIKOUUBLSRNGPD : JXUGKS          OSSIQRLS        NVCAR           TECIUM          DUIDEAXDIRAWJ  
JMVK            : IISTUGNXQVRP    DWDFKIWHC       HCXLBLQEPEOBQ   MPYRWXDPBDGB   
NODAPAYLHNMNV   : DEDRXUHI       
EQWH            : YVKGBMU         CRUCJVUHCUHCRGI YYVYNWHWJWPTUJP GOBEVTYKBBBJKTF
SARYRWWBLUMG    : BRGQFSSECRNFAYQ SJUFBIVBHIL     GVVYQHVOPBLGVYX
DJKVLJHSWWJ     : IDOLONBUEA      ICJFAHDDVGWIQWJ LSMN           
WNLTX           : RJQUMEFEJ       EVOPCIYGMDP     XPMGIMOW        FRMREPTJHSPHTU 
MXJNPGMSTJFARJK : DTFLORO         ALVXWWVSIBYCVXR DLCGEANAQJDAJI  RAKBBT          HKFSHKLNSOJGEM 
FXMM            : UNQGP           OCJMLFH         JPPQVCYCP       OUHWIHEMWQ      DSKFKLWDBUJLXAO
LLBHIQSFOLTOW   : CRUCJVUHCUHCRGI ICYALHSX        VPMBBYEJCAIGYT  YQIQOSYLNL      AKXJ            DEKMWVJXUVL     IIMXHGVBDTJT    EMBLNLUUDUBHD  
GGYAAJHBBQNGX   : MNWBPFFF        NVKTM           LAWXXOQQ        SBQXCKFUKIACVI  MEBVXTMLLJ      EBJOEU          DQOLKDCFG       PSAKPBOFAXTM   
UNFG            : GOROQQUTJGEUQ   XAKSOUNXAYSTEA  SUFOEVLOO       QFMMYWPCIDPBCND
INKAJRQ         : AWBWQYTYYQCN    MFNWVYKFIW     
NIVXO           : QUUBSF          LGCAPL          OGLAYIVOO       XMHTQK          GUDXHGVK        YUPJHBVTCXGVX   XUVEYEKP        UCYQTEURAMKUJQP
XQDHYGKRVQQJN   : TFECFHQKKXTL    CHNODNXRTMHQWLJ ERUNQBJIGKKYTLF XQXD            BWEWBHJTSY     
PWFAKPAV        : HILLLJ          ERUNQBJIGKKYTLF RIGW            MTBRHIUEKBQFRSV
TUVCRVSTTKYDLHQ : LFLE            HASCFMB         GNOSSKDYVVG    
DJTNXA          : NCLMRU          DSLUVPNQDSFL    HHCTEDCELFQXDLM
UGFHVIGGCB      : HGHELEVWPGD     VDPHAONWIAE     DQOLKDCFG       IRRNYUBN       
GSAYPWLQAWYQB   : DEIFVD          GVDQFPJWAGWAR   MEBVTFOB        ATSCLWMBNL      HJGTFWTAWQMIVAH
BWRYXWV         : JWHSTL          MBICHOLV        ESJOCTCBNNIYU   XHISRIMCCKCK    AHXD            UJMUIH          TXCNCVBJTXH     PAMVGIJWUJT    
FDANJG          : RCVNLJLTYOVVBKN XTWCMBBBLAKBRMS QAXEEKB        
NKXILYAILRK     : MLOAB           OTBJPPR         DUKXECJUBICTPRM VCEBFULBX      
QENWFLPG        : JKPSTPKYXA      YKHXJTTOJU     
OEPTHRJTY       : APOVJK          ENUFGDLJUQOTWO  MCCCD           XATVTHWSQT     
JLBRYBS         : FQWSDOW         LTVIITLMSAEFLSW
OMWBF           : XYEANVBHFTVRIV  NDTULOVPOTRADAF DMENNGJGNJAYAE  IJNOALWAYSBRIY 
PCIDROOJUEFEV   : BBSMPXDJ        DJVDPEWYH       KYPP           
XWQJJUCKVWWMJT  : KLHLUX          KNIHYT          PYEGV           CHFXHXTTOEPMN  
OUDQDIL         : KYHSPMLLECHC    DMMVFFF         XTVN            YAFSGG          GRSESFWNSM     
WWOBCSXTTWNDI   : WLBKLMIWGVH     AOYVFGBMOGDXVSL TTCITLKJRRKJ    QJAXVLJWKYXVNM 
HTEEQQ          : FQUWTNEF        QIVYWMBTSWMP    WHHNRY         
KGGH            : LTSWUM          KDYDEN          DNATWXONMPA     FPTMMB          KSLTJEXQUUBJFDE ALVXWWVSIBYCVXR
XKSLGSIWTMPTHLR : QBLKD           MLJUAXQSF       FPTMMB          KJSPNPMR       
RADY            : TJUMCSGDULYOHHM TJFE            NAQKAHOVFOKYP   YRUHAMQIMRRUQD 
JGOCXBIFIUFU    : AWIAIJ          JAJYKCLKSDKCJ   EVDGGAYQAYD     YHUSOBWUSHMH   
QBJBXFNQC       : TFKCCBM         OEFAHKB         ALVXWWVSIBYCVXR SGRSPNYX       
ETPVVUXU        : FYRVRESFLWFHO   YUOQTWUACFFGVD  YEITJDVUBGL    
GJIELTLVOQRHH   : NYIAYRIHL       WWKFRXYBRWDE    XIABFLLTWQAHAT  AAUTNETCFSJPQIR GBKFXMNP        NLJJILGVABCCEA  NKTELBSQQXRFC  
QIVYWMBTSWMP    : FILE            CIWLPXESOFYCWA  HTEEQQ          PFTAVGGHQ      
JPPQVCYCP       : QJQYJHTTWTO     IHXPMEMWFWGLWW  FXMM            DQOLKDCFG      
OLKF            : DQJO            LNMF            NRKMYNVUWJYOY   JTWMFVQ        
RPBL            : UAVLQQUAN       ULRQBTDCI       CUABYR         
WKWLNTEKG       : QAWJJUJXSUMJFOH MIXEKTLQAGETW   VRRBBX          FCXKDUWQ       
FPLVGHXIMND     : TFIUVREI        HCJYBQLV        JTLKAVBFJ       VNAIGQUJFFORKL  KYEYIK         
BNGHIX          : PWIGAJV         HVAEEWM        
TWFGVQVPWG      : OSQM            EAXM            PUYYOKNQXQF     HGDEQ          
TLQFJYPJHCY     : FHPMQFVMMGQOJDG EKDG            FNTHTA          LQYMKJFIRW     
FBBLKLKSHJAN    : TCHPCDUJX       RELTTKLJY       QJAPR           EPQGNQEWNDOCTWX
QJAPR           : HKXOSTJIYCV     JYTDJPJFATSKJG  FBBLKLKSHJAN    SCPHIIIRKG      VPHAOISSTWYC   
JGOPP           : APOVJK          QWIELKTFGL     
HCXLBLQEPEOBQ   : NRJOV           JRIMHMTUDHJR    JMVK           
JAJYKCLKSDKCJ   : IRUDKOWMVOEP    OOWYXYOVMI      JGOCXBIFIUFU   
TCQDGQOJ        : IWTWJT          NEQHRYAUXQEERQR UNMTGABVARF     RYYQ           
FOUKFXBP        : CYRVDPJKWSTU    BIXCYJB         CXASOSJRNBXMA  
EBJOEU          : DYHCREDG        GGYAAJHBBQNGX   AJAFJOFWYYI     WGVFGVJVA      
WAJBMLVQEYWVQG  : OJCWBDSTUECU    EICRELJDARPBBU  BELALEKKTKYLF   BQQLFELWBS      CEWJIS          NXKRTP         
VWXGDV          : MOQJRV          TAPWATDVHASW    CJDCSMKWO      
UGMVPDAMEYMNBB  : LGXXLIGUEQNMV   YLBCMV          UJYOYWAGQBB     SXXB           
YRIAOEQXHN      : WCMFUETIRXM     QNKNXOKFG       LQABHHMNNAF     OCDTNBRT        HJMOYIB        
HVAEEWM         : BNGHIX          XEKHFCWAYU     
VEVXQA          : RWPU            NAQKAHOVFOKYP   HYLQAX         
FQBHUA          : QSVDLTWVITJQMP  JDNJG           ANLBKRAH        JCMU            HRNGQCKJTCIBF  
DCQKVQTJL       : RUHYRJDUTBNP    TRMG            GVVYQHVOPBLGVYX
HOIMLWHHBG      : EFLWCHPAWBLOYT  BEFNWWVTBKSAHW 
RIGW            : XADFSGUMIWDJB   HDFMVSAUI       PWFAKPAV        EMOMDRDHQHOM   
JGVLICNB        : MUVCPIXRHTTMTT 
JRIUFMDTWRI     : IFCFQSKXNXVLQ   SAXUGWJX       
YRUHAMQIMRRUQD  : TXRKJDPBFQELN   KLVE            LNMF            RADY            HFKQQBIDNJPEU  
SRGHDXR         : CRUCJVUHCUHCRGI FWQVQART        XCUDQDWAF       KUPUK          
EFEACVK         : UHGDEBDGYXYIPNE CDSQ            HNSEHOWJNHAUMET
WDTFD           : XVASBTIQV       FVIFNRSICQPCOC 
VMVPESGIWYCFIFE : AUTVDAVVUJ      NNOQCCPMOIUJDUL XTYHJK          EDUNEXC        
GKIKMMIX        : LFERBHSDFXAEHL  BNLOVMDLIJI     RTGIDPCAWGFERTX ABXVWNNONNL    
GBGLGPJ         : IOUS            SWYP            TLPFWIBLGNHPDJ  JDIRGUIRPDGW    NCUX           
NYAIGKFHMLSTR   : HYEUB           QHIIGCN         MQNYWWMSCGLKAV 
BEENQQW         : MLARSLWOQ       KKQQFT          BHVD            VOBRW          
DFRLSYD         : DDFNNUKAOSRYMV 
TSDVBJGJTUWM    : SIBLULY         GIHDIIFB        FRDSKYKGA       ONCPKIG         MPPTDUXIVLQ     NTFCQYPIW       QDWOLHMFARBNX   YIFDCENJIO     
QIUUMILFHDIMW   : OKUJCJSTFE      BAKN            HWEDGNO        
FVYJST          : BRQNGPLYNFU     XMYWWQRLG       YATJNKCHPSSHSU 
OVYVHSSEH       : UROB            KJVRGBKPLUUNFFF SWEQX          
UPFREODKXIU     : PHFYYLTG        OXDAUWKGJTDCXUD TKBWRV          TSEFTMMHGOLNWXD
GRSESFWNSM      : KKCD            XPYFIASJMLCGSXH OUDQDIL         BORHSRQTQC      MUVCPIXRHTTMTT 
RKSLDYSOTLTL    : DNATWXONMPA     OSRJJEOSXCA     NRJOV           VPGDFGEIR       LMXFCTT        
KQCLCXYK        : WFNIPMYGJ       VGDBG           FQTGAICT        YUOQTWUACFFGVD  IHYUID          SUYATTARMAPD   
ROMW            : YJCETXN         ECOIHPTO       
CRBNKLIXOHQ     : LWNCB           UXKWQDHGLINVDYV SQCVJASJVSQ     BHYR            SOEYYKWJ       
DEAOWMI         : FHPMQFVMMGQOJDG JQLBTW          OAMUPPR         NWKODXKJYCXKM   TBLJPTQRIA      YGSKOOFY        KJMPENXJCAM    
XMYWWQRLG       : BEHVEHWV        FVYJST          UMJMGVU        
AIJDWTOHTGPMLS  : IRTJBVYYLFRWTBC CDVML           VUIKJPEAYKPOSUU UHBVSGIF        OGNGKJXHNUKRPNA FEJTR          
NKOBUP          : QISMQSVDSLPQ    KDYDEN          XXRYEALWVFULV   TOPPIGT        
HPBGGSTMJWXUAW  : NSVGAYMUPNUF    EDLVEUQ        
PEKVTXJPRXCG    : JXWARO          UQLKSDHWOMCK    GKWYKEXWJQI     PJVFNJL         AKXJ           
YVCINDOUXIJKFHF : AYUUEVYG        RTGIDPCAWGFERTX OLEHXSA         XAFHN           UQBUPBXMK      
EYXLJ           : EGWNNMGTIDE     SNWODYGMXTL    
HJFWDFBJGAI     : XIIQOAH         UQWPWAJR       
KVQYSPKFAPO     : TKMNELU         XJWYQLNGVRMTNFM MVXPNUBGYSOHBYC
XVGVHST         : CHQNOI          BFLK            MGWSERXUICM     DKRRINQDLB      DMYYY           GOBEVTYKBBBJKTF CRLCYDIIXCF    
ECOIHPTO        : NKDEJ           ROMW            GOJBVELXUXYVCM  CGEDMSJ         LQYMKJFIRW     
ECDDSFVIPDKFS   : MQBNNFFWPJB     MPPTDUXIVLQ     QMBYRXKOM       JWCSYODEAPEC    CRVCJIKUHCS     JCMU           
GOBEVTYKBBBJKTF : EQWH            XVGVHST         WRLXB           FOOYPGAOHGCMDII
MKDRNWY         : XADFSGUMIWDJB   VDPHAONWIAE     VOWLLCRJVBSHOH  OFPVXADOG       LMXFCTT         RYOPBHDNW       TJAELVWFTPE    
FOPSWKLDYMHWJ   : GNOSSKDYVVG     RSJP            NTFCQYPIW       VJEJLCPHE       JBPLXXLQHWPYG  
JKLLVW          : CAEGTLTWMDBG    LDHVVWS        
BXTL            : TOXPNDEJASMR    GYGMBUYHOV      HOIITEBWYLXG    GJCCRGQDDXD     XSWDUUQA        SOEYYKWJ       
NBBNNICDB       : HLRJBEBK        ATSCLWMBNL     
PMEOCOLL        : QYPCQJDPCSTW    QSSSK           CEJYTGQI        IRRNYUBN        TSKCLWPSAYCKPFY
WXLITIPU        : LESVGE          OPMM            LBALBMOHWAHPDHT
JJMAKNNXY       : LESVGE          HJGTFWTAWQMIVAH NJLSIWGIERWP   
DATSPXJROWFMU   : ACSDFCSACMHX    LNMF            VAIMDEWYOALTE   FQXGBW          BOGSQX         
AFYKVVSHFIHS    : CYRVDPJKWSTU    SGDW            HKFSHKLNSOJGEM 
UQWPWAJR        : ACSDFCSACMHX    OOESNJEPNHDFXE  CYMKVHP         KAKGGAQ         HJFWDFBJGAI     QAPA            PMCFUKR         VMHSESDGO      
UQWPWAJR        : LYMB            FIEJRNQXWKHX   
HCJYBQLV        : LLJSSYERLVLXD   PJVFNJL         SNCFWEVIXQ      FPLVGHXIMND    
NCUX            : BGVFUFDY        GHNCSGYEDPXURW  GBGLGPJ         UIGOUPV        
SSHYDPTCMMBCJ   : EBBTOILSOJ      XFLTLXPYVHAM    SGDW           
LESVGE          : TNRWKDERNWIUHR  MNNKRGTREFDJT   AGCTCVGDRQFAHMH WXLITIPU        JJMAKNNXY       PRHKNGPRIWH    
JWIGSVKPVKJQRKU : TPUPW           CHNODNXRTMHQWLJ YRXKULL         QAPA            JIOCOC          LJSXKGFCXECOOW 
EYUS            : BKRBGF          AWIAIJ          DNWTOAYLGSV    
WDELJYHREEBDOH  : BOLXXGXGLPKF    KFGRGA          FHGHCARGLWIE    TMAJOMAULFER   
MROICAYUM       : TORCEBYPAX      UQVROUK         AXWTGECYSOOJJRN
ESUYMV          : WWRGWTEJTTJ     MYVITJC         WITWHFTXKYKLDJ 
RAKBBT          : PHFYYLTG        MXJNPGMSTJFARJK
FATLOCKB        : YIML            VEMEKDXWEEEO    YRISXI         
YLBCMV          : OSRJJEOSXCA     CHBM            UGMVPDAMEYMNBB 
JCIECU          : CYOH           
DMENNGJGNJAYAE  : YKFAYIXPNO      NBKQFLT         WDKS            OMWBF           MQUBAJQKESAJNWY JVNSNOMHOGR     RXTMSOBMHEG    
BBLMENBCC       : QCEJPHWQPMCU    OCDTNBRT        BKMJK          
EMRGHVJ         : DCURTJAOQEPK    AKXJ            SGDW            CYLBBTPUYWWVTXP DDFRMQUDRMBOAW  WVBLIEJJTTI    
DYJJKRYVUB      : SBBDAVCVYRFD    DHJOFTOPVBWCE   TCFBBQKV        IUFCK          
YMWCX           : FJLPHLAKA      
GNNISANFTV      : ROCSBHNS        BBSFYPXFV       MEESTBDPOGSNWFK YYMIRMDHU      
QILTJXFURGQMHNO : EXLEEH          HILLLJ          GJQSM           TJLCKVF        
MQUBAJQKESAJNWY : DMENNGJGNJAYAE  BDHSGNPGSCF    
HNAQ            : APJWVHXOHILPIWT KGWWJX          SWYP           
HNDNFSVUHSJAPK  : DHIX            TSPWGMLBNWXXYY  FHVYRJTHFAEACK  VMROMDNICKFUM   IJNPBVVSQGLAM  
BDLFWL          : DYSAEUDQ        PCXGLSHCG       SATVR           BSQFEFOCPC      UDEXTJHLKOYYHY 
KKQQREQLPXYV    : DMYYY           QJREOX          MRABIKIV       
GOJBVELXUXYVCM  : YFEPL           DTUWBTCQWNO     GGOFMPC         XIIDGKBKLCV     ECOIHPTO        UHEJRDCHT      
YATJNKCHPSSHSU  : SEUIGRVO        FVYJST          UWDGMYX        
IBTSDRWQQT      : KVTO            GVMODOHDAJAQWLG HTWENMBVBP      YIJWVKHHYR      GTACOCSTEYD     OIDTWYFGBVQ     RFRYTUJRPLWVHAL
RQSGSRGMDV      : NYIAYRIHL       TDPAUXRWXE      VOWLLCRJVBSHOH 
FEOAYYUTEEVBYBS : KHWLP           QTBHXFNYWQECP   CPLAPYA        
TJSKDJGJEXSSEOR : CGSENVHQYOGMXHF JABSVYGLKT      QRPUOQEAMX     
UJMUIH          : IRBCHKQVSP      JEEOTXDIAMEKQ   BWRYXWV         INED            LEOJITHR       
ONOPMRJLNUEYYPF : PHMVKL          KIXGHLJSMF      YRISXI         
TFDOLUG         : VRRCPVHFKP      QJREOX          OPTWVRXL       
PRKMATG         : OJVQAKGUGIYN    EQMULVBMXSNM    MUSGXPUPRJ      XJXIAMHDDI      UFCA            OAMUPPR         CPNJAXKR       
IUHWPSKDQOE     : XSEMNEALKPFTTA  ONMNBLD         HKWYBBHCKTGADKN BLBO            UHEJRDCHT      
GJCCRGQDDXD     : LYUJBXQUGLJR    YYMIRMDHU       SHIVXRSNGNFIJQK BXTL            LGOROLBG       
PNISKOMULTRB    : CHQNOI          SMURNYWJW      
DFGT            : CKGR            ILQSYQTMPELS    XTWCMBBBLAKBRMS YUAANJL         PJESAT         
XDVA            : SFMQNHXCJIJGXC  BPHN            BELLWAXUA      
PIWULWYFOOPJBEV : NKDEJ           ELYMHKQNJD      JCMU            AWHUFMJX       
RSQTIV          : YDKBBEJPIKR     JULUJPUIQ      
OPMM            : ORUCI           WXLITIPU        JTVMJEVPNX      QRPUOQEAMX      GBXR            NGDPIYKBY      
KOBAX           : NEAFXTEEKELXO   IHHP            XJQLLTUBO       NJGBBVVOIFWQ    HTBQA          
XJWYQLNGVRMTNFM : XYPAHWNFBHYCY   KVQYSPKFAPO     NILJVQMKXBDXXWL
BUCELSQA        : EQUBXW          DMYYY           BORHSRQTQC      OIBQYV          AQWBWJV        
EPQGNQEWNDOCTWX : EKWXYNOUGPH     PAGSERPP        OXEPEVFYE       FBBLKLKSHJAN    JMQLNHYBDPKUDM  RXTMSOBMHEG     IRRNYUBN       
MTBRHIUEKBQFRSV : WBQMSJYQDVXFYR  CCENJPTQMFH     DSXTXKLXCQGX    PWFAKPAV        OFPVXADOG      
IMDVEJVRPMVLJTY : EKWXYNOUGPH     DGJJ            HWEDGNO        
QAPA            : MPMJJBT         PJVRPJPA        UQWPWAJR        JWIGSVKPVKJQRKU UWDGMYX        
MEVNWBIQW       : SMKJHKT         MNWBPFFF        TGVRTWJXCJ      XPOTWM          NXJNMYFUIOJYPN 
YMLXQV          : LHHEYRXBNJCA    HDDTYDBXF       KLDVOSHMQ      
KNIHYT          : DPIWSJSDFQQOCYL GGOFMPC         XWQJJUCKVWWMJT  UNMTGABVARF     AIHRSXHH       
XSTAITJXBH      : LKYNOVEYUERIC   FUTPTIWEWIGUXNK BMMRJ           VLQT           
AIVQ            : KFGSQOIF        RELTTKLJY      
DSUOQ           : QILA            DSXTXKLXCQGX    KAKGGAQ         XMILYTEB        TISLXFOXPIL    
MMXAUFYOLYHH    : QBPNLJIWUANPCFL XDORJ           APMRMIAYINQH    IXCSIXMXYQM    
SELSFSGFB       : IDRJ            RELTTKLJY       JQXCWVM         PBQXJTGUWTI    
YJGREW          : XJQLLTUBO       WLXDOAWKJHPYJPY QFCIOSKSQQRL   
RKWQ            : DQPRWE          MSIOIU          QDWOLHMFARBNX   VIXHBDP         UCYQTEURAMKUJQP
TXMKJNURN       : AGJCDHSAPQRGDI  LBLMYBLT        BOGSQX          EFLWCHPAWBLOYT 
XYIDRO          : YIWVMQE         AMIAGDO         VFFQRJE         WXRJKOOBQOQVAGS
TTJFCDKANCMMUYI : PJJBEWNGA       DEDRXUHI        CFFDF          
NTFCQYPIW       : SJNYIRXTRRJGA   VQTMMOFTQI      TSDVBJGJTUWM    FOPSWKLDYMHWJ  
SAJHLFEWLGBXIOC : QGLUYV          MABITSYFPBB     MPMJJBT         JTLKAVBFJ       FIEJRNQXWKHX   
EXWMRKIYOY      : JPFOUVLRRYWABL  VULMIPUHK       MOUGVVNH       
HJVYC           : EONJYPXW        SAHTNXBGX       QAXEEKB        
IMMOQJAWKXGCAD  : XDMQRVYBPHFSG   HGDEQ           XFFLH          
AAUTNETCFSJPQIR : XIWFYIE         GJIELTLVOQRHH   CONKLEBOD      
TECIUM          : NCFJUMBQBDE     PMALPXGB        IPYKYWNEB       BGIKOUUBLSRNGPD LBLMYBLT        RYYQ           
UYIDDKGLLJHHWL  : QISMQSVDSLPQ    YOCEFNS        
BQVNGNXYDRDG    : VQTMMOFTQI      XHQWLKT        
BUMVTUBXIHJ     : CGEPTHOYOE      TORAYGVYPUMRH  
QSDPEHRXDFEQFF  : KUASRO          KTVGJMTXWBYVY   GVMQ            LVJNWGDYDYYQTYD
XLDAM           : DDQDNWAVH       GVMODOHDAJAQWLG WFEUY           MABITSYFPBB     IXGKWTQDTLF     WFVR           
NKTKLTSUG       : QSOSDNSOGYD     XHISRIMCCKCK    PDSXVN         
MYWEEEXC        : MQSK            GVMQ            IIMXHGVBDTJT   
FIDL            : NCFJUMBQBDE     BDBECHHVA       KIXGHLJSMF      DSKFKLWDBUJLXAO VGCASNU        
AJAFJOFWYYI     : PUPUCIONM       EBJOEU          SQEB            AIHCMFSJLR     
TDHAUVYTBFAYJ   : QBQOGRSKPM      QITJPXGKEW      QGUOWGTPPKME    DTUWBTCQWNO     FPQSCMPMSAEYC  
FUMQJOCLT       : OTAY            RTNTCIAJ       
CYLBBTPUYWWVTXP : MCEB            EMRGHVJ         HQJAXOCUUSWDJ  
GPVP            : EKWXYNOUGPH     FCSPGNJXLAWR    WGKVKEE         RWABFICQ        BPVSJRACOVBT    YEITJDVUBGL     WTPPDKWGUTJ     CRSIXG         
DKQVVGXJCKLEVO  : EBYRBOWVH       ANNUWAKDKRNXBY  DDIHJTJEWLEAIW 
RECSCB          : PPGM            RBPBMSN         KPTRYDYNRJBF    LAWXXOQQ        RGHDTLP        
XYHWFXUXCYI     : EDUTTBRUNWWD    FFYJWLWLM       XEKHFCWAYU     
UHBVSGIF        : WSNLSVSPEHWX    UOKGUXFCTTSYQDC AIJDWTOHTGPMLS  IDVGDA          ADJEK          
GTTXBXQFYIDXQAE : EKIQLSRENOQEGW  KMLDFIGRRDYRI   IMXOFRLSLRAEM   NQWJXBONGSYLP   YAEH           
WCSVMNTVPPPX    : RUHWFNN         SXMWVOKKWNXCTN  DSKFKLWDBUJLXAO
WKGQEE          : QXVQJEK         WALKUWLMDJMI    CTWPLGHC       
EWYDIEBYGHPEL   : PHJKQPX         QNKNXOKFG       OPFXLGQL       
ABXVWNNONNL     : MMCTVMIXGRELC   VOCECM          GGOFMPC         GKIKMMIX        QJMYYIUQBR      EFLWCHPAWBLOYT 
TFEAYIAYNIFRJMY : ULRQBTDCI       DDIA            MUVCPIXRHTTMTT  VGEDDDDU        FNKDPMDCKRQ    
QNLSOJPNAFDN    : MRMJBTMVEBIKAL  TMEC            PHMYRTXTCMBUPX  XQXD            DSCJ            CPDB           
OOPV            : CGEPTHOYOE      BVSDOGFVUCD     BFSYXCEGQDGC    MYLQLUQOHIJRHCD XWANEIJMR       INFENXYE        VMROMDNICKFUM   YWSIPIDPXWFNTK 
SXEUYRD         : FFXSSNDNTYFX    IMHURXYPEKQXJED RXMFSEXUKXGXSIF CRSIXG         
JMQLNHYBDPKUDM  : HQSPLCNBBUKDOV  PWBHH           EPQGNQEWNDOCTWX INGYERHI       
GBVXROVMJTQE    : IRUDKOWMVOEP    IBGFSFFGCDA     EYILSDOJDUJT    FBDARLGAYCQFX   YYPUHLT        
LHXWVOILYJME    : YWEEIXHKFR      TAQNVDXYVHIGP   CFCO            GPHH            TPKTFHIFXOF     EMHCBXLWAGQX   
YYDMYLPXLHO     : WALKUWLMDJMI   
TXCNCVBJTXH     : MCUMRSKXSH      UTRXEGWSCABX    NBKQFLT         IHYUID          BWRYXWV         KTQCOFMRB       YLXTIHBEGM     
JULUJPUIQ       : CAEGTLTWMDBG    RSQTIV          CEWJIS          NRGHGMNBDP     
WSNOQAXFIUDMI   : EONJYPXW        TVKFDQOTHCH    
IJQEJA          : YHUSOBWUSHMH    LTVIITLMSAEFLSW IGQUHQGEHNMRJXA
SUFOEVLOO       : BDBECHHVA       RXNH            NCFFXYBENA      SNVYNCLLAAWSAU  UNFG            XDXYRYNE       
OHDDXFCFNWKDFRN : TJUMCSGDULYOHHM EMRLKHWDEYBTASM TBUJKH          NHHN            RYOPBHDNW       UOBJO           UQBUPBXMK       ADJEK          
KSCKMVHRMNPAFF  : IUFCLGD         KMLDFIGRRDYRI   TJAELVWFTPE    
TMSWNYYSOXGR    : XIWFYIE         IGEGIDEUMFNC    XCUDQDWAF      
XGVJBYVPWGH     : VIXN            FKOAEUCERBWVXHT
VXNBFDWRVUHWV   : XHDOEQBXSKVUNQA PALVQDRH        BTIKCYVLGNW     TLPFWIBLGNHPDJ 
OUHIAHQYSRARH   : UWDGMYX         UBCYO          
XRKVR           : MQBNNFFWPJB     DEPVBQWCPVWFB   PIKCT           RHODCTKXRKEJLY 
AWBWQYTYYQCN    : SBBDAVCVYRFD    FSERVOPUMHB     UJNTSGF         GLXISREMVA      INKAJRQ         FCXKDUWQ        EUMXHWTODSUQODG
JVNSNOMHOGR     : ADCGB           CPHC            DMENNGJGNJAYAE  YRYKAKJ         SAXUGWJX        RXMFSEXUKXGXSIF
GJVCBVE         : PPKJBWJY        NPLGBPKHW       WHEGD           ORNNPEXDBNBFH   VCFSJER        
WCQYVPXOR       : DQJO            TXRKJDPBFQELN   TJFE            WDNIDHOC        BDHSGNPGSCF    
EDJSWYJL        : ERICOGFQFDN     GXQOISLQVLLY   
YRYKAKJ         : NWOVIKWGLLG     JVNSNOMHOGR     EDPT            APSMNUFKL      
NHHN            : DTFLORO         AHYAJSE         OHDDXFCFNWKDFRN NTINDLS        
LEGJWEBOTFUDA   : EECBLGTTOVTIS   ETKEXVRWTLPRB   XPFEFCGNRWSHUK  RWPU            GOROQQUTJGEUQ   UNOXK           MDDIJASDYCPNLAI GGVHP          
DKFMJYNVBAHDN   : BRCANMHQCEXS    MJRBORWOBMKWYJC CDSOWWBQ        MQNYWWMSCGLKAV  QACAXPCVTGYCBK 
MBWAHDKEJLVD    : CLTJHJNAGKMLVE  XJKGHGGEGYHDKAY VLQT           
QITKNERAPSPLTP  : KKAH            DIEOJLYUQPPJ    IRTJBVYYLFRWTBC GVTKTQXSAVLID   CRLCYDIIXCF    
YFLMI           : VUWCMN          AOYVFGBMOGDXVSL
MQNYWWMSCGLKAV  : SXRPIVQT        QYLTD           NYAIGKFHMLSTR   DKFMJYNVBAHDN   TORCEBYPAX      BIXGDKKVUN     
GPBVI           : AUTPMK          XYLWJHGADUPTF  
HCLDCROQ        : LLVYQPAU        DQPRWE          XEKGXIDTKN      FHVYRJTHFAEACK 
YFQMHQJTLNAXY   : XIRGNOQ         MGNMJJX         UOKGUXFCTTSYQDC
VAIMDEWYOALTE   : KNWBYGPHRN      IIPTOVKTJOCOOPO DATSPXJROWFMU   EURQDDGU        UMRDTXTFTKYVS   AYYBUOW         KKNL            FPQSCMPMSAEYC  
LUDK            : GWALTVNIMODUMSY TMLCGYYR        FNDBJGBOHOYSPV  PJESAT          LTVIITLMSAEFLSW
WXJPJEBXGB      : YATGYYLCBHY     BWEGHCHPGBHX    BKCTDKFD        UOKGUXFCTTSYQDC XIFSCLLCIRKRR   ALKOT           IEVJIMPUBU     
JXYTMEBJERL     : UIHGOLSQRCFSAX  XSEKR          
LRUWOAKRY       : HAQFG           GYJELJSID       CGRBE           FGYCMGFRLKP     WXXMSNXIVGKHO  
BORHSRQTQC      : PQKW            EBBAACE         KKCD            SBQXCKFUKIACVI  GRSESFWNSM      BUCELSQA        NXKRTP         
RVGWYQDQE       : OKJMIKX         NEVJKQX         XLSDLQ          EMRLKHWDEYBTASM FIJSU          
FWRELTODTYH     : MLJUAXQSF       QBSIBHTVWEKLL   VEPGRNAQACB     VMHF            UTUTSHDP       
RQDJHXDLRUKY    : QHTM            TDPAUXRWXE     
JPWDV           : CYMKVHP         UDEXTJHLKOYYHY  PWHKTPVOVYRJWRN JCMU           
ISLOFGEKCF      : VDDBONRPGEGJ    UKBGJEOBE       GVVYQHVOPBLGVYX
MYLQLUQOHIJRHCD : SFTBGYBXKOJRLBI OOPV           
BGVVQOHGTPMH    : URVFVTKIFB      EVKVYFWVTRMIFAA
RBHR            : SETKIQWBPE      TDPAUXRWXE      EFHNYSQMKQRXK  
XDMQRVYBPHFSG   : BMORIWSXYJSL    YPVDFOTBHLEBGYB IMMOQJAWKXGCAD  DLYEYLBICQBHAWM
ACFSROYNFN      : WYTPWBK         IBOXLUBOTWE    
YGYG            : TJUMCSGDULYOHHM RWPU            CNMNX           PMCFUKR        
PGDCW           : WXRJKOOBQOQVAGS
XWANEIJMR       : OMAON           RBYHE           OOPV            YMGIWBNCB      
PWEJLG          : GLQRKVYYJQSWV   UMXUGGCMSTLGWSF IKOIAIWXMVNOEWJ YHUSOBWUSHMH    UAAAKXOOCCMW   
STUSCVBCLIH     : TXFUG           XIWFYIE         XSVRNLCKWLYIVU  DLCGEANAQJDAJI  PCXJITTFUACS   
HEOEHFKPOA      : XWNNQXELNSQKSQ  MQBNNFFWPJB     KEQNUCHW       
APGEYRMXLHUGJS  : NXAPQC          IFTSHOWMY       HYLQAX         
OFPVXADOG       : MKDRNWY         MTBRHIUEKBQFRSV HDOMCDYMRG     
TTCITLKJRRKJ    : EXOQAS          GUHYOUOC        TMXC            WWOBCSXTTWNDI   NAYOTSGEMLNWRL 
KWLGDXYLMGD     : TMDTUL          KDFDS           UJYOYWAGQBB     ILTNTDWQMBNY    GBFBSRCOINPTVW 
EDPT            : AMHILSGDJEPRT   VYJHDTUDUA      YRYKAKJ         DRORTHSVTYFQP  
CPEEBXPLJJDVTK  : YPYJTWO         EBBAACE         TLPFWIBLGNHPDJ 
SXMWVOKKWNXCTN  : BERULFOFPAR     FEOWXM          WCSVMNTVPPPX    ORNNPEXDBNBFH  
EQNKWOKPDVYIRUS : MNNKRGTREFDJT   GLLXHL          NYPYWQUIJLSW   
ORNNPEXDBNBFH   : GJVCBVE         SXMWVOKKWNXCTN  HIWXLOYMFQIL   
DNHTAHK         : NDTULOVPOTRADAF BWEWBHJTSY     
YNGXYXTTYKNOXES : FFHNABMYI       LEMVEHHFOMJ     HTUGSWYGWRVQAW 
JTLKAVBFJ       : NEQHRYAUXQEERQR FPLVGHXIMND     SAJHLFEWLGBXIOC
YKUMW           : SWWDHLMLUMVPS   PBEIUQWRFSUCK  
CGRBE           : LRUWOAKRY       SRDUEXHCR       MIONUIYYBIC     SJUFBIVBHIL    
XFALTXROXBJKLLG : PJVFNJL         QVNRGJJH        KUPUK           PFTAVGGHQ       EHEV           
SRDUEXHCR       : MDOLHOGYWCUXOW  CHNODNXRTMHQWLJ MBDHLCBQLSARU   CGRBE           EVDGGAYQAYD     IBOXLUBOTWE     XFBGDT         
IJNOALWAYSBRIY  : HIMYJVPS        FORKOSLUHNVG    OMWBF           RMNUQDIIS      
TLHHRYAMCUQ     : QWIELKTFGL      KEQNUCHW        LXUGWVLFWMHIG   YIEWLUN         OMGCJF          UJPVP          
EURQDDGU        : MNWBPFFF        KKNWULEFKEDWC   XSVRNLCKWLYIVU  KAKGGAQ         VAIMDEWYOALTE   XQCFLCYLOQT    
RRISKJ          : LBLGY           SQGURUOMDVYOJX  YUBAPIFQ       
UIGOUPV         : OPASV           IVSBV           NCUX            IXCSIXMXYQM    
OWBQTUSYPMRVRX  : QYPCQJDPCSTW    UKQXRILQH       UCLYWYFY        AIHRSXHH       
XRKGKWRV        : AGBCFOSF        TEMYTKXFTE     
CEJYTGQI        : NFVLVROXKIMCT   BNLOVMDLIJI     ENHOFGEDLJRGLB  VOWLLCRJVBSHOH  PMEOCOLL        RGHDTLP        
TBYO            : NMVBDM          MKAV            SUYATTARMAPD   
AFKT            : WCYYMHPGUHEFMK  BNLOVMDLIJI     UBCYO          
CRVCJIKUHCS     : VSDFFUOOIHHGXJ  XYEANVBHFTVRIV  ECDDSFVIPDKFS  
HWKGSSWB        : TAPWATDVHASW    NBKQFLT         FRMREPTJHSPHTU  MDDIJASDYCPNLAI
REYICCPMVSOQQTA : JWHSTL          WGKVKEE        
EWHJP           : NHPL            QSOSDNSOGYD     BLBO            PFTAVGGHQ      
QOVYHOYKOQOQBS  : QITJPXGKEW      OSRJJEOSXCA     JUJIEPJNNE      FBNMTI         
RFSKWJCQ        : QIMWLGQ         QYXWU           NCHKQLO         AXTBFXX        
DUJKGAUYQ       : QJNDTFJRFDG     YCNHV           VBFWUAFIKMVGMCL
YYIXJYQBP       : GHQYLTFFXOJSKO  ROVX            CJRQQHMY        XAFXOVIROUEU    GPOIXWVPTLOGHLS
TMLCGYYR        : GIGAQVYCKSFLAA  LDHVVWS         LUDK            UTUMF          
PEGMOTVQQ       : WBQMSJYQDVXFYR  KDYDEN          GCVUUNQXIOJGC   VPGDFGEIR       QUKTA          
HJVIRTSTMV      : AUAOXERF        VHNDFMGTD       LNMF           
HRYUTHTUYWKGG   : COYM            TFIUVREI        YBXY            YAFSGG          UOBJO          
UAVLQQUAN       : XLTGHSTNO       UTAPAJPJXRNLQA  RPBL            FWQVQART        VLQT           
UJYOYWAGQBB     : APJWVHXOHILPIWT UGMVPDAMEYMNBB  KWLGDXYLMGD     WRLXB          
IXGKWTQDTLF     : WVUIMGCIKBJR    XLDAM           MVXPNUBGYSOHBYC YVQXXNHMAES    
YVGVYVA         : QILA            APMRMIAYINQH    RXNH            IIPTOVKTJOCOOPO UQVROUK        
GBKFXMNP        : COYM            TXRKJDPBFQELN   RTCVV           GJIELTLVOQRHH   LHMEULMDXLKGJO 
QDWOLHMFARBNX   : KDFDS           UIMHEAXYGVUTE   TSDVBJGJTUWM    RKWQ            HKFSHKLNSOJGEM  BKMJK           JUCLXPY        
OTALUVNQCPBJPO  : QUUBSF          NTAYTTAVLIQIV   GYWJ            AKXJ            DUKXECJUBICTPRM CPNJAXKR        QYUNUMGX       
HDOMCDYMRG      : UNKAPQSLDQ      WFQRWIT         UVFGFN          CMIBHSDC        OFPVXADOG       RGHDTLP        
KIDKBRGBD       : FYRVRESFLWFHO   SSTB            GYGMBUYHOV      PLFIYBXYSXH     JRCNPSYSJLBHF   WMUXUPPJNLP    
ATSCLWMBNL      : FUTPTIWEWIGUXNK GSAYPWLQAWYQB   NBBNNICDB      
SAXUGWJX        : JXUGKS          TONO            JRIUFMDTWRI     JVNSNOMHOGR     XLCCJNFPPGSXXUX
YKOCURTETAGVTBX : DHJOFTOPVBWCE   UIHQK          
XMILYTEB        : LMBYKOXUQY      SFTSAPABQEKVAQ  DSUOQ           KYKGPRWXOKU    
CHRLIXMSOOQJL   : UROB            TOXPNDEJASMR    TMEC            UAYMCTGIVMI     JAJJXEHKQT      BTNBWVAMSX     
FNDBJGBOHOYSPV  : XADFSGUMIWDJB   ALJTJICBTFUORP  XAANQTKM        ANNUWAKDKRNXBY  LUDK           
SQEB            : AJAFJOFWYYI     CJIPEPYHW      
RJJFEAVWJJTO    : FHPMQFVMMGQOJDG PJVFNJL        
YPGGRWNIWIA     : LBLGY           MTTODPHEMBIOG   WVUIMGCIKBJR    PGGDDSFENCGV    HRNGQCKJTCIBF  
KSJOVTHHFOMIKL  : QSNDSDSHAT      HIMYJVPS        IMHURXYPEKQXJED
WGLTFDBLWXBFWK  : WVWDTALVEHM    
RUDDKBATJFK     : IDBCNKYCUDPHQPV
PWHKTPVOVYRJWRN : NEKPBYTHTOI     OLDFXMEITXLPILA JPWDV           UWTQESGJNJIVPPM
PXOHSTNF        : EGOYXPLFURS     EWAKQMKU        DQTIGQH         QRPUOQEAMX      AYGUCXHADVLB   
NBEULC          : QXVQJEK         YDCHPR          BESN            MTTLJB          ESJOCTCBNNIYU  
LMXFCTT         : NFVLVROXKIMCT   RKSLDYSOTLTL    MKDRNWY        
UNMTGABVARF     : XLTGHSTNO       TCQDGQOJ        KNIHYT         
LSDGGGNCSPPG    : STVMXHVIYT      VAFUYIJXHI      ACSDFCSACMHX    WTTOCASCNVEKO  
NLJJILGVABCCEA  : IUMCUM          GJIELTLVOQRHH   PJFN           
VIXHBDP         : FQUWTNEF        IAXSQGNPWAHCO   HJJXDC          RKWQ           
JDOEVGK         : DEIFVD          EECBLGTTOVTIS   HWNSKMRBCTXIJR  DFPKN           UTNSOPBGXLL    
TWLDHXJDX       : DBWMMPROAGJK   
IDQIFOQFV       : QUAXNA          QMJYCQRDA       LJUU            PAMVGIJWUJT    
IMHURXYPEKQXJED : ATCM            AUTPMK          UJNTSGF         ENSEEWIESKVWO   CMIBHSDC        SXEUYRD         KSJOVTHHFOMIKL  YLXTIHBEGM     
COTD            : GKWYKEXWJQI     XEVTMFOHO       HUKJVSYBEXUXM   NAOEYEHSDDES   
EGWNNMGTIDE     : AOXLMNRN        QJPNNI          EYXLJ           OBHTPMVT        IVVGDWNTN      
KYRKBHO         : IKNWLTHPIRC     DSXTXKLXCQGX    CUOKWW          FUTPTIWEWIGUXNK NDTULOVPOTRADAF DMSMVYGDXDEV   
AOWFTNJJJOPOW   : DWKGFKQOFJITNVF LGXXLIGUEQNMV   BKMJK           EHEV           
ELYMHKQNJD      : QIMWLGQ         PNGGTODJW       MEGTWMKE        JNXPUHEADUP     YIFUMBSPPLA     SFTBGYBXKOJRLBI PIWULWYFOOPJBEV
BQQLFELWBS      : VSDFFUOOIHHGXJ  VHNDFMGTD       WAJBMLVQEYWVQG 
QDCARR          : QJQYJHTTWTO     FIJSU          
PFWDGKKQDX      : OKIXH           CPHC            VDIFM           FMRSSXQGHHCTBA 
INGYERHI        : EBBTVTCEQYCASQF MPPTDUXIVLQ     ASTGY           JMQLNHYBDPKUDM  VPHAOISSTWYC   
EJYUCCXDWP      : MDDIJASDYCPNLAI CTFHJOHGMBBBII  SOEYYKWJ       
MWTRGGCYLC      : UVFGFN          AGCTCVGDRQFAHMH ENSEEWIESKVWO  
VQJV            : RHTIWFTHEOISGK  FOBGGB         
DDIHJTJEWLEAIW  : DMMVFFF         XBGPEIMYVWTF    DKQVVGXJCKLEVO  NQWJXBONGSYLP   WTPPDKWGUTJ    
WTTOCASCNVEKO   : KNWBYGPHRN      IATCI           OKIXH           PBGM            LSDGGGNCSPPG    RYOPBHDNW      
ILTNTDWQMBNY    : MCNSUQKKKQR     KWLGDXYLMGD    
PJFN            : TUIEL           KITKYEYDTL      VDPHAONWIAE     YEGOHW          NLJJILGVABCCEA  HQJAXOCUUSWDJ  
BIAEKTG         : SPGMFGBIUJBNS   INVYENNLFGRGP   QISPJKNIQWAY    VGGBGG         
RMLIDTTY        : NYFSDWGTRUGBR   CJIPEPYHW       IRRNYUBN       
QCEJPHWQPMCU    : YVKGBMU         JJMMOUTMGEMXQPS BUWM            BBLMENBCC       HBHQNLL        
NWKODXKJYCXKM   : RMGQWU          DEAOWMI        
GGANY           : EDUTTBRUNWWD    XVASBTIQV       YSLVPX          VULMIPUHK      
TIUDHNTTPQWGPHU : KKNL            RCTB           
HFEGJDQVG       : CTWPLGHC       
EJMGO           : IPOVKHHDLRQ     YVJSUNJJIWIVWN  VGEDDDDU       
QJMYYIUQBR      : JQDLDKRAJG      ABXVWNNONNL    
TCROJYVQKYJIH   : QGUOWGTPPKME    MGWSERXUICM     JXEWIKBQVE     
NQXVFH          : NEAFXTEEKELXO   VRRCPVHFKP      SEWQWIJYKXWNRMG YDOGXASN       
QVNRGJJH        : PHFYYLTG        BRGQFSSECRNFAYQ VDNDQWUWTX      WHEGD           XFALTXROXBJKLLG
GBFBSRCOINPTVW  : OLDFXMEITXLPILA XJWMWT          VUWCMN          KWLGDXYLMGD    
LQEJVLYPJOH     : JJYAVKAPX       YEDLF          
AQYEADL         : JWHSTL         
VDFKNUAITWNFPR  : TFKCCBM         GLRXLBFXRV      NKGYCARLN       UDEXTJHLKOYYHY  PGIIBH         
MFQEQHLGIF      : LFRHCUOWX       YIJWVKHHYR      KREYYNUXVI     
OHLAKHGPRTLTEF  : FEIR            LWXOPTEEM       CEWJIS         
UMJMGVU         : LVQMGOOIVD      KEQNUCHW        XMYWWQRLG      
CNHPURUFGC      : FLMBGDSYBW      LMJHBWXIQ       RXMFSEXUKXGXSIF MTOWNEFDO       FJLPHLAKA      
IMXOFRLSLRAEM   : BUWM            GTTXBXQFYIDXQAE PXLWRHXYCQNG    GVAFK          
NCVLYUNMEEJ     : DUVBMNY         IRLTX          
YOCEFNS         : KJSPNPMR        YKHXJTTOJU      UYIDDKGLLJHHWL  GVTKTQXSAVLID   EDUNEXC         HHHLKI         
CAUPSGKUNWMBYI  : PUYYOKNQXQF     RXMFSEXUKXGXSIF WHHNRY         
AFBNK           : QBSIBHTVWEKLL   BUWM            OTUFPRHTDUOGLSM ELSIWP         
WIJMNNTBIAFJW   : AMHILSGDJEPRT   SWEQX          
EEGCR           : GVMQ            QOUQUIRDQOPOT   BLBO           
OUHWIHEMWQ      : XTCO            IGHVI           FNHSLITVHL      IPNFPSLGECOQOV  SGWETGWQNHLW    FXMM            NJLSIWGIERWP   
UADJNS          : ATUXYMFWPF      HYMXLIUSQPQ     DHJOFTOPVBWCE   MDOUHHIGIYIT   
OCDTNBRT        : YRIAOEQXHN      BBLMENBCC       GVVYQHVOPBLGVYX
AVBGKXPJH       : DDFNNUKAOSRYMV  IKWBQECLMETTKBL
OTUFPRHTDUOGLSM : JBSVFJHFHQE     QGQYQGMYRG      NNGCOGBBNEAP    TCFBBQKV        AFBNK           BMILHVRGEUJR    LEOJITHR       
GPCDYDYC        : MMCTVMIXGRELC   OWWQU           KXIUEFSVNOFKRU  FRWQSOW         UXWPPADJXPJD    HHCTEDCELFQXDLM PWNMTARR       
KADTJA          : SPTICX          XNEFBDQVR       NGVTKKCNW       OAMUPPR         RJRXPU          QPPWGBHAKCFNUX  IEVJIMPUBU     
FWQVQART        : NXAPQC          SRGHDXR         UAVLQQUAN      
GDJARTIHWL      : OOESNJEPNHDFXE  PALVQDRH        VHNDFMGTD       TXWACW          IBOXLUBOTWE    
CNMNX           : UJNKGSBCHFPWPJA LFERBHSDFXAEHL  AOXLMNRN        YGYG            JUCLXPY        
QTYSFESXAJXRGVB : BRCANMHQCEXS    HHVKKPQAOQWW    EXLEEH         
IDBCNKYCUDPHQPV : XBIINQUJLXSWQN  CFNBRQVBLHWF    RUDDKBATJFK    
JUFQCAOCJ       : YIDLQISQCQ      HMXRQYWMAXQF   
WRLXB           : OFGKJNPGXYJEAN  TAQNVDXYVHIGP   GOBEVTYKBBBJKTF UJYOYWAGQBB    
BEYOQAQLEI      : MIONUIYYBIC     TKBHXXJWO       PBEWKEOBRS     
WXRJKOOBQOQVAGS : BRGQFSSECRNFAYQ TAPWATDVHASW    SOIOMER         HQRMRYS         XYIDRO          PGDCW          
TQVQTDRKTT      : FJERCSSDA      
IAMDANWJXOAYF   : MYVITJC         JWCSYODEAPEC   
PDSXVN          : WBBRIKOJC       FNTHTA          WNFXMYWAQLWRP   NKTKLTSUG       UNOXK           UQBUPBXMK       HUDXJLAUQ       KYKGPRWXOKU    
OMNKRF          : UTRXEGWSCABX   
LBCTEQAEEWPEN   : DDFRMQUDRMBOAW  TJJLXVCPW       IGNVBMILSVLJFF 
EVKVYFWVTRMIFAA : UNQGP           KYHSPMLLECHC    PAQKCSAINV      PXGTSFQVO       BGVVQOHGTPMH    WVBLIEJJTTI     EQTMYFGKNGFUKR  YFDH           
XNNAKTSKAX      : KLHLUX          BGVFUFDY        NUCAQROR        LWXOPTEEM       OIMDTOWG       
PCXJITTFUACS    : WFWJQFPMKNFO    AYAXKNYH        YOYXUHFYOWGRHG  STUSCVBCLIH    
VGGBGG          : AWIAIJ          GWEGHMSO        BIAEKTG         VBIWAGIV        TPUCWCESD      
EVDGGAYQAYD     : JKPSTPKYXA      JGOCXBIFIUFU    SRDUEXHCR      
CDCMYYRTBVNYRV  : UXWPPADJXPJD   
UCNKIJOQQOPJOPO : BRHYFDTRKEK    
TRMG            : MEBVXTMLLJ      DCQKVQTJL      
LBLMYBLT        : YYRRNWQNCL      OANPSFQW        TXMKJNURN       TECIUM         
SOYGAJP         : SGDW            XHISRIMCCKCK    KREYYNUXVI      CTHXJHHPAECHKSA
AIHRSXHH        : MCUMRSKXSH      KCCNBMWAOK      ARPSG           KNIHYT          OWBQTUSYPMRVRX  BHVD            NYPYWQUIJLSW   
DCUMSGNG        : JMYOWDRTHDL     BKRBGF          NGOT           
OHIKEBAFJCQYUQ  : JIIBJO          TONO            DRWUUEPY        XDNEGCASA      
CJDCSMKWO       : QYYPR           FRXXEX          VWXGDV          VCEBFULBX       BOGSQX         
JKNYSKPB        : DQJO            PUPUCIONM      
BHVD            : PHMVKL          BEENQQW         AIHRSXHH       
FHGHCARGLWIE    : WDELJYHREEBDOH  VCEBFULBX       WOLSM          
VDDBONRPGEGJ    : MXRT            NVCAR           SWWDHLMLUMVPS   RDRUSWICRT      HLRJBEBK        AWIAIJ          ISLOFGEKCF     
JTVMJEVPNX      : OPMM           
HGDEQ           : OPASV           WHAU            TWFGVQVPWG      IMMOQJAWKXGCAD 
RMNUQDIIS       : UNKAPQSLDQ      TDIWUW          IJNOALWAYSBRIY 
MBDMKWLYGR      : SEMLC           HDFMVSAUI       TDIWUW          DDIA           
YHUSOBWUSHMH    : HDFMVSAUI       RELTTKLJY       DETYTKDT        YQBGHDVKW       YXJXFOJWK       JGOCXBIFIUFU    IJQEJA          PWEJLG         
YHUSOBWUSHMH    : QVYCK          
IXCSIXMXYQM     : XVRFU           MMXAUFYOLYHH    UIGOUPV        
PXLWRHXYCQNG    : UTPVNWFMK       RBPBMSN         ALII            IMXOFRLSLRAEM   WVBLIEJJTTI     BTNBWVAMSX     
IBYXIWGHB       : TDSVINGJ        VLQT           
RYOPBHDNW       : MKDRNWY         OHDDXFCFNWKDFRN WTTOCASCNVEKO   SUYATTARMAPD   
BVVIVWNNL       : GLQRKVYYJQSWV   QWIELKTFGL      ASTGY           GTACOCSTEYD    
FVWFTFCCO       : APJWVHXOHILPIWT XBDYQISGVKILI   TGVJDBEQTWG     XDNEGCASA      
EJFUYGE         : YFAOKQKICEBDD   MNNKRGTREFDJT   RAYQXQQJULIVCV  SIWKTDFTWWFRBS 
VBIWAGIV        : KEVXNQXTJFORT   LRSVNFBJCPV     QJPNNI          NAXQUU          VGGBGG         
VLQT            : KWILBK          XSTAITJXBH      MBWAHDKEJLVD    UAVLQQUAN       IBYXIWGHB      
NQWJXBONGSYLP   : YQMXNWLWBLUDTTA GTTXBXQFYIDXQAE DDIHJTJEWLEAIW  FNWMOYDGQBJWKJG
TTDPW           : BBSFYPXFV       TWBC            ONCPKIG         LBKRTVWMW       MEBVXTMLLJ     
PWTXTWVF        : XMOTAEKYGIV     CFFDF           TONO            YXJXFOJWK       DTDTO          
PYEGV           : VOCECM          RDRUSWICRT      XWQJJUCKVWWMJT  MVXPNUBGYSOHBYC YRCCCVSQW       NNCVPEVBD      
GYCVGWUTOTQK    : YDKBBEJPIKR     FORKOSLUHNVG    QQQNPUNWF      
IIMXHGVBDTJT    : VUWCMN          LLBHIQSFOLTOW   MYWEEEXC        GGVHP          
IXRHOY          : ECPJGRKTXGO     SATVR           FUXAAKDNFONHT  
SUQS            : AUTVDAVVUJ     
LHMEULMDXLKGJO  : OYHJSV          VUIKJPEAYKPOSUU OKTN            GBKFXMNP       
GAGPKEKTULDOI   : IFCFQSKXNXVLQ   XIWFYIE         UJBFMGN        
HBHQNLL         : YATGYYLCBHY     CFFDF           QCEJPHWQPMCU   
YQBMCHXSTESAWDG : LRSVNFBJCPV     BDUYP           UMLLNJGURILQ   
XCUDQDWAF       : BRQNGPLYNFU     GOROQQUTJGEUQ   DKPBIFWTBSP     SRGHDXR         TMSWNYYSOXGR    OTSXVJMHJQ     
QUQFWRVX        : WKUESGXGMA      PJVRPJPA        SWEQX          
XIFSCLLCIRKRR   : FWREINRVGB      HHNMGUOPNGXIOKM WDNIDHOC        WXJPJEBXGB      DMSMVYGDXDEV   
OUDURDC         : YDCHPR          RNPDLOEFDG      NVCAR          
WWQCVKXURY      : FXJDXXTWTFEL    XTCO            LWNCB           FNEXAFBRIEPLSW  TJJLXVCPW      
YRHKELVXVNP     : MGNMJJX        
FKOAEUCERBWVXHT : XGVJBYVPWGH     BHNDLYSR       
YUAANJL         : XIIDGKBKLCV     DFGT            BLBO            EQDALYS        
UHRQWJ          : STVMXHVIYT      KEQNUCHW        NGVTKKCNW       XEXGMWBO        BWEDJ          
CVRE            : CLTJHJNAGKMLVE  BONOIWEGTCB     ECMLIMBJLUJQNX  XMHTQK         
OIEIKDEKLAH     : DIEOJLYUQPPJ    MHPREYHCT       JTESUPTFPU      XUVWLXUHGUJJH  
VHNLQYFNI       : DBLOOVWJIWNI    APJWVHXOHILPIWT KFBQG           PGGDDSFENCGV    JUXMLPXXXEV     LQYMKJFIRW     
GFIJKEDOGRANCM  : YRUS            DJVDPEWYH      
GWCGGRENF       : HWEDGNO        
GGWVOVCVGNGMS   : TFDLSLIBOEFJBHU WEXGWOUDENBNPB  VCRT            QQQNPUNWF      
TMAJOMAULFER    : DUOJVVKLWV      SPAWGQDIFLM     WDELJYHREEBDOH  OLNNUDEIGAXMX  
IHEBPKXLBUPY    : NWOVIKWGLLG     MNFRCMRHIFNHB   YIYV            RENLEMIWEEXVS   AQWBWJV         SJUFBIVBHIL    
GISY            : NRTRAPEQF       DRORTHSVTYFQP   OYPQNWEHBPD    
OMIXBW          : RENFJJSCDXVET   QYUNUMGX       
YIFDCENJIO      : NRTRAPEQF       ATMGWPNNDJXFAS  TSDVBJGJTUWM    OQMCQF         
UNOXK           : WCYYMHPGUHEFMK  UVFKNN          REQIHRUFCFFLOSU LEGJWEBOTFUDA   PDSXVN          MVXPNUBGYSOHBYC
XPMGIMOW        : WNLTX           XKWPVGVNSQIPJF  QAXEEKB        
YUCVVDEBGIIWRQ  : OPASV           WMEBUXYEVU      IHFPLWGM        CGEDMSJ        
UOBJO           : CMRR            OHDDXFCFNWKDFRN HRYUTHTUYWKGG  
PMCFUKR         : UELJJP          NRSO            UQWPWAJR        YGYG            UXWPPADJXPJD   
KSKFWGBBMFJUPG  : LDWUGSMSPLDXXSE WCYYMHPGUHEFMK  TRWFPXRPQG      PBGM            FEOWXM          DJVDPEWYH      
IUJWV           : SQCVJASJVSQ     EETORMOX        OLNNUDEIGAXMX  
MKNBOS          : QNKNXOKFG       CIWYBHQJ       
BMILHVRGEUJR    : OLDFXMEITXLPILA HTUGSWYGWRVQAW  OTUFPRHTDUOGLSM LTHDWC          ALKOT           AMMGVXAPIFJGRUK
TORCEBYPAX      : SEMLC           DSBAIRGAUMIRXV  UOKGUXFCTTSYQDC MROICAYUM       MQNYWWMSCGLKAV  HXICVOJCQMGVTLW XEHYGTDJXJVW   
OIBQYV          : XRDISL          IHXPMEMWFWGLWW  GOROQQUTJGEUQ   KGGLPDDR        BUCELSQA        IUFCK           DSKFKLWDBUJLXAO BWEWBHJTSY     
AKAOTVGAB       : GAYNTBDMKLTX    WCYYMHPGUHEFMK  DQJO            MRABIKIV        QRPUOQEAMX      UJPVP          
KSIGHAKNDKEGIRU : FJERCSSDA       IGEGIDEUMFNC    XYOQX          
ULRQBTDCI       : VYJHDTUDUA      RPBL            TFEAYIAYNIFRJMY VGCASNU        
AQWBWJV         : HAQFG           BUCELSQA        IHEBPKXLBUPY    AVPCPGW        
RGHDTLP         : DECIRCUNC       GVMQ            RECSCB          CEJYTGQI        HDOMCDYMRG      JMKQPIWEM      
RXTMSOBMHEG     : XFLTLXPYVHAM    DMENNGJGNJAYAE  EPQGNQEWNDOCTWX
GPHH            : VPMBBYEJCAIGYT  JBGDJXQGYHCBO   LHXWVOILYJME    QACAXPCVTGYCBK  JHUMXCYKBXB    
HKFSHKLNSOJGEM  : MXJNPGMSTJFARJK AFYKVVSHFIHS    QDWOLHMFARBNX   TFIKGMO        
EGOYXPLFURS     : PXOHSTNF        GKBGDVLQLXURFDM
JCMU            : VULMIPUHK       FQBHUA          ECDDSFVIPDKFS   PIWULWYFOOPJBEV JPWDV           YGHAXJCUHYLLR   XPOMDO         
XAFHN           : TVKFDQOTHCH     YVCINDOUXIJKFHF CPLAPYA        
UIHGOLSQRCFSAX  : SOWVAOOIBS      VQBQEOHQXRFAB   TICGQHG         JXYTMEBJERL    
FUXAAKDNFONHT   : SWWKDJRLLA      SGQAAUV         NKDEJ           REBTFPXBDPMIEY  IXRHOY         
UMRDTXTFTKYVS   : VAIMDEWYOALTE   NILURWMBKN      VEPGRNAQACB     DQTIGQH        
XQXD            : EMHREVDHQPDWRO  NMLBFDNRTQTVX   ASTGY           XQDHYGKRVQQJN   QNLSOJPNAFDN   
WGNJJBOAQX      : FLRJHASFBMRUT  
LTHDWC          : EMHREVDHQPDWRO  LUJGUGYCCHMIG   BMILHVRGEUJR   
TJAELVWFTPE     : CRUCJVUHCUHCRGI HRYEETBGJBNMLGK MKDRNWY         KSCKMVHRMNPAFF  TSKCLWPSAYCKPFY
DDFRMQUDRMBOAW  : UUMNPFIYLFQEHAU UUTTDMOHDDMNC   HKWYBBHCKTGADKN EMRGHVJ         LBCTEQAEEWPEN  
EWAKQMKU        : IVICYPCCVJ      ECMLIMBJLUJQNX  PXOHSTNF       
IUFCK           : SHUILFFLGSB     EQMULVBMXSNM    AUAOXERF        PQKPWWIAFPWYQSR DYJJKRYVUB      OIBQYV          SAHTNXBGX       FTYXUJYUVSYGKM 
DQOLKDCFG       : RHTIWFTHEOISGK  DFXSPVRBAFUTV   QFCIOSKSQQRL    EOSTQWCKJY      GGYAAJHBBQNGX   UGFHVIGGCB      JPPQVCYCP      
TKKUH           : SVERGX          SMKJHKT         DILY            IRTI           
BELLWAXUA       : PBIUPOOMR       LKYNOVEYUERIC   XDVA            VNXAK           DSCJ           
PIKCT           : FNTHTA          XRKVR          
UJBFMGN         : GPNTLLJ         GAGPKEKTULDOI   IQPOBBLHHOODLEJ
CJIPEPYHW       : GYGMBUYHOV      SQEB            RMLIDTTY       
UTNSOPBGXLL     : TEEEUMSPGO      VTYY            QGUOWGTPPKME    JDOEVGK         AXWTGECYSOOJJRN
CGEDMSJ         : FLDSULUVAOXFBKS NOVEMVGCTKI     XPYFIASJMLCGSXH ECOIHPTO        YUCVVDEBGIIWRQ 
QMJYCQRDA       : TRWFPXRPQG      LAUALVKDXTHGYAX CNRYR           IUSPWWQRH       IDQIFOQFV       EKCEDTDJQTYELD 
RXMFSEXUKXGXSIF : WHSBBLMCYJPAEY  RJXFFSNLYPPG    SXEUYRD         JVNSNOMHOGR     CNHPURUFGC      CAUPSGKUNWMBYI 
OTSXVJMHJQ      : TFDLSLIBOEFJBHU FRVSE           XCUDQDWAF       PWAJQPIOT      
DTDTO           : VIXN            POSBRV          ACFQ            PPFYSSPKU       PWTXTWVF        KLFIRJOWDMPQJGV
GVTKTQXSAVLID   : APMRMIAYINQH    NDGRHBC         FORKOSLUHNVG    MCEB            QITKNERAPSPLTP  YOCEFNS         PWAJQPIOT       WIDDFSADPP     
WWEXUPKD        : WNEO            PALVQDRH        GYTS            LWLGYVKKE       CHFXHXTTOEPMN  
CDEXGXM         : WYLPNDCWF       YKBYKJCSUYTMBB  PHMYRTXTCMBUPX  SJUFBIVBHIL    
HJGTFWTAWQMIVAH : XIWFYIE         YRIXRJTXXGCT    ETRQUKGTNP      GSAYPWLQAWYQB   JJMAKNNXY       XSWDUUQA       
GHQV            : MCNSUQKKKQR     KPTRYDYNRJBF    VUWCMN         
TXWACW          : FCYAWSVBG       HNSEHOWJNHAUMET UDMQBAG         GDJARTIHWL      RYYQ           
DMSMVYGDXDEV    : YVKGBMU         RMGQWU          GHQYLTFFXOJSKO  KYRKBHO         XIFSCLLCIRKRR  
SGRSPNYX        : WBQMSJYQDVXFYR  QYXWU           HJJXDC          QBJBXFNQC      
UQBUPBXMK       : YVCINDOUXIJKFHF OHDDXFCFNWKDFRN PDSXVN         
YFPWEXBCBHA     : UKQXRILQH       ONCPKIG         IGWPDAWS        CRSIXG         
AGRSWFTUMQNQ    : YPYJTWO         GQHUS          
FRMREPTJHSPHTU  : EHODFRNEJMSINW  MSBFAKPB        PALVQDRH        WNLTX           HWKGSSWB       
DUIDEAXDIRAWJ   : QRWDXJL         IVCDSFRABICFUJB QFIUYCW         BGIKOUUBLSRNGPD
NXUGKMMCIYJCQ   : CWFVBVGUUHKM   
XLCCJNFPPGSXXUX : JKQMDHLXXDBLR   YQDOA           SAXUGWJX        BUICYSGFXAKITE 
KLHHTTVHVFIHJ   : QQHUME          TXRKJDPBFQELN   VNKV            OKUJCJSTFE     
BHNDLYSR        : BELALEKKTKYLF   GOROQQUTJGEUQ   FKOAEUCERBWVXHT EMOMDRDHQHOM   
JAJJXEHKQT      : FWREINRVGB      CHRLIXMSOOQJL  
XPOTWM          : MNFRCMRHIFNHB   XIIQOAH         MEVNWBIQW      
HUKJVSYBEXUXM   : OXEPEVFYE       BIVCAH          COTD            KREYYNUXVI      CTFHJOHGMBBBII 
XXRYEALWVFULV   : ECPJGRKTXGO     VSDFFUOOIHHGXJ  XSEMNEALKPFTTA  NKOBUP         
LJUU            : IDQIFOQFV       BKMJK          
FECADDHDAHRGI   : QUKTA          
YJTBUQYANM      : GIOVWUIOXHKFBBP
HXICVOJCQMGVTLW : BDYAW           TORCEBYPAX      CPLAPYA        
EDLVEUQ         : UROB            HPBGGSTMJWXUAW  RYYQ           
PJESAT          : UNOAUGOXHIR     ACELCJOGNCW     DFGT            LUDK            MQAIMTPJPI      YTWJNFR        
JRCNPSYSJLBHF   : LFLE            KIDKBRGBD      
ELSIWP          : CYRVDPJKWSTU    AFBNK          
SIWKTDFTWWFRBS  : CMNQGJKELFPEG   BVVVMLHVPL      EMRLKHWDEYBTASM EJFUYGE         GLYJHJQIXA     
TSAFEBNMQRXJCWY : KWILBK          APSMNUFKL      
RHODCTKXRKEJLY  : DQPRWE          XRKVR          
IRRNYUBN        : HKXOSTJIYCV     UGFHVIGGCB      PMEOCOLL        EPQGNQEWNDOCTWX RMLIDTTY       
VNXAK           : BESN            OOESNJEPNHDFXE  BELLWAXUA      
TFHKKJFUJWFNG   : YVKGBMU         TXGGO          
PWAJQPIOT       : XBDYQISGVKILI   OTSXVJMHJQ      GVTKTQXSAVLID   KFVECGG        
CPLAPYA         : HYAHQFNWJT      FEOAYYUTEEVBYBS XAFHN           HXICVOJCQMGVTLW
EHWQSC          : QSNDSDSHAT      FILE            KMMTCWM         HMKWDGXCFNLG    PXGTSFQVO       PLFIYBXYSXH     KFVECGG        
EYRUH           : XEKGXIDTKN      KFEWRWMTQN     
KHNTXDFO        : OLDFXMEITXLPILA XFFLH           QJJVFEW         MFNWVYKFIW     
DRORTHSVTYFQP   : EBBTOILSOJ      QWYPOWVHJGECAY  IKOIAIWXMVNOEWJ KMLDFIGRRDYRI   OXYBLLICBLCWHC  EDPT            GISY            TORAYGVYPUMRH  
VBFWUAFIKMVGMCL : HWNSKMRBCTXIJR  GYWJ            TGVRTWJXCJ      DUJKGAUYQ      
BPVSJRACOVBT    : TCFBBQKV        GPVP            DDIA            YUPJHBVTCXGVX   GFBAQRQ        
QUKTA           : OERJRSRT        GMBAPRJUPN      SVJSOBBGCVKIALL QNKNXOKFG       PEGMOTVQQ       FECADDHDAHRGI  
PAPAMCWSQB      : CFNBRQVBLHWF    NAATWKEF        WHHNRY         
SEWQWIJYKXWNRMG : XJVURMS         NQXVFH          XSEKR           FIEJRNQXWKHX    YUBAPIFQ       
YAOJROYS        : SDOKLSO         XAHJWPBAJWPYE  
DRWUUEPY        : SPDSRMBBS       NPAIN           FMHGWWALIV      OHIKEBAFJCQYUQ  UBCYO          
HYLQAX          : JLPRKUO         FYGYJQPG        UKELVJCR        WEXGWOUDENBNPB  VEVXQA          APGEYRMXLHUGJS 
ALKOT           : TFKCCBM         YWEEIXHKFR      WXJPJEBXGB      BMILHVRGEUJR   
NVOXOGYJ        : TWOJESCTBQEYCG  MDOLHOGYWCUXOW  QBLRWLADQK      JVHS           
DDIA            : JOLBGHUDDAAP    BGVFUFDY        SRPAOM          NWES            YMWMXSXHNC      TFEAYIAYNIFRJMY MBDMKWLYGR      BPVSJRACOVBT   
MPYRWXDPBDGB    : BBSFYPXFV       IKCIHYBMRHE     JMVK           
TPKTFHIFXOF     : RNPDLOEFDG      UAAGSBOPTEG     LHXWVOILYJME    FNWMOYDGQBJWKJG
BKMJK           : OWWQU           URVFVTKIFB      BBLMENBCC       QDWOLHMFARBNX   AOWFTNJJJOPOW   LJUU            WGUNPAYHGTEYHVC
YAJQAKW         : MGWSERXUICM     BDKDXXGALK      SOEYYKWJ       
NAYOTSGEMLNWRL  : YIDLQISQCQ      SGQAAUV         DMNMQNG         TBUJKH          TTCITLKJRRKJ   
YUPJHBVTCXGVX   : HOYOY           DILY            NIVXO           BPVSJRACOVBT   
SQGURUOMDVYOJX  : MUSGXPUPRJ      DGTILKASLYEDE   RRISKJ          KFVECGG         VLKPJR          IEVJIMPUBU     
VMHSESDGO       : UQWPWAJR        UNPENAJQ       
INFENXYE        : OOPV            GDMBV          
WVBLIEJJTTI     : JRIMHMTUDHJR    SIXUDDYSHJ      SHIVXRSNGNFIJQK FBDARLGAYCQFX   EMRGHVJ         EVKVYFWVTRMIFAA PXLWRHXYCQNG   
RWMKCF          : DECIRCUNC       JKPSTPKYXA      PXCESCBF       
KUPUK           : SRGHDXR         XFALTXROXBJKLLG JFFKXYJCB      
AXTBFXX         : LNMF            QDQWNKHBJ       RFSKWJCQ        NGDPIYKBY      
AMMGVXAPIFJGRUK : RRQKCIUDXJYAO   UPQKQQGXRGJUJST PPKJBWJY        ASRDRCYJQEY     BMILHVRGEUJR   
MUVCPIXRHTTMTT  : DWDFKIWHC       TSEDYQ          XEKGXIDTKN      JGVLICNB        GRSESFWNSM      TFEAYIAYNIFRJMY FWWEVNVYSHWI   
VGEDDDDU        : FPDHIJI         VWQGSWIXJYVH    TFEAYIAYNIFRJMY EJMGO          
KFVECGG         : CUPHGPH         PWAJQPIOT       EHWQSC          SQGURUOMDVYOJX 
DCRVLRPULL      : STVMXHVIYT      WBBRIKOJC      
FGYCMGFRLKP     : FOBGGB          LRUWOAKRY       SWGLKTPRMSXVKBT
XUVEYEKP        : QXVQJEK         RLLGUGTLINSVAYK NIVXO          
NJGBBVVOIFWQ    : YRUS            NWOVIKWGLLG     KIXGHLJSMF      KOBAX          
YDOGXASN        : RYVGIBDTXN      BQJTTHIYL       XVKPOYB         OLEHXSA         NQXVFH         
SKXXJ           : EFHNYSQMKQRXK   QYUNUMGX       
IBOXLUBOTWE     : MLARSLWOQ       IDOLONBUEA      EONJYPXW        ACFSROYNFN      SRDUEXHCR       GDJARTIHWL      EMOMDRDHQHOM   
EDUNEXC         : UOKGUXFCTTSYQDC VMVPESGIWYCFIFE YOCEFNS        
XFFLH           : AYAXKNYH        IMMOQJAWKXGCAD  KHNTXDFO        JHUMXCYKBXB    
VHYHLJJBIWXJ    : PIOGBHKSK       BAKN            OWEPWHPXB       EKIWUAYCFTHDTG 
RJRXPU          : XJAIOUSTS       BOLXXGXGLPKF    HNSEHOWJNHAUMET KADTJA          JIOCOC         
DYTILRNT        : XADS            PJCRKNJB       
WUCETKR         : BRCANMHQCEXS    VSNSTAE         PRHKNGPRIWH    
VSNSTAE         : QYXWU           CLBORA          WUCETKR         JBPLXXLQHWPYG  
LYMB            : YIWVMQE         UQWPWAJR        VCEBFULBX      
FHVYRJTHFAEACK  : MYVITJC         EXGSS           CUKRJFMMN       RUHYRJDUTBNP    HNDNFSVUHSJAPK  HCLDCROQ       
OCCKXRFRTK      : GHQYLTFFXOJSKO  FSERVOPUMHB     WMEBUXYEVU      NCBLWKTIVEWGE   QTBHXFNYWQECP  
FLRJHASFBMRUT   : WKUYSPMJRHRIFY  LWXOPTEEM       WGNJJBOAQX      RCTB            QVYCK          
UAAAKXOOCCMW    : KEQNUCHW        BFLK            UFCA            PWEJLG          TISLXFOXPIL    
EQTMYFGKNGFUKR  : BMORIWSXYJSL    NEQHRYAUXQEERQR EVKVYFWVTRMIFAA
FNKDPMDCKRQ     : TFEAYIAYNIFRJMY HRNGQCKJTCIBF  
VEMEKDXWEEEO    : RNPDLOEFDG      OVRHPEW         FATLOCKB       
MTOWNEFDO       : CUPHGPH         MEMMMAFVDNVOS   CNHPURUFGC     
SDLUNFMDES      : DMMVFFF         FQTGAICT        VYJHDTUDUA      ISKMWNDSUKMR    XHISRIMCCKCK    NADITMWVQKACY   KXGWXKQAV      
IDVGDA          : NYYQVYMRIVSDU   UHBVSGIF        UKQLEJISCNUPNT 
JRIXL           : SQDENPIUNRHRXC  JJMMOUTMGEMXQPS NILURWMBKN     
VCEBFULBX       : CJJELKXAIO      NKXILYAILRK     CJDCSMKWO       FHGHCARGLWIE    LYMB            PFTAVGGHQ      
VNGKTKFLSLHCO   : MLJUAXQSF       GYGMBUYHOV      TAQL            YKBYKJCSUYTMBB  SJUFBIVBHIL     XQCFLCYLOQT    
QACAXPCVTGYCBK  : QNCJJHDKK       DKFMJYNVBAHDN   GPHH           
BLBO            : BHBGKBIMVN      WGKVKEE         DKRRINQDLB      IUHWPSKDQOE     EWHJP           EEGCR           YUAANJL         HRNGQCKJTCIBF  
OIDTWYFGBVQ     : RBDHRGVAMXJOO   IBTSDRWQQT      ADNSN          
XUVWLXUHGUJJH   : LOEAPUYPVFRX    CGGWJLF         TLQHFXNSPIRAV   CGFGHR          OIEIKDEKLAH    
KTQCOFMRB       : AWIAIJ          TXCNCVBJTXH    
SJQVHJQGFMF     : CDBTB          
NAATWKEF        : SRPAOM          UJNTSGF         BDBECHHVA       PAPAMCWSQB     
OYPQNWEHBPD     : ODOTQFEUSGQSEF  EBYRBOWVH       WEXO            MUCKBLJTNJV     XIGUULIFV       GISY           
GYTS            : ERTDSYSH        AGUGFLVPASQGEL  WWEXUPKD       
AXFFQUISO       : OYHJSV          CLBORA          DKUUVVXF       
DSKFKLWDBUJLXAO : KNWBYGPHRN      FXMM            FIDL            WCSVMNTVPPPX    OIBQYV          LNXHJOLSOLTDWVS
INED            : YDKBBEJPIKR     UJMUIH          KGVATQTU        KLDVOSHMQ       OOBCFWKF       
FBNMTI          : LJIYWSJPTSP     QOVYHOYKOQOQBS 
NYDSUN          : PPGM            PNDEFXQFCHI     MYVITJC         SUVU            YLXTIHBEGM      JTWMFVQ        
FCXKDUWQ        : ODOTQFEUSGQSEF  WKWLNTEKG       AWBWQYTYYQCN   
YFDH            : MLOAB           HUTRKH          EVKVYFWVTRMIFAA
HLEOORCLCYBBC   : GIGAQVYCKSFLAA 
XSWDUUQA        : FYRVRESFLWFHO   UUMNPFIYLFQEHAU VQTMMOFTQI      QGQYQGMYRG      DMNMQNG         BXTL            HJGTFWTAWQMIVAH
NRKMYNVUWJYOY   : OFGKJNPGXYJEAN  NMQYGJVFQWGUY   OLKF            ODIXSAEEVDPEW  
SMURNYWJW       : WCYYMHPGUHEFMK  DQPRWE          OCJMLFH         EGLUQGTQBUJHB   PNISKOMULTRB   
GDMBV           : PVXEAUXMRNQK    INFENXYE       
SJIDXIST        : AAPTUY          RFYAPHXGPTS    
SEFH            : XAANQTKM        ANNUWAKDKRNXBY  DQUYNCYKIPBN   
XATVTHWSQT      : RTNTCIAJ        OEPTHRJTY      
AYYBUOW         : HOYOY           BEAAMXPAPMCUFP  VAIMDEWYOALTE  
YAEH            : NBKQFLT         ACELCJOGNCW     GTTXBXQFYIDXQAE FNWMOYDGQBJWKJG
BLOFQ           : BBSFYPXFV       EAMYHCPUPGSBLB  EFLWCHPAWBLOYT 
MQAIMTPJPI      : FWUQH           VTYY            PJESAT          UTUMF          
AIHCMFSJLR      : KKAH            ECMLIMBJLUJQNX  DGTILKASLYEDE   AJAFJOFWYYI    
SAHTNXBGX       : JKQMDHLXXDBLR   IPBUDEEBCD      HJVYC           IUFCK          
WXXMSNXIVGKHO   : NFWKILDYY       IJMMQKVSSFHL    CDBTB           KSIOHYRHHMKMQ   LRUWOAKRY       YEITJDVUBGL    
TVHDHAQA        : MABITSYFPBB     KFGRGA          UHEJRDCHT      
BTNBWVAMSX      : CHRLIXMSOOQJL   PXLWRHXYCQNG   
FQXGBW          : GWALTVNIMODUMSY IPOVKHHDLRQ     DATSPXJROWFMU   AGACVQB        
OEDDAYLF        : YQWMW          
LVJNWGDYDYYQTYD : QBQAVWNKOL      PLFIYBXYSXH     QSDPEHRXDFEQFF  VXYHVIBT       
QCITBUKHY       : MABITSYFPBB     GIOVWUIOXHKFBBP
HAAMHNKTBKC     : FJRNFECNDYKYTBH RMGQWU          NIOCKGYSKI      JABSVYGLKT      VRRBBX          ILWGEBGVUNGK   
JFFKXYJCB       : KUPUK           WUQAS          
GLYJHJQIXA      : YYVYNWHWJWPTUJP LXDJSSB         FJERCSSDA       SIWKTDFTWWFRBS  WWVCWJMKUETOV  
AOSNYOQJQY      : VQTMMOFTQI      TDPAUXRWXE      VFWU           
XEHYGTDJXJVW    : MTTODPHEMBIOG   YYRRNWQNCL      TORCEBYPAX     
FJLPHLAKA       : WYTPWBK         QWOAGVQBTTDCD   THUTXFEOHQMW    RCVNLJLTYOVVBKN YMWCX           CNHPURUFGC      QVYPTIQOFJNNVA  WMUXUPPJNLP    
AYJRLCQIDX      : ASRDRCYJQEY     HTUGSWYGWRVQAW 
CGKFRI          : AJBVO           MUCKBLJTNJV     RTGIDPCAWGFERTX
NILURWMBKN      : FFXSSNDNTYFX    UMRDTXTFTKYVS   JRIXL          
MIONUIYYBIC     : QEEGRCLSWYEHBB  IBJY            XEJAQSEJQF      CGRBE           BEYOQAQLEI     
BGHLN           : PNGGTODJW       GJQSM           KMLDFIGRRDYRI  
VEPGRNAQACB     : UIUBJSRIINR     EWPCQLRDBETBH   KIRSROCLIIS     QISPJKNIQWAY    FWRELTODTYH     UMRDTXTFTKYVS   VGCASNU         GVVYQHVOPBLGVYX
VEPGRNAQACB     : XEKHFCWAYU     
PNYEEVMDUONAPOG : EKIWUAYCFTHDTG 
CUABYR          : KITKYEYDTL      NAXQUU          RPBL            IVVGDWNTN      
TFIKGMO         : BKRBGF          DMNMQNG         HKFSHKLNSOJGEM 
CEWJIS          : WAJBMLVQEYWVQG  JULUJPUIQ       OHLAKHGPRTLTEF  TSKCLWPSAYCKPFY
OQMCQF          : BONOIWEGTCB     MPMJJBT         GWEGHMSO        YIFDCENJIO     
WFVR            : RUHWFNN         XLDAM           TBLJPTQRIA     
YTWJNFR         : OMAON           GIHDIIFB        LMJHBWXIQ       PJESAT          HRPGCUJIPKNFC  
LEOJITHR        : IOUS            AGUGFLVPASQGEL  UJMUIH          OTUFPRHTDUOGLSM
CQQS            : MSORKAPXBFJQE   MOAGJRFIT      
VLKPJR          : UTPVNWFMK       BDBECHHVA       BTIKCYVLGNW     SQGURUOMDVYOJX  QJBELO         
DYPYYYO         : QSNDSDSHAT      GTACOCSTEYD    
QPPWGBHAKCFNUX  : KADTJA          YBNJHDSYJ      
CTWPLGHC        : HGHELEVWPGD     QMSYIOEOPWKCQF  WKGQEE          HFEGJDQVG       SUYATTARMAPD   
HRNGQCKJTCIBF   : PHJKQPX         AYAXKNYH        FQBHUA          YPGGRWNIWIA     FNKDPMDCKRQ     BLBO           
DQTIGQH         : MXSJDGMXXKDYU   PXOHSTNF        UMRDTXTFTKYVS  
TBLJPTQRIA      : GNOSSKDYVVG     DEAOWMI         WFVR           
VGCASNU         : WEXGWOUDENBNPB  FIDL            ULRQBTDCI       VEPGRNAQACB    
VXDNBTKKABT     : YBXY            YKFVWNVAJGG    
UWDGMYX         : QWYPOWVHJGECAY  AEKJ            YATJNKCHPSSHSU  QAPA            OUHIAHQYSRARH  
HARFH           : IPBUDEEBCD      YAFSGG          PQKPWWIAFPWYQSR
ICJFAHDDVGWIQWJ : HBDMUK          PPRFVXXDBCRIB   DJKVLJHSWWJ     WEWNOKP        
NHKSNWSNECOVK   : QYPCQJDPCSTW    DPJIIG          FYKJKCGLPRQIGBO FNEXAFBRIEPLSW 
SSACX           : YYRRNWQNCL      LAWXXOQQ        TXGGO          
MDDIJASDYCPNLAI : BMGDXRIITHBK    YXJXFOJWK       LEGJWEBOTFUDA   HWKGSSWB        EJYUCCXDWP      NGOT           
XDNEGCASA       : LTVTV           OGLAYIVOO       OHIKEBAFJCQYUQ  FVWFTFCCO       LUUEVJ         
LBALBMOHWAHPDHT : HILLLJ          WXLITIPU        QAXEEKB        
WGVFGVJVA       : VTYY            RTCVV           EBJOEU         
BDKDXXGALK      : YGPSNJ          YAJQAKW        
CRLCYDIIXCF     : APOVJK          XVGVHST         QITKNERAPSPLTP 
ANMWYKWQLADPBD  : EWPCQLRDBETBH   HJGQGYUW        XQQP           
BOGSQX          : FCSPGNJXLAWR    IKCIHYBMRHE     LDHVVWS         DATSPXJROWFMU   TXMKJNURN       CJDCSMKWO      
UAIDKIHQOIGB    : IFCFQSKXNXVLQ   AUUQCS          BGVFUFDY        LLJSSYERLVLXD   XFKDKGCDBQV     SNVYNCLLAAWSAU 
FNEXAFBRIEPLSW  : WWQCVKXURY      NHKSNWSNECOVK   UNPENAJQ       
LWLGYVKKE       : XNTKNXSCDAW     ERTDSYSH        YQIQOSYLNL      WWEXUPKD       
DSCJ            : OPNGUHDYRIEHC   ORUCI           QNLSOJPNAFDN    BELLWAXUA      
HQJOOLTRD       : UXKWQDHGLINVDYV
XTPSSUERGMT     : AGJCDHSAPQRGDI  OAMUPPR         CXASOSJRNBXMA  
YEITJDVUBGL     : XWNNQXELNSQKSQ  XTVN            QHBH            ACELCJOGNCW     ETPVVUXU        GPVP            WXXMSNXIVGKHO  
UCYQTEURAMKUJQP : YKFAYIXPNO      YXJXFOJWK       NIVXO           RKWQ            WEWNOKP        
DJVDPEWYH       : PHMVKL          PCIDROOJUEFEV   GFIJKEDOGRANCM  KSKFWGBBMFJUPG  DNWTOAYLGSV    
TKBHXXJWO       : AMHILSGDJEPRT   KDFDS           BEYOQAQLEI      FMRSSXQGHHCTBA  XSHKYRJSBROPPQQ
DLYEYLBICQBHAWM : DIEOJLYUQPPJ    TNRWKDERNWIUHR  SFTSAPABQEKVAQ  XDMQRVYBPHFSG  
EJQLF           : SEUIGRVO        TDIWUW          KMLDFIGRRDYRI   OKUJCJSTFE      TMEC           
WITWHFTXKYKLDJ  : MCCCD           NXCFTVFYUUQG    ESUYMV         
FTYXUJYUVSYGKM  : RPBTSCADHALPC   RWSDBRMDS       IGSCYQHVDPHKIEA IUFCK           HTBQA          
YLXTIHBEGM      : WYLPNDCWF       TTXKHVEUR       SIBLULY         TXCNCVBJTXH     IMHURXYPEKQXJED NYDSUN          HGNDE          
QAJC            : MUCKBLJTNJV     QGQYQGMYRG      ERUNQBJIGKKYTLF
QVYPTIQOFJNNVA  : WPXVKMBTEABK    HKXOSTJIYCV     FJLPHLAKA       GVAFK           RFRYTUJRPLWVHAL
VOBRW           : CCENJPTQMFH     BEENQQW        
SCPHIIIRKG      : NFWKILDYY       QJAPR          
GFBAQRQ         : TWCCUJKIHA      BPVSJRACOVBT   
BEJX            : UNKAPQSLDQ      DBLOOVWJIWNI   
MVXPNUBGYSOHBYC : PWHTFAHMAMKVTQ  KVQYSPKFAPO     IXGKWTQDTLF     PYEGV           UNOXK          
FNWMOYDGQBJWKJG : EHURPBMUSCHQ    NQWJXBONGSYLP   TPKTFHIFXOF     YAEH            LVVFG          
FERS            : ADSLVIUS        WALKUWLMDJMI    SUVU            QOUQUIRDQOPOT  
SCBMSLNRPEYDBN  : IISTUGNXQVRP    TTXKHVEUR       IGHVI           JTESUPTFPU      YQMXNWLWBLUDTTA
ATAQUJQIVWJB    : CYRVDPJKWSTU    WWRGWTEJTTJ    
BWEWBHJTSY      : WYLPNDCWF       UCLYWYFY        XQDHYGKRVQQJN   DNHTAHK         OIBQYV         
IDON            : GWCYKX          KFBQG           GWEGHMSO       
CHFXHXTTOEPMN   : FVUMONVTMUHJE   NIOCKGYSKI      YJCETXN         XWQJJUCKVWWMJT  WWEXUPKD        IRSCBJAE        PJCRKNJB       
QRPUOQEAMX      : BMORIWSXYJSL    GWEGHMSO        TJSKDJGJEXSSEOR OPMM            PXOHSTNF        AKAOTVGAB      
CIDQYJVG        : BMGDXRIITHBK    WOLSM          
TOPPIGT         : IVILRV          NKOBUP          KTRYEXBQCLCGGPV LJSXKGFCXECOOW 
UKQLEJISCNUPNT  : FHPMQFVMMGQOJDG BONOIWEGTCB     IDVGDA         
XYLWJHGADUPTF   : AUAOXERF        KPYBXRAIPKHNT   GPBVI           UKBGJEOBE      
PFTAVGGHQ       : XSEMNEALKPFTTA  HNTUIV          ETRQUKGTNP      QIVYWMBTSWMP    XFALTXROXBJKLLG EWHJP           VCEBFULBX       VJEJLCPHE      
KGVATQTU        : RNPDLOEFDG      ONMNBLD         UIMHEAXYGVUTE   INED            XDXYRYNE        IEVJIMPUBU     
HTBQA           : XJKGHGGEGYHDKAY WEXGWOUDENBNPB  FCYAWSVBG       EGLUQGTQBUJHB   BAIISUEQLDS     KOBAX           FTYXUJYUVSYGKM 
UWTQESGJNJIVPPM : BMORIWSXYJSL    GWCYKX          JRIMHMTUDHJR    QTJRYXYVAS      MFSKP           PWHKTPVOVYRJWRN
AVPCPGW         : SPGMFGBIUJBNS   IFCFQSKXNXVLQ   AQWBWJV        
YGHAXJCUHYLLR   : KEVXNQXTJFORT   UNOAUGOXHIR     LNMF            CUHHIHYAGMGSC   JCMU           
XFBGDT          : PDHJKMASHGDHDSU JQDLDKRAJG      UBOGWON         OLEHXSA         SRDUEXHCR      
SNWODYGMXTL     : ALII            IYTQLEUGDSSB    EYXLJ           JMKQPIWEM      
DNFMSAVR        : UQLKSDHWOMCK    WFQRWIT         DHCOVMEADHQSB   LEMVEHHFOMJ     XQWKRMVLQOIG    OQUOYDEWERHPMGD
KLFIRJOWDMPQJGV : DTDTO          
NILJVQMKXBDXXWL : EICRELJDARPBBU  NNGCOGBBNEAP    XMOTAEKYGIV     XJWYQLNGVRMTNFM
IRSCBJAE        : GUDXHGVK        YQMXNWLWBLUDTTA VVOUJTVVTBVA    CHFXHXTTOEPMN   AYGUCXHADVLB   
RWIBSVOEHXAB    : OERJRSRT        QMSYIOEOPWKCQF  WBBRIKOJC       KGWWJX          PBQXJTGUWTI    
KYPP            : XOVEXWLBHO      RBPBMSN         PCIDROOJUEFEV  
PMLAXFUCGECMD   : IVKUMCCHAPL     CAEGTLTWMDBG   
LNXHJOLSOLTDWVS : DFXSPVRBAFUTV   HMKWDGXCFNLG    KOSMWHDLOSUC    DSKFKLWDBUJLXAO
VJEJLCPHE       : KBUB            FOPSWKLDYMHWJ   PFTAVGGHQ       EQDALYS        
NJLSIWGIERWP    : GWALTVNIMODUMSY JJMAKNNXY       OUHWIHEMWQ     
NEHQBDJPBUV     : TWOJESCTBQEYCG  SETKIQWBPE      IUFCLGD         DMYYY           TLPFWIBLGNHPDJ 
HXDOFBCQOXYME   : ESGHGSSP        EKDG            IRLTX          
SWGLKTPRMSXVKBT : XCWWHIK         GWEGHMSO        FGYCMGFRLKP     RHLPNTCMQLHG   
OBHTPMVT        : NGVTKKCNW       XIIDGKBKLCV     EGWNNMGTIDE    
KREYYNUXVI      : OBMHSRJCXWN     XWNNQXELNSQKSQ  KARJB           MFQEQHLGIF      SOYGAJP         HUKJVSYBEXUXM  
PXCESCBF        : UQLKSDHWOMCK    PNDEFXQFCHI     RWMKCF         
WMUXUPPJNLP     : ELFRXAOMOTVCCF  DYSAEUDQ        UVTKQVLGGYYERE  KIDKBRGBD       FJLPHLAKA      
GVAFK           : CGGWJLF         UYYPKCHKDNVVTT  IMXOFRLSLRAEM   QVYPTIQOFJNNVA 
DIFNBFRF        : AVYNAJYVVAIBGLF RXNH            JJRJBN          NXKRTP         
WIDDFSADPP      : KIRSROCLIIS     LJIYWSJPTSP     GVTKTQXSAVLID   UYOVJKXLQWJWVYU
BDHSGNPGSCF     : IDOLONBUEA      MQUBAJQKESAJNWY WCQYVPXOR       EPWHOMP        
KKNL            : UJNTSGF         VAIMDEWYOALTE   TIUDHNTTPQWGPHU
HRPGCUJIPKNFC   : GVMODOHDAJAQWLG ROVX            UCLYWYFY        EICRELJDARPBBU  REBTFPXBDPMIEY  YTWJNFR         UQVROUK        
JIOCOC          : CDSQ            OYHJSV          LHHEYRXBNJCA    ERICOGFQFDN     JWIGSVKPVKJQRKU RJRXPU         
WWVCWJMKUETOV   : JIIBJO          GLYJHJQIXA     
TSKCLWPSAYCKPFY : QIRH            NPLUDB          PMEOCOLL        TJAELVWFTPE     CEWJIS         
YVQXXNHMAES     : TAQL            IXGKWTQDTLF     QYUNUMGX       
TQXNJK          : EBBTOILSOJ      UNQGP           LTVTV           MBICHOLV        YIJWVKHHYR     
UIHQK           : DSBAIRGAUMIRXV  PBEIUQWRFSUCK   JKPSTPKYXA      YKOCURTETAGVTBX
SUYATTARMAPD    : WYTPWBK         AEDOJQGLKHAAEYD TWCCUJKIHA      KQCLCXYK        TBYO            RYOPBHDNW       CTWPLGHC       
EFLWCHPAWBLOYT  : YVMXETHHXDHUNKO VGUEQQQYBMD     HOIMLWHHBG      TXMKJNURN       ABXVWNNONNL     BLOFQ          
PGIIBH          : LUNVXKPTM       VDFKNUAITWNFPR  NKTELBSQQXRFC  
WDLOQLG         : LOUQUPRY        EEVHVEWY       
UKBGJEOBE       : ISLOFGEKCF      XYLWJHGADUPTF  
CPDB            : XTVN            MSUORFDQO       UMXUGGCMSTLGWSF VULMIPUHK       QNLSOJPNAFDN    EKBBEKMVXIXKAKT
EQRMAUVLR       : ADSLVIUS        IDOLONBUEA      PBGM            RENFJJSCDXVET  
YGSKOOFY        : BDUYP           BWEGHCHPGBHX    MDOUHHIGIYIT    DEAOWMI        
NKTELBSQQXRFC   : QFDEXYPJAL      GJIELTLVOQRHH   PGIIBH         
WOLSM           : AYUUEVYG        MDOLHOGYWCUXOW  FHGHCARGLWIE    CIDQYJVG        LATFWDHBVEO    
MOXTHKKXRMQFWM  : XVASBTIQV      
LNFCH           : URVFVTKIFB      DHGJVHNWQVE    
VMHF            : BRQNGPLYNFU     TVKFDQOTHCH     FWRELTODTYH    
XSEKR           : UTRXEGWSCABX    YKFVWNVAJGG     JXYTMEBJERL     SEWQWIJYKXWNRMG
CPNJAXKR        : HHVKKPQAOQWW    IBGFSFFGCDA     XINJN           PWBHH           PRKMATG         OTALUVNQCPBJPO 
BAKN            : MGNMJJX         CLRMJK          FHWCCBHX        QIUUMILFHDIMW   VHYHLJJBIWXJ   
XCTCJYXXGGJEBO  : CDBTB           LQYMKJFIRW     
TISLXFOXPIL     : KVFILXAORSTTV   WWKFRXYBRWDE    BEYQLCEDG       HYIX            DSUOQ           UAAAKXOOCCMW   
KXGWXKQAV       : DSBAIRGAUMIRXV  SDLUNFMDES     
ATXGGEKWVEHQ    : FCSPGNJXLAWR   
FVIFNRSICQPCOC  : HDAHEJPTCMFPN   WDTFD           BIXGDKKVUN     
QBLRWLADQK      : YRUS            NVOXOGYJ       
MQHFLOETWRNPBQJ : SXIKT           YJCETXN         PBEWKEOBRS     
UXWPPADJXPJD    : FYBEJFTFRVVG    GPCDYDYC        CDCMYYRTBVNYRV  PMCFUKR        
WGUNPAYHGTEYHVC : MNNKRGTREFDJT   BKMJK          
FWWEVNVYSHWI    : SLVKWPLGWHD     MUVCPIXRHTTMTT  VMROMDNICKFUM   ADJEK           YBNJHDSYJ      
CONKLEBOD       : AJBVO           UPQKQQGXRGJUJST NSNI            ACSEJX          AAUTNETCFSJPQIR
UYOVJKXLQWJWVYU : WFWJQFPMKNFO    DDQTSINBMCOD    NEKPBYTHTOI     ACFQ            XVAGARHHQM      WIFDVNXPEX      XAHJWPBAJWPYE   WIDDFSADPP     
UYOVJKXLQWJWVYU : NYPYWQUIJLSW   
RCTB            : QXFU            SMWMUY          TIUDHNTTPQWGPHU FLRJHASFBMRUT   SXXB           
XRLJEPKUUUPULM  : XVASBTIQV       OOFXMBXTG      
VMROMDNICKFUM   : EXLEEH          QIRH            AUAOXERF        YKHXJTTOJU      HNDNFSVUHSJAPK  OOPV            FWWEVNVYSHWI   
XKWPVGVNSQIPJF  : CYOH            YQBGHDVKW       XPMGIMOW       
VNAIGQUJFFORKL  : FPLVGHXIMND    
JJRJBN          : VFFQRJE         IKPMUXNPOATJIA  DIFNBFRF        FLPKDGFIU      
ADNSN           : PBIUPOOMR       JNXPUHEADUP     OIDTWYFGBVQ    
CTHXJHHPAECHKSA : EWPCQLRDBETBH   MCUMRSKXSH      HHNMGUOPNGXIOKM QGUOWGTPPKME    SOYGAJP        
EFHNYSQMKQRXK   : MQSK            KKQQFT          QOUQUIRDQOPOT   RBHR            SKXXJ          
EMBLNLUUDUBHD   : TWLEVS          IHYUID          LLBHIQSFOLTOW  
ADJEK           : DETYTKDT        UHBVSGIF        OHDDXFCFNWKDFRN FWWEVNVYSHWI    GDSGFG         
TJJLXVCPW       : HTKQO           LIIPXJRTGVW     IFWBPLYWE       MQRKMODCCHMY    LBCTEQAEEWPEN   WWQCVKXURY     
UBCYO           : QBLKD           TSEFTMMHGOLNWXD OUHIAHQYSRARH   AFKT            DRWUUEPY       
KJMPENXJCAM     : BDUYP           XEVTMFOHO       DEAOWMI         XYOQX           FEJTR          
HWEDGNO         : SGQAAUV         QIUUMILFHDIMW   IMDVEJVRPMVLJTY GWCGGRENF      
LTVIITLMSAEFLSW : UBVUYGQJIFRCY   DGRIRCAKVPWWPWM JLBRYBS         IJQEJA          LUDK            JTWMFVQ        
JUCLXPY         : QDWOLHMFARBNX   CNMNX           XQCFLCYLOQT    
ODIXSAEEVDPEW   : SMKJHKT         FRVSE           NRKMYNVUWJYOY  
TRGAYR          : RWSDBRMDS       QJBELO         
VKFTN           : XBDYQISGVKILI   NNGCOGBBNEAP   
RFRYTUJRPLWVHAL : IBTSDRWQQT      QVYPTIQOFJNNVA 
YRISXI          : ICBRXNDAOWG     FATLOCKB        ONOPMRJLNUEYYPF XEKHFCWAYU     
RENFJJSCDXVET   : XJAIOUSTS       OMIXBW          EQRMAUVLR      
OMGCJF          : PUPUCIONM       TLHHRYAMCUQ    
LQYMKJFIRW      : YXKRGBHYBUO     DWKSNSTK        DEPVBQWCPVWFB   TLQFJYPJHCY     ECOIHPTO        VHNLQYFNI       XCTCJYXXGGJEBO 
YMGIWBNCB       : EHURPBMUSCHQ    JQDLDKRAJG      XWANEIJMR      
HUDXJLAUQ       : PLFIYBXYSXH     PDSXVN         
GILSSU          : APMRMIAYINQH    XIWFYIE         SDMDVLQ         PXGTSFQVO       AHYAJSE         FMHGWWALIV     
EPWHOMP         : WDRHIBDHFQVHPXW BDHSGNPGSCF    
LSMN            : YQWMW           RSSJFWRSAHO     YVMXETHHXDHUNKO XAKSOUNXAYSTEA  DJKVLJHSWWJ    
WUQAS           : XSSLPTOV        KOYCDW          SOIOMER         EXVV            OIMDTOWG        JFFKXYJCB       BVAPQ          
LVVFG           : GYJELJSID       FNWMOYDGQBJWKJG QJJVFEW        
PSAKPBOFAXTM    : DUVBMNY         OGUD            SVJSOBBGCVKIALL GYJELJSID       OLEHXSA         NYFSDWGTRUGBR   GGYAAJHBBQNGX  
TXGGO           : AFTIFNULKAUJML  XJQLLTUBO       TFHKKJFUJWFNG   SSACX          
FJTFFWTBUYJCQED : DDQTSINBMCOD    FRVXAPHDNPC     OQUOYDEWERHPMGD
UGQAGOWVFQVLYK  : GXQXPU          MUYDET          YEDLF          
FWKMCJIF        : DKBF           
HQJAXOCUUSWDJ   : CYLBBTPUYWWVTXP PJFN           
BQKXFMIV        : COYM            FVUMONVTMUHJE   UDMQBAG        
FIEJRNQXWKHX    : TWCCUJKIHA      UQWPWAJR        SAJHLFEWLGBXIOC SEWQWIJYKXWNRMG
XADS            : QIMWLGQ         DYTILRNT        PRMKYKQLTXPSXOQ
AYGUCXHADVLB    : HIMYJVPS        ACELCJOGNCW     PXOHSTNF        IRSCBJAE       
SJUFBIVBHIL     : NPLGBPKHW       KXIUEFSVNOFKRU  IRTI            SARYRWWBLUMG    CGRBE           IHEBPKXLBUPY    CDEXGXM         VNGKTKFLSLHCO  
QJJVFEW         : YQJEUFGYJQU     NNOQCCPMOIUJDUL KHNTXDFO        LVVFG          
NTINDLS         : UNOAUGOXHIR     WDKS            TCWCDQN         NHHN            HHHLKI         
WTPPDKWGUTJ     : VUIKJPEAYKPOSUU GPVP            DDIHJTJEWLEAIW 
EUMXHWTODSUQODG : LUCANESUHBCMXT  AWBWQYTYYQCN   
QYUNUMGX        : SVERGX          OTALUVNQCPBJPO  OMIXBW          SKXXJ           YVQXXNHMAES    
DGUYQAENNCWKX   : QGLUYV          FPDHIJI         ANLBKRAH        DPOVXWAOBTWAL   FMRSSXQGHHCTBA 
NRGHGMNBDP      : EWHQI           AHYAJSE         QHEKNVJHACJGQFK DBELOCFHDF      JULUJPUIQ      
TKLALLFTIFKJLB  : UTPVNWFMK       XHISRIMCCKCK    FPQSCMPMSAEYC  
NXJNMYFUIOJYPN  : NEAFXTEEKELXO   GWALTVNIMODUMSY LSPUYH          MEVNWBIQW      
QJBELO          : YMWMXSXHNC      VLKPJR          TRGAYR          XDXYRYNE        RHLPNTCMQLHG    RYYQ           
QJAXVLJWKYXVNM  : QYXWU           IPBUDEEBCD      JQXCWVM         WWOBCSXTTWNDI  
UHEJRDCHT       : UFJTOIJLDUDIO   EMPEDDOULFCI    GOJBVELXUXYVCM  IUHWPSKDQOE     TVHDHAQA       
QVYCK           : AJBVO           ICBRXNDAOWG     BYTP            YHUSOBWUSHMH    FLRJHASFBMRUT  
UTUTSHDP        : YVJSUNJJIWIVWN  CUKRJFMMN       FHWCCBHX        FWRELTODTYH    
FPQSCMPMSAEYC   : GUBFGFWLJXP     PJJBEWNGA       TDHAUVYTBFAYJ   VAIMDEWYOALTE   TKLALLFTIFKJLB  PRHKNGPRIWH    
SWEQX           : WBBRIKOJC       OVYVHSSEH       WIJMNNTBIAFJW   QUQFWRVX        ILWGEBGVUNGK   
EQDALYS         : WIFDVNXPEX      ODHRYFNOSAXTK   YUAANJL         VJEJLCPHE      
FLPKDGFIU       : XOXQXGYXYUWEHSJ YRUS            IBJY            WEPRT           JJRJBN          BVAPQ          
UNUYOYMKXSBVBH  : WPXVKMBTEABK    QYMBKX          HJGQGYUW       
GKBGDVLQLXURFDM : ACSEJX          KTCKN           EGOYXPLFURS    
XDXYRYNE        : UBNJCHSD        DXATRMJPTJE     PWBHH           VGUEQQQYBMD     SUFOEVLOO       KGVATQTU        QJBELO         
GGVHP           : HURMAQF         XEJAQSEJQF      LEGJWEBOTFUDA   IIMXHGVBDTJT    APSMNUFKL      
PAMVGIJWUJT     : WALKUWLMDJMI    QUAXNA          OANPSFQW        BWRYXWV         IDQIFOQFV      
OWEPWHPXB       : HNTUIV          XVAGARHHQM      BELALEKKTKYLF   VHYHLJJBIWXJ   
LGOROLBG        : GJCCRGQDDXD    
RHLPNTCMQLHG    : UQLKSDHWOMCK    IVKUMCCHAPL     KXIUEFSVNOFKRU  BMMRJ           SWGLKTPRMSXVKBT QJBELO         
EKSETK          : VPMBBYEJCAIGYT  BVVVMLHVPL      JWCSYODEAPEC   
WBODQI          : UIUBJSRIINR     XWBHWBPTDJJAA   WEPRT          
EKBBEKMVXIXKAKT : CPDB            AWHUFMJX       
NYSIFOSHLTXRKHL : XFLTLXPYVHAM    NCHKQLO         MGNMJJX         DGTILKASLYEDE   OHYIQWQ        
TORAYGVYPUMRH   : BUMVTUBXIHJ     DRORTHSVTYFQP  
AWHUFMJX        : QOAV            PIWULWYFOOPJBEV EKBBEKMVXIXKAKT
UTUMF           : LUCANESUHBCMXT  SQCVJASJVSQ     PBEIUQWRFSUCK   SGWETGWQNHLW    JQTANLDQLK      TMLCGYYR        MQAIMTPJPI     
BVAPQ           : WUQAS           FLPKDGFIU      
RYYQ            : TCQDGQOJ        TECIUM          TXWACW          EDLVEUQ         QJBELO         
VDIFM           : PXGTSFQVO       PFWDGKKQDX     
CTFHJOHGMBBBII  : CSJSLSSPHQV     EJYUCCXDWP      HUKJVSYBEXUXM  
HIWXLOYMFQIL    : DXWOTYGKV       IVILRV          ORNNPEXDBNBFH  
NXKRTP          : JXUGKS          MXRT            EMRLKHWDEYBTASM OEFAHKB         WAJBMLVQEYWVQG  BORHSRQTQC      DIFNBFRF       
DHGJVHNWQVE     : PWIGAJV         LNFCH          
GBXR            : WDRHIBDHFQVHPXW XAANQTKM        OPMM           
WEWNOKP         : OXLALCBEQHVKRNY DGHWPGEVNSQFPJ  ICJFAHDDVGWIQWJ UCYQTEURAMKUJQP
IATDR           : EAXM            BRHYFDTRKEK     CLUQ           
IYDSWLGUEE      : JIIBJO          HGRWRUDAIRNH   
EKCEDTDJQTYELD  : LFLE            LJIYWSJPTSP     HNGJ            AHYAJSE         QMJYCQRDA       WVWDTALVEHM    
LATFWDHBVEO     : SXCKSKBBITHBB   VEJKSLOLRVBW    WOLSM          
BUICYSGFXAKITE  : QYXWU           XLCCJNFPPGSXXUX
XPOMDO          : SSTB            JCMU           
JMKQPIWEM       : KAJRTKF         KMMTCWM         RGHDTLP         SNWODYGMXTL    
YUBAPIFQ        : KSLTJEXQUUBJFDE EGLUQGTQBUJHB   GJSFEITDTN      RRISKJ          SEWQWIJYKXWNRMG
PBEWKEOBRS      : UHGDEBDGYXYIPNE OWWQU           PPKJBWJY        BEYOQAQLEI      MQHFLOETWRNPBQJ
BEFNWWVTBKSAHW  : IISTUGNXQVRP    AYUUEVYG        JTCMRRB         XHISRIMCCKCK    HOIMLWHHBG     
WHHNRY          : HTEEQQ          CAUPSGKUNWMBYI  PAPAMCWSQB     
YVBD            : OATIWPMJGE      NOVEMVGCTKI     SBQCEBCWAVQHEFG
DWGVXKDLJ       : BIDEMY         
HDDTYDBXF       : DGRIRCAKVPWWPWM YMLXQV          OHYIQWQ        
FOOYPGAOHGCMDII : RPBTSCADHALPC   JJMMOUTMGEMXQPS IVICYPCCVJ      JKPSTPKYXA      GOBEVTYKBBBJKTF
UNPENAJQ        : LVQMGOOIVD      BPHN            VMHSESDGO       FNEXAFBRIEPLSW 
IVVGDWNTN       : QGAH            TVKFDQOTHCH     EGWNNMGTIDE     CUABYR         
KTRYEXBQCLCGGPV : ORXWFFPJ        HURMAQF         ADRTWJQRORKE    TOPPIGT        
GVVYQHVOPBLGVYX : GLQRKVYYJQSWV   SARYRWWBLUMG    DCQKVQTJL       ISLOFGEKCF      OCDTNBRT        VEPGRNAQACB     VPHAOISSTWYC   
VPHAOISSTWYC    : JXWARO          PHJKQPX         IVKUMCCHAPL     QFIUYCW         QJAPR           INGYERHI        GVVYQHVOPBLGVYX
UQVROUK         : MROICAYUM       YVGVYVA         HRPGCUJIPKNFC  
QYOSMUQNSWJKELY : AFTIFNULKAUJML  YYPUHLT         ERUNQBJIGKKYTLF
HRKESOTOHPI     : QISMQSVDSLPQ   
LUUEVJ          : PGUPBGKNYFUNIH  EBBTVTCEQYCASQF QBQAVWNKOL      IBOTMAQMRMKUWBQ XDNEGCASA      
IGNVBMILSVLJFF  : TYEUGXGCJFHWDUE HUTRKH          DPOVXWAOBTWAL   LBCTEQAEEWPEN  
KYKGPRWXOKU     : PAQKCSAINV      QSOSDNSOGYD     XMILYTEB        PDSXVN         
OQUOYDEWERHPMGD : KVFILXAORSTTV   HNSEHOWJNHAUMET DNFMSAVR        FJTFFWTBUYJCQED
LJSXKGFCXECOOW  : RPBTSCADHALPC   HXYPXUITLIJYMN  JWIGSVKPVKJQRKU TOPPIGT        
DNWTOAYLGSV     : EYUS            DJVDPEWYH      
FCCEPNAOXG      : PHMVKL          IRLTX          
AGACVQB         : MCNSUQKKKQR     JMYOWDRTHDL     FQXGBW         
VOXQD           : UROB            NFWKILDYY       SEUIGRVO        JUJIEPJNNE     
PRHKNGPRIWH     : XIIQOAH         LESVGE          WUCETKR         FPQSCMPMSAEYC   PWNMTARR       
WVWDTALVEHM     : NRTRAPEQF       XHDOEQBXSKVUNQA WGLTFDBLWXBFWK  EKCEDTDJQTYELD 
ILWGEBGVUNGK    : UTUQIISABGWSAAX FRQTAWLAQNP     FPTMMB          HAAMHNKTBKC     SWEQX          
VCFSJER         : RNPDLOEFDG      MSBFAKPB        KMMTCWM         GJVCBVE         BIXGDKKVUN     
BWEDJ           : YMWMXSXHNC      UHRQWJ         
IQPOBBLHHOODLEJ : CAEGTLTWMDBG    OTCURHDCNAEFN   FQWSDOW         UJBFMGN        
BIXGDKKVUN      : MQNYWWMSCGLKAV  FVIFNRSICQPCOC  VCFSJER        
YRCCCVSQW       : FOBGGB          YWRBGTVEAH      PYEGV           GDSGFG         
EHEV            : UIUBJSRIINR     JJMMOUTMGEMXQPS XFALTXROXBJKLLG AOWFTNJJJOPOW  
HHCTEDCELFQXDLM : WEXO            XIWFYIE         MPPTDUXIVLQ     QBSIBHTVWEKLL   DJTNXA          GPCDYDYC       
NGDPIYKBY       : FQUWTNEF        ANQXDOFLQWP     BMGDXRIITHBK    HQUB            OPMM            AXTBFXX        
HGNDE           : OXEPEVFYE       YLXTIHBEGM     
NGOT            : YQWMW           DCUMSGNG        MDDIJASDYCPNLAI
SXXB            : MEGTWMKE        UGMVPDAMEYMNBB  RCTB           
YEDLF           : NCBLWKTIVEWGE   VYJHDTUDUA      XFIMS           HQUB            LQEJVLYPJOH     UGQAGOWVFQVLYK 
TJLCKVF         : NWES            KXIUEFSVNOFKRU  QILTJXFURGQMHNO
FMRSSXQGHHCTBA  : STVMXHVIYT      AGJCDHSAPQRGDI  AOYVFGBMOGDXVSL PFWDGKKQDX      TKBHXXJWO       DGUYQAENNCWKX  
CRSIXG          : TOXPNDEJASMR    FNTHTA          XYEANVBHFTVRIV  GPVP            SXEUYRD         YFPWEXBCBHA    
QAXEEKB         : MUCKBLJTNJV     FDANJG          HJVYC           XPMGIMOW        LBALBMOHWAHPDHT
WIBO            : MEESTBDPOGSNWFK RLLGUGTLINSVAYK MSIOIU         
TPUCWCESD       : CMXFJQFO        VGGBGG         
OHYIQWQ         : QBLKD           AKEXFMJQCN      FYKJKCGLPRQIGBO NYSIFOSHLTXRKHL HDDTYDBXF      
PTHUARX         : LBLGY           NCFFXYBENA      SFTBGYBXKOJRLBI
OGNGKJXHNUKRPNA : CUKRJFMMN       AIJDWTOHTGPMLS  YBNJHDSYJ      
XYOQX           : DCURTJAOQEPK    KSIGHAKNDKEGIRU KJMPENXJCAM    
XQCFLCYLOQT     : NHPL            EURQDDGU        VNGKTKFLSLHCO   JUCLXPY        
YFNWMBT         : DACT            GUBFGFWLJXP    
UJPVP           : XVASBTIQV       LLVYQPAU        UYYPKCHKDNVVTT  LAWXXOQQ        TLHHRYAMCUQ     AKAOTVGAB      
WFEXNC          : IDOLONBUEA      MYVITJC         NGVTKKCNW       YKHXJTTOJU     
PJCRKNJB        : PHMVKL          DYTILRNT        CHFXHXTTOEPMN  
NAOEYEHSDDES    : AUTPMK          COTD           
UGXCMVROMHAOB   : NOTSAMHKPVOUH   EQMULVBMXSNM   
EMOMDRDHQHOM    : KJSPNPMR        RIGW            BHNDLYSR        IBOXLUBOTWE    
TQIUNRVPE       : CAVCOGTT        UJNTSGF         GYWJ            GBQIVN         
JVHS            : BPJBI           NVOXOGYJ       
XWJDJBRMSUVJ    : DBLOOVWJIWNI    RVGUVDRIJDCOI   QJREOX          APSMNUFKL      
NXSJPBHDS       : OYHJSV         
VXYHVIBT        : LTSWUM          RRQKCIUDXJYAO   LFRHCUOWX       LVJNWGDYDYYQTYD
XEKHFCWAYU      : YCNHV           HVAEEWM         XYHWFXUXCYI     VEPGRNAQACB     YRISXI         
EKIWUAYCFTHDTG  : ETKEXVRWTLPRB   EGSQAIGREFV     VHYHLJJBIWXJ    PNYEEVMDUONAPOG
PRMKYKQLTXPSXOQ : BESN            QAWJJUJXSUMJFOH DGEDWRVBIQFIPN  YKHXJTTOJU      TAQL            XADS           
TBTSVTTAA       : TNESIPVFKSGEXYB
HFKQQBIDNJPEU   : YRUHAMQIMRRUQD 
EMHCBXLWAGQX    : FRWQSOW         LHXWVOILYJME   
KYEYIK          : IVCDSFRABICFUJB UPEDJES         FPLVGHXIMND    
YBNJHDSYJ       : VDNDQWUWTX      QPPWGBHAKCFNUX  FWWEVNVYSHWI    OGNGKJXHNUKRPNA
NNCVPEVBD       : DNATWXONMPA     PYEGV          
JTWMFVQ         : HWHMDAVAGNTV    UUTTDMOHDDMNC   QYLTD           OLKF            NYDSUN          LTVIITLMSAEFLSW
GDSGFG          : ADJEK           YRCCCVSQW      
OLNNUDEIGAXMX   : GMPSMX          UTAPAJPJXRNLQA  TMAJOMAULFER    IUJWV          
PWNMTARR        : XOVEXWLBHO      YIDLQISQCQ      RSJP            GPCDYDYC        PRHKNGPRIWH    
AXWTGECYSOOJJRN : YKFAYIXPNO      AYUUEVYG        XSSLPTOV        MROICAYUM       UTNSOPBGXLL    
APSMNUFKL       : DGRYBOMU        YRYKAKJ         TSAFEBNMQRXJCWY GGVHP           XWJDJBRMSUVJ   
GLLXHL          : GUBFGFWLJXP     SBQCEBCWAVQHEFG LUNVXKPTM       EQNKWOKPDVYIRUS
HHHLKI          : QGQYQGMYRG      YOCEFNS         NTINDLS        
YWSIPIDPXWFNTK  : AHESKFW         XCWWHIK         QOAV            QUUBSF          MEBVTFOB        JQXCWVM         OOPV           
FEJTR           : PHJKQPX         AKEXFMJQCN      FYBERTVDO       AIJDWTOHTGPMLS  KJMPENXJCAM    
DDJKLSY         : AWIAIJ         
CIWYBHQJ        : QJNDTFJRFDG     MEBVTFOB        XPYFIASJMLCGSXH MKNBOS         
HJMOYIB         : JVUD            VEAS            YRIAOEQXHN     
QFMMYWPCIDPBCND : IGWPDAWS        UNFG           
MFNWVYKFIW      : DNKETV          INKAJRQ         KHNTXDFO       
JHUMXCYKBXB     : UMXUGGCMSTLGWSF WNFXMYWAQLWRP   GPHH            XFFLH          
IEVJIMPUBU      : OKIXH           WXJPJEBXGB      KADTJA          SQGURUOMDVYOJX  KGVATQTU       
XSHKYRJSBROPPQQ : ROVX            TKBHXXJWO      
SOEYYKWJ        : ELFRXAOMOTVCCF  HRYEETBGJBNMLGK CRSNFISYUBXSLV  CRBNKLIXOHQ     BXTL            EJYUCCXDWP      YAJQAKW        
JBPLXXLQHWPYG   : QXVQJEK         SXTFGR          MOQJRV          LNTTIPQUHMG     RCVNLJLTYOVVBKN OIMDTOWG        FOPSWKLDYMHWJ   VSNSTAE        
CXASOSJRNBXMA   : MLJUAXQSF       FOUKFXBP        XTPSSUERGMT    
KLDVOSHMQ       : QWYPOWVHJGECAY  YMLXQV          INED           
GXSXYYJBALVQH   : TWOJESCTBQEYCG  OSQM            YKHXJTTOJU     
IUJGILQUXT      : TRXDUJNXUHMQB   GXQOISLQVLLY    KTCKN           SWGIEFTOPX     
OOBCFWKF        : TNRWKDERNWIUHR  NGVTKKCNW       XBIINQUJLXSWQN  INED           
IGQUHQGEHNMRJXA : CRUCJVUHCUHCRGI OJVQAKGUGIYN    EBEQTJWWSGV     IJQEJA         
JQQJMHYBK       : QJQYJHTTWTO     LTSWUM          XJQLLTUBO       SNVYNCLLAAWSAU 
IJNPBVVSQGLAM   : UPUTHKYL        MEMMMAFVDNVOS   HNDNFSVUHSJAPK 
NYPYWQUIJLSW    : WNFXMYWAQLWRP   MRABIKIV        EQNKWOKPDVYIRUS AIHRSXHH        UYOVJKXLQWJWVYU
