BXCMPVUCO       : QAHKXMIR        LKMTBEGBUSSU    MFIYTIJKNYTIHW  RGYWSRCHI      
FPBJA           : NPQAL           NHIVAJMXAWN    
YDNWGFWNQNHFLS  : LXAE            FTNRKDWT       
OQHCGDWLSBQKEDM : BPQUKTNRREXK    NTOMVEN         EINUJ           KWJIQVFJHG      MJEXCJU         VPHGGVOOFAV     CCYTIRLIQADCAOX
EPVBXDXL        : FPRFCMIFWHRXFDN GRLAJGHN        FYHULNO         UCJANIRSE      
NSBCNGQEQUNVUYQ : PXUTBNXQNUPO    YTWAQAVGLQ      UCJANIRSE      
PBDUNKYGIA      : KPRRTOVFFIFYC   KUYG            OBMLXF         
NBSJQLNSCVMG    : FVFLC           MPAIW           NJGCVPUIMG      OOCKDYIDI      
HTJCUCBNEG      : DYGJDEEX        VREICHWHGD      RSFJQFJLB       RYFDJR          YRSUIEPEQLUPOAM VXQYURDMPL     
TQICCI          : QNMUTEHUYKTMIUG JWFFCVDSVDJUYLA CFGEBFUKK       BWYCRXIHQBPCWR 
RLCEDPR         : WEPUXVDRQD      APPVHFWD        PJKVCWHB        FTNRKDWT        KXQRWO         
RPKYDU          : SYVRBEKI        XHMMKKICBNJ     BMOKYIYMARIXSPS GPBUCD          YRLK           
OYQQCEWIOTCW    : HISGCW          LSYB            NEYBACBHB       GBOOCXVV       
GIHXTJC         : KVQONVKR        FPRFCMIFWHRXFDN OTVDUL         
AVXRMKSRFOIH    : UXRYNJNMOAVUFK  WYQS            PLGMAROKFFVBL   CFGEBFUKK       RTNRRWQO       
YJNY            : JYLVQQL         FTQQQLOOUBJYF   FPVDLSEHFMQMTW 
CUUCSB          : GNJJYKNGFQYKL  
BBGK            : USVTVRB         VLQHMCRVPDU     GEBMR           NERWCEFVRF      PTOGBBRWIRGJBA  XEQFEOIBXJWLEL 
IKCGFQSXIYMQG   : TXKAWCRUYX      HGGJUAXIVC      BODJOXJSFRXS    FQPKVEVWEHWSL  
SPJTKM          : KQNLJIEXFBSAUV  KXQRWO          EVQHFXDPPQALQX  HGGJUAXIVC      ARKLWUHVYH      AGHFV          
FOHIBIKJVQRGS   : EGKHMFACWNM     EJMOVHIXMLJH    RAVNMLVRWOITKI 
NMTMUUBO        : NTSTBRBURFUUGKI FBHRMKYPYJIU    XQGBFCTDYEJVX   SWQHE          
XJSHDEVTLMB     : PLEMPJQW        DPPXQEJUIUVXVOO PJYBXCC         SKYKFPVNABXDILS RDBGALTSIUEXKFK
NMHX            : PVRKFLKL        YASEAKLO        FVFLC           DEDIOSASJKMJ    ISRSEJBNWMJKAO  OLVK            PGVYMIGGY       ARKLWUHVYH     
XRQSSFFMTDJU    : YAPCTTTDLM      LXHM            HXMSTWF         QICBVXICMBWUX   HLFKMNRLEOHKXG  ATFCVLWYKXCXKTA LFNMNOYJJ      
KUDFFGLBAAO     : GQJXTVHI        OBMLXF          LXEWVARMEMJY   
WEPEEAEWRYPY    : NFUUFDWDQHPH    JEUMC           EORN           
ESKNP           : AHWOMQFE       
ANHHSPTVP       : AJWHRXWQPNHTUXX ADFO            TPOGRMVSN      
MSSRLWVN        : CWYKG           PWAMWVQQOV      JNDJO           AWUQTJRFBE      PDQVSBXD       
SFCKG           : JFMI            NFDPP           XIHPJDMOMDVWBR  ROGFJMPWKWGAX  
QBVG            : PLEMPJQW        AITKUYDNRPSMXLR BVNLSI          NMLWO          
AIFJQAYMXO      : JSLMTGIQVEARPP  KSYAVIYDCWBVOQ  VBNV            ILJTMHW         UUHTW           SOLDRXKRQTGUP  
LKDD            : LXAE            MAJTUNFFVTI     FWKXMMGKXJXLHKN
CBLF            : RYFDJR          BVNLSI          PLGMAROKFFVBL  
TJHATBCRJVS     : OHTMERS         PGRRNGMSJHXN    EDVHAXBDPVVR   
DELFEXDUIOHL    : HDTOAQTPIYJXM   MAJTUNFFVTI     VDGRJU          VEAGAPL         IVWY            CEVS            HTULSY         
FNVTUSNE        : EJCDOSAYED      LKMTBEGBUSSU    XSBSSFXLTQR     PDQVSBXD       
PADTSPP         : HNSWAFFFAPYROO  YETATCOMHEKPF  
IURTAXT         : LJMDKPEG        EIIQFG         
TESDPN          : HFUSIACIP       RGEHRFJ         LOYLNOTIPSDE    TIODU           LGTBTSPIHDSB    OLBJDKQGD       YGTXUTJWEPTHK   EDMCUIBEIG     
TESDPN          : DYFJUYLCLO     
FLFAE           : MFIYTIJKNYTIHW  YTXEFIDLPVBIS   FMEMQBSS        WHASHFLQE       NMLAJRCIPLHF   
EGKHMFACWNM     : FOHIBIKJVQRGS   GWHYP           JBWFBOORTBX     XSNMIWO         YTWAQAVGLQ      VPCXBTS        
HISGCW          : OYQQCEWIOTCW    NOAVPYWGA       JMSBBCL         YYISWXTMDMETWWG OSHUTYPEGOP     GOFXSPDRHGLC   
GQFXGQDRV       : GMFJDEIOB       SSELDPDUFQMOYFJ SBLQIUPGV       PFWOHQJN       
XQJGCQU         : SRFD            HXMSTWF         FHBSLXOWFP      AMYHPOVJYYYBGUB
SWGILYQ         : RGGJPFNUFTEKALI KMFDLO          EENPR           OLVK            WLEBFHWTB      
SYVRBEKI        : RPKYDU          ALOQJHU         ERREUES        
QAHKXMIR        : BXCMPVUCO       KMFDLO          IHMLTLLC        SKYKFPVNABXDILS OTTRLUNUOQJ     SFUPBMYMQKU     UUHTW          
PVRKFLKL        : NMHX            SVWCJIJNEBIPNO  YTXEFIDLPVBIS   VPHGGVOOFAV     NMLAJRCIPLHF   
XNMS            : ITNALVN         KVQONVKR       
LQAO            : YNRFLWCJHCLQ    MIRRUHH         CPVNALUACC      CRHNWAYWQDH     RMIBREIYE      
LXAE            : YDNWGFWNQNHFLS  LKDD            JVJKB           SBUKAKOPEIG    
IRXWAP          : EMMLSDWHWJHV    RTNRRWQO       
RNOFSC          : VBADBQTAHRJ     FVFLC           YGQOSHXELE      PJKVCWHB        IVAP            PCSLQSASCMHMR   IATEDRDYLVUO   
HXPWLIFWAHOXUMX : YYRTB           GTGOILX         XBMNSPIMNBQSJIQ WEAVHKHDJ      
MITMG           : JXHWFAVSVLJLVA  YSUILEYLROLVEAM COVDVWPNW       YCGCTUOBCK     
FEQSSVMWP       : CPJE            DOWK            ATFCVLWYKXCXKTA PGVYMIGGY       FKIPDDUSVJGBBFL
VFSHQAGSHUQ     : IGHCWANLRL      TDRMJMONK       XBDXMOY         FPVDLSEHFMQMTW  UMBHEJOTJ      
JQFVABLI        : EWPDYTPYW       LGCOXCQOVY     
QMPLILA         : PXUTBNXQNUPO    HBHUMBIUAPOLQ   FINJYOIAP      
DVDJQKAQTSYQLEB : BLAKCVKACEXMBN  FBHRMKYPYJIU    QONWGISBAQIW   
LYEMKMLDCC      : BDMODTBKEYBUPY  QGWKBYWJGCNIX   TIODU           QQGOVUNMBLPXQXY
KPRRTOVFFIFYC   : PBDUNKYGIA      SJOWJUTEQYGHVQ  XORJPDFHV       KCWAVORNRMR     VGNSJIWEMNCSQU 
XVNEWPRX        : COVDVWPNW      
EJLRON          : QXREPOJXEE      AENVMTWBYYVYOA  JYRGPLVNMOL     NASIEPTQ        VJWEASBNF       SMNFVOBLBPDK   
GAOY            : BNER            PRNDENT         PFWJKEWXOK      CASNKLJIHNT     XMRUGUNUISRW   
IPOPUWWVC       : DVBQIP          IPVRFCHDHEJT    NSXTGGR         QLIIJLFINEJSO   DKOWGBHTTRFBTTJ YRLK           
TXKAWCRUYX      : IKCGFQSXIYMQG   HOMQUJEMHJ      TGSJUCS         GYBFSRYAWKH    
LQVB            : GITRBWTR        GJIOJHANAU      LXQHLLVFXHBHQAR PWMMRQOARSVN   
ECDDUNULDS      : SLEC            YJWFMQENPTYAVDA AMFFRHUQQMCKA   VGBTXVIYWUNNQXJ
AOMYJMLLJOEFP   : PKXNMW          SGCTNTIBSQLL    CSUCYIRJ        KIYC            SBOXQINCYPUJT   WSKDGPBE       
NDUJHMQJP       : LASMCKHBCNMB    JKWFYXHNPWHFHTM PRMWWDBHHTSQY  
GGRRJKCMY       : KUYG            EAMLKE          KVLMDAD         AVJN            AVBYTXLWFRIVNR 
LKGXWQOBX       : IKTNLLJTYCDJC   FHHETWNBOMMAFW  UUHTW          
FLMDXTPOFHK     : AITKUYDNRPSMXLR ERREUES        
NEDAOHMOB       : UQXFWYIROKAXP   SMIOXXTYBUFWXGN JPQF           
YIAVYQY         : RGGJPFNUFTEKALI FHNOLXMISYJFJAU QJUSNVUC        EEXAOURTOY      MOVEDAJNR       RYFDJR          LUSBXONLGIBW   
XHMMKKICBNJ     : RPKYDU          HLFKMNRLEOHKXG  LGTBTSPIHDSB   
YASEAKLO        : NMHX            XORJPDFHV       QWNSLUADDV      DKOWGBHTTRFBTTJ WSKDGPBE        JPQF           
NOAVPYWGA       : HISGCW          WXWXCMNG        GPYGSUWKYKYCV   QETSE           DOWK           
GHKUT           : MASQS           VOJTTEL        
DVBQIP          : IPOPUWWVC       BCULKCFBMIQVT   OOXHCXVC        MXCNHOYICOQISGX VGJNEFCNXGP    
ILTKXG          : KUYG            AITKUYDNRPSMXLR MNBPVILPEY      XGPERMDLMQW     SWVSDOEKFWR    
WVPYTHXQOY      : APPVHFWD        PNSQTJ          VKSD            HREAIRRQRXFBFS 
WGYSBYVYBNH     : EIIQFG          IMDSUGGNWMSLOH  WYQS           
FRGAEEIFB       : OBHYVPXPHF      BVNLSI          JXRPGTS        
VBADBQTAHRJ     : RNOFSC          YJHFUJR         YUQQURMPCLAJE   QSFH            RJFULM          PTEGAOXB       
KMIILJVV        : KOFMJUGDC       FDXIOI          VIHAEEALET      DNXBB           XRTYJAFEJQIXDSJ
CPJE            : FEQSSVMWP       HAOEIX          BDKKQ           TJJVIHKDLVKO    RQNEXUKH        COPCTRXPVTGLDV  EDMCUIBEIG     
NMARSXUSCXLXYSP : DYCEVWUNXGB     MBAAL           JEUMC           OBYKMOUK       
BCWLLKUJ        : KFLDJOTDVJOQMRU YCVPWNENRRPCVO  JPQF            OISSIJRGHJKF   
ANYLRVBGX       : LXQHLLVFXHBHQAR FNWOEXDTDHYNF   MTYDJHFGIQXHA   TIHWASLYKHWNEIX
YYRTB           : HXPWLIFWAHOXUMX THAJCEBUBMPOGJ  MAJTUNFFVTI     MASQS           OEICBFDCHCBVCV  CKKR            GWRD            TWDQJ          
HYPA            : UCJJGLBDLFUOI   EENPR           AAHYU          
CETYPHJ         : XSSBQHUOE       ENWERBBESD     
RSPFT           : BBVJXGLN        KLPB            TAWAJRSTBUEDDN  OYGPUEDUL      
XREGRAGQ        : OPRHTHGIXSDU    FQQPTWYBIT      ICCBQ          
CTKKVAMN        : HCCO            BCULKCFBMIQVT   TFKXSA          TNLGORHMMVF     QQBSTIVRDREIKQR FEXIXYAAKSEVMWE YRLK           
SJDLRPBL        : QQEDR           SJEKJMGAOIR     JXHWFAVSVLJLVA  DKOWGBHTTRFBTTJ BWYCRXIHQBPCWR 
QQGTQXXXPAGJ    : CTYDHGOWVBWGW   QWKHIWCWCEKXCRD SHDH           
KDFU            : RDAL            NEVIK           TDRMJMONK      
IKOMFYQQSGTE    : KQNLJIEXFBSAUV  NBBQEMATYYMRXB  CEVS           
KUYG            : PBDUNKYGIA      GGRRJKCMY       ILTKXG          UTHFTMHXQDWN    YGQOSHXELE      QPGNK           SOLDRXKRQTGUP  
WFMOHU          : YMIQPDXFDST     JLGPGL          FGRQNUP         NWYN            VGJDU          
CFEIDFQN        : ARJQDJF         ALOQJHU         GQYFDICBN       UJEYKCIQNBR    
DUTTMOCGSUTPT   : DQQEOLSBBE      NOXEAIC        
GSHSKPPKTVOCY   : PWAMWVQQOV      PUGVVONFC       KMEWKGWXD      
SORYJNUXCXHUU   : VUUPCBLSBCOSLN  BSQERITOQ       QONWGISBAQIW    MASQS           QICBVXICMBWUX   SHDH            LXEWVARMEMJY   
MRDTMNOWFFI     : YJHFUJR        
DYCEVWUNXGB     : NMARSXUSCXLXYSP IORCVVINGBLDL   SQGVT           XPFDG           VQYTU          
HDTOAQTPIYJXM   : DELFEXDUIOHL    WXWXCMNG        YRVXHTOVBYGF    KCCJTJPIYH      NESYNSNNPHOVRC  GPBUCD         
UTHFTMHXQDWN    : KUYG            NVRTIK          KQLTKRDVULGJ    MUPJXQQFUU      UCNAFMVBAFOVFY  JYBODHEUIR      YUHCEXRUKFXJHNL
VUUPCBLSBCOSLN  : SORYJNUXCXHUU   WEPUXVDRQD      TJJVIHKDLVKO    OWCFWACXEYEBWK  KGTOVKWGCW     
LDFGWMOS        : WQMC            TQEG            AFGISR         
XSSBQHUOE       : CETYPHJ         BIVLAVLNUHGOY   SSSWBJPQN       JNLLK           CASNKLJIHNT     NNLDAGWTS      
GITRBWTR        : LQVB            TFLEKSJOJDKWWR  XBDXMOY        
HFUSIACIP       : TESDPN          QQJW           
BPQUKTNRREXK    : OQHCGDWLSBQKEDM HCCO            RQQKFTHQDDNQS   MJQEYKLU        CHYJQYMNFEFIW   DKSOUTAFJGFYMBN
GGEJD           : GEBMR           HNSWAFFFAPYROO  OYGPUEDUL      
BVKHRF          : PKXNMW          LSXJEDYOGYMYXUN GPYGSUWKYKYCV   CCQXB           OSDNVIYUBVGFMRO FBBMDVNTDSW     IVNPUWACVYQIDY 
THAJCEBUBMPOGJ  : YYRTB           HHNXEMJYSLFR    PWAMWVQQOV      IGSNHHYRLR      TMGVLXFJDRW    
FVFLC           : NBSJQLNSCVMG    NMHX            RNOFSC          OIVAWLHLSVCT    KGYHF           POHGWV         
XHLYGVIXE       : CENNDGBKYUIH    JYRGPLVNMOL    
TNDEQHHLITDYD   : BCULKCFBMIQVT   KTJD            MUPJXQQFUU      NOKPDEYXK       TJJVIHKDLVKO    DYBRSCBOFNBD   
TKKBXOOVYBVFYEF : XYFS            QQCLN          
HYRLFKSN        : ITNALVN         HMGLPGA         EGXDIVIDMFRBBIX VOJXDKLRCPDK   
EJCDOSAYED      : FNVTUSNE        TDCQWKQ         SHDH            GWRD           
USVTVRB         : BBGK            NQPVJVNRYH      RRCJLON         VEAGAPL         JQHQANN         GQYFDICBN       PWOLAJMQLVFQ    TAWAJRSTBUEDDN 
YIBGIURPHND     : BSQERITOQ       TWCDGDUSUKFQLHM PVTEJ           AMYHPOVJYYYBGUB VXQYURDMPL     
RPJW            : CEWHQW          IORCVVINGBLDL   XMRUGUNUISRW    UBQKLE         
DYGJDEEX        : HTJCUCBNEG      WXWXCMNG        KREC            SJPD           
BTWCQVLTCVQWLX  : ANWV            QFNK            JPHF           
RGGJPFNUFTEKALI : SWGILYQ         YIAVYQY         JVJKB          
MCAQUXEP        : QQEDR           XGPERMDLMQW     YRSUIEPEQLUPOAM UBQKLE         
AIBOH           : UBOGVIKOK       NBCGUFIPOMA     TCWR            VEAGAPL        
IPVRFCHDHEJT    : IPOPUWWVC       YWYICCIWEGKQSP  IGHCWANLRL      XCTHMRWWPX      JRLMXIHVROXUTLR
UCJJGLBDLFUOI   : HYPA            SRFD            QSJJXNKXAVKKMWB
PWNGHDC         : NSDXUHIQQA      GPJQWVQCN       AEGAOF         
KEIN            : CBLDXTKJL       NBBQEMATYYMRXB  MXCNHOYICOQISGX LXQHLLVFXHBHQAR OSGG           
MAJTUNFFVTI     : LKDD            DELFEXDUIOHL    YYRTB           VKSD            NJNLITSHOGRANGP IVWY           
FNUVVBOUQ       : GBNCLDWQ       
CTYDHGOWVBWGW   : QQGTQXXXPAGJ    GRMEBDPNXUKQ    NWYN            HSTVTBILKSWUR  
TDCQWKQ         : EJCDOSAYED      CCEAFOQOWTWQLLF CENNDGBKYUIH    WATQJUFAQJDSUSN
ANBYRPT         : LSXJEDYOGYMYXUN VOJXDKLRCPDK   
KYDLEM          : RJFULM          JIPFANGTNXNOWQ  RMIBREIYE      
SJOWJUTEQYGHVQ  : KPRRTOVFFIFYC   PJCHLPMKRCOLX   RDAL            ABFQHYIFPOEAPFY EDWL           
BSQERITOQ       : SORYJNUXCXHUU   YIBGIURPHND     EOMM            GMFJDEIOB       PCPRHW          ALMRQLNOCKFWXAX
NVRTIK          : UTHFTMHXQDWN    EFHPJMQNV       OIWSV          
UBOGVIKOK       : AIBOH           VOJXDKLRCPDK   
WGLYJEPNWAHLR   : RIIBLQQGEMC     PXHUWLCPOH      KEXSDBXXVWXUJI 
BPIWBUMXVBETMQ  : DEENUDRDA       PRMWWDBHHTSQY  
YJHFUJR         : VBADBQTAHRJ     MRDTMNOWFFI     BAUIVNBUX       IQMYKJAGSBIJDJ  PWOLAJMQLVFQ   
YHXCRJV         : LSXJEDYOGYMYXUN
MLPKOMYMKDQERJP : WIGGSWRG        KTJD           
SYXNIPPKX       : VREICHWHGD      PKXNMW          QETSE           FVGM           
MPAIW           : NBSJQLNSCVMG    JSLMTGIQVEARPP  KQOQBMNAQ       DIKXGHPBPU     
VPYL            : CUMOHKH         QXREPOJXEE      VQOLSPT        
YAPCTTTDLM      : XRQSSFFMTDJU    GTGOILX         TXMHCWECOSOFXM  MKNOPOU         EDMCUIBEIG     
LKMTBEGBUSSU    : BXCMPVUCO       FNVTUSNE        FYFQYTLIVFV     XUVGH           FBBMDVNTDSW     EMMLSDWHWJHV    MHKKTSYJW      
PJCHLPMKRCOLX   : SJOWJUTEQYGHVQ  LJMDKPEG        FHBSLXOWFP      MORHSXPH       
RKWQXJDTK       : PEMSPUEDCFORUFO HTPLDW          EEXAOURTOY      EASVVTYQ        EENPR           OTTRLUNUOQJ     LPBXRANVRGRXJ  
BNFVGCCYLGGYVUL : NYGJLBLM        MXCNHOYICOQISGX PUMK           
YACAMVKLM       : VOJTTEL         JXRPGTS         RQNEXUKH        LUSBXONLGIBW   
VREICHWHGD      : HTJCUCBNEG      SYXNIPPKX       RDMINHELMFGWF   WEDJMTJKVMEYSTI
IEXOLYMILCKLGK  : JBWFBOORTBX     PLEMPJQW        LPVWLP          RTNRRWQO        HYVILLHNJD     
CUMOHKH         : VPYL            CPTKKMAESW     
TLVSVC          : WOPHAJYFQBRA    AITKUYDNRPSMXLR GBOOCXVV        NNLDAGWTS      
HKDHBQHPYSTJGB  : CSTDITVWBOKTTR  YMLFITWBAFGJSBY AGHFV          
HDQWUAJEO       : QQBSTIVRDREIKQR IMDSUGGNWMSLOH  IVNPUWACVYQIDY  KEXSDBXXVWXUJI 
PKXNMW          : AOMYJMLLJOEFP   BVKHRF          SYXNIPPKX       WEPUXVDRQD      YGTXUTJWEPTHK   YUCONHIPAPG    
YCFCSMRTHLGOOC  : PHPHAW          KQKPMNMWMA      RQNEXUKH        TBFKBDXPR      
UTWPVJTKO       : TPXAXTVWU       NHIVAJMXAWN     TMDNQV          BODJOXJSFRXS    LUSBXONLGIBW   
UNCJM           : WXWXCMNG        GPYGSUWKYKYCV   JQHQANN         NLVSUNCSWUPPNY  GYCUTHSAE      
KOFMJUGDC       : KMIILJVV        YRVXHTOVBYGF    KXQRWO          LPVWLP          DKOWGBHTTRFBTTJ
JSLMTGIQVEARPP  : AIFJQAYMXO      MPAIW           NKYQRSDMAJXMX   SLTVHLX         AHXDF          
MFIYTIJKNYTIHW  : BXCMPVUCO       FLFAE           HAOEIX         
EHGQVAWET       : FHNOLXMISYJFJAU GSPIQGPGATBPJ   WPMPIJRBPTALNCU QPCMRUYKN      
ITNALVN         : XNMS            HYRLFKSN        TIODU           IPAHMGYYNNLW    VBIPNYM        
EOMM            : BSQERITOQ       ITVCLGFQU       MTYDJHFGIQXHA   IVWY           
YDWSNF          : NERWCEFVRF      AAHYU          
BLAKCVKACEXMBN  : DVDJQKAQTSYQLEB PTEALCGWMOYM    UYWTOYRWJ       RRCJLON        
OKDIORWEPWHPR   : KCCJTJPIYH      CPVNALUACC      FHBSLXOWFP      PGVYMIGGY      
WKYIKJNIVPKD    : MFKQYF          VEAGAPL         PWOLAJMQLVFQ   
XEBNULQFBK      : GBNCLDWQ        PNSQTJ          QPYGUL          GPJQWVQCN      
HCCO            : CTKKVAMN        BPQUKTNRREXK    AENVMTWBYYVYOA  IATEDRDYLVUO   
VLQHMCRVPDU     : BBGK            JHQOKNKUF       BIEJC           FHBSLXOWFP      KCQLH           COPCTRXPVTGLDV 
NXUNCVBY        : IGSNHHYRLR     
TFLEKSJOJDKWWR  : GITRBWTR        XSWQPBUVDAKURJQ BDMODTBKEYBUPY  RIIBLQQGEMC    
YMIQPDXFDST     : WFMOHU          OKPYMESCLPW     TYCIDWKONIIGEHU IBLGGWDEFCGNR   FPBFNFKFBGWO    NMLWO          
OUHYRMKV        : UIWJCSM         EUVIAB          QVWJKNY         XMBNXEGWKTMK    CNBSAPQRAMU     CHQNNJNDYCO    
FHNOLXMISYJFJAU : YIAVYQY         EHGQVAWET       GEBMR           YRVXHTOVBYGF   
XCSQVBHTIHLWTJ  : BWIQFM          GXMCCUAMD      
ARJQDJF         : CFEIDFQN        FBAUC           XGPERMDLMQW     GYCUTHSAE      
CEWHQW          : RPJW            BIVLAVLNUHGOY   XBMNSPIMNBQSJIQ
GWHYP           : EGKHMFACWNM     OEICBFDCHCBVCV  YJWFMQENPTYAVDA AMYHPOVJYYYBGUB VVHQQKRFADOJFLJ
CWYKG           : MSSRLWVN        SLEC            OFCDTCGV       
JBWFBOORTBX     : EGKHMFACWNM     IEXOLYMILCKLGK 
DEENUDRDA       : BPIWBUMXVBETMQ  IVAFNUXA        UTJUBCT         YMLFITWBAFGJSBY
DRJFOISVXCY     : WCOYPSQOWWUSQ   SOLDRXKRQTGUP   GFNDACBWXMPRH  
KALBTFCTOGBSTX  : GXMCCUAMD       OTTRLUNUOQJ     QTUQGFYOGN     
NCAR            : ICWUQWGMMRUBL   PFWOHQJN       
RDMINHELMFGWF   : VREICHWHGD      MJQEYKLU       
ACYDXNLYIHAGW   : NOXEAIC         FWIIMFUN        OOXHCXVC        NHIVAJMXAWN     SHSEIMYDWFVBV  
GQJXTVHI        : KUDFFGLBAAO     OIVDJIXGNJXSGA  OSHUTYPEGOP     HYVILLHNJD     
NTSTBRBURFUUGKI : NMTMUUBO        DMURYSWM        FAMJLXN        
TPHANJJG        : LAVCQSFUM       XUVGH           YCHUBQDUQXC     SMIOXXTYBUFWXGN ERREUES        
JBRSJAJFSD      : THAVKXWUDLXAG   OBHYVPXPHF      JPQF           
KGEE            : NOKPDEYXK       MORHSXPH       
BCULKCFBMIQVT   : DVBQIP          CTKKVAMN        TNDEQHHLITDYD   FMCDJH          NHIVAJMXAWN     EROVUCCCFY      JRLMXIHVROXUTLR
RDAL            : KDFU            SJOWJUTEQYGHVQ  JYRGPLVNMOL     JMSBBCL         RTNRRWQO       
JLGPGL          : WFMOHU          EJNBPSBBDACTVVB
STEW            : AITKUYDNRPSMXLR FWKXMMGKXJXLHKN VPCXBTS        
FBHRMKYPYJIU    : NMTMUUBO        DVDJQKAQTSYQLEB SJPD           
HOHICGTPOLVCMQ  : RYFDJR          CNPOOSNEXKIASJ  TMUIUCFQURAHE   PYWBDNVWVANU   
QQJW            : HFUSIACIP       WGRETRKLXDYDOLV YSDBUOQMKPDXT  
QQEDR           : SJDLRPBL        MCAQUXEP        RGEHRFJ         RVFHYVA         VYHNURCMVDGWTO  AAHYU           OTVDUL         
CCEAFOQOWTWQLLF : TDCQWKQ         NXCTKL          YCHUBQDUQXC    
PRBOITAHM       : LJMDKPEG        CVCXVNETDJU     XYSUNDBO       
XSWQPBUVDAKURJQ : TFLEKSJOJDKWWR  HTPLDW          KSYAVIYDCWBVOQ  OFCDTCGV        CHYJQYMNFEFIW  
DEDIOSASJKMJ    : NMHX            QPYVQFOP        AITKUYDNRPSMXLR LAHJDACYY       VGNSJIWEMNCSQU  EYJUUIQX       
YDSUCLMD        : PCPRHW          GBNCLDWQ        XMRUGUNUISRW   
KJJVGBH         : OIVDJIXGNJXSGA  QSJJXNKXAVKKMWB
RKDUSSQULAGAKYC : NSDXUHIQQA      CKKR            WEFO           
RWRELWMVGVTO    : CNROROIMFFA     JVUPDQOD        SBOXQINCYPUJT   HYVILLHNJD     
CNROROIMFFA     : RWRELWMVGVTO    MNBPVILPEY      GLKTOFIK       
LASMCKHBCNMB    : NDUJHMQJP       HPKFCRQTTX      TMDNQV          QPCMRUYKN      
JKWFYXHNPWHFHTM : NDUJHMQJP      
TUBTN           : JRPGAMVOSTRMJR  IVAFNUXA       
WXWXCMNG        : NOAVPYWGA       HDTOAQTPIYJXM   DYGJDEEX        UNCJM           YNRFLWCJHCLQ    NDHEBSCQLDXGV  
WQMC            : LDFGWMOS        WOPHAJYFQBRA    AGDQWP          PJYBXCC         UIXS            YOUXVTNFI       JCKAFHGNGBTMNV 
KMFDLO          : SWGILYQ         QAHKXMIR        QPRBSQURCDIQ   
UIWJCSM         : OUHYRMKV        FHBSLXOWFP      DDJWS           SUHECSVAPJQQ    STSDKXLLYPJ    
IDXJCXLP        : RBQR           
RFKKTPDECK      : LJMDKPEG        QQOWABQLOMXUN   FWKXMMGKXJXLHKN AMFFRHUQQMCKA   PWOLAJMQLVFQ   
PATKKTVNOJOWO   : OLFFFMNSJXKGBA  HDAUVIRLP       IOWXBDTBENJNE   NCENAQW         POHNKQJ        
GQKU            : IQOONVGNBJBDY   ESUPWVWDXEFC   
WOPHAJYFQBRA    : TLVSVC          WQMC            HMGLPGA         JWFFCVDSVDJUYLA DYBRSCBOFNBD    EGXDIVIDMFRBBIX
TWFFSCU         : VVBJ            SSELDPDUFQMOYFJ CSUCYIRJ        XIVCEP          LTHUXEV         VEAGAPL        
NJGCVPUIMG      : NBSJQLNSCVMG    TFKXSA          VOJTTEL         AWUQTJRFBE     
BVPDGOKY        : QJUSNVUC        FTQQQLOOUBJYF   YSUILEYLROLVEAM VPHGGVOOFAV    
DYNWXT          : GMFJDEIOB       EWPDYTPYW       COROYDJHEFOBJ   OXHNNOTTKIKSK   PYWBDNVWVANU   
SVWCJIJNEBIPNO  : PVRKFLKL        YHJCDXTO        FBBMDVNTDSW     EDWL            POHNKQJ         ROGFJMPWKWGAX  
QNMUTEHUYKTMIUG : TQICCI          FBBMDVNTDSW    
PEMSPUEDCFORUFO : RKWQXJDTK       VPLEWD         
SEIOKQJJDGX     : VYHNURCMVDGWTO  OFCDTCGV        DIAORFAYGIGSKLY GULJJ          
DHBS            : BIVLAVLNUHGOY   FYHULNO         LGTBTSPIHDSB   
PLEMPJQW        : XJSHDEVTLMB     QBVG            IEXOLYMILCKLGK  EASVVTYQ        MKNOPOU        
KREC            : DYGJDEEX        BWHGMG         
YGQOSHXELE      : RNOFSC          KUYG            YRSESYNPYPF     OKDWSUUYS      
YHJCDXTO        : SVWCJIJNEBIPNO  WRQDGV         
HHNXEMJYSLFR    : THAJCEBUBMPOGJ  YRSUIEPEQLUPOAM EORN            TBAFLJPYDIYRD  
VGMGHSTNUUXHA   : NFUUFDWDQHPH    STWLDOSB        ROLOQ           BODJOXJSFRXS   
HTPLDW          : RKWQXJDTK       XSWQPBUVDAKURJQ GBNCLDWQ        NBXMGPD         YRSUIEPEQLUPOAM HJQGSRAWLRLXJT  YNXSVHCGMP     
CENNDGBKYUIH    : XHLYGVIXE       TDCQWKQ         QQBSTIVRDREIKQR XBMNSPIMNBQSJIQ GNJJYKNGFQYKL   IXQCKVIAXPJH   
OOCKDYIDI       : NBSJQLNSCVMG    LMTFUQWSWJKLEUF UUMHXWWQRJNQE   FEFNGEDT        RBQR           
EPETD           : QWKHIWCWCEKXCRD OIVDJIXGNJXSGA  YCLMPC          TSTWMPEAIA     
TFKXSA          : CTKKVAMN        NJGCVPUIMG      COPCTRXPVTGLDV  HREAIRRQRXFBFS 
CBLDXTKJL       : KEIN            LAVCQSFUM       FNWOEXDTDHYNF   TMGVLXFJDRW    
LXHM            : XRQSSFFMTDJU   
KVQONVKR        : GIHXTJC         XNMS            QWKHIWCWCEKXCRD LPQUNPCEMUGBSL  FHYDLGCWAOJBEO 
EYQERQHTTSWRP   : FTNRKDWT        XAHSIDMHASHMEU 
BDMODTBKEYBUPY  : LYEMKMLDCC      TFLEKSJOJDKWWR  WEDJMTJKVMEYSTI JQHQANN         GWRD           
JFMI            : SFCKG           JGTSJVVE        KCQLH           TBFKBDXPR      
QAOY            : UCNAFMVBAFOVFY  YUCONHIPAPG    
ITVCLGFQU       : EOMM            BWKJUUMN        KVLMDAD         EORN            POHGWV         
UQXFWYIROKAXP   : NEDAOHMOB       AJWHRXWQPNHTUXX KLXUT           KCCJTJPIYH      IVNPUWACVYQIDY 
GMFJDEIOB       : GQFXGQDRV       BSQERITOQ       DYNWXT          AJWHRXWQPNHTUXX HODWKKAVM      
QONWGISBAQIW    : DVDJQKAQTSYQLEB SORYJNUXCXHUU   LAHJDACYY       QCXTU           UTJUBCT         TPOGRMVSN       SWVSDOEKFWR    
SRFD            : XQJGCQU         UCJJGLBDLFUOI   HMGLPGA         HNVHEOQRFWBGPP  NOKPDEYXK      
GTGOILX         : HXPWLIFWAHOXUMX YAPCTTTDLM      RVFHYVA         VKSD            RIAYFWMJOD      FEPAHNNVYLPXC  
SGCTNTIBSQLL    : AOMYJMLLJOEFP   DPPXQEJUIUVXVOO NBCGUFIPOMA     YETATCOMHEKPF  
LDCLVVFDYYJ     : KSYAVIYDCWBVOQ  NMXKABXOLPRRQP  PTEGAOXB       
FYFQYTLIVFV     : LKMTBEGBUSSU    JYBODHEUIR      LQYPVTDAVETGXI 
QWKHIWCWCEKXCRD : QQGTQXXXPAGJ    EPETD           KVQONVKR        AMFFRHUQQMCKA   BOMQBOVBHDF     BHVBMJX         WRRHFFOSQUVJVMD
QPYVQFOP        : DEDIOSASJKMJ    PXBPXVFWEIKIUP  QSJJXNKXAVKKMWB YUCONHIPAPG    
BAUIVNBUX       : YJHFUJR         YBBSEEVEHSA    
EWPDYTPYW       : JQFVABLI        DYNWXT          UFONIJIOHVI     SHSEIMYDWFVBV   UJEYKCIQNBR     DYFJUYLCLO     
FBAUC           : ARJQDJF         YRSESYNPYPF     NESYNSNNPHOVRC 
LJMDKPEG        : IURTAXT         PJCHLPMKRCOLX   PRBOITAHM       RFKKTPDECK     
CVCXVNETDJU     : PRBOITAHM       PYKJKHLPU       FEPAHNNVYLPXC   CCYTIRLIQADCAOX
YWYICCIWEGKQSP  : IPVRFCHDHEJT    MBAAL           JYRGPLVNMOL     QPCMRUYKN       OFIXYBVOQQEUBX 
JVJKB           : LXAE            RGGJPFNUFTEKALI AKIXXPSOVRWPQF 
OYEFDXIOUK      : MBAAL           OOXHCXVC        UCAGYEYO        PFWJKEWXOK      QOCTJLYKXDUQSVI FVGM           
RLVTNGSUMF      : MSMJAKEALIXBY   BDBWHELQBIIKJ  
HXMSTWF         : XRQSSFFMTDJU    XQJGCQU         DGQYEOPUFMEHK   LPBXRANVRGRXJ   WLBWXCHOS      
EUVIAB          : OUHYRMKV        FTQQQLOOUBJYF   WDWG            STSDKXLLYPJ    
KPEVFVJDSX      : MOVEDAJNR       BIEJC           MBDYEW         
NSXTGGR         : IPOPUWWVC       QPYGUL          TMUIUCFQURAHE  
YNRFLWCJHCLQ    : LQAO            WXWXCMNG       
BWKJUUMN        : ITVCLGFQU       NURPMGL        
WEPUXVDRQD      : RLCEDPR         VUUPCBLSBCOSLN  PKXNMW          NMMFFSI         ABSW            QQCLN          
LKSKM           : PWAMWVQQOV      SAQVMBKNSSLUWU  YNSSIENKTPUO    THJUVCPEHDQDTO  VGBTXVIYWUNNQXJ
RQQKFTHQDDNQS   : BPQUKTNRREXK    LFNMNOYJJ      
PWAMWVQQOV      : MSSRLWVN        GSHSKPPKTVOCY   THAJCEBUBMPOGJ  LKSKM           DKKEQEE         IXCGMOVE        JPHF           
AITKUYDNRPSMXLR : QBVG            FLMDXTPOFHK     ILTKXG          TLVSVC          STEW            DEDIOSASJKMJ    RMIBREIYE      
BIVLAVLNUHGOY   : XSSBQHUOE       CEWHQW          DHBS            DKSOUTAFJGFYMBN
PYKJKHLPU       : CVCXVNETDJU     SAQVMBKNSSLUWU  KVLGIARWERLKH   PFWJKEWXOK      MVOWXTX         OJTR           
FPRFCMIFWHRXFDN : EPVBXDXL        GIHXTJC         EJMOVHIXMLJH    VQOLSPT        
NTOMVEN         : OQHCGDWLSBQKEDM HODWKKAVM      
QXREPOJXEE      : EJLRON          VPYL            AKIXXPSOVRWPQF  TMCRPLBN        WEGYUGEKCJYW   
IQOONVGNBJBDY   : GQKU            JVUPDQOD        RIIBLQQGEMC    
ULSBABTASXSHKQ  : OKPYMESCLPW     NBXMGPD         OTVDUL         
QVWJKNY         : OUHYRMKV        KQNLJIEXFBSAUV  YOUXVTNFI       EAERQFJOYMPWS  
TNLGORHMMVF     : CTKKVAMN        XRTYJAFEJQIXDSJ FPVDLSEHFMQMTW  QUMLJ          
XJKAEKSOWLD     : ANWV           
ICWUQWGMMRUBL   : NCAR            GRMEBDPNXUKQ    MMPHIRUUS      
NXYVOWFBW       : MUPJXQQFUU      YCVPWNENRRPCVO  AXJKXLLMPWDPGX 
LSXJEDYOGYMYXUN : BVKHRF          ANBYRPT         YHXCRJV         BWQHNTCUMPJOWV  PTEALCGWMOYM   
MJNBOEYPAPMFQL  : IOWXBDTBENJNE   AHXDF           BNER            VGBTXVIYWUNNQXJ
FGRQNUP         : WFMOHU          OLFFFMNSJXKGBA  GBNCLDWQ        PXBPXVFWEIKIUP  IVWY           
DQQEOLSBBE      : DUTTMOCGSUTPT   BMOKYIYMARIXSPS
CSTDITVWBOKTTR  : HKDHBQHPYSTJGB  DGQYEOPUFMEHK   BGAS            BMOKYIYMARIXSPS LVBFQUMTOG      NWLODTOR       
KFLDJOTDVJOQMRU : BCWLLKUJ        ESUPWVWDXEFC    BFJBJVYHGQ     
TPXAXTVWU       : UTWPVJTKO       SBOXQINCYPUJT   JVLBNQPIO      
JRFDFRKQUWI     : NOQDQO          QETSE           QQCLN          
AGDQWP          : WQMC            NQPVSGMJWHWBH   AMFFRHUQQMCKA   PDQVSBXD       
RSFJQFJLB       : HTJCUCBNEG      FHHETWNBOMMAFW  RLBOKRMFWXQWL   WLEBFHWTB      
IORCVVINGBLDL   : DYCEVWUNXGB     RPJW            PDTYMERBQHLL    GBNCLDWQ       
FTGWQV          : JNDJO           QXUJEWR         VPCXBTS        
KQLTKRDVULGJ    : UTHFTMHXQDWN    MASQS           CSUCYIRJ        VIHAEEALET      DKSOUTAFJGFYMBN SWQHE          
JFCTVIWJ        : KSYAVIYDCWBVOQ  OJTR           
LMTFUQWSWJKLEUF : OOCKDYIDI       BOJCEL          WVTYJGQ        
SAVYMCKT        : OIVDJIXGNJXSGA  PTOGBBRWIRGJBA 
GRMEBDPNXUKQ    : CTYDHGOWVBWGW   ICWUQWGMMRUBL   EQEQCKNHTG      JGJIG           QFNK            MCKRCSTSWJVPJL  BWYCRXIHQBPCWR 
EQEQCKNHTG      : GRMEBDPNXUKQ    STWLDOSB        BWQHNTCUMPJOWV  PYTH            SPOV            VVHQ            ERREUES         HSTVTBILKSWUR  
RHVTUSABKPFM    : JGTSJVVE        ILJTMHW         ACGHJNGVKUE     JXRPGTS        
WCSUPKQTDUM     : OYMK            BHVBMJX         AFGISR         
HAOEIX          : CPJE            MFIYTIJKNYTIHW  MVJRFPS        
PWSKPUMCKTQETV  : TMCRPLBN        QETSE           BGAS            OTTRLUNUOQJ     VVGRMFLJ        BONBLRHDUIRSDGF
OLLFHODTTMVKQEJ : RGYWSRCHI       RDBGALTSIUEXKFK WEGYUGEKCJYW   
TGKHXHVCSRTYLRX : FBJNLX          AMFFRHUQQMCKA  
DKKMBPI         : LODLB           SBLQIUPGV       NQNKLVYWSIUVP  
CEGVIRNEA       : MUPJXQQFUU      BWHGMG          PTYTWHBQCRROMQF
LAHJDACYY       : DEDIOSASJKMJ    QONWGISBAQIW    JPHF           
SAQVMBKNSSLUWU  : LKSKM           PYKJKHLPU       OBMLXF          WRRHFFOSQUVJVMD
HMGLPGA         : HYRLFKSN        WOPHAJYFQBRA    SRFD            HTDUJOTAWXBCHV 
QJUSNVUC        : YIAVYQY         BVPDGOKY        BGAS            FHBSLXOWFP      PLGMAROKFFVBL  
UUMHXWWQRJNQE   : OOCKDYIDI       DSJAN           UEUEQVECR       YSDBUOQMKPDXT   BONBLRHDUIRSDGF
XSNMIWO         : EGKHMFACWNM     UXRYNJNMOAVUFK  UEUEQVECR       EDWL           
NAVIO           : EFHPJMQNV       OBHYVPXPHF      BNER           
DSJAN           : UUMHXWWQRJNQE   QICBVXICMBWUX   NLVSUNCSWUPPNY 
HNVHEOQRFWBGPP  : SRFD            HREAIRRQRXFBFS 
BOJCEL          : LMTFUQWSWJKLEUF OKPYMESCLPW     VPLEWD          VDGRJU          OTTRLUNUOQJ     PTOGBBRWIRGJBA  JVLBNQPIO       XCTHMRWWPX     
BOJCEL          : JQXMGM          EJNBPSBBDACTVVB OKDWSUUYS      
MASQS           : GHKUT           YYRTB           SORYJNUXCXHUU   KQLTKRDVULGJ    GCRBWYRDRUQ     EDVHAXBDPVVR    AHWOMQFE       
QICBVXICMBWUX   : XRQSSFFMTDJU    SORYJNUXCXHUU   DSJAN           IBLGGWDEFCGNR   QWNSLUADDV      KEXSDBXXVWXUJI 
DPPXQEJUIUVXVOO : XJSHDEVTLMB     SGCTNTIBSQLL    QSJJXNKXAVKKMWB QPCMRUYKN       GQYFDICBN       WYQS           
THAVKXWUDLXAG   : JBRSJAJFSD      PCPRHW          DODNBSMNPS      PTYTWHBQCRROMQF
ALOQJHU         : SYVRBEKI        CFEIDFQN        VPLEWD          BONBLRHDUIRSDGF
DGQYEOPUFMEHK   : HXMSTWF         CSTDITVWBOKTTR 
IHMLTLLC        : QAHKXMIR        EENPR           IXQCKVIAXPJH   
NOXEAIC         : DUTTMOCGSUTPT   ACYDXNLYIHAGW   SNLCHFUNPX      TDRMJMONK      
NKMOQBG         : KLXUT           MNBPVILPEY      JPLNNVJRAB      LVBFQUMTOG      SSSWBJPQN      
ISRSEJBNWMJKAO  : NMHX            AMFFRHUQQMCKA   JPHF           
NFUUFDWDQHPH    : WEPEEAEWRYPY    VGMGHSTNUUXHA   NJOBRYOCLSB     RIIBLQQGEMC    
SNLCHFUNPX      : NOXEAIC        
OKPYMESCLPW     : YMIQPDXFDST     ULSBABTASXSHKQ  BOJCEL          XUVGH           PYTH           
STWLDOSB        : VGMGHSTNUUXHA   EQEQCKNHTG      QTIWCQNK        OIVDJIXGNJXSGA  TMDNQV          PXHUWLCPOH     
HOMQUJEMHJ      : TXKAWCRUYX      EASVVTYQ        EAERQFJOYMPWS   EQTTFC         
TYCIDWKONIIGEHU : YMIQPDXFDST     AKCYRWL         NWLODTOR       
VPLEWD          : PEMSPUEDCFORUFO BOJCEL          ALOQJHU         FTAYEYGRHNU    
NXCTKL          : CCEAFOQOWTWQLLF KQNLJIEXFBSAUV  QETSE           XLXYBRFQOJIPNOK TPOGRMVSN       VBRWDPSQ        UCJANIRSE      
NFDPP           : SFCKG           BVNLSI          AEGAOF          KLPB           
MBAAL           : NMARSXUSCXLXYSP YWYICCIWEGKQSP  OYEFDXIOUK      TLKPMMVOISD    
JRPGAMVOSTRMJR  : TUBTN           JXHWFAVSVLJLVA  WEGYUGEKCJYW   
GEBMR           : BBGK            GGEJD           FHNOLXMISYJFJAU OMSHCESKLR      DKOWGBHTTRFBTTJ
PJYBXCC         : XJSHDEVTLMB     WQMC            EINUJ          
NMMFFSI         : WEPUXVDRQD      WGRETRKLXDYDOLV IPAHMGYYNNLW    OTVDUL          RAANSHMLS      
OYMK            : WCSUPKQTDUM     AKIXXPSOVRWPQF  FEXIXYAAKSEVMWE
BWIQFM          : XCSQVBHTIHLWTJ  MQKCSFU         LPCTEGGOLRIJMY 
RGEHRFJ         : TESDPN          QQEDR           UBQKLE         
HNSWAFFFAPYROO  : PADTSPP         GGEJD           OLOII           VPHGGVOOFAV    
HPBRIG          : OMSHCESKLR      MORHSXPH       
EAMLKE          : GGRRJKCMY       EEXAOURTOY      FMCDJH          JVUPDQOD        NLVSUNCSWUPPNY  UMPRFXXEMGRAIJ  GFNDACBWXMPRH  
VVBJ            : TWFFSCU         EVQHFXDPPQALQX  FEPAHNNVYLPXC  
AJWHRXWQPNHTUXX : ANHHSPTVP       UQXFWYIROKAXP   GMFJDEIOB       CKOPVWPLESRC    EDVHAXBDPVVR    OJTR           
IGSNHHYRLR      : THAJCEBUBMPOGJ  NXUNCVBY        SLEC           
KSYAVIYDCWBVOQ  : AIFJQAYMXO      XSWQPBUVDAKURJQ LDCLVVFDYYJ     JFCTVIWJ        GXMCCUAMD       JUCUGBGGGDWAA   KRGHLKWBVUKJHYV IDPKHFPCVDMH   
LODLB           : DKKMBPI         FTQQQLOOUBJYF   WEGYUGEKCJYW   
TWCDGDUSUKFQLHM : YIBGIURPHND     XIHPJDMOMDVWBR  HIUIYRQFWOYBE  
GPYGSUWKYKYCV   : NOAVPYWGA       BVKHRF          UNCJM           SBOXQINCYPUJT   TQEG           
QQBSTIVRDREIKQR : CTKKVAMN        HDQWUAJEO       CENNDGBKYUIH    KCQLH           BNER           
NXOMGKK         : LVBFQUMTOG     
WJOXNLA         : MNBPVILPEY      OPRHTHGIXSDU   
EEXAOURTOY      : YIAVYQY         RKWQXJDTK       EAMLKE          DAQWYW          WEFO           
YRVXHTOVBYGF    : HDTOAQTPIYJXM   KOFMJUGDC       FHNOLXMISYJFJAU CDNJ            JRLMXIHVROXUTLR HREAIRRQRXFBFS 
PVTEJ           : YIBGIURPHND     WIGGSWRG        TSRNAWKUMNCL    FWIIMFUN        WGRETRKLXDYDOLV HREAIRRQRXFBFS 
JNDJO           : MSSRLWVN        FTGWQV         
EINUJ           : OQHCGDWLSBQKEDM PJYBXCC         SJEKJMGAOIR     FEXIXYAAKSEVMWE EJNBPSBBDACTVVB HVEKNJX        
VBNV            : AIFJQAYMXO      NEVIK           UYWTOYRWJ       IVNPUWACVYQIDY 
HLFKMNRLEOHKXG  : XRQSSFFMTDJU    XHMMKKICBNJ    
OLFFFMNSJXKGBA  : PATKKTVNOJOWO   FGRQNUP         AYVXLNPQMPWY    XYSUNDBO       
MIRRUHH         : LQAO            TQEG            XFWPD           QPGNK          
SLEC            : ECDDUNULDS      CWYKG           IGSNHHYRLR      IBLGGWDEFCGNR  
CJTQWCVD        : JGJIG           XGPERMDLMQW     FKIPDDUSVJGBBFL
MVAMJIPJNCTFVP  : JYBODHEUIR      MTYDJHFGIQXHA   RJFULM         
EFHPJMQNV       : NVRTIK          NAVIO           YPCXPXOYSUBKGF  XORJPDFHV       HIBUQQ          KQOQBMNAQ      
HSODXH          : LTHUXEV         HSTVTBILKSWUR  
WIGGSWRG        : MLPKOMYMKDQERJP PVTEJ           RVFHYVA         VQOLSPT         UBQKLE         
MOVEDAJNR       : YIAVYQY         KPEVFVJDSX      LSYB            EORN           
AKIXXPSOVRWPQF  : JVJKB           QXREPOJXEE      OYMK            CPTKKMAESW     
WATQJUFAQJDSUSN : TDCQWKQ         OLOII           GWRD            CEVS           
UXBSV           : PYFTO           CASNKLJIHNT     WEFO           
OLOII           : HNSWAFFFAPYROO  WATQJUFAQJDSUSN LFNMNOYJJ      
YPCXPXOYSUBKGF  : EFHPJMQNV      
EASVVTYQ        : RKWQXJDTK       PLEMPJQW        HOMQUJEMHJ      LPQUNPCEMUGBSL 
SHDH            : QQGTQXXXPAGJ    SORYJNUXCXHUU   EJCDOSAYED      KCCJTJPIYH      KGTOVKWGCW     
NOQDQO          : JRFDFRKQUWI     BBVJXGLN        MHKKTSYJW      
QGWKBYWJGCNIX   : LYEMKMLDCC      AENVMTWBYYVYOA  VVRGLDDHH       YBBSEEVEHSA    
GRLAJGHN        : EPVBXDXL        QSWI            TTSOLEPRDLT     YNSSIENKTPUO   
ABFQHYIFPOEAPFY : SJOWJUTEQYGHVQ  CKUXEXWXDCTVC   JIPFANGTNXNOWQ 
NERWCEFVRF      : BBGK            YDWSNF          JGJIG           BPRUTE          YCGCTUOBCK      RCLICAT        
YPUPPYUIITQNKFT : GULJJ           QSFH            FDXIOI         
WCOYPSQOWWUSQ   : DRJFOISVXCY     VPCXBTS        
APPVHFWD        : RLCEDPR         WVPYTHXQOY      IKTNLLJTYCDJC   TQEG           
FYHULNO         : EPVBXDXL        DHBS            NQNKLVYWSIUVP   VVHQQKRFADOJFLJ
KQNLJIEXFBSAUV  : SPJTKM          IKOMFYQQSGTE    QVWJKNY         NXCTKL          TTSOLEPRDLT     OUEVEU          BDBWHELQBIIKJ  
KLXUT           : UQXFWYIROKAXP   NKMOQBG         NURPMGL        
AKCYRWL         : TYCIDWKONIIGEHU UFONIJIOHVI     LAVCQSFUM      
OMSHCESKLR      : GEBMR           HPBRIG          UNDFXKELFV      ABSW            NYQQPB          IGHCWANLRL     
MMPHIRUUS       : ICWUQWGMMRUBL   DOWBWUCWXMSCKH  QSJJXNKXAVKKMWB
QPRBSQURCDIQ    : KMFDLO          WEAVHKHDJ       XPFDG           TGXWB           FEPAHNNVYLPXC  
SSELDPDUFQMOYFJ : GQFXGQDRV       TWFFSCU         DRWCEJTXAURSS   BONBLRHDUIRSDGF
XBMNSPIMNBQSJIQ : HXPWLIFWAHOXUMX CEWHQW          CENNDGBKYUIH   
BWQHNTCUMPJOWV  : LSXJEDYOGYMYXUN EQEQCKNHTG      YETATCOMHEKPF  
WWAM            : EXODC           GULJJ           IPAHMGYYNNLW    WHASHFLQE      
RVFHYVA         : QQEDR           GTGOILX         WIGGSWRG        NCXUX           CJFUBS          VVGRMFLJ       
GSPIQGPGATBPJ   : EHGQVAWET       COROYDJHEFOBJ   JXRPGTS         GPJQWVQCN      
EIIQFG          : IURTAXT         WGYSBYVYBNH     TDRMJMONK       BDBWHELQBIIKJ  
SBLQIUPGV       : GQFXGQDRV       DKKMBPI         LOYLNOTIPSDE    OKDWSUUYS      
NQPVJVNRYH      : USVTVRB         TIHWASLYKHWNEIX NSWH            LPCTEGGOLRIJMY 
QTIWCQNK        : STWLDOSB        IPAHMGYYNNLW    WLBWXCHOS      
HDAUVIRLP       : PATKKTVNOJOWO   SUHECSVAPJQQ    WTKESX          JEJMMAXTVVYCWS 
NDHEBSCQLDXGV   : WXWXCMNG        JYRGPLVNMOL     AGHFV          
QSWI            : GRLAJGHN        POHGWV         
JHQOKNKUF       : VLQHMCRVPDU     IVAP            VKSD           
MVJRFPS         : HAOEIX         
UJLAKSWE        : QETSE           LBUNULHOJIJ     DDJWS          
PDTYMERBQHLL    : IORCVVINGBLDL   FWIIMFUN        AVJN           
JYLVQQL         : YJNY           
OIVDJIXGNJXSGA  : GQJXTVHI        KJJVGBH         EPETD           SAVYMCKT        STWLDOSB        QTUQGFYOGN      JXRPGTS         MSMJAKEALIXBY  
KTJD            : TNDEQHHLITDYD   MLPKOMYMKDQERJP RXSUDHQGKXVIDU  GBNCLDWQ        QPYGUL          IPAHMGYYNNLW    WMAJMLIF        RQNEXUKH       
KTJD            : AEGAOF          COPCTRXPVTGLDV 
XORJPDFHV       : KPRRTOVFFIFYC   YASEAKLO        EFHPJMQNV       IXCGMOVE        DYBRSCBOFNBD   
TMCRPLBN        : QXREPOJXEE      PWSKPUMCKTQETV  NEYBACBHB       ADFO            PUMK            GPLGVVFEYRLSUM  AVBYTXLWFRIVNR 
QXUJEWR         : FTGWQV         
QETSE           : NOAVPYWGA       SYXNIPPKX       JRFDFRKQUWI     PWSKPUMCKTQETV  NXCTKL          UJLAKSWE        TPOGRMVSN       TBAFLJPYDIYRD  
MNBPVILPEY      : ILTKXG          CNROROIMFFA     NKMOQBG         WJOXNLA         EWSWYCWRSPK    
XQGBFCTDYEJVX   : NMTMUUBO        PFWOHQJN        OLVK            VVRGLDDHH       WGBUKVMHSOLUVK  YNXSVHCGMP     
NEVIK           : KDFU            VBNV            MJEXCJU        
VYHNURCMVDGWTO  : QQEDR           SEIOKQJJDGX    
YRSESYNPYPF     : YGQOSHXELE      FBAUC           SKYKFPVNABXDILS SSSWBJPQN      
LPQUNPCEMUGBSL  : KVQONVKR        EASVVTYQ        GPBUCD          RJFULM         
PFWOHQJN        : GQFXGQDRV       NCAR            XQGBFCTDYEJVX   EJMOVHIXMLJH    MJEXCJU        
KCCJTJPIYH      : HDTOAQTPIYJXM   OKDIORWEPWHPR   UQXFWYIROKAXP   SHDH            FDXIOI          MLLF            XRTYJAFEJQIXDSJ FQQPTWYBIT     
PYFTO           : UXBSV           RCLICAT        
CPVNALUACC      : LQAO            OKDIORWEPWHPR   HODWKKAVM       DMURYSWM        FANS           
NSDXUHIQQA      : PWNGHDC         RKDUSSQULAGAKYC UCNAFMVBAFOVFY 
SJEKJMGAOIR     : SJDLRPBL        EINUJ           OLBJDKQGD       BHPX            PCXGSEXFATVFLPU
XSBSSFXLTQR     : FNVTUSNE        TGSJUCS         LFNMNOYJJ       FANS            XRTYJAFEJQIXDSJ
NBCGUFIPOMA     : AIBOH           SGCTNTIBSQLL    OPRHTHGIXSDU    LPBXRANVRGRXJ   RCLICAT        
BGAS            : CSTDITVWBOKTTR  PWSKPUMCKTQETV  QJUSNVUC        DAQWYW         
UFONIJIOHVI     : EWPDYTPYW       AKCYRWL         EDVHAXBDPVVR    TIHWASLYKHWNEIX
PCPRHW          : BSQERITOQ       YDSUCLMD        THAVKXWUDLXAG   PNSQTJ          WTKESX         
OFCDTCGV        : CWYKG           XSWQPBUVDAKURJQ SEIOKQJJDGX     TJJVIHKDLVKO    WQNIAVYLP      
IQBDVPQ         : SKYKFPVNABXDILS SUHECSVAPJQQ    QOCQCG         
BBVJXGLN        : RSPFT           NOQDQO          XYFS            WEGYUGEKCJYW   
CHRBT           : NKYQRSDMAJXMX   NMXKABXOLPRRQP  COPCTRXPVTGLDV 
GXMCCUAMD       : XCSQVBHTIHLWTJ  KALBTFCTOGBSTX  KSYAVIYDCWBVOQ  ALMRQLNOCKFWXAX TXMHCWECOSOFXM  VBRWDPSQ       
PHPHAW          : YCFCSMRTHLGOOC  FHBSLXOWFP      UMPRFXXEMGRAIJ 
CSUCYIRJ        : AOMYJMLLJOEFP   TWFFSCU         KQLTKRDVULGJ    UNDFXKELFV      OOXHCXVC        PRNDENT        
AENVMTWBYYVYOA  : EJLRON          HCCO            QGWKBYWJGCNIX  
GJIOJHANAU      : LQVB            BUDUUCCAWBDDKYD CPTKKMAESW      GCRBWYRDRUQ     EORN           
BDKKQ           : CPJE            TSRNAWKUMNCL    XIVCEP          YNXSVHCGMP     
OEICBFDCHCBVCV  : YYRTB           GWHYP           XNELPCQHVVEKO   VVHQQKRFADOJFLJ
NESYNSNNPHOVRC  : HDTOAQTPIYJXM   FBAUC           WTKESX          VVHQQKRFADOJFLJ
ESUPWVWDXEFC    : GQKU            KFLDJOTDVJOQMRU YCGCTUOBCK     
JXHWFAVSVLJLVA  : MITMG           SJDLRPBL        JRPGAMVOSTRMJR  MJQEYKLU        SWVSDOEKFWR     EGXDIVIDMFRBBIX
NCXUX           : RVFHYVA         FDXIOI          QIQKCVCGDRLN    POHGWV          MORHSXPH       
MUPJXQQFUU      : UTHFTMHXQDWN    TNDEQHHLITDYD   NXYVOWFBW       CEGVIRNEA       VKSD           
UCNAFMVBAFOVFY  : UTHFTMHXQDWN    QAOY            NSDXUHIQQA      EENPR           GQYFDICBN       UUHTW           STSDKXLLYPJ     JPHF           
KWJIQVFJHG      : OQHCGDWLSBQKEDM IRFJPGVHQWRRJ   NHLDTU          LQYPVTDAVETGXI 
ANWV            : BTWCQVLTCVQWLX  XJKAEKSOWLD     LAVCQSFUM       XUVGH           YCVPWNENRRPCVO 
RXSUDHQGKXVIDU  : KTJD            RYGFSVYKYTQOR  
PTEALCGWMOYM    : BLAKCVKACEXMBN  LSXJEDYOGYMYXUN LBUNULHOJIJ    
XIHPJDMOMDVWBR  : SFCKG           TWCDGDUSUKFQLHM
HODWKKAVM       : GMFJDEIOB       NTOMVEN         CPVNALUACC      RFQVR           LVBFQUMTOG      KMEWKGWXD      
UYWTOYRWJ       : BLAKCVKACEXMBN  VBNV            HPKFCRQTTX      IATEDRDYLVUO    RTNRRWQO        QUMLJ          
IOWXBDTBENJNE   : PATKKTVNOJOWO   MJNBOEYPAPMFQL  OHTMERS         OTTRLUNUOQJ     QQGOVUNMBLPXQXY EDVHAXBDPVVR    WLEBFHWTB      
LOYLNOTIPSDE    : TESDPN          SBLQIUPGV       PXUTBNXQNUPO    BVNLSI          AVBYTXLWFRIVNR 
WEDJMTJKVMEYSTI : VREICHWHGD      BDMODTBKEYBUPY 
XWUN            : BONBLRHDUIRSDGF JJELRXT        
GBNCLDWQ        : FNUVVBOUQ       XEBNULQFBK      YDSUCLMD        HTPLDW          FGRQNUP         IORCVVINGBLDL   KTJD            WQNIAVYLP      
QQOWABQLOMXUN   : RFKKTPDECK      EJMOVHIXMLJH    ACGHJNGVKUE    
PXBPXVFWEIKIUP  : QPYVQFOP        FGRQNUP         JGJIG           QLIIJLFINEJSO   TBAFLJPYDIYRD  
LAVCQSFUM       : TPHANJJG        CBLDXTKJL       AKCYRWL         ANWV            KVLMDAD         CPTKKMAESW     
JYRGPLVNMOL     : EJLRON          XHLYGVIXE       RDAL            YWYICCIWEGKQSP  NDHEBSCQLDXGV   AHWOMQFE       
TIODU           : TESDPN          LYEMKMLDCC      ITNALVN        
XNELPCQHVVEKO   : OEICBFDCHCBVCV  TCWR            MBDYEW          HFKFOIOGW      
LGTBTSPIHDSB    : TESDPN          XHMMKKICBNJ     DHBS            DIAORFAYGIGSKLY
JGJIG           : GRMEBDPNXUKQ    CJTQWCVD        NERWCEFVRF      PXBPXVFWEIKIUP  QIQKCVCGDRLN    JJELRXT         MVOWXTX         NPLURRJHEYEJI  
MSPPJYNHDXXSJ   : LPBXRANVRGRXJ  
OLBJDKQGD       : TESDPN          SJEKJMGAOIR     YSUILEYLROLVEAM ATFCVLWYKXCXKTA
UNDFXKELFV      : OMSHCESKLR      CSUCYIRJ        FMCDJH          GWBNDTNSQ       GFNDACBWXMPRH   XYSUNDBO       
QUQXAQXSAFKN    : OSDNVIYUBVGFMRO CFGEBFUKK      
TSRNAWKUMNCL    : PVTEJ           BDKKQ          
JWFFCVDSVDJUYLA : TQICCI          WOPHAJYFQBRA    OPRHTHGIXSDU   
CJFUBS          : RVFHYVA         FHHETWNBOMMAFW  QPGNK          
BFSNTWBTIA      : HVEKNJX         BDBWHELQBIIKJ  
QCXTU           : QONWGISBAQIW   
YGTXUTJWEPTHK   : TESDPN          PKXNMW          UXRYNJNMOAVUFK  QLIIJLFINEJSO   GAMGKGTAM      
IQMYKJAGSBIJDJ  : YJHFUJR         SBUKAKOPEIG     AWUQTJRFBE      ARKLWUHVYH     
BIEJC           : VLQHMCRVPDU     KPEVFVJDSX      LPCTEGGOLRIJMY 
EXODC           : WWAM            AMYHPOVJYYYBGUB WEGYUGEKCJYW   
XMRPUICVUN      : COPCTRXPVTGLDV  JNLLK          
DIAORFAYGIGSKLY : SEIOKQJJDGX     LGTBTSPIHDSB    ETAXQCQQY       LTMXWIOQL       MQCTDUYOAIO    
CDNJ            : YRVXHTOVBYGF   
ABSW            : WEPUXVDRQD      OMSHCESKLR      NYQQPB          LJXJYSDRUOFHHWL DODNBSMNPS      VPCXBTS        
WTIKSLTUCNA     : MFKQYF          FEXIXYAAKSEVMWE
PJKVCWHB        : RLCEDPR         RNOFSC          YRSUIEPEQLUPOAM
JGTSJVVE        : JFMI            RHVTUSABKPFM    OBHYVPXPHF      XGPERMDLMQW     MSMJAKEALIXBY   JJELRXT        
JBOROJGKEKA     : FMCDJH          JEUMC           CRHNWAYWQDH    
NPQAL           : FPBJA           IATEDRDYLVUO    JIPFANGTNXNOWQ 
XUVGH           : LKMTBEGBUSSU    TPHANJJG        OKPYMESCLPW     ANWV            LTHUXEV         AQCGWPQSQGVGN  
CCQXB           : BVKHRF          FBJNLX          QQGOVUNMBLPXQXY
SKYKFPVNABXDILS : XJSHDEVTLMB     QAHKXMIR        YRSESYNPYPF     IQBDVPQ         COROYDJHEFOBJ   EDWL            CCYTIRLIQADCAOX
OHTMERS         : TJHATBCRJVS     IOWXBDTBENJNE   NSWH           
YUQQURMPCLAJE   : VBADBQTAHRJ     VQYTU           TSTWMPEAIA     
WEAVHKHDJ       : HXPWLIFWAHOXUMX QPRBSQURCDIQ    SMNFVOBLBPDK   
MFKQYF          : WKYIKJNIVPKD    WTIKSLTUCNA     JTXXHVI         IVWY           
YCVPWNENRRPCVO  : BCWLLKUJ        NXYVOWFBW       ANWV            MQKCSFU         FPVDLSEHFMQMTW 
DOWK            : FEQSSVMWP       NOAVPYWGA      
HPKFCRQTTX      : LASMCKHBCNMB    UYWTOYRWJ       IKTNLLJTYCDJC   HGGJUAXIVC      RDMFEDWTN       ENWERBBESD      LPBXRANVRGRXJ  
SBUKAKOPEIG     : LXAE            IQMYKJAGSBIJDJ  JEJMMAXTVVYCWS 
FWIIMFUN        : ACYDXNLYIHAGW   PVTEJ           PDTYMERBQHLL    XFWPD          
LBUNULHOJIJ     : UJLAKSWE        PTEALCGWMOYM    HBHUMBIUAPOLQ   JBQYENMYE      
FTNRKDWT        : YDNWGFWNQNHFLS  RLCEDPR         EYQERQHTTSWRP   BERVGXOER      
FBJNLX          : TGKHXHVCSRTYLRX CCQXB           COROYDJHEFOBJ   YSUILEYLROLVEAM XMBNXEGWKTMK   
GLKTOFIK        : CNROROIMFFA     CEAXKL         
RYFDJR          : HTJCUCBNEG      CBLF            YIAVYQY         HOHICGTPOLVCMQ 
FHBSLXOWFP      : XQJGCQU         PJCHLPMKRCOLX   OKDIORWEPWHPR   VLQHMCRVPDU     UIWJCSM         QJUSNVUC        PHPHAW          KQOQBMNAQ      
VDGRJU          : DELFEXDUIOHL    BOJCEL          KNEXJTSVPN     
EJMOVHIXMLJH    : FOHIBIKJVQRGS   FPRFCMIFWHRXFDN PFWOHQJN        QQOWABQLOMXUN  
OOXHCXVC        : DVBQIP          ACYDXNLYIHAGW   OYEFDXIOUK      CSUCYIRJ        WQNIAVYLP       PRNDENT         BWYCRXIHQBPCWR 
NKYQRSDMAJXMX   : JSLMTGIQVEARPP  CHRBT           FINJYOIAP      
TGSJUCS         : TXKAWCRUYX      XSBSSFXLTQR     EDWL            PXHUWLCPOH      YNSSIENKTPUO   
SJPD            : DYGJDEEX        FBHRMKYPYJIU    COROYDJHEFOBJ   AEGAOF         
NYQQPB          : OMSHCESKLR      ABSW            AXJKXLLMPWDPGX  YTWAQAVGLQ     
GULJJ           : SEIOKQJJDGX     YPUPPYUIITQNKFT WWAM            KQOQBMNAQ       FHGYLJYCQB     
UIXS            : WQMC            WQNIAVYLP       DIKXGHPBPU     
UCAGYEYO        : OYEFDXIOUK      NOKPDEYXK       DKKEQEE         PXHUWLCPOH      GENBWFV        
IECWTENKTR      : MLLF           
COROYDJHEFOBJ   : DYNWXT          GSPIQGPGATBPJ   SKYKFPVNABXDILS FBJNLX          SJPD            OTVDUL         
HIUIYRQFWOYBE   : TWCDGDUSUKFQLHM DKSOUTAFJGFYMBN
UXRYNJNMOAVUFK  : AVXRMKSRFOIH    XSNMIWO         YGTXUTJWEPTHK   FPBFNFKFBGWO    VPCXBTS        
OBHYVPXPHF      : FRGAEEIFB       JBRSJAJFSD      NAVIO           JGTSJVVE        DYBRSCBOFNBD   
XGPERMDLMQW     : ILTKXG          MCAQUXEP        ARJQDJF         CJTQWCVD        JGTSJVVE        DKKEQEE         IXCGMOVE       
FMCDJH          : BCULKCFBMIQVT   EAMLKE          UNDFXKELFV      JBOROJGKEKA     YRSUIEPEQLUPOAM XYSUNDBO       
KXQRWO          : RLCEDPR         SPJTKM          KOFMJUGDC       LPCTEGGOLRIJMY 
WGRETRKLXDYDOLV : QQJW            NMMFFSI         PVTEJ           NSWH           
NBBQEMATYYMRXB  : IKOMFYQQSGTE    KEIN            IMDSUGGNWMSLOH  PGVYMIGGY       NMLWO          
XIVCEP          : TWFFSCU         BDKKQ           MXCNHOYICOQISGX
PNSQTJ          : WVPYTHXQOY      XEBNULQFBK      PCPRHW         
PXUTBNXQNUPO    : NSBCNGQEQUNVUYQ QMPLILA         LOYLNOTIPSDE    EMMLSDWHWJHV    YUHCEXRUKFXJHNL
JPLNNVJRAB      : NKMOQBG         OSDNVIYUBVGFMRO YETATCOMHEKPF  
RRCJLON         : USVTVRB         BLAKCVKACEXMBN  OUEVEU         
OIWSV           : NVRTIK          MXCNHOYICOQISGX FAMJLXN        
JMSBBCL         : HISGCW          RDAL            ARKLWUHVYH      JNLLK          
NYGJLBLM        : BNFVGCCYLGGYVUL RDMFEDWTN       AYVXLNPQMPWY    MQCTDUYOAIO     WSKDGPBE       
EENPR           : SWGILYQ         HYPA            RKWQXJDTK       IHMLTLLC        UCNAFMVBAFOVFY  NNLDAGWTS      
FTQQQLOOUBJYF   : YJNY            BVPDGOKY        EUVIAB          LODLB           FANS           
MXCNHOYICOQISGX : DVBQIP          KEIN            BNFVGCCYLGGYVUL XIVCEP          OIWSV           DDJWS           TLKPMMVOISD    
IGHCWANLRL      : VFSHQAGSHUQ     IPVRFCHDHEJT    OMSHCESKLR      LPBXRANVRGRXJ  
DMURYSWM        : NTSTBRBURFUUGKI CPVNALUACC      TIXGKGFDJHX     YSUILEYLROLVEAM KRGHLKWBVUKJHYV FPVDLSEHFMQMTW 
NOKPDEYXK       : TNDEQHHLITDYD   KGEE            SRFD            UCAGYEYO       
LTHUXEV         : TWFFSCU         HSODXH          XUVGH           KCWAVORNRMR     VXQYURDMPL     
QPYGUL          : XEBNULQFBK      NSXTGGR         KTJD            CHQNNJNDYCO     FEPAHNNVYLPXC  
NMXKABXOLPRRQP  : LDCLVVFDYYJ     CHRBT           DRWCEJTXAURSS   FKIPDDUSVJGBBFL
SEYAY           : NWYN            NMLWO          
FWKXMMGKXJXLHKN : LKDD            STEW            RFKKTPDECK      FHHETWNBOMMAFW  ACGHJNGVKUE    
KCWAVORNRMR     : KPRRTOVFFIFYC   LTHUXEV         LSYB            FMEMQBSS        PLGMAROKFFVBL  
MRPTODREPX      : NCENAQW         NURPMGL        
NJOBRYOCLSB     : NFUUFDWDQHPH    NMLWO          
QSFH            : VBADBQTAHRJ     YPUPPYUIITQNKFT SQGVT           TWDQJ           NMLWO          
RYGFSVYKYTQOR   : RXSUDHQGKXVIDU  WHASHFLQE      
FEXIXYAAKSEVMWE : CTKKVAMN        OYMK            EINUJ           WTIKSLTUCNA     GAMGKGTAM      
JVUPDQOD        : RWRELWMVGVTO    IQOONVGNBJBDY   EAMLKE          GYCUTHSAE       UMPRFXXEMGRAIJ  CCYTIRLIQADCAOX
PYTH            : EQEQCKNHTG      OKPYMESCLPW     VGNSJIWEMNCSQU 
DOWBWUCWXMSCKH  : MMPHIRUUS       AMYHPOVJYYYBGUB
OBMLXF          : PBDUNKYGIA      KUDFFGLBAAO     SAQVMBKNSSLUWU  NLVSUNCSWUPPNY  MKNOPOU        
OTTRLUNUOQJ     : QAHKXMIR        RKWQXJDTK       KALBTFCTOGBSTX  PWSKPUMCKTQETV  BOJCEL          IOWXBDTBENJNE   SFUPBMYMQKU     EGXDIVIDMFRBBIX
TJJVIHKDLVKO    : CPJE            VUUPCBLSBCOSLN  TNDEQHHLITDYD   OFCDTCGV       
NBXMGPD         : HTPLDW          ULSBABTASXSHKQ 
LXQHLLVFXHBHQAR : LQVB            ANYLRVBGX       KEIN           
KVLGIARWERLKH   : PYKJKHLPU       AHXDF           JEJMMAXTVVYCWS 
PTOGBBRWIRGJBA  : BBGK            SAVYMCKT        BOJCEL          JXRPGTS        
TCWR            : AIBOH           XNELPCQHVVEKO   NDXIR           RDBGALTSIUEXKFK
DAQWYW          : EEXAOURTOY      BGAS            IHRSUH          VXQYURDMPL     
KIYC            : AOMYJMLLJOEFP   XSCHIUQPTE     
SQGVT           : DYCEVWUNXGB     QSFH            WTKESX         
UEUEQVECR       : UUMHXWWQRJNQE   XSNMIWO         FVGM           
YJWFMQENPTYAVDA : ECDDUNULDS      GWHYP           IRFJPGVHQWRRJ   PCSLQSASCMHMR   WQNIAVYLP       QIQKCVCGDRLN    DJJDVTDW       
VGNSJIWEMNCSQU  : KPRRTOVFFIFYC   DEDIOSASJKMJ    PYTH           
RGYWSRCHI       : BXCMPVUCO       OLLFHODTTMVKQEJ
IKTNLLJTYCDJC   : LKGXWQOBX       APPVHFWD        HPKFCRQTTX      BHPX            PGVYMIGGY       PFWJKEWXOK      EQTTFC         
WPMPIJRBPTALNCU : EHGQVAWET       FEPAHNNVYLPXC  
DDJWS           : UIWJCSM         UJLAKSWE        MXCNHOYICOQISGX ILJTMHW         SMNFVOBLBPDK   
KCQLH           : VLQHMCRVPDU     JFMI            QQBSTIVRDREIKQR BHVBMJX        
VLGSBUKME       : SFUPBMYMQKU     YTWAQAVGLQ     
NWYN            : WFMOHU          CTYDHGOWVBWGW   SEYAY           KQKPMNMWMA      PWMMRQOARSVN    XRTYJAFEJQIXDSJ
OSDNVIYUBVGFMRO : BVKHRF          QUQXAQXSAFKN    JPLNNVJRAB      NHLDTU         
NASIEPTQ        : EJLRON          DKKEQEE         XLXYBRFQOJIPNOK IXQCKVIAXPJH    JPQF           
YETATCOMHEKPF   : PADTSPP         SGCTNTIBSQLL    BWQHNTCUMPJOWV  JPLNNVJRAB      IPAHMGYYNNLW   
SBOXQINCYPUJT   : AOMYJMLLJOEFP   RWRELWMVGVTO    TPXAXTVWU       GPYGSUWKYKYCV  
DKKEQEE         : PWAMWVQQOV      UCAGYEYO        XGPERMDLMQW     NASIEPTQ       
IVAP            : RNOFSC          JHQOKNKUF      
NHIVAJMXAWN     : FPBJA           UTWPVJTKO       ACYDXNLYIHAGW   BCULKCFBMIQVT  
VEAGAPL         : DELFEXDUIOHL    USVTVRB         AIBOH           WKYIKJNIVPKD    TWFFSCU         PTEGAOXB       
AQCGWPQSQGVGN   : XUVGH           CKOPVWPLESRC    VGJDU           TQEG            KDLCWCXESOUMLV  HJQGSRAWLRLXJT 
CNPOOSNEXKIASJ  : HOHICGTPOLVCMQ  CYKAXPB        
EWSWYCWRSPK     : MNBPVILPEY      XPFDG           SMIOXXTYBUFWXGN VOJTTEL        
NQPVSGMJWHWBH   : AGDQWP         
MJEXCJU         : OQHCGDWLSBQKEDM NEVIK           PFWOHQJN       
IVAFNUXA        : DEENUDRDA       TUBTN           TIHWASLYKHWNEIX
NQNKLVYWSIUVP   : DKKMBPI         FYHULNO         IMDSUGGNWMSLOH  CHYJQYMNFEFIW   GPJQWVQCN       CHQNNJNDYCO    
IBLGGWDEFCGNR   : YMIQPDXFDST     QICBVXICMBWUX   SLEC           
LSYB            : OYQQCEWIOTCW    MOVEDAJNR       KCWAVORNRMR     TBFKBDXPR      
OLVK            : NMHX            SWGILYQ         XQGBFCTDYEJVX   FNWOEXDTDHYNF  
SFUPBMYMQKU     : QAHKXMIR        OTTRLUNUOQJ     VLGSBUKME       QTUQGFYOGN      UTJUBCT         IATEDRDYLVUO   
JYBODHEUIR      : UTHFTMHXQDWN    FYFQYTLIVFV     MVAMJIPJNCTFVP 
JTXXHVI         : MFKQYF          XGXVXCCQWOBIQK  MCKRCSTSWJVPJL 
OPRHTHGIXSDU    : XREGRAGQ        WJOXNLA         NBCGUFIPOMA     JWFFCVDSVDJUYLA GWBNDTNSQ      
EVQHFXDPPQALQX  : SPJTKM          VVBJ            CEAXKL          FQPKVEVWEHWSL   XRTYJAFEJQIXDSJ
MJQEYKLU        : BPQUKTNRREXK    RDMINHELMFGWF   JXHWFAVSVLJLVA 
TDRMJMONK       : VFSHQAGSHUQ     KDFU            NOXEAIC         EIIQFG          XMRUGUNUISRW   
XPFDG           : DYCEVWUNXGB     QPRBSQURCDIQ    EWSWYCWRSPK     RBQR           
VGJNEFCNXGP     : DVBQIP          RDMFEDWTN       XEQFEOIBXJWLEL  HSTVTBILKSWUR  
TMDNQV          : UTWPVJTKO       LASMCKHBCNMB    STWLDOSB        AYVXLNPQMPWY    OJTR           
CKOPVWPLESRC    : AJWHRXWQPNHTUXX AQCGWPQSQGVGN   SWQHE          
AMFFRHUQQMCKA   : ECDDUNULDS      RFKKTPDECK      QWKHIWCWCEKXCRD AGDQWP          TGKHXHVCSRTYLRX ISRSEJBNWMJKAO  GNJJYKNGFQYKL  
YSDBUOQMKPDXT   : QQJW            UUMHXWWQRJNQE   FEFNGEDT        HIBUQQ         
QWNSLUADDV      : YASEAKLO        QICBVXICMBWUX   FTAYEYGRHNU     YTWAQAVGLQ      VRQTHU         
TIXGKGFDJHX     : DMURYSWM       
ALMRQLNOCKFWXAX : BSQERITOQ       GXMCCUAMD       MSMJAKEALIXBY  
FTAYEYGRHNU     : VPLEWD          QWNSLUADDV      VVHQQKRFADOJFLJ
WVTYJGQ         : LMTFUQWSWJKLEUF TTSOLEPRDLT    
RFQVR           : HODWKKAVM       ATFCVLWYKXCXKTA FPBFNFKFBGWO    VRQTHU         
VQYTU           : DYCEVWUNXGB     YUQQURMPCLAJE   XAHSIDMHASHMEU 
PUGVVONFC       : GSHSKPPKTVOCY   BDBWHELQBIIKJ   OISSIJRGHJKF   
YCHUBQDUQXC     : TPHANJJG        CCEAFOQOWTWQLLF WMAJMLIF       
VVGRMFLJ        : PWSKPUMCKTQETV  RVFHYVA        
BHPX            : SJEKJMGAOIR     IKTNLLJTYCDJC   PWMMRQOARSVN   
GNJJYKNGFQYKL   : CUUCSB          CENNDGBKYUIH    AMFFRHUQQMCKA  
IPAHMGYYNNLW    : ITNALVN         NMMFFSI         WWAM            QTIWCQNK        KTJD            YETATCOMHEKPF   YOUXVTNFI       DYBRSCBOFNBD   
SPOV            : EQEQCKNHTG     
FHHETWNBOMMAFW  : LKGXWQOBX       RSFJQFJLB       CJFUBS          FWKXMMGKXJXLHKN MVOWXTX        
FEFNGEDT        : OOCKDYIDI       YSDBUOQMKPDXT  
CKKR            : YYRTB           RKDUSSQULAGAKYC HFKFOIOGW      
JQHQANN         : USVTVRB         UNCJM           BDMODTBKEYBUPY 
BOMQBOVBHDF     : QWKHIWCWCEKXCRD PRMWWDBHHTSQY  
SLTVHLX         : JSLMTGIQVEARPP 
YSUILEYLROLVEAM : MITMG           BVPDGOKY        OLBJDKQGD       FBJNLX          DMURYSWM        HIBUQQ         
RIIBLQQGEMC     : WGLYJEPNWAHLR   TFLEKSJOJDKWWR  IQOONVGNBJBDY   NFUUFDWDQHPH    BONBLRHDUIRSDGF
AAHYU           : HYPA            YDWSNF          QQEDR           CEAXKL         
HGGJUAXIVC      : IKCGFQSXIYMQG   SPJTKM          HPKFCRQTTX     
IMDSUGGNWMSLOH  : WGYSBYVYBNH     HDQWUAJEO       NBBQEMATYYMRXB  NQNKLVYWSIUVP   CYKAXPB         HSTVTBILKSWUR  
ROLOQ           : VGMGHSTNUUXHA   MIEWXREGUHLBNMI
XYFS            : TKKBXOOVYBVFYEF BBVJXGLN        KQKPMNMWMA      CHYJQYMNFEFIW   POHGWV          EDMCUIBEIG     
FDXIOI          : KMIILJVV        YPUPPYUIITQNKFT KCCJTJPIYH      NCXUX          
TCRBKIA         : LTMXWIOQL       TPOGRMVSN       FANS            WEGYUGEKCJYW   
BMOKYIYMARIXSPS : RPKYDU          DQQEOLSBBE      CSTDITVWBOKTTR  JPHF           
VVRGLDDHH       : QGWKBYWJGCNIX   XQGBFCTDYEJVX   MBDYEW          EAERQFJOYMPWS  
IRFJPGVHQWRRJ   : KWJIQVFJHG      YJWFMQENPTYAVDA PCSLQSASCMHMR  
JSPCIIYGFSMSVPA : XAHSIDMHASHMEU 
NLVSUNCSWUPPNY  : UNCJM           DSJAN           EAMLKE          OBMLXF         
YTXEFIDLPVBIS   : FLFAE           PVRKFLKL       
LXEWVARMEMJY    : KUDFFGLBAAO     SORYJNUXCXHUU   RTNRRWQO       
BODJOXJSFRXS    : IKCGFQSXIYMQG   UTWPVJTKO       VGMGHSTNUUXHA   TWDQJ           QOCTJLYKXDUQSVI
TTSOLEPRDLT     : GRLAJGHN        KQNLJIEXFBSAUV  WVTYJGQ        
AXJKXLLMPWDPGX  : NXYVOWFBW       NYQQPB          AWUQTJRFBE      WSKDGPBE       
BVNLSI          : QBVG            CBLF            FRGAEEIFB       NFDPP           LOYLNOTIPSDE    ENWERBBESD     
JVLBNQPIO       : TPXAXTVWU       BOJCEL         
IXCGMOVE        : PWAMWVQQOV      XORJPDFHV       XGPERMDLMQW     DIJALNLDQLVRYT  NSWH            PCXGSEXFATVFLPU UCJANIRSE      
YTWAQAVGLQ      : NSBCNGQEQUNVUYQ EGKHMFACWNM     NYQQPB          VLGSBUKME       QWNSLUADDV      CEAXKL         
RDMFEDWTN       : HPKFCRQTTX      NYGJLBLM        VGJNEFCNXGP    
KVLMDAD         : GGRRJKCMY       ITVCLGFQU       LAVCQSFUM       QIQKCVCGDRLN    RTNRRWQO       
ETAXQCQQY       : DIAORFAYGIGSKLY WYQS           
EROVUCCCFY      : BCULKCFBMIQVT  
SMIOXXTYBUFWXGN : NEDAOHMOB       TPHANJJG        EWSWYCWRSPK     XFWPD           LUSBXONLGIBW   
WGBUKVMHSOLUVK  : XQGBFCTDYEJVX   OSGG            AEGAOF          EAERQFJOYMPWS  
OWCFWACXEYEBWK  : VUUPCBLSBCOSLN  QQCLN           YYISWXTMDMETWWG IATEDRDYLVUO   
AHXDF           : JSLMTGIQVEARPP  MJNBOEYPAPMFQL  KVLGIARWERLKH   EDVHAXBDPVVR   
YRSUIEPEQLUPOAM : HTJCUCBNEG      MCAQUXEP        HHNXEMJYSLFR    HTPLDW          PJKVCWHB        FMCDJH         
ENWERBBESD      : CETYPHJ         HPKFCRQTTX      BVNLSI         
SHSEIMYDWFVBV   : ACYDXNLYIHAGW   EWPDYTPYW       VJWEASBNF       KGYHF           YUHCEXRUKFXJHNL
XLXYBRFQOJIPNOK : NXCTKL          NASIEPTQ        CYKAXPB        
CEAXKL          : GLKTOFIK        EVQHFXDPPQALQX  AAHYU           YTWAQAVGLQ      BONBLRHDUIRSDGF CRHNWAYWQDH    
KQKPMNMWMA      : YCFCSMRTHLGOOC  NWYN            XYFS            WLEBFHWTB       PTEGAOXB        NPLURRJHEYEJI  
NDOSTGDE        : DIJALNLDQLVRYT  YCLMPC          TLKPMMVOISD     MLLF           
QSJJXNKXAVKKMWB : UCJJGLBDLFUOI   KJJVGBH         QPYVQFOP        DPPXQEJUIUVXVOO MMPHIRUUS       NPLURRJHEYEJI  
LPBXRANVRGRXJ   : RKWQXJDTK       HXMSTWF         NBCGUFIPOMA     MSPPJYNHDXXSJ   HPKFCRQTTX      IGHCWANLRL      HFKFOIOGW       FPVDLSEHFMQMTW 
XCTHMRWWPX      : IPVRFCHDHEJT    BOJCEL          DNXBB          
DIJALNLDQLVRYT  : IXCGMOVE        NDOSTGDE        YUCONHIPAPG    
ILJTMHW         : AIFJQAYMXO      RHVTUSABKPFM    DDJWS           MCKRCSTSWJVPJL 
RLBOKRMFWXQWL   : RSFJQFJLB       KEXSDBXXVWXUJI 
LPVWLP          : IEXOLYMILCKLGK  KOFMJUGDC      
HBHUMBIUAPOLQ   : QMPLILA         LBUNULHOJIJ    
VKSD            : WVPYTHXQOY      MAJTUNFFVTI     GTGOILX         JHQOKNKUF       MUPJXQQFUU      DIKXGHPBPU     
SUHECSVAPJQQ    : UIWJCSM         HDAUVIRLP       IQBDVPQ         TXMHCWECOSOFXM 
TXMHCWECOSOFXM  : YAPCTTTDLM      GXMCCUAMD       SUHECSVAPJQQ    MHKKTSYJW       KLPB           
QQCLN           : TKKBXOOVYBVFYEF WEPUXVDRQD      JRFDFRKQUWI     OWCFWACXEYEBWK  IVWY            STSDKXLLYPJ    
QPCMRUYKN       : EHGQVAWET       LASMCKHBCNMB    YWYICCIWEGKQSP  DPPXQEJUIUVXVOO
FMEMQBSS        : FLFAE           KCWAVORNRMR     CKUXEXWXDCTVC  
LJXJYSDRUOFHHWL : ABSW            UTJUBCT         RAVNMLVRWOITKI 
OIVAWLHLSVCT    : FVFLC           AEGAOF          JEJMMAXTVVYCWS 
WMAJMLIF        : KTJD            YCHUBQDUQXC     GWBNDTNSQ       PCXGSEXFATVFLPU
ACGHJNGVKUE     : RHVTUSABKPFM    QQOWABQLOMXUN   FWKXMMGKXJXLHKN
WDWG            : EUVIAB          WLEBFHWTB       CCYTIRLIQADCAOX
PCSLQSASCMHMR   : RNOFSC          YJWFMQENPTYAVDA IRFJPGVHQWRRJ  
OUEVEU          : KQNLJIEXFBSAUV  RRCJLON         XFWPD          
CHYJQYMNFEFIW   : BPQUKTNRREXK    XSWQPBUVDAKURJQ NQNKLVYWSIUVP   XYFS            FNWOEXDTDHYNF  
BPRUTE          : NERWCEFVRF     
GYCUTHSAE       : UNCJM           ARJQDJF         JVUPDQOD       
FNWOEXDTDHYNF   : ANYLRVBGX       CBLDXTKJL       OLVK            CHYJQYMNFEFIW   UCJANIRSE      
PWMMRQOARSVN    : LQVB            NWYN            BHPX           
QQGOVUNMBLPXQXY : LYEMKMLDCC      IOWXBDTBENJNE   CCQXB           VQOLSPT        
DRWCEJTXAURSS   : SSELDPDUFQMOYFJ NMXKABXOLPRRQP 
VJWEASBNF       : EJLRON          SHSEIMYDWFVBV   TQEG           
BUDUUCCAWBDDKYD : GJIOJHANAU      VGBTXVIYWUNNQXJ
VVHQ            : EQEQCKNHTG      BFJBJVYHGQ     
FBBMDVNTDSW     : BVKHRF          LKMTBEGBUSSU    SVWCJIJNEBIPNO  QNMUTEHUYKTMIUG PXHUWLCPOH     
XRVDVVA         : WTKESX          YUHCEXRUKFXJHNL DIKXGHPBPU     
BFJBJVYHGQ      : KFLDJOTDVJOQMRU VVHQ            OSGG            FPBFNFKFBGWO    FKIPDDUSVJGBBFL
LTMXWIOQL       : DIAORFAYGIGSKLY TCRBKIA         HVEKNJX        
QLIIJLFINEJSO   : IPOPUWWVC       PXBPXVFWEIKIUP  YGTXUTJWEPTHK  
EMMLSDWHWJHV    : IRXWAP          LKMTBEGBUSSU    PXUTBNXQNUPO   
VPHGGVOOFAV     : OQHCGDWLSBQKEDM PVRKFLKL        BVPDGOKY        HNSWAFFFAPYROO 
NDXIR           : TCWR            GPJQWVQCN      
NEYBACBHB       : OYQQCEWIOTCW    TMCRPLBN       
OXHNNOTTKIKSK   : DYNWXT          MQCTDUYOAIO     JIPFANGTNXNOWQ 
GAMGKGTAM       : YGTXUTJWEPTHK   FEXIXYAAKSEVMWE
COVDVWPNW       : MITMG           XVNEWPRX        TQEG           
DKOWGBHTTRFBTTJ : IPOPUWWVC       YASEAKLO        SJDLRPBL        KOFMJUGDC       GEBMR          
ADFO            : ANHHSPTVP       TMCRPLBN        VIHAEEALET      CFGEBFUKK      
JEUMC           : WEPEEAEWRYPY    NMARSXUSCXLXYSP JBOROJGKEKA     AHWOMQFE       
ERREUES         : SYVRBEKI        FLMDXTPOFHK     TPHANJJG        EQEQCKNHTG      GQYFDICBN       EJNBPSBBDACTVVB
LVBFQUMTOG      : CSTDITVWBOKTTR  NKMOQBG         NXOMGKK         HODWKKAVM       VVHQQKRFADOJFLJ
VGJDU           : WFMOHU          AQCGWPQSQGVGN   TAWAJRSTBUEDDN 
MBDYEW          : KPEVFVJDSX      XNELPCQHVVEKO   VVRGLDDHH       EDMCUIBEIG     
VOJTTEL         : GHKUT           YACAMVKLM       NJGCVPUIMG      EWSWYCWRSPK     NSWH           
BPOTKBNAHSXPE   : BMHUVPIYT       GPXDOJADMFSONK 
MKNOPOU         : YAPCTTTDLM      PLEMPJQW        OBMLXF         
TQEG            : LDFGWMOS        GPYGSUWKYKYCV   MIRRUHH         APPVHFWD        AQCGWPQSQGVGN   VJWEASBNF       COVDVWPNW       OSHUTYPEGOP    
AMYHPOVJYYYBGUB : XQJGCQU         YIBGIURPHND     GWHYP           EXODC           DOWBWUCWXMSCKH  VGBTXVIYWUNNQXJ
YCLMPC          : EPETD           NDOSTGDE        MTYDJHFGIQXHA   WYQS            EGXDIVIDMFRBBIX SMNFVOBLBPDK   
GWRD            : YYRTB           EJCDOSAYED      BDMODTBKEYBUPY  WATQJUFAQJDSUSN VRRSBNLMBUS    
WLBWXCHOS       : HXMSTWF         QTIWCQNK       
ATFCVLWYKXCXKTA : XRQSSFFMTDJU    FEQSSVMWP       OLBJDKQGD       RFQVR           YNSSIENKTPUO    GPLGVVFEYRLSUM 
BWHGMG          : KREC            CEGVIRNEA       NWLODTOR       
PGRRNGMSJHXN    : TJHATBCRJVS     HYVILLHNJD      HJQGSRAWLRLXJT 
KMEWKGWXD       : GSHSKPPKTVOCY   HODWKKAVM       VBIPNYM         VGBTXVIYWUNNQXJ SWQHE          
PGVYMIGGY       : NMHX            FEQSSVMWP       OKDIORWEPWHPR   NBBQEMATYYMRXB  IKTNLLJTYCDJC   YNSSIENKTPUO   
XSCHIUQPTE      : KIYC            YRLK            TBFKBDXPR      
GQYFDICBN       : CFEIDFQN        USVTVRB         DPPXQEJUIUVXVOO UCNAFMVBAFOVFY  ERREUES         YBBSEEVEHSA    
QTUQGFYOGN      : KALBTFCTOGBSTX  OIVDJIXGNJXSGA  SFUPBMYMQKU     YUHCEXRUKFXJHNL LUSBXONLGIBW   
CPTKKMAESW      : CUMOHKH         AKIXXPSOVRWPQF  GJIOJHANAU      LAVCQSFUM       XMBNXEGWKTMK    DYFJUYLCLO     
JXRPGTS         : FRGAEEIFB       YACAMVKLM       RHVTUSABKPFM    GSPIQGPGATBPJ   OIVDJIXGNJXSGA  PTOGBBRWIRGJBA  VRQTHU         
UMPRFXXEMGRAIJ  : EAMLKE          PHPHAW          JVUPDQOD       
UTJUBCT         : DEENUDRDA       QONWGISBAQIW    SFUPBMYMQKU     LJXJYSDRUOFHHWL WRQDGV         
OSGG            : KEIN            WGBUKVMHSOLUVK  BFJBJVYHGQ     
AYVXLNPQMPWY    : OLFFFMNSJXKGBA  NYGJLBLM        TMDNQV          NWLODTOR        KRGHLKWBVUKJHYV
QBHAXDUJXVLSLCN : WEGYUGEKCJYW   
IOUIK           : FPBFNFKFBGWO   
VBIPNYM         : ITNALVN         KMEWKGWXD      
XEQFEOIBXJWLEL  : BBGK            VGJNEFCNXGP     BNER            FQQPTWYBIT     
RDBGALTSIUEXKFK : XJSHDEVTLMB     OLLFHODTTMVKQEJ TCWR            EDVHAXBDPVVR   
FQPKVEVWEHWSL   : IKCGFQSXIYMQG   EVQHFXDPPQALQX 
LFNMNOYJJ       : XRQSSFFMTDJU    RQQKFTHQDDNQS   OLOII           XSBSSFXLTQR    
GPJQWVQCN       : PWNGHDC         XEBNULQFBK      GSPIQGPGATBPJ   NQNKLVYWSIUVP   NDXIR          
NJNLITSHOGRANGP : MAJTUNFFVTI    
WQNIAVYLP       : OFCDTCGV        GBNCLDWQ        OOXHCXVC        UIXS            YJWFMQENPTYAVDA
HIBUQQ          : EFHPJMQNV       YSDBUOQMKPDXT   YSUILEYLROLVEAM
GCRBWYRDRUQ     : MASQS           GJIOJHANAU     
MTYDJHFGIQXHA   : ANYLRVBGX       EOMM            MVAMJIPJNCTFVP  YCLMPC          VIHAEEALET     
IVWY            : DELFEXDUIOHL    MAJTUNFFVTI     EOMM            FGRQNUP         MFKQYF          QQCLN          
EDVHAXBDPVVR    : TJHATBCRJVS     MASQS           AJWHRXWQPNHTUXX UFONIJIOHVI     IOWXBDTBENJNE   AHXDF           RDBGALTSIUEXKFK PYWBDNVWVANU   
RQNEXUKH        : CPJE            YACAMVKLM       YCFCSMRTHLGOOC  KTJD           
KQOQBMNAQ       : MPAIW           EFHPJMQNV       FHBSLXOWFP      GULJJ           YUHCEXRUKFXJHNL BDBWHELQBIIKJ  
FPBFNFKFBGWO    : YMIQPDXFDST     UXRYNJNMOAVUFK  RFQVR           BFJBJVYHGQ      IOUIK          
NCENAQW         : PATKKTVNOJOWO   MRPTODREPX      TMUIUCFQURAHE   FQQPTWYBIT     
BNER            : GAOY            MJNBOEYPAPMFQL  NAVIO           QQBSTIVRDREIKQR XEQFEOIBXJWLEL 
QIQKCVCGDRLN    : NCXUX           JGJIG           YJWFMQENPTYAVDA KVLMDAD        
OTVDUL          : GIHXTJC         QQEDR           ULSBABTASXSHKQ  NMMFFSI         COROYDJHEFOBJ   WTKESX          HJQGSRAWLRLXJT 
YYISWXTMDMETWWG : HISGCW          OWCFWACXEYEBWK 
TIHWASLYKHWNEIX : ANYLRVBGX       NQPVJVNRYH      UFONIJIOHVI     IVAFNUXA       
KGYHF           : FVFLC           SHSEIMYDWFVBV   UYWRCDAPGATHWRU
VIHAEEALET      : KMIILJVV        KQLTKRDVULGJ    ADFO            MTYDJHFGIQXHA  
NSWH            : NQPVJVNRYH      OHTMERS         WGRETRKLXDYDOLV IXCGMOVE        VOJTTEL         VXQYURDMPL      ICCBQ           CCYTIRLIQADCAOX
VRQTHU          : QWNSLUADDV      RFQVR           JXRPGTS        
GBOOCXVV        : OYQQCEWIOTCW    TLVSVC          MHKKTSYJW      
EDWL            : SJOWJUTEQYGHVQ  SVWCJIJNEBIPNO  XSNMIWO         SKYKFPVNABXDILS TGSJUCS         EORN           
WYQS            : AVXRMKSRFOIH    WGYSBYVYBNH     DPPXQEJUIUVXVOO ETAXQCQQY       YCLMPC          MQCTDUYOAIO    
EORN            : WEPEEAEWRYPY    HHNXEMJYSLFR    ITVCLGFQU       MOVEDAJNR       GJIOJHANAU      EDWL            OFIXYBVOQQEUBX  HSTVTBILKSWUR  
QFNK            : BTWCQVLTCVQWLX  GRMEBDPNXUKQ    EJNBPSBBDACTVVB
JQXMGM          : BOJCEL          XBDXMOY         HTDUJOTAWXBCHV 
EJNBPSBBDACTVVB : JLGPGL          BOJCEL          EINUJ           ERREUES         QFNK            YBBSEEVEHSA    
POHGWV          : FVFLC           ITVCLGFQU       QSWI            NCXUX           XYFS           
MHKKTSYJW       : LKMTBEGBUSSU    NOQDQO          TXMHCWECOSOFXM  GBOOCXVV       
YBBSEEVEHSA     : BAUIVNBUX       QGWKBYWJGCNIX   GQYFDICBN       EJNBPSBBDACTVVB
TMUIUCFQURAHE   : HOHICGTPOLVCMQ  NSXTGGR         NCENAQW        
AEGAOF          : PWNGHDC         NFDPP           KTJD            SJPD            WGBUKVMHSOLUVK  OIVAWLHLSVCT   
PXHUWLCPOH      : WGLYJEPNWAHLR   STWLDOSB        TGSJUCS         UCAGYEYO        FBBMDVNTDSW     MLLF            LGCOXCQOVY     
BERVGXOER       : FTNRKDWT        NURPMGL        
NWLODTOR        : CSTDITVWBOKTTR  TYCIDWKONIIGEHU BWHGMG          AYVXLNPQMPWY   
RIAYFWMJOD      : GTGOILX        
XFWPD           : MIRRUHH         FWIIMFUN        SMIOXXTYBUFWXGN OUEVEU          GPXDOJADMFSONK 
PUMK            : BNFVGCCYLGGYVUL TMCRPLBN       
AHWOMQFE        : ESKNP           MASQS           JYRGPLVNMOL     JEUMC           MQCTDUYOAIO    
YOUXVTNFI       : WQMC            QVWJKNY         IPAHMGYYNNLW   
XGXVXCCQWOBIQK  : JTXXHVI         THJUVCPEHDQDTO 
GWBNDTNSQ       : UNDFXKELFV      OPRHTHGIXSDU    WMAJMLIF       
OKDWSUUYS       : YGQOSHXELE      BOJCEL          SBLQIUPGV      
AWUQTJRFBE      : MSSRLWVN        NJGCVPUIMG      IQMYKJAGSBIJDJ  AXJKXLLMPWDPGX  TGXWB          
JBQYENMYE       : LBUNULHOJIJ    
QPGNK           : KUYG            MIRRUHH         CJFUBS         
KKWC            : VRRSBNLMBUS     EYJUUIQX       
TWDQJ           : YYRTB           QSFH            BODJOXJSFRXS   
XMBNXEGWKTMK    : OUHYRMKV        FBJNLX          CPTKKMAESW     
PDQVSBXD        : MSSRLWVN        FNVTUSNE        AGDQWP         
WHASHFLQE       : FLFAE           WWAM            RYGFSVYKYTQOR   WTKESX         
FHYDLGCWAOJBEO  : KVQONVKR        WEGYUGEKCJYW    QUMLJ          
BHVBMJX         : QWKHIWCWCEKXCRD WCSUPKQTDUM     KCQLH          
MQCTDUYOAIO     : DIAORFAYGIGSKLY NYGJLBLM        OXHNNOTTKIKSK   WYQS            AHWOMQFE       
UUHTW           : AIFJQAYMXO      QAHKXMIR        LKGXWQOBX       UCNAFMVBAFOVFY 
DYBRSCBOFNBD    : TNDEQHHLITDYD   WOPHAJYFQBRA    XORJPDFHV       OBHYVPXPHF      IPAHMGYYNNLW   
PWOLAJMQLVFQ    : USVTVRB         YJHFUJR         WKYIKJNIVPKD    RFKKTPDECK      ICCBQ          
CYKAXPB         : CNPOOSNEXKIASJ  IMDSUGGNWMSLOH  XLXYBRFQOJIPNOK
HVEKNJX         : EINUJ           BFSNTWBTIA      LTMXWIOQL       GPLGVVFEYRLSUM 
PLGMAROKFFVBL   : AVXRMKSRFOIH    CBLF            QJUSNVUC        KCWAVORNRMR     DKSOUTAFJGFYMBN
TPOGRMVSN       : ANHHSPTVP       QONWGISBAQIW    NXCTKL          QETSE           TCRBKIA        
PRNDENT         : GAOY            CSUCYIRJ        OOXHCXVC       
YCGCTUOBCK      : MITMG           NERWCEFVRF      ESUPWVWDXEFC   
PCXGSEXFATVFLPU : SJEKJMGAOIR     IXCGMOVE        WMAJMLIF        HSTVTBILKSWUR   EAERQFJOYMPWS  
TLKPMMVOISD     : MBAAL           MXCNHOYICOQISGX NDOSTGDE       
VQOLSPT         : VPYL            FPRFCMIFWHRXFDN WIGGSWRG        QQGOVUNMBLPXQXY
TSTWMPEAIA      : EPETD           YUQQURMPCLAJE   CNBSAPQRAMU    
CNBSAPQRAMU     : OUHYRMKV        TSTWMPEAIA     
KNEXJTSVPN      : VDGRJU          OBYKMOUK       
MCKRCSTSWJVPJL  : GRMEBDPNXUKQ    JTXXHVI         ILJTMHW         WEFO           
DNXBB           : KMIILJVV        XCTHMRWWPX      OYGPUEDUL      
OFIXYBVOQQEUBX  : YWYICCIWEGKQSP  EORN            OBYKMOUK       
VRRSBNLMBUS     : GWRD            KKWC           
STSDKXLLYPJ     : UIWJCSM         EUVIAB          UCNAFMVBAFOVFY  QQCLN           YNXSVHCGMP     
IATEDRDYLVUO    : RNOFSC          HCCO            UYWTOYRWJ       NPQAL           SFUPBMYMQKU     OWCFWACXEYEBWK 
GENBWFV         : UCAGYEYO        QOCQCG          EYJUUIQX       
XBDXMOY         : VFSHQAGSHUQ     GITRBWTR        JQXMGM         
BONBLRHDUIRSDGF : PWSKPUMCKTQETV  UUMHXWWQRJNQE   ALOQJHU         SSELDPDUFQMOYFJ XWUN            RIIBLQQGEMC     CEAXKL          UBQKLE         
MSMJAKEALIXBY   : RLVTNGSUMF      OIVDJIXGNJXSGA  JGTSJVVE        ALMRQLNOCKFWXAX
FANS            : CPVNALUACC      XSBSSFXLTQR     FTQQQLOOUBJYF   TCRBKIA         RCLICAT        
YMLFITWBAFGJSBY : HKDHBQHPYSTJGB  DEENUDRDA      
DJJDVTDW        : YJWFMQENPTYAVDA
CEVS            : DELFEXDUIOHL    IKOMFYQQSGTE    WATQJUFAQJDSUSN
ARKLWUHVYH      : SPJTKM          NMHX            IQMYKJAGSBIJDJ  JMSBBCL        
HTULSY          : DELFEXDUIOHL   
CKUXEXWXDCTVC   : ABFQHYIFPOEAPFY FMEMQBSS        GYBFSRYAWKH    
POHNKQJ         : PATKKTVNOJOWO   SVWCJIJNEBIPNO  TMGVLXFJDRW    
YNSSIENKTPUO    : LKSKM           GRLAJGHN        TGSJUCS         ATFCVLWYKXCXKTA PGVYMIGGY      
COPCTRXPVTGLDV  : CPJE            VLQHMCRVPDU     TFKXSA          KTJD            CHRBT           XMRPUICVUN      SSSWBJPQN      
THJUVCPEHDQDTO  : LKSKM           XGXVXCCQWOBIQK  RBQR           
MQKCSFU         : BWIQFM          YCVPWNENRRPCVO  GPXDOJADMFSONK 
WSKDGPBE        : AOMYJMLLJOEFP   YASEAKLO        NYGJLBLM        AXJKXLLMPWDPGX  FINJYOIAP      
JPHF            : BTWCQVLTCVQWLX  PWAMWVQQOV      LAHJDACYY       ISRSEJBNWMJKAO  UCNAFMVBAFOVFY  BMOKYIYMARIXSPS
WLEBFHWTB       : SWGILYQ         RSFJQFJLB       IOWXBDTBENJNE   KQKPMNMWMA      WDWG            TAWAJRSTBUEDDN 
MLLF            : KCCJTJPIYH      IECWTENKTR      NDOSTGDE        PXHUWLCPOH     
IXQCKVIAXPJH    : CENNDGBKYUIH    IHMLTLLC        NASIEPTQ        OBYKMOUK       
QOCQCG          : IQBDVPQ         GENBWFV         FHGYLJYCQB     
JPQF            : NEDAOHMOB       YASEAKLO        BCWLLKUJ        JBRSJAJFSD      NASIEPTQ       
CRHNWAYWQDH     : LQAO            JBOROJGKEKA     CEAXKL          GPXDOJADMFSONK 
NHLDTU          : KWJIQVFJHG      OSDNVIYUBVGFMRO
KLPB            : RSPFT           NFDPP           TXMHCWECOSOFXM 
YUCONHIPAPG     : PKXNMW          QAOY            QPYVQFOP        DIJALNLDQLVRYT  NNLDAGWTS      
PFWJKEWXOK      : GAOY            OYEFDXIOUK      PYKJKHLPU       IKTNLLJTYCDJC  
IHRSUH          : DAQWYW         
KGTOVKWGCW      : VUUPCBLSBCOSLN  SHDH            NPLURRJHEYEJI  
IVNPUWACVYQIDY  : BVKHRF          HDQWUAJEO       UQXFWYIROKAXP   VBNV           
WTKESX          : HDAUVIRLP       PCPRHW          NESYNSNNPHOVRC  SQGVT           XRVDVVA         OTVDUL          WHASHFLQE      
NMLAJRCIPLHF    : FLFAE           PVRKFLKL        LPCTEGGOLRIJMY  AFGISR         
CFGEBFUKK       : TQICCI          AVXRMKSRFOIH    QUQXAQXSAFKN    ADFO            RAANSHMLS      
CHQNNJNDYCO     : OUHYRMKV        QPYGUL          NQNKLVYWSIUVP  
MIEWXREGUHLBNMI : ROLOQ           KEXSDBXXVWXUJI  RAANSHMLS      
YUHCEXRUKFXJHNL : UTHFTMHXQDWN    PXUTBNXQNUPO    SHSEIMYDWFVBV   XRVDVVA         QTUQGFYOGN      KQOQBMNAQ      
XRTYJAFEJQIXDSJ : KMIILJVV        TNLGORHMMVF     KCCJTJPIYH      XSBSSFXLTQR     NWYN            EVQHFXDPPQALQX 
OSHUTYPEGOP     : HISGCW          GQJXTVHI        TQEG           
EDMCUIBEIG      : TESDPN          CPJE            YAPCTTTDLM      XYFS            MBDYEW          OYGPUEDUL      
SWVSDOEKFWR     : ILTKXG          QONWGISBAQIW    JXHWFAVSVLJLVA 
SSSWBJPQN       : XSSBQHUOE       NKMOQBG         YRSESYNPYPF     COPCTRXPVTGLDV 
FQQPTWYBIT      : XREGRAGQ        KCCJTJPIYH      XEQFEOIBXJWLEL  NCENAQW        
GOFXSPDRHGLC    : HISGCW          RBQR           
KDLCWCXESOUMLV  : AQCGWPQSQGVGN   VGBTXVIYWUNNQXJ
WRQDGV          : YHJCDXTO        UTJUBCT        
BMHUVPIYT       : BPOTKBNAHSXPE   SMNFVOBLBPDK   
EGXDIVIDMFRBBIX : HYRLFKSN        WOPHAJYFQBRA    JXHWFAVSVLJLVA  OTTRLUNUOQJ     YCLMPC         
BDBWHELQBIIKJ   : RLVTNGSUMF      KQNLJIEXFBSAUV  EIIQFG          BFSNTWBTIA      PUGVVONFC       KQOQBMNAQ      
GPLGVVFEYRLSUM  : TMCRPLBN        ATFCVLWYKXCXKTA HVEKNJX        
UJEYKCIQNBR     : CFEIDFQN        EWPDYTPYW      
JEJMMAXTVVYCWS  : HDAUVIRLP       SBUKAKOPEIG     KVLGIARWERLKH   OIVAWLHLSVCT    UCJANIRSE      
QOCTJLYKXDUQSVI : OYEFDXIOUK      BODJOXJSFRXS   
GPBUCD          : RPKYDU          HDTOAQTPIYJXM   LPQUNPCEMUGBSL  RMIBREIYE      
VBRWDPSQ        : NXCTKL          GXMCCUAMD       NPLURRJHEYEJI  
JUCUGBGGGDWAA   : KSYAVIYDCWBVOQ  QUMLJ          
TGXWB           : QPRBSQURCDIQ    AWUQTJRFBE      OISSIJRGHJKF   
BWYCRXIHQBPCWR  : TQICCI          SJDLRPBL        GRMEBDPNXUKQ    OOXHCXVC        LQYPVTDAVETGXI 
FVGM            : SYXNIPPKX       OYEFDXIOUK      UEUEQVECR      
JJELRXT         : XWUN            JGJIG           JGTSJVVE        FINJYOIAP      
VXQYURDMPL      : HTJCUCBNEG      YIBGIURPHND     LTHUXEV         DAQWYW          NSWH            VGBTXVIYWUNNQXJ WRRHFFOSQUVJVMD
JNLLK           : XSSBQHUOE       XMRPUICVUN      JMSBBCL        
LPCTEGGOLRIJMY  : BWIQFM          NQPVJVNRYH      BIEJC           KXQRWO          NMLAJRCIPLHF   
KRGHLKWBVUKJHYV : KSYAVIYDCWBVOQ  DMURYSWM        AYVXLNPQMPWY   
MORHSXPH        : PJCHLPMKRCOLX   KGEE            HPBRIG          NCXUX          
HSTVTBILKSWUR   : CTYDHGOWVBWGW   EQEQCKNHTG      HSODXH          VGJNEFCNXGP     IMDSUGGNWMSLOH  EORN            PCXGSEXFATVFLPU
SMNFVOBLBPDK    : EJLRON          WEAVHKHDJ       DDJWS           YCLMPC          BMHUVPIYT       WEFO           
CASNKLJIHNT     : GAOY            XSSBQHUOE       UXBSV          
XMRUGUNUISRW    : GAOY            RPJW            YDSUCLMD        TDRMJMONK       GFNDACBWXMPRH  
FAMJLXN         : NTSTBRBURFUUGKI OIWSV          
TBAFLJPYDIYRD   : HHNXEMJYSLFR    QETSE           PXBPXVFWEIKIUP  RJFULM         
XAHSIDMHASHMEU  : EYQERQHTTSWRP   VQYTU           JSPCIIYGFSMSVPA EYJUUIQX       
RJFULM          : VBADBQTAHRJ     KYDLEM          MVAMJIPJNCTFVP  LPQUNPCEMUGBSL  TBAFLJPYDIYRD  
UCJANIRSE       : EPVBXDXL        NSBCNGQEQUNVUYQ NXCTKL          IXCGMOVE        FNWOEXDTDHYNF   JEJMMAXTVVYCWS 
SOLDRXKRQTGUP   : AIFJQAYMXO      KUYG            DRJFOISVXCY    
OBYKMOUK        : NMARSXUSCXLXYSP KNEXJTSVPN      OFIXYBVOQQEUBX  IXQCKVIAXPJH   
FKIPDDUSVJGBBFL : FEQSSVMWP       CJTQWCVD        NMXKABXOLPRRQP  BFJBJVYHGQ      VOJXDKLRCPDK   
VGBTXVIYWUNNQXJ : ECDDUNULDS      LKSKM           MJNBOEYPAPMFQL  BUDUUCCAWBDDKYD AMYHPOVJYYYBGUB KMEWKGWXD       KDLCWCXESOUMLV  VXQYURDMPL     
JRLMXIHVROXUTLR : IPVRFCHDHEJT    BCULKCFBMIQVT   YRVXHTOVBYGF   
RTNRRWQO        : AVXRMKSRFOIH    IRXWAP          IEXOLYMILCKLGK  RDAL            UYWTOYRWJ       LXEWVARMEMJY    KVLMDAD        
HFKFOIOGW       : XNELPCQHVVEKO   CKKR            LPBXRANVRGRXJ  
GFNDACBWXMPRH   : DRJFOISVXCY     EAMLKE          UNDFXKELFV      XMRUGUNUISRW   
GYBFSRYAWKH     : TXKAWCRUYX      CKUXEXWXDCTVC  
UYWRCDAPGATHWRU : KGYHF           RCLICAT        
KEXSDBXXVWXUJI  : WGLYJEPNWAHLR   HDQWUAJEO       QICBVXICMBWUX   RLBOKRMFWXQWL   MIEWXREGUHLBNMI
FHGYLJYCQB      : GULJJ           QOCQCG         
XYSUNDBO        : PRBOITAHM       OLFFFMNSJXKGBA  UNDFXKELFV      FMCDJH         
FPVDLSEHFMQMTW  : YJNY            VFSHQAGSHUQ     TNLGORHMMVF     YCVPWNENRRPCVO  DMURYSWM        LPBXRANVRGRXJ  
FINJYOIAP       : QMPLILA         NKYQRSDMAJXMX   WSKDGPBE        JJELRXT        
WEGYUGEKCJYW    : QXREPOJXEE      OLLFHODTTMVKQEJ JRPGAMVOSTRMJR  LODLB           BBVJXGLN        EXODC           TCRBKIA         QBHAXDUJXVLSLCN
WEGYUGEKCJYW    : FHYDLGCWAOJBEO 
ICCBQ           : XREGRAGQ        NSWH            PWOLAJMQLVFQ   
AFGISR          : LDFGWMOS        WCSUPKQTDUM     NMLAJRCIPLHF   
JCKAFHGNGBTMNV  : WQMC           
MVOWXTX         : PYKJKHLPU       JGJIG           FHHETWNBOMMAFW 
TAWAJRSTBUEDDN  : RSPFT           USVTVRB         VGJDU           WLEBFHWTB      
QUMLJ           : TNLGORHMMVF     UYWTOYRWJ       FHYDLGCWAOJBEO  JUCUGBGGGDWAA  
JIPFANGTNXNOWQ  : KYDLEM          ABFQHYIFPOEAPFY NPQAL           OXHNNOTTKIKSK  
OJTR            : PYKJKHLPU       JFCTVIWJ        AJWHRXWQPNHTUXX TMDNQV         
AVJN            : GGRRJKCMY       PDTYMERBQHLL   
DKSOUTAFJGFYMBN : BPQUKTNRREXK    BIVLAVLNUHGOY   KQLTKRDVULGJ    HIUIYRQFWOYBE   PLGMAROKFFVBL  
RCLICAT         : NERWCEFVRF      PYFTO           NBCGUFIPOMA     FANS            UYWRCDAPGATHWRU
RAVNMLVRWOITKI  : FOHIBIKJVQRGS   LJXJYSDRUOFHHWL
VOJXDKLRCPDK    : HYRLFKSN        ANBYRPT         UBOGVIKOK       FKIPDDUSVJGBBFL
FEPAHNNVYLPXC   : GTGOILX         CVCXVNETDJU     VVBJ            QPRBSQURCDIQ    QPYGUL          WPMPIJRBPTALNCU
TMGVLXFJDRW     : THAJCEBUBMPOGJ  CBLDXTKJL       POHNKQJ         HJQGSRAWLRLXJT 
UMBHEJOTJ       : VFSHQAGSHUQ    
HYVILLHNJD      : IEXOLYMILCKLGK  GQJXTVHI        RWRELWMVGVTO    PGRRNGMSJHXN   
RBQR            : IDXJCXLP        OOCKDYIDI       XPFDG           THJUVCPEHDQDTO  GOFXSPDRHGLC   
AVBYTXLWFRIVNR  : GGRRJKCMY       TMCRPLBN        LOYLNOTIPSDE   
WRRHFFOSQUVJVMD : QWKHIWCWCEKXCRD SAQVMBKNSSLUWU  VXQYURDMPL     
OYGPUEDUL       : RSPFT           GGEJD           DNXBB           EDMCUIBEIG     
DIKXGHPBPU      : MPAIW           UIXS            VKSD            XRVDVVA        
GPXDOJADMFSONK  : BPOTKBNAHSXPE   XFWPD           MQKCSFU         CRHNWAYWQDH    
ROGFJMPWKWGAX   : SFCKG           SVWCJIJNEBIPNO 
WEFO            : RKDUSSQULAGAKYC EEXAOURTOY      UXBSV           MCKRCSTSWJVPJL  SMNFVOBLBPDK   
IDPKHFPCVDMH    : KSYAVIYDCWBVOQ 
DODNBSMNPS      : THAVKXWUDLXAG   ABSW           
PRMWWDBHHTSQY   : NDUJHMQJP       BPIWBUMXVBETMQ  BOMQBOVBHDF    
SWQHE           : NMTMUUBO        KQLTKRDVULGJ    CKOPVWPLESRC    KMEWKGWXD       RAANSHMLS      
LUSBXONLGIBW    : YIAVYQY         YACAMVKLM       UTWPVJTKO       SMIOXXTYBUFWXGN QTUQGFYOGN     
PTYTWHBQCRROMQF : CEGVIRNEA       THAVKXWUDLXAG  
VVHQQKRFADOJFLJ : GWHYP           FYHULNO         OEICBFDCHCBVCV  NESYNSNNPHOVRC  FTAYEYGRHNU     LVBFQUMTOG     
HJQGSRAWLRLXJT  : HTPLDW          AQCGWPQSQGVGN   PGRRNGMSJHXN    OTVDUL          TMGVLXFJDRW    
HREAIRRQRXFBFS  : WVPYTHXQOY      TFKXSA          HNVHEOQRFWBGPP  YRVXHTOVBYGF    PVTEJ          
CCYTIRLIQADCAOX : OQHCGDWLSBQKEDM CVCXVNETDJU     SKYKFPVNABXDILS JVUPDQOD        WDWG            NSWH           
VPCXBTS         : EGKHMFACWNM     STEW            FTGWQV          WCOYPSQOWWUSQ   ABSW            UXRYNJNMOAVUFK 
LQYPVTDAVETGXI  : FYFQYTLIVFV     KWJIQVFJHG      BWYCRXIHQBPCWR 
OISSIJRGHJKF    : BCWLLKUJ        PUGVVONFC       TGXWB           EQTTFC         
EAERQFJOYMPWS   : QVWJKNY         HOMQUJEMHJ      VVRGLDDHH       WGBUKVMHSOLUVK  PCXGSEXFATVFLPU
EQTTFC          : HOMQUJEMHJ      IKTNLLJTYCDJC   OISSIJRGHJKF   
YNXSVHCGMP      : HTPLDW          XQGBFCTDYEJVX   BDKKQ           STSDKXLLYPJ    
PTEGAOXB        : VBADBQTAHRJ     LDCLVVFDYYJ     VEAGAPL         KQKPMNMWMA     
PYWBDNVWVANU    : HOHICGTPOLVCMQ  DYNWXT          EDVHAXBDPVVR   
NPLURRJHEYEJI   : JGJIG           KQKPMNMWMA      QSJJXNKXAVKKMWB KGTOVKWGCW      VBRWDPSQ       
AGHFV           : SPJTKM          HKDHBQHPYSTJGB  NDHEBSCQLDXGV  
EYJUUIQX        : DEDIOSASJKMJ    KKWC            GENBWFV         XAHSIDMHASHMEU 
NNLDAGWTS       : XSSBQHUOE       TLVSVC          EENPR           YUCONHIPAPG    
YRLK            : RPKYDU          IPOPUWWVC       CTKKVAMN        XSCHIUQPTE     
RMIBREIYE       : LQAO            KYDLEM          AITKUYDNRPSMXLR GPBUCD         
TBFKBDXPR       : YCFCSMRTHLGOOC  JFMI            LSYB            XSCHIUQPTE     
RAANSHMLS       : NMMFFSI         CFGEBFUKK       MIEWXREGUHLBNMI SWQHE          
NMLWO           : QBVG            YMIQPDXFDST     NBBQEMATYYMRXB  SEYAY           NJOBRYOCLSB     QSFH           
DYFJUYLCLO      : TESDPN          EWPDYTPYW       CPTKKMAESW      NURPMGL        
LGCOXCQOVY      : JQFVABLI        PXHUWLCPOH     
HTDUJOTAWXBCHV  : HMGLPGA         JQXMGM         
UBQKLE          : RPJW            MCAQUXEP        RGEHRFJ         WIGGSWRG        BONBLRHDUIRSDGF
NURPMGL         : BWKJUUMN        KLXUT           MRPTODREPX      BERVGXOER       DYFJUYLCLO     
