OHIWQR          : QQJKR           FYFQ            RXLHKABUQNMYLEL
STEOEBICO       : JUCIWRTJHACJFE  NBJPNFPNESKIWDW WSGBFNJIKVCKS  
ALPEEIDXS       : BCOVNYV         YLBAUXNYTG      BSVNFHTTMEGH    CNPYDLACNCYV    FETCQXVPURNYBJW
KLFPCOABFRWAMBO : SESDMQCV        BMHGHEQJBFDJ    FLTBNIMARV      UIIWR           INHDMKVMBPE     IBNCTTFCCF      NUTWDGTMYKVH    GTGLXGJJM      
KLFPCOABFRWAMBO : TXXAAU         
CXUSDUHUBLDHJXX : IXGEAB          ECNNXKPJAKUH    ECCUR           UIKFLDNHLYIRJ  
LFNQTN          : IHLXBYMI        XWICADRF        FWLRXTNABG     
BGQCURSNWSLRYI  : QTATIIWBDQITHH  AJMWX           MWTWQUWJNRV     VEMFI           VCETOCUTMGV    
TKKARVXR        : QHPPDWMJSIXHRSO JEHQHHJUCGFIAG  LJMLMBSEKMPDK   CDUYRGSJXA     
MWHDQVUTEOVYGR  : SKMQE           VHJUFAMHO       IUSSM          
FKAXJJWGVK      : SVDEWPYLNFDSGDW SMXQKICA        IEDETKBJJOCWY  
NIGHFSE         : OLFOGN          SJANMYEWACTR    AVASSFHJTYWER   OANPOBMRQ       SORWXGJXGXEM   
VWKTQ           : YNXLSRDWGEDRKS  BDEBOY          SITMVOVVIVUF    TMLPI          
IPPQHHW         : FTJHPK          GFGGSTCPWXEJFQ  NFPEGPKKIKTI    DOUUISFWVLH     QABSPSDCNTLI    VTIEOOUCLPOVHF  SSVOBNRO       
HWGSTMO         : HIND            WMYABK         
UERBL           : CYUD            FWAEKDBSDBMR    COVJBCDQ        NHOBSXQ         JULPHHC         TWNK           
URLSQWOINWA     : IULKFIE         ORWHEYLQQXWJNGA PQENJJMWTOUAUAX PQKEGYVNPK     
QHPPDWMJSIXHRSO : TKKARVXR        WQCOMGRTNKQKWHB
WAGRURMLQCVH    : UIIWR           EUQLBLPQYEAH    CHHALU         
VPTFFJLEVUWH    : LQTKXVHUWCI     URPTDKQXS       ROYC            KHJQTSDH        LHNGPYNIHF      SSDHHRTY       
HYQV            : DGBRIVHPLXBGE   SOXGT           SQJWNRJDQEAS   
NXQHSKUHCYDLCC  : FDPMKC          HNKMNWV         NBTLKPKQV       BVBJ            XEUKPOTOAKD     CIBPKNYCRSIQX   XHVYYF         
WHIISOFQMMOVLF  : SIYULNATOWW     GWQSTEPPJDC     KIWOAEC         BCQXMMHIN       UCLGRIRJGU      MJSLWX         
VTPMDLWASYBVM   : RIYEFEGHDYNOJG  AUYLTT          JMIFPFBQALF     WPBMVBFNBGQUI   WWRQBDFKYSQDIA 
APDIA           : FVLJJN          BQOPYJRLQVMGFVE PVAQJCPVFLOWQ   JDSRPEQ        
DPSVEFK         : BGUWEWDJ        IRCEOBJ         XQGYJQOVDUI     BNLMSQQPXHXD   
SSROOJB         : WGQMYTRWRHKATY  QJRIKLKLFIDMTHT IIVRULXXLX      DQDTDUUMG       KMMISBTGH      
UYSP            : XBRTKJXF        IBEKQWIJOENM   
TOPAOHDYIPDAIB  : XLTLNPNXRYBKM   AVJHOACB        ORSVWGLLLJLGIH 
QMELHXBVJENFF   : EVJCE           REFGEIRGPDSIAT 
WIDL            : QBEO            SSHP            CJBSV          
FBFJAPBF        : QKXEF           DTPSXOFJOAFP    PWOAVKOFUGQKUS 
LJTCX           : MVWAWKLC        HWYSIRWXVVUV    YKRXOTOWTFGE    EDPXYOOV       
OFARBK          : OPKAPVNR        AJBDIV          EUFPMP         
QREAOMFB        : YWUJVKG         NYJM            FLTBNIMARV      TKTNPHRFKUHV   
KERTGKWMAJVULT  : PDTYUS          NPBJY           IJUCOIDRUXV    
CBXTCISSCW      : DXPHNVEE        VPDEFNAKNR      JEHQHHJUCGFIAG  QJLCPQW         ADRRFJWUO       YQMXTHGVUOKSW   FHKMXYRVUQ     
QJAT            : UNNDCYXY        QOVGQREUXBIX    REKAUI          EJNBDBKB       
LAPHHAFVDQTXCP  : BVBJ            OWQDPEFLXGTM   
HQUBUFV         : FVVBJPF         IXMIHFMWER     
HSJBEJWCWXUFFWM : WEBGVJWOHQ      QQWNP           RMGQONFPKVUYWD 
ADWAHOXOFUSABQ  : UBUMDRBMCHUDY   MOMIG          
KKBLQNJVKJ      : CWHDPGMKMSLO    FIQPBVWITCWR    NHAQEWCABYR    
RQPG            : XCSCSULKX       RKSHDOH         UQOEQE          XSCNFEOSDDN     NNUQIBYQRKELQC 
SJQSTHSKMO      : YWUJVKG         LSEOG           QLICMLHIS      
ORWGCJIQAVCX    : BKGT            NYKFTB          WLTXEV         
LQBCJHVCT       : RIOR            YROUKJCNKWTMQU  VSLUWROLSYJD    AJYVVXXGNCLS   
WNVQAKHGBYDHD   : MMEGADO         TGRYVYFKRIPGAJU WMTXCGJA       
PTONVNWHGXL     : RJUWECOFSV      AOFSP          
HJVB            : TCNNW           TPGKVA          DKRTDCP         ILUX           
TQVMRIVAJ       : GWQSTEPPJDC     QOVEHVTWVP      POYADYRWECPW   
DRXRJUIXQX      : VUNLKVJUQ      
BFSO            : IBKDJPCHXHOCFC  XFJYU           HRWBXIXLEW      YXBXBH          YVCYPAN        
CYVEY           : SIPADDNFL       PYMNAWFFEY      GQWFBHFNGSVROV  YUBFUFBSI      
WXEQG           : FVIAA           SPTDYREFXP      YGTUNVNCMJEYB  
QQWVKWPTRY      : YDGBDE          DMGFMJ          TIXVH           IVUOIOSVA       SOUVOYSKRTMLCV 
LWMMCHBCKCA     : WHPNYCLFGEHJBYU BCQXMMHIN       SDTWJ          
CRNAVFGX        : IRRH            LHGAHLFXRM      XIUECPD         GRBCMQXCVML    
YWUJVKG         : QREAOMFB        SJQSTHSKMO      KHJQTSDH        CPXBRUUIDYFID   JBJUOVFPFBX    
JXCJ            : GKKRFYOQOIYKJV  BWAYELSH        JJWVY          
QLWTP           : CATTOWRG        GFRHQOKGGQWRCL  PIPQPXGAI       ARVW           
WRABJ           : SHKKI           QVUSESIHECIN    RTBTUYSIOAJMP   MOLQNKQUHTOQH   SDTWJ          
BHVJHVL         : WIJNHCVILNWKQRU JHKOCMHAJAEE   
SWDGDTREXB      : CFBJGKLBHQO     BKUERMYD       
OPOIHYH         : QERLGKS         MXHUHQGLNB      YDCIMCTFMNCKXN  SDHFWFLV       
BIJRLTNXBMJIF   : RFQCGAX         JUKFIBE         MEFXGAUWD       GRHKCFM        
NLMHEQFFKVWB    : TXVYE          
FAOFEYQVNKMLOY  : VMFTRCLB        MHSLIUBQEQUFQD 
WEFKSRTY        : CSYITX          VGHPVFHJ        NVODSKPDNHIXJEJ WEBGVJWOHQ      VVCW            KPAX           
BGUWEWDJ        : DPSVEFK         REWRJ           LCYPUOHVP       CTIJVMQVSRH     FETCQXVPURNYBJW
TQDTHCJUO       : WFUPEBVKUEKO    NTCIVKVNMIN    
JNTITBUOV       : XXBIGOSXVT      IDAYNVA         CPYFTRKRTWLL    RUGIXCHSWCXV   
NGPUEMBBRKCMD   : XXBIGOSXVT      YJJCKURL        LEXNIPQERVM    
GKKRFYOQOIYKJV  : JXCJ            DGBRIVHPLXBGE  
FKPOCMSQNVJ     : AGCBD           OWPN           
XXBIGOSXVT      : JNTITBUOV       NGPUEMBBRKCMD   XWBYCVNBCIN     HKWSTXUWOXE     IXGEAB          SGLHCMO        
PIUOVG          : RUASOLMB        XEEI            CTSFLLPHLYWEVDL
VOXNDDBXV       : BDJSHKIAVHJUF   GWSVVBNJ        LOMAYKVL        EWNI            ICPTHTRNDDFCAJD
THPTFSDLHXJGS   : SWHEDSOYDBO     OCXA           
VDSMYCAWQBL     : WXVOVOTTO       IQUNL           SSVOBNRO        RYOIY           HONFVTWQYYUDDHS
GMVCDRKSLROQE   : VYWHCU         
PNEKMCN         : VASQFYIPKB      TQUVNYBUDXFMY  
PNHRKAS         : RMLVFOXHNADVJTR RTCFBXPL        IPJFDEWF        IEUDDCUGGALTCM  DHMEYU         
VYMTEQLQLXICQ   : WNRAOVTJE       MAHXKTLNCKCLRKA GQWFBHFNGSVROV  CHHALU          AOVPE           NHAQEWCABYR    
BIDHSPKJWC      : ULQJGCQKCWJSWWI
FTJHPK          : IPPQHHW         OKKSBSKSA       MMNBSTRKVBL     UNGWG           NWROMGJEQMD    
QWAUPMLEMWGDJ   : VDVRHEACEJBVQ   CALDYRPHI       IDEGGXYNLMFSXGR OVQFAGDPSJXK    FUXYCSKGCBGD    OXHMX          
OMRHECQCEPJAC   : OBJTIIRVBRNEQN  UAIKGJAFC       BONIBKYRH       SKHJGRMHPHQBNI  XDUJJSX         AOVPE           EOWQUVWDJMIF   
PMWHLXECMS      : VWWM            ONXGM           RVAOEAETX      
YPOCYYQOQBSUT   : BXMET          
YMEYOXRDWYOUF   : XVQEWPKXRSRG    ORWMACXDRH      GQWFBHFNGSVROV  SVIFRJJQTYD     WUPB            HATPDGUOVC     
HXBINSLNREEK    : JIRCGCYNAQS     PFVT            WEBGVJWOHQ      CLRQBJU         LLJOWLYMWEFRC  
WFCUGOBHFYYIW   : JKTUV           HHYY            LIBOETCNTXTDERQ CNPYDLACNCYV   
WTGQEERMSKAIEHM : ERQCMPMQSFI     DOOK            COFTXMVIHLQ    
OLVSGCJKM       : DYXHCEC         KNQSKYIOOCDBDRO VCGWMAGNXHV     AXIGU          
LLWKMUHUNLYHA   : KGOASCHGUHU     LADRCSFY        WSGBFNJIKVCKS   JUTHKCDIIO     
UDCYKQQBD       : JOLKVRDXTHRX    LJDRF           RVDRCHMDOWEVNO  XQGYJQOVDUI     WMYABK         
ULTGVGVIT       : DTPSXOFJOAFP    DMSLFFULC       SKYVCRQVBPJG    CTNNYDFMPP      GMDQD           CDTFXB         
SIPADDNFL       : CYVEY           MEXDRMBXDTTDIP  GKKJKYXUJOEDC  
YGTCHGSAJXPGKJ  : XWTV            SEGAA           PEEHHDRKMGGT    SORWXGJXGXEM   
GRJQLEMUUOXAFD  : UNGWG           YWYWGTENW      
VDVRHEACEJBVQ   : QWAUPMLEMWGDJ   LRDWHA          BJFLLCO         BGKY           
HEVYPNLTCIOQG   : CLDQWYPVARN     AVGVVWGCAUQ     EMLSNWR         UNGWG          
VMFTRCLB        : FAOFEYQVNKMLOY  JDSRPEQ        
LDMXGLOTS       : RKFXSYN         AFILY           OFNQMBVAT      
QUKGGGIQV       : SEGNWDGRPOAWWQU ALBFGQCYCQEWJQ  HIND            VSUHBXSF       
YNXLSRDWGEDRKS  : VWKTQ           CLFBACWATQD     BVVTJC          LQQRODQB        FYWT            GXNASQ         
SEGNWDGRPOAWWQU : QUKGGGIQV       VMRONNEDDPXXEE  DYIAGOVHIEMHNMU
QKXEF           : FBFJAPBF        RJUWECOFSV      JVYGYNBRU       MEFXGAUWD       HOODFGOS        FBDLJLNCCSUHH  
KDYQIQDBJW      : RVVROQJWHDTSEW  COVJBCDQ        SVDEWPYLNFDSGDW EJNBDBKB       
RKFXSYN         : LDMXGLOTS       BQOQC           YGTUNVNCMJEYB   JHAQGG          VUNLKVJUQ       BTPULPSMN      
CMGUHGNTHS      : IHLXBYMI        NHULXGMLXFLEFSX SQRKXDJXHPN     HUXVRYXDXNORJYG DLJAETXF        TAXJJIA         NWLFBIQYU      
AFFYVNPAPBWWVJ  : LBNHSVAB        GLMMHVX        
TEGJLIWTDGCTB   : DKXJRQXVSNOLRD  EVTXURMRYYRRHRC JGGK            KNYQLRYNGKU     MHSLIUBQEQUFQD 
OBJTIIRVBRNEQN  : OMRHECQCEPJAC   OFTNG           PCTQPAPRPYOMWS  YENOKRUMFKISNRR
CRVGAGTIDPOJSI  : IXMIHFMWER      PBCON           FHKMXYRVUQ     
EWNOSVYKUCFIH   : BXMET           NNMNPAJVXCQTG   FWLRXTNABG      IIVRULXXLX      FPUDWMMHT       RXLHKABUQNMYLEL
VJYQGH          : RBHLQJNCWKJ    
MCCPRQBMB       : RYGS            DQLWU           UAOPENEPVAGX    OCMILMRTVMWCILI
RAEGU           : YVMTHMAQGXKBJI  BCSXHDNSTQCT    HSSY            NFYADIY        
HFXKKGTJ        : CMKIRKWSKLYEY   JGSBHXVB        RONCRQWWS       JQMNMVER        DKRTDCP        
DKXJRQXVSNOLRD  : TEGJLIWTDGCTB   XLTLNPNXRYBKM  
GUOKDJNLRLXCURL : GFQF            DXBU           
WXAHQQFMK       : SKTKFMJR        IRMW           
DXPHNVEE        : CBXTCISSCW      HUXYFEK         FCYBHH          KINLA          
IQYVIKVMHPBJMY  : EEJJYCBQDGKTVKV XKUDR           PFYBQNX        
VPDEFNAKNR      : CBXTCISSCW      FVIAA           NHOBSXQ         QUDRTITQYPPYA  
BPYGXHWWF       : DJLN            DADWDGAKCGMD    ISTUHN          TUHRDOKMABIY    NPBJY           AEEOQF          MBNDS           BHLXMKEWGIMNE  
KDTRSUEFUPC     : DADWDGAKCGMD    DNKHWBWJR       JTBGKKAFC       LTJDDQG         VQYNOYUE        HIXXJ          
SGRIID          : YNBBEMUGDG      MVGQSTYOTKACH   CDBMMNOKLX      NHAQEWCABYR    
AWXRVE          : KJQRGY          RXTPPYALHOA     XJPFWWC         LARCDNPNEMGRUI 
FDPMKC          : NXQHSKUHCYDLCC  WWIIYMUSHLOKW   HOBGSJKCPUPSC   ECHMSAVKWBRKLFV FYDVGMKSTK      CHHALU          NWLFBIQYU      
FVIAA           : WXEQG           VPDEFNAKNR      LJYFPU          UNROD           AVYYVAG         DMWSCBF        
WQSKLYEUJJRLJR  : CMKIRKWSKLYEY   HANWVDGCKY      SXOKRLTVNIOE    JQMNMVER        UNPDCSFKGTBQFY  OHFK           
HWUN            : XQGYJQOVDUI     ADRRFJWUO       WWGKJONLISURGCW MLHTJA          JHOHEQRGCRWQVX  FIQPBVWITCWR   
KCNOU           : RVGICQLS        YXBXBH          QOVGQREUXBIX    AVVOGCECLNT     JAYJXAUCRVH    
NDUPTSIODUP     : BSIMKMEKYQAABO  HUBDHSWIIIQWDA 
PYTJKFB         : GRJN            OXPDDW          VSHYVRUPRQABDXX
MAJCDVFQ        : BGOPKNNUQXNRY   VYWHCU          SBFXYVPSNAI     CDHDJLTWJGOUHBS WQHEPW          IUUIXOMWVSNFF  
ALBFGQCYCQEWJQ  : QUKGGGIQV       EUQLBLPQYEAH    JJICYCRIUE      JPAB           
IKXVRBLECWHHTO  : AEEOQF          IMPMGMY        
JOLKVRDXTHRX    : UDCYKQQBD       YNBBEMUGDG      FGGEAQBTLC      PTHNQRMCROLCA  
BOULB           : XKALEFAI        UPEPTQWC        TIXVH          
JSWVABSHIOVIXM  : WEBGVJWOHQ      LAYIUFP         YFMLWBIV        UNNDCYXY       
KKPQLJAD        : BSYANKS         HHYY            CCWVJGBNXNEC   
FGBCTDXGXWCAXW  : NQOADUD         XHVYYF         
IOHSOTOCH       : ORSVWGLLLJLGIH  BTJHAPPAPFNCMJ  NFYADIY        
USQUVB          : RUNPL           WXAAXJSLLWACJCT LKEYEQGAFRAX   
ECFAHDGIAKIAIUK : EVTXURMRYYRRHRC EESQUAJBGYL     MBNDS           AXIGU          
CDNWTPE         : BVBJ            LWAS            YPHMMQIOPUBGH   KRTXIO          QRQSLMTLELNJCFI
MYSIUTKBYPB     : UTKIAGEQPMFCBO  MVGQSTYOTKACH   RAJJ            SITMVOVVIVUF   
UKSWUEWFYJEB    : BEQRBYPQIWJYXQ  BGOPKNNUQXNRY   XJIAJSK        
UAIKGJAFC       : OMRHECQCEPJAC   MIMDMQEPKVFAHM  YPHMMQIOPUBGH   VXPMNQKXOH      NPBOHNKL       
CYUD            : UERBL           SKMQE           CWXGWVFPENPDLI  POUXILQLFLJNKWC UCTP           
LHKITEGOIFUJPBK : NVEGHNHS        LTOMGTLDJ       IYNIYOOLCGN     CGMYUPEO        CDBMMNOKLX      UUDVFX          FRSFCCBCM      
VNNJTYJCDREEMKE : IVUOIOSVA       YENOKRUMFKISNRR
TPLN            : PSMJ            JXPSXRCXLCFQ    HATPDGUOVC      DJPFMFGWKW      BDSBWIKKSIEGM  
RCGYYPQB        : XNNXVFNQCIMP    EESQUAJBGYL     BTJHAPPAPFNCMJ  LFJX            PSJVG          
XWPNGMMPORJ     : HTIYP           JQMNMVER       
WYDBY           : QPJVGESABWPIKC  UNROD           IQUNL           DOOK            OOJIENW        
SKMQE           : MWHDQVUTEOVYGR  CYUD            CUNCBHQABIA     IEGLOVO         SAUCDENW        COYTH           MFWLBFBHSQKGB  
WGQMYTRWRHKATY  : SSROOJB         DQCAYY          SHSDVK          LHEW            CWXGWVFPENPDLI  JPAB            YQXDH          
IRCEOBJ         : DPSVEFK         BTYKS           MQRVEUIFULIJ   
DJLN            : BPYGXHWWF       YAMI            PHHHXYHK        AKSSFUDEVCV     MKDKPTWIIXMY    LBOSVS          JHAQGG         
CUNCBHQABIA     : SKMQE           SKYVCRQVBPJG    HLAFQQTVSSAP    HAKJQWB         LLJOWLYMWEFRC  
QKVMK           : QULQTSXEWSO     GQNH            IKDMC           FMGBYUCGOY     
XCSCSULKX       : RQPG            NHEUGUALRXI    
XNTDIJ          : DNKHWBWJR       EJWWRXEJQ       REFGEIRGPDSIAT  RCMTUWDAAJFAH  
LQVOUFOPXBN     : JKTUV           MYQQCJUSJ       CCRKQCOJTULNT  
LEKPA           : LVDRG           ROQVHJYWYWH     IIKTY          
IUDTUXR         : QBDDHTECXNI     XHVYYF         
TUVECHWYXRG     : UMEQV           DTLDFHRMG       TJHR           
KGOASCHGUHU     : LLWKMUHUNLYHA   PVAQJCPVFLOWQ   IOBDIQBWJN      PPHOXEYMUWMKJ   OPXU            AXYJ            CDNGDAQRQDXF   
EAYYBTLUQH      : QTATIIWBDQITHH  GOJUKCFMB      
TPYU            : KDLPUHB         BMGUVCBX       
QBDDHTECXNI     : IUDTUXR         NSIXEUS         HKWSTXUWOXE     VIIUYXPUCMH     BRLWNBTRLHAE    KGQYG          
UGYYGXAHT       : MWJKCTMYNHRH    EVHYEAWNY       TELKRW          JYHEPN         
DLTEF           : RMGQONFPKVUYWD  MTLCEGRC       
DADWDGAKCGMD    : BPYGXHWWF       KDTRSUEFUPC     HBIMYBUMJMVXWY  SSHP            CCRKQCOJTULNT   CIXP           
XVQEWPKXRSRG    : YMEYOXRDWYOUF   YYVEIVJKOBVF    FHEAX           ATCKPEDIISQWR   MHXXDLDHGYKG    LLJOWLYMWEFRC   SOUVOYSKRTMLCV 
DCEKNIKSHPAJAE  : GTOOPVRGWPDWR   IDAYNVA         YKSFHJH         JDSRPEQ        
PJMNIETFV       : RIYEFEGHDYNOJG  FSMYINKVCHHUN   BRLWNBTRLHAE    CCWVJGBNXNEC   
DOYVWYYYEMMO    : HISBKBIVAFPXLAQ QTBSCTI         BABTBVEYUOV    
HVNHHPOXHXN     : BUSBGMNV        JAVTCCNAJTYEVK  EDMASTNBOGN     AKPDDSDODN     
GTOOPVRGWPDWR   : DCEKNIKSHPAJAE  JUGLFHXLC       LOMAYKVL       
BEQRBYPQIWJYXQ  : UKSWUEWFYJEB    WWIIYMUSHLOKW   QSKHUBXJVDCIE  
LOIHFWYDPGBFLXW : GIIUGCWK       
BDJSHKIAVHJUF   : VOXNDDBXV       ONUHSOOSBRO     RXLHKABUQNMYLEL
WQTGXYDADUGEDT  : HJMCXBDKOIXCLWT IKDMC           FIQPBVWITCWR   
CMFGWANJKNFRADA : CXCAKOEBYLX     EUWV            ONXGM           BPFYPAWXP      
CSYITX          : WEFKSRTY        GCEWUIDEFFWQYVQ WIGBEVMJXAREBEF
TDLAHQVN        : ROQVHJYWYWH     OFNQMBVAT      
JUCIWRTJHACJFE  : STEOEBICO       HWNSQMHKPUMAMJ  HSSY            AVVOGCECLNT    
HWNSQMHKPUMAMJ  : JUCIWRTJHACJFE  RWGN           
IULKFIE         : URLSQWOINWA     RVGICQLS        LJDRF           LSVDVMMFMVLVEC  HHHJQKUP        AOVPE           YGGB           
SLDWVIBKSAYLRNU : SANPTFKETPBUM   SHPPO           LECLAVHMPX      DMGFMJ          ENCKIEISUNUHMC 
FPPHCBXKXLWF    : LXDVGAT         YQEFXTQ         BTPULPSMN       DXBU           
BGOPKNNUQXNRY   : MAJCDVFQ        UKSWUEWFYJEB    ADRRFJWUO       UEVAAHB        
JOVNUOFC        : EQNAJLOWKSFU    HGGTUG          YUWYRSR         MCGAUWLQLNF    
ICGI            : YNJBGY          AVYYVAG         GASCGK         
DNKHWBWJR       : KDTRSUEFUPC     XNTDIJ          QERFWSWNTJG     EEJJYCBQDGKTVKV GSLYSVKH       
EIKUCMVNBUCVJH  : BYODJFS         RYXQLHBJCANEHLP KJFJ            GFMITG         
CSDIBTORGV      : ORWHEYLQQXWJNGA VIOJJJO         LSEOG           ANMAXRHHITOHFPK
HUXYFEK         : DXPHNVEE       
YMEVBGSF        : GFQF            UXOCUOEJLSXR    RJAUH          
COFGH           : SKTKFMJR        MXWTYTUBF      
PJHEBNCRWWRWEV  : LHSYQBMRIEQL    VIOJJJO        
VXVDVYLOEPQTXYB : FPUDWMMHT       MWELYKJQXSXG    QIGLAYHBTSSWFVL
OMSUPIYJFVBECA  : UTKIAGEQPMFCBO  XAGOO           MLHTJA          LUWUPLG        
BXMET           : YPOCYYQOQBSUT   EWNOSVYKUCFIH   ADNWV           XEEI            SBSNMKXEQBURDLI
RKSHDOH         : RQPG            XSDNWYPVGRNJR   MPNKHJBYBIO     JAYJXAUCRVH    
RUTF            : BIBVUAVIASAONAH RIYEFEGHDYNOJG  ELDNUWT        
OWVQ            : QTMWTGYHWROGJD  XEEI            MHWDTTTV        OXPDDW         
CMKIRKWSKLYEY   : HFXKKGTJ        WQSKLYEUJJRLJR  UMJIDIBRN      
QTATIIWBDQITHH  : BGQCURSNWSLRYI  EAYYBTLUQH      JUFPA           QCVAVFMFWS      BDEBOY          BSVNFHTTMEGH   
XOVNAFFMEXXPY   : QDEXIRCIP       UCXXLKX         LOVCSLNUICKXNIQ FWLRXTNABG      CGUXW           WSKVYISVFFJFRPF SPFVLY          KGQYG          
OPVJPP          : OKKSBSKSA       HDCCX          
AMUGFFCPNTN     : HIND            FCYBHH          SXOKRLTVNIOE    EMDCQUMWMHULXIK
QDEXIRCIP       : XOVNAFFMEXXPY   HRVIDNU         OFTNG          
HTIYP           : XWPNGMMPORJ     UHTN            WTNNLNANP       DNRAO           LHNGPYNIHF      DHMEYU         
RIOR            : LQBCJHVCT       UJRWM           UXOCUOEJLSXR    HSQAVRETRYFXBNJ JHOHEQRGCRWQVX  BTVYXPP        
LADRCSFY        : LLWKMUHUNLYHA   XGVYQPTXMWCK    EIYKL           JRMB            NQSGT           YVCYPAN        
JPMQPWKRIA      : RHMSLTTKTODPNBH FPMJLU          HMWLUGYUGJPAA  
RVVROQJWHDTSEW  : KDYQIQDBJW      BUSBGMNV        LSLELEPYAC     
IRRH            : CRNAVFGX        TFFMKTGRFLFEOKT
EYPWOMHIUHVN    : OJYDLD          NKCUDUVFWBAOGJ 
UHTN            : HTIYP           RUNPL           YPFULDMUUEKTMME LARCDNPNEMGRUI 
QUVLPCKDNFW     : DXNALBJEWTGFHIB DQLWU           SCND            KJFJ            WUPB            DXBU            HNPUE           LLKKNHIS       
GBWVALKHW       : TXVYE           WEBGVJWOHQ      CIXPLWWRSU      CPXBRUUIDYFID  
QUVWPFQFXKCVX   : YFUCO           GLMMHVX         ADNWV           RXLHKABUQNMYLEL OMIXSFVLF      
BKVOPSJX        : NQOADUD         MMNBSTRKVBL     VIGKXJBMGLYRJ  
GTWUHFTP        : VCGWMAGNXHV     LUWPMKY         KMMISBTGH      
ONUHSOOSBRO     : BDJSHKIAVHJUF   BNVCJUMUKUU     WWWQIIAVU      
KPLIG           : XHFIAWGTB      
DQCAYY          : WGQMYTRWRHKATY  YHXMDYAR        TQNOPK          PSGPWDEN        FJPFWMJLEF     
VGHPVFHJ        : WEFKSRTY        VUUWKLX        
QERFWSWNTJG     : DNKHWBWJR       YXNX            LINVV          
RMLVFOXHNADVJTR : PNHRKAS         GMCBGTSIUCEUTS  WKEOKYKTEFNTJFS
BDSRJMYGHWVD    : ONTKYNYCDOFMXB 
EMBRYYYPYGFAK   : MWELYKJQXSXG    DBIGALGJAVPCL   NLLESYFRD      
JGSBHXVB        : HFXKKGTJ        ASBFYDTAGXR     OCYGS           AVIJKUUPJGI     GOJUKCFMB      
KAPTYNWISKJMLKL : VVIXPIVUGJHXX   OPXU           
JUGLFHXLC       : GTOOPVRGWPDWR   EWNI           
UCXXLKX         : XOVNAFFMEXXPY   YDOHRISCPGA     DVCVU           RJAUH          
FXOCGHOR        : NVODSKPDNHIXJEJ SEGAA           CDUYRGSJXA     
CEIDNFLCKUA     : EPMMFDDJC       CLDQWYPVARN    
YBUBBSMMSPRQHV  : LRDWHA          PIPQPXGAI       WXAAXJSLLWACJCT
ONSNPWV         : FWAEKDBSDBMR    PRSFFR          WMTXCGJA        IMPMGMY        
NBJPNFPNESKIWDW : STEOEBICO       IXUDYIXKWNAWHAX ASJCUD          NKXTKIPCDPWFVDS VBKXXM         
VPDPWBQNQKBH    : HTRPDKQHBX      IQUNL           MJJANOAVPDEFBAG SDKHQOYA       
YFUCO           : QUVWPFQFXKCVX   DVCVU           PMRAPVVTRSA     OIQTYDXVMQUK   
RTCFBXPL        : PNHRKAS         PIIJHJCVSHGBLYI TFVNMCW         UYPUVIPPGU     
UKGTAJJWMAL     : VQAVXG          UJSJM           XGFKRMVKBJWXN   ECCUR           VMJTRRGLU       GMQNEPVNUIKNL  
KONUOSRQH       : JUFPA           WSGBFNJIKVCKS   WQHEPW          HUXVRYXDXNORJYG RONGXITBWAVUEA 
JEHQHHJUCGFIAG  : TKKARVXR        CBXTCISSCW      CRVPRPKSFPRY    JMJVWXXBPYPWLLU
JFHMSNY         : YXBXBH          AOVPE           SMACMUEQJLMKA  
BTYVMR          : AEEUOKBWRANQVGL LINVV           JXYGQCOTHJD     XAGOO           SQWQPRSBUMEXFTS FFDYAR         
TBJDUSLGNNMTYN  : QYHDQR          TDJHTAKYUNUUYMA LXCCXBJTCLA     GRJSTBQD       
SYHCL           : HDJGAROAEJU     KJQRGY          MEXDRMBXDTTDIP  UXOCUOEJLSXR    BEXHCXIJBBHAOL 
RLLSHKOVCUP     : KTYWXXLGXGMMORY BTPULPSMN      
GTDCFJP         : IIBA            NHGYPDRRVGMLKE  BVNTYNCDRLRVL  
XLTLNPNXRYBKM   : TOPAOHDYIPDAIB  DKXJRQXVSNOLRD  WIKNHX          KNQSKYIOOCDBDRO UMJIDIBRN       NHULXGMLXFLEFSX FHBTGDSF        MMIVHHWNT      
FUYWQBTHJCBO    : OTTQWE          PPMKNYWYFYOQW  
IXUDYIXKWNAWHAX : NBJPNFPNESKIWDW MUTJMGDOH       IPJFDEWF        YDFQVERTIDKP    KTYWXXLGXGMMORY
MMAHLWB         : EHXG            XFJYU           RBHLQJNCWKJ     QOVEHVTWVP      ASIGVVYPFAWP   
SIYULNATOWW     : WHIISOFQMMOVLF  GIGRHM          HWIMEYNOHKKYOP  MMIVHHWNT      
FWAEKDBSDBMR    : UERBL           ONSNPWV         QCNFWRNVEBGWL   DQLWU           KQUF            WTBOEBOSWB      HGKLY           VAFBEKPNVFRAYO 
MCYLDO          : QJHMHFGIEJJRABD
NPAYFCUVBRL     : JHUR            MVWAWKLC        DQDTDUUMG       FELEPVSPRFL     EUFPMP         
RONCRQWWS       : HFXKKGTJ        CXBNKJ         
OIYSILVY        : GSRAVB          RJUWECOFSV     
LQTKXVHUWCI     : VPTFFJLEVUWH    LWAS            RUGIXCHSWCXV   
TWVVQMTN        : HCFGOVPVT       IQWCKHT         QGPYPGBWCM      ATHSCGG         TNQDKNGGT      
GFQF            : GUOKDJNLRLXCURL YMEVBGSF        JRMMBMLEL       RCKQR           JLTRNPCDX       XWCY            AOFSP           AWYFLXJUKETYUS 
BSYANKS         : KKPQLJAD        PFNNYCI         TJHR           
XQGFLDHWLB      : JUFPA           GPPCPVP         DYRLRENT        YGGB           
HANWVDGCKY      : WQSKLYEUJJRLJR  CLQQWPUJ        WWMGT           LJGQFHOMEXEP    TKHHMGG        
LAFKCSUUASM     : UVAJAQLIE       MKDKPTWIIXMY    NRIOLO         
YAMI            : DJLN            VAVVDUD         HIHKWJUI        ERQCMPMQSFI     EOKPNLAJLDA     WUPB            RVAOEAETX       AOVPE          
XKVIKJH         : SOXGT           VNWOFMYF       
OPKAPVNR        : OFARBK          IIVRULXXLX     
XUTURWOGDP      : ROMTTLJUPPHKW   MXWTYTUBF       ASJRTXBPKBYI    DYRLRENT       
RAISKEDWP       : KCWTWQB         BXVXSLKO        TXXAAU          VSCOSIMTFL     
FFARHRQUKR      : AVJHOACB        YQMXTHGVUOKSW   NUTWDGTMYKVH    XBUVMIRU       
HONYNEGSVPLWXE  : GWSVVBNJ        LBTPCAMXKMMLGDO
FHJUT           : NWROMGJEQMD    
AVJHOACB        : TOPAOHDYIPDAIB  FFARHRQUKR      XHFIAWGTB       SNLTYLFKEXDSB   EIEVVCLRSFIV   
WIKNHX          : XLTLNPNXRYBKM   IUSSM           BSIMKMEKYQAABO  BKUGDLQTJAGKXR  MLEMFKMSOKGYCXE
PRSFFR          : ONSNPWV        
JBLSKGOCJKN     : LIYKTOWRQEBOTG  KWEP            LUAFMOAKAOBNVO 
BNVCJUMUKUU     : ONUHSOOSBRO     QEFQNAY         IJOTUKKDT       SVQXBONWFYRL   
MMXSRRBDSMXG    : YBDRCMJI        ONOURSYIWKMNV   PCTQPAPRPYOMWS  QXCCMVHXQMHLJD 
MKEXXXBN        : DCCOCK         
GWQSTEPPJDC     : WHIISOFQMMOVLF  TQVMRIVAJ       AJBDIV          QPRYYWUVCJYBD   SQEMIMYNFDTT    YDCIMCTFMNCKXN  SDHFWFLV       
XWBYCVNBCIN     : XXBIGOSXVT      UNSWVKSLDOX     VVCSJUFW        SRFQEC          OMIXSFVLF      
NNMNPAJVXCQTG   : EWNOSVYKUCFIH   CKSQYB         
JRMMBMLEL       : GFQF            BXRBDHYYWR      HHYY            OMDQOUHMLXMJDL  NHAQEWCABYR    
BYODJFS         : EIKUCMVNBUCVJH  CGUXW           GVRTWXLC       
SHKKI           : WRABJ           XAGOO           PIIJHJCVSHGBLYI MGJGJBSB        KJJMENMDPG      AKHGX           VSLUWROLSYJD   
IIBA            : GTDCFJP         UUDVFX          PCYMYF         
HJMCXBDKOIXCLWT : WQTGXYDADUGEDT  VYXRSU          HWYSIRWXVVUV    SKYVCRQVBPJG    LQQRODQB        UCTP           
GYJGTRSFCRPK    : BKGT            EREIYCHVSCLS   
ROCBDEBEKLSUJX  : ADXU            LAIYM          
ITWRSJX         : RCKQR           QJLCPQW         PLQOC           WMXEPD         
DSTFKKRFCGIGKOJ : UAXWSNSYOL      PFYBQNX         PBDBTOOHQJ     
YVMTHMAQGXKBJI  : RAEGU           JXDM            AKPDDSDODN      DMWSCBF         NHGYPDRRVGMLKE 
MDMRQ           : PHHHXYHK        OJYDLD          OLFOGN          UJRWM           KNYQLRYNGKU     SQWQPRSBUMEXFTS ICPTHTRNDDFCAJD ROPIVCKXDL     
LVDRG           : LEKPA           MRRUFVSMKPJXQJ  NFPEGPKKIKTI    JGGK            QUDDCI          BJFLLCO         BKUGDLQTJAGKXR  OROQYXVSKGD    
EVTXURMRYYRRHRC : TEGJLIWTDGCTB   ECFAHDGIAKIAIUK
DMXPSKJJJUHNPQY : LOVCSLNUICKXNIQ TFVNMCW         POYADYRWECPW    LXEIRW         
MUTJMGDOH       : IXUDYIXKWNAWHAX GMUGXOWARWI     QVJWHMKCJFEVDHK
IORLWVA         : FOLTSGLXRWSPOK  ISUQDHBCUJEMXRO SVIFRJJQTYD    
NSIXEUS         : QBDDHTECXNI     WPBMVBFNBGQUI  
IKDJHRFBD       : VHJUFAMHO       UBSG           
KHKRHTHYHGUHEJ  : HRQQ            JTRBVPHGMWJ     PLSDJXEBMUJJUV 
NJFKETSPYCWSJAY : WTNNLNANP       MKUECBW         ROYC            VPNPMCT         OJIPIPNCAKV     FHBTGDSF       
MIOFPK          : KHVNHX          DXTWODMOB       PLQOC          
ORWMACXDRH      : YMEYOXRDWYOUF   BVLHSEVGS       GFGGSTCPWXEJFQ  TXVYE          
CLFWDE          : EHCDAXHFFHQLHW 
CALDYRPHI       : QWAUPMLEMWGDJ   KCWTWQB         JMJVWXXBPYPWLLU CVORSPH         PYNN            IBNCTTFCCF     
WTNNLNANP       : HTIYP           NJFKETSPYCWSJAY MXHUHQGLNB      PIPCFWPTOJR    
QJHCLVHKBNL     : HBIMYBUMJMVXWY 
NYJM            : QREAOMFB        WBVTYNMVSFXHTV  IISBVBPQX       PLSDJXEBMUJJUV 
BTCBQVOFJCH     : EUOADRVEGJGPSF  HGGTUG          HIXXJ           FVPNUVDR        SJOISXKMWTQV   
TIODRQQPADTOPX  : JXYGQCOTHJD     VTFSKMU         LUAFMOAKAOBNVO  LARCDNPNEMGRUI 
QJRIKLKLFIDMTHT : SSROOJB         UNROD           ONOURSYIWKMNV   PTHNQRMCROLCA  
EEJJYCBQDGKTVKV : IQYVIKVMHPBJMY  DNKHWBWJR       HPOHHLA         DOOK            QUUNLIVD       
TNXFCKSHUVVOG   : LOVXFSSWC       HUXVRYXDXNORJYG OANPOBMRQ      
HKWSTXUWOXE     : XXBIGOSXVT      QBDDHTECXNI    
RCKQR           : GFQF            ITWRSJX         VWWM            JRGMMGANAGVHKFU JTJXJOOW        EOKPNLAJLDA     LMQUYUK         LANRDSRDXHQM   
RCKQR           : RQIVGAKKPM     
GPMIC           : EHXG            OBTFCXDM        JGCHLLSXJT     
RWGN            : HWNSQMHKPUMAMJ  ADXU            AWYFLXJUKETYUS 
MGVWFQSD        : VMWVA           QADXGTWXVIPULCS VVCSJUFW        MEOFVD          NJIFLGWSCSM    
QTMWTGYHWROGJD  : OWVQ            PLQOC          
MKJLQYAF        : JUFPA           FWLRXTNABG      AUYLTT          IWBNXISLPNJJC   EREIYCHVSCLS    WQIRQFTB       
XEOOXRBQOPNIV   : WRKMGRVT       
RVGICQLS        : KCNOU           IULKFIE         GCEWUIDEFFWQYVQ MEOFVD          GASCGK         
YEQRGRAPREFHEY  : ATHSCGG         PCYMYF          IEYKYKFEOBEJGXG BHLXMKEWGIMNE  
UNAKYXXQTEA     : RDMKMCCQANFKVV  FPEAPSSTGYLFAR  KBJSFWNY        QSKHUBXJVDCIE  
WNRAOVTJE       : VYMTEQLQLXICQ   XWICADRF        SWGVO           JBXBHOQWURXLH   WKEOKYKTEFNTJFS
JUFPA           : QTATIIWBDQITHH  KONUOSRQH       XQGFLDHWLB      MKJLQYAF        BRWIXGVVGEYGKSO
UBYRPBDOAB      : ROMTTLJUPPHKW   AJBDIV          MAVQKJWNRUTNL  
VHJUFAMHO       : MWHDQVUTEOVYGR  IKDJHRFBD       HLAFQQTVSSAP    SCMYQSIQKQPD    YHWBRGLVI      
BAPQJKWCMLWNNQ  : OCXA            SQAYBRAFIQKAVDA KUYHGMJKUY      YDCIMCTFMNCKXN 
OTTQWE          : FUYWQBTHJCBO    XKSDYWJBIGDEQD  PTBNLGNT        VYMEHIBVSV     
HNKMNWV         : NXQHSKUHCYDLCC  XGVYQPTXMWCK    MHDJGDQHDIQEREO EREIYCHVSCLS    REKAUI          NWLFBIQYU      
HAFYQ           : DXIMMIUDGV      YRVLELKEMQFBJDI WPKMSQJ        
LNTAC           : VSPXBHUVUPH     ATHSCGG         PLSDJXEBMUJJUV 
QPJVGESABWPIKC  : WYDBY           LAYIUFP         JMBYEAMYLTUX    AWYFLXJUKETYUS 
YYVEIVJKOBVF    : XVQEWPKXRSRG    RUNPL           XTWNYWX         CCWVJGBNXNEC   
WHPNYCLFGEHJBYU : LWMMCHBCKCA     DOASUQDFGQF     UTCGVOMJOH      AJYHWCVHNWPIIJ 
BRNAPTLNFVDJRKG : RDNWHSAJYERXHF  LDQWADXQNJHH    IWQNEUP         WXRLLY         
RYGS            : MCCPRQBMB       HTRPDKQHBX      DLFDJFXUPMO     PTBNLGNT        AJYVVXXGNCLS   
SAHYISDHNR      : OIFNOJERPL      BDJMWGYGTIUNS   JPELAFBLCYGWVI  UJHDL          
IHLXBYMI        : LFNQTN          CMGUHGNTHS      EJIXEWBCEEJT    PBCON           LQQRODQB       
RRPCYITXPOBKOK  : SKJVXG          KGCD           
YDOHRISCPGA     : UCXXLKX         GVRTWXLC       
GMCBGTSIUCEUTS  : RMLVFOXHNADVJTR UBUMDRBMCHUDY   XXXEUMQEI       JGIDGOT         NUTWDGTMYKVH   
GIGRHM          : SIYULNATOWW     PQOJBONHU       BCOVNYV         NQOADUD         LSMYJ           RPCOECOFOHJBABB CBNHMOMPBJYKE  
QERLGKS         : OPOIHYH         KCVSRDXFQTTTL   NEOAVXOV        EMDCQUMWMHULXIK
DYXHCEC         : OLVSGCJKM       EOJKMV          UVAJAQLIE      
NYARUT          : EVVOMT         
QCVAVFMFWS      : QTATIIWBDQITHH  IKSX            PSVG            XBUVMIRU       
IBKDJPCHXHOCFC  : BFSO            QGPYPGBWCM      UUSBPKRVDWTWAH  TGRYVYFKRIPGAJU WAQLYX         
FVVBJPF         : HQUBUFV         EVJCE           DUEPLMGHNKFLY   DNNGGJF        
RBLGHKYJUCTYL   : UBGCTLJT        SHPPO           EYRR            PYALQGHKFMI     WOFTTSQUP      
DVJKMNR         : WXVOVOTTO      
PYMNAWFFEY      : CYVEY           YLBAUXNYTG      WUPB           
RFQCGAX         : BIJRLTNXBMJIF   VWWM            SABMUYMFTRILUPP
VYWHCU          : GMVCDRKSLROQE   MAJCDVFQ        AHTCUMGTALLIUA  AVVOGCECLNT    
PHHHXYHK        : DJLN            MDMRQ           CGNXUA         
JHUR            : NPAYFCUVBRL     CLDQWYPVARN     WTQDTIFWKBNBIFN JUDISUVGWN     
UBGCTLJT        : RBLGHKYJUCTYL   OJNVIIE         AOYAWYSAL       WUPB            WPPOLECCGI      QSRGHSQDPJ     
TRKQYM          : LFJX            KGQYG          
SESDMQCV        : KLFPCOABFRWAMBO AWKMYVNFASJ     VXPMNQKXOH     
PFNNYCI         : BSYANKS         DTPSXOFJOAFP    VIOJJJO         DBEBVHUF        FYJXKRXPVWN     GASCGK         
JKTUV           : WFCUGOBHFYYIW   LQVOUFOPXBN     TXVYE           JVLYVHGWXPX     ATCKPEDIISQWR  
GQHSJJ          : NVJAE           HJESPTNXNLXL    JTJXJOOW        VIAYJVVXAIO     HLAFQQTVSSAP    TQUVNYBUDXFMY  
VCKQF           : JVLYVHGWXPX     DPAKSQLEVLY     LUWPMKY         ANMAXRHHITOHFPK FUNYMRLKBV     
KIWOAEC         : WHIISOFQMMOVLF  KKVIOIYW        JUPATSGN        XXXEUMQEI       LJMLMBSEKMPDK   YENOKRUMFKISNRR
EHXG            : MMAHLWB         GPMIC           EMPU            ANMAXRHHITOHFPK
LBNHSVAB        : AFFYVNPAPBWWVJ  SKHJGRMHPHQBNI  TWEMREKLUKD    
KKVIOIYW        : KIWOAEC         PKOXMOIXSJGUAT 
LHGAHLFXRM      : CRNAVFGX        XKALEFAI        GMUGXOWARWI     MWTWQUWJNRV    
XFJYU           : BFSO            MMAHLWB         OJNVIIE         XDMSCXGA        TAXJJIA         JDSRPEQ        
SSTVJEI         : MPNKHJBYBIO     IJOTUKKDT       JGCHLLSXJT     
MWQOTAADHDLUI   : HRWBXIXLEW      NQSGT          
MWJKCTMYNHRH    : UGYYGXAHT       FNMHLBV         TJVWASYQQ      
BONIBKYRH       : OMRHECQCEPJAC   IFTQNKTC        MHSLIUBQEQUFQD  QBMJVWAINRLHEF 
SKJVXG          : RRPCYITXPOBKOK  NVEGHNHS        VEPODAYEWABFU   LJGQFHOMEXEP   
LSDV            : RONGXITBWAVUEA  BKUERMYD       
HRTGHDAOI       : ANFXCFFRCXFQOS  YPHMMQIOPUBGH   KHJQTSDH       
FVLJJN          : APDIA           WWIIYMUSHLOKW   IJOTUKKDT       KMAPTCKRSHKCJU 
SPTDYREFXP      : WXEQG           RAJJ            VLGJQ           KTYWXXLGXGMMORY KKENPDKS       
BNHIFCQOHQGQVLO : SVQXBONWFYRL   
UAXWSNSYOL      : DSTFKKRFCGIGKOJ OLFOGN          UBSG            MLHTJA          WTBOEBOSWB      AXIGU          
TJUVNLDVQHNGPG  : DMAIBKHKO       EJNBDBKB       
IDAYNVA         : JNTITBUOV       DCEKNIKSHPAJAE  MGOQBHAMSGB     MPNKHJBYBIO     AYSNOXIPRV      JPAB           
USYNTPBYJN      : HISBKBIVAFPXLAQ IQWCKHT         LIBOETCNTXTDERQ
HBIMYBUMJMVXWY  : DADWDGAKCGMD    QJHCLVHKBNL     LRDWHA          QQJKR           VPKS            CDQXSLJFBUSYSE 
VMWVA           : MGVWFQSD        RDMKMCCQANFKVV  PVVUWDPPQWSLYP  QUUNLIVD        CDQXSLJFBUSYSE 
RBHLQJNCWKJ     : VJYQGH          MMAHLWB         BECIQJN         GOKNFY          VIOJJJO         RUKO           
UVYVSOGFK       : RYXQLHBJCANEHLP OICWADE         DPAKSQLEVLY     MUBWWSOC        YHVR           
CLFBACWATQD     : YNXLSRDWGEDRKS  VTIEOOUCLPOVHF 
DTPSXOFJOAFP    : FBFJAPBF        ULTGVGVIT       PFNNYCI         KGCD            HMJWHVK         BLWRXUBHBJXQOD 
BECIQJN         : RBHLQJNCWKJ     YBDRCMJI        TXXAAU         
OOCRLENDHRIDH   : JWBQAJUP        DNHYVFXHI       UPEPTQWC        LHNGPYNIHF      JAQLIVJQHCTKBT  WQCOMGRTNKQKWHB
DXIMMIUDGV      : HAFYQ           BVVTJC          TWEMREKLUKD     FTQSCTSVGYKL   
JEYURDJGGD      : FLTBNIMARV      EJIXEWBCEEJT    MCQOATB         FLGQMUEQXLESL   MMFLLOXMTQFQOXL KWQWUEGE        ICPTHTRNDDFCAJD
MRAULIAVNETVQ   : DUCNBCHWRAB     ROPIVCKXDL     
GLMMHVX         : AFFYVNPAPBWWVJ  QUVWPFQFXKCVX   GPYJBC          VTFSKMU         QUUNLIVD        GLMPIKXMCKL    
WSGBFNJIKVCKS   : STEOEBICO       LLWKMUHUNLYHA   KONUOSRQH      
UTKIAGEQPMFCBO  : MYSIUTKBYPB     OMSUPIYJFVBECA  XJPFWWC         OVNVHBXVUJ      ASJRTXBPKBYI    YHWBRGLVI       WQCXR          
ADXU            : ROCBDEBEKLSUJX  RWGN            VSNMTG         
BCCKLMHPWCE     : PNNDKCQVVSWKQYW UNSWVKSLDOX     YHWBRGLVI       BPFYPAWXP      
VQAVXG          : UKGTAJJWMAL     SPVJEFEYUO     
PSWSVLTVRTTGVVI : BRWIXGVVGEYGKSO EMNRYYUDJT      VPNPMCT        
JUPATSGN        : KIWOAEC         PEPYTWSK        NCYSQBEJUCARN   IKSX           
XNNXVFNQCIMP    : RCGYYPQB        MIGWVYCHID      SXJJELIUKM      SXOWRJC        
LJYFPU          : FVIAA           MNEBNKTS        MRGMXPPYXRPCLUH
ADNWV           : BXMET           QUVWPFQFXKCVX   RWBSTPXLSK      OXNYXPITNKRJW   RJAUH          
QOVEHVTWVP      : TQVMRIVAJ       MMAHLWB         QJLCPQW         PIPQPXGAI      
MIGWVYCHID      : XNNXVFNQCIMP    LEUTARAKJBX     MWELYKJQXSXG    GRBCMQXCVML     PFKODLP         VIGKXJBMGLYRJ   OJPPPWE        
BXRBDHYYWR      : JRMMBMLEL       HDJGAROAEJU     ECHMSAVKWBRKLFV
VYXRSU          : HJMCXBDKOIXCLWT WKMQJ           SJCJQXYWQMI     YDFQVERTIDKP   
LXDVGAT         : FPPHCBXKXLWF    STNEUAX         QSRGHSQDPJ     
EDOH            : JXPSXRCXLCFQ    OVNVHBXVUJ      IWBNXISLPNJJC   IDBLOKLUGLAKC  
RHMSLTTKTODPNBH : JPMQPWKRIA      CCGOKWDADT      WXRLLY         
VAVVDUD         : YAMI            KJQRGY          ARGVQBSO        MGTMVYKXFJ      SSVOBNRO        KURNSASCJKUHVY  JGCHLLSXJT     
OKKSBSKSA       : FTJHPK          OPVJPP          WWMGT           BJFLLCO         SQRKXDJXHPN     JXDM           
ONTKYNYCDOFMXB  : BDSRJMYGHWVD    SQGJLEODFLQYAWC UFOCECJTYUKXRI  AGCBD           QVAKPDMHMGAJV  
VASQFYIPKB      : PNEKMCN         LANRDSRDXHQM    DMAIBKHKO       GXNASQ         
FNMHLBV         : MWJKCTMYNHRH    WMFFATAWVT      MIRBTFWDNDANHWA AUYAWVDPSMMWPBD
OWUNBXDGMDJABJT : MEXDRMBXDTTDIP  IUALXQGSYBBVWM  XXXEUMQEI       QBLVLQNB       
QSDJFE          : ILIUYDQYOSPACV  XIUECPD         VMLWDIKTCUGGK   VNWOFMYF       
MRRUFVSMKPJXQJ  : LVDRG           QXCCMVHXQMHLJD 
WWIIYMUSHLOKW   : FDPMKC          BEQRBYPQIWJYXQ  FVLJJN          IRMW            NEYXPOVDUKMRSS  EWNI            OMIXSFVLF      
QCJKUG          : JRFQXTPPPJU     UJSJM           LUWPMKY         ESCNW           LKEYEQGAFRAX   
QYHDQR          : TBJDUSLGNNMTYN  VFDHPYHCB       DOUUISFWVLH     FPEAPSSTGYLFAR  UNPDCSFKGTBQFY 
HDJGAROAEJU     : SYHCL           BXRBDHYYWR      IUALXQGSYBBVWM  LBTPCAMXKMMLGDO
XJXWIQAREUAWN   : MOYSWCTKL       OLLTFVUPHLTFK  
GSRAVB          : OIYSILVY        HWIMEYNOHKKYOP  TFVNMCW         HOROOWLUMX     
FHEAX           : XVQEWPKXRSRG    HWYSIRWXVVUV    DPAKSQLEVLY     WQHEPW         
EKCSINSHV       : AEEOQF          BGKY           
HPQERPTSXMKYJL  : KJFJ            VBKXXM          CHHALU          IMPMGMY        
QULQTSXEWSO     : QKVMK           QMVQIIJTLBR     WBVTYNMVSFXHTV  VVIXPAXCB      
NVJAE           : GQHSJJ          SBGKXFOKKFS     YKSFHJH         YYCPDPRPAXA     KKENPDKS       
SKTKFMJR        : WXAHQQFMK       COFGH           WWGKJONLISURGCW BEWFVLAB       
KDLPUHB         : TPYU            VBOGTPW         BDJMWGYGTIUNS   KJJMENMDPG      IVUOIOSVA      
BVLHSEVGS       : ORWMACXDRH      UJLQQMG         GRPNXNNNN       SWGVO           XSCNFEOSDDN     EJCYJCTNYQY     CDTFXB         
RUASOLMB        : PIUOVG          LASMSFSO        JBJUOVFPFBX     LSLELEPYAC     
CMICWONOJWQWXM  : VVIXPIVUGJHXX   LOMAYKVL        LLJOWLYMWEFRC  
HIND            : HWGSTMO         QUKGGGIQV       AMUGFFCPNTN     HJESPTNXNLXL    OXNYXPITNKRJW   NHAQEWCABYR    
IXGEAB          : CXUSDUHUBLDHJXX XXBIGOSXVT      JWBQAJUP        POUXILQLFLJNKWC
LOVCSLNUICKXNIQ : XOVNAFFMEXXPY   DMXPSKJJJUHNPQY HNXMFXCEVSPRI   JTRBVPHGMWJ     GASCGK         
IFTQNKTC        : BONIBKYRH       HAKJQWB         EMCC           
TKYUMT          : MVWAWKLC       
DSLXEBSO        : LSVDVASKCJBED   DMWSCBF        
DMSLFFULC       : ULTGVGVIT       DPOCBAFLUYWS   
BMHGHEQJBFDJ    : KLFPCOABFRWAMBO
XWICADRF        : LFNQTN          WNRAOVTJE       PIPQPXGAI       BKUGDLQTJAGKXR 
GAUOIRAKFDYPJI  : YHVR            CDQXSLJFBUSYSE  AWYFLXJUKETYUS 
BRWIXGVVGEYGKSO : JUFPA           PSWSVLTVRTTGVVI RXTPPYALHOA     DUEPLMGHNKFLY   VCWKCBJIEPLAXGH
BQOPYJRLQVMGFVE : APDIA           MRGMXPPYXRPCLUH
NBTLKPKQV       : NXQHSKUHCYDLCC  RDMKMCCQANFKVV  FBDLJLNCCSUHH  
YGENA           : YKSFHJH         UFKDXAKCGYEYV   SLFESTNBAWFJ   
HRVIDNU         : QDEXIRCIP       YKSFHJH         SDTWJ          
LJDRF           : UDCYKQQBD       IULKFIE         AHATXHECYYCES   XGVYQPTXMWCK    VNSWVTL         JLTRNPCDX      
AVLTJVL         : NYCKHAOJIWJTFS 
OIFNOJERPL      : SAHYISDHNR      KNYQLRYNGKU     SQRKXDJXHPN     EGHCXNI         STNEUAX        
NVODSKPDNHIXJEJ : WEFKSRTY        FXOCGHOR        MBNBDCLENN      YJJCKURL        YNSIFSMSTEJQOV  ENCKIEISUNUHMC 
OHRKVCQJTA      : BFGYCAJSPRX     VGMH           
LRDWHA          : VDVRHEACEJBVQ   YBUBBSMMSPRQHV  HBIMYBUMJMVXWY  JWBQAJUP        XSCNFEOSDDN    
LSVDVMMFMVLVEC  : IULKFIE         VODOKW          VTFSKMU         UJSJM           TSFPO          
YNBBEMUGDG      : SGRIID          JOLKVRDXTHRX    VMLWDIKTCUGGK   PFKODLP         OWPN           
GFGGSTCPWXEJFQ  : IPPQHHW         ORWMACXDRH      ROMPEYSBQTQJP   FKDWUPESRRMBW   XGVBUXMTGLX    
ROMTTLJUPPHKW   : XUTURWOGDP      UBYRPBDOAB      SCND            YJJCKURL       
TXVYE           : NLMHEQFFKVWB    GBWVALKHW       ORWMACXDRH      JKTUV           EADC            TAXJJIA        
SBGKXFOKKFS     : NVJAE           XDMSCXGA        QLICMLHIS       PVVUWDPPQWSLYP  JDSRPEQ        
VHYPVKKLBTVX    : VFDHPYHCB       KWVJR           OVQFAGDPSJXK   
RVDRCHMDOWEVNO  : UDCYKQQBD       VXCHAD         
UJLQQMG         : BVLHSEVGS       OOAX            XETWRUWSEVACIW  XTWNYWX         NJIFLGWSCSM    
YSXAMWATOXYIBJ  : RYXQLHBJCANEHLP UYPUVIPPGU      OTGKTA         
GAVMV           : GPYJBC          YAVXKMWJJSBPA   YNSIFSMSTEJQOV  XGVBUXMTGLX    
BEGMRWEG        : BKGT            IKSX           
QGXRINQ         : CUYXSKJWRRS    
HHHJQKUP        : IULKFIE         NCYSQBEJUCARN   FVPNUVDR       
UMEQV           : TUVECHWYXRG     NCYWWCSKO       AVGVVWGCAUQ     NIYEN          
WFUPEBVKUEKO    : TQDTHCJUO       CWPNKI          VTFSKMU         SCMYQSIQKQPD    GTAIPJT        
XFWIMGTFROV     : KINLA           PIPQPXGAI       VNWOFMYF       
JIRCGCYNAQS     : HXBINSLNREEK    CIXP            SSDHHRTY       
PFVT            : HXBINSLNREEK    NYCKHAOJIWJTFS 
KJQRGY          : AWXRVE          SYHCL           VAVVDUD         CTNNYDFMPP      MWELYKJQXSXG    HDCCX           VCWKCBJIEPLAXGH CIYRBECTNJDB   
KJQRGY          : TKHHMGG        
PSMJ            : TPLN            KNQSKYIOOCDBDRO
IUSSM           : MWHDQVUTEOVYGR  WIKNHX          MEFXGAUWD       GKKJKYXUJOEDC  
CRVPRPKSFPRY    : JEHQHHJUCGFIAG  UXOCUOEJLSXR    WOFTTSQUP      
EJWWRXEJQ       : XNTDIJ          TWQHGLKYRC      PENAEEJMBU      VPNPMCT        
SACNSWDP        : TYOVMP          ICNGMUIKRWCUL   HONFVTWQYYUDDHS OLLTFVUPHLTFK  
UNROD           : FVIAA           WYDBY           QJRIKLKLFIDMTHT EJIXEWBCEEJT    IUUIXOMWVSNFF   BTYKS          
HISBKBIVAFPXLAQ : DOYVWYYYEMMO    USYNTPBYJN      BDEBOY          XDUJJSX         MOBERTORP       RXLHKABUQNMYLEL
SQGJLEODFLQYAWC : ONTKYNYCDOFMXB  OAAIDXU         IWBNXISLPNJJC   XSCNFEOSDDN    
FWLRXTNABG      : LFNQTN          EWNOSVYKUCFIH   XOVNAFFMEXXPY   MKJLQYAF        QKOPGFAVTI      VSCOSIMTFL     
MGOQBHAMSGB     : IDAYNVA         QTBSCTI         EUOADRVEGJGPSF  QPRYYWUVCJYBD   IOGTMLXUPWHE    BLWRXUBHBJXQOD 
LMQNMNPWVOKNO   : RSGXMYUAWK      ORWHEYLQQXWJNGA WWWQIIAVU       XFVKV           CIYRBECTNJDB   
EOJKMV          : DYXHCEC         GRHKCFM         EWUDT           AGHM           
DOVKOJFUMFJCV   : IIVRULXXLX      DXNALBJEWTGFHIB NLLESYFRD      
QKOPGFAVTI      : FWLRXTNABG      XARVCBRODQI     XTWNYWX        
IRMW            : WXAHQQFMK       WWIIYMUSHLOKW   BDEBOY          SCND            DEXPIBOLFQMLAAI
HCFGOVPVT       : TWVVQMTN        BVVTJC          SKYVCRQVBPJG    ASJCUD          KMAPTCKRSHKCJU  HBDFQQOHXHLKRQ 
BFGYCAJSPRX     : OHRKVCQJTA      MBNBDCLENN      MNMOG           OPXU            BHLXMKEWGIMNE  
QTBSCTI         : DOYVWYYYEMMO    MGOQBHAMSGB     OBTFCXDM        IMSIO           FTQSCTSVGYKL   
JRFQXTPPPJU     : QCJKUG          KGCD            VUUWKLX         AJYHWCVHNWPIIJ 
ODRSDENTXLM     : UPEPTQWC       
FPMJLU          : JPMQPWKRIA      JWBQAJUP        XQGYJQOVDUI     CCGOKWDADT      AJMWX          
VMRONNEDDPXXEE  : SEGNWDGRPOAWWQU LCSNEQORFOVJ    UVRWXE         
YHXMDYAR        : DQCAYY          RBTRXXANWWUM    SRFQEC         
FICQTYFROWJC    : BUSBGMNV        LUWPMKY        
NFPEGPKKIKTI    : IPPQHHW         LVDRG           UAOPENEPVAGX    VMWK            WXRLLY          CKSQYB         
AHATXHECYYCES   : LJDRF           MHSLIUBQEQUFQD  RUGIXCHSWCXV   
EESQUAJBGYL     : ECFAHDGIAKIAIUK RCGYYPQB        GSXSWEVTGJ      IJOTUKKDT       JJWVY           VTIEOOUCLPOVHF 
JXPSXRCXLCFQ    : TPLN            EDOH            JGGK            NETLCQ          QABSPSDCNTLI    RLNOWT         
GRJN            : PYTJKFB         WRKMGRVT        KGATSMQE        CQRIVEOYNTYJMNX BKUERMYD       
ARRUKMUTNEVBYF  : GCWQWBSOQPA     RCYPPSOLLGM     GPYJBC          HLAFQQTVSSAP    QJHMHFGIEJJRABD YJJCKURL       
OAAIDXU         : SQGJLEODFLQYAWC PVNSVKLUISCS    VSPXBHUVUPH     CDNGDAQRQDXF   
FLMMFVARXTLU    : CPYFTRKRTWLL    CTSFLLPHLYWEVDL DKRTDCP         CONSAXIQYLTXDTC EMCC           
XSDNWYPVGRNJR   : RKSHDOH         FMESCWM         YPFULDMUUEKTMME PFKODLP        
ORSVWGLLLJLGIH  : TOPAOHDYIPDAIB  IOHSOTOCH       MPNKHJBYBIO     IWBNXISLPNJJC   HOODFGOS       
FQQX            : JVYGYNBRU       LMQUYUK        
GWSVVBNJ        : VOXNDDBXV       HONYNEGSVPLWXE  GOKNFY          BTJHAPPAPFNCMJ  EHCDAXHFFHQLHW 
HHYY            : WFCUGOBHFYYIW   KKPQLJAD        JRMMBMLEL      
VWJJIX          : KWVJR          
WEBGVJWOHQ      : HSJBEJWCWXUFFWM WEFKSRTY        HXBINSLNREEK    JSWVABSHIOVIXM  GBWVALKHW       VHGVWHIVKP      WWGKJONLISURGCW CDBMMNOKLX     
WEBGVJWOHQ      : BMGUVCBX        FIQPBVWITCWR    IEDETKBJJOCWY  
FLTBNIMARV      : KLFPCOABFRWAMBO QREAOMFB        JEYURDJGGD      EJKEF           TVYSAQSBBSD     QLICMLHIS       EADC           
RYXQLHBJCANEHLP : EIKUCMVNBUCVJH  UVYVSOGFK       YSXAMWATOXYIBJ  MYQQCJUSJ       PQKEGYVNPK      IVKMU          
BWAYELSH        : JXCJ            ADVBXFUHRIBMP   CONSAXIQYLTXDTC
DVCVU           : UCXXLKX         YFUCO           SPFVLY         
NVEGHNHS        : LHKITEGOIFUJPBK SKJVXG          NCYWWCSKO       BJFLLCO         ANKXPJTJL       NQOQJTBAMN      UIKFLDNHLYIRJ   GASCGK         
IIVRULXXLX      : SSROOJB         EWNOSVYKUCFIH   OPKAPVNR        DOVKOJFUMFJCV   PQENJJMWTOUAUAX
PMRAPVVTRSA     : YFUCO          
PEPYTWSK        : JUPATSGN        YLGPUJOYVX      BUSBGMNV       
BIBVUAVIASAONAH : RUTF            TRDCIJLWYKUR    AGCBD           MAVQKJWNRUTNL  
YBDRCMJI        : MMXSRRBDSMXG    BECIQJN         RXTPPYALHOA     CPXAXSDDHUBKQ  
JDBCPLFX        : JVLYVHGWXPX     CXCAKOEBYLX    
EUOADRVEGJGPSF  : BTCBQVOFJCH     MGOQBHAMSGB     MVWAWKLC        QVUSESIHECIN    GKKJKYXUJOEDC   RQIVGAKKPM      YROUKJCNKWTMQU 
XAXKJGMULNYDYF  : NETLCQ          MEXDRMBXDTTDIP  TNQDKNGGT      
OJYDLD          : EYPWOMHIUHVN    MDMRQ           UNNDCYXY        ELDNUWT         CJUXXNWVVJ     
HJESPTNXNLXL    : GQHSJJ          HIND            YXNX            PLQOC           RKTX           
JUKFIBE         : BIJRLTNXBMJIF   DQLWU           MHDJGDQHDIQEREO CPPQLJHLMQI     VNWOFMYF        UCTP           
CLQQWPUJ        : HANWVDGCKY      RDNWHSAJYERXHF  KMCDDOJUMAP    
RSGXMYUAWK      : LMQNMNPWVOKNO   PENAEEJMBU      VQKNDWULTLXBKB 
WWMGT           : HANWVDGCKY      OKKSBSKSA       EQGKHSRJFKOOVYU UNEOJVGEDVPEGRY
NCYSQBEJUCARN   : JUPATSGN        HHHJQKUP        IQWCKHT         SSVOBNRO        GOJUKCFMB      
JGGK            : TEGJLIWTDGCTB   LVDRG           JXPSXRCXLCFQ    MOMIG          
FFXE            : IEDETKBJJOCWY  
MBOYH           : MUJIPYTBVDXOQQJ EJNBDBKB        NTCIVKVNMIN     EBGFFLXFFJO    
YXNX            : QERFWSWNTJG     HJESPTNXNLXL   
GCWQWBSOQPA     : ARRUKMUTNEVBYF  HSHVER          PVVUWDPPQWSLYP 
XKUDR           : IQYVIKVMHPBJMY  LLFMCTPEPNLSEG  PPMCYWSURVDACIN
HIHKWJUI        : YAMI            EREIYCHVSCLS    YLXHRTITSNULRK 
SXJJELIUKM      : XNNXVFNQCIMP    VODOKW          FQNIYH         
YDGBDE          : QQWVKWPTRY      EPMMFDDJC       VMWK            PQKEGYVNPK     
BKGT            : ORWGCJIQAVCX    GYJGTRSFCRPK    BEGMRWEG        AWKMYVNFASJ     DSFOIWGFCQP    
QEFQNAY         : BNVCJUMUKUU     HWIMEYNOHKKYOP  LASMSFSO       
SWHEDSOYDBO     : THPTFSDLHXJGS   OPWURBAPECAUGCV DBEBVHUF       
HWIMEYNOHKKYOP  : SIYULNATOWW     GSRAVB          QEFQNAY         CEOY           
ERQCMPMQSFI     : WTGQEERMSKAIEHM YAMI            JJICYCRIUE     
LLJRUIAI        : LIYTEJEWLC      LMKXMRNNEMUVG   CBNHMOMPBJYKE  
BVBJ            : NXQHSKUHCYDLCC  LAPHHAFVDQTXCP  CDNWTPE         MGIXHUU         LFOUWKEYAFBLW  
MKUECBW         : NJFKETSPYCWSJAY FLGQMUEQXLESL   OJIPIPNCAKV     VQBCTHHYTH     
ELIQ            : OVQFAGDPSJXK    AJMWX           AGHM           
DXNALBJEWTGFHIB : QUVLPCKDNFW     DOVKOJFUMFJCV   TNQDKNGGT       PKWS           
RIYEFEGHDYNOJG  : VTPMDLWASYBVM   PJMNIETFV       RUTF            MVGQSTYOTKACH   PCTQPAPRPYOMWS  CNPYDLACNCYV   
OGJO            : IOBQYFXN        SDTWJ           BTYKS          
LAYIUFP         : JSWVABSHIOVIXM  QPJVGESABWPIKC  FVPNUVDR       
PQOJBONHU       : GIGRHM          HMWLUGYUGJPAA   LIYKTOWRQEBOTG  LSMYJ           DHMEYU         
QAUGQGO         : VNSWVTL         HPIRLLUSHTDPFTO
VWWM            : PMWHLXECMS      RCKQR           RFQCGAX         PTBNLGNT       
KNQSKYIOOCDBDRO : OLVSGCJKM       XLTLNPNXRYBKM   PSMJ            WXVOVOTTO      
OLFOGN          : NIGHFSE         MDMRQ           UAXWSNSYOL      LHEW            IEGLOVO        
NETLCQ          : JXPSXRCXLCFQ    XAXKJGMULNYDYF  GAAUCT         
TCNNW           : HJVB            DOUUISFWVLH     QPSJTVQE        AOVPE          
MIMDMQEPKVFAHM  : UAIKGJAFC       WQHEPW          YLYTPM          PTYQ           
PBWD            : UJSJM           EDMASTNBOGN     VXCHAD          LMKXMRNNEMUVG   DSFOIWGFCQP    
QQJKR           : OHIWQR          HBIMYBUMJMVXWY  MOLQNKQUHTOQH   ASIGVVYPFAWP    YNSIFSMSTEJQOV  CIXP           
OFTNG           : OBJTIIRVBRNEQN  QDEXIRCIP      
VSNKLSDYQ       : RQIVGAKKPM      MCGAUWLQLNF    
BXWRNAPTIIM     : EJIXEWBCEEJT    VLGJQ           BKUGDLQTJAGKXR  SITMVOVVIVUF    HNPUE           IMPMGMY        
UEXJKTASEX      : EUSV           
SJANMYEWACTR    : NIGHFSE         QCYKEPIJLPKRPJ  PPMKNYWYFYOQW   WTQDTIFWKBNBIFN MBABAMBWDOI    
UJLDUYWPFXC     : NKCUDUVFWBAOGJ  PBDBTOOHQJ      CPPQLJHLMQI     VNWOFMYF       
RCKYAWRJYFVX    : FMGBYUCGOY      GMUGXOWARWI     VXCHAD          LIBOETCNTXTDERQ
SANPTFKETPBUM   : SLDWVIBKSAYLRNU XDRBVNO        
AKSSFUDEVCV     : DJLN            TFVNMCW         SDKHQOYA        QPSJTVQE       
BDEBOY          : VWKTQ           QTATIIWBDQITHH  HISBKBIVAFPXLAQ IRMW            CATTOWRG        HAKJQWB         GLMPIKXMCKL    
COVJBCDQ        : UERBL           KDYQIQDBJW      ECCUR           HENGMRXIVOFYVI 
XGVYQPTXMWCK    : LADRCSFY        HNKMNWV         LJDRF           WUPB            MEOFVD         
ASBFYDTAGXR     : JGSBHXVB        EIYKL           SVDEWPYLNFDSGDW
ISGNMLO         : XTMPBNJF        FJPFWMJLEF      FBDLJLNCCSUHH   OOJIENW        
INLAHKO         : CDFXGBLQXL     
OAGRUKWV        : CQAM            UEVAAHB        
RXTPPYALHOA     : AWXRVE          BRWIXGVVGEYGKSO YBDRCMJI        OWQDPEFLXGTM    WQHEPW          TXXAAU         
DSESGEC         : QJHMHFGIEJJRABD SBSNMKXEQBURDLI GTOWE          
UIIWR           : KLFPCOABFRWAMBO WAGRURMLQCVH    VQYNOYUE        NTCIVKVNMIN    
RCYPPSOLLGM     : ARRUKMUTNEVBYF  GRJSTBQD        RQIVGAKKPM      AKPDDSDODN      YJTCODB        
TUCTQFMUA       : KGATSMQE        KGCD            KYTXSFBLM      
BCOVNYV         : ALPEEIDXS       GIGRHM          GCEWUIDEFFWQYVQ GFMITG          AGHM            OANPOBMRQ      
YNJBGY          : ICGI            EUQLBLPQYEAH   
WMFFATAWVT      : FNMHLBV         BKUJQMUSKDBKO  
EJKEF           : FLTBNIMARV      UAOPENEPVAGX    MFWLBFBHSQKGB  
JVLYVHGWXPX     : JKTUV           VCKQF           JDBCPLFX        MOMIG           AXYJ           
QUDDCI          : LVDRG           EWUDT           BLWRXUBHBJXQOD 
VKCUF           : PLQOC           AFILY           EHCDAXHFFHQLHW  FHKMXYRVUQ      HSQAVRETRYFXBNJ
YQEFXTQ         : FPPHCBXKXLWF    UVRWXE         
GRPNXNNNN       : BVLHSEVGS       WXRLLY         
EIYKL           : LADRCSFY        ASBFYDTAGXR     QMVQIIJTLBR     VIGKXJBMGLYRJ   YIMLFSSUGDOYCIR DJPFMFGWKW     
RJUWECOFSV      : PTONVNWHGXL     QKXEF           OIYSILVY        NKCUDUVFWBAOGJ  MGIXHUU         SVDEWPYLNFDSGDW
QPELXWDM        : WXRLLY         
QCNFWRNVEBGWL   : FWAEKDBSDBMR    IOBQYFXN        YRVLELKEMQFBJDI JBJUOVFPFBX     DNNGGJF         TJHR           
TPGKVA          : HJVB            ESYVPBIYWUGLG   OXPDDW         
JSYPGWOKLMDOAIN : OCSXYQYYANEKOSU NKVHCDIWADYI   
YLBAUXNYTG      : ALPEEIDXS       PYMNAWFFEY      ROAQOPG         SMXQKICA        SOUVOYSKRTMLCV  KPKSKW         
ECHNNDOFJ       : LHEW            BMGUVCBX        GXNASQ         
UVAJAQLIE       : LAFKCSUUASM     DYXHCEC         EQGKHSRJFKOOVYU FELEPVSPRFL     BWETLYKVTH      LIBOETCNTXTDERQ NETODJLCWNIQYA 
JRGMMGANAGVHKFU : RCKQR           XBRTKJXF        REKAUI         
ILIUYDQYOSPACV  : QSDJFE          MJJANOAVPDEFBAG KHJQTSDH       
NQOADUD         : FGBCTDXGXWCAXW  BKVOPSJX        GIGRHM          VMLWDIKTCUGGK   FGGEAQBTLC      KWEP           
XJPFWWC         : AWXRVE          UTKIAGEQPMFCBO  YIMLFSSUGDOYCIR
INHDMKVMBPE     : KLFPCOABFRWAMBO JHAQGG          IPQGHBXLIU     
TDJHTAKYUNUUYMA : TBJDUSLGNNMTYN  ORWHEYLQQXWJNGA VODOKW          AXFRKFGKSNJXVQP WIJNHCVILNWKQRU QUDRTITQYPPYA   AGUQJLDST       NEOAVXOV       
TDJHTAKYUNUUYMA : JAYJXAUCRVH    
KCVSRDXFQTTTL   : QERLGKS         LINVV           GKKJKYXUJOEDC   JXDM            VCETOCUTMGV    
VFDHPYHCB       : QYHDQR          VHYPVKKLBTVX    JGXG           
PVAQJCPVFLOWQ   : APDIA           KGOASCHGUHU     XDMSCXGA        SWGVO           NLOEVGRJHBU     KJFJ           
EJIXEWBCEEJT    : IHLXBYMI        JEYURDJGGD      UNROD           BXWRNAPTIIM     YDFQVERTIDKP    ROPIVCKXDL     
SVJW            : XXQVNSPY        TUHRDOKMABIY    QPSJTVQE        SORWXGJXGXEM   
FYFQ            : OHIWQR          HGKLY           KQVPNIAXXFOCW   NWLFBIQYU       BGKY           
UMJIDIBRN       : CMKIRKWSKLYEY   XLTLNPNXRYBKM   COYTH           RSMRGWNDJH     
DNRAO           : HTIYP           FJIEKD          BXVXSLKO        KBJSFWNY        JGCHLLSXJT     
EVHYEAWNY       : UGYYGXAHT       YENOKRUMFKISNRR
UBUMDRBMCHUDY   : ADWAHOXOFUSABQ  GMCBGTSIUCEUTS  HRQQ            PSGPWDEN        FJPFWMJLEF     
QCYKEPIJLPKRPJ  : SJANMYEWACTR    JMMWJHSTGQ      ONXGM           GRJSTBQD       
RWBSTPXLSK      : ADNWV           EPMMFDDJC       EYRR           
AHTCUMGTALLIUA  : VYWHCU          VAXVKWGKLL      BJFLLCO         REFGEIRGPDSIAT  VHGVWHIVKP      HDCCX          
HRQQ            : KHKRHTHYHGUHEJ  UBUMDRBMCHUDY   DBHXRV         
IOBDIQBWJN      : KGOASCHGUHU     MXIXQJN         POYADYRWECPW    HKMWHMLQTXPCT  
MVGQSTYOTKACH   : SGRIID          MYSIUTKBYPB     RIYEFEGHDYNOJG  GCEWUIDEFFWQYVQ ATCKPEDIISQWR  
DOUUISFWVLH     : IPPQHHW         QYHDQR          TCNNW           ATCKPEDIISQWR   HATPDGUOVC      LLKKNHIS       
MEXDRMBXDTTDIP  : SIPADDNFL       SYHCL           OWUNBXDGMDJABJT XAXKJGMULNYDYF  FOEP           
IUALXQGSYBBVWM  : OWUNBXDGMDJABJT HDJGAROAEJU     HBDFQQOHXHLKRQ  YLXHRTITSNULRK  UCLGRIRJGU     
LBMJEEY         : VNSWVTL         AILJWB          CUYXSKJWRRS     FJPFWMJLEF     
FCYBHH          : DXPHNVEE        AMUGFFCPNTN     MGJGJBSB        CIXPLWWRSU     
AQMAEKQ         : LXCCXBJTCLA    
GQNH            : QKVMK           FIAS            OKXXLF         
MVWAWKLC        : LJTCX           NPAYFCUVBRL     TKYUMT          EUOADRVEGJGPSF  VFYIYIYOFAVMOA  BMGUVCBX       
KHVNHX          : MIOFPK          CUYXSKJWRRS     ASJRTXBPKBYI    PEEHHDRKMGGT    OXHMX          
ORWHEYLQQXWJNGA : URLSQWOINWA     CSDIBTORGV      LMQNMNPWVOKNO   TDJHTAKYUNUUYMA QVXUKPCKDMQCT   IPQGHBXLIU     
CXCAKOEBYLX     : CMFGWANJKNFRADA JDBCPLFX        QPSJTVQE       
SXOKRLTVNIOE    : WQSKLYEUJJRLJR  AMUGFFCPNTN     JMJVWXXBPYPWLLU STNEUAX        
OPWURBAPECAUGCV : SWHEDSOYDBO     MWELYKJQXSXG    OCMILMRTVMWCILI HVYIOLDIXOMVEMY
CLNCCAT         : BKUJQMUSKDBKO   XDRBVNO        
TRDCIJLWYKUR    : BIBVUAVIASAONAH CEAVFWCWQ       KKENPDKS        WMXEPD          KPKSKW         
UJRWM           : RIOR            MDMRQ           MBWXESIQLGV     YXBXBH          SJCJQXYWQMI     MTLCEGRC        SBBXYQHYS       VCETOCUTMGV    
DQLWU           : MCCPRQBMB       QUVLPCKDNFW     FWAEKDBSDBMR    JUKFIBE         CLCQAWFV       
MWBMS           : JLTQI          
HMWLUGYUGJPAA   : JPMQPWKRIA      PQOJBONHU       UUSBPKRVDWTWAH 
JTJXJOOW        : RCKQR           GQHSJJ          XSCNFEOSDDN     YHWBRGLVI      
JVYGYNBRU       : QKXEF           FQQX            PSJVG           AWYFLXJUKETYUS 
OJNVIIE         : UBGCTLJT        XFJYU           AXIGU          
XEUKPOTOAKD     : NXQHSKUHCYDLCC  TYOVMP          AGCBD           QJLCPQW         CVORSPH        
VNSWVTL         : LJDRF           QAUGQGO         LBMJEEY         NIYEN           VVIXPAXCB      
MIRBTFWDNDANHWA : FNMHLBV         IWBYEIGG        KURNSASCJKUHVY 
LTOMGTLDJ       : LHKITEGOIFUJPBK MOMIG           SQEMIMYNFDTT   
CIBPKNYCRSIQX   : NXQHSKUHCYDLCC  SDTWJ           QBLVLQNB       
UXOCUOEJLSXR    : YMEVBGSF        RIOR            SYHCL           CRVPRPKSFPRY    SHSLM           HONFVTWQYYUDDHS HNPUE          
JWBQAJUP        : OOCRLENDHRIDH   IXGEAB          LRDWHA          FPMJLU          NFYWX           NYCKHAOJIWJTFS  EWWSWMRTELTYB   QVJWHMKCJFEVDHK
IQWCKHT         : TWVVQMTN        USYNTPBYJN      NCYSQBEJUCARN   ROMPEYSBQTQJP   EMDCQUMWMHULXIK
FOLTSGLXRWSPOK  : IORLWVA         YQMXTHGVUOKSW   RSMRGWNDJH      YENOKRUMFKISNRR
MMSOV           : BCQXMMHIN      
ESYVPBIYWUGLG   : TPGKVA          UHDGNVHXYJBXLYX UVRWXE          TJHR           
HPOHHLA         : EEJJYCBQDGKTVKV XDUJJSX         WSKVYISVFFJFRPF
CLCQAWFV        : DQLWU           REFGEIRGPDSIAT  WBVTYNMVSFXHTV 
MOMIG           : ADWAHOXOFUSABQ  JGGK            JVLYVHGWXPX     LTOMGTLDJ      
SHPPO           : SLDWVIBKSAYLRNU RBLGHKYJUCTYL  
WRKMGRVT        : XEOOXRBQOPNIV   GRJN            HPIRLLUSHTDPFTO HKMWHMLQTXPCT  
VVIXPIVUGJHXX   : KAPTYNWISKJMLKL CMICWONOJWQWXM  SHSDVK          MWELYKJQXSXG    BWETLYKVTH      TQUVNYBUDXFMY  
EPMMFDDJC       : CEIDNFLCKUA     YDGBDE          RWBSTPXLSK      XJIAJSK         BVNTYNCDRLRVL  
VODOKW          : LSVDVMMFMVLVEC  SXJJELIUKM      TDJHTAKYUNUUYMA NWROMGJEQMD    
JUTHKCDIIO      : LLWKMUHUNLYHA   MFWLBFBHSQKGB   HENGMRXIVOFYVI  SDHFWFLV       
GOKNFY          : RBHLQJNCWKJ     GWSVVBNJ        FSMYINKVCHHUN  
MEFXGAUWD       : BIJRLTNXBMJIF   QKXEF           IUSSM           TGRYVYFKRIPGAJU TWEMREKLUKD     CCRKQCOJTULNT  
KCWTWQB         : RAISKEDWP       CALDYRPHI       IUUIXOMWVSNFF   HNPUE          
SHSDVK          : WGQMYTRWRHKATY  VVIXPIVUGJHXX  
LWAS            : CDNWTPE         LQTKXVHUWCI     JWKOALTOIU     
CFBJGKLBHQO     : SWDGDTREXB      ROFQSB         
SLLR            : GTOWE          
NCYWWCSKO       : UMEQV           NVEGHNHS        AYSNOXIPRV     
HOBGSJKCPUPSC   : FDPMKC          MNEBNKTS        CTIJVMQVSRH    
HWYSIRWXVVUV    : LJTCX           HJMCXBDKOIXCLWT FHEAX           XBRTKJXF        DBIGALGJAVPCL   CEAVFWCWQ      
QGPYPGBWCM      : TWVVQMTN        IBKDJPCHXHOCFC  UQOEQE          VBEH           
GCEWUIDEFFWQYVQ : CSYITX          RVGICQLS        BCOVNYV         MVGQSTYOTKACH  
TOQV            : OJLSOHUIWHHETHO FRSFCCBCM      
YLGPUJOYVX      : PEPYTWSK        XGYAPJYJN       OJIPIPNCAKV    
AEEUOKBWRANQVGL : BTYVMR          MHSLIUBQEQUFQD  KKENPDKS        EJNBDBKB        RLNOWT         
UFOCECJTYUKXRI  : ONTKYNYCDOFMXB  BXXY            TWNK            GXNASQ          EOWQUVWDJMIF   
ROMPEYSBQTQJP   : GFGGSTCPWXEJFQ  IQWCKHT        
XKSDYWJBIGDEQD  : OTTQWE          VSLUWROLSYJD    KMCDDOJUMAP     JAYJXAUCRVH    
CLRQBJU         : HXBINSLNREEK    IKDMC           WQHEPW          OXPDDW         
DXTWODMOB       : MIOFPK          LEWEHNJOB       PKWS           
JGXG            : VFDHPYHCB       CPNGDFAACPKMSB  IISBVBPQX      
CPYFTRKRTWLL    : JNTITBUOV       FLMMFVARXTLU    XBRTKJXF        EQGKHSRJFKOOVYU XSFWNIAUFDF     HBDFQQOHXHLKRQ  YLYTPM          QVXUKPCKDMQCT  
CPYFTRKRTWLL    : HNPUE          
VIAYJVVXAIO     : GQHSJJ          XIGSCMS         DHMEYU          IVKMU          
IXMIHFMWER      : HQUBUFV         CRVGAGTIDPOJSI  CIXP            NETODJLCWNIQYA 
XDMSCXGA        : XFJYU           SBGKXFOKKFS     PVAQJCPVFLOWQ   PIPQPXGAI      
OCSXYQYYANEKOSU : JSYPGWOKLMDOAIN JRMB            DYJTTLGJ       
XIUECPD         : CRNAVFGX        QSDJFE          FIAS           
EVJCE           : QMELHXBVJENFF   FVVBJPF         OWQDPEFLXGTM    LUAFMOAKAOBNVO  SORWXGJXGXEM   
YSMTTLLUMN      : MXIXQJN         YXBXBH          APMUOPWOBD      NQOQJTBAMN      XDRBVNO        
SABMUYMFTRILUPP : RFQCGAX         NKCUDUVFWBAOGJ  BXYIREQRG       TAXJJIA        
AUYLTT          : VTPMDLWASYBVM   MKJLQYAF        LSEOG           GMQNEPVNUIKNL   DTLDFHRMG      
PNNDKCQVVSWKQYW : BCCKLMHPWCE     QPRYYWUVCJYBD   CCGOKWDADT      UNPDCSFKGTBQFY  VYNGYBPJUVUCFST
SOEHLUWGWRFINA  : UPEPTQWC        UVIJBB         
GPYJBC          : GLMMHVX         GAVMV           ARRUKMUTNEVBYF  BTIDWHYMA       TKHHMGG        
YAVXKMWJJSBPA   : GAVMV           QBMJVWAINRLHEF 
KWVJR           : VHYPVKKLBTVX    VWJJIX          EADC           
UHDGNVHXYJBXLYX : ESYVPBIYWUGLG   GKKJKYXUJOEDC  
MXIXQJN         : IOBDIQBWJN      YSMTTLLUMN      QLICMLHIS       YJJCKURL        APSUDWFJUCNH   
XBRTKJXF        : UYSP            JRGMMGANAGVHKFU HWYSIRWXVVUV    CPYFTRKRTWLL    VUEBDNR         RCMTUWDAAJFAH   FYJXKRXPVWN     RIKHWXICOJYIOKQ
XBRTKJXF        : SNDKXMW        
DNHYVFXHI       : OOCRLENDHRIDH   LBOSVS         
TIYRW           : MYQQCJUSJ       ATNKWXBPPAG     VQBCTHHYTH     
CWPNKI          : WFUPEBVKUEKO    KNYQLRYNGKU     GRBCMQXCVML    
LAIYM           : ROCBDEBEKLSUJX 
GGMUPNQVOXG     : HUUSCSWBIORVUUX EIEVVCLRSFIV    KPKSKW         
TQNOPK          : DQCAYY          HTRPDKQHBX      LEXNIPQERVM    
MAHXKTLNCKCLRKA : VYMTEQLQLXICQ   LDQWADXQNJHH    RMGQONFPKVUYWD 
ANFXCFFRCXFQOS  : HRTGHDAOI       JHKOCMHAJAEE    LEUTARAKJBX     PGTLSUWPSKHRSP  HSSY           
BUSBGMNV        : HVNHHPOXHXN     RVVROQJWHDTSEW  FICQTYFROWJC    PEPYTWSK        MWTWQUWJNRV     UCLGRIRJGU     
AXFRKFGKSNJXVQP : TDJHTAKYUNUUYMA MPNKHJBYBIO     KBJSFWNY        PJFAISOIGEN     FVPNUVDR       
OWQDPEFLXGTM    : LAPHHAFVDQTXCP  RXTPPYALHOA     EVJCE           VJEXMCOCOQNSCS  BPFYPAWXP      
REWRJ           : BGUWEWDJ        PPHOXEYMUWMKJ   ECCUR           BABTBVEYUOV     TWEMREKLUKD     UNPDCSFKGTBQFY 
CQAM            : OAGRUKWV        FETCQXVPURNYBJW
NXILO           : RDNWHSAJYERXHF  FNYVEUWGSLF     FRSFCCBCM      
LEWEHNJOB       : DXTWODMOB       WQHEPW          CTIJVMQVSRH    
XWTV            : YGTCHGSAJXPGKJ  RDMKMCCQANFKVV  EUQLBLPQYEAH    JULPHHC         IBNCTTFCCF      TQUVNYBUDXFMY  
BSIMKMEKYQAABO  : NDUPTSIODUP     WIKNHX          DYIAGOVHIEMHNMU
BCSXHDNSTQCT    : RAEGU           JDSRPEQ         HBKEBVIVVR     
XQGYJQOVDUI     : DPSVEFK         UDCYKQQBD       HWUN            FPMJLU          PPHOXEYMUWMKJ  
LLFMCTPEPNLSEG  : XKUDR           LBOSVS          DMAIBKHKO       HENLXPYTPT     
WIJNHCVILNWKQRU : BHVJHVL         TDJHTAKYUNUUYMA NRGD            UJHDL          
DGBRIVHPLXBGE   : HYQV            GKKRFYOQOIYKJV  RYWCNUBOOPNFXV  UCLGRIRJGU      IVKMU          
UBSG            : IKDJHRFBD       UAXWSNSYOL      NUTWDGTMYKVH   
AILJWB          : LBMJEEY         PKOXMOIXSJGUAT 
JRBEOENPYXNGN   : TVYSAQSBBSD    
GRHKCFM         : BIJRLTNXBMJIF   EOJKMV          EQNAJLOWKSFU   
LDXU            : ASJCUD         
HTRPDKQHBX      : VPDPWBQNQKBH    RYGS            TQNOPK          EVWIYJ         
QYVHH           : PBDBTOOHQJ      GFRHQOKGGQWRCL 
IOBQYFXN        : OGJO            QCNFWRNVEBGWL   COFTXMVIHLQ     KPAX           
JTBGKKAFC       : KDTRSUEFUPC    
PVNSVKLUISCS    : OAAIDXU         UPEPTQWC        LFJX           
QVUSESIHECIN    : WRABJ           EUOADRVEGJGPSF  UFKDXAKCGYEYV   SRFQEC         
UNSWVKSLDOX     : XWBYCVNBCIN     BCCKLMHPWCE     WXAAXJSLLWACJCT WMXEPD         
JHKOCMHAJAEE    : BHVJHVL         ANFXCFFRCXFQOS  JPAB           
LINVV           : QERFWSWNTJG     BTYVMR          KCVSRDXFQTTTL   KNYQLRYNGKU     WPKMSQJ         FOEP           
QMVQIIJTLBR     : QULQTSXEWSO     EIYKL           JLQWXNWLSHRQ    YCYFYQEMEL      HNPUE          
MBNBDCLENN      : NVODSKPDNHIXJEJ BFGYCAJSPRX     KASDMUC         QJNQCXJN        HAKJQWB         ARXICWKGGB     
RYWCNUBOOPNFXV  : DGBRIVHPLXBGE   LSEOG           BPFYPAWXP       ELDNUWT        
TKTNPHRFKUHV    : QREAOMFB        EQNAJLOWKSFU    MXWTYTUBF       SSHP           
WKMQJ           : VYXRSU          EVVOMT          CKHETKOBUDLPQX  AOVPE           MGCGVEVPWX      NWROMGJEQMD    
SWGVO           : WNRAOVTJE       BVLHSEVGS       PVAQJCPVFLOWQ   EOKPNLAJLDA     FNYVEUWGSLF     AUYAWVDPSMMWPBD
LECLAVHMPX      : SLDWVIBKSAYLRNU NHULXGMLXFLEFSX MNEBNKTS        JWKOALTOIU     
YPHMMQIOPUBGH   : CDNWTPE         UAIKGJAFC       HRTGHDAOI       ULQJGCQKCWJSWWI IOGTMLXUPWHE   
CGUXW           : XOVNAFFMEXXPY   BYODJFS         VFYIYIYOFAVMOA  GMUGXOWARWI     WWRQBDFKYSQDIA  HSQAVRETRYFXBNJ
MBWXESIQLGV     : UJRWM          
VFYIYIYOFAVMOA  : MVWAWKLC        CGUXW           BEXHCXIJBBHAOL 
KASDMUC         : MBNBDCLENN      GRJSTBQD        NNNLPFYOFFWU   
BVVTJC          : YNXLSRDWGEDRKS  DXIMMIUDGV      HCFGOVPVT       EGHCXNI         PSJVG          
VAXVKWGKLL      : AHTCUMGTALLIUA 
JBCJWOK         : DDRUBXR        
TYOVMP          : SACNSWDP        XEUKPOTOAKD     ESQBNPWKSEQ     DCCOCK          WWGKJONLISURGCW UTCGVOMJOH      WQCXR          
IKDMC           : QKVMK           WQTGXYDADUGEDT  CLRQBJU         NEYXPOVDUKMRSS 
OCXA            : THPTFSDLHXJGS   BAPQJKWCMLWNNQ  PENAEEJMBU      CDBMMNOKLX      YGGB           
EMNRYYUDJT      : PSWSVLTVRTTGVVI NYKFTB          DXBU           
VMLWDIKTCUGGK   : QSDJFE          YNBBEMUGDG      NQOADUD         UJSJM           YCYFYQEMEL     
IYNIYOOLCGN     : LHKITEGOIFUJPBK YHVR            POUXILQLFLJNKWC PLSDJXEBMUJJUV 
EQNAJLOWKSFU    : JOVNUOFC        GRHKCFM         TKTNPHRFKUHV    IPUEWOJIT      
ISUQDHBCUJEMXRO : IORLWVA         SKYVCRQVBPJG    TDPCRX          MJSLWX         
FSMYINKVCHHUN   : PJMNIETFV       GOKNFY          UJSJM           FIQPBVWITCWR   
JXYGQCOTHJD     : BTYVMR          TIODRQQPADTOPX  ECNNXKPJAKUH    BTIDWHYMA       ENCKIEISUNUHMC 
VDDN            : ROFQSB          SMXQKICA       
LIYKTOWRQEBOTG  : JBLSKGOCJKN     PQOJBONHU       CEAVFWCWQ       RONGXITBWAVUEA  AGUQJLDST       UNGWG          
TFFMKTGRFLFEOKT : IRRH            MFWLBFBHSQKGB   PWOAVKOFUGQKUS 
XEEI            : PIUOVG          BXMET           OWVQ            IOSUOFYSDX      UIKFLDNHLYIRJ  
SHSLM           : UXOCUOEJLSXR    SCND           
AGCBD           : FKPOCMSQNVJ     ONTKYNYCDOFMXB  BIBVUAVIASAONAH XEUKPOTOAKD     VPNPMCT         KYTXSFBLM      
IPUEWOJIT       : EQNAJLOWKSFU    CDHDJLTWJGOUHBS RUGIXCHSWCXV   
AELF            : VQYNOYUE        HVYIOLDIXOMVEMY
QJNQCXJN        : MBNBDCLENN      ECNNXKPJAKUH    SBBXYQHYS       JAYJXAUCRVH    
GOSIR           : IKSX            VIIUYXPUCMH    
UAOPENEPVAGX    : MCCPRQBMB       NFPEGPKKIKTI    EJKEF           NVRJSAHNFLQHFEY CJBSV          
RDMKMCCQANFKVV  : UNAKYXXQTEA     VMWVA           NBTLKPKQV       XWTV            WWGKJONLISURGCW NJIFLGWSCSM    
FPEAPSSTGYLFAR  : UNAKYXXQTEA     QYHDQR          ONXGM          
JMJVWXXBPYPWLLU : JEHQHHJUCGFIAG  CALDYRPHI       SXOKRLTVNIOE    DUCNBCHWRAB    
SKYVCRQVBPJG    : ULTGVGVIT       CUNCBHQABIA     HJMCXBDKOIXCLWT HCFGOVPVT       ISUQDHBCUJEMXRO INLHDARCIGLH   
CLDQWYPVARN     : HEVYPNLTCIOQG   CEIDNFLCKUA     JHUR            GLMPIKXMCKL    
JMMWJHSTGQ      : QCYKEPIJLPKRPJ  MOBERTORP       EMPU            MAVQKJWNRUTNL  
XHVYYF          : NXQHSKUHCYDLCC  FGBCTDXGXWCAXW  IUDTUXR         MLHTJA         
TJVWASYQQ       : MWJKCTMYNHRH    CONSAXIQYLTXDTC EBGFFLXFFJO    
KGATSMQE        : GRJN            TUCTQFMUA       BXYIREQRG       KMMISBTGH      
LXCCXBJTCLA     : TBJDUSLGNNMTYN  AQMAEKQ         VSPXBHUVUPH     LUWUPLG         FHBTGDSF       
FJIEKD          : DNRAO           FPUDWMMHT       YWYWGTENW      
DUCNBCHWRAB     : MRAULIAVNETVQ   JMJVWXXBPYPWLLU LDQWADXQNJHH    YGGB            AUYAWVDPSMMWPBD
MCQOATB         : JEYURDJGGD      RAJJ            JLPTLO         
VMWK            : NFPEGPKKIKTI    YDGBDE          SEGAA          
GSXSWEVTGJ      : EESQUAJBGYL     YDFQVERTIDKP   
LSVDVASKCJBED   : DSLXEBSO        OVNVHBXVUJ      IEYKYKFEOBEJGXG PCTQPAPRPYOMWS 
BCQXMMHIN       : WHIISOFQMMOVLF  LWMMCHBCKCA     MMSOV           CTNNYDFMPP     
HRWBXIXLEW      : BFSO            MWQOTAADHDLUI   ROAQOPG        
AWKMYVNFASJ     : SESDMQCV        BKGT            BEXHCXIJBBHAOL  SQPOIWVXIXLJKS 
LHSYQBMRIEQL    : PJHEBNCRWWRWEV  JJICYCRIUE      UJHDL           QUDRTITQYPPYA   PSJVG          
YKSFHJH         : DCEKNIKSHPAJAE  NVJAE           YGENA           HRVIDNU         FMESCWM         CWHDPGMKMSLO   
VTFSKMU         : TIODRQQPADTOPX  GLMMHVX         LSVDVMMFMVLVEC  WFUPEBVKUEKO    LKCMQ          
VBOGTPW         : KDLPUHB         ADVBXFUHRIBMP   IQXASWGNR      
EQGKHSRJFKOOVYU : WWMGT           UVAJAQLIE       CPYFTRKRTWLL    OVNVHBXVUJ     
SCND            : QUVLPCKDNFW     ROMTTLJUPPHKW   IRMW            SHSLM           OMDQOUHMLXMJDL  LQQRODQB       
KINLA           : DXPHNVEE        XFWIMGTFROV     YIMLFSSUGDOYCIR SBSNMKXEQBURDLI
FPUDWMMHT       : EWNOSVYKUCFIH   VXVDVYLOEPQTXYB FJIEKD          SJCJQXYWQMI     LIBOETCNTXTDERQ OOJIENW        
YFMLWBIV        : JSWVABSHIOVIXM  LCSNEQORFOVJ    WTBOEBOSWB      BVNTYNCDRLRVL  
DOASUQDFGQF     : WHPNYCLFGEHJBYU JPAB            AGUQJLDST      
XXXEUMQEI       : GMCBGTSIUCEUTS  KIWOAEC         OWUNBXDGMDJABJT QVAKPDMHMGAJV   SMACMUEQJLMKA   AJYHWCVHNWPIIJ 
EOKPNLAJLDA     : YAMI            RCKQR           SWGVO           DYRLRENT       
VUEBDNR         : XBRTKJXF        RTBTUYSIOAJMP   VDYTKVSSR      
PSGPWDEN        : DQCAYY          UBUMDRBMCHUDY   DIJBM           VSUHBXSF        FVPNUVDR        IAVOLCHKELQSFHJ WNTOSPAWUKO    
NLOEVGRJHBU     : PVAQJCPVFLOWQ   HAKJQWB         LNUVWEVERXXIAAW GVRTWXLC       
DIJBM           : PSGPWDEN        OCYGS          
ECHMSAVKWBRKLFV : FDPMKC          BXRBDHYYWR      MMEGADO         PENAEEJMBU      LBOSVS          EVWIYJ         
LTJDDQG         : KDTRSUEFUPC     KCPXEVIHUF      IPJFDEWF        TWNK           
FLGQMUEQXLESL   : JEYURDJGGD      MKUECBW         UEVAAHB         MQRVEUIFULIJ   
FKDWUPESRRMBW   : GFGGSTCPWXEJFQ  YRVLELKEMQFBJDI NPRSEDF         GIIUGCWK       
TDPCRX          : ISUQDHBCUJEMXRO BNLMSQQPXHXD    SVIFRJJQTYD     VFYDWTUMQKSI    MULVLNPOL       YNSIFSMSTEJQOV  OMIXSFVLF      
EUWV            : CMFGWANJKNFRADA
KCPXEVIHUF      : LTJDDQG         FNYVEUWGSLF     NIYEN          
CATTOWRG        : QLWTP           BDEBOY          PLQOC           IQXASWGNR      
WXVOVOTTO       : VDSMYCAWQBL     DVJKMNR         KNQSKYIOOCDBDRO DUEPLMGHNKFLY   YUWYRSR        
OBTFCXDM        : GPMIC           QTBSCTI         VCUFETNXVB      VHDAWTMQOYVYJ   DHMEYU         
ASJCUD          : NBJPNFPNESKIWDW HCFGOVPVT       LDXU            MLHTJA          ANMAXRHHITOHFPK
KCQQVPPRFNJBJAS : CQRIVEOYNTYJMNX
DMGFMJ          : QQWVKWPTRY      SLDWVIBKSAYLRNU IOGTMLXUPWHE   
TJNFOKI         : HDCCX           CDTFXB          XHEBD           WQCXR          
UNEOJVGEDVPEGRY : WWMGT           KHJQTSDH        NPBJY           PKWS            ROPIVCKXDL     
UNNDCYXY        : QJAT            JSWVABSHIOVIXM  OJYDLD          XHEBD          
NEYXPOVDUKMRSS  : WWIIYMUSHLOKW   IKDMC           PPMCYWSURVDACIN VGMH            KXPNHXFCYAGVFY 
OICWADE         : UVYVSOGFK       UVRWXE          XWCY            MQRVEUIFULIJ    XDKU            EIEVVCLRSFIV   
RTBTUYSIOAJMP   : WRABJ           VUEBDNR         HRQJUVA         LUWUPLG         BTVYXPP        
ISTUHN          : BPYGXHWWF       FYDVGMKSTK      PRPGQKLY       
BJFLLCO         : VDVRHEACEJBVQ   LVDRG           OKKSBSKSA       NVEGHNHS        AHTCUMGTALLIUA 
JMIFPFBQALF     : VTPMDLWASYBVM   YGGB            NNUQIBYQRKELQC 
URPTDKQXS       : VPTFFJLEVUWH    RDNWHSAJYERXHF  UCOCYRUENLOJIQC
OVNVHBXVUJ      : UTKIAGEQPMFCBO  EDOH            LSVDVASKCJBED   EQGKHSRJFKOOVYU ONOURSYIWKMNV   LQQRODQB       
DPAKSQLEVLY     : VCKQF           UVYVSOGFK       FHEAX           OJLSOHUIWHHETHO BTIDWHYMA       YROUKJCNKWTMQU 
EVVOMT          : NYARUT          WKMQJ           YRVLELKEMQFBJDI CCVYLN          VBEH            FHBTGDSF       
SKHJGRMHPHQBNI  : OMRHECQCEPJAC   LBNHSVAB       
XDUJJSX         : OMRHECQCEPJAC   HISBKBIVAFPXLAQ HPOHHLA        
LCHHSVEF        : IMPMGMY        
OOAX            : UJLQQMG         NLLESYFRD       NWLFBIQYU      
NFYWX           : JWBQAJUP        ATHSCGG         KURNSASCJKUHVY  VAFBEKPNVFRAYO  CKSQYB         
KJFJ            : EIKUCMVNBUCVJH  QUVLPCKDNFW     HPQERPTSXMKYJL  PVAQJCPVFLOWQ   DNHAYBOAE       BTPULPSMN      
CUYXSKJWRRS     : QGXRINQ         LBMJEEY         KHVNHX          VEMFI           SLKVKUMH       
XAGOO           : OMSUPIYJFVBECA  BTYVMR          SHKKI           VYMEHIBVSV      XETWRUWSEVACIW  RYOIY           FGRBUIXWJT     
MXWTYTUBF       : COFGH           XUTURWOGDP      TKTNPHRFKUHV    ROAQOPG        
IQUNL           : VDSMYCAWQBL     WYDBY           VPDPWBQNQKBH    VYXVRA          GSLYSVKH        XHEBD          
LHEW            : WGQMYTRWRHKATY  OLFOGN          ECHNNDOFJ       LDQWADXQNJHH    VBKXXM          UBDXNAYLAXY     SJOISXKMWTQV   
VQYNOYUE        : KDTRSUEFUPC     UIIWR           AELF            DIQRBWUKCDXBC   MUBWWSOC        NWLFBIQYU      
ESQBNPWKSEQ     : TYOVMP          FUXYCSKGCBGD   
ULQJGCQKCWJSWWI : BIDHSPKJWC      YPHMMQIOPUBGH   AXYJ           
ROQVHJYWYWH     : LEKPA           TDLAHQVN        AKHGX          
BXXY            : UFOCECJTYUKXRI  MLEMFKMSOKGYCXE SDHFWFLV        OHFK           
OIQTYDXVMQUK    : YFUCO           VCGWMAGNXHV     TFVNMCW         GJYACHQOEDSJPTI
VEPODAYEWABFU   : SKJVXG          RAJJ            IUUIXOMWVSNFF  
DUEPLMGHNKFLY   : FVVBJPF         BRWIXGVVGEYGKSO WXVOVOTTO       LMQUYUK         MHSLIUBQEQUFQD  BPFYPAWXP      
HLAFQQTVSSAP    : CUNCBHQABIA     VHJUFAMHO       GQHSJJ          ARRUKMUTNEVBYF  JYCCQGXOJIP     MOLQNKQUHTOQH   IEUDDCUGGALTCM  IVUOIOSVA      
HLAFQQTVSSAP    : OKXXLF         
EUQLBLPQYEAH    : WAGRURMLQCVH    ALBFGQCYCQEWJQ  YNJBGY          XWTV           
MMFLLOXMTQFQOXL : JEYURDJGGD      PVVUWDPPQWSLYP  GTOWE          
NHULXGMLXFLEFSX : CMGUHGNTHS      XLTLNPNXRYBKM   LECLAVHMPX      LIBOETCNTXTDERQ
HGGTUG          : JOVNUOFC        BTCBQVOFJCH     CQRIVEOYNTYJMNX
RYNINNT         : XKALEFAI        FNYVEUWGSLF     ROPIVCKXDL     
DCCOCK          : MKEXXXBN        TYOVMP          OTGKTA          HJOSVJB         JAYJXAUCRVH    
QJLCPQW         : CBXTCISSCW      ITWRSJX         QOVEHVTWVP      XEUKPOTOAKD     GMUGXOWARWI     OJIPIPNCAKV     DNNGGJF         VSCOSIMTFL     
LEUTARAKJBX     : MIGWVYCHID      ANFXCFFRCXFQOS  VSNMTG          IWQNEUP         RLNOWT         
ONOURSYIWKMNV   : MMXSRRBDSMXG    QJRIKLKLFIDMTHT OVNVHBXVUJ      QDQIFBMUEGPLIRS EHCDAXHFFHQLHW 
PLQOC           : ITWRSJX         MIOFPK          QTMWTGYHWROGJD  HJESPTNXNLXL    VKCUF           CATTOWRG        FUNYMRLKBV     
VYXVRA          : IQUNL           YHVR            QWUMNQI         CBNHMOMPBJYKE  
DBHXRV          : HRQQ            FQNIYH          SLFESTNBAWFJ    HGKLY          
PPHOXEYMUWMKJ   : KGOASCHGUHU     REWRJ           XQGYJQOVDUI     EADC            SSDHHRTY       
ANKXPJTJL       : NVEGHNHS        MJJANOAVPDEFBAG
MPNKHJBYBIO     : RKSHDOH         SSTVJEI         IDAYNVA         ORSVWGLLLJLGIH  AXFRKFGKSNJXVQP YHVR           
PPMKNYWYFYOQW   : FUYWQBTHJCBO    SJANMYEWACTR    PIIJHJCVSHGBLYI FYDVGMKSTK     
CTNNYDFMPP      : ULTGVGVIT       KJQRGY          BCQXMMHIN       ADRRFJWUO       OOJIENW        
ROYC            : VPTFFJLEVUWH    NJFKETSPYCWSJAY
YRVLELKEMQFBJDI : HAFYQ           QCNFWRNVEBGWL   FKDWUPESRRMBW   EVVOMT         
YXBXBH          : BFSO            KCNOU           JFHMSNY         UJRWM           YSMTTLLUMN     
RWJJLJLRKGPV    : AOFSP           VSCOSIMTFL     
DIQRBWUKCDXBC   : VQYNOYUE        SAUCDENW        SSVOBNRO        OCYGS           NETODJLCWNIQYA 
BDJMWGYGTIUNS   : SAHYISDHNR      KDLPUHB         QSMUQJS         ASIGVVYPFAWP   
FQNIYH          : SXJJELIUKM      DBHXRV          KPAX           
DEXPIBOLFQMLAAI : IRMW            AEEOQF         
YREJMSENAUDL    : CKHETKOBUDLPQX  ESCNW           IJUCOIDRUXV    
KNYQLRYNGKU     : TEGJLIWTDGCTB   MDMRQ           OIFNOJERPL      CWPNKI          LINVV           RUKO           
XGYAPJYJN       : YLGPUJOYVX      OPXU           
VIOJJJO         : CSDIBTORGV      PJHEBNCRWWRWEV  PFNNYCI         RBHLQJNCWKJ     PBCON          
HAKJQWB         : CUNCBHQABIA     IFTQNKTC        BDEBOY          MBNBDCLENN      NLOEVGRJHBU     NFYADIY        
MHDJGDQHDIQEREO : HNKMNWV         JUKFIBE         CDFXGBLQXL      LCDUVRSUDSCOOXP AYSNOXIPRV      UNPDCSFKGTBQFY 
PFYBQNX         : IQYVIKVMHPBJMY  DSTFKKRFCGIGKOJ
PIIJHJCVSHGBLYI : RTCFBXPL        SHKKI           PPMKNYWYFYOQW   AKHGX           JMBYEAMYLTUX    IISBVBPQX       JYHEPN         
JBXBHOQWURXLH   : WNRAOVTJE       GVLEEPJJGCBP   
MXHUHQGLNB      : OPOIHYH         WTNNLNANP       CCVYLN          RHXRAXWHGRL     UCLGRIRJGU     
VCGWMAGNXHV     : OLVSGCJKM       GTWUHFTP        OIQTYDXVMQUK    HUUSCSWBIORVUUX
ASJRTXBPKBYI    : XUTURWOGDP      UTKIAGEQPMFCBO  KHVNHX          MFWLBFBHSQKGB   ICPTHTRNDDFCAJD
QOVGQREUXBIX    : QJAT            KCNOU           SNLTYLFKEXDSB   MJSLWX         
XXQVNSPY        : SVJW            BSVNFHTTMEGH   
LWNDKPDSA       : FGRBUIXWJT      XDRBVNO         SNDKXMW        
JYCCQGXOJIP     : HLAFQQTVSSAP    OROQYXVSKGD    
IPJFDEWF        : PNHRKAS         IXUDYIXKWNAWHAX LTJDDQG         FGGEAQBTLC      LIYTEJEWLC      PLSDJXEBMUJJUV 
IEGLOVO         : SKMQE           OLFOGN          KMCDDOJUMAP    
YKRXOTOWTFGE    : LJTCX           HATPDGUOVC      SMXQKICA       
BNLMSQQPXHXD    : DPSVEFK         TDPCRX          HOROOWLUMX     
JRMB            : LADRCSFY        OCSXYQYYANEKOSU MGTMVYKXFJ     
NNTLFPCCMIL     : VCWKCBJIEPLAXGH VTIEOOUCLPOVHF 
FMESCWM         : XSDNWYPVGRNJR   YKSFHJH         AYSNOXIPRV      ELDNUWT         DXBU           
MKDKPTWIIXMY    : DJLN            LAFKCSUUASM     KTYWXXLGXGMMORY VSHYVRUPRQABDXX
IKSX            : QCVAVFMFWS      JUPATSGN        BEGMRWEG        GOSIR           CEOY           
XKALEFAI        : BOULB           LHGAHLFXRM      RYNINNT        
CGNXUA          : PHHHXYHK        DMWSCBF        
GQWFBHFNGSVROV  : CYVEY           VYMTEQLQLXICQ   YMEYOXRDWYOUF   MBNDS          
MJJANOAVPDEFBAG : VPDPWBQNQKBH    ILIUYDQYOSPACV  ANKXPJTJL       PENAEEJMBU      VQBCTHHYTH      QRQSLMTLELNJCFI
IWBNXISLPNJJC   : MKJLQYAF        EDOH            SQGJLEODFLQYAWC ORSVWGLLLJLGIH  CKBQMQPJNGE    
UQOEQE          : RQPG            QGPYPGBWCM      HBDFQQOHXHLKRQ  QIGLAYHBTSSWFVL QYVHN          
RDNWHSAJYERXHF  : BRNAPTLNFVDJRKG CLQQWPUJ        NXILO           URPTDKQXS      
RAJJ            : MYSIUTKBYPB     SPTDYREFXP      MCQOATB         VEPODAYEWABFU   UFKDXAKCGYEYV   SEGAA          
UUSBPKRVDWTWAH  : IBKDJPCHXHOCFC  HMWLUGYUGJPAA   GRBCMQXCVML     EMDCQUMWMHULXIK
JAVTCCNAJTYEVK  : HVNHHPOXHXN     PQENJJMWTOUAUAX CSEI           
MGJGJBSB        : SHKKI           FCYBHH          LEXNIPQERVM     GXNASQ         
XARVCBRODQI     : QKOPGFAVTI      IIKTY           BTVYXPP         OROQYXVSKGD    
SVIFRJJQTYD     : YMEYOXRDWYOUF   IORLWVA         TDPCRX          FYDVGMKSTK      PIPCFWPTOJR    
KJJMENMDPG      : SHKKI           KDLPUHB         LEXNIPQERVM    
UJSJM           : UKGTAJJWMAL     QCJKUG          LSVDVMMFMVLVEC  PBWD            VMLWDIKTCUGGK   FSMYINKVCHHUN   CONSAXIQYLTXDTC
TUHRDOKMABIY    : BPYGXHWWF       SVJW            EDMASTNBOGN     HBDFQQOHXHLKRQ 
LMQUYUK         : RCKQR           FQQX            DUEPLMGHNKFLY   AJBDIV         
ADVBXFUHRIBMP   : BWAYELSH        VBOGTPW         VIIUYXPUCMH     PVVUWDPPQWSLYP  AGUQJLDST      
REFGEIRGPDSIAT  : QMELHXBVJENFF   XNTDIJ          AHTCUMGTALLIUA  CLCQAWFV        ACEOXO          DBEBVHUF        YROUKJCNKWTMQU 
LJGQFHOMEXEP    : HANWVDGCKY      SKJVXG          WWGKJONLISURGCW KPKSKW         
TFVNMCW         : RTCFBXPL        DMXPSKJJJUHNPQY GSRAVB          AKSSFUDEVCV     OIQTYDXVMQUK    RHXRAXWHGRL    
MOBERTORP       : HISBKBIVAFPXLAQ JMMWJHSTGQ      RSMRGWNDJH     
FYDVGMKSTK      : FDPMKC          ISTUHN          PPMKNYWYFYOQW   SVIFRJJQTYD     LUWPMKY         STNEUAX        
JLTQI           : MWBMS           NHOBSXQ         HSHVER          MMIVHHWNT      
FMGBYUCGOY      : QKVMK           RCKYAWRJYFVX    LOMAYKVL        WLTXEV         
HOROOWLUMX      : GSRAVB          BNLMSQQPXHXD    XETWRUWSEVACIW  RONGXITBWAVUEA 
IJOTUKKDT       : BNVCJUMUKUU     SSTVJEI         FVLJJN          EESQUAJBGYL    
RBTRXXANWWUM    : YHXMDYAR        KQBFLTBUR      
LDQWADXQNJHH    : BRNAPTLNFVDJRKG MAHXKTLNCKCLRKA DUCNBCHWRAB     LHEW            HBKEBVIVVR     
RUKO            : RBHLQJNCWKJ     KNYQLRYNGKU     MYQQCJUSJ       SRFQEC          PKWS            OPXU            TKHHMGG        
CPJVPHXDFVAT    : OTGKTA          PCYMYF         
MWELYKJQXSXG    : VXVDVYLOEPQTXYB EMBRYYYPYGFAK   MIGWVYCHID      KJQRGY          OPWURBAPECAUGCV VVIXPIVUGJHXX   BXVXSLKO       
SDKHQOYA        : VPDPWBQNQKBH    AKSSFUDEVCV     GMDQD           OXHMX          
OJLSOHUIWHHETHO : TOQV            DPAKSQLEVLY     CDUYRGSJXA      SGLHCMO        
AOYAWYSAL       : UBGCTLJT        YDFQVERTIDKP    BPFYPAWXP      
QABSPSDCNTLI    : IPPQHHW         JXPSXRCXLCFQ   
JQMNMVER        : HFXKKGTJ        WQSKLYEUJJRLJR  XWPNGMMPORJ     QBLVLQNB        EOWQUVWDJMIF    PLSDJXEBMUJJUV 
SQWQPRSBUMEXFTS : BTYVMR          MDMRQ           WMTXCGJA        MLEMFKMSOKGYCXE
XGFKRMVKBJWXN   : UKGTAJJWMAL     AWYFLXJUKETYUS  CDNGDAQRQDXF   
VIIUYXPUCMH     : QBDDHTECXNI     GOSIR           ADVBXFUHRIBMP   UCOCYRUENLOJIQC MGIXHUU        
MMEGADO         : WNVQAKHGBYDHD   ECHMSAVKWBRKLFV COYTH           TAXJJIA        
PGTLSUWPSKHRSP  : ANFXCFFRCXFQOS  SDTWJ           COFTXMVIHLQ    
UPEPTQWC        : BOULB           OOCRLENDHRIDH   ODRSDENTXLM     SOEHLUWGWRFINA  PVNSVKLUISCS    SQAYBRAFIQKAVDA
LJMLMBSEKMPDK   : TKKARVXR        KIWOAEC        
VFYDWTUMQKSI    : TDPCRX         
KHJQTSDH        : VPTFFJLEVUWH    YWUJVKG         HRTGHDAOI       ILIUYDQYOSPACV  UNEOJVGEDVPEGRY ROFQSB          JWKOALTOIU     
GDLQRDWCRSISX   : IWBYEIGG        LMKXMRNNEMUVG   NPBOHNKL        JAYJXAUCRVH    
PSVG            : QCVAVFMFWS      FFDYAR          CIXP           
PPMCYWSURVDACIN : XKUDR           NEYXPOVDUKMRSS  BRLWNBTRLHAE    RLNOWT         
CTSFLLPHLYWEVDL : PIUOVG          FLMMFVARXTLU    KMMISBTGH       WTNXHVNVKD     
UYPUVIPPGU      : RTCFBXPL        YSXAMWATOXYIBJ  MWTWQUWJNRV     FYLNUDNYDWF    
IDEGGXYNLMFSXGR : QWAUPMLEMWGDJ  
CVORSPH         : CALDYRPHI       XEUKPOTOAKD    
NRGD            : WIJNHCVILNWKQRU QADXGTWXVIPULCS YUBFUFBSI      
BTJHAPPAPFNCMJ  : IOHSOTOCH       RCGYYPQB        GWSVVBNJ        XTWNYWX         IAVOLCHKELQSFHJ
SBFXYVPSNAI     : MAJCDVFQ        PFKODLP         IPQGHBXLIU     
ROFQSB          : CFBJGKLBHQO     VDDN            KHJQTSDH       
ADRRFJWUO       : CBXTCISSCW      HWUN            BGOPKNNUQXNRY   CTNNYDFMPP     
EREIYCHVSCLS    : GYJGTRSFCRPK    MKJLQYAF        HNKMNWV         HIHKWJUI       
NKCUDUVFWBAOGJ  : EYPWOMHIUHVN    UJLDUYWPFXC     RJUWECOFSV      SABMUYMFTRILUPP QIGLAYHBTSSWFVL
BXYIREQRG       : SABMUYMFTRILUPP KGATSMQE        NPBOHNKL       
PBDBTOOHQJ      : DSTFKKRFCGIGKOJ UJLDUYWPFXC     QYVHH           LBTPCAMXKMMLGDO
MHSLIUBQEQUFQD  : FAOFEYQVNKMLOY  TEGJLIWTDGCTB   BONIBKYRH       AHATXHECYYCES   AEEUOKBWRANQVGL DUEPLMGHNKFLY  
WTQDTIFWKBNBIFN : JHUR            SJANMYEWACTR   
TWQHGLKYRC      : EJWWRXEJQ      
YUWYRSR         : JOVNUOFC        WXVOVOTTO       HENLXPYTPT     
PBCON           : CRVGAGTIDPOJSI  IHLXBYMI        VIOJJJO         VPKS            TIXVH           AOFSP           HVYIOLDIXOMVEMY
DOOK            : WTGQEERMSKAIEHM WYDBY           EEJJYCBQDGKTVKV QSRGHSQDPJ      VHDAWTMQOYVYJ  
KGCD            : RRPCYITXPOBKOK  DTPSXOFJOAFP    JRFQXTPPPJU     TUCTQFMUA      
KQBJJDGIADJRYCO : CDHDJLTWJGOUHBS TXXAAU         
FRFSXKHMUO      : QBMJVWAINRLHEF  HUUSCSWBIORVUUX
DQDTDUUMG       : SSROOJB         NPAYFCUVBRL    
SQAYBRAFIQKAVDA : BAPQJKWCMLWNNQ  UPEPTQWC        JPELAFBLCYGWVI  PNACMOLAQHIMGI  NHEUGUALRXI     VSCOSIMTFL     
MNEBNKTS        : LJYFPU          HOBGSJKCPUPSC   LECLAVHMPX     
WPBMVBFNBGQUI   : VTPMDLWASYBVM   NSIXEUS         ASIGVVYPFAWP    HGKLY           KGQYG           OANPOBMRQ      
DBIGALGJAVPCL   : EMBRYYYPYGFAK   HWYSIRWXVVUV    VSPXBHUVUPH     IQXASWGNR       XJIAJSK         YGGB           
VHGVWHIVKP      : WEBGVJWOHQ      AHTCUMGTALLIUA  AIABODPNQ       QBLVLQNB       
NYCKHAOJIWJTFS  : AVLTJVL         PFVT            JWBQAJUP        LXEIRW          SPFVLY         
CIXPLWWRSU      : GBWVALKHW       FCYBHH         
BQOQC           : RKFXSYN         GKKJKYXUJOEDC  
PENAEEJMBU      : EJWWRXEJQ       RSGXMYUAWK      OCXA            ECHMSAVKWBRKLFV MJJANOAVPDEFBAG GJYACHQOEDSJPTI
JPELAFBLCYGWVI  : SAHYISDHNR      SQAYBRAFIQKAVDA ARGVQBSO        UBDXNAYLAXY    
MYQQCJUSJ       : LQVOUFOPXBN     RYXQLHBJCANEHLP TIYRW           RUKO            OVQFAGDPSJXK   
WUPB            : YMEYOXRDWYOUF   QUVLPCKDNFW     YAMI            PYMNAWFFEY      UBGCTLJT        XGVYQPTXMWCK    KRTXIO         
AKHGX           : SHKKI           ROQVHJYWYWH     PIIJHJCVSHGBLYI GMUGXOWARWI     RHWTUYATGBP    
LBTPCAMXKMMLGDO : HONYNEGSVPLWXE  HDJGAROAEJU     PBDBTOOHQJ      HPIRLLUSHTDPFTO
AJBDIV          : OFARBK          GWQSTEPPJDC     UBYRPBDOAB      LMQUYUK         JWKOALTOIU      OCMILMRTVMWCILI
LNUVWEVERXXIAAW : NLOEVGRJHBU     AYSNOXIPRV      MGCGVEVPWX     
MMNBSTRKVBL     : FTJHPK          BKVOPSJX        GXNASQ         
JJWVY           : JXCJ            EESQUAJBGYL     GTOWE          
TVYSAQSBBSD     : FLTBNIMARV      JRBEOENPYXNGN   XDKU            OFNQMBVAT      
VSNMTG          : ADXU            LEUTARAKJBX     NLLESYFRD       LCDUVRSUDSCOOXP
LSEOG           : SJQSTHSKMO      CSDIBTORGV      AUYLTT          RYWCNUBOOPNFXV  RHWTUYATGBP    
ARGVQBSO        : VAVVDUD         JPELAFBLCYGWVI  GAAUCT         
NQSGT           : LADRCSFY        MWQOTAADHDLUI   IEUDDCUGGALTCM 
BXVXSLKO        : RAISKEDWP       DNRAO           MWELYKJQXSXG    APMUOPWOBD      GAQDTF         
SCMYQSIQKQPD    : VHJUFAMHO       WFUPEBVKUEKO    OJIPIPNCAKV     KMCDDOJUMAP    
KRTXIO          : CDNWTPE         WUPB            AIABODPNQ      
DLFDJFXUPMO     : RYGS            GVLEEPJJGCBP    QPSJTVQE       
QBMJVWAINRLHEF  : BONIBKYRH       YAVXKMWJJSBPA   FRFSXKHMUO      HATPDGUOVC      WSKVYISVFFJFRPF
CQRIVEOYNTYJMNX : GRJN            KCQQVPPRFNJBJAS HGGTUG         
ECNNXKPJAKUH    : CXUSDUHUBLDHJXX JXYGQCOTHJD     QJNQCXJN        PQENJJMWTOUAUAX
DKRTDCP         : HJVB            HFXKKGTJ        FLMMFVARXTLU    JLTRNPCDX       XDKU            IAVOLCHKELQSFHJ
QQWNP           : HSJBEJWCWXUFFWM CIXP           
CDHDJLTWJGOUHBS : MAJCDVFQ        IPUEWOJIT       KQBJJDGIADJRYCO YUBFUFBSI      
QVAKPDMHMGAJV   : ONTKYNYCDOFMXB  XXXEUMQEI       SJCJQXYWQMI     VTIEOOUCLPOVHF  RYFBGSQBA      
SAUCDENW        : SKMQE           DIQRBWUKCDXBC   CONSAXIQYLTXDTC WWRQBDFKYSQDIA 
YGTUNVNCMJEYB   : WXEQG           RKFXSYN         SQRKXDJXHPN    
NKXTKIPCDPWFVDS : NBJPNFPNESKIWDW MVHYIEYYQTKGBRJ HSSY            CDNGDAQRQDXF   
GRBCMQXCVML     : CRNAVFGX        MIGWVYCHID      CWPNKI          UUSBPKRVDWTWAH 
LOMAYKVL        : VOXNDDBXV       GTOOPVRGWPDWR   CMICWONOJWQWXM  FMGBYUCGOY     
ONXGM           : PMWHLXECMS      CMFGWANJKNFRADA QCYKEPIJLPKRPJ  FPEAPSSTGYLFAR  NTQDV          
CPXAXSDDHUBKQ   : YBDRCMJI        GUOFLIRSKLE     KGQYG           CDQXSLJFBUSYSE 
XSCNFEOSDDN     : RQPG            BVLHSEVGS       LRDWHA          SQGJLEODFLQYAWC JTJXJOOW       
SOXGT           : HYQV            XKVIKJH         SXOWRJC        
XSFWNIAUFDF     : CPYFTRKRTWLL    MNMOG          
TGRYVYFKRIPGAJU : WNVQAKHGBYDHD   IBKDJPCHXHOCFC  MEFXGAUWD       VVCSJUFW        FJPFWMJLEF      JOYCYHYUIODK   
PQENJJMWTOUAUAX : URLSQWOINWA     IIVRULXXLX      JAVTCCNAJTYEVK  ECNNXKPJAKUH   
GPPCPVP         : XQGFLDHWLB      MGTMVYKXFJ      YLEXFWQEJUJNT   AUYAWVDPSMMWPBD RPCOECOFOHJBABB
GFRHQOKGGQWRCL  : QLWTP           QYVHH          
VBKXXM          : NBJPNFPNESKIWDW HPQERPTSXMKYJL  LHEW           
OVQFAGDPSJXK    : QWAUPMLEMWGDJ   VHYPVKKLBTVX    ELIQ            MYQQCJUSJ       KQBFLTBUR      
QADXGTWXVIPULCS : MGVWFQSD        NRGD            ICNGMUIKRWCUL  
PTBNLGNT        : OTTQWE          RYGS            VWWM            LXEIRW         
GMUGXOWARWI     : MUTJMGDOH       LHGAHLFXRM      RCKYAWRJYFVX    CGUXW           QJLCPQW         AKHGX           RUNPL          
VGMH            : OHRKVCQJTA      NEYXPOVDUKMRSS  UEVAAHB         MCGAUWLQLNF    
HUBDHSWIIIQWDA  : NDUPTSIODUP    
RUNPL           : USQUVB          UHTN            YYVEIVJKOBVF    GMUGXOWARWI     RHWTUYATGBP    
REKAUI          : QJAT            HNKMNWV         JRGMMGANAGVHKFU AFILY          
HPIRLLUSHTDPFTO : QAUGQGO         WRKMGRVT        LBTPCAMXKMMLGDO XTWNYWX        
VVCSJUFW        : XWBYCVNBCIN     MGVWFQSD        TGRYVYFKRIPGAJU YUBFUFBSI       QVXUKPCKDMQCT  
LHNGPYNIHF      : VPTFFJLEVUWH    HTIYP           OOCRLENDHRIDH   TSFPO          
UCOCYRUENLOJIQC : URPTDKQXS       VIIUYXPUCMH     BEXHCXIJBBHAOL 
NHOBSXQ         : UERBL           VPDEFNAKNR      JLTQI           XETWRUWSEVACIW  AIABODPNQ      
QPRYYWUVCJYBD   : GWQSTEPPJDC     MGOQBHAMSGB     PNNDKCQVVSWKQYW LLJOWLYMWEFRC  
HSHVER          : GCWQWBSOQPA     JLTQI           QDQIFBMUEGPLIRS JOYCYHYUIODK   
GMDQD           : ULTGVGVIT       SDKHQOYA       
LCYPUOHVP       : BGUWEWDJ        HMJWHVK        
QLICMLHIS       : SJQSTHSKMO      SBGKXFOKKFS     FLTBNIMARV      MXIXQJN         VDIMSBMSMERX    EJNBDBKB       
SQEMIMYNFDTT    : GWQSTEPPJDC     LTOMGTLDJ       JLPTLO         
SJCJQXYWQMI     : VYXRSU          UJRWM           FPUDWMMHT       QVAKPDMHMGAJV   WXRLLY         
ATCKPEDIISQWR   : XVQEWPKXRSRG    JKTUV           MVGQSTYOTKACH   DOUUISFWVLH    
FUXYCSKGCBGD    : QWAUPMLEMWGDJ   ESQBNPWKSEQ     MYIFQYCJK       SNLTYLFKEXDSB   EADC            KMMISBTGH      
WQIRQFTB        : MKJLQYAF        FYJXKRXPVWN     JXDM           
XHFIAWGTB       : KPLIG           AVJHOACB        HMJWHVK         ANMAXRHHITOHFPK
RCMTUWDAAJFAH   : XNTDIJ          XBRTKJXF        HJOSVJB        
LBOSVS          : DJLN            DNHYVFXHI       LLFMCTPEPNLSEG  ECHMSAVKWBRKLFV
VCUFETNXVB      : OBTFCXDM       
APMUOPWOBD      : YSMTTLLUMN      BXVXSLKO       
IBEKQWIJOENM    : UYSP            UEVAAHB        
RGYREAIER       : GTOWE          
CGMYUPEO        : LHKITEGOIFUJPBK MEOFVD         
GSLYSVKH        : DNKHWBWJR       IQUNL           YDCIMCTFMNCKXN  TQUVNYBUDXFMY  
XTMPBNJF        : ISGNMLO        
RMGQONFPKVUYWD  : HSJBEJWCWXUFFWM DLTEF           MAHXKTLNCKCLRKA JWKOALTOIU      OPXU           
ICNGMUIKRWCUL   : SACNSWDP        QADXGTWXVIPULCS UJHDL           IQXASWGNR      
CCGOKWDADT      : RHMSLTTKTODPNBH FPMJLU          PNNDKCQVVSWKQYW RNSJRPXOQ       CNPYDLACNCYV   
YQMXTHGVUOKSW   : CBXTCISSCW      FFARHRQUKR      FOLTSGLXRWSPOK  OROQYXVSKGD    
KUYHGMJKUY      : BAPQJKWCMLWNNQ  SRFQEC         
UEVAAHB         : BGOPKNNUQXNRY   OAGRUKWV        FLGQMUEQXLESL   VGMH            IBEKQWIJOENM    PKOXMOIXSJGUAT  AVASSFHJTYWER  
VYMEHIBVSV      : OTTQWE          XAGOO           BTPULPSMN      
PIPQPXGAI       : QLWTP           YBUBBSMMSPRQHV  QOVEHVTWVP      XWICADRF        XFWIMGTFROV     XDMSCXGA        VXPMNQKXOH     
BEXHCXIJBBHAOL  : SYHCL           VFYIYIYOFAVMOA  AWKMYVNFASJ     UCOCYRUENLOJIQC NNUQIBYQRKELQC 
YPFULDMUUEKTMME : UHTN            XSDNWYPVGRNJR  
PKOXMOIXSJGUAT  : KKVIOIYW        AILJWB          UEVAAHB         KMAPTCKRSHKCJU  RJAUH          
AJMWX           : BGQCURSNWSLRYI  FPMJLU          ELIQ           
JULPHHC         : UERBL           XWTV           
LSMYJ           : GIGRHM          PQOJBONHU       CJIIEMUXY      
LASMSFSO        : RUASOLMB        QEFQNAY         SBSNMKXEQBURDLI
MVHYIEYYQTKGBRJ : NKXTKIPCDPWFVDS
FELEPVSPRFL     : NPAYFCUVBRL     UVAJAQLIE       CPPQLJHLMQI     UNPDCSFKGTBQFY  BLWRXUBHBJXQOD 
ACEOXO          : REFGEIRGPDSIAT  EIEVVCLRSFIV   
GUOFLIRSKLE     : CPXAXSDDHUBKQ   EGHCXNI         LSLELEPYAC     
RKTX            : HJESPTNXNLXL    LIBOETCNTXTDERQ BTAEHMIOY      
SQRKXDJXHPN     : CMGUHGNTHS      OKKSBSKSA       OIFNOJERPL      YGTUNVNCMJEYB  
EDMASTNBOGN     : HVNHHPOXHXN     PBWD            TUHRDOKMABIY    QBEO           
MWTWQUWJNRV     : BGQCURSNWSLRYI  LHGAHLFXRM      BUSBGMNV        UYPUVIPPGU      HSSY           
UFKDXAKCGYEYV   : YGENA           QVUSESIHECIN    RAJJ            ATHSCGG        
CKBQMQPJNGE     : IWBNXISLPNJJC   QPSJTVQE       
SRFQEC          : XWBYCVNBCIN     YHXMDYAR        QVUSESIHECIN    RUKO            KUYHGMJKUY      ALWOLQVIO       CIYRBECTNJDB   
RHWTUYATGBP     : AKHGX           LSEOG           RUNPL          
ECCUR           : CXUSDUHUBLDHJXX UKGTAJJWMAL     COVJBCDQ        REWRJ           MNMOG          
KBJSFWNY        : UNAKYXXQTEA     DNRAO           AXFRKFGKSNJXVQP SQJWNRJDQEAS   
FGGEAQBTLC      : JOLKVRDXTHRX    NQOADUD         IPJFDEWF        HATPDGUOVC      WPKMSQJ         EMPU           
HIXXJ           : KDTRSUEFUPC     BTCBQVOFJCH    
COYTH           : SKMQE           UMJIDIBRN       MMEGADO         GJYACHQOEDSJPTI
WQHEPW          : MAJCDVFQ        KONUOSRQH       FHEAX           MIMDMQEPKVFAHM  RXTPPYALHOA     CLRQBJU         LEWEHNJOB      
VEMFI           : BGQCURSNWSLRYI  CUYXSKJWRRS     QVJWHMKCJFEVDHK SQPOIWVXIXLJKS 
VLGJQ           : SPTDYREFXP      BXWRNAPTIIM    
QBEO            : WIDL            EDMASTNBOGN     PWOAVKOFUGQKUS  XDKU           
GTAIPJT         : WFUPEBVKUEKO    JHHUBGUODGHNAA  IWQNEUP         WLTXEV         
DDRUBXR         : JBCJWOK         BRLWNBTRLHAE    JMBYEAMYLTUX    HGKLY           ARVW           
KWQWUEGE        : JEYURDJGGD      WBVTYNMVSFXHTV  RIKHWXICOJYIOKQ
LUWPMKY         : GTWUHFTP        VCKQF           QCJKUG          FICQTYFROWJC    FYDVGMKSTK      YUUS           
MHXXDLDHGYKG    : XVQEWPKXRSRG   
PRPGQKLY        : ISTUHN          YLEXFWQEJUJNT  
INLHDARCIGLH    : SKYVCRQVBPJG   
PUIY            : UBDXNAYLAXY     OMIXSFVLF       NNUQIBYQRKELQC 
JJICYCRIUE      : ALBFGQCYCQEWJQ  ERQCMPMQSFI     LHSYQBMRIEQL    BABTBVEYUOV     EBGFFLXFFJO    
WWGKJONLISURGCW : HWUN            SKTKFMJR        WEBGVJWOHQ      TYOVMP          RDMKMCCQANFKVV  LJGQFHOMEXEP    KMAPTCKRSHKCJU 
YHWBRGLVI       : VHJUFAMHO       UTKIAGEQPMFCBO  BCCKLMHPWCE     JTJXJOOW       
QSMUQJS         : BDJMWGYGTIUNS  
TELKRW          : UGYYGXAHT       WWRQBDFKYSQDIA  MAVQKJWNRUTNL   SDHFWFLV       
MOLQNKQUHTOQH   : WRABJ           QQJKR           HLAFQQTVSSAP    SQPOIWVXIXLJKS 
BWETLYKVTH      : UVAJAQLIE       VVIXPIVUGJHXX   DYJTTLGJ       
AVASSFHJTYWER   : NIGHFSE         UEVAAHB         KYTXSFBLM      
NLLESYFRD       : EMBRYYYPYGFAK   DOVKOJFUMFJCV   OOAX            VSNMTG          BTYKS           GTGLXGJJM      
DENYBVRBTTV     : CJIIEMUXY       WWRQBDFKYSQDIA  FOEP           
CEAVFWCWQ       : TRDCIJLWYKUR    HWYSIRWXVVUV    LIYKTOWRQEBOTG  SXOWRJC         MRGMXPPYXRPCLUH
IEUDDCUGGALTCM  : PNHRKAS         HLAFQQTVSSAP    NQSGT           SOUVOYSKRTMLCV 
VPNPMCT         : NJFKETSPYCWSJAY PSWSVLTVRTTGVVI EJWWRXEJQ       AGCBD           BVJWDMYCILSW    FETCQXVPURNYBJW
CPXBRUUIDYFID   : YWUJVKG         GBWVALKHW       VYSDFR         
FJPFWMJLEF      : DQCAYY          ISGNMLO         UBUMDRBMCHUDY   LBMJEEY         TGRYVYFKRIPGAJU SBBXYQHYS      
SXOWRJC         : XNNXVFNQCIMP    SOXGT           CEAVFWCWQ       MRGMXPPYXRPCLUH CIXP           
HDCCX           : OPVJPP          KJQRGY          AHTCUMGTALLIUA  TJNFOKI         NPBOHNKL       
HATPDGUOVC      : YMEYOXRDWYOUF   TPLN            DOUUISFWVLH     YKRXOTOWTFGE    QBMJVWAINRLHEF  FGGEAQBTLC      ATNKWXBPPAG    
KMAPTCKRSHKCJU  : FVLJJN          HCFGOVPVT       PKOXMOIXSJGUAT  WWGKJONLISURGCW CCVYLN         
PYNN            : CALDYRPHI       IPOBNAQMVHJ     UIKFLDNHLYIRJ  
WPKMSQJ         : HAFYQ           LINVV           FGGEAQBTLC      NNFQLWCVARPJ   
POYADYRWECPW    : TQVMRIVAJ       DMXPSKJJJUHNPQY IOBDIQBWJN     
CCVYLN          : EVVOMT          MXHUHQGLNB      KMAPTCKRSHKCJU  NNNLPFYOFFWU    VYSDFR         
CEOY            : HWIMEYNOHKKYOP  IKSX            IPOBNAQMVHJ     RYFBGSQBA      
CONSAXIQYLTXDTC : FLMMFVARXTLU    BWAYELSH        TJVWASYQQ       UJSJM           SAUCDENW       
LCSNEQORFOVJ    : VMRONNEDDPXXEE  YFMLWBIV        DPOCBAFLUYWS   
VDIMSBMSMERX    : QLICMLHIS       XETWRUWSEVACIW  QJHMHFGIEJJRABD IAVOLCHKELQSFHJ
SDTWJ           : LWMMCHBCKCA     WRABJ           HRVIDNU         OGJO            CIBPKNYCRSIQX   PGTLSUWPSKHRSP 
BEWFVLAB        : SKTKFMJR        IUFETXUFSURV    EAWXPKPEFTOD    RYFBGSQBA      
VMJTRRGLU       : UKGTAJJWMAL     GAAUCT          JUDISUVGWN     
EJCYJCTNYQY     : BVLHSEVGS       ULLKCYVABNG    
SEGAA           : YGTCHGSAJXPGKJ  FXOCGHOR        VMWK            RAJJ            IWBYEIGG        TXXAAU         
CDUYRGSJXA      : TKKARVXR        FXOCGHOR        OJLSOHUIWHHETHO TSFPO           DPOCBAFLUYWS   
VXCHAD          : RVDRCHMDOWEVNO  PBWD            RCKYAWRJYFVX    NUTWDGTMYKVH   
CWHDPGMKMSLO    : KKBLQNJVKJ      YKSFHJH        
NRIOLO          : LAFKCSUUASM     PSJVG           JAYJXAUCRVH    
VPKS            : HBIMYBUMJMVXWY  PBCON           UUDVFX         
IUUIXOMWVSNFF   : MAJCDVFQ        UNROD           KCWTWQB         VEPODAYEWABFU  
RXLHKABUQNMYLEL : OHIWQR          EWNOSVYKUCFIH   BDJSHKIAVHJUF   QUVWPFQFXKCVX   HISBKBIVAFPXLAQ
RVAOEAETX       : PMWHLXECMS      YAMI            MGCGVEVPWX      FOEP            GFMITG         
MLHTJA          : HWUN            OMSUPIYJFVBECA  UAXWSNSYOL      XHVYYF          ASJCUD          MGCGVEVPWX      WAQLYX         
VJEXMCOCOQNSCS  : OWQDPEFLXGTM    LQQRODQB        VCETOCUTMGV    
YUBFUFBSI       : CYVEY           NRGD            CDHDJLTWJGOUHBS VVCSJUFW        CCWVJGBNXNEC   
GRJSTBQD        : TBJDUSLGNNMTYN  RCYPPSOLLGM     QCYKEPIJLPKRPJ  KASDMUC        
QSKHUBXJVDCIE   : BEQRBYPQIWJYXQ  UNAKYXXQTEA     QUUNLIVD        ANMAXRHHITOHFPK
JLTRNPCDX       : GFQF            LJDRF           DKRTDCP         BHLXMKEWGIMNE  
NQOQJTBAMN      : NVEGHNHS        YSMTTLLUMN      IOSUOFYSDX      AFILY           GTGLXGJJM       AVVOGCECLNT    
IOGTMLXUPWHE    : MGOQBHAMSGB     YPHMMQIOPUBGH   DMGFMJ          IEYKYKFEOBEJGXG
BTIDWHYMA       : GPYJBC          JXYGQCOTHJD     DPAKSQLEVLY    
GKKJKYXUJOEDC   : SIPADDNFL       IUSSM           EUOADRVEGJGPSF  KCVSRDXFQTTTL   UHDGNVHXYJBXLYX BQOQC           ULLKCYVABNG     HJOSVJB        
GKKJKYXUJOEDC   : MMIVHHWNT      
DYIAGOVHIEMHNMU : SEGNWDGRPOAWWQU BSIMKMEKYQAABO  CKHETKOBUDLPQX 
CDBMMNOKLX      : SGRIID          LHKITEGOIFUJPBK WEBGVJWOHQ      OCXA           
PEEHHDRKMGGT    : YGTCHGSAJXPGKJ  KHVNHX          DNHAYBOAE       BTAEHMIOY      
MHWDTTTV        : OWVQ            VDYTKVSSR       IDBLOKLUGLAKC   TQUVNYBUDXFMY  
ULLKCYVABNG     : EJCYJCTNYQY     GKKJKYXUJOEDC   SVDEWPYLNFDSGDW IAVOLCHKELQSFHJ
VQKNDWULTLXBKB  : RSGXMYUAWK      RRBYASRKX       LKCMQ          
EWUDT           : EOJKMV          QUDDCI          WIGBEVMJXAREBEF HOKJHANYFBPTE  
PFKODLP         : MIGWVYCHID      YNBBEMUGDG      XSDNWYPVGRNJR   SBFXYVPSNAI    
TWNK            : UERBL           UFOCECJTYUKXRI  LTJDDQG         TQUVNYBUDXFMY  
DNHAYBOAE       : KJFJ            PEEHHDRKMGGT   
DBEBVHUF        : PFNNYCI         SWHEDSOYDBO     REFGEIRGPDSIAT 
CPNGDFAACPKMSB  : JGXG            TSFPO           QVJWHMKCJFEVDHK
VCWKCBJIEPLAXGH : BRWIXGVVGEYGKSO KJQRGY          NNTLFPCCMIL     DYRLRENT        LFOUWKEYAFBLW  
LANRDSRDXHQM    : RCKQR           VASQFYIPKB      ATNKWXBPPAG    
TIXVH           : QQWVKWPTRY      BOULB           PBCON          
BKUJQMUSKDBKO   : WMFFATAWVT      CLNCCAT         MLEMFKMSOKGYCXE NHGYPDRRVGMLKE 
XIGSCMS         : VIAYJVVXAIO     AUYAWVDPSMMWPBD
DFOWPOUYCVLYHC  : WWWQIIAVU       MAIRUEFVE       MGCGVEVPWX     
EVWIYJ          : HTRPDKQHBX      ECHMSAVKWBRKLFV UJHDL          
CJIIEMUXY       : LSMYJ           DENYBVRBTTV    
FNYVEUWGSLF     : NXILO           SWGVO           KCPXEVIHUF      RYNINNT         CPPQLJHLMQI     OTGKTA          DJJJMGVXILMKJ   HOODFGOS       
PTHNQRMCROLCA   : JOLKVRDXTHRX    QJRIKLKLFIDMTHT
OWPN            : FKPOCMSQNVJ     YNBBEMUGDG      HENGMRXIVOFYVI 
VDYTKVSSR       : VUEBDNR         MHWDTTTV        GLMPIKXMCKL     JLPTLO         
YUUS            : LUWPMKY         SLKVKUMH        OXPDDW          OXHMX          
ILUX            : HJVB            QPSJTVQE        GAQDTF         
OMDQOUHMLXMJDL  : JRMMBMLEL       SCND           
NKVHCDIWADYI    : JSYPGWOKLMDOAIN KYTXSFBLM      
VIGKXJBMGLYRJ   : BKVOPSJX        MIGWVYCHID      EIYKL           BRLWNBTRLHAE   
DMAIBKHKO       : TJUVNLDVQHNGPG  VASQFYIPKB      LLFMCTPEPNLSEG 
SLKVKUMH        : CUYXSKJWRRS     YUUS           
UTCGVOMJOH      : WHPNYCLFGEHJBYU TYOVMP          IOSUOFYSDX      LARCDNPNEMGRUI 
CKHETKOBUDLPQX  : WKMQJ           YREJMSENAUDL    DYIAGOVHIEMHNMU
ESCNW           : QCJKUG          YREJMSENAUDL    UVRWXE         
HBDFQQOHXHLKRQ  : HCFGOVPVT       IUALXQGSYBBVWM  CPYFTRKRTWLL    UQOEQE          TUHRDOKMABIY    BGKY           
CHHALU          : WAGRURMLQCVH    VYMTEQLQLXICQ   FDPMKC          HPQERPTSXMKYJL  PJFAISOIGEN    
CSEI            : JAVTCCNAJTYEVK  IVUOIOSVA      
GVLEEPJJGCBP    : JBXBHOQWURXLH   DLFDJFXUPMO     TAXJJIA         WAQLYX         
IBNCTTFCCF      : KLFPCOABFRWAMBO CALDYRPHI       XWTV            MYIFQYCJK      
WWRQBDFKYSQDIA  : VTPMDLWASYBVM   CGUXW           SAUCDENW        TELKRW          DENYBVRBTTV     JXDM           
QDQIFBMUEGPLIRS : ONOURSYIWKMNV   HSHVER          CBNHMOMPBJYKE  
QPSJTVQE        : TCNNW           AKSSFUDEVCV     SVJW            CXCAKOEBYLX     DLFDJFXUPMO     CKBQMQPJNGE     ILUX            XHEBD          
MUBWWSOC        : UVYVSOGFK       VQYNOYUE        ALWOLQVIO       SOUVOYSKRTMLCV 
YIMLFSSUGDOYCIR : EIYKL           XJPFWWC         KINLA          
RNSJRPXOQ       : CCGOKWDADT      RLNOWT          NNNLPFYOFFWU   
LLJOWLYMWEFRC   : HXBINSLNREEK    CUNCBHQABIA     XVQEWPKXRSRG    CMICWONOJWQWXM  QPRYYWUVCJYBD   MFWLBFBHSQKGB  
VSPXBHUVUPH     : LNTAC           OAAIDXU         LXCCXBJTCLA     DBIGALGJAVPCL   YYCPDPRPAXA    
FFDYAR          : BTYVMR          PSVG           
MGIXHUU         : BVBJ            RJUWECOFSV      VIIUYXPUCMH    
CPPQLJHLMQI     : JUKFIBE         UJLDUYWPFXC     FELEPVSPRFL     FNYVEUWGSLF    
OXPDDW          : PYTJKFB         OWVQ            TPGKVA          CLRQBJU         YUUS           
CXBNKJ          : RONCRQWWS       JHAQGG         
KQUF            : FWAEKDBSDBMR    HMEFO          
WWWQIIAVU       : ONUHSOOSBRO     LMQNMNPWVOKNO   DFOWPOUYCVLYHC  EUFPMP         
EGHCXNI         : OIFNOJERPL      BVVTJC          GUOFLIRSKLE     CCRKQCOJTULNT   IJUCOIDRUXV    
WMTXCGJA        : WNVQAKHGBYDHD   ONSNPWV         SQWQPRSBUMEXFTS
CWXGWVFPENPDLI  : CYUD            WGQMYTRWRHKATY  SITMVOVVIVUF    UNGWG          
RSMRGWNDJH      : UMJIDIBRN       FOLTSGLXRWSPOK  MOBERTORP       JAQLIVJQHCTKBT 
MNMOG           : BFGYCAJSPRX     XSFWNIAUFDF     ECCUR           ROAQOPG        
MFWLBFBHSQKGB   : SKMQE           EJKEF           JUTHKCDIIO      TFFMKTGRFLFEOKT ASJRTXBPKBYI    LLJOWLYMWEFRC  
ATHSCGG         : TWVVQMTN        YEQRGRAPREFHEY  LNTAC           NFYWX           UFKDXAKCGYEYV   FYLNUDNYDWF    
PQKEGYVNPK      : URLSQWOINWA     RYXQLHBJCANEHLP YDGBDE          AGHM           
PVVUWDPPQWSLYP  : VMWVA           SBGKXFOKKFS     GCWQWBSOQPA     MMFLLOXMTQFQOXL ADVBXFUHRIBMP   NNFQLWCVARPJ   
RRBYASRKX       : VQKNDWULTLXBKB 
MTLCEGRC        : DLTEF           UJRWM           IVUOIOSVA      
MYIFQYCJK       : FUXYCSKGCBGD    IBNCTTFCCF     
YHVR            : UVYVSOGFK       GAUOIRAKFDYPJI  IYNIYOOLCGN     VYXVRA          MPNKHJBYBIO     NIYEN          
WTBOEBOSWB      : FWAEKDBSDBMR    UAXWSNSYOL      YFMLWBIV        LCDUVRSUDSCOOXP
DJPFMFGWKW      : TPLN            EIYKL           YDCIMCTFMNCKXN  IUFETXUFSURV    EIEVVCLRSFIV   
OJIPIPNCAKV     : NJFKETSPYCWSJAY MKUECBW         YLGPUJOYVX      QJLCPQW         SCMYQSIQKQPD    RJAUH           CCWVJGBNXNEC   
YDFQVERTIDKP    : IXUDYIXKWNAWHAX VYXRSU          EJIXEWBCEEJT    GSXSWEVTGJ      AOYAWYSAL      
PWOAVKOFUGQKUS  : FBFJAPBF        TFFMKTGRFLFEOKT QBEO            GIIUGCWK       
HRQJUVA         : RTBTUYSIOAJMP   VCETOCUTMGV    
ATNKWXBPPAG     : TIYRW           HATPDGUOVC      LANRDSRDXHQM    EWWSWMRTELTYB  
VTIEOOUCLPOVHF  : IPPQHHW         CLFBACWATQD     EESQUAJBGYL     NNTLFPCCMIL     QVAKPDMHMGAJV  
CDFXGBLQXL      : INLAHKO         MHDJGDQHDIQEREO SSVOBNRO        OBLXQE         
PDTYUS          : KERTGKWMAJVULT  TJHR           
DYJTTLGJ        : OCSXYQYYANEKOSU BWETLYKVTH     
CTIJVMQVSRH     : BGUWEWDJ        HOBGSJKCPUPSC   LEWEHNJOB       YVCYPAN         UVIJBB          FRSFCCBCM       CCRKQCOJTULNT  
RUGIXCHSWCXV    : JNTITBUOV       LQTKXVHUWCI     AHATXHECYYCES   IPUEWOJIT      
SRXBCBF         : DYRLRENT       
LOVXFSSWC       : TNXFCKSHUVVOG   GTOWE          
OXNYXPITNKRJW   : ADNWV           HIND            LIYTEJEWLC      BTPULPSMN       XDKU            TKHHMGG        
EWNI            : VOXNDDBXV       JUGLFHXLC       WWIIYMUSHLOKW  
SGLHCMO         : XXBIGOSXVT      OJLSOHUIWHHETHO PSJVG          
HNXMFXCEVSPRI   : LOVCSLNUICKXNIQ
KTYWXXLGXGMMORY : RLLSHKOVCUP     IXUDYIXKWNAWHAX SPTDYREFXP      MKDKPTWIIXMY    CCWVJGBNXNEC    NFYADIY        
MGTMVYKXFJ      : VAVVDUD         JRMB            GPPCPVP         STNEUAX         WKEOKYKTEFNTJFS
UBDXNAYLAXY     : LHEW            JPELAFBLCYGWVI  PUIY            QBLVLQNB        ELDNUWT        
XFVKV           : LMQNMNPWVOKNO   UCLGRIRJGU     
LCDUVRSUDSCOOXP : MHDJGDQHDIQEREO VSNMTG          WTBOEBOSWB     
XETWRUWSEVACIW  : UJLQQMG         XAGOO           HOROOWLUMX      NHOBSXQ         VDIMSBMSMERX   
WBVTYNMVSFXHTV  : NYJM            QULQTSXEWSO     CLCQAWFV        KWQWUEGE        RIKHWXICOJYIOKQ HBKEBVIVVR     
OTGKTA          : YSXAMWATOXYIBJ  DCCOCK          CPJVPHXDFVAT    FNYVEUWGSLF    
QSJOUMATHWUD    : IMSIO          
TSFPO           : LSVDVMMFMVLVEC  LHNGPYNIHF      CDUYRGSJXA      CPNGDFAACPKMSB  WSKVYISVFFJFRPF
OXHMX           : QWAUPMLEMWGDJ   KHVNHX          SDKHQOYA        YUUS            FYJXKRXPVWN     BABTBVEYUOV     KPKSKW         
JGIDGOT         : GMCBGTSIUCEUTS 
ALWOLQVIO       : SRFQEC          MUBWWSOC        XTWNYWX         LEXNIPQERVM    
BKUGDLQTJAGKXR  : WIKNHX          LVDRG           XWICADRF        BXWRNAPTIIM     CCWVJGBNXNEC   
HUXVRYXDXNORJYG : CMGUHGNTHS      KONUOSRQH       TNXFCKSHUVVOG   MQRVEUIFULIJ    OHFK           
ASIGVVYPFAWP    : MMAHLWB         QQJKR           BDJMWGYGTIUNS   WPBMVBFNBGQUI   BMGUVCBX        VSUHBXSF        WJXMPETLX      
QJHMHFGIEJJRABD : MCYLDO          ARRUKMUTNEVBYF  DSESGEC         VDIMSBMSMERX    AKPDDSDODN      WXRLLY          EMDCQUMWMHULXIK
JOYCYHYUIODK    : TGRYVYFKRIPGAJU HSHVER         
SLFESTNBAWFJ    : YGENA           DBHXRV          PCYMYF         
YJJCKURL        : NGPUEMBBRKCMD   NVODSKPDNHIXJEJ ROMTTLJUPPHKW   ARRUKMUTNEVBYF  MXIXQJN        
SSVOBNRO        : IPPQHHW         VDSMYCAWQBL     VAVVDUD         NCYSQBEJUCARN   DIQRBWUKCDXBC   CDFXGBLQXL      KTPDDRWOU       KMCDDOJUMAP    
MAIRUEFVE       : DFOWPOUYCVLYHC 
DPOCBAFLUYWS    : DMSLFFULC       LCSNEQORFOVJ    CDUYRGSJXA      CKSQYB         
RQIVGAKKPM      : RCKQR           EUOADRVEGJGPSF  VSNKLSDYQ       RCYPPSOLLGM    
JHAQGG          : RKFXSYN         DJLN            INHDMKVMBPE     CXBNKJ          BVJWDMYCILSW   
JWKOALTOIU      : LWAS            LECLAVHMPX      KHJQTSDH        AJBDIV          RMGQONFPKVUYWD 
BMGUVCBX        : TPYU            WEBGVJWOHQ      ECHNNDOFJ       MVWAWKLC        ASIGVVYPFAWP   
NPBJY           : KERTGKWMAJVULT  BPYGXHWWF       UNEOJVGEDVPEGRY
LQQRODQB        : YNXLSRDWGEDRKS  HJMCXBDKOIXCLWT IHLXBYMI        SCND            OVNVHBXVUJ      VJEXMCOCOQNSCS  GTOWE          
RONGXITBWAVUEA  : KONUOSRQH       LSDV            LIYKTOWRQEBOTG  HOROOWLUMX      SITMVOVVIVUF   
SNLTYLFKEXDSB   : AVJHOACB        QOVGQREUXBIX    FUXYCSKGCBGD    VSUHBXSF        WMXEPD         
VUNLKVJUQ       : DRXRJUIXQX      RKFXSYN         EBGFFLXFFJO    
SSHP            : WIDL            DADWDGAKCGMD    TKTNPHRFKUHV    RYFBGSQBA      
JLQWXNWLSHRQ    : QMVQIIJTLBR    
MUJIPYTBVDXOQQJ : MBOYH          
JHHUBGUODGHNAA  : GTAIPJT         GVRTWXLC        KMCDDOJUMAP     VYSDFR         
MULVLNPOL       : TDPCRX          EDPXYOOV       
OCMILMRTVMWCILI : MCCPRQBMB       OPWURBAPECAUGCV AJBDIV         
UVRWXE          : VMRONNEDDPXXEE  YQEFXTQ         ESYVPBIYWUGLG   OICWADE         ESCNW           FOYJWMGOAYQUCC  MEOFVD         
MCGAUWLQLNF     : JOVNUOFC        VSNKLSDYQ       VGMH            HVYIOLDIXOMVEMY
BRLWNBTRLHAE    : QBDDHTECXNI     PJMNIETFV       PPMCYWSURVDACIN DDRUBXR         VIGKXJBMGLYRJ  
VVCW            : WEFKSRTY       
UJHDL           : SAHYISDHNR      WIJNHCVILNWKQRU LHSYQBMRIEQL    ICNGMUIKRWCUL   EVWIYJ         
AYSNOXIPRV      : IDAYNVA         NCYWWCSKO       MHDJGDQHDIQEREO FMESCWM         LNUVWEVERXXIAAW BTPULPSMN      
FYJXKRXPVWN     : PFNNYCI         XBRTKJXF        WQIRQFTB        OXHMX          
VSUHBXSF        : QUKGGGIQV       PSGPWDEN        ASIGVVYPFAWP    SNLTYLFKEXDSB   SSDHHRTY       
RYOIY           : VDSMYCAWQBL     XAGOO           IWBYEIGG       
XTWNYWX         : YYVEIVJKOBVF    UJLQQMG         QKOPGFAVTI      BTJHAPPAPFNCMJ  HPIRLLUSHTDPFTO ALWOLQVIO      
JPAB            : ALBFGQCYCQEWJQ  WGQMYTRWRHKATY  IDAYNVA         JHKOCMHAJAEE    DOASUQDFGQF    
YROUKJCNKWTMQU  : LQBCJHVCT       EUOADRVEGJGPSF  DPAKSQLEVLY     REFGEIRGPDSIAT  UVIJBB         
YVCYPAN         : BFSO            LADRCSFY        CTIJVMQVSRH    
YNSIFSMSTEJQOV  : NVODSKPDNHIXJEJ GAVMV           QQJKR           TDPCRX          JUDISUVGWN     
FGRBUIXWJT      : XAGOO           LWNDKPDSA       GLMPIKXMCKL    
JMBYEAMYLTUX    : QPJVGESABWPIKC  PIIJHJCVSHGBLYI DDRUBXR         VQBCTHHYTH     
OCYGS           : JGSBHXVB        DIJBM           DIQRBWUKCDXBC  
BABTBVEYUOV     : DOYVWYYYEMMO    REWRJ           JJICYCRIUE      OXHMX          
AIABODPNQ       : VHGVWHIVKP      KRTXIO          NHOBSXQ         AVGVVWGCAUQ    
IQXASWGNR       : VBOGTPW         CATTOWRG        DBIGALGJAVPCL   ICNGMUIKRWCUL  
QUDRTITQYPPYA   : VPDEFNAKNR      TDJHTAKYUNUUYMA LHSYQBMRIEQL   
AOVPE           : VYMTEQLQLXICQ   OMRHECQCEPJAC   IULKFIE         JFHMSNY         YAMI            TCNNW           WKMQJ           NPRSEDF        
BPFYPAWXP       : CMFGWANJKNFRADA BCCKLMHPWCE     OWQDPEFLXGTM    RYWCNUBOOPNFXV  DUEPLMGHNKFLY   AOYAWYSAL       QBLVLQNB       
HGKLY           : FWAEKDBSDBMR    FYFQ            DBHXRV          WPBMVBFNBGQUI   DDRUBXR         XJIAJSK        
VUUWKLX         : VGHPVFHJ        JRFQXTPPPJU    
EADC            : TXVYE           FLTBNIMARV      KWVJR           PPHOXEYMUWMKJ   FUXYCSKGCBGD    RPCOECOFOHJBABB
HSSY            : RAEGU           JUCIWRTJHACJFE  ANFXCFFRCXFQOS  NKXTKIPCDPWFVDS MWTWQUWJNRV     PNACMOLAQHIMGI  YQXDH          
ROAQOPG         : YLBAUXNYTG      HRWBXIXLEW      MXWTYTUBF       MNMOG          
WSKVYISVFFJFRPF : XOVNAFFMEXXPY   HPOHHLA         QBMJVWAINRLHEF  TSFPO          
TWEMREKLUKD     : LBNHSVAB        DXIMMIUDGV      MEFXGAUWD       REWRJ           BTYKS           LKEYEQGAFRAX   
DLJAETXF        : CMGUHGNTHS      LIBOETCNTXTDERQ
QBLVLQNB        : OWUNBXDGMDJABJT CIBPKNYCRSIQX   JQMNMVER        VHGVWHIVKP      UBDXNAYLAXY     BPFYPAWXP      
IVUOIOSVA       : QQWVKWPTRY      VNNJTYJCDREEMKE KDLPUHB         HLAFQQTVSSAP    CSEI            MTLCEGRC        SMACMUEQJLMKA  
IDBLOKLUGLAKC   : EDOH            MHWDTTTV       
VXPMNQKXOH      : UAIKGJAFC       SESDMQCV        PIPQPXGAI      
AVGVVWGCAUQ     : HEVYPNLTCIOQG   UMEQV           AIABODPNQ      
IOSUOFYSDX      : XEEI            NQOQJTBAMN      UTCGVOMJOH      VNWOFMYF       
PNACMOLAQHIMGI  : SQAYBRAFIQKAVDA HSSY            FETCQXVPURNYBJW
IISBVBPQX       : NYJM            JGXG            PIIJHJCVSHGBLYI LKEYEQGAFRAX    YJTCODB        
WXAAXJSLLWACJCT : USQUVB          YBUBBSMMSPRQHV  UNSWVKSLDOX    
LIYTEJEWLC      : LLJRUIAI        IPJFDEWF        OXNYXPITNKRJW   UNGWG          
BTYKS           : IRCEOBJ         UNROD           OGJO            NLLESYFRD       TWEMREKLUKD     NYKFTB          NHEUGUALRXI    
LUWUPLG         : OMSUPIYJFVBECA  LXCCXBJTCLA     RTBTUYSIOAJMP   KQBFLTBUR       NNFQLWCVARPJ    OLLTFVUPHLTFK  
LIBOETCNTXTDERQ : WFCUGOBHFYYIW   USYNTPBYJN      RCKYAWRJYFVX    UVAJAQLIE       FPUDWMMHT       NHULXGMLXFLEFSX RKTX            DLJAETXF       
LIBOETCNTXTDERQ : WNTOSPAWUKO     TARA           
UUDVFX          : LHKITEGOIFUJPBK IIBA            VPKS            MEOFVD          BHLXMKEWGIMNE  
QUUNLIVD        : EEJJYCBQDGKTVKV VMWVA           GLMMHVX         QSKHUBXJVDCIE  
HENLXPYTPT      : LLFMCTPEPNLSEG  YUWYRSR         XJIAJSK         VYNGYBPJUVUCFST
TNQDKNGGT       : TWVVQMTN        XAXKJGMULNYDYF  DXNALBJEWTGFHIB
EMCC            : IFTQNKTC        FLMMFVARXTLU    RARKLE         
PKWS            : DXNALBJEWTGFHIB DXTWODMOB       UNEOJVGEDVPEGRY RUKO           
EWWSWMRTELTYB   : JWBQAJUP        ATNKWXBPPAG    
ELDNUWT         : RUTF            OJYDLD          RYWCNUBOOPNFXV  FMESCWM         UBDXNAYLAXY    
JXDM            : YVMTHMAQGXKBJI  OKKSBSKSA       KCVSRDXFQTTTL   WQIRQFTB        WWRQBDFKYSQDIA  QVXUKPCKDMQCT  
OMIXSFVLF       : QUVWPFQFXKCVX   XWBYCVNBCIN     WWIIYMUSHLOKW   TDPCRX          PUIY            IEDETKBJJOCWY  
EYRR            : RBLGHKYJUCTYL   RWBSTPXLSK      GTOWE          
QVJWHMKCJFEVDHK : MUTJMGDOH       JWBQAJUP        VEMFI           CPNGDFAACPKMSB  CJUXXNWVVJ     
XWCY            : GFQF            OICWADE         HONFVTWQYYUDDHS
KWEP            : JBLSKGOCJKN     NQOADUD         BTAEHMIOY      
KQBFLTBUR       : RBTRXXANWWUM    OVQFAGDPSJXK    LUWUPLG        
ICPTHTRNDDFCAJD : VOXNDDBXV       MDMRQ           JEYURDJGGD      ASJRTXBPKBYI   
TAXJJIA         : CMGUHGNTHS      XFJYU           TXVYE           SABMUYMFTRILUPP MMEGADO         GVLEEPJJGCBP    BGKY           
NNFQLWCVARPJ    : WPKMSQJ         PVVUWDPPQWSLYP  LUWUPLG         HVYIOLDIXOMVEMY
IWQNEUP         : BRNAPTLNFVDJRKG LEUTARAKJBX     GTAIPJT        
XJIAJSK         : UKSWUEWFYJEB    EPMMFDDJC       DBIGALGJAVPCL   HGKLY           HENLXPYTPT     
UVIJBB          : SOEHLUWGWRFINA  CTIJVMQVSRH     YROUKJCNKWTMQU 
BDSBWIKKSIEGM   : TPLN            CIXP            EUFPMP         
YDCIMCTFMNCKXN  : OPOIHYH         GWQSTEPPJDC     BAPQJKWCMLWNNQ  GSLYSVKH        DJPFMFGWKW      DYRLRENT        WLTXEV         
AKPDDSDODN      : HVNHHPOXHXN     YVMTHMAQGXKBJI  RCYPPSOLLGM     QJHMHFGIEJJRABD
NTQDV           : ONXGM           QWUMNQI        
GAAUCT          : NETLCQ          ARGVQBSO        VMJTRRGLU       FBDLJLNCCSUHH  
PJFAISOIGEN     : AXFRKFGKSNJXVQP CHHALU          WMYABK         
YQXDH           : WGQMYTRWRHKATY  HSSY           
SBBXYQHYS       : UJRWM           QJNQCXJN        FJPFWMJLEF      MOYSWCTKL      
COFTXMVIHLQ     : WTGQEERMSKAIEHM IOBQYFXN        PGTLSUWPSKHRSP 
RHXRAXWHGRL     : MXHUHQGLNB      TFVNMCW        
SMACMUEQJLMKA   : JFHMSNY         XXXEUMQEI       IVUOIOSVA       PCYMYF          IPQGHBXLIU     
SITMVOVVIVUF    : VWKTQ           MYSIUTKBYPB     BXWRNAPTIIM     CWXGWVFPENPDLI  RONGXITBWAVUEA 
DYRLRENT        : XQGFLDHWLB      XUTURWOGDP      EOKPNLAJLDA     VCWKCBJIEPLAXGH SRXBCBF         YDCIMCTFMNCKXN 
JBJUOVFPFBX     : YWUJVKG         RUASOLMB        QCNFWRNVEBGWL  
NVRJSAHNFLQHFEY : UAOPENEPVAGX    NUTWDGTMYKVH    SVQXBONWFYRL    WTNXHVNVKD     
SVDEWPYLNFDSGDW : FKAXJJWGVK      KDYQIQDBJW      ASBFYDTAGXR     RJUWECOFSV      ULLKCYVABNG     OLLTFVUPHLTFK  
AOFSP           : PTONVNWHGXL     GFQF            RWJJLJLRKGPV    PBCON           CNPYDLACNCYV   
IWBYEIGG        : MIRBTFWDNDANHWA GDLQRDWCRSISX   SEGAA           RYOIY          
YCYFYQEMEL      : QMVQIIJTLBR     VMLWDIKTCUGGK  
ARVW            : QLWTP           DDRUBXR        
VNWOFMYF        : XKVIKJH         QSDJFE          XFWIMGTFROV     JUKFIBE         UJLDUYWPFXC     IOSUOFYSDX     
YLXHRTITSNULRK  : HIHKWJUI        IUALXQGSYBBVWM  IPOBNAQMVHJ     HNPUE          
EDPXYOOV        : LJTCX           MULVLNPOL       EMLSNWR         TARA           
LMKXMRNNEMUVG   : LLJRUIAI        PBWD            GDLQRDWCRSISX  
SBSNMKXEQBURDLI : BXMET           DSESGEC         KINLA           LASMSFSO       
STNEUAX         : LXDVGAT         OIFNOJERPL      SXOKRLTVNIOE    FYDVGMKSTK      MGTMVYKXFJ     
PCYMYF          : IIBA            YEQRGRAPREFHEY  CPJVPHXDFVAT    SLFESTNBAWFJ    SMACMUEQJLMKA   TKHHMGG        
RIKHWXICOJYIOKQ : XBRTKJXF        KWQWUEGE        WBVTYNMVSFXHTV 
ENCKIEISUNUHMC  : SLDWVIBKSAYLRNU NVODSKPDNHIXJEJ JXYGQCOTHJD     CJBSV          
GLMPIKXMCKL     : GLMMHVX         BDEBOY          CLDQWYPVARN     VDYTKVSSR       FGRBUIXWJT      PTYQ            WXRLLY         
YYCPDPRPAXA     : NVJAE           VSPXBHUVUPH     VAFBEKPNVFRAYO 
UNPDCSFKGTBQFY  : WQSKLYEUJJRLJR  QYHDQR          PNNDKCQVVSWKQYW REWRJ           MHDJGDQHDIQEREO FELEPVSPRFL    
JLPTLO          : MCQOATB         SQEMIMYNFDTT    VDYTKVSSR       CDQXSLJFBUSYSE  AJYVVXXGNCLS   
BTPULPSMN       : RKFXSYN         FPPHCBXKXLWF    RLLSHKOVCUP     KJFJ            VYMEHIBVSV      OXNYXPITNKRJW   AYSNOXIPRV      DTLDFHRMG      
CDTFXB          : ULTGVGVIT       BVLHSEVGS       TJNFOKI        
EUSV            : UEXJKTASEX      FOEP            BKUERMYD       
UCLGRIRJGU      : WHIISOFQMMOVLF  IUALXQGSYBBVWM  BUSBGMNV        DGBRIVHPLXBGE   MXHUHQGLNB      XFVKV          
WPPOLECCGI      : UBGCTLJT       
NIYEN           : UMEQV           VNSWVTL         KCPXEVIHUF      YHVR           
YLYTPM          : MIMDMQEPKVFAHM  CPYFTRKRTWLL    DSFOIWGFCQP    
HUUSCSWBIORVUUX : GGMUPNQVOXG     VCGWMAGNXHV     FRFSXKHMUO      POUXILQLFLJNKWC GJYACHQOEDSJPTI
FVPNUVDR        : BTCBQVOFJCH     HHHJQKUP        LAYIUFP         AXFRKFGKSNJXVQP PSGPWDEN       
QSRGHSQDPJ      : UBGCTLJT        LXDVGAT         DOOK           
IIKTY           : LEKPA           XARVCBRODQI     OKXXLF         
PTYQ            : MIMDMQEPKVFAHM  GLMPIKXMCKL    
EMPU            : EHXG            JMMWJHSTGQ      FGGEAQBTLC      YWYWGTENW      
LXEIRW          : DMXPSKJJJUHNPQY NYCKHAOJIWJTFS  PTBNLGNT       
AGUQJLDST       : TDJHTAKYUNUUYMA LIYKTOWRQEBOTG  DOASUQDFGQF     ADVBXFUHRIBMP   AEEOQF         
DNNGGJF         : FVVBJPF         QCNFWRNVEBGWL   QJLCPQW         LSLELEPYAC      MRGMXPPYXRPCLUH
HMJWHVK         : DTPSXOFJOAFP    LCYPUOHVP       XHFIAWGTB       BEGDAGDXIJRBBWA
AVYYVAG         : FVIAA           ICGI           
SPFVLY          : XOVNAFFMEXXPY   DVCVU           NYCKHAOJIWJTFS 
OPXU            : KGOASCHGUHU     KAPTYNWISKJMLKL BFGYCAJSPRX     XGYAPJYJN       RUKO            RMGQONFPKVUYWD 
JDSRPEQ         : APDIA           VMFTRCLB        DCEKNIKSHPAJAE  XFJYU           SBGKXFOKKFS     BCSXHDNSTQCT   
BEGDAGDXIJRBBWA : HMJWHVK         POUXILQLFLJNKWC
WKEOKYKTEFNTJFS : RMLVFOXHNADVJTR WNRAOVTJE       MGTMVYKXFJ     
JAQLIVJQHCTKBT  : OOCRLENDHRIDH   RSMRGWNDJH      FTQSCTSVGYKL    LFOUWKEYAFBLW  
AEEOQF          : BPYGXHWWF       IKXVRBLECWHHTO  EKCSINSHV       DEXPIBOLFQMLAAI AGUQJLDST      
LKEYEQGAFRAX    : USQUVB          QCJKUG          TWEMREKLUKD     IISBVBPQX      
KTPDDRWOU       : SSVOBNRO       
QVXUKPCKDMQCT   : ORWHEYLQQXWJNGA CPYFTRKRTWLL    VVCSJUFW        JXDM           
JTRBVPHGMWJ     : KHKRHTHYHGUHEJ  LOVCSLNUICKXNIQ
QIGLAYHBTSSWFVL : VXVDVYLOEPQTXYB UQOEQE          NKCUDUVFWBAOGJ  LFOUWKEYAFBLW  
AFILY           : LDMXGLOTS       VKCUF           REKAUI          NQOQJTBAMN      XDRBVNO         AVIJKUUPJGI    
NUTWDGTMYKVH    : KLFPCOABFRWAMBO FFARHRQUKR      GMCBGTSIUCEUTS  UBSG            VXCHAD          NVRJSAHNFLQHFEY
XHEBD           : TJNFOKI         UNNDCYXY        IQUNL           QPSJTVQE       
VCETOCUTMGV     : BGQCURSNWSLRYI  KCVSRDXFQTTTL   UJRWM           VJEXMCOCOQNSCS  HRQJUVA         FUNYMRLKBV     
VSLUWROLSYJD    : LQBCJHVCT       SHKKI           XKSDYWJBIGDEQD  OLLTFVUPHLTFK  
KKENPDKS        : SPTDYREFXP      NVJAE           TRDCIJLWYKUR    AEEUOKBWRANQVGL
EJNBDBKB        : QJAT            KDYQIQDBJW      TJUVNLDVQHNGPG  MBOYH           AEEUOKBWRANQVGL QLICMLHIS       FETCQXVPURNYBJW
IUFETXUFSURV    : BEWFVLAB        DJPFMFGWKW     
CIYRBECTNJDB    : KJQRGY          LMQNMNPWVOKNO   SRFQEC          CKSQYB          OOJIENW        
IEYKYKFEOBEJGXG : YEQRGRAPREFHEY  LSVDVASKCJBED   IOGTMLXUPWHE   
VBEH            : QGPYPGBWCM      EVVOMT          MAVQKJWNRUTNL  
WIGBEVMJXAREBEF : CSYITX          EWUDT           OBLXQE         
LKCMQ           : VTFSKMU         VQKNDWULTLXBKB 
TQUVNYBUDXFMY   : PNEKMCN         GQHSJJ          VVIXPIVUGJHXX   XWTV            GSLYSVKH        MHWDTTTV        TWNK           
IMSIO           : QTBSCTI         QSJOUMATHWUD   
NPRSEDF         : FKDWUPESRRMBW   AOVPE          
QWUMNQI         : VYXVRA          NTQDV           YJTCODB        
RJAUH           : YMEVBGSF        UCXXLKX         ADNWV           PKOXMOIXSJGUAT  OJIPIPNCAKV    
HJOSVJB         : DCCOCK          RCMTUWDAAJFAH   GKKJKYXUJOEDC  
WQCOMGRTNKQKWHB : QHPPDWMJSIXHRSO OOCRLENDHRIDH   XBUVMIRU       
KURNSASCJKUHVY  : VAVVDUD         MIRBTFWDNDANHWA NFYWX           NEOAVXOV       
SPVJEFEYUO      : VQAVXG         
FOYJWMGOAYQUCC  : UVRWXE          GXNASQ         
YLEXFWQEJUJNT   : GPPCPVP         PRPGQKLY        CIXP           
EMLSNWR         : HEVYPNLTCIOQG   EDPXYOOV       
EHCDAXHFFHQLHW  : CLFWDE          GWSVVBNJ        VKCUF           ONOURSYIWKMNV  
XBUVMIRU        : FFARHRQUKR      QCVAVFMFWS      WQCOMGRTNKQKWHB DXBU           
GIIUGCWK        : LOIHFWYDPGBFLXW FKDWUPESRRMBW   PWOAVKOFUGQKUS 
ANMAXRHHITOHFPK : CSDIBTORGV      VCKQF           EHXG            ASJCUD          XHFIAWGTB       QSKHUBXJVDCIE  
NYKFTB          : ORWGCJIQAVCX    EMNRYYUDJT      BTYKS           BTAEHMIOY       VAFBEKPNVFRAYO 
DJJJMGVXILMKJ   : FNYVEUWGSLF     PSJVG          
SQPOIWVXIXLJKS  : AWKMYVNFASJ     VEMFI           MOLQNKQUHTOQH  
LFJX            : RCGYYPQB        TRKQYM          PVNSVKLUISCS    CNPYDLACNCYV   
SMXQKICA        : FKAXJJWGVK      YLBAUXNYTG      VDDN            YKRXOTOWTFGE   
MEOFVD          : MGVWFQSD        RVGICQLS        XGVYQPTXMWCK    CGMYUPEO        UVRWXE          UUDVFX          FYWT            EOWQUVWDJMIF   
VYNGYBPJUVUCFST : PNNDKCQVVSWKQYW HENLXPYTPT     
FTQSCTSVGYKL    : DXIMMIUDGV      QTBSCTI         JAQLIVJQHCTKBT 
PCTQPAPRPYOMWS  : OBJTIIRVBRNEQN  MMXSRRBDSMXG    RIYEFEGHDYNOJG  LSVDVASKCJBED  
POUXILQLFLJNKWC : CYUD            IXGEAB          IYNIYOOLCGN     HUUSCSWBIORVUUX BEGDAGDXIJRBBWA CNPYDLACNCYV   
MGCGVEVPWX      : WKMQJ           LNUVWEVERXXIAAW RVAOEAETX       MLHTJA          DFOWPOUYCVLYHC 
LUAFMOAKAOBNVO  : JBLSKGOCJKN     TIODRQQPADTOPX  EVJCE          
MAVQKJWNRUTNL   : UBYRPBDOAB      BIBVUAVIASAONAH JMMWJHSTGQ      TELKRW          VBEH           
NTCIVKVNMIN     : TQDTHCJUO       MBOYH           UIIWR           HONFVTWQYYUDDHS AGHM           
MBABAMBWDOI     : SJANMYEWACTR   
EAWXPKPEFTOD    : BEWFVLAB       
MQRVEUIFULIJ    : IRCEOBJ         FLGQMUEQXLESL   OICWADE         HUXVRYXDXNORJYG
FOEP            : MEXDRMBXDTTDIP  LINVV           DENYBVRBTTV     RVAOEAETX       EUSV           
IPQGHBXLIU      : INHDMKVMBPE     ORWHEYLQQXWJNGA SBFXYVPSNAI     SMACMUEQJLMKA   AUYAWVDPSMMWPBD
MBNDS           : BPYGXHWWF       ECFAHDGIAKIAIUK GQWFBHFNGSVROV 
KQVPNIAXXFOCW   : FYFQ            BVJWDMYCILSW   
MOYSWCTKL       : XJXWIQAREUAWN   SBBXYQHYS      
LARCDNPNEMGRUI  : AWXRVE          UHTN            TIODRQQPADTOPX  UTCGVOMJOH     
SQJWNRJDQEAS    : HYQV            KBJSFWNY        NHEUGUALRXI    
KGQYG           : QBDDHTECXNI     XOVNAFFMEXXPY   TRKQYM          WPBMVBFNBGQUI   CPXAXSDDHUBKQ  
DMWSCBF         : FVIAA           YVMTHMAQGXKBJI  DSLXEBSO        CGNXUA          IEDETKBJJOCWY  
UCTP            : CYUD            HJMCXBDKOIXCLWT JUKFIBE        
KYTXSFBLM       : TUCTQFMUA       AGCBD           AVASSFHJTYWER   NKVHCDIWADYI   
GMQNEPVNUIKNL   : UKGTAJJWMAL     AUYLTT         
VVIXPAXCB       : QULQTSXEWSO     VNSWVTL        
BTAEHMIOY       : RKTX            PEEHHDRKMGGT    KWEP            NYKFTB          AVIJKUUPJGI    
CDQXSLJFBUSYSE  : HBIMYBUMJMVXWY  VMWVA           GAUOIRAKFDYPJI  CPXAXSDDHUBKQ   JLPTLO          BTVYXPP         KMCDDOJUMAP     FHBTGDSF       
LEXNIPQERVM     : NGPUEMBBRKCMD   TQNOPK          MGJGJBSB        KJJMENMDPG      ALWOLQVIO       KMCDDOJUMAP     KXPNHXFCYAGVFY 
EBGFFLXFFJO     : MBOYH           TJVWASYQQ       JJICYCRIUE      VUNLKVJUQ      
MLEMFKMSOKGYCXE : WIKNHX          BXXY            SQWQPRSBUMEXFTS BKUJQMUSKDBKO  
VQBCTHHYTH      : MKUECBW         TIYRW           MJJANOAVPDEFBAG JMBYEAMYLTUX    WJXMPETLX      
BSVNFHTTMEGH    : ALPEEIDXS       QTATIIWBDQITHH  XXQVNSPY        PLSDJXEBMUJJUV 
SOUVOYSKRTMLCV  : QQWVKWPTRY      XVQEWPKXRSRG    YLBAUXNYTG      IEUDDCUGGALTCM  MUBWWSOC       
XDRBVNO         : SANPTFKETPBUM   CLNCCAT         YSMTTLLUMN      LWNDKPDSA       AFILY          
WJXMPETLX       : ASIGVVYPFAWP    VQBCTHHYTH      GOJUKCFMB      
HVYIOLDIXOMVEMY : OPWURBAPECAUGCV AELF            PBCON           MCGAUWLQLNF     NNFQLWCVARPJ   
NWLFBIQYU       : CMGUHGNTHS      FDPMKC          HNKMNWV         FYFQ            OOAX            VQYNOYUE       
FRSFCCBCM       : LHKITEGOIFUJPBK TOQV            NXILO           CTIJVMQVSRH    
NPBOHNKL        : UAIKGJAFC       GDLQRDWCRSISX   BXYIREQRG       HDCCX           XGVBUXMTGLX    
MJSLWX          : WHIISOFQMMOVLF  ISUQDHBCUJEMXRO QOVGQREUXBIX   
HONFVTWQYYUDDHS : VDSMYCAWQBL     SACNSWDP        UXOCUOEJLSXR    XWCY            NTCIVKVNMIN    
AVIJKUUPJGI     : JGSBHXVB        AFILY           BTAEHMIOY      
FHKMXYRVUQ      : CBXTCISSCW      CRVGAGTIDPOJSI  VKCUF          
VSHYVRUPRQABDXX : PYTJKFB         MKDKPTWIIXMY   
JGCHLLSXJT      : GPMIC           SSTVJEI         VAVVDUD         DNRAO          
GOJUKCFMB       : EAYYBTLUQH      JGSBHXVB        NCYSQBEJUCARN   WJXMPETLX      
HSQAVRETRYFXBNJ : RIOR            VKCUF           CGUXW          
GJYACHQOEDSJPTI : OIQTYDXVMQUK    PENAEEJMBU      COYTH           HUUSCSWBIORVUUX
PYALQGHKFMI     : RBLGHKYJUCTYL   CCWVJGBNXNEC   
ARXICWKGGB      : MBNBDCLENN     
LFOUWKEYAFBLW   : BVBJ            VCWKCBJIEPLAXGH JAQLIVJQHCTKBT  QIGLAYHBTSSWFVL IAVOLCHKELQSFHJ
SJOISXKMWTQV    : BTCBQVOFJCH     LHEW           
XDKU            : OICWADE         TVYSAQSBBSD     DKRTDCP         QBEO            OXNYXPITNKRJW  
RLNOWT          : JXPSXRCXLCFQ    AEEUOKBWRANQVGL LEUTARAKJBX     PPMCYWSURVDACIN RNSJRPXOQ       BGKY           
WAQLYX          : IBKDJPCHXHOCFC  MLHTJA          GVLEEPJJGCBP   
IPOBNAQMVHJ     : PYNN            CEOY            YLXHRTITSNULRK  BTVYXPP        
HOODFGOS        : QKXEF           ORSVWGLLLJLGIH  FNYVEUWGSLF    
NNNLPFYOFFWU    : KASDMUC         CCVYLN          RNSJRPXOQ      
BLWRXUBHBJXQOD  : DTPSXOFJOAFP    MGOQBHAMSGB     QUDDCI          FELEPVSPRFL    
FYWT            : YNXLSRDWGEDRKS  MEOFVD         
NHEUGUALRXI     : XCSCSULKX       SQAYBRAFIQKAVDA BTYKS           SQJWNRJDQEAS    GVRTWXLC        EMDCQUMWMHULXIK
JHOHEQRGCRWQVX  : HWUN            RIOR            GVRTWXLC       
WXRLLY          : BRNAPTLNFVDJRKG RHMSLTTKTODPNBH NFPEGPKKIKTI    GRPNXNNNN       QPELXWDM        SJCJQXYWQMI     QJHMHFGIEJJRABD GLMPIKXMCKL    
GFMITG          : EIKUCMVNBUCVJH  BCOVNYV         RVAOEAETX       FBDLJLNCCSUHH  
CCRKQCOJTULNT   : LQVOUFOPXBN     DADWDGAKCGMD    MEFXGAUWD       EGHCXNI         CTIJVMQVSRH    
JUDISUVGWN      : JHUR            VMJTRRGLU       YNSIFSMSTEJQOV 
CCWVJGBNXNEC    : KKPQLJAD        PJMNIETFV       YYVEIVJKOBVF    YUBFUFBSI       OJIPIPNCAKV     KTYWXXLGXGMMORY BKUGDLQTJAGKXR  PYALQGHKFMI    
QXCCMVHXQMHLJD  : MMXSRRBDSMXG    MRRUFVSMKPJXQJ  GWXMLXWFMMOKQY  KXPNHXFCYAGVFY 
GTGLXGJJM       : KLFPCOABFRWAMBO NLLESYFRD       NQOQJTBAMN     
WMXEPD          : ITWRSJX         TRDCIJLWYKUR    UNSWVKSLDOX     SNLTYLFKEXDSB   OROQYXVSKGD    
NFYADIY         : RAEGU           IOHSOTOCH       HAKJQWB         KTYWXXLGXGMMORY
UIKFLDNHLYIRJ   : CXUSDUHUBLDHJXX NVEGHNHS        XEEI            PYNN           
GVRTWXLC        : BYODJFS         YDOHRISCPGA     NLOEVGRJHBU     JHHUBGUODGHNAA  NHEUGUALRXI     JHOHEQRGCRWQVX 
YJTCODB         : RCYPPSOLLGM     IISBVBPQX       QWUMNQI        
AJYHWCVHNWPIIJ  : WHPNYCLFGEHJBYU JRFQXTPPPJU     XXXEUMQEI      
HBKEBVIVVR      : BCSXHDNSTQCT    LDQWADXQNJHH    WBVTYNMVSFXHTV 
XGVBUXMTGLX     : GFGGSTCPWXEJFQ  GAVMV           NPBOHNKL        DSFOIWGFCQP    
SNDKXMW         : XBRTKJXF        LWNDKPDSA      
TXXAAU          : KLFPCOABFRWAMBO RAISKEDWP       BECIQJN         RXTPPYALHOA     KQBJJDGIADJRYCO SEGAA          
VSCOSIMTFL      : RAISKEDWP       FWLRXTNABG      QJLCPQW         RWJJLJLRKGPV    SQAYBRAFIQKAVDA
BTVYXPP         : RIOR            RTBTUYSIOAJMP   XARVCBRODQI     CDQXSLJFBUSYSE  IPOBNAQMVHJ    
CNPYDLACNCYV    : ALPEEIDXS       WFCUGOBHFYYIW   RIYEFEGHDYNOJG  CCGOKWDADT      AOFSP           LFJX            POUXILQLFLJNKWC
RARKLE          : EMCC           
QRQSLMTLELNJCFI : CDNWTPE         MJJANOAVPDEFBAG
TKHHMGG         : HANWVDGCKY      KJQRGY          GPYJBC          RUKO            OXNYXPITNKRJW   PCYMYF          OOJIENW        
AGHM            : EOJKMV          ELIQ            BCOVNYV         PQKEGYVNPK      NTCIVKVNMIN    
LSLELEPYAC      : RVVROQJWHDTSEW  RUASOLMB        GUOFLIRSKLE     DNNGGJF        
OROQYXVSKGD     : LVDRG           JYCCQGXOJIP     XARVCBRODQI     YQMXTHGVUOKSW   WMXEPD          SORWXGJXGXEM   
OJPPPWE         : MIGWVYCHID     
IAVOLCHKELQSFHJ : PSGPWDEN        BTJHAPPAPFNCMJ  DKRTDCP         VDIMSBMSMERX    ULLKCYVABNG     LFOUWKEYAFBLW  
FIAS            : GQNH            XIUECPD        
DSFOIWGFCQP     : BKGT            PBWD            YLYTPM          XGVBUXMTGLX    
OFNQMBVAT       : LDMXGLOTS       TDLAHQVN        TVYSAQSBBSD    
FBDLJLNCCSUHH   : QKXEF           NBTLKPKQV       ISGNMLO         GAAUCT          GFMITG         
HOKJHANYFBPTE   : EWUDT          
VAFBEKPNVFRAYO  : FWAEKDBSDBMR    NFYWX           YYCPDPRPAXA     NYKFTB         
GTOWE           : DSESGEC         SLLR            MMFLLOXMTQFQOXL JJWVY           RGYREAIER       LOVXFSSWC       LQQRODQB        EYRR           
HENGMRXIVOFYVI  : COVJBCDQ        JUTHKCDIIO      OWPN           
GASCGK          : ICGI            RVGICQLS        PFNNYCI         LOVCSLNUICKXNIQ NVEGHNHS       
FYLNUDNYDWF     : UYPUVIPPGU      ATHSCGG         HMEFO          
DTLDFHRMG       : TUVECHWYXRG     AUYLTT          BTPULPSMN      
WLTXEV          : ORWGCJIQAVCX    FMGBYUCGOY      GTAIPJT         YDCIMCTFMNCKXN 
OANPOBMRQ       : NIGHFSE         TNXFCKSHUVVOG   BCOVNYV         WPBMVBFNBGQUI  
WNTOSPAWUKO     : PSGPWDEN        LIBOETCNTXTDERQ
SDHFWFLV        : OPOIHYH         GWQSTEPPJDC     JUTHKCDIIO      BXXY            TELKRW          EUFPMP         
DXBU            : GUOKDJNLRLXCURL FPPHCBXKXLWF    QUVLPCKDNFW     EMNRYYUDJT      FMESCWM         XBUVMIRU       
EIEVVCLRSFIV    : AVJHOACB        GGMUPNQVOXG     OICWADE         ACEOXO          DJPFMFGWKW     
FIQPBVWITCWR    : KKBLQNJVKJ      HWUN            WQTGXYDADUGEDT  WEBGVJWOHQ      FSMYINKVCHHUN  
APSUDWFJUCNH    : MXIXQJN         NJIFLGWSCSM    
HMEFO           : KQUF            FYLNUDNYDWF    
NHAQEWCABYR     : KKBLQNJVKJ      VYMTEQLQLXICQ   SGRIID          JRMMBMLEL       HIND           
BHLXMKEWGIMNE   : BPYGXHWWF       YEQRGRAPREFHEY  BFGYCAJSPRX     JLTRNPCDX       UUDVFX         
CJBSV           : WIDL            UAOPENEPVAGX    ENCKIEISUNUHMC 
AXIGU           : OLVSGCJKM       ECFAHDGIAKIAIUK UAXWSNSYOL      OJNVIIE        
GXNASQ          : YNXLSRDWGEDRKS  VASQFYIPKB      ECHNNDOFJ       UFOCECJTYUKXRI  MGJGJBSB        MMNBSTRKVBL     FOYJWMGOAYQUCC 
EOWQUVWDJMIF    : OMRHECQCEPJAC   UFOCECJTYUKXRI  JQMNMVER        MEOFVD         
TJHR            : TUVECHWYXRG     BSYANKS         QCNFWRNVEBGWL   ESYVPBIYWUGLG   PDTYUS         
KPKSKW          : YLBAUXNYTG      TRDCIJLWYKUR    GGMUPNQVOXG     LJGQFHOMEXEP    OXHMX          
KMCDDOJUMAP     : CLQQWPUJ        XKSDYWJBIGDEQD  IEGLOVO         SCMYQSIQKQPD    SSVOBNRO        JHHUBGUODGHNAA  CDQXSLJFBUSYSE  LEXNIPQERVM    
AVVOGCECLNT     : KCNOU           JUCIWRTJHACJFE  VYWHCU          NQOQJTBAMN     
AJYVVXXGNCLS    : LQBCJHVCT       RYGS            JLPTLO          FUNYMRLKBV     
UNGWG           : FTJHPK          GRJQLEMUUOXAFD  HEVYPNLTCIOQG   LIYKTOWRQEBOTG  CWXGWVFPENPDLI  LIYTEJEWLC     
YENOKRUMFKISNRR : OBJTIIRVBRNEQN  VNNJTYJCDREEMKE KIWOAEC         EVHYEAWNY       FOLTSGLXRWSPOK 
PSJVG           : RCGYYPQB        JVYGYNBRU       BVVTJC          LHSYQBMRIEQL    NRIOLO          SGLHCMO         DJJJMGVXILMKJ  
JYHEPN          : UGYYGXAHT       PIIJHJCVSHGBLYI NEOAVXOV       
VHDAWTMQOYVYJ   : OBTFCXDM        DOOK           
OBLXQE          : CDFXGBLQXL      WIGBEVMJXAREBEF
OKXXLF          : GQNH            HLAFQQTVSSAP    IIKTY          
BVJWDMYCILSW    : VPNPMCT         JHAQGG          KQVPNIAXXFOCW  
QYVHN           : UQOEQE         
SORWXGJXGXEM    : NIGHFSE         YGTCHGSAJXPGKJ  SVJW            EVJCE           OROQYXVSKGD    
AWYFLXJUKETYUS  : GFQF            RWGN            QPJVGESABWPIKC  GAUOIRAKFDYPJI  JVYGYNBRU       XGFKRMVKBJWXN  
CJUXXNWVVJ      : OJYDLD          QVJWHMKCJFEVDHK
FHBTGDSF        : XLTLNPNXRYBKM   NJFKETSPYCWSJAY LXCCXBJTCLA     EVVOMT          CDQXSLJFBUSYSE 
FETCQXVPURNYBJW : ALPEEIDXS       BGUWEWDJ        CQAM            VPNPMCT         PNACMOLAQHIMGI  EJNBDBKB       
YWYWGTENW       : GRJQLEMUUOXAFD  FJIEKD          EMPU           
TARA            : LIBOETCNTXTDERQ EDPXYOOV       
YGGB            : IULKFIE         XQGFLDHWLB      OCXA            DUCNBCHWRAB     JMIFPFBQALF     DBIGALGJAVPCL  
GAQDTF          : BXVXSLKO        ILUX           
WQCXR           : UTKIAGEQPMFCBO  TYOVMP          TJNFOKI        
WOFTTSQUP       : RBLGHKYJUCTYL   CRVPRPKSFPRY   
MRGMXPPYXRPCLUH : LJYFPU          BQOPYJRLQVMGFVE CEAVFWCWQ       SXOWRJC         DNNGGJF        
NJIFLGWSCSM     : MGVWFQSD        UJLQQMG         RDMKMCCQANFKVV  APSUDWFJUCNH   
NEOAVXOV        : QERLGKS         TDJHTAKYUNUUYMA KURNSASCJKUHVY  JYHEPN         
FUNYMRLKBV      : VCKQF           PLQOC           VCETOCUTMGV     AJYVVXXGNCLS   
NHGYPDRRVGMLKE  : GTDCFJP         YVMTHMAQGXKBJI  BKUJQMUSKDBKO  
IEDETKBJJOCWY   : FKAXJJWGVK      WEBGVJWOHQ      FFXE            OMIXSFVLF       DMWSCBF        
VYSDFR          : CPXBRUUIDYFID   CCVYLN          JHHUBGUODGHNAA 
KMMISBTGH       : SSROOJB         GTWUHFTP        KGATSMQE        CTSFLLPHLYWEVDL FUXYCSKGCBGD   
OLLTFVUPHLTFK   : XJXWIQAREUAWN   SACNSWDP        LUWUPLG         SVDEWPYLNFDSGDW VSLUWROLSYJD   
BKUERMYD        : SWDGDTREXB      LSDV            GRJN            EUSV           
NNUQIBYQRKELQC  : RQPG            JMIFPFBQALF     BEXHCXIJBBHAOL  PUIY           
IJUCOIDRUXV     : KERTGKWMAJVULT  YREJMSENAUDL    EGHCXNI         SVQXBONWFYRL   
NWROMGJEQMD     : FTJHPK          FHJUT           VODOKW          WKMQJ           TMLPI          
HNPUE           : QUVLPCKDNFW     BXWRNAPTIIM     UXOCUOEJLSXR    KCWTWQB         CPYFTRKRTWLL    QMVQIIJTLBR     YLXHRTITSNULRK 
EMDCQUMWMHULXIK : AMUGFFCPNTN     QERLGKS         IQWCKHT         UUSBPKRVDWTWAH  QJHMHFGIEJJRABD NHEUGUALRXI    
AXYJ            : KGOASCHGUHU     JVLYVHGWXPX     ULQJGCQKCWJSWWI
RYFBGSQBA       : QVAKPDMHMGAJV   CEOY            BEWFVLAB        SSHP           
IMPMGMY         : IKXVRBLECWHHTO  ONSNPWV         HPQERPTSXMKYJL  BXWRNAPTIIM     LCHHSVEF       
CIXP            : DADWDGAKCGMD    JIRCGCYNAQS     QQJKR           IXMIHFMWER      PSVG            QQWNP           SXOWRJC         BDSBWIKKSIEGM  
CIXP            : YLEXFWQEJUJNT  
JAYJXAUCRVH     : KCNOU           RKSHDOH         TDJHTAKYUNUUYMA XKSDYWJBIGDEQD  QJNQCXJN        DCCOCK          GDLQRDWCRSISX   NRIOLO         
CDNGDAQRQDXF    : KGOASCHGUHU     OAAIDXU         XGFKRMVKBJWXN   NKXTKIPCDPWFVDS
DHMEYU          : PNHRKAS         HTIYP           PQOJBONHU       VIAYJVVXAIO     OBTFCXDM       
AUYAWVDPSMMWPBD : FNMHLBV         SWGVO           DUCNBCHWRAB     GPPCPVP         XIGSCMS         IPQGHBXLIU     
BVNTYNCDRLRVL   : GTDCFJP         EPMMFDDJC       YFMLWBIV       
LLKKNHIS        : QUVLPCKDNFW     DOUUISFWVLH    
BGKY            : VDVRHEACEJBVQ   EKCSINSHV       FYFQ            HBDFQQOHXHLKRQ  TAXJJIA         RLNOWT         
NETODJLCWNIQYA  : UVAJAQLIE       IXMIHFMWER      DIQRBWUKCDXBC  
KPAX            : WEFKSRTY        IOBQYFXN        FQNIYH         
MMIVHHWNT       : XLTLNPNXRYBKM   SIYULNATOWW     JLTQI           GKKJKYXUJOEDC  
OHFK            : WQSKLYEUJJRLJR  BXXY            HUXVRYXDXNORJYG
IVKMU           : RYXQLHBJCANEHLP VIAYJVVXAIO     DGBRIVHPLXBGE  
WMYABK          : HWGSTMO         UDCYKQQBD       PJFAISOIGEN    
CKSQYB          : NNMNPAJVXCQTG   NFPEGPKKIKTI    NFYWX           DPOCBAFLUYWS    CIYRBECTNJDB   
HKMWHMLQTXPCT   : IOBDIQBWJN      WRKMGRVT       
RPCOECOFOHJBABB : GIGRHM          GPPCPVP         EADC           
PIPCFWPTOJR     : WTNNLNANP       SVIFRJJQTYD    
OOJIENW         : WYDBY           ISGNMLO         FPUDWMMHT       CTNNYDFMPP      CIYRBECTNJDB    TKHHMGG         PLSDJXEBMUJJUV 
ROPIVCKXDL      : MDMRQ           MRAULIAVNETVQ   EJIXEWBCEEJT    UNEOJVGEDVPEGRY RYNINNT        
SVQXBONWFYRL    : BNVCJUMUKUU     BNHIFCQOHQGQVLO NVRJSAHNFLQHFEY IJUCOIDRUXV    
GWXMLXWFMMOKQY  : QXCCMVHXQMHLJD 
TMLPI           : VWKTQ           NWROMGJEQMD    
PLSDJXEBMUJJUV  : KHKRHTHYHGUHEJ  NYJM            LNTAC           IYNIYOOLCGN     IPJFDEWF        JQMNMVER        BSVNFHTTMEGH    OOJIENW        
SSDHHRTY        : VPTFFJLEVUWH    JIRCGCYNAQS     PPHOXEYMUWMKJ   VSUHBXSF       
EUFPMP          : OFARBK          NPAYFCUVBRL     WWWQIIAVU       BDSBWIKKSIEGM   SDHFWFLV       
CBNHMOMPBJYKE   : GIGRHM          LLJRUIAI        VYXVRA          QDQIFBMUEGPLIRS
KXPNHXFCYAGVFY  : NEYXPOVDUKMRSS  LEXNIPQERVM     QXCCMVHXQMHLJD 
WTNXHVNVKD      : CTSFLLPHLYWEVDL NVRJSAHNFLQHFEY
