TRYLSHVC        : KVUIKAHQVE      JGPPGIVACQFNXO  TAGEUCPBMEDXIYI
WGVWFTAXPWFNW   : WCBEGNIGIA      GMHJMAMNAKESAS  WRVNB           DCVD           
PWJMFIDCFWBSSK  : YVUHRPW         KXAMKOFSMRBW    KBTDHANTPV      HODQOTSKOFEKD   RPYHOF         
UAQDW           : PCFADSDWRP      LNSOTOAYWCYEGKP DRKJDWRM       
KSQJIPQYMFOKOER : NCNXNSOVL       PKWR            OKCUYBWXQUBWYJ  KBTDHANTPV      ENYLFV         
JTGIXCBIT       : PIUSUIW         YNYMNMWXFO      BAAXSLC        
JKCIB           : EVKYTASV        RIUPVOJVUXMSB   JMMBNCYQQHC     KYMKETGGD      
BRYLHPKWUCJ     : MRVD            TCOJFXA         DQJGTEUVCXHQA  
GBKRXTAVVCEP    : QHOSC           CYQU            XOFJUNOQ        KOUMNEVOJ      
PCFADSDWRP      : UAQDW           WVWMFLQNUDAE    TIPJFV          CJLETBNWRBNWBMG BOVM            YEWA            NHHRPUV         SSSEUTV        
HAEEENPK        : YQNNWDCMKOGD    EWAKWPJFVQQD   
DEMWFIS         : XODGEWKRSH      YPUWES          JGPPGIVACQFNXO  WXCTGQJDFWCOC   EWKTANCSMD      XRJPGPESH       FXDKWDNGQ      
PKKHOPISLL      : FODCVIULU       OLJMUXDJOT      FEOMV          
DBWNEBRIOKV     : CFEECSGRBJ      MRVQ            XOFJUNOQ        RBLEBEYHKUJ    
NCUKHGF         : NDFDSGBVPFCM    BCBLMNUK        QRPDY           LLVJDFAAAYT     IOOUCKEGRHI     RQQF           
VRDFGVNYJCRMFQ  : EKACFGJCF       KAQJQHAYUMQH    XNJDQMJTOLBQB   JUMHLW          SFNOH           LWSUM          
LUWWLHURUWP     : NIQU            DCVD            SJRHCCTRYW     
FVOXTGEYMCPOLT  : MRVD            KVTGRLB         FWEFEJRION     
XYYD            : DNFWCYUULUEKDJ  GMSKGVHOQM      JATPKJEA        GGVA           
TAIIJDCGARNHNEI : RJFJEGPEB       XTKFTJDATV      IEEIBQPRQWOBK  
KMJWOBLA        : YVUHRPW         KAQJQHAYUMQH    MXAUEUYVWL      GMSKGVHOQM      BOWGPEYMEHFPYG  YEJIWBPKOVTS   
VATVFFRHPCQU    : RCFAUCPJFKVPYA  OKCUYBWXQUBWYJ  NAYEQPSTUKENA   WJER            VAHERFRL        UQWADWVNOC     
WVWMFLQNUDAE    : PCFADSDWRP      SSGSJC          JTEL           
QHOSC           : GBKRXTAVVCEP   
VWJBED          : RTNYPWPIIFDK    HCHCMJYANCS    
WGARLANIOTVIJRL : HEPAJRTCAXAM   
XODGEWKRSH      : DEMWFIS         OIQA            HDQKWTBOKBLDIVT GGVA           
VOGFL           : NDFDSGBVPFCM    RNPFRIGYXAXFX   FHTD            CWNVGRXCPTMMIT  IEEIBQPRQWOBK   CDVWDXUPOWELINX
IDAKT           : FQLNMHWGQILSE   JUMHLW          NJIDNBNVGDCFPVH EHXRPVEPCAFNG  
YPHJYBVLCKPKQ   : VJTFVVHRHL      NCNXNSOVL       BXVFK           CRWYMMYVYLDW    MJQNIUKLVPKI    RIOP            NHHRPUV        
UIJDLFTUNFHXKKI : TJPEMSVPNKD     NJIDNBNVGDCFPVH PGCGPLWCOSTGI   CVCVKD          QCCUVLDULNNWPSA
VJTFVVHRHL      : YPHJYBVLCKPKQ   FKCF            BWVFYMEFCKG     BBQGYLVQKDCUQ   ADKSI          
YVVPQ           : IBERPNCPCRUQRO  LPUPEYOWPVBCP   OVXIRK          YUOGYUXKTACOV  
YVUHRPW         : PWJMFIDCFWBSSK  KMJWOBLA       
YUKJF           : YFVUTPWWPAXY    HSMWMUJQQELNGI  NTQBEKDK       
FQLNMHWGQILSE   : IDAKT           CFEECSGRBJ      RROBFRNAFIDD    HLCW            FDGBBNIVNLP     PKGGWFRVUQCVHIY
IWRKVMTNC       : CFVHORL         YHLKHVQYYAR     OQVHBKUO       
NCNXNSOVL       : KSQJIPQYMFOKOER YPHJYBVLCKPKQ   KPFMWL          CDVWDXUPOWELINX
JYJGHDOSV       : IDRTAIK         QMHNHIAMODNXTA  TCOJFXA         SUDCYLB        
EGTWQRLKIODVSQ  : OVHCATJSV       VDGEGYP        
GLMCXPNWBT      : JFVISUM         OEPPDSGIJ       VCDYQFEMUMKUQE  KSLQKGVKANIK    PQBWRQNM       
EKACFGJCF       : VRDFGVNYJCRMFQ  MBADODDIJ       JCINCEKJYOGU    TJCICXFCK       GKNL           
TRPCGSABM       : HCHCMJYANCS     WSDIQAHSTPNTE  
JXJOVBCUCWCJHE  : IJMJA           LRPYSCCUBYSYNK  KCHSBCK        
PKWR            : KSQJIPQYMFOKOER BMSMSDXNQWL     MJQNIUKLVPKI    NHHRPUV         XRJPGPESH      
ALIR            : MEIKIJXPGYWXQHO KYMKETGGD      
QMQTYPDABTVC    : KQEP            AXSRLEH         GDYNWFQMXJ     
TEVXNFCCUO      : RCFAUCPJFKVPYA  VCJMCCQEYSETR   GVFPUSGPVKIF    DHFWQFWTBBXG   
OHBDPUTIIME     : HADSIY          UIDH           
CKJDEIFBCMY     : NIQU            KFFJEKKUKYVV    TAICDFNBQXJGKF  SABRWKVBFE      RQQF            VAYDEOEPJ      
CFEECSGRBJ      : DBWNEBRIOKV     FQLNMHWGQILSE   SOEQWD         
SFQENDIYI       : LUDDIAFOW       TMLYGDDASQ      WBDKYVK        
JLARTDVIDV      : FODCVIULU       WVPEBP          UONWHYQ         SMQXUULWVCT    
IARKU           : TCJNHFXK        WVPEBP          JFOAHVK         WGUCYUIOSKIR    YHLKHVQYYAR     IOOUCKEGRHI    
EVJBRQTVGXGGGC  : TIPJFV          NIFWUJBYVLSXF   AFSTS          
TCJNHFXK        : IARKU           RJFJEGPEB       MJSCJBFGDU      ILOW            HEPAJRTCAXAM   
LUDDIAFOW       : SFQENDIYI       LGDIGQTR        WJER            RBNPQ          
QOIKMOKSWSWMNYV : QMHNHIAMODNXTA  YBTX            LLVJDFAAAYT    
JDETEPRJU       : GWMRGEIMOGMQY   NLMC            JJBUPAYR        CADFXXAPAKQWKW 
KAQJQHAYUMQH    : VRDFGVNYJCRMFQ  KMJWOBLA        DNFWCYUULUEKDJ  ETLVJVSEQCB     OLJMUXDJOT      WJER            SJXUXCTGSAOI   
NDFDSGBVPFCM    : NCUKHGF         VOGFL           UBPIFDDFBC      LKDNYIJMG       SSQCKBUYDCAKO  
RGXMIIMY        : DQNMMUUWVKQKEOE UIWPL           QFFWYDYOANBIJEQ ENYLFV         
GJTHGIXPROSWRLG : IXMBRXTTBFOK    KEPM            VAIDIFVN        XTPOBEMKCLBFT   IAIGMFHBQXQYVCM IBHXMFL        
KXAMKOFSMRBW    : PWJMFIDCFWBSSK  EWDJYIOWIO      PYLHUJXG        MHBVHU         
DQNMMUUWVKQKEOE : RGXMIIMY        EXAVW           SJRHCCTRYW     
WYAU            : UIWPL           XGDWKXIK       
NIQU            : LUWWLHURUWP     CKJDEIFBCMY     MTJJMTF         RHPXIDWY        MEIKIJXPGYWXQHO
FODCVIULU       : PKKHOPISLL      JLARTDVIDV      QTLTYDYDYHXNE   KVUIKAHQVE      AMOQLJYOLU      BHRFGD         
JRGFCWRIN       : RPUGXRMUTBLF    BDJARMRQGLT     RROBFRNAFIDD   
YMYBIB          : BCBLMNUK        JCDUG          
QTLTYDYDYHXNE   : FODCVIULU       SPMNCMERA       AGKKXBBKDVK     BWVFYMEFCKG     ANCBBNQEYBHUSIV
WVPEBP          : JLARTDVIDV      IARKU           XQLTKKFOJ       NLMC            GLETSJOQRLWOQ   NYDYNECV       
JFVISUM         : GLMCXPNWBT      YQNNWDCMKOGD    SPMNCMERA       RPUGXRMUTBLF    KHTECQKVVFB    
YFVUTPWWPAXY    : YUKJF           ASAWWFGFRO      CQJGE           SSHOKR          PKGGWFRVUQCVHIY
LEKKADOBUML     : JFOAHVK         KQEGHUOQMGMK    FXDKWDNGQ      
KVUIKAHQVE      : TRYLSHVC        FODCVIULU       YPUWES          ASAWWFGFRO      QIQXAABCEYJDUU  BWVFYMEFCKG     KSLQKGVKANIK    AEHKOIBWGHB    
OBJGEHF         : KVTGRLB         DMRVCSLYJHAMXN 
TJPEMSVPNKD     : UIJDLFTUNFHXKKI
VCNEOONFKTRBVB  : FHTD            MSVVYXPJOW      MHBVHU         
AJPHFBWLPSHGGU  : VEHLVALMCVDORW  KLVPWKJEGOUQVUQ XTUHUDVVNVY     IBHXMFL        
YQNNWDCMKOGD    : HAEEENPK        JFVISUM         GWMRGEIMOGMQY   WWGEGYMWMAV     BWVFYMEFCKG    
EGAGPPNWRLJH    : IBERPNCPCRUQRO  IOLKXORHRORB    NHHRPUV        
SPMNCMERA       : QTLTYDYDYHXNE   JFVISUM         AOIAOATTMQV     JJBUPAYR        AMQOTNEXBLDTFTP XYKAQS          GYVOCX         
WEPISWNLBTM     : QYWBOEPNRWOHR   GVFPUSGPVKIF    ADKSI           XRJPGPESH      
MCXJVJUG        : AGKKXBBKDVK     KGUEXOHWNCMED   UJNLXKLSGLTMRLS
OVHCATJSV       : EGTWQRLKIODVSQ  TAGEUCPBMEDXIYI RKRECMGAF       WJER            DCVD           
RCFAUCPJFKVPYA  : VATVFFRHPCQU    TEVXNFCCUO      OKCUYBWXQUBWYJ  LKDNYIJMG       KEPM            QXSUKYWPAKBIPOM DVCCDVEUVRYAVMQ HDKHUTVL       
KYAGFSWDA       : QWADABLE        CHBG            NKRAEEGNVXF    
EVKYTASV        : JKCIB           DDITJUOAMTV     VARYQPLQSN     
TSLJC           : HUTGSKOKS      
VAJWBXIAXOHS    : FLFGR           XTUHUDVVNVY    
KSMQQARKC       : OEPPDSGIJ       ETLVJVSEQCB     YEWA            JATPKJEA       
ILHEWSGPPHY     : GMSKGVHOQM      BHRFGD         
KWWMXL          : DPYD            VARYQPLQSN      XVQSP          
QYEMOXDQPQSD    : MJQNIUKLVPKI   
EKFDEOSVVSK     : FHTD            LXEGMBUMCTQBXXN
RIUPVOJVUXMSB   : JKCIB           LGDIGQTR        TAGEUCPBMEDXIYI CJLETBNWRBNWBMG CYQU            AMQOTNEXBLDTFTP AVXB            LLVJDFAAAYT    
RIUPVOJVUXMSB   : RBNPQ          
LTXOVEABHGPCC   : RNPFRIGYXAXFX   KQEP            AXSRLEH         CADFXXAPAKQWKW  MJQNIUKLVPKI   
UOVPW           : FGYWXXEPFDIRUIO JCINCEKJYOGU    QWFOCBJN        NBLYLXSCMVHG   
HVJQTFOGASLNOJ  : OVXIRK          DEHWVTHOH       GKNL            WJPUATUKPWTWRUW
KPFMWL          : NCNXNSOVL       GMMVICST        WCBEGNIGIA      SUDCYLB         SOEQWD         
YPUWES          : DEMWFIS         KVUIKAHQVE      NRYOALBA        ANCBBNQEYBHUSIV SSHOKR          DRGOJSNXDTS    
EMVCV           : WRVNB           KCFDOMJMT      
VDGEGYP         : EGTWQRLKIODVSQ  NUFIHNCJQH      MJSCJBFGDU     
QYWBOEPNRWOHR   : WEPISWNLBTM     DDITJUOAMTV     DHRGB          
OKCUYBWXQUBWYJ  : KSQJIPQYMFOKOER VATVFFRHPCQU    RCFAUCPJFKVPYA  YGWGFTQHSOU    
OEPPDSGIJ       : GLMCXPNWBT      KSMQQARKC       KVTGRLB        
AGKKXBBKDVK     : QTLTYDYDYHXNE   MCXJVJUG        AMOQLJYOLU      CVVQVKEYULRV    TNUFOBYGRRCAT  
UIWPL           : RGXMIIMY        WYAU            MBADODDIJ       IFEQQ          
OVXFAPUDI       : HODQOTSKOFEKD   CYQU            RUAFYBMYLWVURJ  UQWADWVNOC      NLSNV           WFQEIMNDBYOMUA 
NRYOALBA        : YPUWES          PYUGBAUJN       PYLHUJXG       
CLSAXYUG        : WDQYXTP        
MRVD            : BRYLHPKWUCJ     FVOXTGEYMCPOLT  GGVA           
TIPJFV          : PCFADSDWRP      EVJBRQTVGXGGGC  XGDWKXIK        ELVJXVNBGNHVF  
IJMJA           : JXJOVBCUCWCJHE  IXMBRXTTBFOK    TLOTAOTUUQU     BOVM            WWGEGYMWMAV     BBQGYLVQKDCUQ   RBLEBEYHKUJ     ENYLFV         
IJMJA           : GGVA           
UBPIFDDFBC      : NDFDSGBVPFCM    OLJMUXDJOT      DXPYIEHJFUKTLW  EWDJYIOWIO      XJEMQHPUXLBQYWH QWFOCBJN       
HYOBWRRQAJAHHUR : QWADABLE        AVXB           
JDTX            : KCHSBCK         BBQGYLVQKDCUQ  
XNJDQMJTOLBQB   : VRDFGVNYJCRMFQ  GOXNQAARN      
NSYHV           : KCHSBCK         TAICDFNBQXJGKF  WQHIK          
HFSEXKNBGM      : GWIUUIGIMCLE    ISWYJDHMMO      MUJPCBN         WJPUATUKPWTWRUW
ECLIT           : WKCBQMUN        KQEGHUOQMGMK   
RNPFRIGYXAXFX   : VOGFL           LTXOVEABHGPCC   IBERPNCPCRUQRO  AEYS            HLCW           
NDBT            : SOEQWD          XXCWGTMQVWY    
NIFWUJBYVLSXF   : EVJBRQTVGXGGGC  TMLYGDDASQ      KOUMNEVOJ      
PLDXREWTEC      : BOVM            EWAKWPJFVQQD    TXAKEYN        
MRVQ            : DBWNEBRIOKV     WGUCYUIOSKIR    KLVPWKJEGOUQVUQ IPOEWBKM       
YGWGFTQHSOU     : OKCUYBWXQUBWYJ  PMTNDR          ITDENLYBC       WSDIQAHSTPNTE  
MBADODDIJ       : EKACFGJCF       UIWPL           BHRFGD          LWSUM           PXKBKGFV       
DNFWCYUULUEKDJ  : XYYD            KAQJQHAYUMQH    WQFJNK         
TSXKOMXRMDGRGQ  : WDHWNN          NKRAEEGNVXF    
JTQQTSPOOEL     : JMMBNCYQQHC     RHPXIDWY        QCCUVLDULNNWPSA
OPEVLXTWMIWGUAM : MDQPBNUNUB      EWAKWPJFVQQD    NYDYNECV       
IDRTAIK         : JYJGHDOSV       LGDIGQTR        CRKSMBO         XJEMQHPUXLBQYWH
DDITJUOAMTV     : EVKYTASV        QYWBOEPNRWOHR   UXUOPS          TNUFOBYGRRCAT  
RPUGXRMUTBLF    : JRGFCWRIN       JFVISUM         GWLOUC          CQJGE           NBLYLXSCMVHG   
DYGNMCRPNLBKBB  : SADLLOKBB      
UXUOPS          : DDITJUOAMTV     NLMC            HDKHUTVL       
QMHNHIAMODNXTA  : JYJGHDOSV       QOIKMOKSWSWMNYV EIBRJTRUADDYSD  DHFWQFWTBBXG   
LRPYSCCUBYSYNK  : JXJOVBCUCWCJHE  LNSOTOAYWCYEGKP
IBERPNCPCRUQRO  : YVVPQ           EGAGPPNWRLJH    RNPFRIGYXAXFX   QYBLUJCQVKVOEI  BXVFK           IFEQQ          
VCJMCCQEYSETR   : TEVXNFCCUO      MJQNIUKLVPKI    WDHWNN         
FLFGR           : VAJWBXIAXOHS    CQJGE           CVCVKD          WQFJNK         
XGAPITNYNCSJHC  : HLJBBPCYKKD     AATDF           AEHKOIBWGHB     VRIAR           GWOG           
JGPPGIVACQFNXO  : TRYLSHVC        DEMWFIS         BWVFYMEFCKG     KQEP           
UONWHYQ         : JLARTDVIDV      KFFJEKKUKYVV    IPOEWBKM        QIQXAABCEYJDUU 
AEYS            : RNPFRIGYXAXFX   XYKAQS          ADEQTG         
GWMRGEIMOGMQY   : JDETEPRJU       YQNNWDCMKOGD    FNSHQ           VCKMLYPEP       DHFWQFWTBBXG   
GWLOUC          : RPUGXRMUTBLF    PTIKDTUU       
RJFJEGPEB       : TAIIJDCGARNHNEI TCJNHFXK        LIYURLGTOWXNJKQ OVXIRK         
KBTDHANTPV      : PWJMFIDCFWBSSK  KSQJIPQYMFOKOER IEEIBQPRQWOBK  
GVFPUSGPVKIF    : TEVXNFCCUO      WEPISWNLBTM     IESPVQQEI       TJCICXFCK       LYGUGCBPLXSUXGJ XJEMQHPUXLBQYWH SJRHCCTRYW      SSMPPEK        
TKBJOCQBF       : HODQOTSKOFEKD   YEJIWBPKOVTS    OQVHBKUO        MHBVHU         
GMMVICST        : KPFMWL         
QYBLUJCQVKVOEI  : IBERPNCPCRUQRO  VEHLVALMCVDORW  HSMWMUJQQELNGI  LNSOTOAYWCYEGKP KCFDOMJMT      
PYUGBAUJN       : NRYOALBA        JMMBNCYQQHC     LPUPEYOWPVBCP   DVYIPLYHPHP     RQQF           
IXMBRXTTBFOK    : GJTHGIXPROSWRLG IJMJA           KVTGRLB         DKKHGY         
FHTD            : VOGFL           VCNEOONFKTRBVB  EKFDEOSVVSK     TMLYGDDASQ      QWFOCBJN       
AMOQLJYOLU      : FODCVIULU       AGKKXBBKDVK     PIUSUIW         BOVM            HEPAJRTCAXAM   
BDJARMRQGLT     : JRGFCWRIN       BNEIVR          GKNL           
CFVHORL         : IWRKVMTNC       EXAVW           MHBVHU         
SADLLOKBB       : DYGNMCRPNLBKBB  JGTKSUUJLHOAE   HEPAJRTCAXAM   
ECMNEFAWXG      : ETLVJVSEQCB     JTEL            ADKSI          
RTNYPWPIIFDK    : VWJBED          INERSTQEYPQRPTL
QWADABLE        : KYAGFSWDA       HYOBWRRQAJAHHUR RKRECMGAF      
XTKFTJDATV      : TAIIJDCGARNHNEI JUMHLW          AXSRLEH         WAISJYDACNM     GEVJY          
JUMHLW          : VRDFGVNYJCRMFQ  IDAKT           XTKFTJDATV     
SADBSABVCEHIM   : NAYEQPSTUKENA   SPQHVUT        
CWNVGRXCPTMMIT  : VOGFL           PMTNDR          UJNLXKLSGLTMRLS
FNSHQ           : GWMRGEIMOGMQY   EXAVW          
ASAWWFGFRO      : YFVUTPWWPAXY    KVUIKAHQVE      FWEFEJRION      RIOP            FEOMV          
QFFWYDYOANBIJEQ : RGXMIIMY        HLCW            WQFJNK          WBDKYVK        
WAQTDKUCJCIPTA  : FKCF            LLVJDFAAAYT    
KFFJEKKUKYVV    : CKJDEIFBCMY     UONWHYQ         FEOMV          
AOIAOATTMQV     : SPMNCMERA       KNUFDJXEDKXDNO 
SFNOH           : VRDFGVNYJCRMFQ  PRTVDRFUDB     
BMSMSDXNQWL     : PKWR            YEWA           
HODQOTSKOFEKD   : PWJMFIDCFWBSSK  OVXFAPUDI       TKBJOCQBF       KSLQKGVKANIK    WQFJNK         
RROBFRNAFIDD    : FQLNMHWGQILSE   JRGFCWRIN       OVXIRK          JATPKJEA       
VCKMLYPEP       : GWMRGEIMOGMQY   XVQSP           WXCTGQJDFWCOC  
WCBEGNIGIA      : WGVWFTAXPWFNW   KPFMWL          YHLKHVQYYAR     LNSOTOAYWCYEGKP XJEMQHPUXLBQYWH PXKBKGFV       
JFOAHVK         : IARKU           LEKKADOBUML    
YHJDTVPUOVKB    : WJER           
MEXV            : CHBG            KQEGHUOQMGMK   
IEEIBQPRQWOBK   : TAIIJDCGARNHNEI VOGFL           KBTDHANTPV     
KVTGRLB         : FVOXTGEYMCPOLT  OBJGEHF         OEPPDSGIJ       IXMBRXTTBFOK    DXPYIEHJFUKTLW  LWSUM           CDQYV          
HLJBBPCYKKD     : XGAPITNYNCSJHC  BOVM            BWVFYMEFCKG     LLVJDFAAAYT    
VEHLVALMCVDORW  : AJPHFBWLPSHGGU  QYBLUJCQVKVOEI  MEIKIJXPGYWXQHO JNICFRJGBGO     NBLYLXSCMVHG   
LIYURLGTOWXNJKQ : RJFJEGPEB      
GWIUUIGIMCLE    : HFSEXKNBGM      EYKWRO         
KCHSBCK         : JXJOVBCUCWCJHE  JDTX            NSYHV           EWDJYIOWIO      PKEGWWTWCALFUAH
LGDIGQTR        : LUDDIAFOW       RIUPVOJVUXMSB   IDRTAIK         HFFMGX          DRGOJSNXDTS    
TAGEUCPBMEDXIYI : TRYLSHVC        OVHCATJSV       RIUPVOJVUXMSB   JDONPFYYJHFCD   TJRADQF         TAHHUYXC       
JDONPFYYJHFCD   : TAGEUCPBMEDXIYI LXEGMBUMCTQBXXN SSMPPEK        
MXAUEUYVWL      : KMJWOBLA        XXCWGTMQVWY     YVUHNCPIKUP     DHRGB          
CJLETBNWRBNWBMG : PCFADSDWRP      RIUPVOJVUXMSB   JTEL            GGVA           
TLOTAOTUUQU     : IJMJA           RKRECMGAF       MUJPCBN         DHFWQFWTBBXG    PBSESHBGOYJ    
PIUSUIW         : JTGIXCBIT       AMOQLJYOLU      XVQSP           XTPOBEMKCLBFT   GOXNQAARN      
JMMBNCYQQHC     : JKCIB           JTQQTSPOOEL     PYUGBAUJN       WDHWNN          SECQQGEWLCU    
SSGSJC          : WVWMFLQNUDAE    EWAKWPJFVQQD    XXCWGTMQVWY     TAHHUYXC       
ETLVJVSEQCB     : KAQJQHAYUMQH    KSMQQARKC       ECMNEFAWXG      MDQPBNUNUB      JCINCEKJYOGU    YVUHNCPIKUP    
LPUPEYOWPVBCP   : YVVPQ           PYUGBAUJN       LMBHHNLBNKN     IOLKXORHRORB    OIQA           
LKDNYIJMG       : NDFDSGBVPFCM    RCFAUCPJFKVPYA  TMLYGDDASQ      VAHERFRL       
JAACEEIRTFH     : HSMWMUJQQELNGI  KGUEXOHWNCMED   PKEGWWTWCALFUAH
EXAVW           : DQNMMUUWVKQKEOE CFVHORL         FNSHQ           SOEQWD          LVPTXQJKQEFOM   NKRAEEGNVXF     WSDIQAHSTPNTE  
BOVM            : PCFADSDWRP      IJMJA           PLDXREWTEC      AMOQLJYOLU      HLJBBPCYKKD     MDQPBNUNUB      WRVNB           HADSIY         
BCBLMNUK        : NCUKHGF         YMYBIB          FWEFEJRION      ISWYJDHMMO     
WKCBQMUN        : ECLIT           AATDF           JGTKSUUJLHOAE  
DPYD            : KWWMXL          CRKSMBO         XTPOBEMKCLBFT   XRJPGPESH      
VARYQPLQSN      : EVKYTASV        KWWMXL          BWVFYMEFCKG     RHPXIDWY        PBSESHBGOYJ     ILOW           
HCHCMJYANCS     : VWJBED          TRPCGSABM      
WGUCYUIOSKIR    : IARKU           MRVQ            ANCBBNQEYBHUSIV
AFSTS           : EVJBRQTVGXGGGC  EIBRJTRUADDYSD 
BXVFK           : YPHJYBVLCKPKQ   IBERPNCPCRUQRO  RBLEBEYHKUJ    
GMSKGVHOQM      : XYYD            KMJWOBLA        ILHEWSGPPHY     VAIDIFVN        MJSCJBFGDU      ITDENLYBC       QWFOCBJN       
NUFIHNCJQH      : VDGEGYP         ADKSI           TNUFOBYGRRCAT   RBLEBEYHKUJ    
MDQPBNUNUB      : OPEVLXTWMIWGUAM ETLVJVSEQCB     BOVM            BOWGPEYMEHFPYG  PYLHUJXG        SSMPPEK        
OLJMUXDJOT      : PKKHOPISLL      KAQJQHAYUMQH    UBPIFDDFBC      YEWA            CRJHKSONBFRMJ  
TCOJFXA         : BRYLHPKWUCJ     JYJGHDOSV       HADSIY          SSQCKBUYDCAKO  
DMRVCSLYJHAMXN  : OBJGEHF         VMNYBT          WJPUATUKPWTWRUW
KLVPWKJEGOUQVUQ : AJPHFBWLPSHGGU  MRVQ            DVCCDVEUVRYAVMQ GKNL            GEVJY           GYVOCX         
XGDWKXIK        : WYAU            TIPJFV         
PMTNDR          : YGWGFTQHSOU     CWNVGRXCPTMMIT  DQJGTEUVCXHQA   MJSCJBFGDU      NHHRPUV         RBNPQ          
OQQL            : NJIDNBNVGDCFPVH YEJIWBPKOVTS    WSDIQAHSTPNTE  
CRKSMBO         : IDRTAIK         DPYD            DQJGTEUVCXHQA  
TAICDFNBQXJGKF  : CKJDEIFBCMY     NSYHV           SABRWKVBFE     
NAYEQPSTUKENA   : VATVFFRHPCQU    SADBSABVCEHIM   VJSEPBDOADTP    EWAKWPJFVQQD   
FKCF            : VJTFVVHRHL      WAQTDKUCJCIPTA  TJRADQF         INERSTQEYPQRPTL
EIBRJTRUADDYSD  : QMHNHIAMODNXTA  AFSTS           DXPYIEHJFUKTLW 
XVQSP           : KWWMXL          VCKMLYPEP       PIUSUIW         VCDYQFEMUMKUQE  HLCW            PQBWRQNM        HEPAJRTCAXAM   
FWEFEJRION      : FVOXTGEYMCPOLT  ASAWWFGFRO      BCBLMNUK       
WQHIK           : NSYHV           KUOBYDDBF      
GMHJMAMNAKESAS  : WGVWFTAXPWFNW   ISWYJDHMMO      GYVOCX         
WWGEGYMWMAV     : YQNNWDCMKOGD    IJMJA          
KEPM            : GJTHGIXPROSWRLG RCFAUCPJFKVPYA  LWSUM          
CVVQVKEYULRV    : AGKKXBBKDVK     XQLTKKFOJ       HSMWMUJQQELNGI  HLCW           
SUDCYLB         : JYJGHDOSV       KPFMWL          XXCWGTMQVWY    
IPOEWBKM        : MRVQ            UONWHYQ         ELUJPLUO        MEHOQOJVSAGQXNT
XQLTKKFOJ       : WVPEBP          CVVQVKEYULRV    RKRECMGAF       HQLDVRPMRKJ     SABRWKVBFE     
ADXGWTLBUWE     : CHBG            VMNYBT         
HTYLSCYFSWX     : OVXIRK          JGTKSUUJLHOAE   CDQYV          
QIQXAABCEYJDUU  : KVUIKAHQVE      UONWHYQ         WDQYXTP        
QSIAC           : ERNLSDSA        IAIGMFHBQXQYVCM SABRWKVBFE     
BOWGPEYMEHFPYG  : KMJWOBLA        MDQPBNUNUB      WLRRCPIJOA      MJQNIUKLVPKI   
BHRFGD          : FODCVIULU       ILHEWSGPPHY     MBADODDIJ       VMNYBT          SECQQGEWLCU    
CYQU            : GBKRXTAVVCEP    RIUPVOJVUXMSB   OVXFAPUDI      
BWVFYMEFCKG     : VJTFVVHRHL      QTLTYDYDYHXNE   KVUIKAHQVE      YQNNWDCMKOGD    JGPPGIVACQFNXO  HLJBBPCYKKD     VARYQPLQSN      PGCGPLWCOSTGI  
BWVFYMEFCKG     : VAYDEOEPJ      
RPYHOF          : PWJMFIDCFWBSSK  NJIDNBNVGDCFPVH HEPAJRTCAXAM   
SMQXUULWVCT     : JLARTDVIDV      MBQRJFBHVHCCN  
ERNLSDSA        : QSIAC           IAIGMFHBQXQYVCM SJRHCCTRYW     
FGYWXXEPFDIRUIO : UOVPW           NJIDNBNVGDCFPVH NBLYLXSCMVHG   
TMLYGDDASQ      : SFQENDIYI       NIFWUJBYVLSXF   FHTD            LKDNYIJMG       KSLQKGVKANIK    YBTX            KILVJGXX       
VJSEPBDOADTP    : NAYEQPSTUKENA   RBLEBEYHKUJ     FXDKWDNGQ       KILVJGXX       
WXCTGQJDFWCOC   : DEMWFIS         VCKMLYPEP       RUAFYBMYLWVURJ  ADEQTG         
OVXIRK          : YVVPQ           HVJQTFOGASLNOJ  RJFJEGPEB       RROBFRNAFIDD    HTYLSCYFSWX    
VCDYQFEMUMKUQE  : GLMCXPNWBT      XVQSP           JATPKJEA        WDQYXTP        
KQEP            : QMQTYPDABTVC    LTXOVEABHGPCC   JGPPGIVACQFNXO  UIDH            XXCWGTMQVWY    
IESPVQQEI       : GVFPUSGPVKIF    HADSIY          RHPXIDWY       
HFFMGX          : LGDIGQTR        WDQYXTP         DKKHGY         
NLMC            : JDETEPRJU       WVPEBP          UXUOPS          DRKJDWRM       
JTEL            : WVWMFLQNUDAE    ECMNEFAWXG      CJLETBNWRBNWBMG HSMWMUJQQELNGI  OIQA           
WRVNB           : WGVWFTAXPWFNW   EMVCV           BOVM           
ISWYJDHMMO      : HFSEXKNBGM      BCBLMNUK        GMHJMAMNAKESAS 
AXSRLEH         : QMQTYPDABTVC    LTXOVEABHGPCC   XTKFTJDATV      MIYMUS          HLCW           
CQJGE           : YFVUTPWWPAXY    RPUGXRMUTBLF    FLFGR           PTIKDTUU        DVYIPLYHPHP     HDKHUTVL       
EWKTANCSMD      : DEMWFIS         KNUFDJXEDKXDNO  KOOBHIDIC      
RKRECMGAF       : OVHCATJSV       QWADABLE        TLOTAOTUUQU     XQLTKKFOJ      
NJIDNBNVGDCFPVH : IDAKT           UIJDLFTUNFHXKKI OQQL            RPYHOF          FGYWXXEPFDIRUIO DEHWVTHOH      
AATDF           : XGAPITNYNCSJHC  WKCBQMUN        LLVJDFAAAYT     FXDKWDNGQ      
QXSUKYWPAKBIPOM : RCFAUCPJFKVPYA  ULAV            ADKSI          
MUJPCBN         : HFSEXKNBGM      TLOTAOTUUQU     RBNPQ          
HQLDVRPMRKJ     : XQLTKKFOJ       HDQKWTBOKBLDIVT GGVA           
JGTKSUUJLHOAE   : SADLLOKBB       WKCBQMUN        HTYLSCYFSWX     MEHOQOJVSAGQXNT
PGCGPLWCOSTGI   : UIJDLFTUNFHXKKI BWVFYMEFCKG     AVXB           
QRPDY           : NCUKHGF         KUOBYDDBF      
PTIKDTUU        : GWLOUC          CQJGE           WLRRCPIJOA      GVPHNFDRXHUD    ITDENLYBC       NVQWSKTEBUCXCP 
YUOGYUXKTACOV   : YVVPQ           IOLKXORHRORB    DRKJDWRM       
WJER            : VATVFFRHPCQU    LUDDIAFOW       KAQJQHAYUMQH    OVHCATJSV       YHJDTVPUOVKB    VAYDEOEPJ      
HSMWMUJQQELNGI  : YUKJF           QYBLUJCQVKVOEI  JAACEEIRTFH     CVVQVKEYULRV    JTEL            JCINCEKJYOGU    ELUJPLUO       
MIYMUS          : AXSRLEH         PRTVDRFUDB      WSDIQAHSTPNTE  
YHLKHVQYYAR     : IWRKVMTNC       IARKU           WCBEGNIGIA     
YEJIWBPKOVTS    : KMJWOBLA        TKBJOCQBF       OQQL            BBQGYLVQKDCUQ   MJSCJBFGDU     
CRWYMMYVYLDW    : YPHJYBVLCKPKQ   DEHWVTHOH       TXAKEYN        
CVCVKD          : UIJDLFTUNFHXKKI FLFGR          
ULAV            : QXSUKYWPAKBIPOM
LMBHHNLBNKN     : LPUPEYOWPVBCP   BBQGYLVQKDCUQ  
JJBUPAYR        : JDETEPRJU       SPMNCMERA      
DQJGTEUVCXHQA   : BRYLHPKWUCJ     PMTNDR          CRKSMBO         WDHWNN          NLSNV           MHBVHU         
ANCBBNQEYBHUSIV : QTLTYDYDYHXNE   YPUWES          WGUCYUIOSKIR    XOFJUNOQ        ADKSI           GFEWHITFVWAJN  
HADSIY          : OHBDPUTIIME     BOVM            TCOJFXA         IESPVQQEI       VAPHGMBSD       PKGGWFRVUQCVHIY
DVCCDVEUVRYAVMQ : RCFAUCPJFKVPYA  KLVPWKJEGOUQVUQ ADKSI           WBDKYVK        
MTJJMTF         : NIQU           
DHFWQFWTBBXG    : TEVXNFCCUO      QMHNHIAMODNXTA  GWMRGEIMOGMQY   TLOTAOTUUQU     QWFOCBJN       
CDVWDXUPOWELINX : VOGFL           NCNXNSOVL       MBQRJFBHVHCCN  
VAIDIFVN        : GJTHGIXPROSWRLG GMSKGVHOQM      XTPOBEMKCLBFT   RBNPQ          
SOEQWD          : CFEECSGRBJ      KPFMWL          NDBT            EXAVW           VAPHGMBSD       PKGGWFRVUQCVHIY
BBQGYLVQKDCUQ   : VJTFVVHRHL      IJMJA           JDTX            YEJIWBPKOVTS    LMBHHNLBNKN     CDQYV          
XOFJUNOQ        : GBKRXTAVVCEP    DBWNEBRIOKV     ANCBBNQEYBHUSIV
TJRADQF         : TAGEUCPBMEDXIYI FKCF           
RHPXIDWY        : NIQU            JTQQTSPOOEL     VARYQPLQSN      IESPVQQEI       NHHRPUV        
ADKSI           : VJTFVVHRHL      WEPISWNLBTM     ECMNEFAWXG      NUFIHNCJQH      QXSUKYWPAKBIPOM ANCBBNQEYBHUSIV DVCCDVEUVRYAVMQ CHBG           
ADKSI           : FDGBBNIVNLP     GYVOCX         
KNUFDJXEDKXDNO  : AOIAOATTMQV     EWKTANCSMD      GVPHNFDRXHUD    LWSUM           ILOW           
MJSCJBFGDU      : TCJNHFXK        VDGEGYP         GMSKGVHOQM      PMTNDR          YEJIWBPKOVTS    ITDENLYBC      
IFEQQ           : UIWPL           IBERPNCPCRUQRO  XRJPGPESH      
ELVJXVNBGNHVF   : TIPJFV         
IOLKXORHRORB    : EGAGPPNWRLJH    LPUPEYOWPVBCP   YUOGYUXKTACOV  
XTPOBEMKCLBFT   : GJTHGIXPROSWRLG PIUSUIW         DPYD            VAIDIFVN        JNICFRJGBGO    
OQVHBKUO        : IWRKVMTNC       TKBJOCQBF      
KGUEXOHWNCMED   : MCXJVJUG        JAACEEIRTFH     KMKYSVUMPPFM   
TNUFOBYGRRCAT   : AGKKXBBKDVK     DDITJUOAMTV     NUFIHNCJQH      GEVJY          
UIDH            : OHBDPUTIIME     KQEP           
AMQOTNEXBLDTFTP : SPMNCMERA       RIUPVOJVUXMSB   GBKPKIRTVHHUADR
KSLQKGVKANIK    : GLMCXPNWBT      KVUIKAHQVE      HODQOTSKOFEKD   TMLYGDDASQ     
PBSESHBGOYJ     : TLOTAOTUUQU     VARYQPLQSN      SSSEUTV         WFQEIMNDBYOMUA 
DEHWVTHOH       : HVJQTFOGASLNOJ  NJIDNBNVGDCFPVH CRWYMMYVYLDW    GWOG           
YNYMNMWXFO      : JTGIXCBIT       MEHOQOJVSAGQXNT NTQBEKDK       
XTUHUDVVNVY     : AJPHFBWLPSHGGU  VAJWBXIAXOHS    GKNL           
DXPYIEHJFUKTLW  : UBPIFDDFBC      KVTGRLB         EIBRJTRUADDYSD  UJNLXKLSGLTMRLS
JCINCEKJYOGU    : EKACFGJCF       UOVPW           ETLVJVSEQCB     HSMWMUJQQELNGI  SSQCKBUYDCAKO  
EWAKWPJFVQQD    : HAEEENPK        PLDXREWTEC      OPEVLXTWMIWGUAM SSGSJC          NAYEQPSTUKENA  
BAAXSLC         : JTGIXCBIT       MEHOQOJVSAGQXNT NKRAEEGNVXF     WFQEIMNDBYOMUA 
AEHKOIBWGHB     : KVUIKAHQVE      XGAPITNYNCSJHC 
HLCW            : FQLNMHWGQILSE   RNPFRIGYXAXFX   QFFWYDYOANBIJEQ XVQSP           CVVQVKEYULRV    AXSRLEH         SSHOKR          TXAKEYN        
KUOBYDDBF       : WQHIK           QRPDY          
VRIAR           : XGAPITNYNCSJHC  PKEGWWTWCALFUAH QCCUVLDULNNWPSA
JCDUG           : YMYBIB          KHTECQKVVFB     QCCUVLDULNNWPSA
BNEIVR          : BDJARMRQGLT     GKNL           
SPUQHYPM        : PKEGWWTWCALFUAH QCCUVLDULNNWPSA SPQHVUT        
SSHOKR          : YFVUTPWWPAXY    YPUWES          HLCW           
CHBG            : KYAGFSWDA       MEXV            ADXGWTLBUWE     ADKSI          
VMNYBT          : DMRVCSLYJHAMXN  ADXGWTLBUWE     BHRFGD         
WLRRCPIJOA      : BOWGPEYMEHFPYG  PTIKDTUU        NTQBEKDK       
SSQCKBUYDCAKO   : NDFDSGBVPFCM    TCOJFXA         JCINCEKJYOGU    PQBWRQNM       
YEWA            : PCFADSDWRP      KSMQQARKC       BMSMSDXNQWL     OLJMUXDJOT      SSMPPEK         KOUMNEVOJ      
EYKWRO          : GWIUUIGIMCLE    XJEMQHPUXLBQYWH UVLCBRECFOAUB  
CADFXXAPAKQWKW  : JDETEPRJU       LTXOVEABHGPCC   CDQYV           PXKBKGFV       
MJQNIUKLVPKI    : YPHJYBVLCKPKQ   PKWR            QYEMOXDQPQSD    LTXOVEABHGPCC   VCJMCCQEYSETR   BOWGPEYMEHFPYG  VAYDEOEPJ       UJNLXKLSGLTMRLS
EWDJYIOWIO      : KXAMKOFSMRBW    UBPIFDDFBC      KCHSBCK         WDQYXTP        
IAIGMFHBQXQYVCM : GJTHGIXPROSWRLG QSIAC           ERNLSDSA       
TXAKEYN         : PLDXREWTEC      CRWYMMYVYLDW    HLCW            WSDIQAHSTPNTE  
XXCWGTMQVWY     : NDBT            MXAUEUYVWL      SSGSJC          SUDCYLB         KQEP            QCCUVLDULNNWPSA
EHNUHFVFH       : FEOMV           ATNWGIIYSFR    
WDHWNN          : TSXKOMXRMDGRGQ  VCJMCCQEYSETR   JMMBNCYQQHC     DQJGTEUVCXHQA   GFEWHITFVWAJN   SECQQGEWLCU     ATNWGIIYSFR    
DCVD            : WGVWFTAXPWFNW   LUWWLHURUWP     OVHCATJSV      
TJCICXFCK       : EKACFGJCF       GVFPUSGPVKIF    XRJPGPESH       KOUMNEVOJ      
LYGUGCBPLXSUXGJ : GVFPUSGPVKIF   
LNSOTOAYWCYEGKP : UAQDW           LRPYSCCUBYSYNK  QYBLUJCQVKVOEI  WCBEGNIGIA      PYLHUJXG        GGVA           
LVPTXQJKQEFOM   : EXAVW           AVXB            LLVJDFAAAYT    
LXEGMBUMCTQBXXN : EKFDEOSVVSK     JDONPFYYJHFCD   GVPHNFDRXHUD   
PYLHUJXG        : KXAMKOFSMRBW    NRYOALBA        MDQPBNUNUB      LNSOTOAYWCYEGKP WFQEIMNDBYOMUA 
PKEGWWTWCALFUAH : KCHSBCK         JAACEEIRTFH     VRIAR           SPUQHYPM        LWSUM           HDKHUTVL       
RIOP            : YPHJYBVLCKPKQ   ASAWWFGFRO      RQQF            KILVJGXX       
EHXRPVEPCAFNG   : IDAKT           DVYIPLYHPHP     QCCUVLDULNNWPSA
MEIKIJXPGYWXQHO : ALIR            NIQU            VEHLVALMCVDORW  QCCUVLDULNNWPSA
GVPHNFDRXHUD    : PTIKDTUU        KNUFDJXEDKXDNO  LXEGMBUMCTQBXXN DKKHGY         
DRKJDWRM        : UAQDW           NLMC            YUOGYUXKTACOV   BDHTHFPDG      
HUTGSKOKS       : TSLJC           RUAFYBMYLWVURJ  IBHXMFL        
GLETSJOQRLWOQ   : WVPEBP          ELUJPLUO        NYDYNECV       
YBTX            : QOIKMOKSWSWMNYV TMLYGDDASQ      IOOUCKEGRHI     UQWADWVNOC     
ITDENLYBC       : YGWGFTQHSOU     GMSKGVHOQM      PTIKDTUU        MJSCJBFGDU      PRTVDRFUDB     
VAPHGMBSD       : HADSIY          SOEQWD          MSVVYXPJOW     
KOOBHIDIC       : EWKTANCSMD      IOOUCKEGRHI    
ELUJPLUO        : IPOEWBKM        HSMWMUJQQELNGI  GLETSJOQRLWOQ   QCCUVLDULNNWPSA
XYKAQS          : SPMNCMERA       AEYS            RBLEBEYHKUJ    
DVYIPLYHPHP     : PYUGBAUJN       CQJGE           EHXRPVEPCAFNG   DHRGB          
PRTVDRFUDB      : SFNOH           MIYMUS          ITDENLYBC       MEHOQOJVSAGQXNT
RBLEBEYHKUJ     : DBWNEBRIOKV     IJMJA           BXVFK           NUFIHNCJQH      VJSEPBDOADTP    XYKAQS          PXKBKGFV       
LWSUM           : VRDFGVNYJCRMFQ  MBADODDIJ       KVTGRLB         KEPM            KNUFDJXEDKXDNO  PKEGWWTWCALFUAH
KHTECQKVVFB     : JFVISUM         JCDUG           DKKHGY         
RUAFYBMYLWVURJ  : OVXFAPUDI       WXCTGQJDFWCOC   HUTGSKOKS       WQFJNK         
MEHOQOJVSAGQXNT : IPOEWBKM        JGTKSUUJLHOAE   YNYMNMWXFO      BAAXSLC         PRTVDRFUDB     
GOXNQAARN       : XNJDQMJTOLBQB   PIUSUIW        
NKRAEEGNVXF     : KYAGFSWDA       TSXKOMXRMDGRGQ  EXAVW           BAAXSLC        
VAHERFRL        : VATVFFRHPCQU    LKDNYIJMG       SJXUXCTGSAOI   
ADEQTG          : AEYS            WXCTGQJDFWCOC  
NTQBEKDK        : YUKJF           YNYMNMWXFO      WLRRCPIJOA     
KYMKETGGD       : JKCIB           ALIR           
XJEMQHPUXLBQYWH : UBPIFDDFBC      IDRTAIK         GVFPUSGPVKIF    WCBEGNIGIA      EYKWRO         
DRGOJSNXDTS     : YPUWES          LGDIGQTR        ILOW           
AVXB            : RIUPVOJVUXMSB   HYOBWRRQAJAHHUR PGCGPLWCOSTGI   LVPTXQJKQEFOM  
ENYLFV          : KSQJIPQYMFOKOER RGXMIIMY        IJMJA           HEPAJRTCAXAM   
SABRWKVBFE      : CKJDEIFBCMY     TAICDFNBQXJGKF  XQLTKKFOJ       QSIAC          
QWFOCBJN        : UOVPW           UBPIFDDFBC      FHTD            GMSKGVHOQM      DHFWQFWTBBXG   
INERSTQEYPQRPTL : RTNYPWPIIFDK    FKCF            GGVA            GBKPKIRTVHHUADR
GKNL            : EKACFGJCF       HVJQTFOGASLNOJ  BDJARMRQGLT     KLVPWKJEGOUQVUQ XTUHUDVVNVY     BNEIVR         
FEOMV           : PKKHOPISLL      ASAWWFGFRO      KFFJEKKUKYVV    EHNUHFVFH      
NHHRPUV         : PCFADSDWRP      YPHJYBVLCKPKQ   PKWR            EGAGPPNWRLJH    PMTNDR          RHPXIDWY       
PQBWRQNM        : GLMCXPNWBT      XVQSP           SSQCKBUYDCAKO   GBKPKIRTVHHUADR
JATPKJEA        : XYYD            KSMQQARKC       RROBFRNAFIDD    VCDYQFEMUMKUQE 
KQEGHUOQMGMK    : LEKKADOBUML     ECLIT           MEXV            KOUMNEVOJ      
CDQYV           : KVTGRLB         HTYLSCYFSWX     BBQGYLVQKDCUQ   CADFXXAPAKQWKW  GEVJY          
OIQA            : XODGEWKRSH      LPUPEYOWPVBCP   JTEL           
MSVVYXPJOW      : VCNEOONFKTRBVB  VAPHGMBSD       WJPUATUKPWTWRUW
XRJPGPESH       : DEMWFIS         PKWR            WEPISWNLBTM     DPYD            IFEQQ           TJCICXFCK       SJXUXCTGSAOI   
WAISJYDACNM     : XTKFTJDATV      IBHXMFL        
LLVJDFAAAYT     : NCUKHGF         QOIKMOKSWSWMNYV RIUPVOJVUXMSB   WAQTDKUCJCIPTA  HLJBBPCYKKD     AATDF           LVPTXQJKQEFOM  
QCCUVLDULNNWPSA : UIJDLFTUNFHXKKI JTQQTSPOOEL     VRIAR           JCDUG           SPUQHYPM        XXCWGTMQVWY     EHXRPVEPCAFNG   MEIKIJXPGYWXQHO
QCCUVLDULNNWPSA : ELUJPLUO       
IOOUCKEGRHI     : NCUKHGF         IARKU           YBTX            KOOBHIDIC      
GFEWHITFVWAJN   : ANCBBNQEYBHUSIV WDHWNN          MHBVHU         
HDKHUTVL        : RCFAUCPJFKVPYA  UXUOPS          CQJGE           PKEGWWTWCALFUAH GWOG           
YVUHNCPIKUP     : MXAUEUYVWL      ETLVJVSEQCB    
FXDKWDNGQ       : DEMWFIS         LEKKADOBUML     VJSEPBDOADTP    AATDF          
NVQWSKTEBUCXCP  : PTIKDTUU        WDQYXTP        
RBNPQ           : LUDDIAFOW       RIUPVOJVUXMSB   PMTNDR          MUJPCBN         VAIDIFVN       
WQFJNK          : DNFWCYUULUEKDJ  FLFGR           QFFWYDYOANBIJEQ HODQOTSKOFEKD   RUAFYBMYLWVURJ 
WBDKYVK         : SFQENDIYI       QFFWYDYOANBIJEQ DVCCDVEUVRYAVMQ TAHHUYXC       
GEVJY           : XTKFTJDATV      KLVPWKJEGOUQVUQ TNUFOBYGRRCAT   CDQYV          
HDQKWTBOKBLDIVT : XODGEWKRSH      HQLDVRPMRKJ    
UQWADWVNOC      : VATVFFRHPCQU    OVXFAPUDI       YBTX            MHBVHU         
NLSNV           : OVXFAPUDI       DQJGTEUVCXHQA  
GGVA            : XYYD            XODGEWKRSH      MRVD            IJMJA           CJLETBNWRBNWBMG HQLDVRPMRKJ     LNSOTOAYWCYEGKP INERSTQEYPQRPTL
KMKYSVUMPPFM    : KGUEXOHWNCMED  
ILOW            : TCJNHFXK        VARYQPLQSN      KNUFDJXEDKXDNO  DRGOJSNXDTS    
RQQF            : NCUKHGF         CKJDEIFBCMY     PYUGBAUJN       RIOP           
GBKPKIRTVHHUADR : AMQOTNEXBLDTFTP INERSTQEYPQRPTL PQBWRQNM        SSMPPEK        
SJRHCCTRYW      : LUWWLHURUWP     DQNMMUUWVKQKEOE GVFPUSGPVKIF    ERNLSDSA        UJNLXKLSGLTMRLS
SPQHVUT         : SADBSABVCEHIM   SPUQHYPM        HEPAJRTCAXAM   
FDGBBNIVNLP     : FQLNMHWGQILSE   ADKSI          
GYVOCX          : SPMNCMERA       KLVPWKJEGOUQVUQ GMHJMAMNAKESAS  ADKSI          
TAHHUYXC        : TAGEUCPBMEDXIYI SSGSJC          WBDKYVK         KILVJGXX       
UVLCBRECFOAUB   : EYKWRO         
WJPUATUKPWTWRUW : HVJQTFOGASLNOJ  HFSEXKNBGM      DMRVCSLYJHAMXN  MSVVYXPJOW      IBHXMFL        
SSSEUTV         : PCFADSDWRP      PBSESHBGOYJ    
WDQYXTP         : CLSAXYUG        QIQXAABCEYJDUU  VCDYQFEMUMKUQE  HFFMGX          EWDJYIOWIO      NVQWSKTEBUCXCP 
DHRGB           : QYWBOEPNRWOHR   MXAUEUYVWL      DVYIPLYHPHP    
SSMPPEK         : GVFPUSGPVKIF    JDONPFYYJHFCD   MDQPBNUNUB      YEWA            GBKPKIRTVHHUADR
BDHTHFPDG       : DRKJDWRM        JNICFRJGBGO    
GWOG            : XGAPITNYNCSJHC  DEHWVTHOH       HDKHUTVL       
GDYNWFQMXJ      : QMQTYPDABTVC   
NYDYNECV        : WVPEBP          OPEVLXTWMIWGUAM GLETSJOQRLWOQ  
MBQRJFBHVHCCN   : SMQXUULWVCT     CDVWDXUPOWELINX
PKGGWFRVUQCVHIY : FQLNMHWGQILSE   YFVUTPWWPAXY    HADSIY          SOEQWD         
JNICFRJGBGO     : VEHLVALMCVDORW  XTPOBEMKCLBFT   BDHTHFPDG      
KCFDOMJMT       : EMVCV           QYBLUJCQVKVOEI 
KOUMNEVOJ       : GBKRXTAVVCEP    NIFWUJBYVLSXF   YEWA            TJCICXFCK       KQEGHUOQMGMK   
CRJHKSONBFRMJ   : OLJMUXDJOT     
PXKBKGFV        : MBADODDIJ       WCBEGNIGIA      CADFXXAPAKQWKW  RBLEBEYHKUJ     MHBVHU         
DKKHGY          : IXMBRXTTBFOK    HFFMGX          GVPHNFDRXHUD    KHTECQKVVFB    
NBLYLXSCMVHG    : UOVPW           RPUGXRMUTBLF    VEHLVALMCVDORW  FGYWXXEPFDIRUIO
SECQQGEWLCU     : JMMBNCYQQHC     BHRFGD          WDHWNN         
MHBVHU          : KXAMKOFSMRBW    VCNEOONFKTRBVB  TKBJOCQBF       CFVHORL         DQJGTEUVCXHQA   GFEWHITFVWAJN   UQWADWVNOC      PXKBKGFV       
KILVJGXX        : TMLYGDDASQ      VJSEPBDOADTP    RIOP            TAHHUYXC       
HEPAJRTCAXAM    : WGARLANIOTVIJRL TCJNHFXK        AMOQLJYOLU      SADLLOKBB       XVQSP           RPYHOF          ENYLFV          SPQHVUT        
WFQEIMNDBYOMUA  : OVXFAPUDI       PBSESHBGOYJ     BAAXSLC         PYLHUJXG       
VAYDEOEPJ       : CKJDEIFBCMY     BWVFYMEFCKG     WJER            MJQNIUKLVPKI   
SJXUXCTGSAOI    : KAQJQHAYUMQH    VAHERFRL        XRJPGPESH      
UJNLXKLSGLTMRLS : MCXJVJUG        CWNVGRXCPTMMIT  DXPYIEHJFUKTLW  MJQNIUKLVPKI    SJRHCCTRYW     
WSDIQAHSTPNTE   : TRPCGSABM       YGWGFTQHSOU     EXAVW           OQQL            MIYMUS          TXAKEYN        
IBHXMFL         : GJTHGIXPROSWRLG AJPHFBWLPSHGGU  HUTGSKOKS       WAISJYDACNM     WJPUATUKPWTWRUW
ATNWGIIYSFR     : EHNUHFVFH       WDHWNN         
