ROIIVVJJGJTR    : SUUFTVJRGQTS    YYHWUSLPLKBP    LXLKLR         
NPUSXUPBRXJ     : DORTJDKFCBXXJB  UWMBEYVW       
IVRIBOBPWJNU    : UYQRCVQVPI      CBFMISWDCYPXVQK IPJRGWDJON      JRVMSJVL        QBFGHQDCCDUHWCS
YBET            : KSGMU           UMKJATN        
YJLWCLRU        : HDDPUORFOCGHDUD BNUN            NBAUM           BLQBKCQTVNCDTE 
KSYREXLMYBNQ    : XWKMWXOYRW      NUQRTSUSHMTMGX 
YGVTGYACUCL     : HYYKY           RWCIN          
YPUSKKF         : CXYDLEXONAMPDGV HPGVHHRWNBWMV  
LWKJJWK         : IAQTLCLFLPVLM   FRAUYLIP        GCTUXKU         HWKKYHIKDPKGVC 
NBMOKILQI       : EACRVNBFMYXTXKB TTCNNI          TAJDXK         
SDNGMOVJIJVNPHN : INJIT           UUFBWXHICT      MHSR            VOTMOSWYLT     
TWYEJOIVESHPLP  : ORBXBAE         FEQPRYPKJJSWLB  EWCOEQRJXKSDH  
EURKJIIS        : KBVQLJTHAXHTC   KCCXJVHCQK      QKLI           
ROHJYWLSTNYFC   : FOLH            BNUN            NBAUM           XDVWDNULKQHAY   UWMBEYVW       
DGCKXPCCTXV     : OAHOWHQJILA     TCFJRFO         MBVUCUIW       
JERFXLVHVWEJPA  : VVTDNWAVRO      SAUGLEXIEE      JODVTBB         WCLXCFFXQCHJ    NWHOLMAYCVY     MFPEBHIBVL      VJWLEL         
RFABIIGTHVXLQX  : ITUKEQTWPF      XNEYDNAXEUPQF   JMKPNPGEHN      KHAM            JWIVXICQAYKIOCN XWVAGU          TUUXDQDBOSEVBSV KFNXMRW        
RFABIIGTHVXLQX  : NMPQIE         
YINQPLF         : LDKOHUP         BSWUUGYQJ      
UBJYMB          : YSSIKTFKFKE     BFONKUTIUVXDQM  IFWAGI         
KSGMU           : YBET            UGAKUHDEFUTPW   XGCIPNAMMNIHW   CVNWSC          VCUFH          
UBNEYLPPK       : UGBXYRMOK       OVFFUMQJOEHCMJ  IYVQPGOT        SVGFEJPJACG     VYIRAMEPWFS    
RUNKKBPXWSJ     : SAUGLEXIEE      LKFTHJSGWJNCXSF SKQVLCQ         FDLS            PVID           
GNASIIFFCCIP    : NREGXIQMN       IDMXO           JWVFUIXT        QJKJYJLHUWFN    AEUIKWFKJUHBT   BDARBJH         NOIBGMTMBXQFM   QJTYCMNK       
IEYAQY          : MHSR            VWRTWTGIY      
LMFXPUXMQ       : IQGD            AYTBJSFCLGF     FOVMHFKFBTKYHSV XBQGOQXU       
NWXNPGXWMBYUSG  : SJQDMFUUTTAHC   XOBHGCSEKEJP    KKFLELNJPQQRM   IJIBYSCGYDX     NNOWGILHA      
WGGNHXYVFYLDXBT : HQDFILOD        FDKILTHGEKQR    NCPDIIWUYSFSHWD
OSGEIMCHBDGWW   : BNUN            QBFGHQDCCDUHWCS
CVXIKFJLBOLORJ  : UUFBWXHICT      UFRNDMOFYJ      HYULKELXGB      DVJUTJARHHJ    
NREGXIQMN       : GNASIIFFCCIP    UOEHIVQAEIJXNA  VTJWDCBSG      
OQFNPUPMUB      : YDUOQAA         QUSNGCIVVH      EYHGUBWQCO      LKVXCVGLKFVLTUA
AMKDDVRXHIL     : RSBFWSPKKRA     DFLCRGRKQQBKYLR VQUARVEYGUVEV   KCBHIHJKBRETENU YSSIKTFKFKE     YXQPQDS         XWNAICXV        BXJUVHPNKJRV   
MSWXLKL         : GJWK            YJMYKGLY        TQWICCABMPLJBE  VGIESVJUYVSP   
BEROUO          : FGQXNOFRTRES    RIAKLJBMJTS    
JJHI            : FMSORUWDOYA     SCTFJNROFNP     JGPRAYA         IBHJDQQKDMKNS   DKCNDNAUQQ      SBNWNEVEQKGRXA 
VUOATGXB        : KBVQLJTHAXHTC   WDWXNQJGMR     
LBEEAC          : MMQCJBIDFJHJDOU RVQMDLTEIO      FNHAKUROQVXVUSB VTJWDCBSG      
MNDNRUCOLJAU    : BDEIPAEEB       WTQMHFUQ        UUFBWXHICT      YJKBRLPETLODG   XKDTRLYMKKH     RWXYY           AWXIVEACEPR    
KGRGURABR       : TTCXPBFONYPLAR  QGYQVBYF        JRGIOAFBGVR     AUHYKYL        
QDEUKHYDTOG     : YSXWVGIFRXAYQW  DIOH            BHDYKUSSKXOHY   TFARDUPJUJBWPS  OFQIVW          BDQEEBWG       
IDMXO           : GNASIIFFCCIP    JBTPIQFXMYX     CATFRPMJBIDIHG  KCBHIHJKBRETENU FTPNKHONHFLK   
AJRLRJTMDV      : QXVMBFNELQFGG   PTUGRK          SMKDUFGYOJHQ    USCDTNQODJQ    
WYICGFMNERH     : HPGY            GQEGBBCNVDKK    DBDNAPDPPTGDA  
XPCDDCRBE       : NBTOM           VOQBOGPIVAN    
UPWELJJ         : ABPLPM          RIXSMFECFYRVEC  QKFOHQUQNYTXTW 
CGJKJPQX        : JOSIDR          AKLTOQ          HKMXHVDYTC      XJLALRXYJJ     
WQMSOFWU        : AFFVSXYDFYRP    TAJDXK          DGXLM          
BMNFSJXPPJC     : QHXAVETWE       DYYPHBCMBAT     IOHDDAPBFJR     TUUTB          
TEIFQRUJQ       : HNHJYGCWSYLCHCB PCKHNKMNHETBNRU IYAPPLAP       
JJOCAT          : NIGEN           GWGGNMXY        MGUPDC          NHBRHOPLFOXY    KIUDR          
UGAKUHDEFUTPW   : KSGMU           ASJMSPBTUXINAL 
LDFQUWNGPPP     : KXNQG          
ERABSWHUHCDKIIG : SURHT          
AFBNLGEGGTOXJ   : BQIRSMUD        JCPXJRFPJ       YVSHVKEH        TDHQEG          CKFGMRTW        XIIXTJUGSAVAX  
XQYARSYYPHES    : ABPLPM          YKMKULS         HKYILWQASFJVQQV AJJFCBYYA       JTYHLULHWM      BLQBKCQTVNCDTE 
MECREITS        : GHNUVYXVJLUNR   GRBKDRIX        BNIJXFXSPJEVRQG
AYCITQHDXHVXHNS : XCDKYSLT        RPVA           
PIPVEKIIMDM     : FIAFN           CJGOVRJAW       OUTNCYVLV       ANWDJVG         HMBEESJFVX     
WHQYHUIB        : CDREYK          RIXSMFECFYRVEC  MXMPJKWDKR      SURHT           MYIUGON         HOFHJ          
PGMYDMISFOIQ    : HNBJYPL         PYGO            WELQFBLUOKOIJC  DAFFGUIXGOG    
GURPFEURCRC     : QKCEH           ACGOKKQAFBUJG   MFPEBHIBVL     
SJQDMFUUTTAHC   : NWXNPGXWMBYUSG  GELLFVM         JWIVXICQAYKIOCN WVQJYIAARGRB    VCUFH           ATGOIM         
OTEHBLCSDHY     : UUFBWXHICT      TPWBGMNFYAJXQEK TSTRD           GGKNFJKGQAWC    XQHE           
CDREYK          : WHQYHUIB        IRFS           
ROCWJWSGXAIT    : SSKGYDH         MNSPRPLK        ICUXDKCXWP     
CXYDLEXONAMPDGV : YPUSKKF         FDIUXFMOFCIQLQ  ALFYGLJWLAA     IKJQOFJLQ       KUPGYWPKTFLICL  RHYERMRG        BBNEWUEBPJJ    
RLVIPUTPOAPQJ   : FDIUXFMOFCIQLQ  OJENV           WELQFBLUOKOIJC  IIACLYTLM       DXXQHSP        
INJIT           : SDNGMOVJIJVNPHN SVBCDFAYXAWIK   JYXHRFK         HGTBV          
OTKCTAUAGQE     : GQNUFNPHAUN    
FDIUXFMOFCIQLQ  : CXYDLEXONAMPDGV RLVIPUTPOAPQJ   XTHLA           KKFLELNJPQQRM   WTJDLEHHLMAHGM 
VBYTPUGSPGN     : JDXDTEADH       QHBIVHSXI       TNTYLP         
PGVP            : LWUSJBXACFHYTBN UPLD            TVYM            YRYUXCQDFDNFQ   JBPDFSFHEYHGRL  BDARBJH        
YBJAGVQN        : CVQL            PUDVHFPSRKNA    JRVMSJVL        FVIMKG          RHNJLCGWVGEJB   RBEKAVKF       
YFMSMKTNGMINH   : XXXMWGLVAP      WVPLFNPFVIYYAET XWNAICXV        BJKN            KNLANJEJXSITTDA
VWPLDMERNHDPPBH : KJDAYIXK       
CGKRBW          : RAKQFPUCQVT     WMTIDNVT        YXQPQDS         OHGJBPKKAUP     RAKHUXBPTHTAR   FSTETCHQJSAUQY  KXKMPW         
VKLKVYRTUO      : VIUODPDAOAVQCC  YLUNPUBAFXJAMD  XHIBATATDRQMV  
JTBPNOW         : OPDPSEOIJTQJCHD HENUASMC        SDASPODFT       VTJWDCBSG      
FMSORUWDOYA     : JJHI            PKADHQWVHS     
WNFHJG          : WANWIGGQS       AELFHMFE        UHDWMAQ        
FDRROLSE        : NSBCXC          GRHSRJMLYQLUX   JIYPCHMPYS      GQNKWMMEXOTM    FFTKMVCAJLFO    JUAJPULTRS     
KDSPR           : LDPMXMEOWDSPHJN MFVTRIYNWSQ     HQRHHLNWMAUJ    LNNRHHKHSUFIWU  YBXGEEYTDX      XJLALRXYJJ     
GKJDNXCPRYFYI   : XNEYDNAXEUPQF   MTHXXIVMFCRCILC XROJCDEPXN      MGUPDC          UJTIHJDFHUNINLN JGJX           
HJWL            : HLRMFPNMYD      SUUFTVJRGQTS    LEVODMACTVX     AELKI           UFFLLNVIGUO    
OAPKFR          : RNVAGLLWQTE     YVSHVKEH        TOHTEBIRICCYRFB JQPIYWWXJ       PGBCPPRWW      
KMMDB           : LWUSJBXACFHYTBN GGDSR           LMXOPUMXMEOJSDW IAOIMINAMD     
NKXDKDUFCB      : JLIJQWNTNEUW    SNODNKVW        CQONSOOL       
NRMYOADGASQH    : WYBATVODC       CYCXEDVEPBMR    IYBI            FJYWEB          EMVRNVKPGNK     ITTNPJJYOESJV   LNNRHHKHSUFIWU  TVBOSDSF       
NRMYOADGASQH    : XUFQYJNSEELYAPF
NSBCXC          : FDRROLSE        IYHAV           BTLM            OBLPWPSWULCEGGS
LMWQAALFFMLSFAR : QASK            XBASHFLS        WHSSGUMNH       UCTDXKYKSWY     HSFOQFO         ONFMUHY        
AUCDPUMEKHGMF   : FDLS            AWLUVKFNILLXLA  MKGWW           RAKHUXBPTHTAR   VJTIWATHYF     
LSXLJXLXD       : EEMGLSGPGQAYWY  SVLD            GCTUXKU        
MOLTPEQRY       : SAUGLEXIEE      OEVFQJHAYLM     SNODNKVW       
URQIVB          : SWVA            GFYXVBCQ        TTFNTXCEWTMHMD 
CQXNESLPFJCDO   : PWIEYD         
PFHM            : HXQCLQQXDBVATYX YYKCNFULIYFCDEQ FLBMQFIQHCTNFQQ DLSOHLA         BGUFGOKSYMI     IVIU           
LDPMXMEOWDSPHJN : KDSPR           MWMTSPUFNAGDNGN JGQQ            SBUCX          
NIGEN           : JJOCAT          DORTJDKFCBXXJB  JGXIA           VKVQBGUJPIUYUP  JPVL            EGKPSYSGYIKT    UHDWMAQ         MBVUCUIW       
IQGD            : LMFXPUXMQ       WMWLJ           MWJVDJCTARB    
OKVLXBBNBOTSLWL : LKCHVXUBP       CPIGQENAJ       LHUJLCSOSP      POJCKJUD       
FWSCKCJQPDYJMFS : NGHAIATGPYLLFJ 
RQMSTQGUH       : AACYCXSJCVUSN   HIIBHXEPKTYRO  
PUADY           : MACSRPCYUHGHEX  YREBRYBFXPKA    CFJMVJKPLUCIN   WTJDLEHHLMAHGM  CTUQ            FSTETCHQJSAUQY 
ARJLVUEMBG      : COJWMFVRIBMTSC  GKVVTIS         JCPXJRFPJ       SBCWTUOQTTDE    OIVBLPHYVFS    
NLQO            : JRLRRVWJCSTHWGN SVVDYAMO        BMNFFSYPHCROHUG FIAQEAYFJFXAPW  YPEGLEMHGOVCF  
JDXDTEADH       : VBYTPUGSPGN     WXNYEXAUXMS     HYULKELXGB      WMXVIDRLDQB    
YJVXSW          : TBHLTBHRVFI     VFQXYCYFDUGOIF  KNDCBAJ        
EKOAODBUBQITHO  : VWVVG           QVAESRPJABOJRQ  RIAKLJBMJTS    
KMIHTIMBDL      : QGJLW           MGWTEJHL        UPLYKJNCAL     
ALFYGLJWLAA     : CXYDLEXONAMPDGV PHXTVOSVVXSQPG  LWOATRIENEBKP   HUFWAF          IEVKQMTEJN      MVOQWK         
VDHGWOUCCIKLCU  : IILJK           SGGA            VABKB           CIDRQBTNQXPA    LLYKQMOFDTOWD   MAPTPITRSITHN  
FYKTY           : IXQYMVMVNPNRTD  BQXDBCTXHLLNAAS CSBSDDSFOA      DPKSRHVYPJHOTS  YFLLQTWY        RDECTBRMVNEK   
BAEMJBBJDPHGA   : PMAGVJB         PKWNNOI         KUPGYWPKTFLICL  SIPT            EIEXTCVCEMR    
FOLH            : ROHJYWLSTNYFC   MNLHQ           KFKFCTFPIKVPIW  RJSSWR         
TTCXPBFONYPLAR  : KGRGURABR       VIUODPDAOAVQCC  XXOYUTRIM       GHQCYVGHQXTCU   YWMYWVPTUAMXG  
NBTOM           : XPCDDCRBE       EMITWDBHROMLDTW KQJQ            PQVMW           XGYMPPHPJYT    
GWGGNMXY        : JJOCAT          DDSMTMQQTTPFXF  YVNKKHKG       
OVQTVGWCWMD     : DANLTOY         AVHN            HGTBV          
XEGQTJNKVLSSRA  : YCJFFCHX        VQDQP           HVNSI           VSWEDDU        
GAIDQGVKC       : IEDDYGAUMJ      HAHAOJEXDOWBY   IXOMXEJQ        HSFOQFO        
JEDVKR          : TAYUDLDX        IXFYUSJLD       LUHMJ          
OAPKLDWHQP      : LCVAAUR         BPGXSQUPLHSFR   PCKHNKMNHETBNRU TNDE           
JRLRRVWJCSTHWGN : NLQO            GHHWLJOB        EQDFRISJ        FDLS            WQVMAXOABBI     DMJEC          
EXTDOVTYHYXR    : SHREKKBXUGLQGP  RPJIWCDU        WHXWINJWL       NMIITCCGOJTRW   ICUXDKCXWP     
OWCGITYHT       : WHPOK           HQTTROT         QROGSADUX       SBUCX           GFYXVBCQ        NROOSFVJHQRKP  
LMESMMJORHLUWJQ : CTKAQYVIJ       PSMWWPIBUHJHKF  PUMWKLBIE       DOAFHNFFID      TWQBQAAFRRQ     CMBTVAM         PYLPWPVNUWF    
RQWJHLGJTQFSAY  : CBFMISWDCYPXVQK VWIBNGITDHO     TQUMWNRBFK      BGQXVKYOJVKPV  
MOKHDWQROBFMAPD : QFNGPUQFQICXCJ  XWNAICXV        VTMYLAQKP      
HTWSBKB         : XHFHMEGQA       CFJMVJKPLUCIN  
FTSAUTGJI       : DVHIMUCQOSE     NPREGKYBXUL     DDSMTMQQTTPFXF  EOKARVBGSRS    
QLNKGDLNPLDS    : QHBIVHSXI       LBHENUBSG       KHRSSTTUQQ      WYFJC           YPBGJPIHUG     
MNLHQ           : FOLH            OVFFUMQJOEHCMJ  RCVIHUIMFXWVB  
IEDDYGAUMJ      : GAIDQGVKC       GHQCYVGHQXTCU   FQECITLM       
DCRQMAVAO       : GUIBFL          VDUSWBHI       
NTHCH           : XRUO            LXLUSOOXXEPP    UMKJATN         YLNGCHEOKA      LNVAJ           JBPDFSFHEYHGRL 
NQPLCVRFW       : ABPLPM          HWCEMFUBLOTD    ADVWBJYUTCPORKV WELQFBLUOKOIJC 
FSMQWRSQKIRHII  : FOME            BFONKUTIUVXDQM  CTUQ            VCUFH           TVJQUSCJWL     
YCEBLDQDTCF     : GQNUFNPHAUN     RYMREUQY        DFFEXRVC        YWFMRBXY       
VMPVTIKKHEF     : IDUIIFYMMWKXTR  BURPRHD         XQHE           
PNPWWXTVDYYOCP  : IXQYMVMVNPNRTD  NGNQXXWSKNSMOL 
XTYQQNGO        : CSAR            VJENCTDHGN      NFIODUTXAQDQ    CSQORYDIYNJG    KWTKRYUMYCHH   
OCTVGCTV        : YWSLMUSXICKUBR  JODVTBB         YNDBABKJ        IOACHH          DWPKXYNIR       HMBEESJFVX     
MUMMPKROJ       : TBFSKDQUGJWH    QUSNGCIVVH      YPEGLEMHGOVCF   QAABJLYHUFSF   
SBBTVDKO        : YCJFFCHX        VAJOXNSMTVSL    YLVDOTGPEV      JQPIYWWXJ      
QFDHHYFOBBKRNGG : YXFUHIJYPE      UOEHIVQAEIJXNA  WOTAHFIMAUP    
XRUO            : NTHCH           HUPIWEWDX       KHAM            GKTENXEKCFEXAB  OHGJBPKKAUP     NDRFIC          DEEJ           
EJHGDDLNREG     : BLCNPVAFF       VUPMGUAYLWT    
HNHHUVKWICKQJP  : XBASHFLS        XWKMWXOYRW      BNFXSSV         SBNWNEVEQKGRXA  BEYUALLWGN     
DNFIRPPASSLHM   : NYVNOWRMWO      CMIBPPRFDVXI    JYES            HMBEESJFVX     
PMAGVJB         : BAEMJBBJDPHGA   QGJLW           GJBC            YRUEJBCRUT     
UXCYLTKDKNQQYJ  : RNVAGLLWQTE     XIDIJPS         BTLM           
OLBKXKYS        : MKDMDRR         NSII            JVBIENF         EYHGUBWQCO     
NSHJFKDCJ       : OUVDNKJFTMFP    GHAY            UUUJYIYEPQAD    PBBVNYEVQ       FSOTAQI         BNIJXFXSPJEVRQG RXSNMDPCLY     
BWCOAOE         : QXYSOWT         FPOL           
HDDPUORFOCGHDUD : YJLWCLRU        HXXOGDK         EJCFYDUCNFPHCQV NINGDNKUQUIOFH 
GKAKMLS         : LQPRUUBY        JYDLWVIYO       YLVDOTGPEV      MCTHX           TNDE            WGMRRKXWXYRM   
IUGKLLCTOHJJYB  : YDUOQAA         KNVT            RHYERMRG        JQJUYDCRS       YQPOHLV         HXJIJVVIEJ     
PGAALUFYDPB     : QKPRVQYBTCUPR   SESIODCHCAOWH   ADVWBJYUTCPORKV OAHGNRYJ       
EMITWDBHROMLDTW : NBTOM           AJAAIBLHUHJ     FGDKMB         
UBILHINUFSV     : QXFWDIUUU       BPGXSQUPLHSFR   TFARDUPJUJBWPS  ECKVYFARTPIGFY 
IWYMJIIINLQFADS : CMVNQWYRG       EVLIGSDDJDGADKA YNDBABKJ        VPBFFUOKLIUYRXP JFEIGNTSU      
YSXWVGIFRXAYQW  : QDEUKHYDTOG     NNGI            FXTFRDKU        OUKTOPHJGX     
YTKNGUVOIKHQKKL : FWET            AXLPHT          OUKTOPHJGX     
MGQJCATHRRISKHE : KOSGBWEXSOVL    SXPWYDFGUK      UDWOOMRAQNWTIYL
BQYJLWBVJ       : XCDKYSLT        WKLE            TTREL          
OUVDNKJFTMFP    : NSHJFKDCJ       UWMBEYVW        GRDQRKEPPXSKWT 
YJERTLXFPOGYC   : QVHVDXJXDYNMAK  VCNK            MXOAGQ          PYCS            HXXOGDK         DLSOHLA        
ABPLPM          : UPWELJJ         XQYARSYYPHES    NQPLCVRFW       GIWOUHLJEHMK   
SCTFJNROFNP     : JJHI            JAFGJNLI        WHOXCEBFCQGINX  FGUFGPWHVPGCPP 
SKKG            : ICVQTDYIYVI     SYWMIHO         YYHWUSLPLKBP   
RVAAXEHAF       : IYHAV           YPRJWDPXEXKPOG  OXRUODNORYBHO  
LXLUSOOXXEPP    : NTHCH          
GHAY            : NSHJFKDCJ       HHELKOTSSGFUY   BLNGGFOFARS    
MHDGEFGCJ       : WNWEPN          CEUDPL          MANACRR        
CPNQPCLISD      : GIWOUHLJEHMK   
QHBIVHSXI       : VBYTPUGSPGN     QLNKGDLNPLDS    HCRKSC          RYAMCDJNENB     UAVLODXNNL      KJPRGITLMJUC    VMKCVRPUB      
LQPRUUBY        : GKAKMLS         DUDXINFUNLXTEUF EWGOVDHITTU     QVEEYRMUU       GUCCENFDRN     
PBWFTMHGWA      : BNBIQPSWOXLNYMD VGUYU           EBADFWQ        
ITUKEQTWPF      : RFABIIGTHVXLQX  MQCTER          FSXEAULDKY      VNRPSVLUAIBJF   QJTYCMNK        MANACRR        
BVAU            : JYDLWVIYO       IXFYUSJLD       XLCKGHXCTKCRISL ODVXAINXLORSKBM
VVTDNWAVRO      : JERFXLVHVWEJPA  VJENCTDHGN      XTNEFYXVGJJU    CIRJKPWAWM      HIFUYAB         KFBJFPKUXILLF   OMMVGU         
XNILWEGJI       : RMJCICKDRXLV    YRBIOOW         NNOWGILHA       HVNSI           PIMMYFUN        OQXDUJ         
FINKSQGUNB      : HEGE            JOXRXYOAVX      IYAY            BTLRWRUA       
MUTCSVX         : YWILUKJPT       IAOIMINAMD      DUKO           
MGKBOVASCL      : QXVMBFNELQFGG   FOME            CPLJESBYLQBHRWH GFYXVBCQ        VQFXG           NROOSFVJHQRKP  
CQLPCGIK        : VYXWHYUISMK     PTUGRK          SNWTFBFHUGCSKTV YYKCNFULIYFCDEQ
WMWLJ           : IQGD            NERCGBMSFNCLP   VEFNBRLYCRQPUJR
NEPOODU         : ENYXQ           HJVJKKWLVAVFSO  KXKMPW         
GJYGCETH        : ATNQFJPYY       MWNFKN          DVYYEVK        
KVYOCHA         : HDDEMWPJ        ODVXAINXLORSKBM RIBFOMLTY      
GOGRAAIFPWVUR   : BGIBFVAYOACR    RLUONNIG        EACRVNBFMYXTXKB AFUAAMJFDRDAI   QVYOS           IWHN           
BDWJHBDOKQKJF   : URBHQOFIX       QJTYCMNK       
QHXAVETWE       : BMNFSJXPPJC     KHRJC           VTMCYQR         SVEE            PQVMW          
EUBARSXVV       : WIMPQQJWERII    FDHPVYL         TAJDXK          NGMBVDBVEGMEB  
FDBLULEFULUOTT  : QFNGPUQFQICXCJ  GVFQVQWEVQVYL   AEUIKWFKJUHBT   IAOIMINAMD     
RAKQFPUCQVT     : CGKRBW          JBMXJUKHJXR     SWVA            TDII            TWAOPOPGQQBGVBX
VPKTXQXLLLPQJ   : RHKWQMAWO       HQDFILOD        WLBEKWWWICJVH   XKCSGJ         
OXWKQPKDGR      : BDHUB           JHHGFPQJLQ     
CTKAQYVIJ       : LMESMMJORHLUWJQ CTRMCFNAHKJCXH  MWGFXPRXMENRUPN INXDWOJYGTV     HGYOBS         
IAQTLCLFLPVLM   : LWKJJWK         RJXBAEWEQX      CRAWGTWF        OBJPAAGFJ      
EESILNBPHNR     : NIEVYIWXLM      ULWQDTFJFDWR   
MNJWITYYO       : NAHXUNAIVHT    
ECSRT           : AXVTURNKBSHU    VWVVG           ENYXQ           GGPDXWXA        DANLTOY         HNBJYPL        
GJWK            : MSWXLKL         XLACSFACUFOHKC 
RSBFWSPKKRA     : AMKDDVRXHIL     EMELTL          IILJK           NMOKRVIPLOVX   
DYJXXJOL        : CQFMBKWMWJ      SOJVGUBUIE      KAKQ           
QGJLW           : KMIHTIMBDL      PMAGVJB         EDCTWXSSWCFPUXY TOVSEYRQUKO     JRXQNCCNNXABLC 
WVDKQVMXUFNG    : YXWJTPRUOKFI    NUQRTSUSHMTMGX  HXXOGDK         XDMPQWA        
IITLHDLHOAVETE  : OWRF            BTLRWRUA       
HEGE            : FINKSQGUNB      BFOAYTEKVTIIYQD RYIJ            NTFFQHLPUPTWHW  ITXUFKRXHSF    
JOSIDR          : CGJKJPQX        NIEVYIWXLM      GQNUFNPHAUN     QIGMEQQVGTYEFJ  JVALUCW         JQPIYWWXJ       MFNPJPHQ        EBXXGHDMRCSY   
JOSIDR          : NMTEAERAQOI    
LHLEPTXCDBNNSQ  : OTIW            YUKJFNFVN      
WKPPRTW         : JCPXJRFPJ       HUUO           
WIMPQQJWERII    : EUBARSXVV       BBQEYFEBFAT     TMPSDMJ         GQNKWMMEXOTM    RFUPACBLRE      KSNUBRAKNN     
FILKLCXES       : CQFMBKWMWJ      STWSXOQYWEQBV  
EDCTWXSSWCFPUXY : QGJLW           IOSHCXWBAOKYBQX LHJNJUFV       
CQFMBKWMWJ      : DYJXXJOL        FILKLCXES       RAQDCOBWLUKX    GMTTN           MAPTPITRSITHN  
XPJJTONQL       : RVKGWWEKUPBU    WHPOK           GKTENXEKCFEXAB 
LGLN            : FPOL            LFYQRVNFE       SFNPYQTEDMGJRK  BSPDAP          ATUGUMTOANCSL  
DLMD            : ETVATHMPIINKR   XROJCDEPXN      ITBBIK          HIOLBCXUOEYXPFI
RVKGWWEKUPBU    : XPJJTONQL       UFJFIFJOB       AQMFNLN         LYRCMWDFBNYBXP  YPBGJPIHUG      IVIU           
LECASSMJ        : XLACSFACUFOHKC  PMSXFLHIGMCQT   FOAVHW          EDFETSOSLNF     IEANJKLDXL     
UUUJYIYEPQAD    : NSHJFKDCJ       UOMINWHXMR      XBASHFLS        WMQT            WHQSBJB        
XCDKYSLT        : AYCITQHDXHVXHNS BQYJLWBVJ       GQEGBBCNVDKK    PDKWVNGHXLOY    SHHAVDEC       
WYBATVODC       : NRMYOADGASQH    IWQXSHPVEXQYRED TPWBGMNFYAJXQEK
AYTBJSFCLGF     : LMFXPUXMQ       RWPDJPHPVWVTFGH SJIGSAJLYP      XEBSL          
GHOQJHCDICEJE   : FJYWEB          TPGC            IBDJ           
HSDME           : PAEYAX          TTYRPKBBUAKV    LPYP            EDRNUOKQIEP     JFEIGNTSU       XJPCOEQBASVGB  
NAHXUNAIVHT     : MNJWITYYO       QTSESMCCHRHYU   XHIBATATDRQMV   CPIGQENAJ       POEAWHIT       
QKUARYEBBIMH    : IUINABOSK       VMKCVRPUB      
WCOLHUYJDYHSYPO : HGGIEGXWI       INXDWOJYGTV    
LSAVPAOOGRSRG   : WTQMHFUQ       
BFDRQ           : NBRNQUXWQEI     SSPQROJVXJSXWIW MDQLMTORAIL    
NQVSP           : PEUFJ           BHDYKUSSKXOHY   XDVWDNULKQHAY   FXWK           
LRVC            : DWJBOVBOKL      SBYOXWLXQSOBHE 
HWCEMFUBLOTD    : NQPLCVRFW       CERP            NSEWYTUMRIF     QFFKLUUNYEFXDOQ LOWTYSEEU      
UGBXYRMOK       : UBNEYLPPK       BBKUVMGA        BLFMH           RYAMCDJNENB     HKYKJ           WMXVIDRLDQB     BLNGGFOFARS    
HBQUUM          : TVWKVVNQPPLSCVY YJXTWLOJCAKY    KNDCBAJ        
WVTCAGHWHULEB   : CBFMISWDCYPXVQK MDQLMTORAIL     NGTKOBKFVITAV   BOYE            JTAKJQUKXHEK    JBJV            GXSBLOPEFKBXRBF IGTFCTCEVEHUOED
YJMYKGLY        : MSWXLKL         HBHVFAIP        FDHPVYL        
VIUODPDAOAVQCC  : VKLKVYRTUO      TTCXPBFONYPLAR  QFWOLT          FYANA           KFKFCTFPIKVPIW 
CMVNQWYRG       : IWYMJIIINLQFADS XPRK            XGTGVMHKELFWM   JUBMCOSTAQ      SVOWORSCS       MVOQWK         
QTSESMCCHRHYU   : NAHXUNAIVHT     JMKPNPGEHN      HCRKSC          INXDWOJYGTV     HSBHJJEFY       VMKCVRPUB      
PWGHALHCAFRS    : BUHCXK          JXYJKQUUQBHI    OQXKXHSD       
TKNF            : LRUFHEHMLAK     JWSUMWMHGQYL    WSCDWYIQKVTDQ   TQIEYQ          EIEMCAVPUL     
HAHAOJEXDOWBY   : GAIDQGVKC       QFWOLT          HHWFDOL         RYBWPVDDYUMF   
XHWASGEUOWNSQXG : MHSR            WVPQVCAPXKNHRA  OTIW            GTYMEYBPHDPSFS 
BNBIQPSWOXLNYMD : PBWFTMHGWA      OTWPP           CLLI            IKTEHH          OHIQOLUTO      
UCXPLDLACY      : JTIXTPHUTBYHPKU JBMXJUKHJXR     HSBHJJEFY       DBDNAPDPPTGDA   PCTHKXXCJM      HMBEESJFVX     
UXCSYRVI        : HJVJKKWLVAVFSO  SBCWTUOQTTDE    CMIBPPRFDVXI    BDEBHOYMKLAP   
ODIFDTSDJYBEDBT : UCPJCVXA        ICBJVKW         BFVIOHPI        VFQXYCYFDUGOIF 
GFOIFKD         : YVUOTAW         CBGHCOWPODIFB   NPCOTFAOKCKDTD  YYNPMMVDEVBXNJT BNRNNBOJNWAATPU
OYEGWORLT       : EVTDREPLSXT     VNRPSVLUAIBJF  
QXVMBFNELQFGG   : AJRLRJTMDV      MGKBOVASCL      DFRGHLE         LKTAOPIYEFEU    OWOKH          
LWUSJBXACFHYTBN : PGVP            KMMDB           DYJAWASVXSOPI   JYDLWVIYO       WHPOK           QKLI           
BEMYS           : IEOTXWPDXORAJ   QVEEYRMUU       FXTFRDKU        TEJCEIWGGMIKLU 
FGTQXBY         : STBWVAOS        AHRWFECVN      
NNFLGROHRQMYR   : VEJPHK          RHNJLCGWVGEJB   ITEQN           KWMESLSNM       YLJMWILYETMOBID
AFWDKLDFDKMWD   : WEEPXPSIU       XJJI            KOVQKOCYM       BDSBXJQ        
YDUOQAA         : OQFNPUPMUB      IUGKLLCTOHJJYB  XJJI            DBAXWAAPDQDAJA  HNBJYPL        
TQIMHUNAEQFDTRP : COJWMFVRIBMTSC  IYVQPGOT       
ASJMSPBTUXINAL  : UGAKUHDEFUTPW   NEVL            NGHAIATGPYLLFJ 
UCXHMSUMYLTDIOU : ISLIAXWKHYPFCR  MVEYYMCFWJ      HGYOBS         
OPTDKJGEEENREY  : JSJFVWVTIGPILNE ISMFSQRVCEW     BFVIOHPI        EABYWSYGTW      SPKDFKVKDAUFVOL LKBVP           HDVUUWN         VJTIWATHYF     
BDEIPAEEB       : MNDNRUCOLJAU    TTYRPKBBUAKV    YPRJWDPXEXKPOG 
YGAPDIEVE       : XLACSFACUFOHKC 
GPRLVVBPCCVEFD  : OBLPWPSWULCEGGS OWOKH          
VFSA            : TVYM            LDFRABFNPBWL    GPSJTXWRBKEGA   XGJDG           OFAJSEUDSWUMMDG
NBRNQUXWQEI     : BFDRQ           GQNUFNPHAUN     LHTHQRDIAAEDYLS IXOMXEJQ        SDLQVLITADXS   
TALPVOFBQEF     : SVMULCT         BBDQKTY        
JTTQPUBD        : RYAMCDJNENB     TKPCURAWQVT    
SSPQROJVXJSXWIW : BFDRQ           MVWRNCRGNKHGJG 
QXCWFBI         : VWVVG           HIRVQHYC        GHLYIHPCHFCTA  
UYQRCVQVPI      : IVRIBOBPWJNU    IEOTXWPDXORAJ   VAJOXNSMTVSL    NSEWYTUMRIF     GNHG            QTJWFQEST       WOTAHFIMAUP    
JWVFUIXT        : GNASIIFFCCIP    QLLXCYXV        YYHWUSLPLKBP    IXOMXEJQ        OFVFSHLNGCHEYI 
JSRC            : IOSHCXWBAOKYBQX FFGY            JQJUYDCRS       YWNWFV          RNNUUQMYQ      
VYXWHYUISMK     : CQLPCGIK        HOCYY           LDKOHUP         XPSKLBGIF      
FIENUPL         : YTIBYUXIKE      YJIADOU        
VIEVEJHWDJPAIN  : TCFJRFO         SNODNKVW        PQHPYMCETM      OIVBLPHYVFS    
RNVAGLLWQTE     : OAPKFR          UXCYLTKDKNQQYJ 
RTSNRDROIDXFHIV : EOFTRPMDXPBWAK  LHUJLCSOSP      PJBGJHDUUBAHMWP TTCNNI          RAMYBH          BLQBKCQTVNCDTE  EQSYFLMRBIDXVHJ
QJKJYJLHUWFN    : GNASIIFFCCIP    NNHYAWBMITL    
JUNFPB          : GKVVTIS         WVQJYIAARGRB    AKDGALKSJJODOMJ WGMRRKXWXYRM   
TUOEAMJJUHSOTG  : RSESJEOHSMWQD   USCDTNQODJQ    
UPLD            : PGVP            CNWPYXBRLRW    
LKCHVXUBP       : OKVLXBBNBOTSLWL TQBQASUM        EHFMSDKVJKWXU  
YLUNPUBAFXJAMD  : VKLKVYRTUO      EEMGLSGPGQAYWY  BEPUTLU         LNDM           
OYAB            : MCPFJDHVVFLELJF HPJONNFTWBNVWF  SQVBHCB         UQMUVIKEDXTYMO  HIRVQHYC        GAVKJJQC       
MOOPVKP         : ASVTVFATXI      QKPMXKVPJIK     VFQXYCYFDUGOIF  QKLI           
LFONTJB         : KBVQLJTHAXHTC   TKVELAXHQ      
GELLFVM         : SJQDMFUUTTAHC   CPQVGSQ         UYHGMWKKDKJTYPQ ACGOKKQAFBUJG  
BUHCXK          : PWGHALHCAFRS    FSHUBQRFDMWA    GYDGMXXAAKJN    OIWNUIHN        BOTQWRMYCGBO   
KYWCUHTNVAEJV   : SNWTFBFHUGCSKTV KWTKRYUMYCHH    BQWNUOWNRTEBM   KCAJCLHDN      
MFVTRIYNWSQ     : KDSPR           CWJN            FPOL           
CTRMCFNAHKJCXH  : CTKAQYVIJ       QLGYYNULEYVLU   LHTHQRDIAAEDYLS MWJVDJCTARB    
CSAR            : XTYQQNGO        SJEKROXT       
HOCYY           : VYXWHYUISMK     XJJI            DAKKEJ          RHHQLRMEKWAIW   ETQJ           
OXVGRYC         : MUMIDLHAUDR     FVKQDJPRIYMVIIE EURBCOBVSXMYKUI TTREL          
NERCGBMSFNCLP   : WMWLJ           GXGQNMFAMDEE    CMBQNQYWQHV     WVPQVCAPXKNHRA  NXHKE          
NIEVYIWXLM      : EESILNBPHNR     JOSIDR          CUMY            EGUWPIS         PFSWJRJGTKX    
HUPIWEWDX       : XRUO            APBEPWBUH       QIFPHYGLF      
MCPFJDHVVFLELJF : OYAB            KJPRGITLMJUC    LTFNCN          VWCTSFDBIQPIIMX
JFHXB           : SYWMIHO        
SSARAYWXAJ      : TTYRPKBBUAKV    TWYGQWFKGP      VMUPX           SAOYWOENUYBY   
SQKV            : NDHNTOVLEYY     JWIVXICQAYKIOCN BMQUAHRFVMMK    LLYKQMOFDTOWD   SIIBBACAPGUBHD  QDLKBVEBYCSFHRC
IRGVXSGF        : VOQBOGPIVAN     RGCTPBSB        VKDWQ           WANJBUDUANYV   
PKWNNOI         : BAEMJBBJDPHGA   UXGCRFPVXOOBHH  CYCXEDVEPBMR    FRAUYLIP        LWPCHQLHN       GGKNFJKGQAWC    IGXAVE         
OAHOWHQJILA     : DGCKXPCCTXV     ESIA            DPKSRHVYPJHOTS  TBFSKDQUGJWH    SVVDYAMO        KJTKNFCNL      
IBDCKYDDFI      : DWVMRDX         AXSFQN          DANLTOY         WJANODFF       
WTQMHFUQ        : MNDNRUCOLJAU    LSAVPAOOGRSRG   YSSIKTFKFKE     WDWXNQJGMR      VOMIL          
WANWIGGQS       : WNFHJG          CERP            GUIBFL          AHATQOCLEFYF    FDLS            YPBGJPIHUG      PYAGDNOLUGLLMR 
LDKOHUP         : YINQPLF         VYXWHYUISMK     LGWQJUXKR       QLLXCYXV       
AXVTURNKBSHU    : ECSRT           CUMY            GBQAAWO         WJANODFF       
FUFEFMKV        : GKUIYC          CSUHXMO         WDWXNQJGMR     
SJIF            : WMQT            SIWFPOFA        PWIEYD          XLMEQ           CQONSOOL        PDKWVNGHXLOY   
RAQDCOBWLUKX    : CQFMBKWMWJ      AICY            IITTUXDCYTEYTS  MIHIUXTFNEF    
FGQXNOFRTRES    : BEROUO          CYYGDW         
YCJFFCHX        : XEGQTJNKVLSSRA  SBBTVDKO        BURPRHD         OFSIXHCFODLGGF 
KOIJCFV         : BQWNUOWNRTEBM   FEXHTQHXSSC     OUDLBYJJCKTW   
BDHUB           : OXWKQPKDGR      CRAWGTWF        RKQOGNAODIDROR 
JJODDUXDTDO     : NRWYMQRYQJI     XCGQ            SOGEVCTJLBQUBXA
ISLIAXWKHYPFCR  : UCXHMSUMYLTDIOU KUQHJLNF        XDMPQWA         HVHLJNS         DBDNAPDPPTGDA  
JOKGXVWDYR      : GKVVTIS         FVKQDJPRIYMVIIE QUSNGCIVVH     
EOFTRPMDXPBWAK  : RTSNRDROIDXFHIV WAWUNRL        
SPYMYKBLTBHQEI  : FQGBITO         NOLUPWRXM       AWLUVKFNILLXLA  QEHWLJYU        YOWCIXMNDJR    
INCPJTFXAFN     : UMKJATN         YWMYWVPTUAMXG  
COOYJGAV        : FSYPKHOWBACRVW  UXWSQICN       
MWSGXCAELLNYND  : XILYC           CQNNVXMPKEJS    IQADWFQFEOJB   
JLIJQWNTNEUW    : NKXDKDUFCB      YXFUHIJYPE      UOEHIVQAEIJXNA  YKWCBQWMQN      SBYOXWLXQSOBHE 
WSSJRLQROSVC    : OPDPSEOIJTQJCHD SIVSRJAIII     
LDTPNDDVNTUDPI  : AEUIKWFKJUHBT   FXTFRDKU        ICUXDKCXWP     
KHRJC           : QHXAVETWE       LIJSI           TKYSLMW         GOACXQGPVEHF    RFFM            CLLI           
TVYM            : PGVP            VFSA            JYDLWVIYO       WBHBCIC         NNGUPFNCS       LAGFHJVHSWHNVNT
PFKRLVUFNIIQGX  : PPVQXECXSUEM    NJSABDQIHULY    EWQOLSUTASE     CUPRGOEF       
CBFMISWDCYPXVQK : IVRIBOBPWJNU    RQWJHLGJTQFSAY  WVTCAGHWHULEB   VRUJIO          UEPYV           EDRNUOKQIEP    
GRVADUU         : SVLD            TAYUDLDX        XTVQF           NYTPAFPLIRRPFIW
IFTCMT          : KGPJRUECYFCJFP  XUFQYJNSEELYAPF
QVWDGPALUC      : RMRWUMMNWBRG    JNOAAGMNFCPONXD TLFHKQDSMR      SWKPYLCSIEAAK   YJQOV          
SAUGLEXIEE      : JERFXLVHVWEJPA  RUNKKBPXWSJ     MOLTPEQRY       EVTDREPLSXT     JWCAPLDVWNAR    HUQSIUVXC      
CONHKPVFJMDJSLY : TJXSTWOF        UDBRDFTMWGUFOAJ
XVWEPYBVL       : LCVAAUR         XLACSFACUFOHKC  UPGRVGRSL       DNHLPBSGME      BEYUALLWGN     
VTMCYQR         : QHXAVETWE       YREBRYBFXPKA    SBJGXFUDM       ODIKAHNVER      EDRNUOKQIEP    
XEFULQJ         : DOAFHNFFID      NJSABDQIHULY    RFUPACBLRE     
ACDCX           : MTHXXIVMFCRCILC JYDLWVIYO       BKYWP           HLRUKB          WQVMAXOABBI    
XWHNWILIQK      : MACSRPCYUHGHEX  DVUCPAYK        IQPVMLROTKBYBV 
FMFVGTVLBSYS    : FWET            CVQL            NFIODUTXAQDQ    CIRJKPWAWM      ODVXAINXLORSKBM
QSFTUFW         : TBAXKKTLTLWLCT  ONFYCK         
DEJCMXMFIS      : LANIHPBNMGRL    GUTFRR          JTAKJQUKXHEK   
UXGCRFPVXOOBHH  : PKWNNOI         IYLLKH          YKNDJHRWC       RFFM           
BFOAYTEKVTIIYQD : HEGE            WBHBCIC         RGDFUNFETNAH    JTAKJQUKXHEK    XJLALRXYJJ     
OBUQV           : WXNYEXAUXMS     DNSPUABBBWN     VOQBOGPIVAN     TQWICCABMPLJBE 
IRYYICHPLK      : VWVVG           IYVSAVMCDYLFMGM DAFFGUIXGOG    
DLVWRHVLRGNJKC  : YXFUHIJYPE      VIEDCCM         AVGJCBMEPEF     ERXBYTN         RAMYBH          TKPCURAWQVT     WXRCLNAORAK    
NWQJXYDY        : VUPMGUAYLWT     XCGQ            JQPIYWWXJ       JBMXJUKHJXR     WELQFBLUOKOIJC 
LBHENUBSG       : QLNKGDLNPLDS    SQYCEORUAJDNVP  PMUCPOHQTU     
PAHLMY          : VABKB           NXHKE           JQDDHRIMOXWPAVB FXTFRDKU       
CKFEISDBFDCK    : KRMJUQEK        JRGIOAFBGVR     DWPKXYNIR       QDLKBVEBYCSFHRC
DWGMDVHEOP      : KLQJCVFJFKHE    JWCAPLDVWNAR    GVHFYQYGWDUIF   VPBFFUOKLIUYRXP WTJFBCUGLSGU   
GQNUFNPHAUN     : OTKCTAUAGQE     YCEBLDQDTCF     JOSIDR          NBRNQUXWQEI     GHHWLJOB        TTGI            RLFKABAUUYX     NIPTRDTVMPUC   
GQNUFNPHAUN     : XJDKRSDJXJWYNU  NROOSFVJHQRKP  
PSMWWPIBUHJHKF  : LMESMMJORHLUWJQ CBJEOFCPNG      TXMDVHXEX       PXIWT           RDECTBRMVNEK    UDWOOMRAQNWTIYL
QVHVDXJXDYNMAK  : YJERTLXFPOGYC   IEOTXWPDXORAJ   VQUARVEYGUVEV  
LCVAAUR         : OAPKLDWHQP      XVWEPYBVL       PBBVNYEVQ       FOAVHW         
XMRIUE          : YVRYA           IOHDDAPBFJR     DURYVIPXGUNXO   WVPQVCAPXKNHRA 
MWMTSPUFNAGDNGN : LDPMXMEOWDSPHJN IDUIIFYMMWKXTR  CMBTVAM        
TRPUTKMELCX     : WCLXCFFXQCHJ   
WEJLCVHWLC      : LJQLCQPUGHEW    VBHBHLTKEU      DWJBOVBOKL      DQVIINAYDKWV    GHAOLFYXJCDV    UYFPWMEUDXUDJ  
BFLEUTTMOODLI   : GHQCYVGHQXTCU  
APBEPWBUH       : HUPIWEWDX       FOME            GHHWLJOB        MGQVVKQULHT     HWKKYHIKDPKGVC 
YFYVTBBUIOC     : VOCXQCFY        NFHBFPKCBJ      BGUFGOKSYMI    
IXQYMVMVNPNRTD  : FYKTY           PNPWWXTVDYYOCP  LKFTHJSGWJNCXSF MCTHX          
XXXMWGLVAP      : YFMSMKTNGMINH   WNHRMIF         JESNWETNII      IDUIIFYMMWKXTR  PUYXOGB        
WXNYEXAUXMS     : JDXDTEADH       OBUQV           XUUIOXW         WFRQODVXFSH     SWVA            ACGOKKQAFBUJG   HTNEWFEHUT     
KGCXAWE         : VCQLAOSVMK      QTCDXNYGHTMLSH  AELKI          
UCPJCVXA        : ODIFDTSDJYBEDBT UQTIILKR        FTPNKHONHFLK    QDLKBVEBYCSFHRC XJLALRXYJJ     
NYVNOWRMWO      : DNFIRPPASSLHM   WBGPUKS         LHTHQRDIAAEDYLS TUUXDQDBOSEVBSV JQMPGCQAYBSQY   RDFIWX         
KJXWQAXQWCIT    : RDECTBRMVNEK    YSCSNECKXIXQ    KRLQSFYDIEP     TWAOPOPGQQBGVBX VTJWDCBSG       KSENBYFTBYU    
BEIWCIXRJ       : XNEYDNAXEUPQF   TTSRYQ          DVHIMUCQOSE     PQURUIE        
HXQCLQQXDBVATYX : PFHM            RYDH            NGNQXXWSKNSMOL 
XCXSJYYRXD      : TRDMVVLJLIYJXTG OFSIXHCFODLGGF 
VWMPENJG        : MMQCJBIDFJHJDOU RVQMDLTEIO      GRSQJERNJRKGCH 
CAYFDV          : IITTUXDCYTEYTS  MFNPJPHQ        IFWAGI         
YWILUKJPT       : MUTCSVX         CFDWDLKIREYN    CBJEOFCPNG      QBYDAPDT        JVBIENF         UAVLODXNNL     
OOJTRFQGXXVJE   : CQDUFCXQHK      PAHMQIHVR      
LGWQJUXKR       : LDKOHUP         IDUIIFYMMWKXTR  RKQOGNAODIDROR 
WMTIDNVT        : CGKRBW          DYJAWASVXSOPI   BGUXJYJJRI      GDJOVVMR        KFBJFPKUXILLF  
FOVMHFKFBTKYHSV : LMFXPUXMQ       TLCVYWFPLQRN    HCEHJUCKVVB     YWHDGJUGUPOL    JGXIA          
FSYPKHOWBACRVW  : COOYJGAV        FCJSB           KBQQLOXY       
DNSPUABBBWN     : OBUQV           NEOF            VTMYLAQKP      
FIAFN           : PIPVEKIIMDM     CMIBPPRFDVXI   
GGDOUDRWFLSEIVT : XXGQMDVDLXYFPFV CSQORYDIYNJG    YWMYWVPTUAMXG   JFORKKJD        OXRUODNORYBHO  
OPDPSEOIJTQJCHD : JTBPNOW         WSSJRLQROSVC    PTUGRK          YXQPQDS         JAXBRNNMYIRTW  
NGYILRITDBXN    : DKPCGFCOXNWPI  
UQOMTGFBUPK     : TLCVYWFPLQRN    RLUONNIG       
GVTNYE          : QIFPHYGLF       PLOAHAOVBXJ     MKGWW           WSCDWYIQKVTDQ  
IEOTXWPDXORAJ   : BEMYS           UYQRCVQVPI      QVHVDXJXDYNMAK  NGTKOBKFVITAV   JYRLWFUIVASK    VABWYOMMEKRKIS 
QXFWDIUUU       : UBILHINUFSV     WTJDLEHHLMAHGM  LUHMJ           MCTHX           JYES           
BQIRSMUD        : AFBNLGEGGTOXJ   RVHDGGSKPFAQ    GUCCENFDRN      JQMPGCQAYBSQY   IGXAVE         
JYQIPUHEOJP     : XPSKLBGIF       MGQVVKQULHT     XBLSSLORDQY    
BPGXSQUPLHSFR   : OAPKLDWHQP      UBILHINUFSV     PXIXILDELFTL    IKJQOFJLQ       GRITCQOQHFB     GSLPNFDWFTJ    
XHIBATATDRQMV   : VKLKVYRTUO      NAHXUNAIVHT     HCEHJUCKVVB     ATUGUMTOANCSL  
XNEYDNAXEUPQF   : RFABIIGTHVXLQX  GKJDNXCPRYFYI   BEIWCIXRJ       TMHJVKNIMNFRJ   IBHJDQQKDMKNS  
VWVVG           : EKOAODBUBQITHO  ECSRT           QXCWFBI         IRYYICHPLK      RWPDJPHPVWVTFGH PAHMQIHVR       MCAJCCBMUJHPOYJ
YJBBD           : EOEHMISDCAGCAHE ORBXBAE         BLQBKCQTVNCDTE 
TTSRYQ          : BEIWCIXRJ       IQPVMLROTKBYBV  MANACRR        
FSNSUOXPE       : VQDLJTNELNOKP   LDNUMKQ        
WNOU            : SNWTFBFHUGCSKTV AXSFQN         
MDQLMTORAIL     : BFDRQ           WVTCAGHWHULEB   GHHWLJOB        DVYYEVK         YJXTWLOJCAKY    MQUG           
DMOLUHBPC       : RMJCICKDRXLV    AHATQOCLEFYF    PYCQOTHGGD     
PTUGRK          : AJRLRJTMDV      CQLPCGIK        OPDPSEOIJTQJCHD DBAXWAAPDQDAJA  OUDN            WQVMAXOABBI    
OWJRQWHKMYLWNIA : WDWXNQJGMR     
WNWEPN          : MHDGEFGCJ       CQDUFCXQHK      VEJPHK          CIRJKPWAWM     
HDDEMWPJ        : KVYOCHA         RYMREUQY        RVHDGGSKPFAQ    HNBJYPL         EGKPSYSGYIKT    YLJMWILYETMOBID
OVFFUMQJOEHCMJ  : UBNEYLPPK       MNLHQ           PEOAKYHTLH      KCAJCLHDN       KPNNPXYB       
MACSRPCYUHGHEX  : PUADY           XWHNWILIQK      IEKDFDH        
RMRWUMMNWBRG    : QVWDGPALUC      VCNK            EUADSOUQVBOC   
GRHSRJMLYQLUX   : FDRROLSE        RWPDJPHPVWVTFGH RFLSTRP         JAXBRNNMYIRTW   XEPEMWKB       
EEPAVERUYFJME   : HBHVFAIP        BOYE            DIHVNMI         RRMDDRQRNNK     SFNPYQTEDMGJRK  CHYLBYOHOBRHB  
GMNPEXKWH       : AJAAIBLHUHJ     EWHW            OOLWFFE         OMMVGU         
IJPVGPPK        : RPJIWCDU        YPRJWDPXEXKPOG  SXUDN           RFFM            VCUFH           QXCKM          
HLRMFPNMYD      : HJWL            PXIXILDELFTL    DQNQYVHI        QBFGHQDCCDUHWCS BBNEWUEBPJJ    
KJDAYIXK        : VWPLDMERNHDPPBH WFRQODVXFSH     QKPMXKVPJIK     AINRXQJ         TQUMWNRBFK     
IJRRC           : HNBJYPL         URBHQOFIX      
XRIKOQXGFE      : ECBV            SIWFPOFA        OFYYJKRT        RYAMCDJNENB    
UQXXKKKNM       : VHSNIVG         IBDJ            DKPCGFCOXNWPI  
XNVHVICPKUPED   : JVALUCW         PQVMW          
SVBCDFAYXAWIK   : INJIT           EBBBKIIDKJASR   CATFRPMJBIDIHG  WHOXCEBFCQGINX  WHXWINJWL       EWCOEQRJXKSDH  
YATYNRHLCLDOG   : IISHJKFNOWNEP  
TLUOIXQLFTKETK  : WWNBFB          DVJUTJARHHJ     IAOIMINAMD      OPHAWPMNWVL    
HTNHPNWKWKMK    : CERP            SGGA            TAYUDLDX        LEVODMACTVX     PDPTERIVTHWB    YRHUJT         
ESIA            : OAHOWHQJILA     MVEYYMCFWJ      OIQPJIPVQNUTDO  GSRYYMESJY     
FOME            : FSMQWRSQKIRHII  MGKBOVASCL      APBEPWBUH       CIDRQBTNQXPA    EBSCISAJQWUDI  
BLCNPVAFF       : EJHGDDLNREG     FQECITLM        XJPCOEQBASVGB  
UOMINWHXMR      : UUUJYIYEPQAD    WHOXCEBFCQGINX 
QKXQRGHE        : ITBBIK          HYYKY           OQXDUJ          KFBJFPKUXILLF  
PHXTVOSVVXSQPG  : ALFYGLJWLAA     IDUIIFYMMWKXTR  SYWMIHO         GJBC            GPPQ            BSPDAP          IGXAVE         
DFLCRGRKQQBKYLR : AMKDDVRXHIL     EATDDLKXNGYCHKN NAXTBKM         TAJDXK          BGQXVKYOJVKPV   VFQXYCYFDUGOIF 
DYJAWASVXSOPI   : LWUSJBXACFHYTBN WMTIDNVT        LWOATRIENEBKP   XPCOKPVAFVURVQ  PLOAHAOVBXJ    
RMFFQ           : FMHHSTWJXMEHFG 
LIIFB           : QEAOOWPYUPMPRK  YAQWCRPQJNES    XDXTQETHXRUFVX  MEUAPW         
PCWHNDHADGAXCYQ : XHFHMEGQA       MDAUH           GMTTN           TTCNNI          ICUXDKCXWP     
QASK            : LMWQAALFFMLSFAR SDEB            DRXSGPRA        HGGIEGXWI       ENGH           
XPFVCPGHTRY     : KHRSSTTUQQ     
RHKWQMAWO       : VPKTXQXLLLPQJ   GOACXQGPVEHF    FEXHTQHXSSC     VABWYOMMEKRKIS  DRPGRX         
CPQVGSQ         : GELLFVM         HPGY            VBHBHLTKEU      FXWK            XXIOWTFO        SBNWNEVEQKGRXA  UITMVUDYGJLHQ  
HPJONNFTWBNVWF  : OYAB            WBGPUKS         UFJFIFJOB       NHDH            DUKO            IFECR          
JCVVE           : TSFJPPNHYLSX    SJEKROXT        SBNWNEVEQKGRXA  RELTONQWFPJQU  
LEXDVVKQMFYEO   : RXDFAGMKNYWQQ   MKGWW           XKNIPFLADJQLSQ 
REWLBXA         : CPIGQENAJ       IASDTJFF        ICUXDKCXWP     
XHFHMEGQA       : HTWSBKB         PCWHNDHADGAXCYQ XCQCXJ          XLCKGHXCTKCRISL FCJSB          
XAWV            : UFRNDMOFYJ      CQDUFCXQHK      RIAKLJBMJTS     DUKO            YQPOHLV         RXSNMDPCLY     
JMKPNPGEHN      : RFABIIGTHVXLQX  QTSESMCCHRHYU   PTKLIURFTUM    
VOCXQCFY        : YFYVTBBUIOC     QIFPHYGLF      
TDRLDNLDLHBWVL  : LHTHQRDIAAEDYLS MBVUCUIW       
KBVQLJTHAXHTC   : EURKJIIS        VUOATGXB        LFONTJB         HESUUDWTDMIC   
SOJVGUBUIE      : DYJXXJOL        FEQPRYPKJJSWLB  QKPMXKVPJIK    
PHFN            : VOTMOSWYLT      YFLLQTWY        MNMGOCPCKKL    
UXWSQICN        : COOYJGAV        XGTGVMHKELFWM   IFRWJA         
ENYXQ           : NEPOODU         ECSRT          
QFWOLT          : VIUODPDAOAVQCC  HAHAOJEXDOWBY   LUVIAQPQGJFVXE  UWGXUVOGKAICMF  JAXBRNNMYIRTW   KJPRGITLMJUC   
ICVQTDYIYVI     : SKKG            VUPMGUAYLWT     DSGLR           GGDSR           OWRF           
OCGSPAWFB       : MMQCJBIDFJHJDOU QXXTSMQJ        PCTHKXXCJM     
VOQBOGPIVAN     : XPCDDCRBE       IRGVXSGF        OBUQV           NDHNTOVLEYY     ITBBIK          AHRWFECVN       TKPCURAWQVT     GRSQJERNJRKGCH 
TJXSTWOF        : CONHKPVFJMDJSLY KEIGWVLKLSJVUKW LNUWTEM         HCTNVSO         DXXQHSP         MVOQWK          BDSBXJQ         OFSIXHCFODLGGF 
FHDXYDWEEU      : VUPMGUAYLWT     HPGY            CVTRIWCKBHWQO  
VMEKSVUQWKLQ    : SKQVLCQ         PLKAFJPOCNTJQ   XKDTRLYMKKH     UYFPWMEUDXUDJ  
KLQJCVFJFKHE    : DWGMDVHEOP      UFRNDMOFYJ      QKCEH           PLKAFJPOCNTJQ   RBEKAVKF        OMMVGU         
GJWCMSQQFLPB    : DGKPVPUWCMRTVQ  KAGT            UPLYKJNCAL     
MNQFK           : VDRIGNQYCA      MBBDSGSDCPP     HWPFVVTDLXUHKIP
SCKUA           : FLERIXATJPB     EIEMCAVPUL      EOKARVBGSRS    
EGFNMVTVSX      : SVEE            VGUYU           RMMOPXUUV      
MQCTER          : ITUKEQTWPF      YJIADOU         OFYYJKRT        JRGIOAFBGVR     AQMFNLN         YJQOV          
JGLALVDGAPD     : ETERJAQJF       SQYCEORUAJDNVP 
KJJPWVNSUGT     : RYIJ            QFFKLUUNYEFXDOQ OFVFSHLNGCHEYI 
UKHPRBOBHADUYGB : KQJQ            PJOVNQ         
XGCIPNAMMNIHW   : KSGMU           PUMWKLBIE       GHEKT           CQFJOOSUUKUH    UDWOOMRAQNWTIYL
MROWJGXYJG      : VIEDCCM         RSESJEOHSMWQD   GOACXQGPVEHF    GGDSR           IKTEHH          BOTQWRMYCGBO   
MDAUH           : PCWHNDHADGAXCYQ MTVBIYXG        HYLYPPGTSTU     IDNY           
TNEEE           : NDVEAWPWEXD     GGKNFJKGQAWC    MQUG            XJCRLMLWHL     
FSHUBQRFDMWA    : BUHCXK          JFIQKYESODPEG   BNIJXFXSPJEVRQG
DYYPHBCMBAT     : BMNFSJXPPJC     JGPRAYA         YFLLQTWY        BAFPN           UCFRCAAWH      
VIKAOFHHO       : SBNWNEVEQKGRXA 
LFWQKJNL        : CATFRPMJBIDIHG  FJUTDDACJ       BNFXSSV         SIVSRJAIII      ITEQN          
TMHJVKNIMNFRJ   : XNEYDNAXEUPQF   BBKUVMGA        VEILKEWSOJD     TTREL          
EMELTL          : RSBFWSPKKRA     HKYILWQASFJVQQV GGDSR           SXUDN           SLIQDPKXDKCHH  
YWHWQSI         : SKQVLCQ         GLIITGRFIQBKC   XGYMPPHPJYT    
EQASBJOLAY      : AHATQOCLEFYF    VOTMOSWYLT      SFTBAEWKTYN     HNHJYGCWSYLCHCB VKDWQ          
PEUCTYOXLKMLK   : NRJHQMBUISMGRSE XUFQYJNSEELYAPF
THAORHSJHNM     : BNUN            HTPJHDDYCBHKGQE OFVFSHLNGCHEYI  JFEIGNTSU      
EATDDLKXNGYCHKN : DFLCRGRKQQBKYLR QIGMEQQVGTYEFJ  DPEVGRPXJDDO    RNSM           
YXFUHIJYPE      : QFDHHYFOBBKRNGG JLIJQWNTNEUW    DLVWRHVLRGNJKC  XQSQVUIVRRSRYN  AELKI          
YRYUXCQDFDNFQ   : PGVP            CBGHCOWPODIFB   UPOGNA          EJDBDEEHHLWGAJ 
ETERJAQJF       : JGLALVDGAPD     PXIXILDELFTL    KVQLPYSLHXXDWT 
SNWTFBFHUGCSKTV : CQLPCGIK        KYWCUHTNVAEJV   WNOU            RPJIWCDU        SBJGXFUDM       TKSDEXTTO       FDHPVYL         NPREGKYBXUL    
SNWTFBFHUGCSKTV : FXTFRDKU        FYGQBT         
WKWPJEL         : BURPRHD         GPPQ           
VUPMGUAYLWT     : EJHGDDLNREG     NWQJXYDY        ICVQTDYIYVI     FHDXYDWEEU      BLQBKCQTVNCDTE 
XBASHFLS        : LMWQAALFFMLSFAR HNHHUVKWICKQJP  UUUJYIYEPQAD    YYKCNFULIYFCDEQ MNMGOCPCKKL    
HKXTKPF         : VDNU            VEILKEWSOJD     OYRPG           DIHVNMI        
CUMY            : NIEVYIWXLM      AXVTURNKBSHU    CTUQ            SIIBBACAPGUBHD 
BGIBFVAYOACR    : GOGRAAIFPWVUR   GHHWLJOB        SQYCEORUAJDNVP  GXGQNMFAMDEE    KIERC           SVOWORSCS       GTYMEYBPHDPSFS  XEPEMWKB       
MWGFXPRXMENRUPN : CTKAQYVIJ       PODXQPVYBB      WLBEKWWWICJVH   DOPHAPBLWN     
PXIXILDELFTL    : BPGXSQUPLHSFR   HLRMFPNMYD      ETERJAQJF       FTGXO           IYVQPGOT        PFSWJRJGTKX    
NGTKOBKFVITAV   : WVTCAGHWHULEB   IEOTXWPDXORAJ   LWOATRIENEBKP   KBTBGVMGH       NOIBGMTMBXQFM   SVOWORSCS      
XOBHGCSEKEJP    : NWXNPGXWMBYUSG  RMJCICKDRXLV    LNDM            OILAGYUKIOKUPR 
QLGYYNULEYVLU   : CTRMCFNAHKJCXH  AJJFCBYYA       TPWBGMNFYAJXQEK NHDH            SYBXRIKHROQ     VMUPX           VJWLEL         
FWET            : YTKNGUVOIKHQKKL FMFVGTVLBSYS    VQPSIJR         BMCLNPSAMWYVG  
UUFBWXHICT      : SDNGMOVJIJVNPHN CVXIKFJLBOLORJ  MNDNRUCOLJAU    OTEHBLCSDHY     NHBJBW          HIOLBCXUOEYXPFI XEPEMWKB       
WKLE            : BQYJLWBVJ       UWGXUVOGKAICMF  GRLYBDXNIF      JAYGHNQGOEPRB  
MTHXXIVMFCRCILC : GKJDNXCPRYFYI   ACDCX           YAAWYL          NAXTBKM         FOAVHW          BTLRWRUA       
JHHGFPQJLQ      : OXWKQPKDGR      SVMULCT         NNOWGILHA       HNBJYPL         EYTN            OFSIXHCFODLGGF 
VCNK            : YJERTLXFPOGYC   RMRWUMMNWBRG    NRWYMQRYQJI     DAFFGUIXGOG    
HTOHCMT         : RJXBAEWEQX      NGMBVDBVEGMEB  
QOLAANELULSCDJM : PEUFJ           IBHJDQQKDMKNS   TSTRD           SJEKROXT       
BVNFJAW         : JVWO            CQMOOLNQDCRXILK
TLCVYWFPLQRN    : FOVMHFKFBTKYHSV UQOMTGFBUPK     NUQUJTUEGOG     RDFIWX         
VAEK            : GLOBRNDLJP      LAGFHJVHSWHNVNT
HPGVHHRWNBWMV   : YPUSKKF         EYREOXNTE       DVWE            BGQXVKYOJVKPV   XKCSGJ         
XXOYUTRIM       : TTCXPBFONYPLAR  IXUOYXPCQLUF    HDJNGYGAU      
YTIBYUXIKE      : FIENUPL         SGGA            OAHGNRYJ       
TOVSEYRQUKO     : QGJLW          
YQQUIBIRC       : JWCAPLDVWNAR    YOWCIXMNDJR    
CFDWDLKIREYN    : YWILUKJPT       XTHLA           TKPCURAWQVT     HIOLBCXUOEYXPFI JEVOADYXBEJP   
DORTJDKFCBXXJB  : NPUSXUPBRXJ     NIGEN           GVNVDCJXSYXRLN  WAWUNRL         RKXRFWLCDU     
EEMGLSGPGQAYWY  : LSXLJXLXD       YLUNPUBAFXJAMD  JFCUUJGJWC      SRVRGPP         FYANA           GYDGMXXAAKJN    JQSCUFBYLEMMFM  FFJAXUPBESVE   
WEEPXPSIU       : AFWDKLDFDKMWD   EVTDREPLSXT     UCUHBQUPNOD     TYYAEKBECGQNYX 
KUWVWFADUJQNRI  : NYFGLPO         KSXGITBWS       VOMIL          
IISHJKFNOWNEP   : YATYNRHLCLDOG   TSFJPPNHYLSX    PKADHQWVHS      LJQLCQPUGHEW    CBGHCOWPODIFB   LPYP            FIAQEAYFJFXAPW 
COJWMFVRIBMTSC  : ARJLVUEMBG      TQIMHUNAEQFDTRP YNJSKYYQQTRGV   FQECITLM       
DWVMRDX         : IBDCKYDDFI      PYLPWPVNUWF     LAOM           
IOSHCXWBAOKYBQX : EDCTWXSSWCFPUXY JSRC            EQDFRISJ        LVUWRBRXXHOMBOD
BBKUVMGA        : UGBXYRMOK       TMHJVKNIMNFRJ   FSOTAQI         KXYQAID         YSCSNECKXIXQ   
EOEHMISDCAGCAHE : YJBBD           SGGA            ITBBIK          LXLKLR         
UFRNDMOFYJ      : CVXIKFJLBOLORJ  XAWV            KLQJCVFJFKHE    KQJQ           
MRBXXREFFPAK    : MFNPJPHQ       
BQXDBCTXHLLNAAS : FYKTY           TQBQASUM        BUBKNGLIVLIF   
LVOFAODR        : RSESJEOHSMWQD  
IYLLKH          : UXGCRFPVXOOBHH 
DFRGHLE         : QXVMBFNELQFGG   KHAM            RQFYRMFJAOKNT   ONLB            SBUCX           NUFCDLXKMTPEXT  CQMOOLNQDCRXILK
YREBRYBFXPKA    : PUADY           VTMCYQR         YCJEYAAXNRYDRE  HTPJHDDYCBHKGQE
NRBYTOMGVBJ     : FSXEAULDKY      RNNUUQMYQ      
SSKGYDH         : ROCWJWSGXAIT    UQMUVIKEDXTYMO  HMBEESJFVX     
IILJK           : VDHGWOUCCIKLCU  RSBFWSPKKRA     FFTKMVCAJLFO   
HCEHJUCKVVB     : FOVMHFKFBTKYHSV XHIBATATDRQMV   BXJUVHPNKJRV    CTPJSSXGVVVWNG 
CWJN            : MFVTRIYNWSQ     RIRJUDEVSBLYWPP PCTHKXXCJM     
CIKKIORAYCN     : HKYILWQASFJVQQV MWNFKN          UWMBEYVW        ADFRFS          SRBEQ           IRJYCD         
MHSR            : SDNGMOVJIJVNPHN IEYAQY          XHWASGEUOWNSQXG JMRINXUHT       GKUIYC         
CBJEOFCPNG      : PSMWWPIBUHJHKF  YWILUKJPT       PUDVHFPSRKNA    WCKSHEONPRAJ   
WWNBFB          : TLUOIXQLFTKETK  HHELKOTSSGFUY   QVAESRPJABOJRQ 
NRHPSJEDYNVQAB  : HBHVFAIP        SUFRGECYEDHBK   BOYE            FGDKMB          ULWQDTFJFDWR   
JFIQKYESODPEG   : FSHUBQRFDMWA    NSEWYTUMRIF     GLOBRNDLJP      KFNXMRW         CQFJOOSUUKUH    WDWXNQJGMR     
FTLYDERNKX      : PPACUPCHHYCTNXP CEUDPL         
XTFBU           : RLUONNIG        LAOM            EYTN            YBXGEEYTDX     
KDICPHIIVOBCU   : IYHAV           SESIODCHCAOWH  
KRMJUQEK        : CKFEISDBFDCK    BIPCOWHD        CMIBPPRFDVXI   
CYCXEDVEPBMR    : NRMYOADGASQH    PKWNNOI        
VDBTREVOFGGSSE  : NSMCI           VHJK           
YONDORBU        : KNLANJEJXSITTDA YQPOHLV         HYLYPPGTSTU     CYYGDW          VFXVUYU        
YYKCNFULIYFCDEQ : PFHM            CQLPCGIK        XBASHFLS        IYHAV           QFTNYSK         UKLMUS         
MAEF            : KUQHJLNF        GNHG            MNHJJRAXCLRAD   OQXKXHSD        EBUKEMAYEK      ANYGNCCUVAVAACD
PEUFJ           : NQVSP           QOLAANELULSCDJM HIYRBBUFSFOP    CTPJSSXGVVVWNG  SAOYWOENUYBY   
WNHRMIF         : XXXMWGLVAP      MGWTEJHL        PLOAHAOVBXJ     EDRNUOKQIEP    
YKMKULS         : XQYARSYYPHES    ETVATHMPIINKR   EKPVNLSHNMJ     TBAXKKTLTLWLCT  ATGOIM         
RWPDJPHPVWVTFGH : AYTBJSFCLGF     VWVVG           GRHSRJMLYQLUX   PWLMIHEAS       WIOE            QROGSADUX      
TQWICCABMPLJBE  : MSWXLKL         OBUQV           MTVBIYXG        TVBOSDSF        DQVIINAYDKWV   
UBXXNQFFMF      : SYWMIHO         FJUTDDACJ       QJTYCMNK       
IKJQOFJLQ       : CXYDLEXONAMPDGV BPGXSQUPLHSFR   QIGMEQQVGTYEFJ  NAXTBKM         SIIBBACAPGUBHD 
NSMCI           : VDBTREVOFGGSSE  KQJQ            QFTNYSK        
LKFTHJSGWJNCXSF : RUNKKBPXWSJ     IXQYMVMVNPNRTD  PCMJXNRDLOFBOGO TKMEVOLB       
FRAUYLIP        : LWKJJWK         PKWNNOI         INSLWIR         JXMURSEJULMC    PERVJTYBVRD     FRXESOSFU       ICUXDKCXWP     
YJKBRLPETLODG   : MNDNRUCOLJAU   
CPIGQENAJ       : OKVLXBBNBOTSLWL NAHXUNAIVHT     REWLBXA         TBNVV          
CGFNPWLQIYTD    : KWTKRYUMYCHH    EJCFYDUCNFPHCQV AORNVVNHYCECSQP WJJRSJDDSIFED  
JJEX            : EOKARVBGSRS    
JESNWETNII      : XXXMWGLVAP      BAFPN           KOVQKOCYM      
TPRDUFUUTLDSFGF : XGYMPPHPJYT    
QMPOVVKMSO      : CJGOVRJAW       HOIS            CYWLQMGIM       AINRXQJ         KWMESLSNM      
IWQXSHPVEXQYRED : WYBATVODC       IGTFCTCEVEHUOED DWXDV          
KLRE            : BBQEYFEBFAT     FMHHSTWJXMEHFG  KOVQKOCYM       KBQQLOXY       
EVTDREPLSXT     : OYEGWORLT       SAUGLEXIEE      WEEPXPSIU       DVHIMUCQOSE     YFLLQTWY        LDNUMKQ         GBPYGUQ         DIUA           
PUMWKLBIE       : LMESMMJORHLUWJQ XGCIPNAMMNIHW   GYSLGNWBWGSSQXC PLKAFJPOCNTJQ   MWJVDJCTARB     PXBNRORJ        ADDDXNINPH     
CJGOVRJAW       : PIPVEKIIMDM     QMPOVVKMSO      EJSFUL          GNHG            KBTBGVMGH       DKCNDNAUQQ     
VQSPWIBRJXJYSXV : HVCMFPAHCYSJB   WJANODFF        FNHAKUROQVXVUSB
JWQOASXIKVBVVA  : RYIJ            KMQXHTFBPKJ     KHRSSTTUQQ      CONBTE         
TSFJPPNHYLSX    : JCVVE           IISHJKFNOWNEP   LWOATRIENEBKP   AIEJGIMASAAOV   JRXQNCCNNXABLC  OXRUODNORYBHO  
SVLD            : LSXLJXLXD       GRVADUU         FGQBBM          QKCEH           UEPYV           ONFYCK         
ETVATHMPIINKR   : DLMD            YKMKULS        
DYQUPGEOTYPARL  : OEVFQJHAYLM     KEIGWVLKLSJVUKW JXSTVXSPCRDJHA 
WHSSGUMNH       : LMWQAALFFMLSFAR NTFFQHLPUPTWHW  HKMXHVDYTC     
XPRK            : CMVNQWYRG       GRITCQOQHFB     SLIQDPKXDKCHH   EIVFVLLEQCJ    
YNJSKYYQQTRGV   : COJWMFVRIBMTSC  HJTMBOWXOGOOW   DJUOMBEDQBWAV   MIWNQIAYANL    
RMJCICKDRXLV    : XNILWEGJI       DMOLUHBPC       XOBHGCSEKEJP    KHAM            IASDTJFF        MGOEKKORGWHL    WTJFBCUGLSGU   
BOINNXXIIWKYP   : IEKDFDH         FNXSACBTLNLKPIX YWNWFV         
SVEE            : QHXAVETWE       EGFNMVTVSX      YRBIOOW         TBAXKKTLTLWLCT  GVCOGLXXAEAYL  
RNUASFFKDQIBUWL : CRAWGTWF        QXCKM           UJHWHLBRBH     
NJIVRIISXOLUT   : SQVBHCB         XBLSSLORDQY    
NNGI            : YSXWVGIFRXAYQW  IWJQMYWCMPQD    VOMIL          
BNUN            : YJLWCLRU        ROHJYWLSTNYFC   OSGEIMCHBDGWW   THAORHSJHNM     MNHJJRAXCLRAD   OOTOWCPSLKAFNV 
MVTJTF          : OEVFQJHAYLM     UWMBEYVW       
HQDFILOD        : WGGNHXYVFYLDXBT VPKTXQXLLLPQJ   DPIONMMK        XKNIPFLADJQLSQ 
FQGBITO         : SPYMYKBLTBHQEI  CQNNVXMPKEJS    CQLIFLHE        MVWRNCRGNKHGJG  HVHLJNS         TQIEYQ         
CERP            : HWCEMFUBLOTD    WANWIGGQS       HTNHPNWKWKMK    YYHWUSLPLKBP    GCTUXKU        
FIOC            : FLERIXATJPB     XVRFBQVCWUG     ETQJ            LLBOC          
XXLTHCWMMKDR    : EJSFUL          HUFWAF          NGEDR           MFNPJPHQ        VNRPSVLUAIBJF   PYAGDNOLUGLLMR 
LIDMTXCI        : KJTKNFCNL       VFQXYCYFDUGOIF 
IDUIIFYMMWKXTR  : VMPVTIKKHEF     MWMTSPUFNAGDNGN XXXMWGLVAP      LGWQJUXKR       PHXTVOSVVXSQPG  RMAHTOT         JXYJKQUUQBHI    LAOM           
IDUIIFYMMWKXTR  : RJSWNTAW       
SHREKKBXUGLQGP  : EXTDOVTYHYXR    BBXHFAKEOEU     TUUXDQDBOSEVBSV YAGQHGELJBQT    AKDGALKSJJODOMJ KFUHXVYXVI     
JAFGJNLI        : SCTFJNROFNP     CSQORYDIYNJG   
XILYC           : MWSGXCAELLNYND  OFVFSHLNGCHEYI  CQMOOLNQDCRXILK
EUNX            : PMSXFLHIGMCQT   BDARBJH         HSYGOQCFTUGLCRC PCKHNKMNHETBNRU
AICY            : RAQDCOBWLUKX    JNJKJWG         VEFNBRLYCRQPUJR EJDBDEEHHLWGAJ 
JMWREYB         : UVSRCXXU        OMOWJKWOEJKI    BGUXJYJJRI      FFJAXUPBESVE   
GHNUVYXVJLUNR   : MECREITS        QJMCJPBKNPFJPMO KPNNPXYB        FMLAMLDEMJ      DUKO            EDRNUOKQIEP    
KHAM            : RFABIIGTHVXLQX  XRUO            DFRGHLE         RMJCICKDRXLV    PAEYAX          RJXBAEWEQX      PXQXCSTUE       JGQQ           
KHAM            : JTYHLULHWM      VFXVUYU         ONFYCK         
KQJQ            : NBTOM           UKHPRBOBHADUYGB UFRNDMOFYJ      NSMCI           RGDFUNFETNAH    WRXXRTCTMSX     EYHGUBWQCO     
VQUARVEYGUVEV   : AMKDDVRXHIL     QVHVDXJXDYNMAK  ANWDJVG         UYHGMWKKDKJTYPQ
AFFVSXYDFYRP    : WQMSOFWU        GMTTN           HPAQCPEKCTRG    OUDLBYJJCKTW    QIMHTAEVAA     
JYDLWVIYO       : GKAKMLS         BVAU            LWUSJBXACFHYTBN TVYM            ACDCX           KSXGITBWS      
GPPDLTYHTG      : JUBMCOSTAQ      EABYWSYGTW      LKBVP           YQPOHLV        
RYMREUQY        : YCEBLDQDTCF     HDDEMWPJ        KMDFARNNHCDMBD  OIVBLPHYVFS    
DIOH            : QDEUKHYDTOG     SDEB            MNSPRPLK        OQXDUJ         
NDHNTOVLEYY     : SQKV            VOQBOGPIVAN     GABIHHVCCRK     GVCOGLXXAEAYL   CBRCHESDRLKVFW  VFXVUYU         FIAQEAYFJFXAPW 
XGTGVMHKELFWM   : CMVNQWYRG       UXWSQICN        FJUTDDACJ       SLXWXBFURTF    
BUJITWNB        : WFRQODVXFSH    
IRIVVJVVHCPNAC  : TNTYLP          SVMULCT         DWJBOVBOKL      LXLKLR          OILAGYUKIOKUPR 
LIJSI           : KHRJC           WJANODFF        LFYQRVNFE      
NJTYTP          : ADVWBJYUTCPORKV DSDQBKPMY       CKFGMRTW       
JSLTK           : NSII            WYFJC           AVFRVFKAMR     
QIGMEQQVGTYEFJ  : JOSIDR          EATDDLKXNGYCHKN IKJQOFJLQ       RXDFAGMKNYWQQ   WLBEKWWWICJVH  
ATNQFJPYY       : GJYGCETH        OUTNCYVLV       VOETRDQ        
LTDFGAVOIKUY    : SYBXRIKHROQ    
RIXSMFECFYRVEC  : UPWELJJ         WHQYHUIB        JBTVDSAPKRUVDVC
GDDRAI          : CTUQ            VSWEDDU        
GKVVTIS         : ARJLVUEMBG      JUNFPB          JOKGXVWDYR      FFTKMVCAJLFO    RKTLMNAHNOF    
MKDMDRR         : OLBKXKYS        NJWAKOWOTGH     DSGLR           TYYAEKBECGQNYX 
VAJOXNSMTVSL    : SBBTVDKO        UYQRCVQVPI      MMQCJBIDFJHJDOU
BLFMH           : UGBXYRMOK       MVEYYMCFWJ      GSDJLUMMA       QXXTSMQJ        OFAJSEUDSWUMMDG
IPVD            : SPKDFKVKDAUFVOL TMLSCF          VQPSIJR        
HJTMBOWXOGOOW   : YNJSKYYQQTRGV   MVEYYMCFWJ      SYWMIHO         EICKYE          TKPCURAWQVT    
CQDUFCXQHK      : OOJTRFQGXXVJE   WNWEPN          XAWV            QLKH            IRFS            VOETRDQ         OUDLBYJJCKTW   
KUPGYWPKTFLICL  : CXYDLEXONAMPDGV BAEMJBBJDPHGA   LUHMJ           VFQXYCYFDUGOIF 
LANIHPBNMGRL    : DEJCMXMFIS      VDRIGNQYCA      DAKKEJ          HGYOBS         
YXWJTPRUOKFI    : WVDKQVMXUFNG    HQTTROT         RXDFAGMKNYWQQ   YNDBABKJ       
SQTHRHHGR       : EWHW            DGKPVPUWCMRTVQ  MBPFUONUFAVE    DWXDV          
XTHLA           : FDIUXFMOFCIQLQ  CFDWDLKIREYN   
YAAWYL          : MTHXXIVMFCRCILC QTCDXNYGHTMLSH  XEBSL          
QFNGPUQFQICXCJ  : MOKHDWQROBFMAPD FDBLULEFULUOTT  OYCBCGUPLE     
ICBJVKW         : ODIFDTSDJYBEDBT HJVJKKWLVAVFSO  MSCDKTUXP      
JVALUCW         : JOSIDR          XNVHVICPKUPED   ERXBYTN         NDRFIC         
SDEB            : QASK            DIOH            IJIBYSCGYDX     BNFXSSV        
CSBSDDSFOA      : FYKTY           MGOEKKORGWHL    PMUQPHON        IETBKONYGPPAV  
QEAOOWPYUPMPRK  : LIIFB           BHDYKUSSKXOHY   FYANA           YWMVDAXUCOHDDCW BMXRKUFKNAY    
NPNOIRHLMKQF    : QKPRVQYBTCUPR   XQSQVUIVRRSRYN  TKPCURAWQVT     OIQPJIPVQNUTDO  QVYOS          
GHHWLJOB        : JRLRRVWJCSTHWGN GQNUFNPHAUN     APBEPWBUH       MDQLMTORAIL     BGIBFVAYOACR    ORBXBAE         JGJX           
ECBV            : XRIKOQXGFE      GHEKT           LYRCMWDFBNYBXP 
SQYCEORUAJDNVP  : LBHENUBSG       JGLALVDGAPD     BGIBFVAYOACR    KHRSSTTUQQ      LNVAJ          
DINKRM          : SVVDYAMO        VKVQBGUJPIUYUP  XSUGLNQ         ECCLAAK         XKNIPFLADJQLSQ  TYGWMDQBTN     
BBXHFAKEOEU     : SHREKKBXUGLQGP  QAHEPGKG        LJLSMN          SVOWORSCS      
IYHAV           : NSBCXC          RVAAXEHAF       KDICPHIIVOBCU   YYKCNFULIYFCDEQ
JYXHRFK         : INJIT           ANWDJVG         AQMFNLN         XDMPQWA         WANJBUDUANYV   
SUUFTVJRGQTS    : ROIIVVJJGJTR    HJWL            PQGUY           XTVQF           TAJDXK         
LWPCHQLHN       : PKWNNOI         SKWOWVVT        GMTTN           JYRLWFUIVASK    XJDKRSDJXJWYNU 
QOVAGBK         : MMQCJBIDFJHJDOU CUPRGOEF       
VIEDCCM         : DLVWRHVLRGNJKC  MROWJGXYJG      PPVQXECXSUEM    NGHAIATGPYLLFJ 
IEQCBCBRGJ      : QKPMXKVPJIK     RJSSWR          VQFXG           KFUB            UIDGYDFKKNFRU  
SSAQMPMMXNAHJI  : LBHXXGLU        IYAY            VHMRPOOJFY     
MMQCJBIDFJHJDOU : LBEEAC          VWMPENJG        OCGSPAWFB       VAJOXNSMTVSL    QOVAGBK         OEVFQJHAYLM     INSLWIR         NHDH           
MMQCJBIDFJHJDOU : VJWLEL         
JNOAAGMNFCPONXD : QVWDGPALUC      KXNQG           NBAUM          
MVEYYMCFWJ      : UCXHMSUMYLTDIOU ESIA            BLFMH           HJTMBOWXOGOOW   DPKSRHVYPJHOTS  IETBKONYGPPAV  
AALQLYGLAMA     : XWKMWXOYRW      UWDAXS         
TCFJRFO         : DGCKXPCCTXV     VIEVEJHWDJPAIN  DOAFHNFFID      EJCFYDUCNFPHCQV
TKYSLMW         : KHRJC           WOTAHFIMAUP     JAYGHNQGOEPRB  
LHJNJUFV        : EDCTWXSSWCFPUXY IXTT            BIPCOWHD        WAPWK          
NJWAKOWOTGH     : MKDMDRR         PMUCPOHQTU      GFTWIRCMCTISG   KXYQAID         IBHJDQQKDMKNS   PDKWVNGHXLOY   
UCUHBQUPNOD     : WEEPXPSIU       MXMPJKWDKR      BMQUAHRFVMMK    TDII           
XRHTWDQKONMY    : QVAESRPJABOJRQ  NGEDR          
JOXRXYOAVX      : FINKSQGUNB      CPLJESBYLQBHRWH VFXVUYU        
MTVBIYXG        : MDAUH           TQWICCABMPLJBE  GQNKWMMEXOTM    KNLANJEJXSITTDA
HCRKSC          : QHBIVHSXI       QTSESMCCHRHYU   HQTTROT         WMXVIDRLDQB    
GRBKDRIX        : MECREITS        LKHULQOICKL     QJRUFTSF       
JMRINXUHT       : MHSR            OUDN            MFHA           
PUYXOGB         : XXXMWGLVAP      LLBOC          
TTLVDFWN        : RYDH            TSTRD          
RYIJ            : HEGE            KJJPWVNSUGT     JWQOASXIKVBVVA  BFVIOHPI        SLIQDPKXDKCHH  
VCQLAOSVMK      : KGCXAWE         NEOF            RCIVHICYTA      JRVMSJVL        ADDDXNINPH     
LKHULQOICKL     : GRBKDRIX        SMKDUFGYOJHQ    WJWYFUXPPSRLN  
JBTDADNJBRCMTQH : DSDQBKPMY       NTOOXYM        
GRITCQOQHFB     : BPGXSQUPLHSFR   XPRK            XIDIJPS         OUKTOPHJGX      EIVFVLLEQCJ    
PMUCPOHQTU      : LBHENUBSG       NJWAKOWOTGH     HQTTROT         SFTBAEWKTYN     TWDPYUBY       
UOEHIVQAEIJXNA  : NREGXIQMN       QFDHHYFOBBKRNGG JLIJQWNTNEUW    SGGA            YVUOTAW         BVSP           
EJSFUL          : CJGOVRJAW       XXLTHCWMMKDR    FMHHSTWJXMEHFG  OJCIHLJJMSDCQGE DFFEXRVC        MIAJKM          UQTIILKR        MSCDKTUXP      
RPJIWCDU        : EXTDOVTYHYXR    IJPVGPPK        SNWTFBFHUGCSKTV UPOGNA          FSTETCHQJSAUQY 
XJJI            : AFWDKLDFDKMWD   YDUOQAA         HOCYY           MFPEBHIBVL     
HYULKELXGB      : CVXIKFJLBOLORJ  JDXDTEADH       DOAFHNFFID      SWVA           
PWLMIHEAS       : RWPDJPHPVWVTFGH KBPUEGQFEC      HVHLJNS        
YVSVCQIL        : DXNXCAVPSSQ     QVEEYRMUU       LBPBXUF         VNRPSVLUAIBJF  
DUDXINFUNLXTEUF : LQPRUUBY        AELFHMFE        NEVL            HPGY            LUVIAQPQGJFVXE  FVPSEFAJSMEL   
DOAFHNFFID      : LMESMMJORHLUWJQ XEFULQJ         TCFJRFO         HYULKELXGB      IBBKGSFCGBXX   
YLVDOTGPEV      : SBBTVDKO        GKAKMLS         XSKTGM          GIWOUHLJEHMK    DJMHK           KFUB           
YJIADOU         : FIENUPL         MQCTER          JBTPIQFXMYX     VBLXAQMKA       FFJAXUPBESVE   
IYBI            : NRMYOADGASQH    XUUIOXW         AAOUXCPJ        YBNMG          
KXNQG           : LDFQUWNGPPP     JNOAAGMNFCPONXD VTJWDCBSG      
BHDYKUSSKXOHY   : QDEUKHYDTOG     NQVSP           QEAOOWPYUPMPRK  HOIS            TWAOPOPGQQBGVBX
RYDH            : HXQCLQQXDBVATYX TTLVDFWN        GXGQNMFAMDEE    CBRCHESDRLKVFW  WTJFBCUGLSGU   
PPVQXECXSUEM    : PFKRLVUFNIIQGX  VIEDCCM         IMULTGQTNEBUR   JXSTVXSPCRDJHA  FIAQEAYFJFXAPW 
NRWYMQRYQJI     : JJODDUXDTDO     VCNK            ORBXBAE        
JBTPIQFXMYX     : IDMXO           YJIADOU         SMKDUFGYOJHQ    LNNRHHKHSUFIWU 
DXNXCAVPSSQ     : YVSVCQIL        YSSIKTFKFKE     IIEHQFUUCMVFEA  KOSGBWEXSOVL    PFSWJRJGTKX    
LLJEURW         : LDJYWJFTTMSBP   TDHQEG         
SQVBHCB         : OYAB            NJIVRIISXOLUT   KOSGBWEXSOVL    LAOM            CTUQ            KFWSBCEPJO     
BBQEYFEBFAT     : WIMPQQJWERII    KLRE            WFRQODVXFSH     HIFUYAB         KFUB           
UMKJATN         : YBET            NTHCH           INCPJTFXAFN     TKSDEXTTO       GPSJTXWRBKEGA  
LMCFFXIO        : JTAKJQUKXHEK    DAGNRBNGAG      RDFIWX         
KKFLELNJPQQRM   : NWXNPGXWMBYUSG  FDIUXFMOFCIQLQ  KCAJCLHDN       MANACRR        
PAEYAX          : HSDME           KHAM            VQDLJTNELNOKP   YWMVDAXUCOHDDCW
XLACSFACUFOHKC  : GJWK            LECASSMJ        YGAPDIEVE       XVWEPYBVL       TYOEULKINHPMURA USCDTNQODJQ     VMUPX           MBVUCUIW       
YPWOHOJTIYV     : UFJFIFJOB       HCFAK           OOLWFFE         EFVFXXPB        PXBNRORJ       
XWKMWXOYRW      : KSYREXLMYBNQ    HNHHUVKWICKQJP  AALQLYGLAMA     TWQBQAAFRRQ     SGGA            GYMY            XEBSL           IRJYCD         
TTGI            : GQNUFNPHAUN     CKFGMRTW       
TMPSDMJ         : WIMPQQJWERII    WBHBCIC        
DSGLR           : ICVQTDYIYVI     MKDMDRR         DGQSHELOWEYIY  
ARCMFYLVX       : BURPRHD         ISMFSQRVCEW     GRLYBDXNIF     
SYWMIHO         : SKKG            JFHXB           PHXTVOSVVXSQPG  UBXXNQFFMF      HJTMBOWXOGOOW   NDVEAWPWEXD     PQGUY           GKUIYC         
SYWMIHO         : YUKJFNFVN      
VGUYU           : PBWFTMHGWA      EGFNMVTVSX      BRXNQ           XBQGOQXU        SVYCSJBDFYOSO  
NBAUM           : YJLWCLRU        ROHJYWLSTNYFC   JNOAAGMNFCPONXD JFEIGNTSU      
ANMEATDLP       : VHJK            JPVL           
OJENV           : RLVIPUTPOAPQJ   FTGXO           BEPUTLU        
WMQT            : UUUJYIYEPQAD    SJIF            KUQHJLNF        WRXXRTCTMSX     SLIQDPKXDKCHH   TKVELAXHQ      
NUQUJTUEGOG     : TLCVYWFPLQRN    MBBDSGSDCPP     CQMOOLNQDCRXILK DDSMTMQQTTPFXF  JEVOADYXBEJP   
BKYWP           : ACDCX           LUHMJ           JBJV           
NSEWYTUMRIF     : HWCEMFUBLOTD    UYQRCVQVPI      JFIQKYESODPEG   JGQQ            HENUASMC       
FTGXO           : PXIXILDELFTL    OJENV           DVUCPAYK        BIPCOWHD       
RJXBAEWEQX      : IAQTLCLFLPVLM   HTOHCMT         KHAM            RWCIN          
GLOBRNDLJP      : VAEK            JFIQKYESODPEG   BTLM            RWCDXSCBCANRFW 
TWQBQAAFRRQ     : LMESMMJORHLUWJQ XWKMWXOYRW      NOLUPWRXM       BNBH            GDVDK          
STWSXOQYWEQBV   : FILKLCXES       HOIS            HQTTROT         HSYGOQCFTUGLCRC
EKPVNLSHNMJ     : YKMKULS         VEILKEWSOJD    
TBHLTBHRVFI     : YJVXSW          HEUSGGEAWXLOWPW DFFEXRVC        YYNPMMVDEVBXNJT JSLRF          
GFTWIRCMCTISG   : NJWAKOWOTGH     SSUCHURGNPJRKBJ
CVQL            : YBJAGVQN        FMFVGTVLBSYS    TRUOPBPUBXSREM  HSFOQFO         UVIBDKMEAEKWXE 
KMQXHTFBPKJ     : JWQOASXIKVBVVA  FQECITLM       
TQBQASUM        : LKCHVXUBP       BQXDBCTXHLLNAAS SUFRGECYEDHBK   QLKH            GMGG            JSLRF           YMEQERLPWRQ    
PXQXCSTUE       : KHAM            DWPKXYNIR      
FSXEAULDKY      : ITUKEQTWPF      NRBYTOMGVBJ     IBDJ           
RSESJEOHSMWQD   : TUOEAMJJUHSOTG  MROWJGXYJG      LVOFAODR        INXDWOJYGTV     MXFSPQ          NMPQIE          IAOIMINAMD     
UVSRCXXU        : JMWREYB         BFONKUTIUVXDQM  SFNPYQTEDMGJRK  QKLI           
EXQPBEQQXJUTVB  : WTJDLEHHLMAHGM  YAFJBTKXHIRVS  
DVUCPAYK        : XWHNWILIQK      FTGXO           IXTT            UWDAXS          LJQLCQPUGHEW   
TFARDUPJUJBWPS  : QDEUKHYDTOG     UBILHINUFSV     RDFIWX         
PCMJXNRDLOFBOGO : LKFTHJSGWJNCXSF MQUG            NPCOTFAOKCKDTD 
ATMTYKKI        : PYGO            QXXTSMQJ        SBNWNEVEQKGRXA 
VJENCTDHGN      : XTYQQNGO        VVTDNWAVRO      TDHQEG          JCUMPBPVMVBVMY  FIAQEAYFJFXAPW 
VHJK            : VDBTREVOFGGSSE  ANMEATDLP      
QLLXCYXV        : JWVFUIXT        LDKOHUP         MEYGFOY         IBDJ           
UUXHF           : RWCDXSCBCANRFW 
DPKSRHVYPJHOTS  : FYKTY           OAHOWHQJILA     MVEYYMCFWJ     
QJMCJPBKNPFJPMO : GHNUVYXVJLUNR   CIRJKPWAWM     
RGHKBQICGUJ     : CEVMJSUO        JRQOPJQQNT     
OEVFQJHAYLM     : MOLTPEQRY       DYQUPGEOTYPARL  MVTJTF          MMQCJBIDFJHJDOU IEKDFDH         SKWOWVVT       
DRXSGPRA        : QASK            AKLTOQ          SWVA            UHIMKGKMOBKAPCS DIUA            BBNEWUEBPJJ    
BKYRVCAQNVF     : QROGSADUX       BFONKUTIUVXDQM  UVLFCNFGNJFIUJ 
TKJDTJEHYRMQR   : LEKVHGBQHSCO    LXLGEA          TNDE            UQXM           
AJAAIBLHUHJ     : EMITWDBHROMLDTW GMNPEXKWH       UQXKCVPKJCSFH   CLOJ            NJBJW           CSQORYDIYNJG   
AXSFQN          : IBDCKYDDFI      WNOU            JXSTVXSPCRDJHA 
CQNNVXMPKEJS    : MWSGXCAELLNYND  FQGBITO         UYFPWMEUDXUDJ  
TUGCVTJSBV      : NIPTRDTVMPUC    SIVSRJAIII      EBADFWQ         CQMOOLNQDCRXILK
DVHIMUCQOSE     : FTSAUTGJI       BEIWCIXRJ       EVTDREPLSXT     XWNAICXV       
QTCDXNYGHTMLSH  : KGCXAWE         YAAWYL          XBQGOQXU        MYIUGON        
LKTAOPIYEFEU    : QXVMBFNELQFGG   MSCDKTUXP       UFFLLNVIGUO    
WBGPUKS         : NYVNOWRMWO      HPJONNFTWBNVWF  TMLSCF         
YRBIOOW         : XNILWEGJI       SVEE            DIPKPAV         IDNY           
XUUIOXW         : WXNYEXAUXMS     IYBI            CUPRGOEF        BSCHFVTFQU      EBXXGHDMRCSY   
IWKND           : CQFJOOSUUKUH    PMUQPHON        VQPSIJR        
KAKQ            : DYJXXJOL        IEVKQMTEJN      ECCLAAK         TYGWMDQBTN      TNDE            EIEMCAVPUL     
IEKDFDH         : MACSRPCYUHGHEX  BOINNXXIIWKYP   OEVFQJHAYLM     GMGG            IWHN           
TXMDVHXEX       : PSMWWPIBUHJHKF  XMWEOWJ         IQADWFQFEOJB   
CEGBQWEAHGLAXTE : IEVKQMTEJN      IDNY           
YLNGCHEOKA      : NTHCH           FDLS            OOTOWCPSLKAFNV 
LHUJLCSOSP      : OKVLXBBNBOTSLWL RTSNRDROIDXFHIV EWHW            OXRUODNORYBHO  
TWBHWYB         : WJJRSJDDSIFED  
JCPXJRFPJ       : AFBNLGEGGTOXJ   ARJLVUEMBG      WKPPRTW         TLFHKQDSMR      XTVQF           TERKBECXLVXQ   
SGGA            : VDHGWOUCCIKLCU  HTNHPNWKWKMK    YTIBYUXIKE      EOEHMISDCAGCAHE UOEHIVQAEIJXNA  XWKMWXOYRW      RMAHTOT        
RLFKABAUUYX     : GQNUFNPHAUN     XIPDDDRSKFOSEMB MAPTPITRSITHN  
YWHDGJUGUPOL    : FOVMHFKFBTKYHSV OUDN            YQBOBPBODIK     MFNPJPHQ       
JEHP            : BFONKUTIUVXDQM  DXFCXGDCKGSOMVN WXTBXBDJWE      NWHOLMAYCVY    
KHRSSTTUQQ      : QLNKGDLNPLDS    XPFVCPGHTRY     JWQOASXIKVBVVA  SQYCEORUAJDNVP  QKFOHQUQNYTXTW  NGMBVDBVEGMEB  
OUTNCYVLV       : PIPVEKIIMDM     ATNQFJPYY       DANLTOY         SIVSRJAIII      QXXTSMQJ        QDLKBVEBYCSFHRC IRJYCD         
HLRUKB          : ACDCX           QXYSOWT         TRUOPBPUBXSREM  TQIEYQ         
RSHFAYXUUTSLKPA : XROJCDEPXN      JXYJKQUUQBHI    JLMEVMLONSXW   
JNJKJWG         : AICY            MYNQXEUKGWGD    LBQLYPJAXHVSKDJ VCRANNLAJWBXU   PJOVNQ         
GUIBFL          : DCRQMAVAO       WANWIGGQS       HQRHHLNWMAUJ    AONKISRYVHRE    DRPGRX         
AELFHMFE        : WNFHJG          DUDXINFUNLXTEUF SBNWNEVEQKGRXA  MGMCPTKN       
YWSLMUSXICKUBR  : OCTVGCTV        IXUOYXPCQLUF    SIVSRJAIII      EBUKEMAYEK     
IMULTGQTNEBUR   : PPVQXECXSUEM    QFFKLUUNYEFXDOQ IKNFJVQVK       FCJSB          
YYHWUSLPLKBP    : ROIIVVJJGJTR    SKKG            JWVFUIXT        CERP            QAHEPGKG        QAABJLYHUFSF   
XROJCDEPXN      : GKJDNXCPRYFYI   DLMD            RSHFAYXUUTSLKPA YMEQERLPWRQ    
TBNVV           : CPIGQENAJ       QKCEH           NGEDR           LAGFHJVHSWHNVNT
EWGOVDHITTU     : LQPRUUBY        MBBDSGSDCPP     RWXYY           UPLYKJNCAL     
LRUFHEHMLAK     : TKNF            SFTBAEWKTYN     FYANA           UHDWMAQ        
IHCXFX          : CRAWGTWF        JXYJKQUUQBHI    FNXSACBTLNLKPIX
LWOATRIENEBKP   : ALFYGLJWLAA     DYJAWASVXSOPI   NGTKOBKFVITAV   TSFJPPNHYLSX    PVID            SBUCX           XGJDG           WQVJNPNRL      
LWOATRIENEBKP   : IKNFJVQVK      
HVCMFPAHCYSJB   : VQSPWIBRJXJYSXV TWAOPOPGQQBGVBX
QBYDAPDT        : YWILUKJPT       EWUUAHXVVPYLOL  UYFPWMEUDXUDJ  
NAXTBKM         : DFLCRGRKQQBKYLR MTHXXIVMFCRCILC IKJQOFJLQ      
SIWFPOFA        : SJIF            XRIKOQXGFE      WCLXCFFXQCHJ    AACYCXSJCVUSN  
GSDJLUMMA       : BLFMH           RNIHRERKJYK     SWVYHLMGUESHGTM
CFJMVJKPLUCIN   : PUADY           HTWSBKB         RIAKLJBMJTS     JCEEGDWHBPQIMYH VYIRAMEPWFS    
HUFWAF          : ALFYGLJWLAA     XXLTHCWMMKDR    KBPUEGQFEC      JCUMPBPVMVBVMY 
IXTT            : LHJNJUFV        DVUCPAYK        HGGIEGXWI       FVKQDJPRIYMVIIE WMXVIDRLDQB     GDVDK          
QGYQVBYF        : KGRGURABR       SIIBBACAPGUBHD  DWXDV          
UQXKCVPKJCSFH   : AJAAIBLHUHJ     URBHQOFIX      
HOIS            : QMPOVVKMSO      BHDYKUSSKXOHY   STWSXOQYWEQBV   ECKVYFARTPIGFY  HWKKYHIKDPKGVC 
CMBTVAM         : LMESMMJORHLUWJQ MWMTSPUFNAGDNGN JNNJK          
DNYRIPRVSPNFA   : RQKMIXJGIT      KLTTCWYBCPJIFU  UAVLODXNNL      DIHVNMI        
AHATQOCLEFYF    : WANWIGGQS       DMOLUHBPC       EQASBJOLAY      LNNRHHKHSUFIWU  GUCCENFDRN      MKGWW           WFANQVC        
WHPOK           : OWCGITYHT       XPJJTONQL       LWUSJBXACFHYTBN RGDFUNFETNAH    SRBEQ          
NEOF            : DNSPUABBBWN     VCQLAOSVMK      JSLRF           KXKMPW         
MXOAGQ          : YJERTLXFPOGYC   KOVQKOCYM       ECKVYFARTPIGFY 
IASDTJFF        : REWLBXA         RMJCICKDRXLV    BGUXJYJJRI      XKNIPFLADJQLSQ 
MGUPDC          : JJOCAT          GKJDNXCPRYFYI   SSXJKXMBNWBFA   SBCWTUOQTTDE    JLMEVMLONSXW   
TPMJVDPU        : WQNTGBLXL      
PMSXFLHIGMCQT   : LECASSMJ        EUNX            SLXWXBFURTF    
GHQCYVGHQXTCU   : TTCXPBFONYPLAR  IEDDYGAUMJ      BFLEUTTMOODLI   PWIEYD          UPLYKJNCAL     
RRSKGNIOCRW     : NKLBAT          YJXTWLOJCAKY    VHMRPOOJFY      VSWEDDU        
EBBBKIIDKJASR   : SVBCDFAYXAWIK   TNDE           
RLUONNIG        : GOGRAAIFPWVUR   UQOMTGFBUPK     XTFBU           ANWDJVG         GLPOPDVAGEP    
PWIEYD          : CQXNESLPFJCDO   SJIF            GHQCYVGHQXTCU   PXIWT          
HHELKOTSSGFUY   : GHAY            WWNBFB          ITBBIK          XQSQVUIVRRSRYN  SIPT            LAOM           
NSII            : OLBKXKYS        JSLTK           PQURUIE        
YVSHVKEH        : AFBNLGEGGTOXJ   OAPKFR          GBQAAWO        
DKTNTX          : QVIQGW          RQFYRMFJAOKNT   XPCOKPVAFVURVQ  IQUP            THQRLKFNC      
FOUAJB          : BXJUVHPNKJRV    IFRWJA          MKGWW          
EACRVNBFMYXTXKB : NBMOKILQI       GOGRAAIFPWVUR   QIFPHYGLF       JRXQNCCNNXABLC  PIMMYFUN        ETQJ            KSNUBRAKNN     
BEPUTLU         : YLUNPUBAFXJAMD  OJENV          
QKPRVQYBTCUPR   : PGAALUFYDPB     NPNOIRHLMKQF    SURHT           HNBJYPL         CLMVWPGCYTUEQCG MOIECMT        
WEXXA           : FXWK            WGMRRKXWXYRM    BMXRKUFKNAY     TTFNTXCEWTMHMD 
IBBKGSFCGBXX    : DOAFHNFFID      YBORILCHIVBHP  
NRJHQMBUISMGRSE : PEUCTYOXLKMLK   RDECTBRMVNEK   
TAYUDLDX        : JEDVKR          GRVADUU         HTNHPNWKWKMK    KJTKNFCNL       RELTONQWFPJQU  
GFVGFJV         : ORBXBAE         SDLQVLITADXS    URBHQOFIX       KYNFK           HWKKYHIKDPKGVC 
VDRIGNQYCA      : MNQFK           LANIHPBNMGRL    HQTTROT         ITXUFKRXHSF     TVBOSDSF        PSTNJDICED     
VEJPHK          : NNFLGROHRQMYR   WNWEPN          FFJAXUPBESVE   
KVQLPYSLHXXDWT  : ETERJAQJF       AACYCXSJCVUSN   VOMIL          
OEPEXRH         : EYREOXNTE       FEQPRYPKJJSWLB  XDMPQWA        
JFCUUJGJWC      : EEMGLSGPGQAYWY 
ITBBIK          : DLMD            QKXQRGHE        VOQBOGPIVAN     EOEHMISDCAGCAHE HHELKOTSSGFUY  
GOACXQGPVEHF    : KHRJC           RHKWQMAWO       MROWJGXYJG      TPGC           
QKFOHQUQNYTXTW  : UPWELJJ         KHRSSTTUQQ      IKNFJVQVK       ONFYCK         
EICKYE          : HJTMBOWXOGOOW   OYRPG          
YVUOTAW         : GFOIFKD         UOEHIVQAEIJXNA  XKCSGJ         
CPLJESBYLQBHRWH : MGKBOVASCL      JOXRXYOAVX      SAOYWOENUYBY   
BRXNQ           : VGUYU           BVSP            OQXKXHSD        NPREGKYBXUL     YLJMWILYETMOBID
CRAWGTWF        : IAQTLCLFLPVLM   BDHUB           RNUASFFKDQIBUWL IHCXFX          STPAJ           VSWEDDU        
AVGJCBMEPEF     : DLVWRHVLRGNJKC  RVQMDLTEIO      NXFRGKRCMOGS   
XCGQ            : JJODDUXDTDO     NWQJXYDY        HNHJYGCWSYLCHCB CYWLQMGIM       QVYOS          
XQSQVUIVRRSRYN  : YXFUHIJYPE      NPNOIRHLMKQF    HHELKOTSSGFUY  
UWDAXS          : AALQLYGLAMA     DVUCPAYK        URBHQOFIX       MKGWW           QVYOS          
PYLPWPVNUWF     : LMESMMJORHLUWJQ DWVMRDX         BYGXCWU        
NBKYY           : LEKVHGBQHSCO    BIPYRONJGUY    
SRVRGPP         : EEMGLSGPGQAYWY  AONKISRYVHRE    YQBOBPBODIK    
TRDMVVLJLIYJXTG : XCXSJYYRXD      VWIBNGITDHO     NUQRTSUSHMTMGX  MFNPJPHQ        YQPOHLV        
JWIVXICQAYKIOCN : RFABIIGTHVXLQX  SJQDMFUUTTAHC   SQKV            HIYRBBUFSFOP    NGHAIATGPYLLFJ  IWHN           
TTYRPKBBUAKV    : HSDME           BDEIPAEEB       SSARAYWXAJ      UFJFIFJOB       SYBXRIKHROQ    
TBFSKDQUGJWH    : MUMMPKROJ       OAHOWHQJILA     HHWFDOL         MOUWCGY        
GVYVJSPINHT     : YCJEYAAXNRYDRE  GGPDXWXA        CEKWSACNJXXTJ   NGNQXXWSKNSMOL  YPEGLEMHGOVCF   MVIFAWHYED     
IQPVMLROTKBYBV  : XWHNWILIQK      TTSRYQ          JGQQ            SLIQDPKXDKCHH   YRUEJBCRUT      QBUBHKC         ECKVYFARTPIGFY 
MUMIDLHAUDR     : OXVGRYC         HDVUUWN         AXLPHT          KRJQKYU        
QAYHISWGFLA     : LBPBXUF         EBUKEMAYEK     
HKYILWQASFJVQQV : XQYARSYYPHES    EMELTL          CIKKIORAYCN     GSRYYMESJY      HTNEWFEHUT     
VOTMOSWYLT      : SDNGMOVJIJVNPHN PHFN            EQASBJOLAY      XXGQMDVDLXYFPFV
THIPQ           : TRUOPBPUBXSREM  NMTEAERAQOI    
PAHMQIHVR       : OOJTRFQGXXVJE   VWVVG          
PKADHQWVHS      : FMSORUWDOYA     IISHJKFNOWNEP   IWJQMYWCMPQD   
JGPRAYA         : JJHI            DYYPHBCMBAT     QIFPHYGLF       QVIWUQ          LAOM           
QVIQGW          : DKTNTX          ISYCYGPTCXTIGU  MEUAPW         
QFFKLUUNYEFXDOQ : HWCEMFUBLOTD    KJJPWVNSUGT     IMULTGQTNEBUR   BQBNRHSLLP      IRFS           
XANPAPSSGQDY    : AJJFCBYYA       TNTYLP          GLPOPDVAGEP     XJLALRXYJJ     
DIPKPAV         : YRBIOOW         KBTBGVMGH       PPACUPCHHYCTNXP CHYLBYOHOBRHB   HBLTFMVU       
XLMEQ           : SJIF            NOMFODQHWAWGNYN JFORKKJD        QJRUFTSF       
HGGIEGXWI       : WCOLHUYJDYHSYPO QASK            IXTT            AAOUXCPJ        JTYHLULHWM      BLHEYFQM        UVIBDKMEAEKWXE 
RCVIHUIMFXWVB   : MNLHQ           YWMVDAXUCOHDDCW KNYKIFYLMF      XCQFAGIH       
HBHVFAIP        : YJMYKGLY        EEPAVERUYFJME   NRHPSJEDYNVQAB  ONFMUHY        
OAPW            : RWCIN           QEHWLJYU       
MGOEKKORGWHL    : RMJCICKDRXLV    CSBSDDSFOA      FDLS            JGXIA          
GJBC            : PMAGVJB         PHXTVOSVVXSQPG  BNFXSSV         DBDNAPDPPTGDA  
CLOJ            : AJAAIBLHUHJ     NTFFQHLPUPTWHW 
ABWQBMOCBWQFHBV : EWHW            JLMEVMLONSXW    OULROS         
JTIXTPHUTBYHPKU : UCXPLDLACY     
MTJPGAR         : KEIGWVLKLSJVUKW DGKPVPUWCMRTVQ 
WIOE            : RWPDJPHPVWVTFGH
LHTHQRDIAAEDYLS : NBRNQUXWQEI     CTRMCFNAHKJCXH  NYVNOWRMWO      TDRLDNLDLHBWVL  GHLYIHPCHFCTA  
INXDWOJYGTV     : CTKAQYVIJ       WCOLHUYJDYHSYPO QTSESMCCHRHYU   RSESJEOHSMWQD   XWVAGU          KNLANJEJXSITTDA XOPOBIGPY       WGMRRKXWXYRM   
KCCXJVHCQK      : EURKJIIS        WSCDWYIQKVTDQ   WQJMQMLODDBJR   IGXAVE         
SKQVLCQ         : RUNKKBPXWSJ     VMEKSVUQWKLQ    YWHWQSI         JYRLWFUIVASK    ITQIVQTFGIR    
LEVODMACTVX     : HJWL            HTNHPNWKWKMK    XJCRLMLWHL      ATUGUMTOANCSL  
HCNHMLPQ        : QVIWUQ         
CEWPUSB         : PLOAHAOVBXJ    
MYNQXEUKGWGD    : JNJKJWG         LNVAJ           RXSNMDPCLY     
RMAHTOT         : IDUIIFYMMWKXTR  SGGA            ORBXBAE         TSTRD           JPVL           
IXOMXEJQ        : GAIDQGVKC       NBRNQUXWQEI     JWVFUIXT       
LDJYWJFTTMSBP   : LLJEURW        
UCTDXKYKSWY     : LMWQAALFFMLSFAR GGPDXWXA        EVLIGSDDJDGADKA YWMVDAXUCOHDDCW
WFRQODVXFSH     : WXNYEXAUXMS     KJDAYIXK        BUJITWNB        BBQEYFEBFAT     NYFGLPO         RFFM            DIHVNMI         IBDJ           
MEYGFOY         : QLLXCYXV        FXWK           
SUFRGECYEDHBK   : NRHPSJEDYNVQAB  TQBQASUM        GVHFYQYGWDUIF   BSWUUGYQJ       RAKHUXBPTHTAR   CYYGDW          HTNEWFEHUT     
TYEQALJHWY      : FUNTHFSSRPIVCU  HPWYGVW        
VHSNIVG         : UQXXKKKNM       YSSIKTFKFKE     FVAFRN          OOTOWCPSLKAFNV  AXLPHT          QJTYCMNK       
DAKKEJ          : HOCYY           LANIHPBNMGRL    MGWTEJHL        WVQJYIAARGRB    IIACLYTLM      
HQTTROT         : OWCGITYHT       YXWJTPRUOKFI    HCRKSC          PMUCPOHQTU      STWSXOQYWEQBV   VDRIGNQYCA      GSLPNFDWFTJ     OHGJBPKKAUP    
HQTTROT         : GRDQRKEPPXSKWT  SXPWYDFGUK     
FVKQDJPRIYMVIIE : OXVGRYC         JOKGXVWDYR      IXTT            MIHIUXTFNEF     DSDQBKPMY      
OFYYJKRT        : XRIKOQXGFE      MQCTER          YRUEJBCRUT      YAGQHGELJBQT    QAABJLYHUFSF   
LNVAJ           : NTHCH           SQYCEORUAJDNVP  MYNQXEUKGWGD    XGYMPPHPJYT     SXPWYDFGUK     
FFGY            : JSRC            LOWTYSEEU       KRJQKYU         YMEQERLPWRQ    
PODXQPVYBB      : MWGFXPRXMENRUPN GVCOGLXXAEAYL  
RIMQTY          : HCTNVSO         RGNWKPXFINYIYLY KSENBYFTBYU    
NDVEAWPWEXD     : TNEEE           SYWMIHO         LXLGEA         
JVWO            : BVNFJAW         VGIESVJUYVSP    EURBCOBVSXMYKUI
NGUOHXCYGQRCP   : IRFS            HIOLBCXUOEYXPFI
STBWVAOS        : FGTQXBY         YWMYWVPTUAMXG  
MYMXWJM         : MXFSPQ          UIDGYDFKKNFRU  
WVPLFNPFVIYYAET : YFMSMKTNGMINH   PUDVHFPSRKNA   
HQRHHLNWMAUJ    : KDSPR           GUIBFL          XKDTRLYMKKH     IBHJDQQKDMKNS  
KEIGWVLKLSJVUKW : TJXSTWOF        DYQUPGEOTYPARL  MTJPGAR        
ESIWLREYFDLIYW  : MVIFAWHYED     
LDFRABFNPBWL    : VFSA            BFONKUTIUVXDQM  XCQFAGIH        GDVDK          
JIYPCHMPYS      : FDRROLSE        WVQJYIAARGRB    NYYVNAF        
GWCOXYL         : WUKPLHJYNLJMJ   HTNEWFEHUT     
EQDFRISJ        : JRLRRVWJCSTHWGN IOSHCXWBAOKYBQX PDPTERIVTHWB    BOYE            NGNNPMPSSTT    
RVHDGGSKPFAQ    : BQIRSMUD        HDDEMWPJ        MIHIUXTFNEF     UPLYKJNCAL      SIIBBACAPGUBHD 
QXYSOWT         : BWCOAOE         HLRUKB          RWXYY          
GYSLGNWBWGSSQXC : PUMWKLBIE       VOETRDQ         VJTIWATHYF     
QMPXNIAEGA      : NTFFQHLPUPTWHW  AMYFVBCH       
XWVAGU          : RFABIIGTHVXLQX  INXDWOJYGTV     YUKJFNFVN      
TDHQEG          : AFBNLGEGGTOXJ   LLJEURW         VJENCTDHGN      GHAOLFYXJCDV   
YAQWCRPQJNES    : LIIFB           MKGWW           HVHLJNS         QWXYNMCRKA     
LBQLYPJAXHVSKDJ : JNJKJWG        
LJQLCQPUGHEW    : WEJLCVHWLC      IISHJKFNOWNEP   DVUCPAYK        XPSKLBGIF       HCFAK           LLBOC          
YNYBEMA         : UIUFIO          VOETRDQ        
WCUEXPQDBGPNA   : MQUG            RGNWKPXFINYIYLY
PQVMW           : NBTOM           QHXAVETWE       XNVHVICPKUPED   KQRXFSPISNNUNT 
TTSSJUVPJYMIBJ  : YPRJWDPXEXKPOG  LKOCXGXWOOEUXHM RKRTVHAL       
CBGHCOWPODIFB   : GFOIFKD         YRYUXCQDFDNFQ   IISHJKFNOWNEP   JBJV           
FGQBBM          : SVLD            GAAHAHAPVHJBXC  CBRCHESDRLKVFW  RXWJIMHCADIDOI 
XIDIJPS         : UXCYLTKDKNQQYJ  GRITCQOQHFB    
BIPCOWHD        : KRMJUQEK        LHJNJUFV        FTGXO           HXXOGDK         MOSJADPCGOY     CYYGDW          KWMESLSNM      
WUAHAB          : RPVA            RKRTVHAL       
HJVJKKWLVAVFSO  : NEPOODU         UXCSYRVI        ICBJVKW        
VWIBNGITDHO     : RQWJHLGJTQFSAY  TRDMVVLJLIYJXTG XWNAICXV        MSCDKTUXP       YBNMG          
PQGUY           : SUUFTVJRGQTS    SYWMIHO         VBHBHLTKEU     
QKCEH           : GURPFEURCRC     KLQJCVFJFKHE    SVLD            TBNVV           BTLRWRUA        RMMOPXUUV      
AJJFCBYYA       : XQYARSYYPHES    QLGYYNULEYVLU   XANPAPSSGQDY   
AONKISRYVHRE    : GUIBFL          SRVRGPP         IYAPPLAP        JGJX           
SVVDYAMO        : NLQO            OAHOWHQJILA     DINKRM          VRUJIO          DSDQBKPMY      
WBHBCIC         : TVYM            BFOAYTEKVTIIYQD TMPSDMJ         XEPKWLUTTLBMIVB OOLWFFE         ULWQDTFJFDWR   
SESIODCHCAOWH   : PGAALUFYDPB     KDICPHIIVOBCU   NYFGLPO         LOWTYSEEU       KSPXVYR        
PDPTERIVTHWB    : HTNHPNWKWKMK    EQDFRISJ        DURYVIPXGUNXO   DPIONMMK       
BMNFFSYPHCROHUG : NLQO            TOHTEBIRICCYRFB DWJBOVBOKL      KNLANJEJXSITTDA KXKMPW         
CATFRPMJBIDIHG  : IDMXO           SVBCDFAYXAWIK   LFWQKJNL        GVFQVQWEVQVYL  
IUINABOSK       : QKUARYEBBIMH    BNFXSSV         YWFMRBXY        HWPFVVTDLXUHKIP
KCBHIHJKBRETENU : AMKDDVRXHIL     IDMXO           PYCQOTHGGD      CWCYTUAL       
SFTBAEWKTYN     : EQASBJOLAY      PMUCPOHQTU      LRUFHEHMLAK     IOACHH         
RXDFAGMKNYWQQ   : LEXDVVKQMFYEO   QIGMEQQVGTYEFJ  YXWJTPRUOKFI   
KUQHJLNF        : ISLIAXWKHYPFCR  MAEF            WMQT            RYAMCDJNENB     URBHQOFIX       PGBCPPRWW      
PLKAFJPOCNTJQ   : VMEKSVUQWKLQ    KLQJCVFJFKHE    PUMWKLBIE       UFJFIFJOB       IFWAGI         
VDNU            : HKXTKPF        
FLERIXATJPB     : SCKUA           FIOC           
FMHHSTWJXMEHFG  : RMFFQ           KLRE            EJSFUL          BIPYRONJGUY    
JUBMCOSTAQ      : CMVNQWYRG       GPPDLTYHTG      QJUPPMKAMYWK    TWAOPOPGQQBGVBX
VBLXAQMKA       : YJIADOU         HGTBV          
EYREOXNTE       : HPGVHHRWNBWMV   OEPEXRH         YAFJBTKXHIRVS   SYBXRIKHROQ     QVYOS          
FBVTDNN         : NGMBVDBVEGMEB   UHIMKGKMOBKAPCS VJWLEL         
NEVL            : ASJMSPBTUXINAL  DUDXINFUNLXTEUF XKNIPFLADJQLSQ 
IJIBYSCGYDX     : NWXNPGXWMBYUSG  SDEB            RWCIN           WVPQVCAPXKNHRA  CWCYTUAL        XKCSGJ          HMBEESJFVX     
RVQMDLTEIO      : LBEEAC          VWMPENJG        AVGJCBMEPEF     GLPOPDVAGEP     AAOUXCPJ       
VEILKEWSOJD     : TMHJVKNIMNFRJ   HKXTKPF         EKPVNLSHNMJ     LNNRHHKHSUFIWU  FNHAKUROQVXVUSB
IXUOYXPCQLUF    : XXOYUTRIM       YWSLMUSXICKUBR  RFLSTRP         IBDJ            JBJV           
IYVQPGOT        : UBNEYLPPK       TQIMHUNAEQFDTRP PXIXILDELFTL    KQRXFSPISNNUNT  DPEVGRPXJDDO    PCTHKXXCJM      QAABJLYHUFSF   
AFUAAMJFDRDAI   : GOGRAAIFPWVUR   FLBMQFIQHCTNFQQ RKTLMNAHNOF     QBFGHQDCCDUHWCS
XXGQMDVDLXYFPFV : GGDOUDRWFLSEIVT VOTMOSWYLT      THQRLKFNC       FCJSB          
VWRTWTGIY       : IEYAQY          MBBDSGSDCPP     OAHGNRYJ        LKBVP           MVOQWK         
AELKI           : HJWL            KGCXAWE         YXFUHIJYPE      SIVSRJAIII      XKNIPFLADJQLSQ 
JODVTBB         : JERFXLVHVWEJPA  OCTVGCTV        VDUSWBHI       
YBORILCHIVBHP   : IBBKGSFCGBXX    VABKB           DGQSHELOWEYIY   NYBNLWGUODCLWH  QIMHTAEVAA     
PQURUIE         : BEIWCIXRJ       NSII            NNGUPFNCS      
TNTYLP          : VBYTPUGSPGN     IRIVVJVVHCPNAC  XANPAPSSGQDY    EMVRNVKPGNK     KFKFCTFPIKVPIW  XJDKRSDJXJWYNU 
PYCS            : YJERTLXFPOGYC   FJUTDDACJ      
TBAXKKTLTLWLCT  : QSFTUFW         YKMKULS         SVEE            JBPDFSFHEYHGRL 
YCJEYAAXNRYDRE  : YREBRYBFXPKA    GVYVJSPINHT     QFTNYSK         UPLYKJNCAL      DEEJ           
GAAIYKUUYOHVCLQ : CKFGMRTW        DGXLM           IKNFJVQVK      
NUQRTSUSHMTMGX  : KSYREXLMYBNQ    WVDKQVMXUFNG    TRDMVVLJLIYJXTG OUKTOPHJGX      IEANJKLDXL     
OYLWAVRU        : PEOAKYHTLH     
IEVKQMTEJN      : ALFYGLJWLAA     KAKQ            CEGBQWEAHGLAXTE TWYGQWFKGP      NXJFW          
EGUWPIS         : NIEVYIWXLM      GKTENXEKCFEXAB 
QROGSADUX       : OWCGITYHT       RWPDJPHPVWVTFGH BKYRVCAQNVF     RKQOGNAODIDROR  RJQP            DKCVAOHQKAGHT   RNNUUQMYQ      
PXIWT           : PSMWWPIBUHJHKF  PWIEYD          POEAWHIT        SLIQDPKXDKCHH   BSCHFVTFQU     
NIPTRDTVMPUC    : GQNUFNPHAUN     TUGCVTJSBV      NXJFW           GYDGMXXAAKJN    QXXTSMQJ       
OFQIVW          : QDEUKHYDTOG     NWLVGSLO        YVNKKHKG       
XDVWDNULKQHAY   : ROHJYWLSTNYFC   NQVSP           LTFNCN         
VQDQP           : XEGQTJNKVLSSRA  RHNJLCGWVGEJB   YAGQHGELJBQT    OIQPJIPVQNUTDO 
GKUIYC          : FUFEFMKV        MHSR            SYWMIHO        
HYYKY           : YGVTGYACUCL     QKXQRGHE       
IXFYUSJLD       : JEDVKR          BVAU            FEQRYNUMNWTTWLV RYBWPVDDYUMF    YWNWFV         
KDIEIBTBJE      : SOGEVCTJLBQUBXA
RGCTPBSB        : IRGVXSGF        XMWEOWJ         FEQRYNUMNWTTWLV CUPRGOEF        SCQDPUX         JRQOPJQQNT     
WLBEKWWWICJVH   : VPKTXQXLLLPQJ   MWGFXPRXMENRUPN QIGMEQQVGTYEFJ  RAMYBH          LMXOPUMXMEOJSDW JFORKKJD       
ASVTVFATXI      : MOOPVKP        
RYAMCDJNENB     : QHBIVHSXI       UGBXYRMOK       JTTQPUBD        XRIKOQXGFE      KUQHJLNF       
MXMPJKWDKR      : WHQYHUIB        UCUHBQUPNOD     PONWRIS         JXMURSEJULMC    NOMFODQHWAWGNYN SLIQDPKXDKCHH  
GNHG            : UYQRCVQVPI      MAEF            CJGOVRJAW       WTJDLEHHLMAHGM  TSLORGKBXXABCB 
HPGY            : WYICGFMNERH     CPQVGSQ         FHDXYDWEEU      DUDXINFUNLXTEUF
INSLWIR         : FRAUYLIP        MMQCJBIDFJHJDOU MXFSPQ          IBDJ           
JXYJKQUUQBHI    : PWGHALHCAFRS    IDUIIFYMMWKXTR  RSHFAYXUUTSLKPA IHCXFX          EDRNUOKQIEP    
NWLVGSLO        : OFQIVW          ANYGNCCUVAVAACD
EWHW            : GMNPEXKWH       SQTHRHHGR       LHUJLCSOSP      ABWQBMOCBWQFHBV ERXBYTN         VSWEDDU        
GGDSR           : KMMDB           ICVQTDYIYVI     MROWJGXYJG      EMELTL          JUAJPULTRS      NYTPAFPLIRRPFIW OBLPWPSWULCEGGS
SEPLYKC         : ISMFSQRVCEW     CIDRQBTNQXPA   
TLFHKQDSMR      : QVWDGPALUC      JCPXJRFPJ       PJOVNQ          HHWFDOL         JFEIGNTSU      
GVFQVQWEVQVYL   : FDBLULEFULUOTT  CATFRPMJBIDIHG  YDOERMEDRXREJ  
OYCBCGUPLE      : QFNGPUQFQICXCJ  OJWKPV          BEYUALLWGN     
FJUTDDACJ       : LFWQKJNL        UBXXNQFFMF      XGTGVMHKELFWM   PYCS            GAVKJJQC        JQSCUFBYLEMMFM 
XCQCXJ          : XHFHMEGQA       BNFXSSV         ORBXBAE         EWQOLSUTASE     DOPHAPBLWN     
WWFNVJOAPLPCP   : AACYCXSJCVUSN   LVUWRBRXXHOMBOD FGUFGPWHVPGCPP 
JBPDFSFHEYHGRL  : PGVP            NTHCH           TBAXKKTLTLWLCT  CNWPYXBRLRW     FXWK            WFANQVC        
BNFXSSV         : HNHHUVKWICKQJP  LFWQKJNL        SDEB            GJBC            IUINABOSK       XCQCXJ          HXXOGDK         TYILMCJMNKNCRMY
JWSUMWMHGQYL    : TKNF            FUNTHFSSRPIVCU  NUFCDLXKMTPEXT  AVHN            CHYLBYOHOBRHB  
RQFYRMFJAOKNT   : DFRGHLE         DKTNTX          ACGOKKQAFBUJG   JRQOPJQQNT     
HNHJYGCWSYLCHCB : TEIFQRUJQ       EQASBJOLAY      XCGQ            ADVWBJYUTCPORKV HWPFVVTDLXUHKIP
AVKFUETCOTQBI   : ERXBYTN         FLBMQFIQHCTNFQQ JAXBRNNMYIRTW  
ORBXBAE         : TWYEJOIVESHPLP  YJBBD           GHHWLJOB        NRWYMQRYQJI     GFVGFJV         RMAHTOT         XCQCXJ         
WYFJC           : QLNKGDLNPLDS    JSLTK           WHXWINJWL       EQSYFLMRBIDXVHJ
NFIODUTXAQDQ    : XTYQQNGO        FMFVGTVLBSYS    VABKB           RNSM           
VRUJIO          : CBFMISWDCYPXVQK SVVDYAMO        UPLYKJNCAL      FFJAXUPBESVE   
GQNKWMMEXOTM    : FDRROLSE        WIMPQQJWERII    MTVBIYXG        JSJFVWVTIGPILNE HENUASMC       
DBAXWAAPDQDAJA  : YDUOQAA         PTUGRK         
TPWBGMNFYAJXQEK : OTEHBLCSDHY     WYBATVODC       QLGYYNULEYVLU  
JNNJK           : CMBTVAM         BNRNNBOJNWAATPU
KBTBGVMGH       : NGTKOBKFVITAV   CJGOVRJAW       DIPKPAV         DVJUTJARHHJ    
VGIESVJUYVSP    : MSWXLKL         JVWO            XRRCHFO        
FDLS            : RUNKKBPXWSJ     AUCDPUMEKHGMF   JRLRRVWJCSTHWGN WANWIGGQS       YLNGCHEOKA      MGOEKKORGWHL    MIHIUXTFNEF     SBCWTUOQTTDE   
UFJFIFJOB       : RVKGWWEKUPBU    HPJONNFTWBNVWF  YPWOHOJTIYV     TTYRPKBBUAKV    PLKAFJPOCNTJQ  
XKDTRLYMKKH     : MNDNRUCOLJAU    VMEKSVUQWKLQ    HQRHHLNWMAUJ    GABIHHVCCRK    
GABIHHVCCRK     : NDHNTOVLEYY     XKDTRLYMKKH     PYCQOTHGGD      GOPNMTLSDSOT   
YSSIKTFKFKE     : UBJYMB          AMKDDVRXHIL     WTQMHFUQ        DXNXCAVPSSQ     VHSNIVG        
YFLLQTWY        : FYKTY           PHFN            DYYPHBCMBAT     EVTDREPLSXT     XDXTQETHXRUFVX  IBYRWRNDXVUF   
AIEJGIMASAAOV   : TSFJPPNHYLSX    DWXDV          
YPRJWDPXEXKPOG  : RVAAXEHAF       BDEIPAEEB       IJPVGPPK        TTSSJUVPJYMIBJ  NNOWGILHA       XBLSSLORDQY    
PEOAKYHTLH      : OVFFUMQJOEHCMJ  OYLWAVRU        MNMGOCPCKKL    
NJBJW           : AJAAIBLHUHJ     AVFRVFKAMR      WUKPLHJYNLJMJ   XQHE           
CONBTE          : JWQOASXIKVBVVA  GLPOPDVAGEP     DGKPVPUWCMRTVQ 
AEOPUUE         : PIOXHUIWKUX     CQFJOOSUUKUH    MXEXQYOJLGSI   
BTLM            : NSBCXC          UXCYLTKDKNQQYJ  GLOBRNDLJP      FYANA          
SGGCUVMWILBMCP  : BVSP            HXJIJVVIEJ     
YVRYA           : XMRIUE          BTXL            CQMOOLNQDCRXILK
PUDVHFPSRKNA    : YBJAGVQN        CBJEOFCPNG      WVPLFNPFVIYYAET DGKPVPUWCMRTVQ  MOUWCGY         OFSIXHCFODLGGF 
SURHT           : ERABSWHUHCDKIIG WHQYHUIB        QKPRVQYBTCUPR   YNDBABKJ        NGEDR          
SVMULCT         : TALPVOFBQEF     JHHGFPQJLQ      IRIVVJVVHCPNAC  SXUDN           BNIJXFXSPJEVRQG EYHGUBWQCO     
WTJDLEHHLMAHGM  : FDIUXFMOFCIQLQ  PUADY           QXFWDIUUU       EXQPBEQQXJUTVB  GNHG            TKSDEXTTO       PTKLIURFTUM     VQPSIJR        
WTJDLEHHLMAHGM  : JLMEVMLONSXW   
GGPDXWXA        : ECSRT           GVYVJSPINHT     UCTDXKYKSWY     JVBIENF         WJWYFUXPPSRLN  
TMLHQHONDATQGBB : YYSFAJOUNDHGJKN GGKNFJKGQAWC    RLCBVJWHEIEJ   
PBBVNYEVQ       : NSHJFKDCJ       LCVAAUR         FNHAKUROQVXVUSB DVJUTJARHHJ     YMAASOAIT      
TOHTEBIRICCYRFB : OAPKFR          BMNFFSYPHCROHUG RKXRFWLCDU     
WHOXCEBFCQGINX  : SCTFJNROFNP     SVBCDFAYXAWIK   UOMINWHXMR     
JMXEQCOLM       : RHKOMRV         JCUMPBPVMVBVMY  UVIBDKMEAEKWXE 
NOLUPWRXM       : SPYMYKBLTBHQEI  TWQBQAAFRRQ     WAPWK           LHNVWLYEITVG    PQHPYMCETM     
CSUHXMO         : FUFEFMKV        IQADWFQFEOJB   
CMWL            : ERXBYTN         XSUGLNQ         KNLANJEJXSITTDA
XRRCHFO         : VGIESVJUYVSP    ADFRFS         
SDLQVLITADXS    : NBRNQUXWQEI     GFVGFJV         XJCRLMLWHL     
FSOTAQI         : NSHJFKDCJ       BBKUVMGA        ENGH            PGBCPPRWW      
FJYWEB          : NRMYOADGASQH    GHOQJHCDICEJE   PJOVNQ          CYYGDW         
JSJFVWVTIGPILNE : OPTDKJGEEENREY  GQNKWMMEXOTM    NNOWGILHA      
TWDPYUBY        : PMUCPOHQTU      SSXJKXMBNWBFA   SDASPODFT       HIOLBCXUOEYXPFI SBYOXWLXQSOBHE 
KXYQAID         : BBKUVMGA        NJWAKOWOTGH     FQECITLM        VCRANNLAJWBXU   JTAKJQUKXHEK   
RKQOGNAODIDROR  : BDHUB           LGWQJUXKR       QROGSADUX       SLIQDPKXDKCHH  
OUDN            : PTUGRK          JMRINXUHT       YWHDGJUGUPOL    TMLSCF         
EMVRNVKPGNK     : NRMYOADGASQH    TNTYLP          HEUSGGEAWXLOWPW PQHPYMCETM     
XBQGOQXU        : LMFXPUXMQ       VGUYU           QTCDXNYGHTMLSH  KAGT           
BMQUAHRFVMMK    : SQKV            UCUHBQUPNOD     IGXAVE         
GXGQNMFAMDEE    : NERCGBMSFNCLP   BGIBFVAYOACR    RYDH            GBQAAWO         NCWKFVSFAQAJB  
SWKPYLCSIEAAK   : QVWDGPALUC      UPGRVGRSL      
MWJVDJCTARB     : IQGD            CTRMCFNAHKJCXH  PUMWKLBIE       BOYE            MJBEFDLKNAML    KFWSBCEPJO     
GHEKT           : XGCIPNAMMNIHW   ECBV            PYGO            YDOERMEDRXREJ  
KGPJRUECYFCJFP  : IFTCMT          TRUOPBPUBXSREM  EJDBDEEHHLWGAJ 
ONLB            : DFRGHLE         LXLGEA          LRHDQOE        
IBHJDQQKDMKNS   : JJHI            XNEYDNAXEUPQF   QOLAANELULSCDJM NJWAKOWOTGH     HQRHHLNWMAUJ    VFQXYCYFDUGOIF 
XMWEOWJ         : TXMDVHXEX       RGCTPBSB        TDII            KBQQLOXY       
IPJRGWDJON      : IVRIBOBPWJNU    RWCIN           BFDCLBS        
YXQPQDS         : AMKDDVRXHIL     CGKRBW          OPDPSEOIJTQJCHD CTPJSSXGVVVWNG 
NHBRHOPLFOXY    : JJOCAT          TWYGQWFKGP      VMUPX          
PIOXHUIWKUX     : AEOPUUE         DWJBOVBOKL      BBNEWUEBPJJ    
NNEQIKGPLY      : GIWOUHLJEHMK    KFWSBCEPJO     
CQLIFLHE        : FQGBITO         YAFJBTKXHIRVS   AWLUVKFNILLXLA  DLGXXCW         MFHA           
SVYCSJBDFYOSO   : VGUYU           TMLSCF         
MXFSPQ          : RSESJEOHSMWQD   MYMXWJM         INSLWIR        
PVID            : RUNKKBPXWSJ     LWOATRIENEBKP  
PONWRIS         : MXMPJKWDKR      XOPOBIGPY      
LNDM            : YLUNPUBAFXJAMD  XOBHGCSEKEJP    ITEQN           BLNGGFOFARS    
IOHDDAPBFJR     : BMNFSJXPPJC     XMRIUE         
DJUOMBEDQBWAV   : YNJSKYYQQTRGV  
NJSABDQIHULY    : PFKRLVUFNIIQGX  XEFULQJ         PJOVNQ          DPEVGRPXJDDO    RYBWPVDDYUMF   
SIPT            : BAEMJBBJDPHGA   HHELKOTSSGFUY   RGDFUNFETNAH    IKPLH          
BQBNRHSLLP      : QFFKLUUNYEFXDOQ OQXDUJ          BMXRKUFKNAY    
HIYRBBUFSFOP    : PEUFJ           JWIVXICQAYKIOCN OIVBLPHYVFS     ULWQDTFJFDWR   
NNOWGILHA       : NWXNPGXWMBYUSG  XNILWEGJI       JHHGFPQJLQ      YPRJWDPXEXKPOG  JSJFVWVTIGPILNE
XTVQF           : GRVADUU         SUUFTVJRGQTS    JCPXJRFPJ       YMEQERLPWRQ    
JSRR            : IQADWFQFEOJB    HPDPMFK        
LUVIAQPQGJFVXE  : QFWOLT          DUDXINFUNLXTEUF HVHLJNS        
IPKIGIFEBKO     : SBUCX          
EIEXTCVCEMR     : BAEMJBBJDPHGA  
UDBRDFTMWGUFOAJ : CONHKPVFJMDJSLY FOAVHW          VFQXYCYFDUGOIF 
NXFRGKRCMOGS    : AVGJCBMEPEF     FFTKMVCAJLFO    OFVFSHLNGCHEYI  SYBXRIKHROQ     MIWNQIAYANL     BGUFGOKSYMI    
BOYE            : WVTCAGHWHULEB   EEPAVERUYFJME   NRHPSJEDYNVQAB  EQDFRISJ        MWJVDJCTARB    
SKWOWVVT        : LWPCHQLHN       OEVFQJHAYLM     MNSPRPLK       
MWNFKN          : GJYGCETH        CIKKIORAYCN     WUKPLHJYNLJMJ  
EWXVYMKI        : MGWTEJHL        KOSGBWEXSOVL    XVRFBQVCWUG     CMIBPPRFDVXI   
QJUPPMKAMYWK    : JUBMCOSTAQ      YWMYWVPTUAMXG  
ROKOEPBRDFO     : MSCDKTUXP       GSRYYMESJY      JBTVDSAPKRUVDVC FCJSB           FGUFGPWHVPGCPP 
DQNQYVHI        : HLRMFPNMYD     
YAFJBTKXHIRVS   : EXQPBEQQXJUTVB  EYREOXNTE       CQLIFLHE        WUKPLHJYNLJMJ   YLYAQDCLT       NGNQXXWSKNSMOL  EIEMCAVPUL     
AKLTOQ          : CGJKJPQX        DRXSGPRA        JQJUYDCRS      
RWCIN           : YGVTGYACUCL     RJXBAEWEQX      OAPW            IJIBYSCGYDX     IPJRGWDJON     
EWNWVNC         : XPSKLBGIF       CJOQTYBQ        NGNNPMPSSTT     LKVXCVGLKFVLTUA
OYRPG           : HKXTKPF         EICKYE          FUNTHFSSRPIVCU  TAJDXK          PSTNJDICED     
HEUSGGEAWXLOWPW : TBHLTBHRVFI     EMVRNVKPGNK     AQMFNLN         QFTNYSK         AKDGALKSJJODOMJ
SBJGXFUDM       : VTMCYQR         SNWTFBFHUGCSKTV ISMFSQRVCEW     YRUEJBCRUT     
CEBKFL          : JQDDHRIMOXWPAVB OIVBLPHYVFS    
AEUIKWFKJUHBT   : GNASIIFFCCIP    FDBLULEFULUOTT  LDTPNDDVNTUDPI  YNDBABKJ        QKLI            OHIQOLUTO      
WXDFVIABWOFC    : IKPLH           DADRCPAGFRX     IGTFCTCEVEHUOED RXSNMDPCLY     
PJBGJHDUUBAHMWP : RTSNRDROIDXFHIV ERXBYTN        
RLKPPQNASR      : QUXQRCTELQYPCI  MOUWCGY         ANYGNCCUVAVAACD HTNEWFEHUT     
JWCAPLDVWNAR    : SAUGLEXIEE      DWGMDVHEOP      YQQUIBIRC      
BURPRHD         : VMPVTIKKHEF     YCJFFCHX        WKWPJEL         ARCMFYLVX       GPPQ            OTIW            LTFNCN          VOKYMGHY       
VQDLJTNELNOKP   : FSNSUOXPE       PAEYAX          FFTKMVCAJLFO    LFYQRVNFE      
ADVWBJYUTCPORKV : NQPLCVRFW       PGAALUFYDPB     NJTYTP          HNHJYGCWSYLCHCB LFYQRVNFE      
XTNEFYXVGJJU    : VVTDNWAVRO      BLNGGFOFARS    
ANWDJVG         : PIPVEKIIMDM     VQUARVEYGUVEV   JYXHRFK         RLUONNIG       
UEPYV           : CBFMISWDCYPXVQK SVLD            OWRF            LVUWRBRXXHOMBOD QEFCBL         
QIFPHYGLF       : HUPIWEWDX       GVTNYE          VOCXQCFY        EACRVNBFMYXTXKB JGPRAYA         HYVCOCECCPAUJ   CWCYTUAL       
LDNUMKQ         : FSNSUOXPE       EVTDREPLSXT     NOIBGMTMBXQFM   BJKN            NHBJBW          SIIBBACAPGUBHD  YPBGJPIHUG     
XPSKLBGIF       : VYXWHYUISMK     JYQIPUHEOJP     LJQLCQPUGHEW    EWNWVNC        
HCFAK           : YPWOHOJTIYV     LJQLCQPUGHEW    MQUG            TERKBECXLVXQ   
QTJWFQEST       : UYQRCVQVPI      LKVXCVGLKFVLTUA
NHDH            : HPJONNFTWBNVWF  QLGYYNULEYVLU   MMQCJBIDFJHJDOU PLOAHAOVBXJ    
EWQOLSUTASE     : PFKRLVUFNIIQGX  XCQCXJ          WHXWINJWL       NYBNLWGUODCLWH 
XEPKWLUTTLBMIVB : WBHBCIC         TQIEYQ         
YKNDJHRWC       : UXGCRFPVXOOBHH  DJMHK          
RCIVHICYTA      : VCQLAOSVMK      TXGHIKW         PPXCUVLPPXR    
QVEEYRMUU       : LQPRUUBY        BEMYS           YVSVCQIL        VMKCVRPUB      
UHUAQEU         : CEVMJSUO        ATGOIM         
GLIITGRFIQBKC   : YWHWQSI        
JGXIA           : NIGEN           FOVMHFKFBTKYHSV MGOEKKORGWHL   
EURBCOBVSXMYKUI : OXVGRYC         JVWO            GOPNMTLSDSOT    RXSNMDPCLY     
DANLTOY         : OVQTVGWCWMD     ECSRT           IBDCKYDDFI      OUTNCYVLV      
IIEHQFUUCMVFEA  : DXNXCAVPSSQ     JQPIYWWXJ      
WAPWK           : LHJNJUFV        NOLUPWRXM       GKTENXEKCFEXAB 
HTPJHDDYCBHKGQE : THAORHSJHNM     YREBRYBFXPKA    RHKOMRV         QKPMXKVPJIK     FQYTKG         
LBPBXUF         : YVSVCQIL        QAYHISWGFLA    
AEAPBNC         : KJPRGITLMJUC    TVJQUSCJWL      BMXRKUFKNAY    
HTUOXANACX      : FTPNKHONHFLK    MFPEBHIBVL     
KQRXFSPISNNUNT  : PQVMW           IYVQPGOT        DURYVIPXGUNXO  
EVLIGSDDJDGADKA : IWYMJIIINLQFADS UCTDXKYKSWY     ENRTFAGIA       IIACLYTLM      
UQMUVIKEDXTYMO  : OYAB            SSKGYDH         HESUUDWTDMIC   
SMKDUFGYOJHQ    : AJRLRJTMDV      LKHULQOICKL     JBTPIQFXMYX     LTFNCN          YUPXXJJSGYNI   
RQKMIXJGIT      : DNYRIPRVSPNFA   EXUNJT          PDKWVNGHXLOY    EIEMCAVPUL     
LUHMJ           : JEDVKR          QXFWDIUUU       KUPGYWPKTFLICL  BKYWP           EABYWSYGTW     
LEKVHGBQHSCO    : TKJDTJEHYRMQR   NBKYY           PSTNJDICED      OFSIXHCFODLGGF 
RGDFUNFETNAH    : BFOAYTEKVTIIYQD KQJQ            WHPOK           SIPT            UHIMKGKMOBKAPCS TERKBECXLVXQ    OUDLBYJJCKTW    UFFLLNVIGUO    
UPOGNA          : YRYUXCQDFDNFQ   RPJIWCDU        HKYKJ           BYGXCWU        
YYSFAJOUNDHGJKN : TMLHQHONDATQGBB MGMCPTKN        NCPDIIWUYSFSHWD
XSKTGM          : YLVDOTGPEV      LHNVWLYEITVG   
HIRVQHYC        : QXCWFBI         OYAB            ENGH           
XWNAICXV        : AMKDDVRXHIL     YFMSMKTNGMINH   MOKHDWQROBFMAPD DVHIMUCQOSE     VWIBNGITDHO    
FEQPRYPKJJSWLB  : TWYEJOIVESHPLP  SOJVGUBUIE      OEPEXRH         DGKPVPUWCMRTVQ 
FYANA           : VIUODPDAOAVQCC  EEMGLSGPGQAYWY  QEAOOWPYUPMPRK  LRUFHEHMLAK     BTLM           
VABKB           : VDHGWOUCCIKLCU  PAHLMY          YBORILCHIVBHP   NFIODUTXAQDQ   
MYIUGON         : WHQYHUIB        QTCDXNYGHTMLSH  HOFHJ          
HNNTYYNXNQHSR   : THQRLKFNC       NDRFIC         
ISMFSQRVCEW     : OPTDKJGEEENREY  ARCMFYLVX       SEPLYKC         SBJGXFUDM       DOPHAPBLWN      LKVXCVGLKFVLTUA
BDARBJH         : GNASIIFFCCIP    PGVP            EUNX            YGLDUJH         RELTONQWFPJQU   AMYFVBCH       
DGQSHELOWEYIY   : DSGLR           YBORILCHIVBHP  
NTFFQHLPUPTWHW  : HEGE            WHSSGUMNH       CLOJ            QMPXNIAEGA      XQHE            NDRFIC         
OOLWFFE         : GMNPEXKWH       YPWOHOJTIYV     WBHBCIC        
QVIWUQ          : JGPRAYA         HCNHMLPQ        BGUXJYJJRI     
JGQQ            : LDPMXMEOWDSPHJN KHAM            NSEWYTUMRIF     IQPVMLROTKBYBV  GXSBLOPEFKBXRBF
JYCYTRSQBQ      : MBBDSGSDCPP     XIPDDDRSKFOSEMB UPLYKJNCAL     
RHKOMRV         : JMXEQCOLM       HTPJHDDYCBHKGQE SCQDPUX         ADDDXNINPH      TVJQUSCJWL     
JRGIOAFBGVR     : KGRGURABR       CKFEISDBFDCK    MQCTER          JVBIENF         BDQEEBWG       
HSYGOQCFTUGLCRC : EUNX            STWSXOQYWEQBV   UPGRVGRSL      
JXMURSEJULMC    : FRAUYLIP        MXMPJKWDKR      UAVLODXNNL     
GBQAAWO         : AXVTURNKBSHU    YVSHVKEH        GXGQNMFAMDEE    SRBEQ          
YWMVDAXUCOHDDCW : QEAOOWPYUPMPRK  PAEYAX          RCVIHUIMFXWVB   UCTDXKYKSWY     MCBN           
IITTUXDCYTEYTS  : RAQDCOBWLUKX    CAYFDV         
UPGRVGRSL       : XVWEPYBVL       SWKPYLCSIEAAK   HSYGOQCFTUGLCRC CEVMJSUO       
AQMFNLN         : RVKGWWEKUPBU    MQCTER          JYXHRFK         HEUSGGEAWXLOWPW
GKTENXEKCFEXAB  : XRUO            XPJJTONQL       EGUWPIS         WAPWK           AINRXQJ         WAWUNRL         OPHAWPMNWVL     EOKARVBGSRS    
GSLPNFDWFTJ     : BPGXSQUPLHSFR   HQTTROT         MNHJJRAXCLRAD  
JVBIENF         : OLBKXKYS        YWILUKJPT       GGPDXWXA        JRGIOAFBGVR     PYGO            BGUXJYJJRI      YWMYWVPTUAMXG   KFUB           
BFONKUTIUVXDQM  : UBJYMB          FSMQWRSQKIRHII  UVSRCXXU        BKYRVCAQNVF     JEHP            LDFRABFNPBWL   
ERXBYTN         : DLVWRHVLRGNJKC  JVALUCW         EWHW            AVKFUETCOTQBI   CMWL            PJBGJHDUUBAHMWP SLXWXBFURTF     NCPDIIWUYSFSHWD
GLPOPDVAGEP     : RLUONNIG        XANPAPSSGQDY    RVQMDLTEIO      CONBTE          HPWYGVW        
OMOWJKWOEJKI    : JMWREYB         FEQRYNUMNWTTWLV YKWCBQWMQN      IYVSAVMCDYLFMGM BMXRKUFKNAY    
KMDFARNNHCDMBD  : RYMREUQY        BGQXVKYOJVKPV   HYLYPPGTSTU    
FUNTHFSSRPIVCU  : TYEQALJHWY      JWSUMWMHGQYL    OYRPG           WANJBUDUANYV    QBUBHKC        
FFTKMVCAJLFO    : FDRROLSE        IILJK           GKVVTIS         NXFRGKRCMOGS    VQDLJTNELNOKP   SRBEQ           UQNRYLMQKOXPCM 
ITTNPJJYOESJV   : NRMYOADGASQH   
HXXOGDK         : HDDPUORFOCGHDUD YJERTLXFPOGYC   WVDKQVMXUFNG    BIPCOWHD        BNFXSSV         ECCLAAK         BOTQWRMYCGBO   
SIVSRJAIII      : WSSJRLQROSVC    LFWQKJNL        TUGCVTJSBV      OUTNCYVLV       YWSLMUSXICKUBR  AELKI          
EXUNJT          : RQKMIXJGIT      BMCLNPSAMWYVG  
NMOKRVIPLOVX    : RSBFWSPKKRA    
OHGJBPKKAUP     : CGKRBW          XRUO            HQTTROT        
TKSDEXTTO       : SNWTFBFHUGCSKTV UMKJATN         WTJDLEHHLMAHGM  WXQEEGXF        HGTBV          
LKOCXGXWOOEUXHM : TTSSJUVPJYMIBJ  AACYCXSJCVUSN  
RNIHRERKJYK     : GSDJLUMMA       LFYQRVNFE       JQSCUFBYLEMMFM 
UYHGMWKKDKJTYPQ : GELLFVM         VQUARVEYGUVEV  
XDMPQWA         : WVDKQVMXUFNG    ISLIAXWKHYPFCR  JYXHRFK         OEPEXRH         SSXJKXMBNWBFA   GPSJTXWRBKEGA   ITEQN           QDLKBVEBYCSFHRC
BTXL            : YVRYA           FEQRYNUMNWTTWLV
JQPIYWWXJ       : OAPKFR          SBBTVDKO        JOSIDR          NWQJXYDY        IIEHQFUUCMVFEA  HCTNVSO        
DURYVIPXGUNXO   : XMRIUE          PDPTERIVTHWB    KQRXFSPISNNUNT  YAGQHGELJBQT    UHIMKGKMOBKAPCS
AAOUXCPJ        : IYBI            HGGIEGXWI       RVQMDLTEIO      FFJAXUPBESVE   
GUTFRR          : DEJCMXMFIS     
AWLUVKFNILLXLA  : AUCDPUMEKHGMF   SPYMYKBLTBHQEI  CQLIFLHE        FJMXEBIXKQGWEM 
MCAJCCBMUJHPOYJ : VWVVG           IBYRWRNDXVUF    KUHPRGDSHXJJ   
AHRWFECVN       : FGTQXBY         VOQBOGPIVAN    
HNBJYPL         : PGMYDMISFOIQ    ECSRT           YDUOQAA         HDDEMWPJ        IJRRC           JHHGFPQJLQ      QKPRVQYBTCUPR   HGYOBS         
YNDBABKJ        : OCTVGCTV        IWYMJIIINLQFADS YXWJTPRUOKFI    SURHT           AEUIKWFKJUHBT  
CJCIL           : IFECR          
CIRJKPWAWM      : VVTDNWAVRO      FMFVGTVLBSYS    WNWEPN          QJMCJPBKNPFJPMO
GMTTN           : CQFMBKWMWJ      PCWHNDHADGAXCYQ AFFVSXYDFYRP    LWPCHQLHN      
JRVMSJVL        : IVRIBOBPWJNU    YBJAGVQN        VCQLAOSVMK      MBBDSGSDCPP    
FNXSACBTLNLKPIX : BOINNXXIIWKYP   IHCXFX          YKWCBQWMQN      NNGUPFNCS       FGUFGPWHVPGCPP 
QKPMXKVPJIK     : MOOPVKP         KJDAYIXK        SOJVGUBUIE      IEQCBCBRGJ      HTPJHDDYCBHKGQE DVWE            GPSJTXWRBKEGA  
FVIMKG          : YBJAGVQN        SJIGSAJLYP      ODAS            KSPXVYR         FEXHTQHXSSC     IKTEHH          VOKYMGHY       
MIHIUXTFNEF     : RAQDCOBWLUKX    FVKQDJPRIYMVIIE RVHDGGSKPFAQ    FDLS            WXTBXBDJWE     
URBHQOFIX       : BDWJHBDOKQKJF   IJRRC           UQXKCVPKJCSFH   GFVGFJV         UWDAXS          KUQHJLNF       
TSTRD           : OTEHBLCSDHY     QOLAANELULSCDJM TTLVDFWN        RMAHTOT         LBHXXGLU       
CJOQTYBQ        : EWNWVNC         NXHKE          
UWMBEYVW        : NPUSXUPBRXJ     ROHJYWLSTNYFC   OUVDNKJFTMFP    CIKKIORAYCN     MVTJTF          GQEGBBCNVDKK    ERUANSYBALEICC  VHMRPOOJFY     
UWMBEYVW        : RNSM           
FPOL            : BWCOAOE         LGLN            MFVTRIYNWSQ     MIWNQIAYANL     HWKKYHIKDPKGVC 
MCTHX           : GKAKMLS         IXQYMVMVNPNRTD  QXFWDIUUU       MNHJJRAXCLRAD  
MGQVVKQULHT     : APBEPWBUH       JYQIPUHEOJP     SVOWORSCS       JBJV            CMIBPPRFDVXI   
GGKNFJKGQAWC    : OTEHBLCSDHY     PKWNNOI         TNEEE           TMLHQHONDATQGBB IYAPPLAP       
MGWTEJHL        : KMIHTIMBDL      WNHRMIF         DAKKEJ          EWXVYMKI        KNYKIFYLMF      YUKJFNFVN      
FJMXEBIXKQGWEM  : AWLUVKFNILLXLA  YHUWXLXACWX     QXXTSMQJ       
QUXQRCTELQYPCI  : RLKPPQNASR      BNBH            FGUFGPWHVPGCPP 
EPMTQQWYQJ      : BBDQKTY         ENGH            JQDDHRIMOXWPAVB
XGYMPPHPJYT     : NBTOM           YWHWQSI         TPRDUFUUTLDSFGF LNVAJ           DADRCPAGFRX     YWNWFV         
EFVFXXPB        : YPWOHOJTIYV     UFFLLNVIGUO     KSENBYFTBYU    
FOAVHW          : LECASSMJ        LCVAAUR         MTHXXIVMFCRCILC UDBRDFTMWGUFOAJ DOPHAPBLWN     
BIPYRONJGUY     : NBKYY           FMHHSTWJXMEHFG  DAGNRBNGAG      EYTN           
TUUXDQDBOSEVBSV : RFABIIGTHVXLQX  NYVNOWRMWO      SHREKKBXUGLQGP  OFVFSHLNGCHEYI  PLOAHAOVBXJ    
DVWE            : HPGVHHRWNBWMV   QKPMXKVPJIK     MFPEBHIBVL     
OFVFSHLNGCHEYI  : JWVFUIXT        KJJPWVNSUGT     THAORHSJHNM     XILYC           NXFRGKRCMOGS    TUUXDQDBOSEVBSV MOUWCGY        
QLKH            : CQDUFCXQHK      TQBQASUM        DPEVGRPXJDDO   
ODIKAHNVER      : VTMCYQR         HDELWYKCK       FFJAXUPBESVE   
SYBXRIKHROQ     : QLGYYNULEYVLU   LTDFGAVOIKUY    TTYRPKBBUAKV    EYREOXNTE       NXFRGKRCMOGS    IBYRWRNDXVUF    YBNMG          
NYFGLPO         : KUWVWFADUJQNRI  WFRQODVXFSH     SESIODCHCAOWH   ADRHFTMQACYQ    VABWYOMMEKRKIS 
GRDQRKEPPXSKWT  : OUVDNKJFTMFP    HQTTROT        
QCVXTKRRAQWHEOX : LVUWRBRXXHOMBOD VTJWDCBSG      
XPCOKPVAFVURVQ  : DYJAWASVXSOPI   DKTNTX         
OTWPP           : BNBIQPSWOXLNYMD
HKMXHVDYTC      : CGJKJPQX        WHSSGUMNH       BJKN            NCWKFVSFAQAJB  
LHNVWLYEITVG    : NOLUPWRXM       XSKTGM         
AUHYKYL         : KGRGURABR      
JXSTVXSPCRDJHA  : DYQUPGEOTYPARL  PPVQXECXSUEM    AXSFQN          DVJUTJARHHJ    
TYOEULKINHPMURA : XLACSFACUFOHKC  TVBOSDSF        UJHWHLBRBH     
BXJUVHPNKJRV    : AMKDDVRXHIL     HCEHJUCKVVB     FOUAJB         
RFLSTRP         : GRHSRJMLYQLUX   IXUOYXPCQLUF    NYYVNAF        
CYWLQMGIM       : QMPOVVKMSO      XCGQ           
MNHJJRAXCLRAD   : MAEF            BNUN            GSLPNFDWFTJ     MCTHX           KBPUEGQFEC      IIACLYTLM      
FQECITLM        : IEDDYGAUMJ      BLCNPVAFF       COJWMFVRIBMTSC  KMQXHTFBPKJ     KXYQAID        
JBMXJUKHJXR     : RAKQFPUCQVT     UCXPLDLACY      NWQJXYDY        OTIW           
KJTKNFCNL       : OAHOWHQJILA     LIDMTXCI        TAYUDLDX        NOMFODQHWAWGNYN KNVT            UIDGYDFKKNFRU  
VCRANNLAJWBXU   : JNJKJWG         KXYQAID         BAFPN           WSCDWYIQKVTDQ  
UIUFIO          : YNYBEMA         NOIBGMTMBXQFM   WQNTGBLXL       ETQJ           
SXUDN           : IJPVGPPK        EMELTL          SVMULCT         YQGUTNILLAI     BSCHFVTFQU      BUBKNGLIVLIF   
HENUASMC        : JTBPNOW         NSEWYTUMRIF     GQNKWMMEXOTM   
DPIONMMK        : HQDFILOD        PDPTERIVTHWB    XQDUXGXDXGXOE  
HUUO            : WKPPRTW         IQADWFQFEOJB    JFOVKOF        
KNYKIFYLMF      : RCVIHUIMFXWVB   MGWTEJHL        VBHBHLTKEU      RJSWNTAW       
IFRWJA          : UXWSQICN        FOUAJB          MKGWW          
YJQOV           : QVWDGPALUC      MQCTER          BJKN            ADDDXNINPH     
CVNWSC          : KSGMU           BAFPN           GAAHAHAPVHJBXC  NKLBAT          TQIEYQ         
DSDQBKPMY       : NJTYTP          JBTDADNJBRCMTQH FVKQDJPRIYMVIIE SVVDYAMO        XLCKGHXCTKCRISL
OJCIHLJJMSDCQGE : EJSFUL          NKLBAT         
VBHBHLTKEU      : WEJLCVHWLC      CPQVGSQ         PQGUY           KNYKIFYLMF      AWXIVEACEPR    
VKVQBGUJPIUYUP  : NIGEN           DINKRM         
YGLDUJH         : BDARBJH         JYRLWFUIVASK    OULROS         
KOSGBWEXSOVL    : MGQJCATHRRISKHE DXNXCAVPSSQ     SQVBHCB         EWXVYMKI        XUFQYJNSEELYAPF
CIDRQBTNQXPA    : VDHGWOUCCIKLCU  FOME            SEPLYKC         IWJQMYWCMPQD   
SWVA            : URQIVB          RAKQFPUCQVT     WXNYEXAUXMS     HYULKELXGB      DRXSGPRA       
IQUP            : DKTNTX          KPNNPXYB       
TTPMKMXE        : LNNRHHKHSUFIWU  WOTAHFIMAUP     VSWEDDU        
GHLYIHPCHFCTA   : QXCWFBI         LHTHQRDIAAEDYLS
RDECTBRMVNEK    : FYKTY           PSMWWPIBUHJHKF  KJXWQAXQWCIT    NRJHQMBUISMGRSE MEUAPW          QJRUFTSF       
SJEKROXT        : CSAR            JCVVE           QOLAANELULSCDJM
FLBMQFIQHCTNFQQ : PFHM            AFUAAMJFDRDAI   AVKFUETCOTQBI   NTOOXYM        
DOPHAPBLWN      : MWGFXPRXMENRUPN XCQCXJ          ISMFSQRVCEW     FOAVHW         
LLYKQMOFDTOWD   : VDHGWOUCCIKLCU  SQKV            TRUOPBPUBXSREM 
SSXJKXMBNWBFA   : MGUPDC          TWDPYUBY        XDMPQWA         FEXHTQHXSSC    
CNWPYXBRLRW     : UPLD            JBPDFSFHEYHGRL  YRHUJT         
LNNRHHKHSUFIWU  : KDSPR           NRMYOADGASQH    JBTPIQFXMYX     AHATQOCLEFYF    VEILKEWSOJD     TTPMKMXE        EBADFWQ        
ADFRFS          : CIKKIORAYCN     XRRCHFO         JCUMPBPVMVBVMY 
VTMYLAQKP       : MOKHDWQROBFMAPD DNSPUABBBWN     THQRLKFNC       HIFUYAB         NLLXFJQTNSHBSJF FIAQEAYFJFXAPW 
BFVIOHPI        : ODIFDTSDJYBEDBT OPTDKJGEEENREY  RYIJ            ETQJ           
XQDUXGXDXGXOE   : DPIONMMK        JGJX           
DFFEXRVC        : YCEBLDQDTCF     EJSFUL          TBHLTBHRVFI    
BBDQKTY         : TALPVOFBQEF     EPMTQQWYQJ      MNSPRPLK        UQTIILKR        KFUHXVYXVI      GHAOLFYXJCDV   
TRUOPBPUBXSREM  : CVQL            HLRUKB          THIPQ           KGPJRUECYFCJFP  LLYKQMOFDTOWD   IWHN           
JTYHLULHWM      : XQYARSYYPHES    KHAM            HGGIEGXWI      
PYGO            : PGMYDMISFOIQ    ATMTYKKI        GHEKT           JVBIENF         RIBFOMLTY       KBQQLOXY       
AINRXQJ         : KJDAYIXK        QMPOVVKMSO      GKTENXEKCFEXAB  HOFHJ           KSXGITBWS       VJTIWATHYF      UFFLLNVIGUO    
RHNJLCGWVGEJB   : YBJAGVQN        NNFLGROHRQMYR   VQDQP          
QAHEPGKG        : BBXHFAKEOEU     YYHWUSLPLKBP    NNGUPFNCS      
NOMFODQHWAWGNYN : XLMEQ           MXMPJKWDKR      KJTKNFCNL       TEJCEIWGGMIKLU 
WVQJYIAARGRB    : SJQDMFUUTTAHC   JUNFPB          DAKKEJ          JIYPCHMPYS      DKCNDNAUQQ      JGJX           
BAFPN           : DYYPHBCMBAT     JESNWETNII      VCRANNLAJWBXU   CVNWSC          XSUGLNQ        
HSFOQFO         : LMWQAALFFMLSFAR GAIDQGVKC       CVQL            RLCBVJWHEIEJ   
SNODNKVW        : NKXDKDUFCB      MOLTPEQRY       VIEVEJHWDJPAIN  QJTYCMNK       
GYMY            : XWKMWXOYRW      OXRUODNORYBHO   VQPSIJR        
GAAHAHAPVHJBXC  : FGQBBM          CVNWSC          UFFLLNVIGUO    
MBBDSGSDCPP     : MNQFK           NUQUJTUEGOG     EWGOVDHITTU     VWRTWTGIY       JYCYTRSQBQ      JRVMSJVL        SFNPYQTEDMGJRK  QBUBHKC        
QEHWLJYU        : SPYMYKBLTBHQEI  OAPW            LMXOPUMXMEOJSDW EBSCISAJQWUDI   RIBFOMLTY      
GUCCENFDRN      : LQPRUUBY        BQIRSMUD        AHATQOCLEFYF    UJTIHJDFHUNINLN
TQUMWNRBFK      : RQWJHLGJTQFSAY  KJDAYIXK        ADRHFTMQACYQ    YJXTWLOJCAKY    VMKCVRPUB      
WOTVCGVXSE      : JFEIGNTSU      
WJANODFF        : IBDCKYDDFI      AXVTURNKBSHU    VQSPWIBRJXJYSXV LIJSI          
BVSP            : UOEHIVQAEIJXNA  BRXNQ           SGGCUVMWILBMCP 
GIWOUHLJEHMK    : ABPLPM          CPNQPCLISD      YLVDOTGPEV      NNEQIKGPLY      UKLMUS          CYYGDW         
KFKFCTFPIKVPIW  : FOLH            VIUODPDAOAVQCC  TNTYLP          HUQSIUVXC      
BNIJXFXSPJEVRQG : MECREITS        NSHJFKDCJ       FSHUBQRFDMWA    SVMULCT         JFOVKOF        
DNHLPBSGME      : XVWEPYBVL       XSUGLNQ        
CMBQNQYWQHV     : NERCGBMSFNCLP   HDJNGYGAU      
WHQSBJB         : UUUJYIYEPQAD   
NOIBGMTMBXQFM   : GNASIIFFCCIP    NGTKOBKFVITAV   LDNUMKQ         UIUFIO          BGUFGOKSYMI     NGNNPMPSSTT    
WCLXCFFXQCHJ    : JERFXLVHVWEJPA  TRPUTKMELCX     SIWFPOFA        KXVDHFD        
JTAKJQUKXHEK    : WVTCAGHWHULEB   DEJCMXMFIS      BFOAYTEKVTIIYQD LMCFFXIO        KXYQAID         TMLSCF         
FEQRYNUMNWTTWLV : IXFYUSJLD       RGCTPBSB        OMOWJKWOEJKI    BTXL            GFYXVBCQ       
WVPQVCAPXKNHRA  : XHWASGEUOWNSQXG NERCGBMSFNCLP   XMRIUE          IJIBYSCGYDX     EDFETSOSLNF     LBHXXGLU        IDNY           
WELQFBLUOKOIJC  : PGMYDMISFOIQ    RLVIPUTPOAPQJ   NQPLCVRFW       NWQJXYDY       
QCFISBL         : PXBNRORJ       
SJIGSAJLYP      : AYTBJSFCLGF     FVIMKG          TYILMCJMNKNCRMY
QVAESRPJABOJRQ  : EKOAODBUBQITHO  WWNBFB          XRHTWDQKONMY    YRHUJT         
DLSOHLA         : PFHM            YJERTLXFPOGYC   GDJOVVMR        WANJBUDUANYV   
SSUCHURGNPJRKBJ : GFTWIRCMCTISG   FGDKMB          DRPGRX         
DLLNFCCIPUYA    : GOPNMTLSDSOT    CTPJSSXGVVVWNG 
YSCSNECKXIXQ    : KJXWQAXQWCIT    BBKUVMGA        HPAQCPEKCTRG    UYFPWMEUDXUDJ  
SBUCX           : LDPMXMEOWDSPHJN OWCGITYHT       DFRGHLE         LWOATRIENEBKP   IPKIGIFEBKO     LBHXXGLU        NHBJBW          KFUHXVYXVI     
PJOVNQ          : UKHPRBOBHADUYGB JNJKJWG         TLFHKQDSMR      FJYWEB          NJSABDQIHULY    PDKWVNGHXLOY    GTYMEYBPHDPSFS 
GMGG            : TQBQASUM        IEKDFDH         MVIFAWHYED     
HYVCOCECCPAUJ   : QIFPHYGLF       WHXWINJWL       MGMCPTKN       
WHXWINJWL       : EXTDOVTYHYXR    SVBCDFAYXAWIK   WYFJC           EWQOLSUTASE     HYVCOCECCPAUJ   CLMVWPGCYTUEQCG
NUFCDLXKMTPEXT  : DFRGHLE         JWSUMWMHGQYL    KIUDR           VWCTSFDBIQPIIMX
DLGXXCW         : CQLIFLHE        SRBEQ          
CUPRGOEF        : PFKRLVUFNIIQGX  QOVAGBK         XUUIOXW         RGCTPBSB        KNVT            ONFYCK         
BLHEYFQM        : HGGIEGXWI      
IQADWFQFEOJB    : MWSGXCAELLNYND  TXMDVHXEX       CSUHXMO         JSRR            HUUO           
LXLGEA          : TKJDTJEHYRMQR   NDVEAWPWEXD     ONLB            RKXRFWLCDU      ECCLAAK         KWMESLSNM      
KFNXMRW         : RFABIIGTHVXLQX  JFIQKYESODPEG   EHFMSDKVJKWXU   RKXRFWLCDU     
KLTTCWYBCPJIFU  : DNYRIPRVSPNFA   RHHQLRMEKWAIW   MKGWW           GSRYYMESJY      LXLKLR         
BJKN            : YFMSMKTNGMINH   LDNUMKQ         HKMXHVDYTC      YJQOV           MOIECMT         NNGUPFNCS      
PPACUPCHHYCTNXP : FTLYDERNKX      DIPKPAV         XXIOWTFO        KIUDR          
WOTAHFIMAUP     : QFDHHYFOBBKRNGG UYQRCVQVPI      TKYSLMW         TTPMKMXE        CTUQ            YUKJFNFVN      
GFYXVBCQ        : URQIVB          OWCGITYHT       MGKBOVASCL      FEQRYNUMNWTTWLV
EBADFWQ         : PBWFTMHGWA      TUGCVTJSBV      LNNRHHKHSUFIWU  NINGDNKUQUIOFH 
MJBEFDLKNAML    : MWJVDJCTARB     NINGDNKUQUIOFH 
WRXXRTCTMSX     : KQJQ            WMQT            SLIQDPKXDKCHH  
VDUSWBHI        : DCRQMAVAO       JODVTBB         ONFMUHY        
NNHYAWBMITL     : QJKJYJLHUWFN    WSCDWYIQKVTDQ   AVHN            QBUBHKC        
RKTLMNAHNOF     : GKVVTIS         AFUAAMJFDRDAI   RHHQLRMEKWAIW   JFEIGNTSU      
LAOM            : DWVMRDX         XTFBU           IDUIIFYMMWKXTR  SQVBHCB         HHELKOTSSGFUY   JGPRAYA         QUSNGCIVVH      WXTBXBDJWE     
LAOM            : EBUKEMAYEK     
WQVMAXOABBI     : JRLRRVWJCSTHWGN ACDCX           PTUGRK          RIAKLJBMJTS     TVWKVVNQPPLSCVY RNNUUQMYQ      
PLOAHAOVBXJ     : GVTNYE          DYJAWASVXSOPI   WNHRMIF         CEWPUSB         NHDH            TUUXDQDBOSEVBSV VTJWDCBSG      
EDFETSOSLNF     : LECASSMJ        WVPQVCAPXKNHRA 
NTOOXYM         : JBTDADNJBRCMTQH FLBMQFIQHCTNFQQ CLMVWPGCYTUEQCG UIDGYDFKKNFRU  
KBPUEGQFEC      : PWLMIHEAS       HUFWAF          MNHJJRAXCLRAD   RAKHUXBPTHTAR   YUPXXJJSGYNI   
KIERC           : BGIBFVAYOACR   
GVNVDCJXSYXRLN  : DORTJDKFCBXXJB 
ODAS            : FVIMKG          TYYAEKBECGQNYX  IGXAVE          JEVOADYXBEJP   
SXPWYDFGUK      : MGQJCATHRRISKHE HQTTROT         LNVAJ           DEEJ           
BGUXJYJJRI      : WMTIDNVT        JMWREYB         IASDTJFF        QVIWUQ          JVBIENF         RELTONQWFPJQU   KFUB           
MVWRNCRGNKHGJG  : SSPQROJVXJSXWIW FQGBITO        
POEAWHIT        : NAHXUNAIVHT     PXIWT           HPDPMFK         RFUPACBLRE     
TTREL           : BQYJLWBVJ       OXVGRYC         TMHJVKNIMNFRJ   OQXKXHSD       
PXBNRORJ        : PUMWKLBIE       YPWOHOJTIYV     QCFISBL         DKCNDNAUQQ     
GVCOGLXXAEAYL   : SVEE            NDHNTOVLEYY     PODXQPVYBB      NHBJBW          AMYFVBCH       
TTCNNI          : NBMOKILQI       RTSNRDROIDXFHIV PCWHNDHADGAXCYQ YWNWFV         
PYCQOTHGGD      : DMOLUHBPC       KCBHIHJKBRETENU GABIHHVCCRK     MXEXQYOJLGSI   
EHFMSDKVJKWXU   : LKCHVXUBP       KFNXMRW        
TXGHIKW         : RCIVHICYTA     
OQXKXHSD        : PWGHALHCAFRS    MAEF            BRXNQ           TTREL          
XLCKGHXCTKCRISL : BVAU            XHFHMEGQA       DSDQBKPMY      
CSQORYDIYNJG    : XTYQQNGO        GGDOUDRWFLSEIVT JAFGJNLI        AJAAIBLHUHJ     KXVDHFD        
MFHA            : JMRINXUHT       CQLIFLHE       
THQRLKFNC       : DKTNTX          XXGQMDVDLXYFPFV HNNTYYNXNQHSR   VTMYLAQKP       VKDWQ          
JPVL            : NIGEN           ANMEATDLP       RMAHTOT        
MCBN            : YWMVDAXUCOHDDCW BEYUALLWGN     
LNUWTEM         : TJXSTWOF        WANJBUDUANYV    ONFMUHY        
NMIITCCGOJTRW   : EXTDOVTYHYXR    PCTHKXXCJM     
HUQSIUVXC       : SAUGLEXIEE      KFKFCTFPIKVPIW  NXJFW           OUKTOPHJGX     
NXHKE           : NERCGBMSFNCLP   PAHLMY          CJOQTYBQ        OUDLBYJJCKTW   
LUIUDDYHL       : QUSNGCIVVH      GPPQ            YVNKKHKG       
RHHQLRMEKWAIW   : HOCYY           KLTTCWYBCPJIFU  RKTLMNAHNOF     LJLSMN          SVGFEJPJACG    
RLCBVJWHEIEJ    : TMLHQHONDATQGBB HSFOQFO        
FQYTKG          : HTPJHDDYCBHKGQE
CTUQ            : PUADY           FSMQWRSQKIRHII  CUMY            GDDRAI          SQVBHCB         WOTAHFIMAUP    
HPDPMFK         : JSRR            POEAWHIT        ADRHFTMQACYQ   
KNVT            : IUGKLLCTOHJJYB  KJTKNFCNL       CUPRGOEF        LOWTYSEEU       USCDTNQODJQ     AXLPHT         
GAVKJJQC        : OYAB            FJUTDDACJ       JUAJPULTRS      VSWEDDU        
MNSPRPLK        : ROCWJWSGXAIT    DIOH            SKWOWVVT        BBDQKTY        
UAVLODXNNL      : QHBIVHSXI       YWILUKJPT       DNYRIPRVSPNFA   JXMURSEJULMC    JAYGHNQGOEPRB   ADRHFTMQACYQ   
JYRLWFUIVASK    : IEOTXWPDXORAJ   LWPCHQLHN       SKQVLCQ         YGLDUJH         AORNVVNHYCECSQP PCKHNKMNHETBNRU
OAHGNRYJ        : PGAALUFYDPB     YTIBYUXIKE      VWRTWTGIY      
UWGXUVOGKAICMF  : QFWOLT          WKLE            YHUWXLXACWX    
HOFHJ           : WHQYHUIB        MYIUGON         AINRXQJ         TVJQUSCJWL     
WXQEEGXF        : TKSDEXTTO       VCUFH           DUKO           
RAMYBH          : RTSNRDROIDXFHIV DLVWRHVLRGNJKC  WLBEKWWWICJVH   WQNTGBLXL       JCEEGDWHBPQIMYH JEMYFYFFBD     
PQHPYMCETM      : VIEVEJHWDJPAIN  NOLUPWRXM       EMVRNVKPGNK    
AVFRVFKAMR      : JSLTK           NJBJW           KCAJCLHDN      
RJSSWR          : FOLH            IEQCBCBRGJ     
GRLYBDXNIF      : WKLE            ARCMFYLVX      
WCKSHEONPRAJ    : CBJEOFCPNG      EJCFYDUCNFPHCQV OIQPJIPVQNUTDO  BNBH            EIVFVLLEQCJ    
TSLORGKBXXABCB  : GNHG            KAGT           
MIAJKM          : EJSFUL          VQTXHJMWPDQR    YDOERMEDRXREJ  
UQTIILKR        : UCPJCVXA        EJSFUL          BBDQKTY         WXRCLNAORAK    
ENRTFAGIA       : EVLIGSDDJDGADKA
LCJMRVWRHHGLEWF : NLLXFJQTNSHBSJF SVOWORSCS       EBXXGHDMRCSY    NWHOLMAYCVY    
ISYCYGPTCXTIGU  : QVIQGW          HWKKYHIKDPKGVC 
TWYGQWFKGP      : SSARAYWXAJ      IEVKQMTEJN      NHBRHOPLFOXY    HGTBV           HPBEBPEAP      
STPAJ           : CRAWGTWF       
VKDWQ           : IRGVXSGF        EQASBJOLAY      THQRLKFNC      
QUSNGCIVVH      : OQFNPUPMUB      MUMMPKROJ       JOKGXVWDYR      LAOM            LUIUDDYHL      
FXWK            : NQVSP           CPQVGSQ         WEXXA           MEYGFOY         JBPDFSFHEYHGRL  AORNVVNHYCECSQP
EABYWSYGTW      : OPTDKJGEEENREY  GPPDLTYHTG      LUHMJ          
WUKPLHJYNLJMJ   : GWCOXYL         NJBJW           MWNFKN          YAFJBTKXHIRVS  
MOSJADPCGOY     : BIPCOWHD        OIQPJIPVQNUTDO  KXVDHFD         QEFCBL         
QFTNYSK         : YYKCNFULIYFCDEQ NSMCI           YCJEYAAXNRYDRE  HEUSGGEAWXLOWPW IEANJKLDXL     
KWSVXHJK        : DVYYEVK         ADNRHPSOCAOCQL  MBVUCUIW        HWKKYHIKDPKGVC 
TDII            : RAKQFPUCQVT     UCUHBQUPNOD     XMWEOWJ         NYBNLWGUODCLWH 
RIAKLJBMJTS     : BEROUO          EKOAODBUBQITHO  XAWV            CFJMVJKPLUCIN   WQVMAXOABBI    
ITXUFKRXHSF     : HEGE            VDRIGNQYCA      UKLMUS         
FDKILTHGEKQR    : WGGNHXYVFYLDXBT
RFFM            : KHRJC           UXGCRFPVXOOBHH  IJPVGPPK        WFRQODVXFSH     MQUG           
KWTKRYUMYCHH    : XTYQQNGO        KYWCUHTNVAEJV   CGFNPWLQIYTD   
MKGWW           : AUCDPUMEKHGMF   GVTNYE          LEXDVVKQMFYEO   AHATQOCLEFYF    FOUAJB          UWDAXS          YAQWCRPQJNES    IFRWJA         
MKGWW           : KLTTCWYBCPJIFU  ECKVYFARTPIGFY 
FDHPVYL         : EUBARSXVV       YJMYKGLY        SNWTFBFHUGCSKTV
GQEGBBCNVDKK    : WYICGFMNERH     XCDKYSLT        UWMBEYVW       
PTKLIURFTUM     : JMKPNPGEHN      WTJDLEHHLMAHGM  MBPFUONUFAVE    IVIU            VYIRAMEPWFS    
CEUDPL          : MHDGEFGCJ       FTLYDERNKX      EBUKEMAYEK     
GPSJTXWRBKEGA   : VFSA            UMKJATN         XDMPQWA         QKPMXKVPJIK    
SLIQDPKXDKCHH   : EMELTL          XPRK            RYIJ            WMQT            IQPVMLROTKBYBV  PXIWT           MXMPJKWDKR      RKQOGNAODIDROR 
SLIQDPKXDKCHH   : WRXXRTCTMSX     GDJOVVMR       
XSUGLNQ         : DINKRM          CMWL            BAFPN           DNHLPBSGME      WSCDWYIQKVTDQ   TKVELAXHQ      
LPYP            : HSDME           IISHJKFNOWNEP   HCTNVSO        
FVAFRN          : VHSNIVG        
IRFS            : CDREYK          CQDUFCXQHK      QFFKLUUNYEFXDOQ NGUOHXCYGQRCP  
IFWSNFSIAYT     : XDXTQETHXRUFVX 
RBEKAVKF        : YBJAGVQN        KLQJCVFJFKHE    JIVIALAE       
NKLBAT          : RRSKGNIOCRW     CVNWSC          OJCIHLJJMSDCQGE
GPPQ            : PHXTVOSVVXSQPG  WKWPJEL         BURPRHD         LUIUDDYHL      
OLKVETXGPNART   : KXKMPW          QMGNN          
RPVA            : AYCITQHDXHVXHNS WUAHAB          BNRNNBOJNWAATPU
LMXOPUMXMEOJSDW : KMMDB           WLBEKWWWICJVH   QEHWLJYU       
JQMPGCQAYBSQY   : NYVNOWRMWO      BQIRSMUD        ATGOIM          HDELWYKCK      
DMJEC           : JRLRRVWJCSTHWGN VYIRAMEPWFS    
BQWNUOWNRTEBM   : KYWCUHTNVAEJV   KOIJCFV        
TVWKVVNQPPLSCVY : HBQUUM          WQVMAXOABBI     HVHLJNS         QIMHTAEVAA     
WAWUNRL         : EOFTRPMDXPBWAK  DORTJDKFCBXXJB  GKTENXEKCFEXAB 
HDJNGYGAU       : XXOYUTRIM       CMBQNQYWQHV    
MSCDKTUXP       : ICBJVKW         EJSFUL          LKTAOPIYEFEU    VWIBNGITDHO     ROKOEPBRDFO    
VOETRDQ         : ATNQFJPYY       CQDUFCXQHK      GYSLGNWBWGSSQXC YNYBEMA         IFWAGI         
VCUFH           : KSGMU           SJQDMFUUTTAHC   FSMQWRSQKIRHII  IJPVGPPK        WXQEEGXF       
TPGC            : GHOQJHCDICEJE   GOACXQGPVEHF   
DIHVNMI         : EEPAVERUYFJME   HKXTKPF         DNYRIPRVSPNFA   WFRQODVXFSH     ENGH           
HHWFDOL         : HAHAOJEXDOWBY   TBFSKDQUGJWH    TLFHKQDSMR     
GOPNMTLSDSOT    : GABIHHVCCRK     EURBCOBVSXMYKUI DLLNFCCIPUYA    ADRHFTMQACYQ    VJTIWATHYF     
SOGEVCTJLBQUBXA : JJODDUXDTDO     KDIEIBTBJE     
JAXBRNNMYIRTW   : OPDPSEOIJTQJCHD GRHSRJMLYQLUX   QFWOLT          AVKFUETCOTQBI   IIACLYTLM       UITMVUDYGJLHQ  
WSCDWYIQKVTDQ   : TKNF            GVTNYE          KCCXJVHCQK      VCRANNLAJWBXU   NNHYAWBMITL     XSUGLNQ         AGOBPJGIQV     
CQONSOOL        : NKXDKDUFCB      SJIF            BDSBXJQ        
DAGNRBNGAG      : LMCFFXIO        BIPYRONJGUY     BGUFGOKSYMI    
GDJOVVMR        : WMTIDNVT        DLSOHLA         SLIQDPKXDKCHH   CEVMJSUO       
DPEVGRPXJDDO    : EATDDLKXNGYCHKN IYVQPGOT        NJSABDQIHULY    QLKH           
JCUMPBPVMVBVMY  : VJENCTDHGN      HUFWAF          JMXEQCOLM       ADFRFS          UITMVUDYGJLHQ  
YRUEJBCRUT      : PMAGVJB         IQPVMLROTKBYBV  OFYYJKRT        SBJGXFUDM      
EWUUAHXVVPYLOL  : QBYDAPDT        TTFNTXCEWTMHMD 
RKXRFWLCDU      : DORTJDKFCBXXJB  TOHTEBIRICCYRFB LXLGEA          KFNXMRW         LYRCMWDFBNYBXP  AGOBPJGIQV     
IOACHH          : OCTVGCTV        SFTBAEWKTYN     CCQMRPLOFOVNW  
ECCLAAK         : DINKRM          KAKQ            HXXOGDK         LXLGEA          DXFCXGDCKGSOMVN BGQXVKYOJVKPV  
AVHN            : OVQTVGWCWMD     JWSUMWMHGQYL    NNHYAWBMITL     EWCOEQRJXKSDH  
YAGQHGELJBQT    : SHREKKBXUGLQGP  OFYYJKRT        VQDQP           DURYVIPXGUNXO   DWPKXYNIR       RGNWKPXFINYIYLY
RWXYY           : MNDNRUCOLJAU    EWGOVDHITTU     QXYSOWT         CQMOOLNQDCRXILK KFBJFPKUXILLF  
BDQEEBWG        : QDEUKHYDTOG     JRGIOAFBGVR     FYGQBT         
GVHFYQYGWDUIF   : DWGMDVHEOP      SUFRGECYEDHBK  
DXFCXGDCKGSOMVN : JEHP            ECCLAAK        
XVRFBQVCWUG     : FIOC            EWXVYMKI       
ENGH            : QASK            FSOTAQI         HIRVQHYC        EPMTQQWYQJ      DIHVNMI        
LJLSMN          : BBXHFAKEOEU     RHHQLRMEKWAIW   KYNFK           VOKYMGHY       
UJTIHJDFHUNINLN : GKJDNXCPRYFYI   GUCCENFDRN      JFEIGNTSU      
HVHLJNS         : ISLIAXWKHYPFCR  FQGBITO         PWLMIHEAS       YAQWCRPQJNES    LUVIAQPQGJFVXE  TVWKVVNQPPLSCVY RHYERMRG        JRQOPJQQNT     
CEKWSACNJXXTJ   : GVYVJSPINHT     PDKWVNGHXLOY    KAGT            TYGWMDQBTN     
YQBOBPBODIK     : YWHDGJUGUPOL    SRVRGPP         IKNFJVQVK      
TVBOSDSF        : NRMYOADGASQH    TQWICCABMPLJBE  VDRIGNQYCA      TYOEULKINHPMURA JYES           
NGEDR           : XXLTHCWMMKDR    XRHTWDQKONMY    TBNVV           SURHT          
CLLI            : BNBIQPSWOXLNYMD KHRJC           CKFGMRTW        OTIW            UCFRCAAWH      
EJCFYDUCNFPHCQV : HDDPUORFOCGHDUD CGFNPWLQIYTD    TCFJRFO         WCKSHEONPRAJ    DEEJ            QAABJLYHUFSF   
VQFXG           : MGKBOVASCL      IEQCBCBRGJ      VNRPSVLUAIBJF  
CKFGMRTW        : AFBNLGEGGTOXJ   NJTYTP          TTGI            GAAIYKUUYOHVCLQ CLLI           
XGJDG           : VFSA            LWOATRIENEBKP   HGYOBS          MFPEBHIBVL     
AKDGALKSJJODOMJ : JUNFPB          SHREKKBXUGLQGP  HEUSGGEAWXLOWPW TEJAJVLLK      
OTIW            : LHLEPTXCDBNNSQ  XHWASGEUOWNSQXG BURPRHD         JBMXJUKHJXR     CLLI            EYHGUBWQCO     
CQFJOOSUUKUH    : XGCIPNAMMNIHW   JFIQKYESODPEG   IWKND           AEOPUUE        
DKCNDNAUQQ      : JJHI            CJGOVRJAW       WVQJYIAARGRB    PXBNRORJ        YMEQERLPWRQ    
DVYYEVK         : GJYGCETH        MDQLMTORAIL     KWSVXHJK        WFANQVC        
NPREGKYBXUL     : FTSAUTGJI       SNWTFBFHUGCSKTV BRXNQ           KRLQSFYDIEP     IAOIMINAMD     
XVOOBCQVVHGYD   : MAPTPITRSITHN   SRBEQ           IFWAGI         
XJDKRSDJXJWYNU  : GQNUFNPHAUN     LWPCHQLHN       TNTYLP          GXSBLOPEFKBXRBF IKNFJVQVK      
YHUWXLXACWX     : FJMXEBIXKQGWEM  UWGXUVOGKAICMF 
DWPKXYNIR       : OCTVGCTV        CKFEISDBFDCK    PXQXCSTUE       YAGQHGELJBQT   
LBHXXGLU        : SSAQMPMMXNAHJI  TSTRD           WVPQVCAPXKNHRA  SBUCX           RDCPXKJSOJTO    FTPNKHONHFLK   
KCAJCLHDN       : KYWCUHTNVAEJV   OVFFUMQJOEHCMJ  KKFLELNJPQQRM   AVFRVFKAMR      BLNGGFOFARS    
DWJBOVBOKL      : LRVC            WEJLCVHWLC      IRIVVJVVHCPNAC  BMNFFSYPHCROHUG PIOXHUIWKUX     YQGUTNILLAI     KXVDHFD         NCPDIIWUYSFSHWD
TAJDXK          : NBMOKILQI       WQMSOFWU        EUBARSXVV       DFLCRGRKQQBKYLR SUUFTVJRGQTS    OYRPG           OOTOWCPSLKAFNV 
JFOVKOF         : HUUO            BNIJXFXSPJEVRQG POJCKJUD       
AORNVVNHYCECSQP : CGFNPWLQIYTD    JYRLWFUIVASK    FXWK            TKMEVOLB       
KPNNPXYB        : OVFFUMQJOEHCMJ  GHNUVYXVJLUNR   IQUP           
OWRF            : IITLHDLHOAVETE  ICVQTDYIYVI     UEPYV           HPBEBPEAP       JYES           
HGTBV           : INJIT           OVQTVGWCWMD     VBLXAQMKA       TKSDEXTTO       TWYGQWFKGP     
YLYAQDCLT       : YAFJBTKXHIRVS  
NGMBVDBVEGMEB   : EUBARSXVV       HTOHCMT         KHRSSTTUQQ      FBVTDNN         QWXYNMCRKA     
IIACLYTLM       : RLVIPUTPOAPQJ   DAKKEJ          EVLIGSDDJDGADKA MNHJJRAXCLRAD   JAXBRNNMYIRTW   OOTOWCPSLKAFNV  UVIBDKMEAEKWXE  OQXDUJ         
IIACLYTLM       : OIWNUIHN       
LFYQRVNFE       : LGLN            LIJSI           VQDLJTNELNOKP   ADVWBJYUTCPORKV RNIHRERKJYK     SFNPYQTEDMGJRK 
IBDJ            : GHOQJHCDICEJE   UQXXKKKNM       FSXEAULDKY      QLLXCYXV        WFRQODVXFSH     IXUOYXPCQLUF    INSLWIR        
KRLQSFYDIEP     : KJXWQAXQWCIT    NPREGKYBXUL    
XDXTQETHXRUFVX  : LIIFB           YFLLQTWY        IFWSNFSIAYT     OPHAWPMNWVL    
WDWXNQJGMR      : VUOATGXB        WTQMHFUQ        FUFEFMKV        OWJRQWHKMYLWNIA JFIQKYESODPEG  
PCKHNKMNHETBNRU : TEIFQRUJQ       OAPKLDWHQP      EUNX            JYRLWFUIVASK   
WQJMQMLODDBJR   : KCCXJVHCQK     
RHYERMRG        : CXYDLEXONAMPDGV IUGKLLCTOHJJYB  HVHLJNS        
YKWCBQWMQN      : JLIJQWNTNEUW    OMOWJKWOEJKI    FNXSACBTLNLKPIX RRMDDRQRNNK    
DGKPVPUWCMRTVQ  : GJWCMSQQFLPB    SQTHRHHGR       MTJPGAR         CONBTE          PUDVHFPSRKNA    FEQPRYPKJJSWLB  NNGUPFNCS      
PFSWJRJGTKX     : NIEVYIWXLM      PXIXILDELFTL    DXNXCAVPSSQ    
YQGUTNILLAI     : SXUDN           DWJBOVBOKL      PIMMYFUN       
CWCYTUAL        : KCBHIHJKBRETENU IJIBYSCGYDX     QIFPHYGLF       HVNSI           VQTXHJMWPDQR   
UKLMUS          : YYKCNFULIYFCDEQ GIWOUHLJEHMK    ITXUFKRXHSF    
HSBHJJEFY       : QTSESMCCHRHYU   UCXPLDLACY      NYTPAFPLIRRPFIW WQNTGBLXL       HCTNVSO        
TKPCURAWQVT     : JTTQPUBD        DLVWRHVLRGNJKC  VOQBOGPIVAN     CFDWDLKIREYN    HJTMBOWXOGOOW   NPNOIRHLMKQF    YRHUJT         
HVNSI           : XEGQTJNKVLSSRA  XNILWEGJI       CWCYTUAL        XJLALRXYJJ     
PDKWVNGHXLOY    : XCDKYSLT        SJIF            NJWAKOWOTGH     RQKMIXJGIT      PJOVNQ          CEKWSACNJXXTJ  
IKPLH           : SIPT            WXDFVIABWOFC   
NHBJBW          : UUFBWXHICT      LDNUMKQ         SBUCX           GVCOGLXXAEAYL  
XKNIPFLADJQLSQ  : LEXDVVKQMFYEO   HQDFILOD        DINKRM          IASDTJFF        NEVL            AELKI          
HPAQCPEKCTRG    : AFFVSXYDFYRP    YSCSNECKXIXQ   
SDASPODFT       : JTBPNOW         TWDPYUBY       
IYAY            : FINKSQGUNB      SSAQMPMMXNAHJI  ITEQN           CYCGOGG        
SPKDFKVKDAUFVOL : OPTDKJGEEENREY  IPVD           
JQDDHRIMOXWPAVB : PAHLMY          CEBKFL          EPMTQQWYQJ      DVJUTJARHHJ    
LOWTYSEEU       : HWCEMFUBLOTD    FFGY            SESIODCHCAOWH   KNVT           
KSPXVYR         : SESIODCHCAOWH   FVIMKG          IFWAGI         
EYTN            : JHHGFPQJLQ      XTFBU           BIPYRONJGUY     KSENBYFTBYU    
KNLANJEJXSITTDA : YFMSMKTNGMINH   YONDORBU        MTVBIYXG        INXDWOJYGTV     BMNFFSYPHCROHUG CMWL           
XBLSSLORDQY     : JYQIPUHEOJP     NJIVRIISXOLUT   YPRJWDPXEXKPOG  XEBSL           CHYLBYOHOBRHB  
MOUWCGY         : TBFSKDQUGJWH    PUDVHFPSRKNA    RLKPPQNASR      OFVFSHLNGCHEYI 
RDCPXKJSOJTO    : LBHXXGLU       
HIFUYAB         : VVTDNWAVRO      BBQEYFEBFAT     VTMYLAQKP       RXWJIMHCADIDOI 
YFEPABRIBJDGLS  : FCJSB           IEANJKLDXL     
WFANQVC         : AHATQOCLEFYF    JBPDFSFHEYHGRL  DVYYEVK        
FMLAMLDEMJ      : GHNUVYXVJLUNR   RIRJUDEVSBLYWPP EJGFM          
CLMVWPGCYTUEQCG : QKPRVQYBTCUPR   WHXWINJWL       NTOOXYM        
TEJAJVLLK       : AKDGALKSJJODOMJ BSPDAP         
RRMDDRQRNNK     : EEPAVERUYFJME   YKWCBQWMQN     
RJQP            : QROGSADUX      
JRXQNCCNNXABLC  : QGJLW           TSFJPPNHYLSX    EACRVNBFMYXTXKB
DQVIINAYDKWV    : WEJLCVHWLC      TQWICCABMPLJBE 
NLLXFJQTNSHBSJF : VTMYLAQKP       LCJMRVWRHHGLEWF
NXJFW           : IEVKQMTEJN      NIPTRDTVMPUC    HUQSIUVXC       OBJPAAGFJ       SLXWXBFURTF    
PMUQPHON        : CSBSDDSFOA      IWKND           QBFGHQDCCDUHWCS BBNEWUEBPJJ    
CBRCHESDRLKVFW  : NDHNTOVLEYY     RYDH            FGQBBM          VMKCVRPUB       XJCRLMLWHL     
LKBVP           : OPTDKJGEEENREY  GPPDLTYHTG      VWRTWTGIY       NGNNPMPSSTT    
PIMMYFUN        : XNILWEGJI       EACRVNBFMYXTXKB YQGUTNILLAI     WQVJNPNRL      
BSWUUGYQJ       : YINQPLF         SUFRGECYEDHBK  
CTPJSSXGVVVWNG  : HCEHJUCKVVB     PEUFJ           YXQPQDS         DLLNFCCIPUYA   
BGQXVKYOJVKPV   : RQWJHLGJTQFSAY  DFLCRGRKQQBKYLR HPGVHHRWNBWMV   KMDFARNNHCDMBD  ECCLAAK        
YRHUJT          : HTNHPNWKWKMK    CNWPYXBRLRW     QVAESRPJABOJRQ  TKPCURAWQVT     YQPOHLV        
ERUANSYBALEICC  : UWMBEYVW       
ODVXAINXLORSKBM : BVAU            KVYOCHA         FMFVGTVLBSYS    IGXAVE         
FEXHTQHXSSC     : KOIJCFV         RHKWQMAWO       FVIMKG          SSXJKXMBNWBFA   KSXGITBWS      
UHIMKGKMOBKAPCS : DRXSGPRA        FBVTDNN         RGDFUNFETNAH    DURYVIPXGUNXO   XIPDDDRSKFOSEMB
FGDKMB          : EMITWDBHROMLDTW NRHPSJEDYNVQAB  SSUCHURGNPJRKBJ
JUAJPULTRS      : FDRROLSE        GGDSR           GAVKJJQC       
EGKPSYSGYIKT    : NIGEN           HDDEMWPJ       
SCQDPUX         : RGCTPBSB        RHKOMRV         RXWJIMHCADIDOI 
RAKHUXBPTHTAR   : CGKRBW          AUCDPUMEKHGMF   SUFRGECYEDHBK   KBPUEGQFEC     
USCDTNQODJQ     : AJRLRJTMDV      TUOEAMJJUHSOTG  XLACSFACUFOHKC  KNVT           
OIQPJIPVQNUTDO  : ESIA            NPNOIRHLMKQF    VQDQP           WCKSHEONPRAJ    MOSJADPCGOY     KXVDHFD         GXSBLOPEFKBXRBF
WQVJNPNRL       : LWOATRIENEBKP   PIMMYFUN       
KAGT            : GJWCMSQQFLPB    XBQGOQXU        TSLORGKBXXABCB  CEKWSACNJXXTJ  
DKCVAOHQKAGHT   : QROGSADUX       YOWCIXMNDJR    
XXIOWTFO        : CPQVGSQ         PPACUPCHHYCTNXP YBXGEEYTDX      BOTQWRMYCGBO   
WANJBUDUANYV    : IRGVXSGF        JYXHRFK         FUNTHFSSRPIVCU  DLSOHLA         LNUWTEM         IAOIMINAMD     
NFHBFPKCBJ      : YFYVTBBUIOC     UCFRCAAWH      
JAYGHNQGOEPRB   : WKLE            TKYSLMW         UAVLODXNNL     
OBJPAAGFJ       : IAQTLCLFLPVLM   NXJFW          
NYTPAFPLIRRPFIW : GRVADUU         GGDSR           HSBHJJEFY       ANYGNCCUVAVAACD
NMPQIE          : RFABIIGTHVXLQX  RSESJEOHSMWQD   PPXCUVLPPXR     VJWLEL         
TUUTB           : BMNFSJXPPJC    
DKPCGFCOXNWPI   : NGYILRITDBXN    UQXXKKKNM       YYNPMMVDEVBXNJT
WQNTGBLXL       : TPMJVDPU        UIUFIO          RAMYBH          HSBHJJEFY       ITEQN          
SFNPYQTEDMGJRK  : LGLN            EEPAVERUYFJME   UVSRCXXU        MBBDSGSDCPP     LFYQRVNFE      
RXWJIMHCADIDOI  : FGQBBM          HIFUYAB         SCQDPUX        
HDVUUWN         : OPTDKJGEEENREY  MUMIDLHAUDR    
BSCHFVTFQU      : XUUIOXW         PXIWT           SXUDN           VFQXYCYFDUGOIF 
ADRHFTMQACYQ    : NYFGLPO         TQUMWNRBFK      HPDPMFK         UAVLODXNNL      GOPNMTLSDSOT    XEPEMWKB       
FNHAKUROQVXVUSB : LBEEAC          VQSPWIBRJXJYSXV VEILKEWSOJD     PBBVNYEVQ       CQMOOLNQDCRXILK GHAOLFYXJCDV   
NGNQXXWSKNSMOL  : PNPWWXTVDYYOCP  HXQCLQQXDBVATYX GVYVJSPINHT     YAFJBTKXHIRVS   IRJYCD         
TYGWMDQBTN      : DINKRM          KAKQ            CEKWSACNJXXTJ  
RKRTVHAL        : TTSSJUVPJYMIBJ  WUAHAB          TMLSCF          OJWKPV         
YJXTWLOJCAKY    : HBQUUM          MDQLMTORAIL     RRSKGNIOCRW     TQUMWNRBFK      IVIU           
SVOWORSCS       : CMVNQWYRG       BGIBFVAYOACR    NGTKOBKFVITAV   BBXHFAKEOEU     MGQVVKQULHT     LCJMRVWRHHGLEWF
ONFMUHY         : LMWQAALFFMLSFAR HBHVFAIP        VDUSWBHI        LNUWTEM         FSUXEPDINXJYW   DDSMTMQQTTPFXF 
IKTEHH          : BNBIQPSWOXLNYMD MROWJGXYJG      FVIMKG          YOWCIXMNDJR    
TKVELAXHQ       : LFONTJB         WMQT            XSUGLNQ         YDOERMEDRXREJ   UIDGYDFKKNFRU  
XIPDDDRSKFOSEMB : RLFKABAUUYX     JYCYTRSQBQ      UHIMKGKMOBKAPCS
HGYOBS          : CTKAQYVIJ       UCXHMSUMYLTDIOU LANIHPBNMGRL    HNBJYPL         XGJDG           EDRNUOKQIEP     PYAGDNOLUGLLMR 
YWMYWVPTUAMXG   : TTCXPBFONYPLAR  INCPJTFXAFN     GGDOUDRWFLSEIVT STBWVAOS        QJUPPMKAMYWK    JVBIENF        
RYBWPVDDYUMF    : HAHAOJEXDOWBY   IXFYUSJLD       NJSABDQIHULY    QXCKM           TVJQUSCJWL     
DJMHK           : YLVDOTGPEV      YKNDJHRWC      
TMLSCF          : IPVD            WBGPUKS         OUDN            SVYCSJBDFYOSO   JTAKJQUKXHEK    RKRTVHAL        QJRUFTSF        SVGFEJPJACG    
FTPNKHONHFLK    : IDMXO           UCPJCVXA        HTUOXANACX      LBHXXGLU       
KFWSBCEPJO      : SQVBHCB         MWJVDJCTARB     NNEQIKGPLY     
GBPYGUQ         : EVTDREPLSXT     YBXGEEYTDX     
PGBCPPRWW       : OAPKFR          KUQHJLNF        FSOTAQI        
KJPRGITLMJUC    : QHBIVHSXI       MCPFJDHVVFLELJF QFWOLT          AEAPBNC        
BFDCLBS         : IPJRGWDJON     
SBCWTUOQTTDE    : ARJLVUEMBG      UXCSYRVI        MGUPDC          FDLS            OFAJSEUDSWUMMDG
VMUPX           : SSARAYWXAJ      QLGYYNULEYVLU   XLACSFACUFOHKC  NHBRHOPLFOXY   
BTLRWRUA        : FINKSQGUNB      IITLHDLHOAVETE  MTHXXIVMFCRCILC QKCEH           KIUDR          
XUFQYJNSEELYAPF : NRMYOADGASQH    IFTCMT          PEUCTYOXLKMLK   KOSGBWEXSOVL   
LRHDQOE         : ONLB            BEYUALLWGN      JIVIALAE       
DVJUTJARHHJ     : CVXIKFJLBOLORJ  TLUOIXQLFTKETK  KBTBGVMGH       PBBVNYEVQ       JXSTVXSPCRDJHA  JQDDHRIMOXWPAVB
TYYAEKBECGQNYX  : WEEPXPSIU       MKDMDRR         ODAS            YLJMWILYETMOBID
PPXCUVLPPXR     : RCIVHICYTA      NMPQIE          IETBKONYGPPAV  
HCTNVSO         : TJXSTWOF        RIMQTY          JQPIYWWXJ       LPYP            HSBHJJEFY       JQJUYDCRS      
YBXGEEYTDX      : KDSPR           XTFBU           XXIOWTFO        GBPYGUQ         YDOERMEDRXREJ  
UPLYKJNCAL      : KMIHTIMBDL      GJWCMSQQFLPB    EWGOVDHITTU     GHQCYVGHQXTCU   RVHDGGSKPFAQ    YCJEYAAXNRYDRE  VRUJIO          JYCYTRSQBQ     
KSXGITBWS       : KUWVWFADUJQNRI  JYDLWVIYO       AINRXQJ         FEXHTQHXSSC    
XQHE            : OTEHBLCSDHY     VMPVTIKKHEF     NJBJW           NTFFQHLPUPTWHW  VJTIWATHYF      UQXM           
GYDGMXXAAKJN    : BUHCXK          EEMGLSGPGQAYWY  NIPTRDTVMPUC    BDSBXJQ        
JBJV            : WVTCAGHWHULEB   BKYWP           CBGHCOWPODIFB   IXUOYXPCQLUF    MGQVVKQULHT    
JCEEGDWHBPQIMYH : CFJMVJKPLUCIN   RAMYBH         
ITQIVQTFGIR     : SKQVLCQ         HWKKYHIKDPKGVC 
TNDE            : OAPKLDWHQP      GKAKMLS         TKJDTJEHYRMQR   KAKQ            EBBBKIIDKJASR   MIWNQIAYANL    
HKYKJ           : UGBXYRMOK       UPOGNA          XJCRLMLWHL     
NYYVNAF         : JIYPCHMPYS      RFLSTRP         YMEQERLPWRQ    
IBYRWRNDXVUF    : YFLLQTWY        MCAJCCBMUJHPOYJ SYBXRIKHROQ    
KIUDR           : JJOCAT          NUFCDLXKMTPEXT  PPACUPCHHYCTNXP BTLRWRUA        OFSIXHCFODLGGF 
CCQMRPLOFOVNW   : IOACHH         
MQUG            : MDQLMTORAIL     TNEEE           PCMJXNRDLOFBOGO WCUEXPQDBGPNA   HCFAK           RFFM           
XEBSL           : AYTBJSFCLGF     YAAWYL          XWKMWXOYRW      XBLSSLORDQY    
ETQJ            : HOCYY           FIOC            EACRVNBFMYXTXKB UIUFIO          BFVIOHPI        ULWQDTFJFDWR   
XOPOBIGPY       : INXDWOJYGTV     PONWRIS         YWNWFV         
EUADSOUQVBOC    : RMRWUMMNWBRG    QKLI           
KOVQKOCYM       : AFWDKLDFDKMWD   JESNWETNII      KLRE            MXOAGQ          YOWCIXMNDJR    
QBUBHKC         : IQPVMLROTKBYBV  FUNTHFSSRPIVCU  MBBDSGSDCPP     NNHYAWBMITL    
QXXTSMQJ        : OCGSPAWFB       BLFMH           ATMTYKKI        OUTNCYVLV       NIPTRDTVMPUC    FJMXEBIXKQGWEM 
SBNWNEVEQKGRXA  : JJHI            HNHHUVKWICKQJP  CPQVGSQ         JCVVE           VIKAOFHHO       ATMTYKKI        AELFHMFE        WJJRSJDDSIFED  
YUKJFNFVN       : LHLEPTXCDBNNSQ  SYWMIHO         XWVAGU          MGWTEJHL        WOTAHFIMAUP    
RIRJUDEVSBLYWPP : CWJN            FMLAMLDEMJ      GXSBLOPEFKBXRBF SAOYWOENUYBY   
XIIXTJUGSAVAX   : AFBNLGEGGTOXJ   BYGXCWU        
FSUXEPDINXJYW   : ONFMUHY         ACGOKKQAFBUJG  
OOTOWCPSLKAFNV  : BNUN            YLNGCHEOKA      VHSNIVG         TAJDXK          IIACLYTLM      
NINGDNKUQUIOFH  : HDDPUORFOCGHDUD EBADFWQ         MJBEFDLKNAML   
QXCKM           : IJPVGPPK        RNUASFFKDQIBUWL RYBWPVDDYUMF   
MEUAPW          : LIIFB           QVIQGW          RDECTBRMVNEK    IGTFCTCEVEHUOED
FVPSEFAJSMEL    : DUDXINFUNLXTEUF ULWQDTFJFDWR   
MAPTPITRSITHN   : VDHGWOUCCIKLCU  CQFMBKWMWJ      RLFKABAUUYX     XVOOBCQVVHGYD  
JFORKKJD        : GGDOUDRWFLSEIVT XLMEQ           WLBEKWWWICJVH  
OFAJSEUDSWUMMDG : VFSA            BLFMH           SBCWTUOQTTDE   
VPBFFUOKLIUYRXP : IWYMJIIINLQFADS DWGMDVHEOP     
GSRYYMESJY      : ESIA            HKYILWQASFJVQQV ROKOEPBRDFO     KLTTCWYBCPJIFU 
XCQFAGIH        : RCVIHUIMFXWVB   LDFRABFNPBWL   
DXXQHSP         : RLVIPUTPOAPQJ   TJXSTWOF        KWMESLSNM      
SIIBBACAPGUBHD  : SQKV            CUMY            IKJQOFJLQ       QGYQVBYF        RVHDGGSKPFAQ    LDNUMKQ         UFFLLNVIGUO    
LTFNCN          : MCPFJDHVVFLELJF XDVWDNULKQHAY   BURPRHD         SMKDUFGYOJHQ   
PSTNJDICED      : VDRIGNQYCA      OYRPG           LEKVHGBQHSCO   
MFNPJPHQ        : JOSIDR          CAYFDV          MRBXXREFFPAK    XXLTHCWMMKDR    YWHDGJUGUPOL    TRDMVVLJLIYJXTG LYRCMWDFBNYBXP 
IAOIMINAMD      : KMMDB           MUTCSVX         FDBLULEFULUOTT  TLUOIXQLFTKETK  RSESJEOHSMWQD   NPREGKYBXUL     WANJBUDUANYV   
CVTRIWCKBHWQO   : FHDXYDWEEU      HTNEWFEHUT     
IYAPPLAP        : TEIFQRUJQ       AONKISRYVHRE    GGKNFJKGQAWC    YMAASOAIT      
JEMYFYFFBD      : RAMYBH         
SLXWXBFURTF     : XGTGVMHKELFWM   PMSXFLHIGMCQT   ERXBYTN         NXJFW          
UITMVUDYGJLHQ   : CPQVGSQ         JAXBRNNMYIRTW   JCUMPBPVMVBVMY  DADRCPAGFRX    
MVOQWK          : ALFYGLJWLAA     CMVNQWYRG       TJXSTWOF        VWRTWTGIY      
UHDWMAQ         : WNFHJG          NIGEN           LRUFHEHMLAK     QIMHTAEVAA     
ITEQN           : NNFLGROHRQMYR   LFWQKJNL        LNDM            XDMPQWA         IYAY            WQNTGBLXL      
MIWNQIAYANL     : YNJSKYYQQTRGV   NXFRGKRCMOGS    FPOL            TNDE            OXRUODNORYBHO  
CEVMJSUO        : RGHKBQICGUJ     UHUAQEU         UPGRVGRSL       GDJOVVMR        AGOBPJGIQV     
JQJUYDCRS       : IUGKLLCTOHJJYB  JSRC            AKLTOQ          HCTNVSO        
HESUUDWTDMIC    : KBVQLJTHAXHTC   UQMUVIKEDXTYMO 
MXEXQYOJLGSI    : AEOPUUE         PYCQOTHGGD      JBTVDSAPKRUVDVC
XKCSGJ          : VPKTXQXLLLPQJ   HPGVHHRWNBWMV   YVUOTAW         IJIBYSCGYDX    
BGUFGOKSYMI     : PFHM            YFYVTBBUIOC     NXFRGKRCMOGS    NOIBGMTMBXQFM   DAGNRBNGAG     
MNMGOCPCKKL     : PHFN            XBASHFLS        PEOAKYHTLH     
KXVDHFD         : WCLXCFFXQCHJ    CSQORYDIYNJG    MOSJADPCGOY     DWJBOVBOKL      OIQPJIPVQNUTDO  RJSWNTAW       
OXRUODNORYBHO   : RVAAXEHAF       GGDOUDRWFLSEIVT TSFJPPNHYLSX    LHUJLCSOSP      GYMY            MIWNQIAYANL     FRXESOSFU      
NDRFIC          : XRUO            JVALUCW         HNNTYYNXNQHSR   NTFFQHLPUPTWHW 
VWCTSFDBIQPIIMX : MCPFJDHVVFLELJF NUFCDLXKMTPEXT 
CMIBPPRFDVXI    : DNFIRPPASSLHM   UXCSYRVI        FIAFN           KRMJUQEK        EWXVYMKI        MGQVVKQULHT    
AACYCXSJCVUSN   : RQMSTQGUH       SIWFPOFA        KVQLPYSLHXXDWT  WWFNVJOAPLPCP   LKOCXGXWOOEUXHM KXKMPW          UJHWHLBRBH     
DADRCPAGFRX     : WXDFVIABWOFC    XGYMPPHPJYT     UITMVUDYGJLHQ   TIWH           
UVLFCNFGNJFIUJ  : BKYRVCAQNVF     QKLI            RWCDXSCBCANRFW 
PERVJTYBVRD     : FRAUYLIP        TTFNTXCEWTMHMD 
YWFMRBXY        : YCEBLDQDTCF     IUINABOSK      
MGMCPTKN        : AELFHMFE        YYSFAJOUNDHGJKN HYVCOCECCPAUJ   WXTBXBDJWE     
QDLKBVEBYCSFHRC : SQKV            CKFEISDBFDCK    UCPJCVXA        OUTNCYVLV       XDMPQWA        
HWPFVVTDLXUHKIP : MNQFK           IUINABOSK       HNHJYGCWSYLCHCB BDEBHOYMKLAP   
OBLPWPSWULCEGGS : NSBCXC          GPRLVVBPCCVEFD  GGDSR           ADDDXNINPH     
DIUA            : EVTDREPLSXT     DRXSGPRA        FFJAXUPBESVE   
RFUPACBLRE      : WIMPQQJWERII    XEFULQJ         POEAWHIT        HIIBHXEPKTYRO  
VQPSIJR         : FWET            IPVD            IWKND           WTJDLEHHLMAHGM  GYMY            VFQXYCYFDUGOIF  ADNRHPSOCAOCQL 
WTJFBCUGLSGU    : DWGMDVHEOP      RMJCICKDRXLV    RYDH           
NPCOTFAOKCKDTD  : GFOIFKD         PCMJXNRDLOFBOGO
FXTFRDKU        : YSXWVGIFRXAYQW  BEMYS           LDTPNDDVNTUDPI  PAHLMY          SNWTFBFHUGCSKTV
IETBKONYGPPAV   : CSBSDDSFOA      MVEYYMCFWJ      PPXCUVLPPXR    
OIVBLPHYVFS     : ARJLVUEMBG      VIEVEJHWDJPAIN  RYMREUQY        HIYRBBUFSFOP    CEBKFL         
YWNWFV          : JSRC            BOINNXXIIWKYP   IXFYUSJLD       XGYMPPHPJYT     TTCNNI          XOPOBIGPY      
YYNPMMVDEVBXNJT : GFOIFKD         TBHLTBHRVFI     DKPCGFCOXNWPI   HIOLBCXUOEYXPFI
WMXVIDRLDQB     : JDXDTEADH       UGBXYRMOK       HCRKSC          IXTT           
VABWYOMMEKRKIS  : IEOTXWPDXORAJ   RHKWQMAWO       NYFGLPO        
VEFNBRLYCRQPUJR : WMWLJ           AICY            HBLTFMVU       
FRXESOSFU       : FRAUYLIP        OXRUODNORYBHO  
WGMRRKXWXYRM    : GKAKMLS         JUNFPB          WEXXA           INXDWOJYGTV    
TERKBECXLVXQ    : JCPXJRFPJ       HCFAK           RGDFUNFETNAH   
OJWKPV          : OYCBCGUPLE      RKRTVHAL        NCWKFVSFAQAJB   PYAGDNOLUGLLMR 
CQMOOLNQDCRXILK : BVNFJAW         DFRGHLE         XILYC           NUQUJTUEGOG     TUGCVTJSBV      YVRYA           RWXYY           FNHAKUROQVXVUSB
CQMOOLNQDCRXILK : ADNRHPSOCAOCQL 
POJCKJUD        : OKVLXBBNBOTSLWL JFOVKOF        
ECKVYFARTPIGFY  : UBILHINUFSV     HOIS            MXOAGQ          IQPVMLROTKBYBV  MKGWW           EIVFVLLEQCJ    
JSLRF           : TBHLTBHRVFI     TQBQASUM        NEOF           
DUKO            : MUTCSVX         HPJONNFTWBNVWF  XAWV            GHNUVYXVJLUNR   WXQEEGXF       
WXTBXBDJWE      : JEHP            MIHIUXTFNEF     LAOM            MGMCPTKN        CHYLBYOHOBRHB  
AXLPHT          : YTKNGUVOIKHQKKL MUMIDLHAUDR     VHSNIVG         KNVT           
IFECR           : HPJONNFTWBNVWF  CJCIL          
HPBEBPEAP       : TWYGQWFKGP      OWRF            VOKYMGHY       
BNBH            : TWQBQAAFRRQ     QUXQRCTELQYPCI  WCKSHEONPRAJ    IGXAVE          AMYFVBCH       
BLQBKCQTVNCDTE  : YJLWCLRU        XQYARSYYPHES    RTSNRDROIDXFHIV YJBBD           VUPMGUAYLWT    
RNNUUQMYQ       : JSRC            NRBYTOMGVBJ     QROGSADUX       WQVMAXOABBI    
BSPDAP          : LGLN            PHXTVOSVVXSQPG  TEJAJVLLK      
NGHAIATGPYLLFJ  : FWSCKCJQPDYJMFS ASJMSPBTUXINAL  VIEDCCM         JWIVXICQAYKIOCN EBUKEMAYEK     
TWAOPOPGQQBGVBX : RAKQFPUCQVT     KJXWQAXQWCIT    BHDYKUSSKXOHY   HVCMFPAHCYSJB   JUBMCOSTAQ     
RELTONQWFPJQU   : JCVVE           TAYUDLDX        BDARBJH         BGUXJYJJRI     
VQTXHJMWPDQR    : MIAJKM          CWCYTUAL        MBVUCUIW       
OUKTOPHJGX      : YSXWVGIFRXAYQW  YTKNGUVOIKHQKKL GRITCQOQHFB     NUQRTSUSHMTMGX  HUQSIUVXC      
EDRNUOKQIEP     : HSDME           CBFMISWDCYPXVQK VTMCYQR         WNHRMIF         GHNUVYXVJLUNR   JXYJKQUUQBHI    HGYOBS         
NCPDIIWUYSFSHWD : WGGNHXYVFYLDXBT YYSFAJOUNDHGJKN ERXBYTN         DWJBOVBOKL      VFXVUYU        
EBUKEMAYEK      : MAEF            YWSLMUSXICKUBR  QAYHISWGFLA     LAOM            CEUDPL          NGHAIATGPYLLFJ 
MOIECMT         : QKPRVQYBTCUPR   BJKN            EIEMCAVPUL     
UCFRCAAWH       : DYYPHBCMBAT     CLLI            NFHBFPKCBJ      OFSIXHCFODLGGF 
ADDDXNINPH      : PUMWKLBIE       VCQLAOSVMK      RHKOMRV         YJQOV           OBLPWPSWULCEGGS
ACGOKKQAFBUJG   : GURPFEURCRC     GELLFVM         WXNYEXAUXMS     RQFYRMFJAOKNT   FSUXEPDINXJYW  
NGNNPMPSSTT     : EQDFRISJ        EWNWVNC         NOIBGMTMBXQFM   LKBVP          
CHYLBYOHOBRHB   : EEPAVERUYFJME   DIPKPAV         JWSUMWMHGQYL    XBLSSLORDQY     WXTBXBDJWE      MVIFAWHYED     
IWJQMYWCMPQD    : NNGI            PKADHQWVHS      CIDRQBTNQXPA   
JYES            : DNFIRPPASSLHM   QXFWDIUUU       TVBOSDSF        OWRF            DGXLM           TTFNTXCEWTMHMD 
NROOSFVJHQRKP   : OWCGITYHT       MGKBOVASCL      GQNUFNPHAUN    
JBTVDSAPKRUVDVC : RIXSMFECFYRVEC  ROKOEPBRDFO     MXEXQYOJLGSI   
YQPOHLV         : IUGKLLCTOHJJYB  XAWV            YONDORBU        GPPDLTYHTG      TRDMVVLJLIYJXTG YRHUJT         
UDWOOMRAQNWTIYL : MGQJCATHRRISKHE PSMWWPIBUHJHKF  XGCIPNAMMNIHW  
QJRUFTSF        : GRBKDRIX        XLMEQ           RDECTBRMVNEK    TMLSCF         
LVUWRBRXXHOMBOD : IOSHCXWBAOKYBQX WWFNVJOAPLPCP   UEPYV           QCVXTKRRAQWHEOX
NYBNLWGUODCLWH  : YBORILCHIVBHP   EWQOLSUTASE     TDII           
KFUHXVYXVI      : SHREKKBXUGLQGP  BBDQKTY         SBUCX           DBDNAPDPPTGDA  
LLBOC           : FIOC            PUYXOGB         LJQLCQPUGHEW   
QEFCBL          : UEPYV           MOSJADPCGOY    
SRBEQ           : CIKKIORAYCN     WHPOK           GBQAAWO         FFTKMVCAJLFO    DLGXXCW         XVOOBCQVVHGYD   NCWKFVSFAQAJB  
EBSCISAJQWUDI   : FOME            QEHWLJYU       
HYLYPPGTSTU     : MDAUH           YONDORBU        KMDFARNNHCDMBD 
LYRCMWDFBNYBXP  : RVKGWWEKUPBU    ECBV            RKXRFWLCDU      MFNPJPHQ       
UVIBDKMEAEKWXE  : CVQL            HGGIEGXWI       JMXEQCOLM       IIACLYTLM       NMTEAERAQOI    
JQSCUFBYLEMMFM  : EEMGLSGPGQAYWY  FJUTDDACJ       RNIHRERKJYK    
GHAOLFYXJCDV    : WEJLCVHWLC      TDHQEG          BBDQKTY         FNHAKUROQVXVUSB
DDSMTMQQTTPFXF  : GWGGNMXY        FTSAUTGJI       NUQUJTUEGOG     ONFMUHY        
GTYMEYBPHDPSFS  : XHWASGEUOWNSQXG BGIBFVAYOACR    PJOVNQ         
GXSBLOPEFKBXRBF : WVTCAGHWHULEB   JGQQ            XJDKRSDJXJWYNU  OIQPJIPVQNUTDO  RIRJUDEVSBLYWPP
HBLTFMVU        : DIPKPAV         VEFNBRLYCRQPUJR
BLNGGFOFARS     : GHAY            UGBXYRMOK       LNDM            XTNEFYXVGJJU    KCAJCLHDN      
IYVSAVMCDYLFMGM : IRYYICHPLK      OMOWJKWOEJKI   
EIVFVLLEQCJ     : XPRK            GRITCQOQHFB     WCKSHEONPRAJ    ECKVYFARTPIGFY 
TEJCEIWGGMIKLU  : BEMYS           NOMFODQHWAWGNYN
BDEBHOYMKLAP    : UXCSYRVI        HWPFVVTDLXUHKIP
EBXXGHDMRCSY    : JOSIDR          XUUIOXW         LCJMRVWRHHGLEWF
EJDBDEEHHLWGAJ  : YRYUXCQDFDNFQ   AICY            KGPJRUECYFCJFP 
CYYGDW          : FGQXNOFRTRES    YONDORBU        SUFRGECYEDHBK   BIPCOWHD        FJYWEB          GIWOUHLJEHMK   
JGJX            : GKJDNXCPRYFYI   GHHWLJOB        AONKISRYVHRE    XQDUXGXDXGXOE   WVQJYIAARGRB   
OQXDUJ          : XNILWEGJI       QKXQRGHE        DIOH            BQBNRHSLLP      IIACLYTLM      
VMKCVRPUB       : QHBIVHSXI       QKUARYEBBIMH    QTSESMCCHRHYU   QVEEYRMUU       TQUMWNRBFK      CBRCHESDRLKVFW  BDSBXJQ         IDNY           
FSTETCHQJSAUQY  : CGKRBW          PUADY           RPJIWCDU       
KYNFK           : GFVGFJV         LJLSMN          KBQQLOXY       
EYHGUBWQCO      : OQFNPUPMUB      OLBKXKYS        KQJQ            SVMULCT         OTIW           
XJCRLMLWHL      : TNEEE           LEVODMACTVX     SDLQVLITADXS    CBRCHESDRLKVFW  HKYKJ          
BMCLNPSAMWYVG   : FWET            EXUNJT         
YDOERMEDRXREJ   : GVFQVQWEVQVYL   GHEKT           MIAJKM          TKVELAXHQ       YBXGEEYTDX     
NWHOLMAYCVY     : JERFXLVHVWEJPA  JEHP            LCJMRVWRHHGLEWF
SAOYWOENUYBY    : SSARAYWXAJ      PEUFJ           CPLJESBYLQBHRWH RIRJUDEVSBLYWPP
SWVYHLMGUESHGTM : GSDJLUMMA       RJSWNTAW       
VFXVUYU         : YONDORBU        KHAM            NDHNTOVLEYY     JOXRXYOAVX      NCPDIIWUYSFSHWD
EJGFM           : FMLAMLDEMJ     
JFEIGNTSU       : IWYMJIIINLQFADS HSDME           THAORHSJHNM     NBAUM           TLFHKQDSMR      WOTVCGVXSE      RKTLMNAHNOF     UJTIHJDFHUNINLN
YPBGJPIHUG      : QLNKGDLNPLDS    RVKGWWEKUPBU    WANWIGGQS       LDNUMKQ        
RIBFOMLTY       : KVYOCHA         PYGO            QEHWLJYU        VYIRAMEPWFS    
DGXLM           : WQMSOFWU        GAAIYKUUYOHVCLQ JYES           
HIIBHXEPKTYRO   : RQMSTQGUH       RFUPACBLRE      VTJWDCBSG      
XJPCOEQBASVGB   : HSDME           BLCNPVAFF      
TQIEYQ          : TKNF            FQGBITO         HLRUKB          XEPKWLUTTLBMIVB CVNWSC         
IRJYCD          : CIKKIORAYCN     XWKMWXOYRW      OUTNCYVLV       NGNQXXWSKNSMOL 
VTJWDCBSG       : NREGXIQMN       LBEEAC          JTBPNOW         KJXWQAXQWCIT    KXNQG           QCVXTKRRAQWHEOX PLOAHAOVBXJ     HIIBHXEPKTYRO  
VHMRPOOJFY      : SSAQMPMMXNAHJI  RRSKGNIOCRW     UWMBEYVW       
GRSQJERNJRKGCH  : VWMPENJG        VOQBOGPIVAN    
EIEMCAVPUL      : TKNF            SCKUA           KAKQ            YAFJBTKXHIRVS   RQKMIXJGIT      MOIECMT        
LXLKLR          : ROIIVVJJGJTR    EOEHMISDCAGCAHE IRIVVJVVHCPNAC  KLTTCWYBCPJIFU 
HIOLBCXUOEYXPFI : DLMD            UUFBWXHICT      CFDWDLKIREYN    NGUOHXCYGQRCP   TWDPYUBY        YYNPMMVDEVBXNJT
ULWQDTFJFDWR    : EESILNBPHNR     NRHPSJEDYNVQAB  WBHBCIC         HIYRBBUFSFOP    ETQJ            FVPSEFAJSMEL   
QWXYNMCRKA      : YAQWCRPQJNES    NGMBVDBVEGMEB  
QBFGHQDCCDUHWCS : IVRIBOBPWJNU    OSGEIMCHBDGWW   HLRMFPNMYD      AFUAAMJFDRDAI   PMUQPHON       
HPWYGVW         : TYEQALJHWY      GLPOPDVAGEP    
JLMEVMLONSXW    : RSHFAYXUUTSLKPA MGUPDC          ABWQBMOCBWQFHBV WTJDLEHHLMAHGM 
BBNEWUEBPJJ     : CXYDLEXONAMPDGV HLRMFPNMYD      DRXSGPRA        PIOXHUIWKUX     PMUQPHON       
IKNFJVQVK       : IMULTGQTNEBUR   LWOATRIENEBKP   QKFOHQUQNYTXTW  GAAIYKUUYOHVCLQ YQBOBPBODIK     XJDKRSDJXJWYNU 
TYILMCJMNKNCRMY : BNFXSSV         SJIGSAJLYP     
OPHAWPMNWVL     : TLUOIXQLFTKETK  GKTENXEKCFEXAB  XDXTQETHXRUFVX 
TVJQUSCJWL      : FSMQWRSQKIRHII  AEAPBNC         RHKOMRV         HOFHJ           RYBWPVDDYUMF   
KXKMPW          : CGKRBW          NEPOODU         NEOF            BMNFFSYPHCROHUG OLKVETXGPNART   AACYCXSJCVUSN  
NNGUPFNCS       : TVYM            PQURUIE         FNXSACBTLNLKPIX QAHEPGKG        BJKN            DGKPVPUWCMRTVQ 
BEYUALLWGN      : HNHHUVKWICKQJP  XVWEPYBVL       OYCBCGUPLE      MCBN            LRHDQOE        
DBDNAPDPPTGDA   : WYICGFMNERH     UCXPLDLACY      ISLIAXWKHYPFCR  GJBC            KFUHXVYXVI     
VFQXYCYFDUGOIF  : YJVXSW          ODIFDTSDJYBEDBT MOOPVKP         DFLCRGRKQQBKYLR LIDMTXCI        KUPGYWPKTFLICL  IBHJDQQKDMKNS   UDBRDFTMWGUFOAJ
VFQXYCYFDUGOIF  : BSCHFVTFQU      VQPSIJR        
YMAASOAIT       : PBBVNYEVQ       IYAPPLAP       
ANYGNCCUVAVAACD : MAEF            NWLVGSLO        RLKPPQNASR      NYTPAFPLIRRPFIW VHCBISKSEPQRYFA KSENBYFTBYU    
KUHPRGDSHXJJ    : MCAJCCBMUJHPOYJ
FCJSB           : FSYPKHOWBACRVW  XHFHMEGQA       IMULTGQTNEBUR   XXGQMDVDLXYFPFV ROKOEPBRDFO     YFEPABRIBJDGLS 
IGTFCTCEVEHUOED : WVTCAGHWHULEB   IWQXSHPVEXQYRED WXDFVIABWOFC    MEUAPW         
WJJRSJDDSIFED   : CGFNPWLQIYTD    TWBHWYB         SBNWNEVEQKGRXA 
VNRPSVLUAIBJF   : ITUKEQTWPF      OYEGWORLT       XXLTHCWMMKDR    YVSVCQIL        VQFXG          
OIWNUIHN        : BUHCXK          IIACLYTLM       VJTIWATHYF     
KSNUBRAKNN      : WIMPQQJWERII    EACRVNBFMYXTXKB
FIAQEAYFJFXAPW  : NLQO            IISHJKFNOWNEP   NDHNTOVLEYY     PPVQXECXSUEM    VJENCTDHGN      VTMYLAQKP      
KFUB            : IEQCBCBRGJ      YLVDOTGPEV      BBQEYFEBFAT     JVBIENF         BGUXJYJJRI      KWMESLSNM      
HTNEWFEHUT      : WXNYEXAUXMS     HKYILWQASFJVQQV SUFRGECYEDHBK   GWCOXYL         RLKPPQNASR      CVTRIWCKBHWQO  
ADNRHPSOCAOCQL  : KWSVXHJK        VQPSIJR         CQMOOLNQDCRXILK
DRPGRX          : RHKWQMAWO       GUIBFL          SSUCHURGNPJRKBJ
IEANJKLDXL      : LECASSMJ        NUQRTSUSHMTMGX  QFTNYSK         YFEPABRIBJDGLS  MFPEBHIBVL     
MFPEBHIBVL      : JERFXLVHVWEJPA  GURPFEURCRC     XJJI            HTUOXANACX      DVWE            XGJDG           IEANJKLDXL     
IGXAVE          : PKWNNOI         BQIRSMUD        PHXTVOSVVXSQPG  KCCXJVHCQK      BMQUAHRFVMMK    ODAS            ODVXAINXLORSKBM BNBH           
VHCBISKSEPQRYFA : ANYGNCCUVAVAACD MBPFUONUFAVE   
MBVUCUIW        : DGCKXPCCTXV     NIGEN           TDRLDNLDLHBWVL  XLACSFACUFOHKC  KWSVXHJK        VQTXHJMWPDQR   
OUDLBYJJCKTW    : KOIJCFV         AFFVSXYDFYRP    CQDUFCXQHK      RGDFUNFETNAH    NXHKE          
MBPFUONUFAVE    : SQTHRHHGR       PTKLIURFTUM     VHCBISKSEPQRYFA
BYGXCWU         : PYLPWPVNUWF     UPOGNA          XIIXTJUGSAVAX   RWCDXSCBCANRFW 
IVIU            : PFHM            RVKGWWEKUPBU    PTKLIURFTUM     YJXTWLOJCAKY   
KFBJFPKUXILLF   : VVTDNWAVRO      WMTIDNVT        QKXQRGHE        RWXYY           RDFIWX         
NCWKFVSFAQAJB   : GXGQNMFAMDEE    HKMXHVDYTC      OJWKPV          SRBEQ          
SVGFEJPJACG     : UBNEYLPPK       RHHQLRMEKWAIW   TMLSCF         
KRJQKYU         : MUMIDLHAUDR     FFGY            LKVXCVGLKFVLTUA
LAGFHJVHSWHNVNT : TVYM            VAEK            TBNVV          
XJLALRXYJJ      : CGJKJPQX        KDSPR           BFOAYTEKVTIIYQD UCPJCVXA        XANPAPSSGQDY    HVNSI           RJSWNTAW       
TKMEVOLB        : LKFTHJSGWJNCXSF AORNVVNHYCECSQP
UYFPWMEUDXUDJ   : WEJLCVHWLC      VMEKSVUQWKLQ    CQNNVXMPKEJS    QBYDAPDT        YSCSNECKXIXQ   
DWXDV           : IWQXSHPVEXQYRED SQTHRHHGR       QGYQVBYF        AIEJGIMASAAOV  
ONFYCK          : QSFTUFW         SVLD            KHAM            QKFOHQUQNYTXTW  CUPRGOEF        RGNWKPXFINYIYLY
QVYOS           : GOGRAAIFPWVUR   NPNOIRHLMKQF    XCGQ            UWDAXS          EYREOXNTE       CYCGOGG        
TIWH            : DADRCPAGFRX    
RMMOPXUUV       : EGFNMVTVSX      QKCEH          
ATGOIM          : SJQDMFUUTTAHC   YKMKULS         UHUAQEU         JQMPGCQAYBSQY  
KWMESLSNM       : NNFLGROHRQMYR   QMPOVVKMSO      BIPCOWHD        LXLGEA          DXXQHSP         KFUB           
VJWLEL          : JERFXLVHVWEJPA  QLGYYNULEYVLU   MMQCJBIDFJHJDOU FBVTDNN         NMPQIE         
SBYOXWLXQSOBHE  : LRVC            JLIJQWNTNEUW    TWDPYUBY       
EQSYFLMRBIDXVHJ : RTSNRDROIDXFHIV WYFJC          
BMXRKUFKNAY     : QEAOOWPYUPMPRK  WEXXA           BQBNRHSLLP      AEAPBNC         OMOWJKWOEJKI   
HDELWYKCK       : ODIKAHNVER      JQMPGCQAYBSQY  
VOKYMGHY        : BURPRHD         FVIMKG          LJLSMN          HPBEBPEAP      
KNDCBAJ         : YJVXSW          HBQUUM         
QKLI            : EURKJIIS        LWUSJBXACFHYTBN MOOPVKP         UVSRCXXU        AEUIKWFKJUHBT   EUADSOUQVBOC    UVLFCNFGNJFIUJ 
QMGNN           : OLKVETXGPNART  
RXSNMDPCLY      : NSHJFKDCJ       XAWV            MYNQXEUKGWGD    WXDFVIABWOFC    EURBCOBVSXMYKUI
RJSWNTAW        : IDUIIFYMMWKXTR  KNYKIFYLMF      KXVDHFD         SWVYHLMGUESHGTM XJLALRXYJJ     
QJTYCMNK        : GNASIIFFCCIP    ITUKEQTWPF      BDWJHBDOKQKJF   UBXXNQFFMF      VHSNIVG         SNODNKVW       
BDSBXJQ         : AFWDKLDFDKMWD   TJXSTWOF        CQONSOOL        GYDGMXXAAKJN    VMKCVRPUB      
YUPXXJJSGYNI    : SMKDUFGYOJHQ    KBPUEGQFEC     
VYIRAMEPWFS     : UBNEYLPPK       CFJMVJKPLUCIN   PTKLIURFTUM     DMJEC           RIBFOMLTY       TTFNTXCEWTMHMD 
BUBKNGLIVLIF    : BQXDBCTXHLLNAAS SXUDN          
BOTQWRMYCGBO    : BUHCXK          MROWJGXYJG      HXXOGDK         XXIOWTFO       
RNSM            : EATDDLKXNGYCHKN NFIODUTXAQDQ    UWMBEYVW       
VJTIWATHYF      : AUCDPUMEKHGMF   OPTDKJGEEENREY  GYSLGNWBWGSSQXC AINRXQJ         GOPNMTLSDSOT    XQHE            OIWNUIHN       
GCTUXKU         : LWKJJWK         LSXLJXLXD       CERP           
ATUGUMTOANCSL   : LGLN            XHIBATATDRQMV   LEVODMACTVX    
OULROS          : ABWQBMOCBWQFHBV YGLDUJH        
WJWYFUXPPSRLN   : LKHULQOICKL     GGPDXWXA       
ICUXDKCXWP      : ROCWJWSGXAIT    EXTDOVTYHYXR    LDTPNDDVNTUDPI  PCWHNDHADGAXCYQ REWLBXA         FRAUYLIP       
RDFIWX          : NYVNOWRMWO      TLCVYWFPLQRN    LMCFFXIO        TFARDUPJUJBWPS  KFBJFPKUXILLF  
IWHN            : GOGRAAIFPWVUR   IEKDFDH         JWIVXICQAYKIOCN TRUOPBPUBXSREM 
FFJAXUPBESVE    : EEMGLSGPGQAYWY  JMWREYB         YJIADOU         VEJPHK          VRUJIO          AAOUXCPJ        ODIKAHNVER      DIUA           
JIVIALAE        : RBEKAVKF        LRHDQOE         IDNY           
KBQQLOXY        : FSYPKHOWBACRVW  KLRE            XMWEOWJ         PYGO            KYNFK          
FGUFGPWHVPGCPP  : SCTFJNROFNP     WWFNVJOAPLPCP   ROKOEPBRDFO     FNXSACBTLNLKPIX QUXQRCTELQYPCI  YPEGLEMHGOVCF  
MANACRR         : MHDGEFGCJ       ITUKEQTWPF      TTSRYQ          KKFLELNJPQQRM  
UIDGYDFKKNFRU   : IEQCBCBRGJ      MYMXWJM         KJTKNFCNL       NTOOXYM         TKVELAXHQ      
PCTHKXXCJM      : UCXPLDLACY      OCGSPAWFB       CWJN            IYVQPGOT        NMIITCCGOJTRW  
YMEQERLPWRQ     : TQBQASUM        XROJCDEPXN      FFGY            XTVQF           DKCNDNAUQQ      NYYVNAF        
YBNMG           : IYBI            VWIBNGITDHO     SYBXRIKHROQ    
JEVOADYXBEJP    : CFDWDLKIREYN    NUQUJTUEGOG     ODAS           
IDNY            : MDAUH           YRBIOOW         CEGBQWEAHGLAXTE WVPQVCAPXKNHRA  VMKCVRPUB       JIVIALAE       
HMBEESJFVX      : PIPVEKIIMDM     OCTVGCTV        DNFIRPPASSLHM   UCXPLDLACY      SSKGYDH         IJIBYSCGYDX    
DEEJ            : XRUO            YCJEYAAXNRYDRE  SXPWYDFGUK      EJCFYDUCNFPHCQV
UJHWHLBRBH      : RNUASFFKDQIBUWL TYOEULKINHPMURA AACYCXSJCVUSN  
EWCOEQRJXKSDH   : TWYEJOIVESHPLP  SVBCDFAYXAWIK   AVHN           
AMYFVBCH        : QMPXNIAEGA      BDARBJH         GVCOGLXXAEAYL   BNBH           
YOWCIXMNDJR     : SPYMYKBLTBHQEI  YQQUIBIRC       DKCVAOHQKAGHT   IKTEHH          KOVQKOCYM      
OILAGYUKIOKUPR  : XOBHGCSEKEJP    IRIVVJVVHCPNAC 
RWCDXSCBCANRFW  : GLOBRNDLJP      UUXHF           UVLFCNFGNJFIUJ  BYGXCWU        
BNRNNBOJNWAATPU : GFOIFKD         JNNJK           RPVA            LKVXCVGLKFVLTUA
JRQOPJQQNT      : RGHKBQICGUJ     RGCTPBSB        RQFYRMFJAOKNT   HVHLJNS        
FYGQBT          : SNWTFBFHUGCSKTV BDQEEBWG       
QIMHTAEVAA      : AFFVSXYDFYRP    YBORILCHIVBHP   TVWKVVNQPPLSCVY UHDWMAQ         HXJIJVVIEJ     
UQXM            : TKJDTJEHYRMQR   XQHE           
OFSIXHCFODLGGF  : YCJFFCHX        XCXSJYYRXD      TJXSTWOF        JHHGFPQJLQ      PUDVHFPSRKNA    LEKVHGBQHSCO    KIUDR           UCFRCAAWH      
YPEGLEMHGOVCF   : NLQO            MUMMPKROJ       GVYVJSPINHT     FGUFGPWHVPGCPP 
OMMVGU          : VVTDNWAVRO      GMNPEXKWH       KLQJCVFJFKHE   
PYAGDNOLUGLLMR  : WANWIGGQS       XXLTHCWMMKDR    HGYOBS          OJWKPV         
SHHAVDEC        : XCDKYSLT       
UQNRYLMQKOXPCM  : FFTKMVCAJLFO   
YVNKKHKG        : GWGGNMXY        OFQIVW          LUIUDDYHL      
RGNWKPXFINYIYLY : RIMQTY          WCUEXPQDBGPNA   YAGQHGELJBQT    ONFYCK         
CYCGOGG         : IYAY            QVYOS          
VSWEDDU         : XEGQTJNKVLSSRA  GDDRAI          RRSKGNIOCRW     CRAWGTWF        EWHW            TTPMKMXE        GAVKJJQC       
LKVXCVGLKFVLTUA : OQFNPUPMUB      EWNWVNC         QTJWFQEST       ISMFSQRVCEW     KRJQKYU         BNRNNBOJNWAATPU
UFFLLNVIGUO     : HJWL            LKTAOPIYEFEU    RGDFUNFETNAH    EFVFXXPB        AINRXQJ         GAAHAHAPVHJBXC  SIIBBACAPGUBHD 
YLJMWILYETMOBID : NNFLGROHRQMYR   HDDEMWPJ        BRXNQ           TYYAEKBECGQNYX 
GDVDK           : TWQBQAAFRRQ     IXTT            LDFRABFNPBWL   
OWOKH           : QXVMBFNELQFGG   GPRLVVBPCCVEFD 
HXJIJVVIEJ      : IUGKLLCTOHJJYB  SGGCUVMWILBMCP  QIMHTAEVAA     
IFWAGI          : UBJYMB          CAYFDV          PLKAFJPOCNTJQ   VOETRDQ         XVOOBCQVVHGYD   KSPXVYR        
EOKARVBGSRS     : FTSAUTGJI       SCKUA           JJEX            GKTENXEKCFEXAB 
QAABJLYHUFSF    : MUMMPKROJ       YYHWUSLPLKBP    OFYYJKRT        IYVQPGOT        EJCFYDUCNFPHCQV
XEPEMWKB        : GRHSRJMLYQLUX   BGIBFVAYOACR    UUFBWXHICT      ADRHFTMQACYQ   
KSENBYFTBYU     : KJXWQAXQWCIT    RIMQTY          EFVFXXPB        EYTN            ANYGNCCUVAVAACD
AGOBPJGIQV      : WSCDWYIQKVTDQ   RKXRFWLCDU      CEVMJSUO       
VOMIL           : WTQMHFUQ        KUWVWFADUJQNRI  NNGI            KVQLPYSLHXXDWT 
MVIFAWHYED      : GVYVJSPINHT     ESIWLREYFDLIYW  GMGG            CHYLBYOHOBRHB  
DAFFGUIXGOG     : PGMYDMISFOIQ    IRYYICHPLK      VCNK           
NMTEAERAQOI     : JOSIDR          THIPQ           UVIBDKMEAEKWXE 
OHIQOLUTO       : BNBIQPSWOXLNYMD AEUIKWFKJUHBT  
AWXIVEACEPR     : MNDNRUCOLJAU    VBHBHLTKEU     
TTFNTXCEWTMHMD  : URQIVB          WEXXA           EWUUAHXVVPYLOL  PERVJTYBVRD     JYES            VYIRAMEPWFS    
HWKKYHIKDPKGVC  : LWKJJWK         APBEPWBUH       HOIS            GFVGFJV         FPOL            ISYCYGPTCXTIGU  KWSVXHJK        ITQIVQTFGIR    
WXRCLNAORAK     : DLVWRHVLRGNJKC  UQTIILKR       
