OWYFLG          : KHFBRDFMCNQGAJ  HUXLB           MCQOCTK         HQWXCFPUVM      LLWAACHCIJQ     IJJVDYHERQCQIH  TORKUSP        
IMUSKTUBFSX     : MFAEFCWHERM     ARCIYMEGGJEVOI  DFQB           
UCMSBM          : CMDDC           TAHOKSPFJULPEHG ESOCEPKTUCCOBS  CSKIYJLO        LNQMRXMANTLKBVE TORKUSP        
MKBMSRJTWUDBF   : HTKPOIOJ        FFPLBLYNXWGHXBH VAPA            LWGFT           MJTDBUVYXL      HMEMOFFAE      
VXCPTDWODDL     : HHCTTFELLRMIDFU CIYHHMGNMIKUA   TYXEOLRBD      
PEHCCVOGIIASE   : BTKMSMYSCKXV    VWUAK           GGSIDMIBJDBB   
PHBVAWVCMR      : SXAYLGYBBJB     OGULMNV         GENBKGWLIFQ    
LGJORPE         : ILFLBKBCPXLLGU  TETTGCYNVJCL    PPGCYWWEVUCSKR  WMVL           
YJBWXJFIKANKSUL : XCSAMJUDPGEB    OIPVCCTF        TERNCUIAGW      CCCQIDHTVXII   
WKMAYFIKNR      : SXHK            VVEJHWVKYYNM   
GJGFKPIHQSP     : KYSSJLHRH       LNHUDQYH        UCAFIHPBW      
FROPKMDBJNQL    : HIWKSLEEBK      GEJKHGITKMLBW   CVDMGPWEQAPAX  
XTWLMYTXGBLVMSM : KRTFADELKK      GJVNAFLFX       MMDREAXU        GYFXL           XTOVATPDB      
KOMDFEPRJTCWK   : UJWAMXML        JNOXBVQUOF      UUUUBLU        
JKKI            : SIANUJGAVEMBI   QAPHYFCMC       KIXXAJJXW      
YIUWQVKMKECR    : NLIATWLR        YXUQRLSMQMEIQ   MYXQ            URCS           
SGVXKMQT        : VEQU            RTEMHPVHEDVLR   VLVOUF          YXLMUKBLCJSK    LDYVEHW         DAUIYAGYOAR    
USSKEFUPDVX     : AGMWGNDL        IVTP            MCAB            NBHCYEGQMVHC    HUUNIBJE       
TQWGF           : ICSUOGIREE      EBIOMNEMHVJN   
MJCECIABV       : SIANUJGAVEMBI   YVYOJBQGGKAIVVA CBLOVLILCNW     KUCJQYNGAF     
TRWQNPDRU       : QCKNSIOP        AIHYQ           LUPRKQTUHI      WLQRNCPTBDBK    UMGGRARDSOVTE   MYFRRLXRM       KTHYT          
HBWHYSXXAGIMP   : DKADFKRVXUKJRUX XNHAPUTAXGYS    SKDBVQJO        RPHXCKDYGWGSEB 
QSUTVSIRLGIBXL  : ARLFAGENBIFYQDN EKLH            GYRJOAI         JGJOSUMEO      
VMDYMMAFLYFRHSJ : KLQTYYD         QOYRMBVUFANHECM WIVDOPTDGAX     TPTIILCYMGNNRDM
LCOFXKQRXYAYYOR : KYSSJLHRH       THQBCWHBPD      HYQCMWCUP       GFTJTJAK        TMVEPVGRJ       HUUNIBJE        CAJEEMRKXYTEEV  CCCQIDHTVXII   
LCOFXKQRXYAYYOR : XLCGU          
DWTPKUVX        : NLSW            KUGCPCBIMS      EETSMIITAOEVWGV KXTGXCW        
BRFVBYIE        : SIMQPRD         XCSAMJUDPGEB    YXSCRPUIQMVS    VRITG          
NEAGWX          : VDJMXIXM        QVXIMSUDF       MPMKQMI         KRNLYUOT        MYIIOLJMXNOFUJF
YWFNRCRO        : LVIXXXGADIUTL   OAAANSBGGFC     VKBXQCXOEUVGD  
HYVDY           : NNRUSWDXVM      DSTSQ           WLBPOG          IDTGBUTHUB      VLWCWEULIMAY    AMTSJ          
HQWDSVLYLCFMKC  : PJQRVWELKM      NQSHSIUWRUBRYY  YPJNTVNOURYBV   XFMMWBBPWWBUCMR
QCKVRCXJQWT     : LFONIODDTFMQU   IDGDE           LFKGKOGWOBOJI   QOYPUVPGCXUUC  
UYRMGLLMEHADV   : YSPUQPEKGD      NGLPYNA         XOLQQHYHJGAAO   HJKLVYDSMRQ     SNJYGSSJPC     
IKPNWGRHELJEVDE : VCCQQGVXWKGAW   GVWAUSVL       
XYQRMADAOHIQM   : HMNQGITUCDHR    CXNHQIQWAHF     AWWKAIYEPRB    
VXSNNPVFAAQLGOO : LYFFTKOCQG      RWGK            OQGOK           MVTTYKOYQHF     EILMMDNFWH     
IOKCHY          : AJCTBKSC        ENAMNVI         IOEIOWRMRERBLE  VOWIKUF         KPBALGCHLMP     SMGBKJELDVJ    
KYSSJLHRH       : GJGFKPIHQSP     LCOFXKQRXYAYYOR WKYNV           SWUEMHNTHUUD    CVISGBEPM       XJHXJGLGAPHIIQA
KWSB            : RQXBTSXYY       GLGUSIL         UEHJHTERIUKY   
ADUTOCIG        : ESUJSLEFJQR     GLIF           
TUYVCX          : NNRUSWDXVM      JHDQWMBCMM      MGVSGTPJN       KQGEIFSOD       TORKUSP        
NAUIJGRE        : DCCV            UKCBWXJBBRQKWH 
AONS            : THHFGLVJDHR     PNWQE           KAUQJWLN        PPVSBMGQCVQGJX 
HVUCPKGASTTNS   : KFICFALXEKBD    SPKEQCLJ        FWRQRQSHKNTHF  
QTRGTMOFVIJMI   : APGS            MFAEFCWHERM     BBKO            LNUSUKIFHX      QWPOHGQJCSL    
AESJAQ          : BVMGGDTAAEINA   NFTSNCV         OVUOEWAVMLWH    VBQUDEVLFB      TCWXCSCDW       OAAANSBGGFC    
RDUTVQQJKIAG    : HNBALKLYARXENH  MSSTCEHAOCL     HMEMOFFAE       BIORTN          EMXFYYOJAUTAWUR
ICRYHNIT        : BHJXRNCANLMTX   QRWQW           BXRRGGFRDHYPIBE OPOXCLEWRY      JSVTMMSGSLPSLC 
QUDUPOWGDOJBLF  : GDOUJEK         GBXIDA          RUGQBSIVECNHP   VLWCWEULIMAY    DSGLPITMU       GDVHX           USUAIFGPND      FFRGDKPC       
CPEMRKPB        : ILFLBKBCPXLLGU  YUUUHRPUFPGCYQ  CNTS            LYMTUBQRGBQBHX  GEJKHGITKMLBW  
ICWXKQYCNEYD    : RTEMHPVHEDVLR   QAOAXJQV        YLDYQADPUGW     KUDNCJBHG       LORHIPXKCWBYVLE
WKYNV           : KYSSJLHRH       YJYVVDLBVPT     RCHKNCJB       
BCTFRYSL        : LNAOFPCKCW      PKTWFCBEGOA     DAVSLFSEHGU     HLOOMSTVJVFLWJT
KOYURXTEO       : OGXXE           HREGOVSPMBWUE   WSJJTYOSTNNPIK  EKLH            STGVSBKEHUTMM   DLGFILQ         LQRTQYENBJPYAR 
IEYIHTHTSWQUYU  : MQAXHHBMYS      EPGNQPXUIU     
EOQYACK         : HWEWKICOPQYREWG WFFGXTFX        XBSUKOTEPOQOTI 
DFJB            : JDAC            VUSFW          
NRVWVUHG        : CYDGMNVJYGNFO   TJUBGLPBAYFCDW  UKCBWXJBBRQKWH  AMTSJ          
QCKNSIOP        : TRWQNPDRU       BHKGLAJJYXFK    HFSXGAFFADJKIQ  PRIXC           EGFFTPI         CEREOXUCPLIYD  
VEQU            : SGVXKMQT        SINESNEX        HKPUSHY         HEJFWTF         JGJOSUMEO      
SHYY            : LQJWLCJKWGAV    KEBYXLNR        SRBBECPVCSPJNAY WVNOAJCGJIJFSJG SHYITAKYKEOGYEK
IAQXSNWQKEWCUAP : SRGNWGTTS       PFKAK          
UXALVVROTYJDX   : KXOURT          RCGXRHVPJX      TUQM            OBFSWO          EBBMTA         
SGJMHECEWMLU    : UKCB            PEHKNUANX       TLFXVWSXOQPAVD  LRJBEXOPTBGNUR  EEINFPAMQDDGS   JLEWHYHSIFFPO  
GWHRTFUHDSARMB  : YWLGPSFW        UMXKKN          XDQGJEITMH      HUCEYUHTXSBSMV  AMISHV         
SAKNGV          : CITHGIK         XBPNBNJJCYF     GMEUSFRNPSRLYLL
PCCUY           : NCFXK           KDIPRHFTDYRNTDE QRPAKIHEMYJ     HYYSOPIVJLPD   
GVJO            : RFBNJYLHAY      KYLTWQMD        FALRNVGQPPAQLR  LDYVEHW        
SJPXEYDW        : OGULMNV         TFGTHXMRYYBTSW  TIAETTMYO       QURVFXCJCMHVTVI
WMDXHDK         : UQWYJSQDYGTHJQC XGVPO          
LIVEKAYMTH      : HPPMXTYQRIDWSR  KIRBQAXSHV      SHWHWTTOKOWTCHY MUTWFNPLYJHQL   SDTYQQOOYL     
FXEXHV          : RFAWBWTYVMIRJA  CDPLNRRRBNOPHSG JTPK            IDTGBUTHUB      PYYOPJKLMHLOYQN
NWBNYXCEYJJLEWU : UHRGDYPV        ELNKFJRKJFIUHT  RNVRMUT         DRJPKRKERO      OSEVGUUTI       WLBPOG         
BHDATWJDDIJ     : OTJG            SUCLKYBBGBDBFQC QHNAVPBW        SDXSARWY       
RFCGCDTDEVHF    : TRCBBTFGXEHTV   DQXBPXYAYXK     CSKIYJLO       
QQLQNO          : FONDGFUAO       JHDQWMBCMM      FFPLBLYNXWGHXBH FHABEKFX        XGXIOEVPNHDT   
VRSROEW         : VNILGD          EILMMDNFWH      MIADYDXXO       RPRFDU         
MGXF            : XYCADASL       
ANSFJXLFG       : CJXNGU          HNMLSWDUNY      OERTLGGEHXDYW   JWSHTIB         LDVRQXTI        AKTTCNGOFFDPJLF
MYKAPXOIVG      : SHRFYG          YUOROWRMD       IHMLBPAO        JYPM            EBIOMNEMHVJN   
OXJNTYUR        : CYDGMNVJYGNFO   KDRJBQ          STWOIKH         PMGGKNXIRLFIBN  KWYYYINCE      
KRTFADELKK      : XTWLMYTXGBLVMSM EUOBGCBWJMMM    CNTS            VHCPTG          BQJVCSOVCSMVD  
YLNYE           : IHFYNH          JLJLGBIKPDT     TFGTHXMRYYBTSW  AAOBBDPFVKVHC   OKGMCYOAYHEKHMI BBTCSTHPFCBRA  
OOKWTBWDORC     : XGMQN           XMUGSP          QEDXIB         
JKWEE           : ISBJCWVF        BSVK            GJQVVRUOBKX     PFKQNYRG       
EJGRVSWUHKWNBN  : VQUADN          WYTOGS          OKMSKDCXOVGXEB 
LKVOIBDAG       : RQXBTSXYY       PJQRVWELKM      FMRJ            HJKLVYDSMRQ     BLSLDVVYKGFMYFH OVUIMG          ALJUANAV       
LQOPXS          : YSLBGIJGYSEFT   GRDSHKCR        FGLYVGHDTIJRSAV
JCOGWLDGYATA    : GNJVTE          TYGQGYUHX      
VNBTELVHNEYY    : DUIGMPAPTNIKJYM VWPPB           UNWCUQLO       
PRULNFP         : ICFKWPREB       YRHP            OJYGHBPIBRTCP   PUJKASXHGNFP    VVXLAVWC       
LOQO            : JVHY           
RRPRHOHIIL      : MJBQNAIOKRT     YFAEIMNQFIVAL   EPGNQPXUIU      WCEJJWYLCICPL  
GUJKWLIMDDASKPX : ITRK            WUFJXSDJKMM     IMOIXLKLLCTJJPU PMXP           
FONDGFUAO       : QQLQNO          JSROCQNFHEDHVGF
JXUUTBPGOM      : NJQYBLD         THHFGLVJDHR     QIYLAQXVCO     
YCWECPPUN       : HDXBFTNOSACJ    TDYF            DGTFBTNGLBIWCX  RIBRTOFLNFD     GWUHLR         
CEBH            : GYFXL           SEJARDLOKXTQQ   DVRNIGOHPYLUJWW NGWNUXQ         UUUUBLU        
ICMXMVXHSTK     : ELNKFJRKJFIUHT  RJDSO           DIDJYUINJO      NQHRA           FRFGCHFLXXTD   
CBATCCQH        : XDGCTTQCXSMJ    GVKRTIMXKVW     WYTOGS          UMGGRARDSOVTE   WCFWHTPYUCUTO   WIVDOPTDGAX    
HWEWKICOPQYREWG : EOQYACK         AKORWLMLC       AMTSJ          
WNXTBJV         : JVMRFBAISD      GCHGKS          BIORTN          XDAB            LNTQXYPBIY     
JQHOJOVS        : QAGWDTCL        QTEVXCQKA       QOIGBQIA        CRQCERYP        OUVQQFJ         MCVYBLNTBYVCEF 
CQXKUOALOTRNBWN : QJFFOQHB        YWLGPSFW        JEPOHYAQN       ENYEQSFTXPJTF  
UHRGDYPV        : NWBNYXCEYJJLEWU LFDRSQQMB       GRFRPQV         YKYULB          MYIIOLJMXNOFUJF
GGWCB           : KOVAKP          OKQKYBROJR      IPTN           
GTKQQCSDQPWGQ   : GJVNAFLFX       IFIIDXVWBQDE    JRGES           JSRDG           FPHEUG         
THQBCWHBPD      : LCOFXKQRXYAYYOR JXUYTEOPNBSNNYK PEAVIRRNMKW     JGJOSUMEO      
VLGBPSJJFDBHX   : EYTOJAIVPXECFWV LVUGMOAUR      
XNDHEABO        : QEARS          
FQSOTKTFIINLXGV : NFNOVNMB        EYORFEFVCYH     YTCY            JDWY           
LYKTWQTLWDR     : PVOQW           XMBVLPCGNRP     RFBJ            WDYWN          
HGTOY           : GBKGSOBDFQNGBKN MOFWBWVPJMDWC   KOUEQPBRBWSTA  
DSYWAIFNTF      : FSMASIB         OOBTLANDB       WUFJXSDJKMM    
PNIQAEORACQ     : CDOKJOBL        GRYJNGCVDCV     GGNKDYANDJY     UYFBD           JMFWXPVBHPBSGGV
TPLDLACBDXA     : SIANUJGAVEMBI   EGPYQIY        
XIKMFPIWFQOGWFA : CMSHYUPIUKDNFQ  UWEUQPDOFJXAYR  KRNJ            QAOAXJQV        RSOIRQCQYNLI    OBRQ           
HQCD            : DWGG            JKPVCQLKSYSMETB
NGTPJUUJXW      : EQHNPRRLDVAKDW  YQJIORNWOFYH    JAXMULFGGETQNND
GJVNAFLFX       : XTWLMYTXGBLVMSM GTKQQCSDQPWGQ   VINXWVXRYWPVFPF YJYVVDLBVPT     OQUQ            LXONUKOQT       NOGQ           
NVHN            : RKATTBIA        RBHXFEKDXBDVCJ 
QEVVOLDJ        : RWOMG           ISWL            NWRWWNBI        RBHXFEKDXBDVCJ 
OGXXE           : KOYURXTEO       AVWMGU          CGMBV           KKPWO          
HNHEDHJOOHSD    : JPTXFSU         RNVC            UFTSEO          ROFPM           YHVAH          
CSYSX           : FTURY           TKOQFTFK       
ROIUALLH        : KPBALGCHLMP     TREKP          
LNHUDQYH        : GJGFKPIHQSP     FTRJXOJC        DKADFKRVXUKJRUX XFXFKWCFYVPC   
KXOURT          : UXALVVROTYJDX   MCRREONYDUHDOGN FSMASIB         JDIQDLJHQRK     NGMDSBLMPXBKT  
TNAPNW          : HMFPVMI         KGXGAWGEEKIDSQ  PVLQGKSRTWWTTRH KKSQG           GTXDTBBDKPSNU  
CIEDV           : PNVTN           JMTIUV          FSGEAYKY       
MGDCPXGGANG     : YDGCEUYCPRFPYGD CEPKNLJ         MUNG            BTBEVOCWYQXJ    DAUIYAGYOAR    
LWHDRKA         : GANCTHACR       BEHBN           SRUJC           XFMXY          
KRSJYWTFCQWOYCT : OLSHH           CGMGFS          YDKSICDGOGFOS  
AAWAPFNBCWHT    : IASYUYNIHRVVQB  DYNMFYC         JUNCGRJDVSBPT  
HBTB            : ENAMNVI         PQOCUFQRQCGW    NDJLYQKU        IOEIOWRMRERBLE  SDTYQQOOYL      JAXMULFGGETQNND PLYIPVMD       
EATXHXQ         : NDJLYQKU        NXAQWJXEIH      OUVQQFJ         NSGE           
PPGJ            : KBQJWEIQURFVFPL GHJPJLYOSMRXI   SYEYTDY         LFCHQNWH        WWRYIVHML       BQJVCSOVCSMVD  
ILFLBKBCPXLLGU  : LGJORPE         CPEMRKPB        BPNCAUFRTCLV    HJBG            RJDSO           HJQUOU          BMQGVTFMJVTY   
AVLGXHHFGXLVO   : AIHYQ           TFMFWGRQHEW     CDNDBFGJFC      WWRYIVHML      
HWDSDQTP        : JYPM            UNODVUVFB       LNTQXYPBIY     
XFPKTXFJ        : FPFEDDSRQQSMC   HNBALKLYARXENH  ALJUANAV       
EUHC            : BXWYAMLROIOMJTC IHMLBPAO        DIDJYUINJO      LGFIPPYXJ       LFCVXMRWORA    
QILPVJGQSD      : XKQFTXPTQU      PSLCEVTNNQLDX   KSHIBDLIMESIFK 
LIOFYGD         : CDNDBFGJFC      SXKFEYHEYPYHRL  ENADRSXYMVR    
XPAWXJACHH      : RJISFKWKFCN     BLNV            GSQEIVXUEYH     BBKO           
OYOCQL          : QBIDAQ          AJTIXDNQ        ESADMDKWMQGMON  BIIUWOEIQH     
YEEECRNQYO      : NFTSNCV         JJVSNWIMEBAON   USXRGFEDSAQ     WSPFACIJQXTSTLF
EUWUVVSHVUQEY   : UYXWCKRJBUPQW   XMEXBIELEABS    JYRPQTQXCQBL   
FQHXCUWIBBKSQ   : NLRLLHQVFJU     FBUTEOC         PQOCUFQRQCGW    WUFJXSDJKMM     WXIQM           BSSOKRMIC       HJYKHIGC        FIVRFFSESLEHVI 
FQHXCUWIBBKSQ   : GWSYWJO        
RFAWBWTYVMIRJA  : FXEXHV          HFLMIYD         RXGRLD          LXONUKOQT       KPBALGCHLMP     CEREOXUCPLIYD   QEARS           XUQHKFP        
KHFBRDFMCNQGAJ  : OWYFLG          OCFBTQ          STCAFNYWA       BHJXRNCANLMTX   CVISGBEPM       AARSRVGUPR     
DEFFDIF         : EUIAJ           IOEIOWRMRERBLE  HUCEYUHTXSBSMV  RPUWJRBGS      
HBLRS           : FFNNCSIFEKK     SYSGGJPFAPCCIVX RXFFRMMIJ       VHCPTG          XKQFTXPTQU      XRTTBTCAPOPCTXJ PKAICDWVMIXFD  
TRHCYJVD        : LVUGMOAUR       DTNAGRVUEFQEOJL
IHFYNH          : YLNYE           SXTFAQHMV       KMDQJHBSOUX     CYLHABXU        FMDKVLK        
NNRUSWDXVM      : HYVDY           TUYVCX          SOLAYFJYXKYW    XYLCQYVROQYN   
JGUG            : TSNHIXR         SHWHWTTOKOWTCHY OUVQQFJ         PSLCEVTNNQLDX  
ONFNWBSO        : ESOCEPKTUCCOBS  OUILQVNIJRQVDJF
BVNQFB          : IFIIDXVWBQDE    UBDCQUQHROYU    LHXBQPMDN      
SSDMRGMNUOY     : LFDRSQQMB       AEDXG           AUAQVMXNCX      OKGMCYOAYHEKHMI
LFFAS           : AMOKCDVS        CCDGQELD        LFDRSQQMB       MGVSGTPJN      
PSLLJYOH        : HMNQGITUCDHR    EPPW            KWYYYINCE      
HMNQGITUCDHR    : XYQRMADAOHIQM   PSLLJYOH        DOODHOE         LFONIODDTFMQU   PEHKNUANX       MDQD            LLWAACHCIJQ     NSGE           
XQCJVH          : WNUQCKKBUQAP    OKMSKDCXOVGXEB 
RTEMHPVHEDVLR   : SGVXKMQT        ICWXKQYCNEYD    DAYCUVCT        UOGFKSCVPWELFF 
EXWYUACDREDL    : UPXUDMVSHRBTWX  HPPMXTYQRIDWSR  OCRYVCHK        FHUEOOGUA      
NJQYBLD         : JXUUTBPGOM      SOMQPYU         HNHWH          
SULCYQYNJ       : VMXJBGI         RTKIKRFSJKVGNM  PTAXNNVWTPUWVCA KVAMW           YGBPEOTSTOON    MYAHXED         TORKUSP        
RJISFKWKFCN     : XPAWXJACHH      YSXLACWFA      
JDAC            : DFJB            IHLD            XDUT            CEPKNLJ         UREYJVYKSDPKY  
EPIRJEGNFW      : CKPID           FFPLBLYNXWGHXBH DHAS            XONVPQGV        PRRIUYOBLEMJFI 
SIANUJGAVEMBI   : JKKI            MJCECIABV       TPLDLACBDXA     LNDCT           XFMBMRLPIBFMSHF KVAMW           LKQYHOD         AYFSLCSACWEYSD 
SIANUJGAVEMBI   : CHHHFJXVFC      ENYEQSFTXPJTF  
RTGSVLYM        : QWEAXAQOK       VRWB            YHVAH          
SXAYLGYBBJB     : PHBVAWVCMR      GNJIEAPP        UEUBOIOELCJ     CXPILLRIHH     
EMXGJESMMVF     : JWIMCGNQHVYDHG  FXSDXWUIXGJN    OUQMW           OAOPEYXEVVTBV  
EAEPYSJRSM      : JREHFTBDQ       JALUYW          KAUQJWLN        ULFKBY         
HSSITCL         : JBCVCPEWII      PPGCYWWEVUCSKR  JTFKFU         
JBLPMRJYGH      : ESOCEPKTUCCOBS  MRVSLWDHKVN     HTPYICOPMQCH   
OLGUBHO         : KDNSBWDXROP     UCLIDEW         QKIMNGVKMN      YMHUBDY         AHUMBRNYKUHXY   QEARS           UNODVUVFB      
CJYVQTQBQUPE    : WBFIVE          RKATTBIA        UYTL            XNYBDXUBV       OBABJSSUE      
QRUDJGERNLGB    : YDGCEUYCPRFPYGD WWBXBTXVCUPNLGM
BEERSGEUEUOWYHR : SXTFAQHMV       IHLD            UOHKLU         
LYFFTKOCQG      : VXSNNPVFAAQLGOO XJHXJGLGAPHIIQA WYTOGS          XFMMWBBPWWBUCMR
EOSYSYDKRL      : YQEGYENFGI     
MROEONLICAHJFD  : ONRQRWYRCAHYAYW PYYUBSCQ        OPGTUYMNQ       RJYS            MPKFGGN         DINSYVUPVLETQ  
WFOFWTURSNQXAJL : SINESNEX        OTIMKMXEQFLM    QOEKPXYHX       ORYEXIVBAYT     WKCVOLGUAJQFT  
XDGCTTQCXSMJ    : CBATCCQH        HVLFIUMOOO      RQDEBOIWVM     
PHWXVDWPAP      : EFRANSGDHIJK    VMPJAXRKNJLNVK  HXTODPWVBSXDR   DTMPPFKFSR      JMFWXPVBHPBSGGV
NGINRTHQYNUS    : DGJFQ           QLAPDLAUEM     
NVJGISJAAGXW    : TIRMDY          GCDE            TIKORUNOYOPXR  
VMLNX           : SAONALYPC       KRNLYUOT        HJKLVYDSMRQ     SHEIOEAKYCKH    HOWI           
TIRMDY          : NVJGISJAAGXW    DENQNUQ         JHDQWMBCMM      DWGG            TNYMYKHAAC      NOQQJFWN        SVXOMAYOCLOECV 
ENAXYOTJWECG    : CKPID           WNUQCKKBUQAP    PXDXEMVQEQBSO   NPOEIROOPNASG   ACWD            STLTGTPM       
FPFEDDSRQQSMC   : XFPKTXFJ        YNXOYRLBWCE     MLLRFGD         USUAIFGPND     
BHKGLAJJYXFK    : QCKNSIOP        FAICXT          LRHDHLTI        BVBXVXYMKEDH    EOFC           
JPEQUVXYYDRSVLM : ICFKWPREB       AKORWLMLC       GANCTHACR       QPSXXXCD        OHOCUJC        
PYMW            : GLGUSIL         UOBANUIAQJ     
SINESNEX        : VEQU            WFOFWTURSNQXAJL UKCB            XJJAM           RNXTIASJPML     GETUDF         
CKPID           : EPIRJEGNFW      ENAXYOTJWECG    MIYDDMWYQW     
EDLFGGYCRNM     : XSXIUELJCR      UYWPVEGXSXCXB  
OYGBUOOYHEEIFGU : JCCJQVWBASHCNNQ MLDXOCUVBVJ     PSEIYHDC        HJQUOU         
QAGWDTCL        : JQHOJOVS        TXVH            SHGSISTRNIFAJWE
DPTQ            : FDIG            GPUAFP          MMDREAXU        KKPWO          
DGEJJYYXAIDESKM : DVUGLWLFU       BIORTN         
FFNNCSIFEKK     : HBLRS           EQHNPRRLDVAKDW  PROUBXWVYHX     WWRLLQAQIPCWER 
FCYIKD          : XGBQBPB         LPAVIFKXSRTG    MYYMHHXSNKTA    PPJNGTOLMSVERJD BLSLDVVYKGFMYFH EAJTQXSWRKKREXC
TETTGCYNVJCL    : LGJORPE         KVMMONGHOA      AAGJNIUVG      
ICFKWPREB       : PRULNFP         JPEQUVXYYDRSVLM MWQYAKFGU       LMYUGPFMTWACS   GGNKDYANDJY     MWIBVXPB        UGOKDBQNY      
AIHYQ           : TRWQNPDRU       AVLGXHHFGXLVO   GETUDF          WCFWHTPYUCUTO   AWQG           
ELNKFJRKJFIUHT  : NWBNYXCEYJJLEWU ICMXMVXHSTK     HAFS            QUPMGNXXXU      PWKRFDLUKMAII  
RXUDVMWCNACVJ   : PICGJWTUDRDI    GELBQLPORLGIGFV NEWM           
PDIBSTHDNTOSCJ  : SNJOMNHPRH     
XYWWTAUI        : UWSWSXBQNJ      QSRWLDCK       
WYAYULDMPMOKI   : MSITSYCGWQAGCX  TOCKCYMACOEG    PCIXFUYXSMBWL  
PVREQVQSTRPS    : GDOUJEK         WFFGXTFX        YQBXYMCDHDBXGEF
RNVRMUT         : NWBNYXCEYJJLEWU BTKMSMYSCKXV    OYRXWVUBW       NLQVWOGFHJH     PTAXNNVWTPUWVCA HJYKHIGC        NEWM           
SHRFYG          : MYKAPXOIVG      RJLX            UOHKLU          BTUGIXAWXWSQP  
KOVAKP          : GGWCB           GELBQLPORLGIGFV XCME           
BLAWGROYFJPBDEY : UPKGADKFMDFJE   ICYXOLBNPJTD    HAFS            YFAEIMNQFIVAL   HXWIQQHVKFRSKCV
SRGNWGTTS       : IAQXSNWQKEWCUAP MTXLABCUVYF     PTWIAJ         
PUXGCCTCB       : MCQOCTK         INYPADFATD      DDXE            VRITG          
TRCBBTFGXEHTV   : RFCGCDTDEVHF    DOODHOE         ICHRM           VWUAK          
HUWDORQH        : IMFKCXYVMWCKJ   LIHQSFU         WKCVOLGUAJQFT  
PPPRLTSMQKQROKW : UNHSBHY         UNYHPKCHP      
KBFEYVNUS       : YUOROWRMD      
LMKS            : NBTUNOA         QTMAOYA         KNRJAHS         BQUQLMEMAP     
AKORWLMLC       : HWEWKICOPQYREWG JPEQUVXYYDRSVLM TYUYTNUHBAJXF   WYYTBMSYSNO     TLRXYCMWBSGS   
ETOQT           : UVVSCHRT        EUOBGCBWJMMM    ULNUQFRSKO      SBUAKIDMLPYI    GWUHLR          GWSYWJO         UNODVUVFB      
BUSIUOXPJRBVD   : SWUEMHNTHUUD    TGHYESXR        EKRFQKKW       
VDJMXIXM        : NEAGWX          PYYOPJKLMHLOYQN BIHELFAM        JXDGMCRD       
AMCWDSQRW       : LPKKLJQIYMBTOG  VCCQQGVXWKGAW   MQKDMLT         PIFPDCTYGHECIDN
KFICFALXEKBD    : HVUCPKGASTTNS   RYODEMQEALOALI  DIDJYUINJO      YPJNTVNOURYBV  
GOUGATTVVIY     : OTHQFDSCDOR     KUDNCJBHG       OSFGRVEWDMUSOOO
OTJG            : BHDATWJDDIJ     JBKXREBARVRIVYH LKMQGEVOWS      LYXWWUXF        EMXFYYOJAUTAWUR
XSXIUELJCR      : EDLFGGYCRNM     SXHK            RNDHDR          AJNLGSJPIWQCKJG WVNOAJCGJIJFSJG JTWTTQ         
FWCNLWUNSQKPBL  : MSPRMVJO        MCRREONYDUHDOGN WFFGXTFX        CMUKVCDJQIYGEPI
PFUXYSRWDODQAFI : SXHK            AXENMUP         DIWEQCVEKU      REJLAUTKOYGXL   JYPM            LTQB           
MHXBVXXJQQVI    : LNAOFPCKCW      XXNLRH          EGGHW          
HTKPOIOJ        : MKBMSRJTWUDBF   UYWPVEGXSXCXB  
NMTRGVYQS       : VMLE            NSEDUBKOWKXD    OPOXCLEWRY      YOWKEKXRJ      
YSPUQPEKGD      : UYRMGLLMEHADV   BUSSSGLL        DHHCTBJAMFKY   
AMOKCDVS        : LFFAS           EHNDITXYE       QKIMNGVKMN      MXVAEBUCCSWRLR 
AJCTBKSC        : IOKCHY          UXVYG          
LOAEGWXVEKEH    : SOMQPYU         NWRWWNBI        OTBXWLNB       
FTURY           : CSYSX           LYDVFHOPHWTP    QQWF           
PRPQBTMEE       : RRERJ           EGFUWPA         SPRCHRH        
HFSXGAFFADJKIQ  : QCKNSIOP        NXAQWJXEIH     
PLOJKPAEHSI     : DUSTXGHTQ       UMJDPYNIBADF   
HMFPVMI         : TNAPNW          ILDBSVBQGC     
UKCB            : SGJMHECEWMLU    SINESNEX        GXTUGGUEERI    
HKUPCPHP        : YKSHIXWCYYYBG   OJAXELICG      
RAVTGDMO        : SOLAYFJYXKYW    BQUQLMEMAP     
TENLCBWYV       : RDPU            QFVGRWDSNUDQ    JXDGMCRD        XONVPQGV        JXUYTEOPNBSNNYK MQKDMLT         VSUFWNFVMKXQ   
DWSLIPD         : MTDSDAGSEOC     YBSLAPURIU      XJJAM           WMMWQXW         XEBBFLGAS      
FLCKDEIWKOLCUHI : SEMTFDHIGMGQ    CIYHHMGNMIKUA   UEUBOIOELCJ    
TKMQM           : NTQUPCOFWUC     REJLAUTKOYGXL   MQKDMLT        
APGS            : QTRGTMOFVIJMI   LXTDLFXILFED    PROUBXWVYHX     HRTNFL         
QJFFOQHB        : CQXKUOALOTRNBWN MKQESBPDDBM     MFKQAWBPYCJDKO  JYRPQTQXCQBL    XTIAHSDV        LFCVXMRWORA    
NKUABGCVNMHJA   : KJSEYYJHQNNTRDT RXUGUTLPOWJCDQ  JSEVOJ          SRBBECPVCSPJNAY SNJOMNHPRH     
CMDDC           : UCMSBM          QBCSCYKEYM     
VGEHLJYES       : PSMKYSBX        OSEVGUUTI      
AGMWGNDL        : USSKEFUPDVX     DQCKCKOAIN     
SXTFAQHMV       : IHFYNH          BEERSGEUEUOWYHR IIUVVUSU        PLPPIPDHKX      KEYGHSAO       
RJLX            : SHRFYG          BQIBPSOPSMOKOL  HUKQI           NOGQ            KPCDYULJE      
SLYRPRURAJOGXTR : QMUWCWC         AYFSLCSACWEYSD  XEBBFLGAS       SFAWJYWBT       DLGFILQ        
MSITSYCGWQAGCX  : WYAYULDMPMOKI   TIAETTMYO       KMDQJHBSOUX     QIMBMPABTEUI    NSGE           
VJWPBQMSQWHX    : RGDBUIYXLPAH    YNBI            QTWHUSWMBSPO    VWYHMSMWCQHDTFJ
DRJPKRKERO      : NWBNYXCEYJJLEWU MJBQNAIOKRT     JKBKDSYFFUWTWPJ MSPQDFGG       
QFOXIMTGXTXBKNT : JPTXFSU         QVXVAOQTXIK     XCME            QHNAVPBW       
KDCHG           : HVLFIUMOOO      SEMTFDHIGMGQ    EPKMGOXRXRJK    VDIITQFIRT     
SXHK            : WKMAYFIKNR      XSXIUELJCR      PFUXYSRWDODQAFI TFGTHXMRYYBTSW  YHGABGY        
NEYCV           : TRUITQHMOXHQUE  XRTTBTCAPOPCTXJ NQIQMKYUHV     
QVRFPX          : UBDCQUQHROYU    WGWTFVR         DJLFRWUUYVD    
LXGWLCBXF       : CSKIYJLO        PROUBXWVYHX     YSXLACWFA       WVNOAJCGJIJFSJG
HNBALKLYARXENH  : RDUTVQQJKIAG    XFPKTXFJ        PEHKNUANX       WTBS            BUPF            RNVC            DTAM            UWLJLBQHAUIT   
HNBALKLYARXENH  : JKTVPYNTEULK    AIYEBHHXMQAEAC 
JYCCYH          : QRWQW           MJBQNAIOKRT     YUUNBLXULW      DJMETT         
APMLRPMYUTO     : KATXBJJM       
UBJICKACO       : IDKXPHYYEQJ     OLNNKFDGMWE    
KMCJOGLY        : IXJN            CBBHMBCVWTF     BSVK            PCUSDWAPLVFJUYM
LQJWLCJKWGAV    : SHYY            FXWLXM          CVDMGPWEQAPAX  
DGJFQ           : NGINRTHQYNUS    VREMMEU        
HHCTTFELLRMIDFU : VXCPTDWODDL     QMUWCWC         VQGUUECCTS      TMAWVIOOTECN    TMTJPSYKKWJ     RCYQJVA        
QWOCVUESVHYF    : QSRWLDCK        GDOUJEK         LKCULIFM        LNUSUKIFHX     
RQXBTSXYY       : KWSB            LKVOIBDAG       LPAVIFKXSRTG    FXTPW           SVXOMAYOCLOECV  ORYEXIVBAYT     LIJFQLNCPPVOARO AFAUOCETC      
MQXXTDSVWR      : FBUTEOC         JXUYTEOPNBSNNYK BAAQICGJBYSYKT  XPYY           
YNFFGDOHKDBCB   : BPNCAUFRTCLV    LKCULIFM        JLEWHYHSIFFPO  
XVBYUMLNM       : XNHJKWPKGFBTKQO FICGNMHP        VSUFWNFVMKXQ   
HREGOVSPMBWUE   : KOYURXTEO       NOBN            LAMPRGFTRPCI    UCAFIHPBW      
DPQGTULTQMUOBG  : RKXUIVUNC       OREV           
PSMKYSBX        : VGEHLJYES       FYHTD           EGPYQIY         JVHY            KBFMCTGIQC     
TKOQFTFK        : CSYSX           RTKIKRFSJKVGNM  CGUHTVWKOEFXB   UCLIDEW         ROFPM           NYMPYCWTX       EPGNQPXUIU      BAAQICGJBYSYKT 
VTHQFDIUX       : CJXNGU          WINWQELNDPM     KWJISBP         RKYRTUOPWQIUWGR IJRDOTRYT       EWNLDGEREMEDL   EIGXWOENVVNHRY 
XGBQBPB         : FCYIKD          IMFKCXYVMWCKJ   APKXQGFYCNW     PUJKASXHGNFP    TFMAG           HOHHXMIOLCWCLFG SRUJC           NBHCYEGQMVHC   
KEBYXLNR        : SHYY            MPRR            BUSSSGLL       
JWGWSCGKHJUCHT  : WLQRNCPTBDBK    VMLE           
QUTRNU          : WGOHGCMFSP      INEJPHGFBFUSTP  HRTNFL          BLALAVL         FQXXIBPLXKFBQ   KSWMECL         OUHNKIBGHKKAH  
XYVWAJNRDWOLU   : CDHEWGGJFAKIKSO EAXUR           DQXBPXYAYXK     LSWGFUPO        YPJCMHXRIJJM   
NBTUNOA         : LMKS            WUFOQFW         NLHN            YXLMUKBLCJSK    QEYDEHHJ       
IDLGYGTTBRUX    : JHDQWMBCMM      DBOHYOQNMW      SIBBN           RMSBNS          LKMQGEVOWS     
UHDOMCDXYN      : UEUBOIOELCJ     CDRAR           KOWFEWKEXUDTGGR
DHLQWNLHQANPGHL : BXRRGGFRDHYPIBE NRHQWB          MCQOCTK         UEHJHTERIUKY    QIMBMPABTEUI   
CIHTERYUEBYF    : UWEUQPDOFJXAYR  FQCYYKCGQP      WIJHDAMK       
OSEVGUUTI       : NWBNYXCEYJJLEWU VGEHLJYES       QTMAOYA         JIHSFCNTOETIGBJ LORHIPXKCWBYVLE
MKQESBPDDBM     : QJFFOQHB        JMOOABG         PYUJCF          SRBBECPVCSPJNAY PADK           
HEVCJYBQA       : JKBKDSYFFUWTWPJ WEYD            TNGHL          
JGOS            : PEHKNUANX       HVLFIUMOOO      WSJJTYOSTNNPIK  YRHP            ALJUANAV        RYWH           
JMOOABG         : MKQESBPDDBM     DWQLFOXPUADOFTB YBSLAPURIU      UOJCAERBCNW     AOYRYFHCHCBP    LTKWHDOYNL     
UJWAMXML        : KOMDFEPRJTCWK   GLCVNXNRHAATRS  WLBPOG          JALUYW          WBJVSQCHNDW    
THHFGLVJDHR     : AONS            JXUUTBPGOM      RPVINXMRUOGQL   TGTLWJDCYLG    
AXENMUP         : PFUXYSRWDODQAFI NOQQJFWN       
BTKMSMYSCKXV    : PEHCCVOGIIASE   RNVRMUT         POOMOEKPN      
IBDVYO          : MPGTDLGREQFIX  
IGVJGCY         : PLPPIPDHKX      HNYCIKXLMAJWXBM SBJBIDWLLOHNNFR WCHKGOAVEKG     RLUQOAMTJLAQUK 
WQLBM           : UKYMNVBKMVCIUEL AEYYXED         BLALAVL        
NGLPYNA         : UYRMGLLMEHADV   REOGMUYS        JSRDG           ESUJSLEFJQR     RNXTIASJPML     QANGHTIUKK      URUNXWBJSVH    
JWIMCGNQHVYDHG  : EMXGJESMMVF     QPSXXXCD        CNAWKLGVW       BKWRSATO        RMIAS          
GBFWMGMJVSU     : WXIKLVX         DLLXMIQDH      
TKOTTLEINKVGS   : NWBXDQRSLPSK    VUQCTGOBHSO     JEPOHYAQN       CGUHTVWKOEFXB   DBNVYFJBC       QXKNGS         
FXCLG           : RJDSO           WHUAC           JCCJQVWBASHCNNQ
NLIATWLR        : YIUWQVKMKECR    MBMVB           JUNCGRJDVSBPT   NRHQWB          RUGNTOACPJIEGIV JKUMBBIBHHA    
IEJSSGOGKYVXUE  : SPRCHRH         FMDKVLK         PUELDCJDLJJTGFH
PJQRVWELKM      : HQWDSVLYLCFMKC  LKVOIBDAG       BNTXARFY        XQWLXNYNEJVJS  
GLAYBKF         : YXEJWPQI        STWOIKH         RQDEBOIWVM      XEBBFLGAS       TFEEBBJIAFIB    KXTGXCW        
GXTUGGUEERI     : UKCB            KVMMONGHOA      ROPDNVW        
JRODPNIDBWRHJTI : JRGES          
ENAMNVI         : IOKCHY          HBTB           
DFAJ            : WTBS            CTVHCTKQMHYLE  
IHLD            : JDAC            BEERSGEUEUOWYHR BTMQA          
OUJYYKWSUI      : FRJG            ADIVX           LYXWWUXF       
DUSTXGHTQ       : PLOJKPAEHSI     VEPOUEFOO       BYVNPRVU        JMOXBESNHRFMKRM
YXEJWPQI        : GLAYBKF         IHDWTBP         XIBGWA          LRYWXBXJHMNC    EPPXMYJKB      
OARAYSLXL       : CDAOTOKIVAXHQD  EUIAJ           XQBTG           SRFARXW         HUCEYUHTXSBSMV  DFCEEMXRTIDGPW 
GANCTHACR       : LWHDRKA         JPEQUVXYYDRSVLM IVTP            LPKOPEGR        XEBBFLGAS       JTWTTQ         
UVVSCHRT        : ETOQT           VKSUS          
DOODHOE         : HMNQGITUCDHR    TRCBBTFGXEHTV   BLNV            TIVPKFLFLMQK    XFPIOGRGCUEYITB
CDOKJOBL        : PNIQAEORACQ     QMREVEYSYX      KWGAPE          TEEQBUGALOUJ    PKYOXDBTMTET    UNODVUVFB      
INOCMJXKEBRWUR  : PQOQNUGVKDUM    PYUJCF          DTOASCWXMW      JSEVOJ          VKBXQCXOEUVGD  
MGHVWLXAOMMY    : QJVDLHNYBTVGJ   FGDHQ           XLCGU          
NMOYD           : QMBNLDPIQYP     HMEMOFFAE      
BPNCAUFRTCLV    : ILFLBKBCPXLLGU  YNFFGDOHKDBCB   XDQGJEITMH      LASHVOGGDIWM    BPALQDWBSDUBJ   YHVAH           YPJCMHXRIJJM   
TDKQOLQGXGHATTP : OMWUHQQYRDWFO   EFQTPQSJ        RLUQOAMTJLAQUK  DCLBENIC       
YVYOJBQGGKAIVVA : MJCECIABV       YMHQXAWWGGYDAQX SPUSDWC         DNMOALWJHM      YPHSVNX         UKCBWXJBBRQKWH 
YMHQXAWWGGYDAQX : YVYOJBQGGKAIVVA
MWQYAKFGU       : ICFKWPREB       CDPLNRRRBNOPHSG QIXXGMTMWWKAGUY UKGXHTBUWC      OVUIMG         
RRERJ           : PRPQBTMEE       EBJIGGHWMUFTX   YJHHLAD         GTLXTRIY        CCCQIDHTVXII   
GSWFTVE         : OGULMNV         WUIRXBS         CPHYVJROXBWPS   PICGJWTUDRDI    KYLTWQMD        MWIBVXPB       
CDHEWGGJFAKIKSO : XYVWAJNRDWOLU   JSRDG           AAOBBDPFVKVHC   YTCY            CYMFHCVO       
YIYFCJLJEKQ     : QMREVEYSYX      DJSWXXJTVSCA    QKFVXJMTA       OSFGRVEWDMUSOOO XGXIOEVPNHDT   
IUDMAKTWSC      : DOSHSHPNXCA     GCHGWRCBTPR     RCHKNCJB        PMXTIOP        
BCTJOMAWNLXTNJ  : UYNWSBCUJH      XGHAEREUJWVDS   VLWCWEULIMAY    RQDEBOIWVM      XPIXYUCFFK      VVWHTVWNHMVN    SOLAYFJYXKYW    TUNGASQKGP     
BCTJOMAWNLXTNJ  : RPHXCKDYGWGSEB 
WOSPOBKTQL      : UNHSBHY         XRLENHL        
KKCMTD          : RGHJVFTFVNDDIXX KXDNDAEGEMQV    RWOMG           BHKYTYXMWUWMK   RGAXYD          FFRGDKPC        DCLBENIC       
OOGDRF          : UFCSHBVF        MPGTDLGREQFIX   SBJBIDWLLOHNNFR
DENQNUQ         : TIRMDY          WBEMKJ          OWBHFGN         WWNWLQUWGADUR   WRFXYMGUKYOQB   RBSLTSJLJ      
NGTRTNIHWSRAHMF : TDISYNSDPWIVO   JBKXREBARVRIVYH QXVIAP          XBGENYIKQFQE    CVUFYEOP        QJYKWFEINYX     AIYEBHHXMQAEAC 
DUIGMPAPTNIKJYM : VNBTELVHNEYY    BJBVTWSHB       RMNBIQGHGEJ     OCOCGOFQ       
IIQCYYLVTDVERCF : CJXNGU          QBCSCYKEYM      RMSBNS          NGGOWIM        
YPELGGDCULM     : SHEIOEAKYCKH    HDYFUQUYPBLTY  
NCFXK           : PCCUY           SIMQPRD         IMOIXLKLLCTJJPU CSRIWMKYHJ     
CJXNGU          : ANSFJXLFG       VTHQFDIUX       IIQCYYLVTDVERCF OTIMKMXEQFLM    FLYXH          
EBJIGGHWMUFTX   : RRERJ           DTWNSVAJNUV     CNAENTV         GCHGWRCBTPR     QEDXIB          IVASTTFX        LVIXXXGADIUTL  
QMUWCWC         : SLYRPRURAJOGXTR HHCTTFELLRMIDFU GSAEGWGB        KSWMECL        
JBCVCPEWII      : HSSITCL         MTDSDAGSEOC     NFNOVNMB        JKBKDSYFFUWTWPJ XCAMOQQYEGAUEWD GETUDF          ULBYSQC        
TREDBD          : KXTGXCW        
WINWQELNDPM     : VTHQFDIUX       QMREVEYSYX      ARCIYMEGGJEVOI  OOXTMCGJU       HXTODPWVBSXDR   JLWYXMYMJI      AIYKVSVYYX     
PVJTRLL         : QIYLAQXVCO      QMREVEYSYX      WRBSOL         
KWJISBP         : VTHQFDIUX       YNBI           
EUOBGCBWJMMM    : KRTFADELKK      ETOQT           CEFGWFBNTXOVX   VLUQAJHPACOEX   PWTLWLHOGOTJNV  KMUOVWTDTTIMD  
YUUUHRPUFPGCYQ  : CPEMRKPB        VJAYTRLPKRL    
CITHGIK         : SAKNGV          VLUQAJHPACOEX   LYYJNOUNOO      ESADMDKWMQGMON 
NLLYBXL         : VRHWUGQMBOMWJ   GUWF            DDGMXYKQOTYHG   OMWUHQQYRDWFO   INEJPHGFBFUSTP  TAMJ            WUVKKQVPETXAYMS
WJDTQ           : UYWPVEGXSXCXB   HVLFIUMOOO      ROFPM           URCS            DDXE           
LNDCT           : SIANUJGAVEMBI  
BNDEX           : TLSEGRHVVA      IVTP            TMAWVIOOTECN    UUVXWAMTUYWS   
NEIX            : LWDABWG         VLVOUF          JXYSRHYAOUYKWJC
XMCWNC          : OTHQFDSCDOR     ESKJND          DLGFILQ         YEVOYOMBWRHOH   VQTSDTHM       
TYUYTNUHBAJXF   : AKORWLMLC       BNTXARFY        AMISHV          XFPIOGRGCUEYITB URUNXWBJSVH    
NLRLLHQVFJU     : FQHXCUWIBBKSQ   HUKQI          
OTHQFDSCDOR     : GOUGATTVVIY     XMCWNC          YBSLAPURIU      YQJIORNWOFYH    YHGABGY         OUVQQFJ        
VVAGTHVJS       : LXTDLFXILFED    YHGABGY         RMIAS           FJCCI          
UEWNDCAA        : NQSHSIUWRUBRYY  YHMY            HFBDP           WXIQM           KYLTWQMD        QRPAKIHEMYJ    
OTEHCIAGLOYNL   : CPHYVJROXBWPS   ICSUOGIREE      QWPOHGQJCSL     OJMXNYVA       
NTQUPCOFWUC     : TKMQM           MSVKGWRUEDDX    XLCGU          
AGNADE          : XDDSHEQS        KOBQH           TPTIILCYMGNNRDM
KLYSOFGDGTQD    : DIMI            VBQUDEVLFB      YKPPI          
MVECXUJX        : LTDWCPWDFSFFX   WDYWN          
NLSW            : DWTPKUVX        GYFXL           AECBSJVTOVMN    XSTGORWURRNC   
TAHOKSPFJULPEHG : UCMSBM          JIHSFCNTOETIGBJ FFWPF           QEBHBFK         SOBAKYIPOFONGV 
QTEVXCQKA       : JQHOJOVS        QYBOMDDDUJKOD   BPALQDWBSDUBJ  
ANDWQWAX        : EAXUR           JQNANYUMWT      MLDXOCUVBVJ    
MTDSDAGSEOC     : DWSLIPD         JBCVCPEWII      YLDYQADPUGW     AMTSJ          
FXSDXWUIXGJN    : EMXGJESMMVF     TFMAG          
IFIIDXVWBQDE    : GTKQQCSDQPWGQ   BVNQFB          VLUQAJHPACOEX   NHPHYOYUYQQ     RPRMHBORAGSE    BBTCSTHPFCBRA  
VINXWVXRYWPVFPF : GJVNAFLFX       UHSRVYXGL       MDQD            JVUXLHTUG      
DQCKCKOAIN      : AGMWGNDL        NIAXDBHVKAFMHK  SEMTFDHIGMGQ    RPUWJRBGS       XDAB           
BQIBPSOPSMOKOL  : RJLX            OAOPEYXEVVTBV   VLGHSKPWAAL    
MSPRMVJO        : FWCNLWUNSQKPBL  UEUBOIOELCJ    
NBWNMLTNE       : YXNPE           YUOROWRMD       EPKMGOXRXRJK    NRRNGTCONLBQSBX TTYGXVDU       
QVXIMSUDF       : NEAGWX          GYCGFFMHTIYHQUJ
QIYLAQXVCO      : JXUUTBPGOM      PVJTRLL         ONRQRWYRCAHYAYW TXJIRCFJQXU     AARSRVGUPR     
PSAGHN          : SWVAHYEUEEIL    NLHN           
WUFOQFW         : NBTUNOA         CCDGQELD        XDOQIDA         EGFUWPA         OMWUHQQYRDWFO   TYFRFFBBIIVM   
ATIFE           : MOMWEO          HEJFWTF         QOVINWKSMHQYTUP BOVMPHTWTVCNPX 
NFNOVNMB        : FQSOTKTFIINLXGV JBCVCPEWII      TMTJPSYKKWJ     MPKFGGN         LKTHAEPEU      
RQASYHIA        : EUVNIG         
DHUWORCOONV     : UKUOFJWPDB      HRTNFL          CVUFYEOP       
OMAEDVUPWCI     : NCMBEUJNDLJJSF  PBSPM          
CDPLNRRRBNOPHSG : FXEXHV          MWQYAKFGU       LMYUGPFMTWACS   GVKRTIMXKVW     RYRYHWAPSV     
GDQXPQESPYKO    : LFIO            GUVR            MVQSX          
SFFXXQMRJG      : GPUAFP          GSFXXYXTABVI   
YWLGPSFW        : GWHRTFUHDSARMB  CQXKUOALOTRNBWN PCUSDWAPLVFJUYM
VWPPB           : VNBTELVHNEYY    SEMTFDHIGMGQ    KUGCPCBIMS      TREKP          
FBUTEOC         : FQHXCUWIBBKSQ   MQXXTDSVWR      MCRREONYDUHDOGN CJXD            BVBXVXYMKEDH    BDVNAWWWGJRH    GTLXTRIY        JSVTMMSGSLPSLC 
OCFBTQ          : KHFBRDFMCNQGAJ  QXKFNJBCH      
PPGCYWWEVUCSKR  : LGJORPE         HSSITCL         YNYXEDDM        AYMQWHDOL       HXTODPWVBSXDR   CYLHABXU       
UYWPVEGXSXCXB   : EDLFGGYCRNM     HTKPOIOJ        WJDTQ           XFRVADUFMIBA    RFBJ           
PLOFRQGOP       : PXCOXB          NEXYOQVCX       MFKAMRLVBL      YGBPEOTSTOON    YXLMUKBLCJSK   
MMPHYJETJBLF    : CAEKEUGUPOGNUTD LECHRH          WWNWLQUWGADUR   JTFKFU          EILMMDNFWH      KPCDYULJE       LFCVXMRWORA    
UFCSHBVF        : OOGDRF          TIGIKSJV        RAKDHKYIQWHWAYD QYHLBCT        
HTXAMFQE        : FKXY            LYDVFHOPHWTP    NXAQWJXEIH      TAMJ           
EQHNPRRLDVAKDW  : NGTPJUUJXW      FFNNCSIFEKK     WPKWML          FMJRRDITWSWPG   TVTI            FNDWBICWIOQGFII
GRYJNGCVDCV     : PNIQAEORACQ     STCAFNYWA       UOJCAERBCNW     MXEWYRATQFYNFVK
HOUCUNJJ        : DUWLKQXS        VLWCWEULIMAY    EADVS           CYMFHCVO       
DBRGWTSDQKLI    : FPDRVECIVHC     RSOIRQCQYNLI    JWSHTIB         YPWPVS         
UWSWSXBQNJ      : XYWWTAUI        SWUEMHNTHUUD    FVMUFID         YKSHIXWCYYYBG   VWUAK          
KNBBYMHD        : RDXHXMQHADOSRFG PMVHDJPPGAIV    EBIOMNEMHVJN    UOJCAERBCNW    
BLNV            : XPAWXJACHH      DOODHOE         MCRREONYDUHDOGN XIPDLP          YAIDUGELJA      BSSOKRMIC      
QMREVEYSYX      : CDOKJOBL        YIYFCJLJEKQ     WINWQELNDPM     PVJTRLL         SOMQPYU         UCMUKY          HLOOMSTVJVFLWJT
WBEMKJ          : DENQNUQ         HYQKSLHLUOQLLDO GBXIDA          WHYXKTGLCP     
AMBAYKFPLSDHAV  : DJUMWXLMAWX     NTBFLCJAA       VDFPLAQNLNNN    TPTIILCYMGNNRDM
UASBBLABYYCDNPM : GVKRTIMXKVW     BHGNWXPBYHS     UQWYJSQDYGTHJQC
RCQRB           : HNYCIKXLMAJWXBM MPGTDLGREQFIX  
YQPSVYUT        : MTXLABCUVYF     RPNWOWDVHOOLOGH JSVTMMSGSLPSLC 
PVOQW           : LYKTWQTLWDR     NRSITBI         IHMLBPAO       
SAYRFEIWTX      : FDIG            JBKJ            MYXQ            CXPILLRIHH     
VRHWUGQMBOMWJ   : NLLYBXL         EYTOJAIVPXECFWV DOOHCB         
MFAEFCWHERM     : IMUSKTUBFSX     QTRGTMOFVIJMI   ESGKRFUMIWPPTJG PSEIYHDC       
AJCABXRI        : XDQGJEITMH      ROFPM           YFJQLACN       
PQOCUFQRQCGW    : HBTB            FQHXCUWIBBKSQ   WMVL           
KEGKLKEBTGMVGN  : CVYTYPHDOWB     EPPXMYJKB      
YXUQRLSMQMEIQ   : YIUWQVKMKECR    GWMIQHSN        EPPW            LCSIDT          GUVR            ICHRM           KFCTN          
HUXLB           : OWYFLG          DWGG            VHNMXQLQ        LBVHRVIJYRKQLPJ QXKNGS         
YMQAI           : OGULMNV         GRFRPQV         GSAEGWGB       
NGDB            : YNXOYRLBWCE     YKASWXWRPSTIHR 
EAXUR           : XYVWAJNRDWOLU   ANDWQWAX        HFCNTDPKCAKIIRW SRMPEYTXAF     
QGFFMN          : FXTPW           EYGHGNQVYHM     EKOMAALSL       FXWLXM         
YWQYKTJJIA      : EGFFTPI        
QYAAFDDJFEHYRA  : LPKKLJQIYMBTOG  DYNMFYC         FWCIWTBD        EGFUWPA         CSRIWMKYHJ      NQHRA           GDVHX           KWJRCM         
WFRMBRJ         : WFFGXTFX        FDOIRAMU        WWRLLQAQIPCWER 
QTNDGWFSPFUP    : UPKGADKFMDFJE   NAXPCJIONNYJ    QVJSWCPDT       FNQFKRQX       
XVVGCFFTHNRM    : JSRDG           YPJNTVNOURYBV  
EPBOJU          : QQYDAPREAJUNX   GYCGFFMHTIYHQUJ PBKXKJMSAYWYBI  RPRFDU          DLLXMIQDH      
XXQWFLMKGFWHBVN : SPRCHRH         UUVXWAMTUYWS    DUSEJHBF        KXTGXCW         VWYHMSMWCQHDTFJ
DUWLKQXS        : HOUCUNJJ        TNYMYKHAAC      CNTS            GDSFMDTUQGFDDGC UYTL            AYFSLCSACWEYSD  URCS            AWWKAIYEPRB    
DUWLKQXS        : YKASWXWRPSTIHR 
QTMAOYA         : LMKS            OSEVGUUTI       GNMCKRPN        ADYHSUDEBUME    LEXSQAABCDNTB   EUVNIG          QOEKPXYHX       NOGQ           
SWUEMHNTHUUD    : KYSSJLHRH       BUSIUOXPJRBVD   UWSWSXBQNJ      YXNPE           IEDRCMNGWRIP    PWDFGXPC       
AGHYTSQUN       : JVMRFBAISD      AUAQVMXNCX      XTOVATPDB      
LJDLBCOPUN      : RJRANRWDU       VUMGQUQIAH      GTXDTBBDKPSNU   PADK           
CCUP            : ESUJSLEFJQR     YMHUBDY        
CMSHYUPIUKDNFQ  : XIKMFPIWFQOGWFA CVISGBEPM       GWFPYVX         FTQGNLSGVMRXAW 
QDHEEJSV        : RHHVBDXOWAFMX   PPTNXYCDB      
JLJLGBIKPDT     : YLNYE           ILHJAID         QFVGRWDSNUDQ    FSMASIB         VJAYTRLPKRL    
YJYVVDLBVPT     : WKYNV           GJVNAFLFX       JUNCGRJDVSBPT   FLLJGRGVGNMDJPD OJAXELICG      
WBFIVE          : CJYVQTQBQUPE    KLKQHPUVMFT     TBIFPOHVE      
FPDRVECIVHC     : DBRGWTSDQKLI    LFIO            XDDSHEQS        UNYHPKCHP       GBDGEDEQ        TBFICJ          TYGQGYUHX       UNODVUVFB      
FPDRVECIVHC     : QOYPUVPGCXUUC  
GNMCKRPN        : QTMAOYA         QBCSCYKEYM      CMLOALVCEOXYTUD
FIPEJU          : PQOQNUGVKDUM    HVLFIUMOOO      CRQCERYP        WPLPM           OSINEEHHEBSC    EGGHW           FXWLXM         
FYHNO           : QSRWLDCK        EUIAJ           VCCQQGVXWKGAW   BKUMXJHN        ALJUANAV       
FMRJ            : LKVOIBDAG       MLLRFGD         XUQHKFP        
QQYDAPREAJUNX   : EPBOJU          GBXIDA         
XNHJKWPKGFBTKQO : XVBYUMLNM       MOMWEO          JYPM            IMOIXLKLLCTJJPU
LFONIODDTFMQU   : QCKVRCXJQWT     HMNQGITUCDHR    CBNRWYOD        ISRWM          
STCAFNYWA       : KHFBRDFMCNQGAJ  GRYJNGCVDCV     GDOUJEK         SVYCWST         HUFYKC         
CDAOTOKIVAXHQD  : OARAYSLXL      
MIYDDMWYQW      : CKPID           EBQSSKBFWOD     WRFTUA          ENADRSXYMVR     ILMQMT          WCEJJWYLCICPL  
GYCGFFMHTIYHQUJ : QVXIMSUDF       EPBOJU          AUXARF          XRTTBTCAPOPCTXJ FVWJ            QIMBMPABTEUI   
CARMNCMSGBPHRP  : KDTSWLSOCWOWNUO HXTODPWVBSXDR   DGOSK           RQKDCSBUBW      VDFPLAQNLNNN   
YORHVYTD        : GUWF            YHMY            KRLHIK          BMQGVTFMJVTY   
DCCV            : NAUIJGRE       
LNAOFPCKCW      : BCTFRYSL        MHXBVXXJQQVI    FTRJXOJC        STXPMVNIYCYSA   GEDRWXJSE       BDVNAWWWGJRH    NYRWDVJUJJVD   
FNAWFPVVJERIAU  : LIHQSFU         OPOXCLEWRY      HLOOMSTVJVFLWJT PVPCYVPHYCH    
FAICXT          : BHKGLAJJYXFK    BUPF            VKBXQCXOEUVGD  
AIWRMHVKA       : GSAEGWGB        XJJAM          
ADYHSUDEBUME    : QTMAOYA        
RJRANRWDU       : LJDLBCOPUN      STXPMVNIYCYSA   NXAQWJXEIH      JMFWXPVBHPBSGGV
DMUMJHNKHSLO    : EUIAJ          
JTPK            : FXEXHV          ITRK           
EOIXBBYOUV      : VMLE            DSPKIJXUBCCDOU  FNDWBICWIOQGFII KMUOVWTDTTIMD  
RDXHXMQHADOSRFG : KNBBYMHD        GVUQ            KQNXNYMKRREMF   YKSHIXWCYYYBG   AOYRYFHCHCBP    KAUQJWLN       
YXNPE           : NBWNMLTNE       SWUEMHNTHUUD    YKPCJU         
YDGCEUYCPRFPYGD : MGDCPXGGANG     QRUDJGERNLGB    GPUAFP          OUILQVNIJRQVDJF HLERXMYS        LKQYHOD         OJMXNYVA        KMUOVWTDTTIMD  
NFWFBQMJROKGEO  : WRBSOL          YDWQQBINVWFLB   PUELDCJDLJJTGFH
FTRJXOJC        : LNHUDQYH        LNAOFPCKCW      RNDHDR          PWKRFDLUKMAII   DFCEEMXRTIDGPW  HDYFUQUYPBLTY  
DIWEQCVEKU      : PFUXYSRWDODQAFI AYQW            QHNAVPBW       
LMYUGPFMTWACS   : ICFKWPREB       CDPLNRRRBNOPHSG LWDABWG         DVRNIGOHPYLUJWW
LRJWVSCEPGWUEEF : PRIXC           WNAMDYJCEQHP    SFRCUVBJVAQBL   ICDJLB          FJCCI           REPK           
PQOQNUGVKDUM    : INOCMJXKEBRWUR  FIPEJU          OHOCUJC        
NHSHSSELUKDCI   : KJSEYYJHQNNTRDT OVXVAM          LKRXRJYLEO      OTBXWLNB       
IMFKCXYVMWCKJ   : HUWDORQH        XGBQBPB         EBIOMNEMHVJN    GHJPJLYOSMRXI   WGOHGCMFSP     
FVMUFID         : UWSWSXBQNJ      CNTS           
BHJXRNCANLMTX   : ICRYHNIT        KHFBRDFMCNQGAJ  XXUY            EYTOJAIVPXECFWV LNTQXYPBIY     
RANGW           : FITUHXXHCAI     SFRCUVBJVAQBL   BTUGIXAWXWSQP  
QIXXGMTMWWKAGUY : MWQYAKFGU       UCYPR           YPWPVS         
KDBAQPTPJO      : XGHAEREUJWVDS   YKPPI          
YUOROWRMD       : MYKAPXOIVG      KBFEYVNUS       NBWNMLTNE       VQUADN          YXKVIJIVHJJT    KAAJGVLSCDR     NMWXQUAQVDBPGVI
IPCFDCNADOMHRMX : FUMBRFOKUKDWYJ  DINSYVUPVLETQ   RNLOOOO        
JPTXFSU         : HNHEDHJOOHSD    QFOXIMTGXTXBKNT LYMSW           HJKLVYDSMRQ     HTPYICOPMQCH   
KJSEYYJHQNNTRDT : NKUABGCVNMHJA   NHSHSSELUKDCI   OQUQ            QGECKSMPHPDEEN  PADK           
RGHJVFTFVNDDIXX : KKCMTD          ULNUQFRSKO      ATONXEVUNJ      XCAMOQQYEGAUEWD
KSXJRJQJYGDT    : VLKAM           DTMPPFKFSR      SRMPEYTXAF      RPRFDU         
ARCIYMEGGJEVOI  : IMUSKTUBFSX     WINWQELNDPM     JXDGMCRD        INYPADFATD      PTWIAJ          QEBHBFK         YEVOYOMBWRHOH  
NIAXDBHVKAFMHK  : DQCKCKOAIN      WHUAC           MYYMHHXSNKTA    PSEIYHDC       
RKATTBIA        : NVHN            CJYVQTQBQUPE    FEWLPNNFTBTTPCK
OKQKYBROJR      : GGWCB           NHPHYOYUYQQ     MGVWLIVGAROSIG  QHDCTCEN       
MSVKGWRUEDDX    : NTQUPCOFWUC     LFHA            UCYFVWNGVHQPS  
FRJG            : OUJYYKWSUI      DMQXHJEEKFUGDK  YHVAH          
MRRWIFX         : XXBMEWF         MBDBCCXRRHFG    IIAP            TIOGMUPVGUOR    KOWFEWKEXUDTGGR
WNUQCKKBUQAP    : XQCJVH          ENAXYOTJWECG    MGVSGTPJN       OOBTLANDB      
GSQEIVXUEYH     : XPAWXJACHH      KOKQQFNOQF      HIGK            KLQTYYD         RRTNIKVENDGUW  
TGHYESXR        : BUSIUOXPJRBVD   CDNDBFGJFC      JODHEFIRPXR    
OWBBXXRANF      : JMXK            SUCLKYBBGBDBFQC KLKQHPUVMFT     HNHWH          
GVKRTIMXKVW     : CBATCCQH        CDPLNRRRBNOPHSG UASBBLABYYCDNPM RCGXRHVPJX      CIYHHMGNMIKUA   YYWRLMSUEC      JAXMULFGGETQNND
CEFGWFBNTXOVX   : EUOBGCBWJMMM    OHLIMIDWWWVKBXH MKOL            TXVH            PTFYEAPA       
PXDXEMVQEQBSO   : ENAXYOTJWECG    OUILQVNIJRQVDJF CSRIWMKYHJ      WCHKGOAVEKG    
ONRQRWYRCAHYAYW : MROEONLICAHJFD  QIYLAQXVCO      INEJPHGFBFUSTP 
OOXTMCGJU       : WINWQELNDPM     XIPDLP          XMBVLPCGNRP     MXEWYRATQFYNFVK WADRXOES       
CWFSITHDMBAMS   : JNOXBVQUOF      MQAXHHBMYS      SALSQILFOQWHV   KWYYYINCE       ACWD            VBQUDEVLFB      LKTHAEPEU      
OBGPCDPQROKHQR  : PCIXFUYXSMBWL   ILMQMT          TCCOGNCDHDG    
OGULMNV         : PHBVAWVCMR      SJPXEYDW        GSWFTVE         YMQAI           DREFH          
UYXWCKRJBUPQW   : EUWUVVSHVUQEY   IJRDOTRYT       MWGUES         
JNOXBVQUOF      : KOMDFEPRJTCWK   CWFSITHDMBAMS   BJBVTWSHB       QQQQ           
JQNANYUMWT      : ANDWQWAX        KATXBJJM        OBVNJGBOKJIXIPK
JMXK            : OWBBXXRANF      KRWWFKQK        GRWKVOBAVSCNMDT
PEHKNUANX       : SGJMHECEWMLU    HMNQGITUCDHR    HNBALKLYARXENH  JGOS            YKWMPNFWCQ      OPDD            EKRCUFJTM      
ESPKUY          : ENADRSXYMVR     EUMUOXS         LYXWWUXF       
KBQJWEIQURFVFPL : PPGJ            BEXRPTE         XPIXYUCFFK      SRFARXW         AOYRYFHCHCBP   
WYYTBMSYSNO     : AKORWLMLC       RJYS            SXKFEYHEYPYHRL  JBIQI           DPGLNWMBWWN     TIGIKSJV        YQBXYMCDHDBXGEF
KQHVRXHQEQKCKPX : TAYUWLJJINAB    LWGFT           LRYWXBXJHMNC   
HJBG            : ILFLBKBCPXLLGU  PUJKASXHGNFP    XQBTG           TAWIEJEQDPI    
CBLOVLILCNW     : MJCECIABV       NAUPDIATUAJ    
WUPVCGCUSE      : LHXBQPMDN      
LEXSQAABCDNTB   : QTMAOYA         UKYMNVBKMVCIUEL MQAXHHBMYS      XKQFTXPTQU      DPNOMDWCIPDTEUT
EMDR            : UOJCAERBCNW     OIRITVESW       XBSUKOTEPOQOTI 
BPEQNJYRGSW     : KPFHLPSCLIIHIKH
EBNYRNYTREJLFK  : DUSEJHBF        LKTHAEPEU      
SPKEQCLJ        : HVUCPKGASTTNS   JCCJQVWBASHCNNQ TIVPKFLFLMQK   
WLHDEGSK        : LCSIDT          OIRITVESW      
GLCVNXNRHAATRS  : UJWAMXML        TGTLWJDCYLG     UMGGRARDSOVTE  
CYDGMNVJYGNFO   : NRVWVUHG        OXJNTYUR        UAQATN          NNEEN           PCIXFUYXSMBWL  
RYODEMQEALOALI  : KFICFALXEKBD    IDTGBUTHUB      VLKAM           WUFJXSDJKMM     LVUGMOAUR       DFQB           
GUWF            : NLLYBXL         YORHVYTD        DBOHYOQNMW      EADVS          
ESOCEPKTUCCOBS  : UCMSBM          ONFNWBSO        JBLPMRJYGH      FMNK            UNWCUQLO       
HFLMIYD         : RFAWBWTYVMIRJA  QWRYFFJL        VKISDCSTO       YLGP            AAGJNIUVG       AXCKIXYNIAPXYQ 
KLDQJDXKJ       : LQRTQYENBJPYAR 
YNXOYRLBWCE     : FPFEDDSRQQSMC   NGDB            UYDKYPCTGLMUE  
VMXJBGI         : SULCYQYNJ       VDIITQFIRT     
QSRWLDCK        : XYWWTAUI        QWOCVUESVHYF    FYHNO           EBQSSKBFWOD     QFWXIMFAP      
LDOBDFAXQDUUKMR : GLDDTPDAL       YDJFID         
MBAUMGO         : VUSFW           QVKEHJHHYFURU   POOMOEKPN      
ALTGPETDJJE     : ORSARBHRGCYD    XYCADASL        EKLH            YXLMUKBLCJSK   
OHLIMIDWWWVKBXH : CEFGWFBNTXOVX   REOGMUYS        IHMLBPAO        EYORFEFVCYH     NDQJTSL         SYKBJQEIURUQGUY RGXKCWJ         RKYRTUOPWQIUWGR
GVUJH           : WUIRXBS         GBKGSOBDFQNGBKN QESTLAS         SPUSDWC         MDQD           
PYUJCF          : MKQESBPDDBM     INOCMJXKEBRWUR  PNVTN           FDOIRAMU        STGVSBKEHUTMM  
HUKQI           : RJLX            NLRLLHQVFJU     RYCGY           KATXBJJM        PPJNGTOLMSVERJD
DQXBPXYAYXK     : RFCGCDTDEVHF    XYVWAJNRDWOLU   UNCMNFNWS       RCYQJVA         MQKDMLT         MHGCE          
EGLPQBFPVPSDKC  : VQGUUECCTS      EPTNJPCF        CVDMGPWEQAPAX  
WUIRXBS         : GSWFTVE         GVUJH           DIDJYUINJO     
RQYTRYE         : KHUOLFCHYGCST   EPPXMYJKB      
FLTVCWB         : OYRXWVUBW       CEREOXUCPLIYD  
VSOYESAD        : MGVWLIVGAROSIG  ONNERC          UUVXWAMTUYWS    MWIBVXPB       
KVMMONGHOA      : TETTGCYNVJCL    GXTUGGUEERI     LFDRSQQMB       SNLMVSHYSYO     CBBHMBCVWTF     KKPWO          
NHJVUFRYFUSBOIC : SXKFEYHEYPYHRL  BUIX            YAIDUGELJA     
BEXRPTE         : KBQJWEIQURFVFPL GTLXTRIY       
KRKTHMUWT       : MLXCUMANGHMLH   VDNDWTR        
SQOMPTKJUY      : UNHSBHY         AAGJNIUVG       DPGLNWMBWWN    
YVWET           : LYMSW           NCVWPUOSAWUU   
VQUADN          : EJGRVSWUHKWNBN  YUOROWRMD       RPJVOUFONIBMM   LYDVFHOPHWTP    ITRK           
AWYU            : CVDMGPWEQAPAX   XLCGU          
VEPOUEFOO       : DUSTXGHTQ      
LPKKLJQIYMBTOG  : AMCWDSQRW       QYAAFDDJFEHYRA  MRVSLWDHKVN     CHHHFJXVFC     
BGIDEFBIWPDB    : FMDKVLK        
TSNHIXR         : JGUG            MDCAFR          OUVQQFJ        
ILHJAID         : JLJLGBIKPDT     GELBQLPORLGIGFV DWQLFOXPUADOFTB EETSMIITAOEVWGV
QPSXXXCD        : JPEQUVXYYDRSVLM JWIMCGNQHVYDHG  GTXDTBBDKPSNU   XRLENHL         PKYOXDBTMTET   
MCRREONYDUHDOGN : KXOURT          FWCNLWUNSQKPBL  FBUTEOC         BLNV            WHUAC           MQKDMLT        
NWBXDQRSLPSK    : TKOTTLEINKVGS   ADQEHPWN        HIDFHKENY       KKSQG          
YLGBDAHUN       : TLFXVWSXOQPAVD 
XIQBWWP         : SAOB            KUDNCJBHG       RGAXYD          BEDRLFTLIU     
NOBN            : HREGOVSPMBWUE   ANOX           
TFMFWGRQHEW     : AVLGXHHFGXLVO   BXRRGGFRDHYPIBE MLXCUMANGHMLH   SFRCUVBJVAQBL   AWWKAIYEPRB     XGVPO          
HYQCMWCUP       : LCOFXKQRXYAYYOR FHUEOOGUA      
UPXUDMVSHRBTWX  : EXWYUACDREDL    CCRSSPPOHKL     WWRLLQAQIPCWER 
RPJVOUFONIBMM   : VQUADN          CCCQIDHTVXII   
DSTSQ           : HYVDY           MLMKQATB       
XGMQN           : OOKWTBWDORC     DWQLFOXPUADOFTB TMAWVIOOTECN    KMUOVWTDTTIMD  
RJDSO           : ICMXMVXHSTK     ILFLBKBCPXLLGU  FXCLG           AJCTKAFJWV     
IASYUYNIHRVVQB  : AAWAPFNBCWHT    RYRYHWAPSV      SBJBIDWLLOHNNFR TIJCEBOFYVYJ   
MTIDTOPKCVFOBAD : PPNEKUTXFVGNIQ  VWUAK          
KDRJBQ          : OXJNTYUR        ARLEG           XKQFTXPTQU     
LARJWKKMYGUCAKT : BPALQDWBSDUBJ  
ORSFSSIRFMKOPB  : MGVWLIVGAROSIG 
BCILYUVNVD      : NOQQJFWN        DAYCUVCT        KLKQHPUVMFT     TAMJ            PFKQNYRG       
XDUT            : JDAC            AAVPDYJSCXVGSGV
MLLRFGD         : FPFEDDSRQQSMC   FMRJ            DDGMXYKQOTYHG   QEBHBFK        
LRHDHLTI        : BHKGLAJJYXFK    DAVSLFSEHGU    
DTOASCWXMW      : INOCMJXKEBRWUR  SOUXHYGMKFN     YXSCRPUIQMVS    DINSYVUPVLETQ  
KRWWFKQK        : JMXK            DOOXXPBVJN      FUAFRHMGHR      BQJVCSOVCSMVD  
TKFLTIUF        : TIAETTMYO       YMQPGHHCUGC     SDTYQQOOYL      KROQHCIMRDKIE  
EUIAJ           : DEFFDIF         OARAYSLXL       FYHNO           DMUMJHNKHSLO    BYVNPRVU        XWMQKPGGHQBU    LYXHQJDUPFIMFC  FXWLXM         
UNHSBHY         : PPPRLTSMQKQROKW WOSPOBKTQL      SQOMPTKJUY      ISGFLGTCYWACP   YFAEIMNQFIVAL  
BVMGGDTAAEINA   : AESJAQ          RXFFRMMIJ       YPJNTVNOURYBV  
JGXPDGRPT       : PPTNXYCDB       UIVSOLBGDSBHEGK SNJOMNHPRH     
FDIG            : DPTQ            SAYRFEIWTX      WGWTFVR         TJUBGLPBAYFCDW  RYEBOENQBORW    TUNGASQKGP     
HVLFIUMOOO      : XDGCTTQCXSMJ    KDCHG           JGOS            WJDTQ           FIPEJU          FKGEACPFKIKXUS  NGGOWIM        
UWEUQPDOFJXAYR  : XIKMFPIWFQOGWFA CIHTERYUEBYF    RNXTIASJPML     SRBBECPVCSPJNAY
EUVNIG          : RQASYHIA        QTMAOYA         YSFIKY          OJAXELICG       TYXEOLRBD       IYGNTTNCM      
VLUQAJHPACOEX   : EUOBGCBWJMMM    CITHGIK         IFIIDXVWBQDE    RDPU            PKRFEWEARROH   
WDYEMYELSRSPQGX : NGMDSBLMPXBKT   OVUIMG         
RUKMNNVVDXXTDX  : YURY            OJAXELICG       AJNLGSJPIWQCKJG
CCDGQELD        : LFFAS           WUFOQFW         DYNMFYC         IINJILFMARR     GUXD           
FXMXE           : ILTSWOOSLHQPCGO TXJIRCFJQXU     BHGNWXPBYHS    
WXIKLVX         : GBFWMGMJVSU     WKCVOLGUAJQFT  
TDISYNSDPWIVO   : NGTRTNIHWSRAHMF UHSRVYXGL       FITUHXXHCAI    
JRJRPWRVKRTUCH  : GRSQTWKNKLCOCW 
ARLFAGENBIFYQDN : QSUTVSIRLGIBXL  DYNMFYC         WRFXYMGUKYOQB  
NHPHYOYUYQQ     : IFIIDXVWBQDE    OKQKYBROJR      XWMQKPGGHQBU    YAULGHBY        ANFRDB          KROQHCIMRDKIE  
UYNWSBCUJH      : BCTJOMAWNLXTNJ  UNWCUQLO       
KRNJ            : XIKMFPIWFQOGWFA AUAQVMXNCX      KNRJAHS         MSPQDFGG        UODKIPSLAWTVG   GDOBSMAU        WHGHBDPOD      
SYSGGJPFAPCCIVX : HBLRS           CNTS            TLFXVWSXOQPAVD  LWDABWG        
WLBPOG          : HYVDY           NWBNYXCEYJJLEWU UJWAMXML        SRSPWCECTCOVUJ 
APUNJKW         : HFBDP           WCOPHOEO        KUDNCJBHG       IPTN            LIGABERDFOUOPWW
DYNMFYC         : AAWAPFNBCWHT    QYAAFDDJFEHYRA  CCDGQELD        ARLFAGENBIFYQDN YACKRBSPQ      
YTRDFNCLKPMC    : LKTHAEPEU      
UOHKLU          : BEERSGEUEUOWYHR SHRFYG          WMMWQXW        
VUQCTGOBHSO     : TKOTTLEINKVGS   TIAETTMYO       RGDBUIYXLPAH   
PJMU            : NVQUGJXFNNFPYI  QOIGBQIA        NSILYM          KOWFEWKEXUDTGGR IVASTTFX        WMVL           
OGKEUOLQEVDP    : CNAWKLGVW       MYXQ           
XOLQQHYHJGAAO   : UYRMGLLMEHADV   ROFJTVJGDA      CWYW            LDYVEHW        
JBKJ            : SAYRFEIWTX      PYYOPJKLMHLOYQN LTQB            MHGCE           LFHA           
STWOIKH         : OXJNTYUR        GLAYBKF         TDYF            BDVNAWWWGJRH   
GKFAITNBMV      : PYYUBSCQ        KUGCPCBIMS      WRFXYMGUKYOQB  
TFGTHXMRYYBTSW  : SJPXEYDW        YLNYE           SXHK            KOKQQFNOQF      SYEYTDY         EWNLDGEREMEDL  
JHDQWMBCMM      : TUYVCX          QQLQNO          TIRMDY          IDLGYGTTBRUX    PMXP            GDTO           
APKXQGFYCNW     : XGBQBPB         LUPRKQTUHI      YXLMUKBLCJSK   
HYQKSLHLUOQLLDO : WBEMKJ          XDQGJEITMH      CENTSKDWGIQV   
RDPU            : TENLCBWYV       VLUQAJHPACOEX   HXFPVVFVHFJU   
CSKIYJLO        : UCMSBM          RFCGCDTDEVHF    LXGWLCBXF       GTGJ            VDIITQFIRT      EEINFPAMQDDGS  
CVISGBEPM       : KYSSJLHRH       KHFBRDFMCNQGAJ  CMSHYUPIUKDNFQ  DJLFRWUUYVD     JOMQWM         
GDOUJEK         : QUDUPOWGDOJBLF  PVREQVQSTRPS    QWOCVUESVHYF    STCAFNYWA       RUGNTOACPJIEGIV ACNKXDS         XECQBHG        
HDXBFTNOSACJ    : YCWECPPUN       RAKUOIEYSWSB    TUQM            FSGEAYKY       
EFRANSGDHIJK    : PHWXVDWPAP      SAONALYPC       YPJNTVNOURYBV   RSJCIKBF       
EVDRANWXOCRF    : OSFGRVEWDMUSOOO UNYHPKCHP       CMUKVCDJQIYGEPI XPYY           
MFUV            : MPKFGGN         QYHLBCT         SDXSARWY       
CDGEQBKVIUIUS   : VSAJX           DOACBGLCE       GUXD           
RXGRLD          : RFAWBWTYVMIRJA  CVUFYEOP       
DIMI            : KLYSOFGDGTQD    PIFPDCTYGHECIDN FJCCI           AIYEBHHXMQAEAC 
YNYXEDDM        : PPGCYWWEVUCSKR  XROCWUQG        ADIVX           AOYRYFHCHCBP   
WPTSXPBUKQOI    : AYQW            GLIF            YURY            NEXYOQVCX       SBJBIDWLLOHNNFR EBBMTA         
IUFBXPPIQ       : HLERXMYS        LCSIDT          ENYEQSFTXPJTF   DSGLPITMU      
XROCWUQG        : YNYXEDDM        PRFWVSLMOOAKK   NQSHSIUWRUBRYY 
GBKGSOBDFQNGBKN : HGTOY           GVUJH           TNYMYKHAAC      RYEBOENQBORW   
KDTSWLSOCWOWNUO : CARMNCMSGBPHRP  WAYECLGLHIEDC   IAABPAUHHS      TTYGXVDU       
VCCQQGVXWKGAW   : IKPNWGRHELJEVDE AMCWDSQRW       FYHNO           KWGAPE          VRKHJPHQCVNF   
FKXY            : HTXAMFQE        MOFWBWVPJMDWC   JKBKDSYFFUWTWPJ ICHRM          
UKYMNVBKMVCIUEL : WQLBM           LEXSQAABCDNTB   MMDREAXU        TMLHXQB         NUNPN           TGRYCJ          FUAFRHMGHR     
WRIWQUDQTAV     : JMOXBESNHRFMKRM LVUGMOAUR      
YXKVIJIVHJJT    : YUOROWRMD       XJJAM          
LFDRSQQMB       : UHRGDYPV        SSDMRGMNUOY     LFFAS           KVMMONGHOA      RIDLWTKSRSMI   
DXSV            : XMUGSP          EGFUWPA        
VUWUSJQ         : NQIQMKYUHV     
UCADLLYVYEY     : QQWF            ISBJCWVF       
WSJJTYOSTNNPIK  : KOYURXTEO       JGOS            DJSWXXJTVSCA   
DWGG            : HQCD            TIRMDY          HUXLB           IKBVPET        
IIUVVUSU        : SXTFAQHMV       IPQRX           WWRLLQAQIPCWER 
TNYMYKHAAC      : TIRMDY          DUWLKQXS        GBKGSOBDFQNGBKN QXTUKMR         NQHRA           HFVUJIPWNIU    
NPOXCCD         : MLJGSEHQUJI     HAFS            ADQEHPWN        OCRYVCHK        YDWQQBINVWFLB   YUUNBLXULW      OHOCUJC        
ILTSWOOSLHQPCGO : FXMXE           DVUGLWLFU       NGMDSBLMPXBKT  
GBXIDA          : QUDUPOWGDOJBLF  WBEMKJ          QQYDAPREAJUNX   NVQUGJXFNNFPYI  UXVYG           HYYSOPIVJLPD   
QRWQW           : ICRYHNIT        JYCCYH          LQRTQYENBJPYAR 
TXJIRCFJQXU     : QIYLAQXVCO      FXMXE           UMXKKN          ONNERC          UJTLKKHWBRSALOD
QMDXDRGFSOIU    : MXEWYRATQFYNFVK TPUTY           SSFBWGEKBEU    
CNTS            : CPEMRKPB        KRTFADELKK      DUWLKQXS        FVMUFID         SYSGGJPFAPCCIVX
UPKGADKFMDFJE   : BLAWGROYFJPBDEY QTNDGWFSPFUP    OUQMW           FMJRRDITWSWPG   UREYJVYKSDPKY  
WHUAC           : FXCLG           NIAXDBHVKAFMHK  MCRREONYDUHDOGN VUYFHDJROABQT   MVQSX          
FWRQRQSHKNTHF   : HVUCPKGASTTNS   UFTSEO          XSTGORWURRNC   
PFKAK           : IAQXSNWQKEWCUAP XPJMWFG         VUYFHDJROABQT   USUAIFGPND     
ESGKRFUMIWPPTJG : MFAEFCWHERM    
BYVNPRVU        : DUSTXGHTQ       EUIAJ           EKLY           
NDJOPGUIPFAWAOF : UMXKKN          PVLQGKSRTWWTTRH
GVUQ            : RDXHXMQHADOSRFG NAUPDIATUAJ     LCPWUOQPCNURSRO
JREHFTBDQ       : EAEPYSJRSM      CXNHQIQWAHF     ARLEG           HUCEYUHTXSBSMV 
RTKIKRFSJKVGNM  : SULCYQYNJ       TKOQFTFK        DYOQUJHWXTWS   
OTIMKMXEQFLM    : WFOFWTURSNQXAJL CJXNGU          TMAWVIOOTECN    FNAOXSFEXHDE   
REJLAUTKOYGXL   : PFUXYSRWDODQAFI TKMQM           PKRFEWEARROH    MDCAFR          TUQM           
EBQSSKBFWOD     : MIYDDMWYQW      QSRWLDCK        ICSUOGIREE      WEYD           
HKPUSHY         : VEQU            NDJLYQKU        EKLH           
UBXOMMPUKBYQF   : REOGMUYS        CIYHHMGNMIKUA   MLAJHD          IVASTTFX        JKTVPYNTEULK   
KXDNDAEGEMQV    : KKCMTD          YFAJXX          NBHCYEGQMVHC   
LFIO            : GDQXPQESPYKO    FPDRVECIVHC     GRDSHKCR       
JMOXBESNHRFMKRM : DUSTXGHTQ       WRIWQUDQTAV     OJYGHBPIBRTCP   NFXCU           ARLEG           EPKMGOXRXRJK    IYGNTTNCM       JVHY           
HPPMXTYQRIDWSR  : LIVEKAYMTH      EXWYUACDREDL    RPRMHBORAGSE    OHFVMCKPN      
EHNDITXYE       : AMOKCDVS        KLQTYYD         ANNADJTBJQW     LQRTQYENBJPYAR 
ESDX            : GVWAUSVL       
QFVGRWDSNUDQ    : TENLCBWYV       JLJLGBIKPDT     ADIVX           QURVFXCJCMHVTVI AAGJNIUVG       PBSPM          
VLTBSIEDECEK    : XIPDLP          NPOEIROOPNASG   IJJVDYHERQCQIH  YWUAWHBFXPMMGT 
KEAIKQQIAIHD    : ACNKXDS         ISRWM           OREV           
VAHOUEAPHUAN    : SRSPWCECTCOVUJ  FYHTD           NOGQ           
GRFRPQV         : UHRGDYPV        YMQAI           EKLY            YMQPGHHCUGC    
BIHRS           : IJJVDYHERQCQIH 
DBOHYOQNMW      : IDLGYGTTBRUX    GUWF            SOBAKYIPOFONGV 
EENGRO          : MRHA            RSTCX           IJRDOTRYT      
KWGAPE          : CDOKJOBL        VCCQQGVXWKGAW   AAVPDYJSCXVGSGV PMVHDJPPGAIV    XQWLXNYNEJVJS  
QOYLIIQLWXKOQ   : GCHGKS          SUCLKYBBGBDBFQC QXDI            NBHCYEGQMVHC   
DOSHSHPNXCA     : IUDMAKTWSC      LYMSW           VOWIKUF         WGOHGCMFSP     
LAMPRGFTRPCI    : HREGOVSPMBWUE   MDCAFR          IYVGRAAVWS      FTQGNLSGVMRXAW  HHHLBC          NYMPYCWTX       WWRYIVHML      
CIPSBRV         : ELFVMEJXPQDI    KMCTGTUOVJFK    OBRQ           
LFLSU           : VDNDWTR        
QYBOMDDDUJKOD   : QTEVXCQKA       ANFRDB          FEWLPNNFTBTTPCK
TLFXVWSXOQPAVD  : SGJMHECEWMLU    YLGBDAHUN       SYSGGJPFAPCCIVX DNMOALWJHM      AFAUOCETC      
SEMTFDHIGMGQ    : FLCKDEIWKOLCUHI KDCHG           DQCKCKOAIN      VWPPB           CPHYVJROXBWPS   DTMPPFKFSR      WPLPM           EKRFQKKW       
WTBS            : HNBALKLYARXENH  DFAJ            ADIVX           QYVWSCJXHWOEV   AXQVGRA         MWIBVXPB       
ISGFLGTCYWACP   : UNHSBHY         EGGHW           WYKDWMC         KEYGHSAO        LHXBQPMDN      
JEPOHYAQN       : CQXKUOALOTRNBWN TKOTTLEINKVGS   YKPPI           LTKWHDOYNL     
HMHDPBNATUFIDB  : YYWRLMSUEC      FQXXIBPLXKFBQ  
CXNHQIQWAHF     : XYQRMADAOHIQM   JREHFTBDQ       WPKWML          DNMOALWJHM      HNYCIKXLMAJWXBM
JVMRFBAISD      : WNXTBJV         AGHYTSQUN       EKLH            GUVR            NEWM           
SWVAHYEUEEIL    : PSAGHN          NDQJTSL        
QESTLAS         : GVUJH           VKISDCSTO       PNQVSLD        
XIPDLP          : BLNV            OOXTMCGJU       VLTBSIEDECEK    RQKDCSBUBW     
FSMASIB         : DSYWAIFNTF      KXOURT          JLJLGBIKPDT    
KHUOLFCHYGCST   : RQYTRYE         VVWHTVWNHMVN    ILDBSVBQGC     
LPAVIFKXSRTG    : FCYIKD          RQXBTSXYY       BLALAVL         RARXE          
OQUQ            : GJVNAFLFX       KJSEYYJHQNNTRDT
CMRORTXSAALUE   : THFONKU         EIGXWOENVVNHRY 
MGVWLIVGAROSIG  : OKQKYBROJR      VSOYESAD        ORSFSSIRFMKOPB  CQFIOU          XDFB            VRKHJPHQCVNF    QHTWF           UUUUBLU        
MGVWLIVGAROSIG  : NSGE           
YJSLCJGVHYY     : EYORFEFVCYH     PMVHDJPPGAIV   
LVPNKVLIJ       : RXUGUTLPOWJCDQ  MJTDBUVYXL      QHNAVPBW       
GPUAFP          : DPTQ            SFFXXQMRJG      YDGCEUYCPRFPYGD
NGHWBVBME       : XNYBDXUBV       KKSQG           VRWB            BQUQLMEMAP      GWSYWJO         DLLXMIQDH      
TDYF            : YCWECPPUN       STWOIKH         NVQUGJXFNNFPYI  SHGSISTRNIFAJWE QJVDLHNYBTVGJ   KWJRCM         
WUGJSSRCNATI    : MGNAYXGSICMAP  
BBKO            : QTRGTMOFVIJMI   XPAWXJACHH     
SOMQPYU         : NJQYBLD         LOAEGWXVEKEH    QMREVEYSYX      EIGXWOENVVNHRY 
UAQATN          : CYDGMNVJYGNFO   PIOOXEFD        JYPM            UUVXWAMTUYWS    QAQPPVNEGMUMY  
AARSRVGUPR      : KHFBRDFMCNQGAJ  QIYLAQXVCO      HRTNFL          FSGEAYKY       
TSIIEDWQTPPQHKQ : NLHN            JYRPQTQXCQBL   
MKOL            : CEFGWFBNTXOVX   FYHTD           DKFPAGRXDS     
OFGJBP          : RMNBIQGHGEJ     WBJVSQCHNDW    
SHDMCNXGSWY     : JTFKFU          TYGQGYUHX      
MOFWBWVPJMDWC   : HGTOY           FKXY            RNDHDR          VRKHJPHQCVNF    NDCVUNCSQT      JKPVCQLKSYSMETB
GNJVTE          : JCOGWLDGYATA    ISWL            SSTWXBGECYGGPW  QTWHUSWMBSPO   
YRHP            : PRULNFP         JGOS            KDIPRHFTDYRNTDE ISWL            NRRNGTCONLBQSBX
PIOOXEFD        : UAQATN          UEUBOIOELCJ    
ICYXOLBNPJTD    : BLAWGROYFJPBDEY VRVJVRBDWFAFE   XGXIOEVPNHDT   
PYYUBSCQ        : MROEONLICAHJFD  GKFAITNBMV      TUNGASQKGP      GGSIDMIBJDBB   
RYCGY           : HUKQI           HJTNRKPCSHVK    DWFXCPKOBTUVBFM JNXW            PMXP            XFXFKWCFYVPC   
NFJVHITXVWMMIGR : EMJGY           SLVNEYSYXAECXXP PFKQNYRG       
WRFTUA          : MIYDDMWYQW      NFTSNCV         FNAOXSFEXHDE    GETUDF         
LNQMRXMANTLKBVE : UCMSBM          FDCMTDBTXIBXQE  XCAMOQQYEGAUEWD UEHJHTERIUKY    LXMBR          
REOGMUYS        : NGLPYNA         OHLIMIDWWWVKBXH UBXOMMPUKBYQF   VNILGD         
SAONALYPC       : VMLNX           EFRANSGDHIJK    SONVPVSBFWL     SPRCHRH        
JCCJQVWBASHCNNQ : OYGBUOOYHEEIFGU FXCLG           SPKEQCLJ        SHGSISTRNIFAJWE NWUDBGU         YACKRBSPQ       JTFKFU          JSEVOJ         
BLSTINVWBXKCO   : PICGJWTUDRDI    OWPAURXIUL      DGTFBTNGLBIWCX  VKSUS          
QXTUKMR         : TNYMYKHAAC      RYWH           
PRFWVSLMOOAKK   : XROCWUQG        TXRDPRKS        WVNOAJCGJIJFSJG
XGHAEREUJWVDS   : BCTJOMAWNLXTNJ  KDBAQPTPJO      XDOQIDA         ROFPM           BJUJK           AIYKVSVYYX     
PKRFEWEARROH    : VLUQAJHPACOEX   REJLAUTKOYGXL   TAWIEJEQDPI     DHGJRGP         VSUFWNFVMKXQ   
ORSARBHRGCYD    : ALTGPETDJJE     RRTNIKVENDGUW   DTAM            NSEDUBKOWKXD   
VBQOJI          : XRTTBTCAPOPCTXJ FPHEUG          EWPNQUL         PKYOXDBTMTET   
CPHYVJROXBWPS   : GSWFTVE         OTEHCIAGLOYNL   SEMTFDHIGMGQ    HJTNRKPCSHVK    XDQGJEITMH     
PKTWFCBEGOA     : BCTFRYSL        YQEGYENFGI      KXTGXCW        
HRTRSVHBWE      : HLMSKIDWWU      EPGNQPXUIU     
QULRRB          : GUXD           
KQAH            : YYWRLMSUEC     
HJTNRKPCSHVK    : RYCGY           CPHYVJROXBWPS   IKBVPET         AXCKIXYNIAPXYQ 
RUGQBSIVECNHP   : QUDUPOWGDOJBLF  LRJBEXOPTBGNUR  KLQTYYD         OERTLGGEHXDYW   GBDGEDEQ       
XRKQB           : LECHRH          BHKYTYXMWUWMK   MXRTJJONWYXFJJO
MOMWEO          : ATIFE           XNHJKWPKGFBTKQO NLUCVCAEEDOC   
MMDREAXU        : XTWLMYTXGBLVMSM DPTQ            UKYMNVBKMVCIUEL WNCXBV          BMQGVTFMJVTY   
QFWXIMFAP       : QSRWLDCK        QOEKPXYHX       DSPKIJXUBCCDOU  MYIIOLJMXNOFUJF
TAYUWLJJINAB    : KQHVRXHQEQKCKPX VWUAK          
MGVSGTPJN       : TUYVCX          LFFAS           WNUQCKKBUQAP    SJIKAB          PVPCYVPHYCH    
GLGUSIL         : KWSB            PYMW            KOWFEWKEXUDTGGR
CNAWKLGVW       : JWIMCGNQHVYDHG  OGKEUOLQEVDP    PTFYEAPA        LNUSUKIFHX      KGXGAWGEEKIDSQ  MLMKQATB        UEUBOIOELCJ    
XXBMEWF         : MRRWIFX         XECQBHG        
TXVH            : QAGWDTCL        CEFGWFBNTXOVX   IHVVDY          SVXOMAYOCLOECV 
EUEYPMKRQYRNLG  : ROVHCVDS        ICICGSINPCDFTO 
IDTGBUTHUB      : HYVDY           FXEXHV          RYODEMQEALOALI  UFLRFGQWML      EWCKXIBFOLHWCBM
OYRXWVUBW       : RNVRMUT         FLTVCWB         MBMVB           OAOPEYXEVVTBV   CEREOXUCPLIYD  
PICGJWTUDRDI    : RXUDVMWCNACVJ   GSWFTVE         BLSTINVWBXKCO   RKXUIVUNC       ULBYSQC        
MLJGSEHQUJI     : NPOXCCD         UNWCUQLO        AXCKIXYNIAPXYQ 
GGNKDYANDJY     : PNIQAEORACQ     ICFKWPREB       MPGTDLGREQFIX  
DWFXCPKOBTUVBFM : RYCGY           GDSFMDTUQGFDDGC WNCXBV          HJKLVYDSMRQ     NOGQ           
QWRYFFJL        : HFLMIYD        
MBMVB           : NLIATWLR        OYRXWVUBW       OVXVAM         
BXWYAMLROIOMJTC : EUHC            LNTQXYPBIY      HYYSOPIVJLPD   
MYYMHHXSNKTA    : FCYIKD          NIAXDBHVKAFMHK  UYTL            HIUV           
WPKWML          : EQHNPRRLDVAKDW  CXNHQIQWAHF    
BXRRGGFRDHYPIBE : ICRYHNIT        DHLQWNLHQANPGHL TFMFWGRQHEW     VQGUUECCTS      YKYULB          MPKFGGN         DUSEJHBF        MWIBVXPB       
IDKXPHYYEQJ     : UBJICKACO       PVPCYVPHYCH    
FWCIWTBD        : QYAAFDDJFEHYRA  TLRXYCMWBSGS    DHWCEXXBCV     
GWFPYVX         : CMSHYUPIUKDNFQ  NLQVWOGFHJH     TRUITQHMOXHQUE  XQWLXNYNEJVJS  
AQKFBIV         : XMBVLPCGNRP     LFHA           
JUNCGRJDVSBPT   : AAWAPFNBCWHT    NLIATWLR        YJYVVDLBVPT     QUPMGNXXXU      UXWCPEAI        FXWLXM         
RCGXRHVPJX      : UXALVVROTYJDX   GVKRTIMXKVW     BQJVCSOVCSMVD  
TEIEASOUIS      : SOLAYFJYXKYW    YOWKEKXRJ      
ADIVX           : OUJYYKWSUI      YNYXEDDM        QFVGRWDSNUDQ    WTBS            PUJKASXHGNFP    AUAQVMXNCX      GETUDF         
NRSITBI         : PVOQW           UKUOFJWPDB      KRNLYUOT        YKPCJU          QEBHBFK        
IEDRCMNGWRIP    : SWUEMHNTHUUD    NSGE           
DYCIBHRAFDN     : DKADFKRVXUKJRUX HHHLBC         
XXUY            : BHJXRNCANLMTX   DPGLNWMBWWN    
IHMLBPAO        : MYKAPXOIVG      EUHC            PVOQW           OHLIMIDWWWVKBXH TJVBGOHTAAAWNT  ULFKBY         
WHHPRM          : XVYE            IPTN            MVQSX          
TXRDPRKS        : PRFWVSLMOOAKK   DJUMWXLMAWX    
JRGES           : GTKQQCSDQPWGQ   JRODPNIDBWRHJTI AJCTKAFJWV     
MDCBETB         : CVUCFMKNLDUV    KIRBQAXSHV      ROPDNVW        
UBDCQUQHROYU    : BVNQFB          QVRFPX          AOYRYFHCHCBP    AECBSJVTOVMN    ASIVCCLONRGX   
TIAETTMYO       : SJPXEYDW        MSITSYCGWQAGCX  TKFLTIUF        VUQCTGOBHSO     XJHXJGLGAPHIIQA UJTLKKHWBRSALOD
NRHQWB          : DHLQWNLHQANPGHL NLIATWLR        SKMUUUCIXBVCMK  NDJPKTQGU      
QVXVAOQTXIK     : QFOXIMTGXTXBKNT LDYRHKUYVNPPYVA AUAQVMXNCX      CGMGFS         
GRSQTWKNKLCOCW  : JRJRPWRVKRTUCH  YBHHNWWE        BKWRSATO        JDWY           
STXPMVNIYCYSA   : LNAOFPCKCW      RJRANRWDU       DOOXXPBVJN      OHOCUJC        
DASWUJQUTGHI    : HBKOBRVANRC     RYRYHWAPSV      VWYHMSMWCQHDTFJ
VKISDCSTO       : HFLMIYD         QESTLAS         DOOXXPBVJN     
JYPM            : MYKAPXOIVG      HWDSDQTP        PFUXYSRWDODQAFI XNHJKWPKGFBTKQO UAQATN          YSFIKY          XMBVLPCGNRP     QXVIAP         
KOKQQFNOQF      : GSQEIVXUEYH     TFGTHXMRYYBTSW  VNBMDSV         FIVRFFSESLEHVI  GCHGWRCBTPR    
NLQVWOGFHJH     : RNVRMUT         GWFPYVX         UYTL           
FXTPW           : RQXBTSXYY       QGFFMN          OOIUASRW        FQXXIBPLXKFBQ   UEHJHTERIUKY   
EXWUKNOQBDHIO   : XXNLRH          NQIQMKYUHV     
UHSRVYXGL       : VINXWVXRYWPVFPF TDISYNSDPWIVO   HNYCIKXLMAJWXBM
KQGEIFSOD       : TUYVCX          CTVHCTKQMHYLE  
MOFBHIG         : SVXOMAYOCLOECV  SRUJC           PKAICDWVMIXFD   UWFIQHAYW      
RWOMG           : QEVVOLDJ        KKCMTD          SLVNEYSYXAECXXP ICICGSINPCDFTO 
GCHGKS          : WNXTBJV         QOYLIIQLWXKOQ   DOACBGLCE       UQWYJSQDYGTHJQC
VLWCWEULIMAY    : HYVDY           QUDUPOWGDOJBLF  BCTJOMAWNLXTNJ  HOUCUNJJ        RIDLWTKSRSMI    HTCEUCNLKTVWNRN
DIDJYUINJO      : ICMXMVXHSTK     EUHC            KFICFALXEKBD    WUIRXBS        
PTFYEAPA        : CEFGWFBNTXOVX   CNAWKLGVW       VLGHSKPWAAL    
MFKQAWBPYCJDKO  : QJFFOQHB        VREMMEU         ASIVCCLONRGX   
MLXCUMANGHMLH   : KRKTHMUWT       TFMFWGRQHEW     RPRFDU         
NVQUGJXFNNFPYI  : PJMU            GBXIDA          TDYF            CBNRWYOD        VLGHSKPWAAL    
OWPAURXIUL      : BLSTINVWBXKCO   BULHSSGCO       FBQOWAUAW      
CAEKEUGUPOGNUTD : MMPHYJETJBLF    ITRK            KKSQG          
KDIPRHFTDYRNTDE : PCCUY           YRHP            GLDDTPDAL       PXCOXB          KYJBHYGNFVT     PKYOXDBTMTET   
FLLJGRGVGNMDJPD : YJYVVDLBVPT     DGTFBTNGLBIWCX  HIOQKNMRUQJTQSN LKQYHOD        
SNLMVSHYSYO     : KVMMONGHOA      MJBQNAIOKRT     VHNMXQLQ       
FUNMGYWOSFLCS   : RQVJNRBDXRT     IQGHWAHVYBHOV   QANGHTIUKK     
FFPLBLYNXWGHXBH : MKBMSRJTWUDBF   QQLQNO          EPIRJEGNFW      HFOHUIYKOUOG   
QOIGBQIA        : JQHOJOVS        PJMU            LVUGMOAUR      
DGTFBTNGLBIWCX  : YCWECPPUN       BLSTINVWBXKCO   FLLJGRGVGNMDJPD HKCJIUHAEMHHHJA
AEDXG           : SSDMRGMNUOY     SLVNEYSYXAECXXP SOBAKYIPOFONGV 
LYDVFHOPHWTP    : FTURY           HTXAMFQE        VQUADN          UOBANUIAQJ      USXRGFEDSAQ     HEJFWTF         YPJCMHXRIJJM   
BTMQA           : IHLD            PGMXH           BJUJK          
RKXUIVUNC       : DPQGTULTQMUOBG  PICGJWTUDRDI    BMKIIF          ROFJTVJGDA     
VQGUUECCTS      : HHCTTFELLRMIDFU EGLPQBFPVPSDKC  BXRRGGFRDHYPIBE SHUK            SDTYQQOOYL     
QOEKPXYHX       : WFOFWTURSNQXAJL QTMAOYA         QFWXIMFAP       JDWY           
BJBVTWSHB       : DUIGMPAPTNIKJYM JNOXBVQUOF      HBKOBRVANRC    
FSUANCFRVAF     : YAIDUGELJA      DJUMWXLMAWX     PSPQNAOQHJXI    PROUBXWVYHX    
OJYGHBPIBRTCP   : PRULNFP         JMOXBESNHRFMKRM SMGBKJELDVJ     ANFRDB          YQBXYMCDHDBXGEF
CJXD            : FBUTEOC         XNYBDXUBV       DHWCEXXBCV     
DVUGLWLFU       : DGEJJYYXAIDESKM ILTSWOOSLHQPCGO YWPBXBRY        NGMDSBLMPXBKT   QHDCTCEN        REPK           
LKCULIFM        : QWOCVUESVHYF    YNFFGDOHKDBCB   GELBQLPORLGIGFV YAIDUGELJA      XBSUKOTEPOQOTI  RARXE          
NQSHSIUWRUBRYY  : HQWDSVLYLCFMKC  UEWNDCAA        XROCWUQG        MCQOCTK         EPKMGOXRXRJK   
FLMSSIGES       : KDNSBWDXROP     URMJOW          ICDJLB          HYYSOPIVJLPD   
CGUHTVWKOEFXB   : TKOQFTFK        TKOTTLEINKVGS   JOMQWM          URUNXWBJSVH    
RWGK            : VXSNNPVFAAQLGOO QUPMGNXXXU      BLALAVL         RYWH           
HAFS            : ELNKFJRKJFIUHT  BLAWGROYFJPBDEY NPOXCCD         QANGHTIUKK      HJSIVYRGACWA    TYFRFFBBIIVM    NOENCMIVLRH    
XMUGSP          : OOKWTBWDORC     DXSV           
UYLESIB         : BUIX           
YHMY            : UEWNDCAA        YORHVYTD        IVTP            YPWPVS         
PRIXC           : QCKNSIOP        LRJWVSCEPGWUEEF JOMQWM          WVNOAJCGJIJFSJG
GELBQLPORLGIGFV : RXUDVMWCNACVJ   KOVAKP          ILHJAID         LKCULIFM        EYNFUNMY        YQEGYENFGI     
AGOF            : RWNNRCTIW      
YSFIKY          : EUVNIG          JYPM            CPCEVL          HYNXJEYB       
LDYRHKUYVNPPYVA : QVXVAOQTXIK     WPLPM          
CVUCFMKNLDUV    : MDCBETB         MRHA            ONNERC          PPJNGTOLMSVERJD OCOCGOFQ       
UOBANUIAQJ      : PYMW            LYDVFHOPHWTP    NFTSNCV         OUILQVNIJRQVDJF
EYNFUNMY        : GELBQLPORLGIGFV WGWTFVR         KAUQJWLN        QQQQ           
ICSUOGIREE      : TQWGF           OTEHCIAGLOYNL   EBQSSKBFWOD     AHUMBRNYKUHXY   STGVSBKEHUTMM   VRWB           
YSLBGIJGYSEFT   : LQOPXS          KIRBQAXSHV      RCYQJVA         DAVSLFSEHGU     RBHXFEKDXBDVCJ 
MRHA            : EENGRO          CVUCFMKNLDUV    HRTNFL          YCFBH           SDTYQQOOYL     
UKUOFJWPDB      : DHUWORCOONV     NRSITBI        
NCMBEUJNDLJJSF  : OMAEDVUPWCI     WNCXBV          RFBJ            DUSEJHBF        XGXIOEVPNHDT   
GWMIQHSN        : YXUQRLSMQMEIQ   UQWYJSQDYGTHJQC LFCVXMRWORA    
AAVPDYJSCXVGSGV : XDUT            KWGAPE          SBUAKIDMLPYI    ANFRDB         
THFONKU         : CMRORTXSAALUE   VLGHSKPWAAL     LCPWUOQPCNURSRO
WFFGXTFX        : EOQYACK         PVREQVQSTRPS    FWCNLWUNSQKPBL  WFRMBRJ         SJUWMKJTMFHTFDO
DNYCYUEWQMR     : DWPMEUXCIW      PCUSDWAPLVFJUYM
LNUSUKIFHX      : QTRGTMOFVIJMI   QWOCVUESVHYF    CNAWKLGVW       SPUSDWC         XJJAM          
NDJLYQKU        : HBTB            EATXHXQ         HKPUSHY         JXDGMCRD        ANOX            PKAICDWVMIXFD   DMYXNLPKKUNFTD  QOYPUVPGCXUUC  
AUXARF          : GYCGFFMHTIYHQUJ LIHQSFU         CGMGFS          EGGHW          
ITRK            : GUJKWLIMDDASKPX JTPK            VQUADN          CAEKEUGUPOGNUTD YKASWXWRPSTIHR 
HFBDP           : UEWNDCAA        APUNJKW         KATXBJJM        ULBYSQC         LHXBQPMDN      
IXJN            : KMCJOGLY        KVAMW           GYRJOAI        
PYYOPJKLMHLOYQN : FXEXHV          VDJMXIXM        JBKJ            GYRJOAI         OTCWG          
NFTSNCV         : AESJAQ          YEEECRNQYO      WRFTUA          UOBANUIAQJ      JWSHTIB        
RIBRTOFLNFD     : YCWECPPUN       XCME            MLAJHD          JOHURVVPNDPQJ   PHKDIHWEPHRDV   XPYY            XFXFKWCFYVPC    WIJHDAMK       
QPSDWFRXX       : EPPW            HTPYICOPMQCH    UDOMJIUMDYNLS   HFVUJIPWNIU    
HLNEHDI         : HHHLBC          CCCQIDHTVXII   
VAPA            : MKBMSRJTWUDBF   OWAUUI          PHIRHIMFDU      BQUQLMEMAP     
MQAXHHBMYS      : IEYIHTHTSWQUYU  CWFSITHDMBAMS   LEXSQAABCDNTB   OHFVMCKPN      
EPPW            : PSLLJYOH        YXUQRLSMQMEIQ   QPSDWFRXX       XOUSOEEOSDOEE  
NFXCU           : JMOXBESNHRFMKRM DKADFKRVXUKJRUX ESKJND          KWJRCM         
LYMSW           : JPTXFSU         YVWET           DOSHSHPNXCA     DPGLNWMBWWN    
JWLV            : FTQGNLSGVMRXAW  KUGCPCBIMS      NTBFLCJAA      
OVXVAM          : NHSHSSELUKDCI   MBMVB           XPIXYUCFFK      WMMWQXW         UODKIPSLAWTVG   LFCHQNWH       
SUCLKYBBGBDBFQC : BHDATWJDDIJ     OWBBXXRANF      QOYLIIQLWXKOQ   LWGFT           QWEAXAQOK      
JALUYW          : EAEPYSJRSM      UJWAMXML        QBCSCYKEYM      LUPRKQTUHI      KMCTGTUOVJFK    QTITRQOSYNU    
PLPPIPDHKX      : SXTFAQHMV       IGVJGCY         XDOQIDA         XFMBMRLPIBFMSHF GFTJTJAK       
VLKAM           : KSXJRJQJYGDT    RYODEMQEALOALI 
BRUJKWFTYQPYOIQ : BQUQLMEMAP     
AHKRKSDKEB      : DHNEMNXHWTYUGX  NMWXQUAQVDBPGVI FVWJ            KFCTN           RYWH            TCCOGNCDHDG    
PBKIFE          : OOIUASRW        SFBAJXSRSFSNMCM
OOBTLANDB       : DSYWAIFNTF      WNUQCKKBUQAP    ILXHFDSMBDAGJF 
NSEOCRG         : EGFUWPA         QMBNLDPIQYP     SVMUBYKFUGLX    ASUBMOBBIOX    
MJBQNAIOKRT     : RRPRHOHIIL      DRJPKRKERO      JYCCYH          SNLMVSHYSYO     FMEYI          
UKGXHTBUWC      : MWQYAKFGU       LFKGKOGWOBOJI   VRKHJPHQCVNF    WIJHDAMK       
LWDABWG         : NEIX            LMYUGPFMTWACS   SYSGGJPFAPCCIVX QMBNLDPIQYP     LFCHQNWH       
JSRDG           : GTKQQCSDQPWGQ   NGLPYNA         CDHEWGGJFAKIKSO XVVGCFFTHNRM   
LWGFT           : MKBMSRJTWUDBF   KQHVRXHQEQKCKPX SUCLKYBBGBDBFQC EMJGY          
BEHBN           : LWHDRKA         FYHTD           TMVEPVGRJ      
CIYHHMGNMIKUA   : VXCPTDWODDL     FLCKDEIWKOLCUHI GVKRTIMXKVW     UBXOMMPUKBYQF   FEWLPNNFTBTTPCK
PTAXNNVWTPUWVCA : SULCYQYNJ       RNVRMUT         BTUGIXAWXWSQP  
GDSFMDTUQGFDDGC : DUWLKQXS        DWFXCPKOBTUVBFM DBNVYFJBC       WAKAR          
CCRSSPPOHKL     : UPXUDMVSHRBTWX  QEYDEHHJ       
PNQVSLD         : QESTLAS         HTCEUCNLKTVWNRN VBQUDEVLFB     
OWBHFGN         : DENQNUQ         TGULQWRU       
OPGTUYMNQ       : MROEONLICAHJFD  ULFKBY          IAABPAUHHS     
EYORFEFVCYH     : FQSOTKTFIINLXGV OHLIMIDWWWVKBXH YJSLCJGVHYY     QEARS           EQERFOQIAOXQ   
EYGHGNQVYHM     : QGFFMN          BHKYTYXMWUWMK   JAHBWBXU        AXCKIXYNIAPXYQ  VWYHMSMWCQHDTFJ
BHGNWXPBYHS     : UASBBLABYYCDNPM FXMXE           CDXHEFI         JAHBWBXU       
NXAQWJXEIH      : EATXHXQ         HFSXGAFFADJKIQ  HTXAMFQE        RJRANRWDU       STWHENJ         QQQQ            YHFPIEHHV       PCUSDWAPLVFJUYM
RUGNTOACPJIEGIV : NLIATWLR        GDOUJEK         SEJARDLOKXTQQ   SFRCUVBJVAQBL  
HFCNTDPKCAKIIRW : EAXUR           DWQLFOXPUADOFTB GRWKVOBAVSCNMDT KLQTYYD         QHIMTGQKSV      LHXBQPMDN      
NDQJTSL         : OHLIMIDWWWVKBXH SWVAHYEUEEIL    BMQGVTFMJVTY   
DWQLFOXPUADOFTB : JMOOABG         ILHJAID         XGMQN           HFCNTDPKCAKIIRW PWTLWLHOGOTJNV 
TLSEGRHVVA      : BNDEX           OBRQ           
RSTCX           : EENGRO         
UMXKKN          : GWHRTFUHDSARMB  TXJIRCFJQXU     NDJOPGUIPFAWAOF
MRVSLWDHKVN     : JBLPMRJYGH      LPKKLJQIYMBTOG  OBABJSSUE       UOGFKSCVPWELFF 
OUQMW           : EMXGJESMMVF     UPKGADKFMDFJE  
ESUJSLEFJQR     : ADUTOCIG        NGLPYNA         CCUP            FBQOWAUAW      
XFRVADUFMIBA    : UYWPVEGXSXCXB   XCME            ESKJND          JLEWHYHSIFFPO  
RXUGUTLPOWJCDQ  : NKUABGCVNMHJA   LVPNKVLIJ       KOBQH           XSRQWGCJQ       OHFVMCKPN      
ULNUQFRSKO      : ETOQT           RGHJVFTFVNDDIXX RGAXYD          TVLAVTSAW      
WWBXBTXVCUPNLGM : QRUDJGERNLGB    MBLGFMDDNCQT    BOVMPHTWTVCNPX  HIUV            OGCC           
KQNXNYMKRREMF   : RDXHXMQHADOSRFG VUYFHDJROABQT  
MCQOCTK         : OWYFLG          PUXGCCTCB       DHLQWNLHQANPGHL NQSHSIUWRUBRYY  PHKDIHWEPHRDV  
PMVHDJPPGAIV    : KNBBYMHD        KWGAPE          YJSLCJGVHYY     DAYCUVCT        DSPKIJXUBCCDOU  KYJBHYGNFVT    
XXNLRH          : MHXBVXXJQQVI    EXWUKNOQBDHIO   SDXSARWY       
FMJRRDITWSWPG   : EQHNPRRLDVAKDW  UPKGADKFMDFJE   ATONXEVUNJ      VDIITQFIRT     
YLGP            : HFLMIYD         AJCTKAFJWV      OEQLCK         
MPMKQMI         : NEAGWX         
XDOQIDA         : WUFOQFW         XGHAEREUJWVDS   PLPPIPDHKX      XCXJYSNMBCT     MYIIOLJMXNOFUJF PKYOXDBTMTET   
UFLRFGQWML      : IDTGBUTHUB      JDNU            FMNK            WMMWQXW        
ARLEG           : KDRJBQ          JREHFTBDQ       JMOXBESNHRFMKRM XNYBDXUBV       NNEEN          
QQWF            : FTURY           UCADLLYVYEY     PWBNFF          NOENCMIVLRH    
EGFUWPA         : PRPQBTMEE       WUFOQFW         QYAAFDDJFEHYRA  DXSV            NSEOCRG         AUKBJXTQF       EETSMIITAOEVWGV BYHRICQEO      
RXFFRMMIJ       : HBLRS           BVMGGDTAAEINA   VHCPTG         
VHCPTG          : KRTFADELKK      HBLRS           RXFFRMMIJ       SJVBBBWI        RAGSSHRCQCVMUUA
AYQW            : DIWEQCVEKU      WPTSXPBUKQOI    QXVIAP          UUAF            HHHLBC          FIVRFFSESLEHVI 
SDMAAJPBJKY     : XVYE            TBIFPOHVE       DSGLPITMU      
RQDEBOIWVM      : XDGCTTQCXSMJ    GLAYBKF         BCTJOMAWNLXTNJ  TSUX            YTQGKUQIY      
RUMRTDR         : SONVPVSBFWL     ALIFXFBDI       NSEDUBKOWKXD    DREFH          
YWPBXBRY        : DVUGLWLFU       EMJGY          
EADVS           : HOUCUNJJ        GUWF            BEYDNR          NWUDBGU         URCS            SDTYQQOOYL      JVUXLHTUG      
DTWNSVAJNUV     : EBJIGGHWMUFTX   SRFARXW         HNHWH          
QBCSCYKEYM      : CMDDC           IIQCYYLVTDVERCF GNMCKRPN        JALUYW          XYCADASL        ELFVMEJXPQDI    OCOCGOFQ       
XYCADASL        : MGXF            ALTGPETDJJE     QBCSCYKEYM      QUPMGNXXXU      QHTWF          
OLSHH           : KRSJYWTFCQWOYCT
QWPOHGQJCSL     : QTRGTMOFVIJMI   OTEHCIAGLOYNL   GUXD           
YKYULB          : UHRGDYPV        BXRRGGFRDHYPIBE NMVRBS          DPNOMDWCIPDTEUT HYNXJEYB       
LECHRH          : MMPHYJETJBLF    XRKQB           YFAJXX          JGHSJIMC        XTOVATPDB      
DDGMXYKQOTYHG   : NLLYBXL         MLLRFGD         BGNWJSFNCJAUYC 
CRQCERYP        : JQHOJOVS        FIPEJU          ILXHFDSMBDAGJF 
BEYDNR          : EADVS           PWDFGXPC       
LUPRKQTUHI      : TRWQNPDRU       APKXQGFYCNW     JALUYW          OPOGLUGQHB      NOENCMIVLRH    
GRWKVOBAVSCNMDT : JMXK            HFCNTDPKCAKIIRW CWYW            YOWKEKXRJ      
IHDWTBP         : YXEJWPQI        QBIDAQ          FQXXIBPLXKFBQ   TVLAVTSAW      
LGFIPPYXJ       : EUHC            MCAB            WYTOGS          BCXG            OLNNKFDGMWE     CVDMGPWEQAPAX  
IINJILFMARR     : CCDGQELD        XBASDOPP        YGKKCWNYNW      ANWA            CDJSPTSNCQBSXG  WOBVOTMEELPPD  
FACL            : SIBBN           TMLHXQB         SFRCUVBJVAQBL  
VMPJAXRKNJLNVK  : PHWXVDWPAP      YYWRLMSUEC      TLRXYCMWBSGS    UEUUXJWMVQ      YKSHIXWCYYYBG   GJQVVRUOBKX    
EBIOMNEMHVJN    : TQWGF           MYKAPXOIVG      KNBBYMHD        IMFKCXYVMWCKJ   AJNLGSJPIWQCKJG
LYYJNOUNOO      : CITHGIK         MGNAYXGSICMAP   DKADFKRVXUKJRUX TBFICJ         
CBNRWYOD        : LFONIODDTFMQU   NVQUGJXFNNFPYI  OVUIMG          XECQBHG        
ATONXEVUNJ      : RGHJVFTFVNDDIXX FMJRRDITWSWPG   EQERFOQIAOXQ    GMEUSFRNPSRLYLL
BKUMXJHN        : FYHNO           MFKAMRLVBL      GSFXXYXTABVI    JAXMULFGGETQNND
WNCXBV          : MMDREAXU        DWFXCPKOBTUVBFM NCMBEUJNDLJJSF  GRYVGOENCAP    
CNAENTV         : EBJIGGHWMUFTX   LFCVXMRWORA     TAMJ           
UCYPR           : QIXXGMTMWWKAGUY SHGSISTRNIFAJWE BUSSSGLL        LFCVXMRWORA    
LSWGFUPO        : XYVWAJNRDWOLU   CMUJVBFF        ROVHCVDS        JYJHCPW        
PNVTN           : CIEDV           PYUJCF          OHOCUJC        
RKEFMJSJHW      : AYMQWHDOL       HXFPVVFVHFJU    QGECKSMPHPDEEN  SYKSSSIML       LQRTQYENBJPYAR 
LXTDLFXILFED    : APGS            VVAGTHVJS       QLAPDLAUEM      AJPPDTAUBACGYRL
OUILQVNIJRQVDJF : ONFNWBSO        YDGCEUYCPRFPYGD PXDXEMVQEQBSO   UOBANUIAQJ      WKCVOLGUAJQFT  
ILXHFDSMBDAGJF  : OOBTLANDB       CRQCERYP        MPRR            RMSBNS         
YCNMULAGURWTXI  : RFBJ            OIPVCCTF        VWUAK           QAQPPVNEGMUMY  
KRNLYUOT        : NEAGWX          VMLNX           NRSITBI        
SYKBJQEIURUQGUY : OHLIMIDWWWVKBXH SMGBKJELDVJ     TSUX           
OVUOEWAVMLWH    : AESJAQ          WWNWLQUWGADUR   CPCEVL         
SPUSDWC         : YVYOJBQGGKAIVVA GVUJH           LNUSUKIFHX      KDNSBWDXROP     KRLHIK         
DMQXHJEEKFUGDK  : FRJG            MBUCWHUEROXONWI TGULQWRU        LDYVEHW         FUAFRHMGHR      XQDBHJQJOX     
CMLOALVCEOXYTUD : GNMCKRPN        XJHXJGLGAPHIIQA SNFYEXV         BLALAVL        
XPIXYUCFFK      : BCTJOMAWNLXTNJ  KBQJWEIQURFVFPL OVXVAM          UWLJLBQHAUIT   
ONNERC          : VSOYESAD        TXJIRCFJQXU     CVUCFMKNLDUV    CBBHMBCVWTF     GHJPJLYOSMRXI   RBVSHYRQTCSK    LKTHAEPEU       OLNNKFDGMWE    
GCDE            : NVJGISJAAGXW    GENCS           ANNADJTBJQW     LNNKPBM        
KUCJQYNGAF      : MJCECIABV       SONVPVSBFWL     LTQB            XFMMWBBPWWBUCMR TCCOGNCDHDG    
XFMBMRLPIBFMSHF : SIANUJGAVEMBI   PLPPIPDHKX      JODHEFIRPXR     LDVRQXTI       
LIHQSFU         : HUWDORQH        FNAWFPVVJERIAU  AUXARF          KXTGXCW        
VUSFW           : DFJB            MBAUMGO         AEYYXED         CDRAR          
WUFJXSDJKMM     : GUJKWLIMDDASKPX DSYWAIFNTF      FQHXCUWIBBKSQ   RYODEMQEALOALI  JQVYQHYTHU      JWSHTIB        
YFAEIMNQFIVAL   : RRPRHOHIIL      BLAWGROYFJPBDEY UNHSBHY         XBGENYIKQFQE   
WGWTFVR         : QVRFPX          FDIG            EYNFUNMY        TVTI           
FPHJCSXOLYWNE   : RCYQJVA         WWRLLQAQIPCWER 
CTVHCTKQMHYLE   : DFAJ            KQGEIFSOD       BAAQICGJBYSYKT 
IVTP            : USSKEFUPDVX     GANCTHACR       BNDEX           YHMY            WIVDOPTDGAX    
DBNVYFJBC       : TKOTTLEINKVGS   GDSFMDTUQGFDDGC PTAOKCBAID      HIDFHKENY       XPYY           
FHABEKFX        : QQLQNO          KSHIBDLIMESIFK  JVHY           
XMEXBIELEABS    : EUWUVVSHVUQEY   HQWXCFPUVM      QOYRMBVUFANHECM UGOKDBQNY      
FICGNMHP        : XVBYUMLNM       KIRBQAXSHV      DAVSLFSEHGU     PKAICDWVMIXFD  
OAOPEYXEVVTBV   : EMXGJESMMVF     BQIBPSOPSMOKOL  OYRXWVUBW       CSRIWMKYHJ      KKPWO           TAMJ           
JDIQDLJHQRK     : KXOURT          TAMJ           
GYFXL           : XTWLMYTXGBLVMSM CEBH            NLSW            NWUDBGU         LFHA           
XCME            : KOVAKP          QFOXIMTGXTXBKNT RIBRTOFLNFD     XFRVADUFMIBA    MHFPYMXHFAPW   
MLAJHD          : UBXOMMPUKBYQF   RIBRTOFLNFD     XYLCQYVROQYN    UWFIQHAYW       EPPXMYJKB      
EPKMGOXRXRJK    : KDCHG           NBWNMLTNE       JMOXBESNHRFMKRM NQSHSIUWRUBRYY  RFBJ            UREYJVYKSDPKY   QQQQ            YPWPVS         
RJYS            : MROEONLICAHJFD  WYYTBMSYSNO     IJJVDYHERQCQIH 
VSAJX           : CDGEQBKVIUIUS   LKQYHOD         PXCOXB          CVYTYPHDOWB    
VLGHSKPWAAL     : BQIBPSOPSMOKOL  PTFYEAPA        NVQUGJXFNNFPYI  THFONKU         KUGCPCBIMS     
QLAPDLAUEM      : NGINRTHQYNUS    LXTDLFXILFED   
WLQRNCPTBDBK    : TRWQNPDRU       JWGWSCGKHJUCHT 
NAUPDIATUAJ     : CBLOVLILCNW     GVUQ            EGPYQIY        
NMVRBS          : YKYULB         
MJJB            : VLAS            HIDFHKENY       DAVSLFSEHGU    
BUPF            : HNBALKLYARXENH  FAICXT          LXMBR          
CDNDBFGJFC      : AVLGXHHFGXLVO   LIOFYGD         TGHYESXR        MHFPYMXHFAPW    XRDJIWDYCUR    
HOFVBDPC        : XKQFTXPTQU      ROVHCVDS        GMEUSFRNPSRLYLL
JOHURVVPNDPQJ   : RIBRTOFLNFD     DVISAGYCKFNQFI  GWUHLR          TAMJ           
VMLE            : NMTRGVYQS       JWGWSCGKHJUCHT  EOIXBBYOUV      HLERXMYS        RPVINXMRUOGQL  
RGDBUIYXLPAH    : VJWPBQMSQWHX    VUQCTGOBHSO     TMAWVIOOTECN    WHGXOALAKMPKVUJ
RQVJNRBDXRT     : FUNMGYWOSFLCS   LLWAACHCIJQ    
VRVJVRBDWFAFE   : ICYXOLBNPJTD    OCOCGOFQ        SYKSSSIML       RCHKNCJB       
SVYCWST         : STCAFNYWA       DGOSK          
DHNEMNXHWTYUGX  : AHKRKSDKEB      TPTIILCYMGNNRDM
HBKOBRVANRC     : DASWUJQUTGHI    BJBVTWSHB       EEINFPAMQDDGS  
PUJKASXHGNFP    : PRULNFP         XGBQBPB         HJBG            ADIVX          
CQFIOU          : MGVWLIVGAROSIG  PHIRHIMFDU     
RHHVBDXOWAFMX   : QDHEEJSV        EJOPWLOVANKLY   VQABMWVAG       QICULPUMSBQH   
AXMAHUONKY      : KOWFEWKEXUDTGGR LNTQXYPBIY      UCYFVWNGVHQPS  
DHAS            : EPIRJEGNFW      GWUHLR         
RMNBIQGHGEJ     : DUIGMPAPTNIKJYM OFGJBP          XDFB            DPNOMDWCIPDTEUT SSTWXBGECYGGPW  NMWXQUAQVDBPGVI SNJYGSSJPC      JVXLW          
SHGSISTRNIFAJWE : QAGWDTCL        TDYF            JCCJQVWBASHCNNQ UCYPR           UWLJLBQHAUIT    BULHSSGCO      
YYWRLMSUEC      : GVKRTIMXKVW     HMHDPBNATUFIDB  KQAH            VMPJAXRKNJLNVK  EJOPWLOVANKLY   FITUHXXHCAI     MCVYBLNTBYVCEF  UNODVUVFB      
MGNAYXGSICMAP   : WUGJSSRCNATI    LYYJNOUNOO      IQGHWAHVYBHOV   MVTTYKOYQHF     ROPDNVW        
IQGHWAHVYBHOV   : FUNMGYWOSFLCS   MGNAYXGSICMAP   CPCEVL          BHKYTYXMWUWMK   UYFBD           MLMKQATB        BJCNWVA         FNQFKRQX       
SXKFEYHEYPYHRL  : LIOFYGD         WYYTBMSYSNO     NHJVUFRYFUSBOIC POOMOEKPN       ICHRM          
KIRBQAXSHV      : LIVEKAYMTH      MDCBETB         YSLBGIJGYSEFT   FICGNMHP        CESUGFP         RWNNRCTIW      
KFJGKCF         : MAJIHPK         FFRGDKPC       
JJVSNWIMEBAON   : YEEECRNQYO      UUAF            SYKSSSIML      
IOEIOWRMRERBLE  : IOKCHY          HBTB            DEFFDIF         TYRXDRPXYWED    RBVSHYRQTCSK    LNTQXYPBIY     
QAOAXJQV        : ICWXKQYCNEYD    XIKMFPIWFQOGWFA
FCVISJS         : BMKIIF          QTITRQOSYNU     UBTQAFTW       
AYMQWHDOL       : PPGCYWWEVUCSKR  RKEFMJSJHW      DMYXNLPKKUNFTD 
SWAXNCPQC       : TRUITQHMOXHQUE  OKGMCYOAYHEKHMI
HXTODPWVBSXDR   : PHWXVDWPAP      WINWQELNDPM     PPGCYWWEVUCSKR  CARMNCMSGBPHRP 
TOUWGGUYGW      : HMLCE           JVXLW           AFAUOCETC      
TBOMDQ          : DKADFKRVXUKJRUX AKGHLDYKCJMPFL  EILMMDNFWH     
EKLH            : QSUTVSIRLGIBXL  KOYURXTEO       ALTGPETDJJE     HKPUSHY         JVMRFBAISD      STLTGTPM       
IDGDE           : QCKVRCXJQWT     GDTO           
VREMMEU         : DGJFQ           MFKQAWBPYCJDKO  UCAFIHPBW       ISRWM           FUMBRFOKUKDWYJ  TAMJ            NDCVUNCSQT     
BVBXVXYMKEDH    : BHKGLAJJYXFK    FBUTEOC         EWCKXIBFOLHWCBM PPTNXYCDB       LFCHQNWH       
QURVFXCJCMHVTVI : SJPXEYDW        QFVGRWDSNUDQ    LASG            UWDA           
RFBNJYLHAY      : GVJO            FKGEACPFKIKXUS 
GEDRWXJSE       : LNAOFPCKCW      WNAMDYJCEQHP    DHHCTBJAMFKY    AXQVGRA        
XPJMWFG         : PFKAK           OOIUASRW        AKTTCNGOFFDPJLF
PGMXH           : BTMQA           FITUHXXHCAI     VNILGD          RKGFRH          KPCDYULJE      
HIOQKNMRUQJTQSN : FLLJGRGVGNMDJPD SVXOMAYOCLOECV  OTCWG           XECQBHG        
DNMOALWJHM      : YVYOJBQGGKAIVVA TLFXVWSXOQPAVD  CXNHQIQWAHF     ECAQLAOM        EMXFYYOJAUTAWUR
TMAWVIOOTECN    : HHCTTFELLRMIDFU BNDEX           XGMQN           OTIMKMXEQFLM    RGDBUIYXLPAH    PMGGKNXIRLFIBN  HYNXJEYB        FGDHQ          
TMAWVIOOTECN    : TREKP          
UYTL            : CJYVQTQBQUPE    DUWLKQXS        MYYMHHXSNKTA    NLQVWOGFHJH    
JLWYXMYMJI      : WINWQELNDPM     FFWPF          
XBPNBNJJCYF     : SAKNGV          OERTLGGEHXDYW   ICICGSINPCDFTO 
BUIX            : NHJVUFRYFUSBOIC UYLESIB         MEPJNYBGKEMJADW
EJOPWLOVANKLY   : RHHVBDXOWAFMX   YYWRLMSUEC      JIHSFCNTOETIGBJ TIKORUNOYOPXR  
KATXBJJM        : APMLRPMYUTO     JQNANYUMWT      HUKQI           HFBDP           KMCTGTUOVJFK    GBDGEDEQ        BTUGIXAWXWSQP  
ISWL            : QEVVOLDJ        GNJVTE          YRHP            GEJKHGITKMLBW  
HJKLVYDSMRQ     : UYRMGLLMEHADV   LKVOIBDAG       VMLNX           JPTXFSU         DWFXCPKOBTUVBFM VQTSDTHM       
HBBGFNGC        : LKQYHOD         NEXYOQVCX       TERNCUIAGW      SNJOMNHPRH      QYHLBCT        
JNXW            : RYCGY           KMJCPLJ         LFCHQNWH        GTSIXVRHTE     
GRDSHKCR        : LQOPXS          LFIO           
XQBTG           : OARAYSLXL       HJBG            HBJFVLKGPF     
KVAMW           : SULCYQYNJ       SIANUJGAVEMBI   IXJN            LKQYHOD         SYKSSSIML       OJMXNYVA       
TLRXYCMWBSGS    : AKORWLMLC       FWCIWTBD        VMPJAXRKNJLNVK  QVKEHJHHYFURU   DKFPAGRXDS      ULBYSQC        
YAIDUGELJA      : BLNV            NHJVUFRYFUSBOIC FSUANCFRVAF     LKCULIFM        WCOPHOEO        WBJVSQCHNDW    
CKPEYPNTDITE    : IHVVDY          BGNWJSFNCJAUYC 
GENBKGWLIFQ     : PHBVAWVCMR      SHEIOEAKYCKH    OTCWG           LBVHRVIJYRKQLPJ
NWRWWNBI        : QEVVOLDJ        LOAEGWXVEKEH    TVTI            JOMQWM          KWJRCM         
IHVVDY          : TXVH            CKPEYPNTDITE   
XDQGJEITMH      : GWHRTFUHDSARMB  BPNCAUFRTCLV    AJCABXRI        HYQKSLHLUOQLLDO CPHYVJROXBWPS  
XNYBDXUBV       : CJYVQTQBQUPE    NGHWBVBME       CJXD            ARLEG          
CEPKNLJ         : MGDCPXGGANG     JDAC            RIDLWTKSRSMI    UXWCPEAI       
MPRR            : KEBYXLNR        ILXHFDSMBDAGJF 
ACNKXDS         : GDOUJEK         KEAIKQQIAIHD    AAOBBDPFVKVHC   RYRYHWAPSV     
BIHELFAM        : VDJMXIXM        LKMQGEVOWS      LBVHRVIJYRKQLPJ
LRJBEXOPTBGNUR  : SGJMHECEWMLU    RUGQBSIVECNHP   CPCEVL          YPJCMHXRIJJM   
WHYXKTGLCP      : WBEMKJ          PROUBXWVYHX     HBJFVLKGPF     
NWUDBGU         : JCCJQVWBASHCNNQ EADVS           GYFXL           RMSBNS         
JBKXREBARVRIVYH : OTJG            NGTRTNIHWSRAHMF JMTIUV         
MDCAFR          : TSNHIXR         REJLAUTKOYGXL   LAMPRGFTRPCI    URMJOW          FPHEUG          HYYSOPIVJLPD   
SONVPVSBFWL     : SAONALYPC       RUMRTDR         KUCJQYNGAF     
OQGOK           : VXSNNPVFAAQLGOO ASIVCCLONRGX   
ISBJCWVF        : JKWEE           UCADLLYVYEY     OSINEEHHEBSC    LTDWCPWDFSFFX   YTCY           
YKQRGFIEXE      : ALIFXFBDI       OJAXELICG       VQTSDTHM       
YKWMPNFWCQ      : PEHKNUANX       FDOIRAMU        SBJBIDWLLOHNNFR
MLDXOCUVBVJ     : OYGBUOOYHEEIFGU ANDWQWAX        UEUUXJWMVQ     
NPYXVWDVVPULFI  : YSXLACWFA      
EMJGY           : NFJVHITXVWMMIGR LWGFT           YWPBXBRY        GDQO            DOOHCB         
LXONUKOQT       : GJVNAFLFX       RFAWBWTYVMIRJA  WNOFHYJP        ITWFFXTXY       GTDPND         
GLIF            : ADUTOCIG        WPTSXPBUKQOI    QVJSWCPDT       MHGCE           YPJCMHXRIJJM   
FKGEACPFKIKXUS  : HVLFIUMOOO      RFBNJYLHAY      QXKFNJBCH       SHJWHTXRQ       EBBMTA         
SHWHWTTOKOWTCHY : LIVEKAYMTH      JGUG           
NJTTJXLQITDIQY  : YBSLAPURIU      NTBFLCJAA       LIJFQLNCPPVOARO OTBXWLNB       
JIHSFCNTOETIGBJ : OSEVGUUTI       TAHOKSPFJULPEHG EJOPWLOVANKLY   SHEIOEAKYCKH   
QUPMGNXXXU      : ELNKFJRKJFIUHT  JUNCGRJDVSBPT   RWGK            XYCADASL        WCOPHOEO       
HLERXMYS        : YDGCEUYCPRFPYGD IUFBXPPIQ       VMLE           
DGOSK           : CARMNCMSGBPHRP  SVYCWST         IYVGRAAVWS      BLSLDVVYKGFMYFH
DTMPPFKFSR      : PHWXVDWPAP      KSXJRJQJYGDT    SEMTFDHIGMGQ    HEJFWTF         KKSQG           TSUX           
SRSPWCECTCOVUJ  : WLBPOG          VAHOUEAPHUAN    NNEEN           DBFYIUMGSEC    
EYTOJAIVPXECFWV : VLGBPSJJFDBHX   VRHWUGQMBOMWJ   BHJXRNCANLMTX  
RPVINXMRUOGQL   : THHFGLVJDHR     VMLE            DTNAGRVUEFQEOJL EKRCUFJTM      
RPRMHBORAGSE    : IFIIDXVWBQDE    HPPMXTYQRIDWSR  LYXHQJDUPFIMFC  YOWKEKXRJ      
XDFB            : MGVWLIVGAROSIG  RMNBIQGHGEJ     WDYWN          
UYDKYPCTGLMUE   : YNXOYRLBWCE     MBUCWHUEROXONWI QOYRMBVUFANHECM
MVTTYKOYQHF     : VXSNNPVFAAQLGOO MGNAYXGSICMAP   VQABMWVAG      
HIGK            : GSQEIVXUEYH     KWYYYINCE       EPGNQPXUIU     
EJJOJCTFIFS     : SKMUUUCIXBVCMK 
LASHVOGGDIWM    : BPNCAUFRTCLV    TVTI            TDNFTXWL        BLSLDVVYKGFMYFH SFRCUVBJVAQBL   XFMMWBBPWWBUCMR
VUYFHDJROABQT   : WHUAC           PFKAK           KQNXNYMKRREMF  
CBBHMBCVWTF     : KMCJOGLY        KVMMONGHOA      ONNERC          KWYYYINCE       QRPAKIHEMYJ    
WNAMDYJCEQHP    : LRJWVSCEPGWUEEF GEDRWXJSE       PPVSBMGQCVQGJX 
WPLPM           : FIPEJU          SEMTFDHIGMGQ    LDYRHKUYVNPPYVA DOACBGLCE       KYLTWQMD        AJTIXDNQ        JWSHTIB        
RNVC            : HNHEDHJOOHSD    HNBALKLYARXENH 
AEYYXED         : WQLBM           VUSFW           NUNPN           PADK           
TFMAG           : XGBQBPB         FXSDXWUIXGJN    OBFSWO         
EKOMAALSL       : QGFFMN         
FITUHXXHCAI     : RANGW           TDISYNSDPWIVO   YYWRLMSUEC      PGMXH           UGNAVNBHWHQCE  
GLDDTPDAL       : LDOBDFAXQDUUKMR KDIPRHFTDYRNTDE YDWQQBINVWFLB   PKYOXDBTMTET   
NAXPCJIONNYJ    : QTNDGWFSPFUP    JXUYTEOPNBSNNYK IMOIXLKLLCTJJPU GETUDF          XQDBHJQJOX     
GHJPJLYOSMRXI   : PPGJ            IMFKCXYVMWCKJ   ONNERC         
DJUMWXLMAWX     : AMBAYKFPLSDHAV  TXRDPRKS        FSUANCFRVAF     RRTNIKVENDGUW   YCFBH          
KLQTYYD         : VMDYMMAFLYFRHSJ GSQEIVXUEYH     EHNDITXYE       RUGQBSIVECNHP   HFCNTDPKCAKIIRW RQKDCSBUBW     
PNWQE           : AONS            WFTL            AIYEBHHXMQAEAC 
DWPMEUXCIW      : DNYCYUEWQMR     YPWPVS         
VLAS            : MJJB            SNJYGSSJPC      DYOQUJHWXTWS   
RGXKCWJ         : OHLIMIDWWWVKBXH EBBMTA         
IYVGRAAVWS      : LAMPRGFTRPCI    DGOSK          
ENKIXHITSKPFE   : RRTNIKVENDGUW   YUUNBLXULW     
DOACBGLCE       : CDGEQBKVIUIUS   GCHGKS          WPLPM           MPGTDLGREQFIX   FMEYI          
UFTSEO          : HNHEDHJOOHSD    FWRQRQSHKNTHF   MAJIHPK         URMJOW          RQKDCSBUBW      LYMTUBQRGBQBHX  PUELDCJDLJJTGFH
KDNSBWDXROP     : OLGUBHO         FLMSSIGES       SPUSDWC         MCAB           
UNCMNFNWS       : DQXBPXYAYXK     XJJAM           XFMMWBBPWWBUCMR
BMKIIF          : RKXUIVUNC       FCVISJS         XYAB            YPJCMHXRIJJM   
XKADATEWYE      : TJVBGOHTAAAWNT  TMLHXQB         JSEVOJ          HUCEYUHTXSBSMV  BAUE           
PTOLHRXXYNWRDXG : YXSCRPUIQMVS    SBUAKIDMLPYI    MWIBVXPB        JSVTMMSGSLPSLC 
JQVYQHYTHU      : WUFJXSDJKMM     HLMSKIDWWU      UMGGRARDSOVTE   QHDCTCEN        WDYWN          
HUFYKC          : STCAFNYWA       HXWIQQHVKFRSKCV HRTNFL         
XJHXJGLGAPHIIQA : KYSSJLHRH       LYFFTKOCQG      TIAETTMYO       CMLOALVCEOXYTUD
PSPQNAOQHJXI    : FSUANCFRVAF     RKGFRH          PPTNXYCDB      
AVWMGU          : OGXXE           TIVPKFLFLMQK    CSRIWMKYHJ     
MHFPYMXHFAPW    : XCME            CDNDBFGJFC      QOVINWKSMHQYTUP EPGNQPXUIU      EUMUOXS        
GNJIEAPP        : SXAYLGYBBJB     SLVNEYSYXAECXXP
XMBVLPCGNRP     : LYKTWQTLWDR     OOXTMCGJU       AQKFBIV         JYPM            USXRGFEDSAQ     YQEGYENFGI      UJTLKKHWBRSALOD RSJCIKBF       
HOHHXMIOLCWCLFG : XGBQBPB         XEBBFLGAS       DOOHCB         
WWNWLQUWGADUR   : DENQNUQ         MMPHYJETJBLF    OVUOEWAVMLWH    JKBKDSYFFUWTWPJ
PBKXKJMSAYWYBI  : EPBOJU          VPVTW           NGWNUXQ        
JXDGMCRD        : VDJMXIXM        TENLCBWYV       ARCIYMEGGJEVOI  NDJLYQKU       
OMWUHQQYRDWFO   : TDKQOLQGXGHATTP NLLYBXL         WUFOQFW         JKUMBBIBHHA     NBHCYEGQMVHC   
XONVPQGV        : EPIRJEGNFW      TENLCBWYV       OSINEEHHEBSC    KOWFEWKEXUDTGGR
FYHTD           : PSMKYSBX        VAHOUEAPHUAN    MKOL            BEHBN          
YBSLAPURIU      : DWSLIPD         JMOOABG         OTHQFDSCDOR     NJTTJXLQITDIQY  PROUBXWVYHX     BJCNWVA        
LTQB            : PFUXYSRWDODQAFI JBKJ            KUCJQYNGAF      VPVTW           WBIVOJLLHMXFFSH JAHBWBXU        FEWLPNNFTBTTPCK
RRTNIKVENDGUW   : GSQEIVXUEYH     ORSARBHRGCYD    DJUMWXLMAWX     ENKIXHITSKPFE   MBUCWHUEROXONWI ULFKBY         
XWMQKPGGHQBU    : EUIAJ           NHPHYOYUYQQ     PMXTIOP        
UOECGVXVGLRNY   : TCDEVKVRQYWYEB  ICHRM           SSFBWGEKBEU     YBVFFJUXMPQ     YQBXYMCDHDBXGEF
VVWHTVWNHMVN    : BCTJOMAWNLXTNJ  KHUOLFCHYGCST   GTXDTBBDKPSNU   PBSPM           RWNNRCTIW      
NOQQJFWN        : TIRMDY          AXENMUP         BCILYUVNVD     
UOJCAERBCNW     : JMOOABG         GRYJNGCVDCV     KNBBYMHD        EMDR            BJCNWVA        
USXRGFEDSAQ     : YEEECRNQYO      LYDVFHOPHWTP    XMBVLPCGNRP    
TJUBGLPBAYFCDW  : NRVWVUHG        FDIG            KPVNSS          VKSUS           XCAMOQQYEGAUEWD
HKCJIUHAEMHHHJA : DGTFBTNGLBIWCX 
DJLFRWUUYVD     : QVRFPX          CVISGBEPM       RAWYCCBVKEDGDD 
AAGJNIUVG       : TETTGCYNVJCL    HFLMIYD         SQOMPTKJUY      QFVGRWDSNUDQ   
XKQFTXPTQU      : QILPVJGQSD      HBLRS           LEXSQAABCDNTB   KDRJBQ          HOFVBDPC        SOLAYFJYXKYW   
DAYCUVCT        : RTEMHPVHEDVLR   BCILYUVNVD      PMVHDJPPGAIV    BSVK            KMUOVWTDTTIMD  
DTAM            : HNBALKLYARXENH  ORSARBHRGCYD    TYFRFFBBIIVM    IQWEXSDJC      
PWBNFF          : QQWF            LIJFQLNCPPVOARO
PWTLWLHOGOTJNV  : EUOBGCBWJMMM    DWQLFOXPUADOFTB KUGCPCBIMS     
KAAJGVLSCDR     : YUOROWRMD       HNYCIKXLMAJWXBM CBJJLEF        
QXKFNJBCH       : OCFBTQ          FKGEACPFKIKXUS  OHFVMCKPN       FHUEOOGUA      
JXUYTEOPNBSNNYK : THQBCWHBPD      TENLCBWYV       MQXXTDSVWR      NAXPCJIONNYJ   
ROFJTVJGDA      : XOLQQHYHJGAAO   RKXUIVUNC       AJTIXDNQ        AOYRYFHCHCBP    WUJDXBHLTJCO   
ECAQLAOM        : DNMOALWJHM      KOUEQPBRBWSTA  
UCLIDEW         : OLGUBHO         TKOQFTFK        BEDRLFTLIU     
DJSWXXJTVSCA    : YIYFCJLJEKQ     WSJJTYOSTNNPIK 
UEUUXJWMVQ      : VMPJAXRKNJLNVK  MLDXOCUVBVJ     BEDRLFTLIU     
ADQEHPWN        : NWBXDQRSLPSK    NPOXCCD         KYLTWQMD        KIXXAJJXW      
RKYRTUOPWQIUWGR : VTHQFDIUX       OHLIMIDWWWVKBXH ALJUANAV        IYGNTTNCM      
PPJNGTOLMSVERJD : FCYIKD          HUKQI           CVUCFMKNLDUV   
TEEQBUGALOUJ    : CDOKJOBL        YAULGHBY        KELQFEFE       
NGMDSBLMPXBKT   : KXOURT          WDYEMYELSRSPQGX ILTSWOOSLHQPCGO DVUGLWLFU      
EFKQYQVRRQX     : UWFIQHAYW       UWDA           
DPNOMDWCIPDTEUT : LEXSQAABCDNTB   YKYULB          RMNBIQGHGEJ     PRRIUYOBLEMJFI 
HNMLSWDUNY      : ANSFJXLFG       FNAOXSFEXHDE    EUMUOXS        
FRNAUFPL        : PTWIAJ          OJMXNYVA       
SJVBBBWI        : VHCPTG          TCWXCSCDW       XGXIOEVPNHDT   
RNDHDR          : XSXIUELJCR      FTRJXOJC        MOFWBWVPJMDWC   HFOHUIYKOUOG    SVMUBYKFUGLX    UBTQAFTW        SEJARDLOKXTQQ   XKJGC          
RNDHDR          : WMVL           
AUAQVMXNCX      : SSDMRGMNUOY     AGHYTSQUN       KRNJ            ADIVX           QVXVAOQTXIK     EPTNJPCF        WAKAR           QICULPUMSBQH   
HNYCIKXLMAJWXBM : IGVJGCY         RCQRB           CXNHQIQWAHF     UHSRVYXGL       KAAJGVLSCDR    
KPVNSS          : TJUBGLPBAYFCDW  RNXTIASJPML     YDJFID          RBHXFEKDXBDVCJ 
JODHEFIRPXR     : TGHYESXR        XFMBMRLPIBFMSHF BAUE           
HCRUQRENQ       : SIBBN           KVGYXBQIXDUAKF  YPHSVNX         BGNWJSFNCJAUYC  UIVSOLBGDSBHEGK
BUSSSGLL        : YSPUQPEKGD      KEBYXLNR        UCYPR           KMJCPLJ         TGULQWRU       
UCAFIHPBW       : GJGFKPIHQSP     HREGOVSPMBWUE   VREMMEU         XCSAMJUDPGEB   
UQWYJSQDYGTHJQC : WMDXHDK         UASBBLABYYCDNPM GCHGKS          GWMIQHSN        YFAJXX          DSGLPITMU      
LKQYHOD         : SIANUJGAVEMBI   YDGCEUYCPRFPYGD FLLJGRGVGNMDJPD VSAJX           HBBGFNGC        KVAMW           INYPADFATD      GENCS          
TMTJPSYKKWJ     : HHCTTFELLRMIDFU NFNOVNMB        YGKKCWNYNW      KOWFEWKEXUDTGGR
RCYQJVA         : HHCTTFELLRMIDFU DQXBPXYAYXK     YSLBGIJGYSEFT   FPHJCSXOLYWNE   DHHCTBJAMFKY   
MCAB            : USSKEFUPDVX     LGFIPPYXJ       KDNSBWDXROP     DKFPAGRXDS      LXMBR          
TAWIEJEQDPI     : HJBG            PKRFEWEARROH    NSILYM         
OSINEEHHEBSC    : FIPEJU          ISBJCWVF        XONVPQGV        OUVQQFJ         UKCBWXJBBRQKWH 
NOGQ            : GJVNAFLFX       RJLX            QTMAOYA         VAHOUEAPHUAN    DWFXCPKOBTUVBFM YUUNBLXULW      WPEYUMBDVRSUNNK EQERFOQIAOXQ   
NOGQ            : TNGHL          
VKSUS           : UVVSCHRT        BLSTINVWBXKCO   TJUBGLPBAYFCDW  HIUV           
GYRJOAI         : QSUTVSIRLGIBXL  IXJN            PYYOPJKLMHLOYQN POOMOEKPN       FIVRFFSESLEHVI 
SSTWXBGECYGGPW  : GNJVTE          RMNBIQGHGEJ     PSLCEVTNNQLDX  
GRMSKJNJQMDCB   : MFKAMRLVBL     
KGXGAWGEEKIDSQ  : TNAPNW          CNAWKLGVW       PPVSBMGQCVQGJX  RARXE           AIYEBHHXMQAEAC 
RFBJ            : LYKTWQTLWDR     UYWPVEGXSXCXB   NCMBEUJNDLJJSF  YCNMULAGURWTXI  EPKMGOXRXRJK    DFQB           
VVEJHWVKYYNM    : WKMAYFIKNR      ELFVMEJXPQDI    YAHHYRN         DYOQUJHWXTWS   
NSILYM          : PJMU            TAWIEJEQDPI     EGFFTPI         CEREOXUCPLIYD   VQTSDTHM       
LVUGMOAUR       : VLGBPSJJFDBHX   TRHCYJVD        RYODEMQEALOALI  WRIWQUDQTAV     QOIGBQIA       
OOIUASRW        : FXTPW           PBKIFE          XPJMWFG         QTWHUSWMBSPO   
TVTI            : EQHNPRRLDVAKDW  WGWTFVR         NWRWWNBI        LASHVOGGDIWM   
JDNU            : UFLRFGQWML      STMRRQCSOVVJNQ  XVYE            KELQFEFE       
AKPXGX          : TGRYCJ         
WXIQM           : FQHXCUWIBBKSQ   UEWNDCAA        YQEGYENFGI     
HXWIQQHVKFRSKCV : BLAWGROYFJPBDEY HUFYKC          XCAMOQQYEGAUEWD
YACKRBSPQ       : DYNMFYC         JCCJQVWBASHCNNQ ELFVMEJXPQDI    DJMETT         
QBIDAQ          : OYOCQL          IHDWTBP        
WYTOGS          : EJGRVSWUHKWNBN  CBATCCQH        LYFFTKOCQG      LGFIPPYXJ       SLVNEYSYXAECXXP LTKWHDOYNL     
NMWXQUAQVDBPGVI : YUOROWRMD       AHKRKSDKEB      RMNBIQGHGEJ     XOUSOEEOSDOEE   INEJPHGFBFUSTP  OSFGRVEWDMUSOOO ICDJLB         
LYXTEAMIALEQTWR : JSROCQNFHEDHVGF ENYEQSFTXPJTF  
MQKDMLT         : AMCWDSQRW       TENLCBWYV       TKMQM           DQXBPXYAYXK     MCRREONYDUHDOGN GWSYWJO        
OWAUUI          : VAPA            KUGCPCBIMS      SELGWWKEXWDU    HTCEUCNLKTVWNRN LFKGKOGWOBOJI  
IJRDOTRYT       : VTHQFDIUX       UYXWCKRJBUPQW   EENGRO          EKRCUFJTM      
DKADFKRVXUKJRUX : HBWHYSXXAGIMP   LNHUDQYH        DYCIBHRAFDN     NFXCU           LYYJNOUNOO      TBOMDQ          TVLAVTSAW      
VUMGQUQIAH      : LJDLBCOPUN      NPOEIROOPNASG   YDWQQBINVWFLB   CENTSKDWGIQV    OAAANSBGGFC    
SIBBN           : IDLGYGTTBRUX    FACL            HCRUQRENQ      
BSSOKRMIC       : FQHXCUWIBBKSQ   BLNV            FVWJ            WCHKGOAVEKG     NEWM            UNODVUVFB      
AAXSV           : SOLAYFJYXKYW    JOMQWM          HDYFUQUYPBLTY  
HEJFWTF         : VEQU            ATIFE           LYDVFHOPHWTP    DTMPPFKFSR      UCBEFRBMUYOLQB 
AAOBBDPFVKVHC   : YLNYE           CDHEWGGJFAKIKSO ACNKXDS         SNFYEXV         MWIBVXPB       
PHIRHIMFDU      : VAPA            CQFIOU          KXNOXYJ         PADK           
MAJIHPK         : KFJGKCF         UFTSEO          STWHENJ         GCHGWRCBTPR    
FMNK            : ESOCEPKTUCCOBS  UFLRFGQWML      NOENCMIVLRH    
SIMQPRD         : BRFVBYIE        NCFXK           EGGHW           SDTYQQOOYL      VWYHMSMWCQHDTFJ
YNBI            : VJWPBQMSQWHX    KWJISBP         GWSYWJO        
ONYLYNLIVUYJFGV : NLHN            RSJCIKBF        BQJVCSOVCSMVD  
SAOB            : XIQBWWP         ICICGSINPCDFTO 
GTGJ            : CSKIYJLO        UWDA           
HXFPVVFVHFJU    : RDPU            RKEFMJSJHW     
IPQRX           : IIUVVUSU        KOBQH           RBHXFEKDXBDVCJ 
NRRNGTCONLBQSBX : NBWNMLTNE       YRHP            MIADYDXXO      
WTOSDVFAON      : CDXHEFI         SNJOMNHPRH     
HFOHUIYKOUOG    : FFPLBLYNXWGHXBH RNDHDR         
AJCTKAFJWV      : RJDSO           JRGES           YLGP            VNBMDSV         SYEYTDY        
AUKBJXTQF       : EGFUWPA        
XCSAMJUDPGEB    : YJBWXJFIKANKSUL BRFVBYIE        UCAFIHPBW       LVIXXXGADIUTL   MHGCE          
ALIFXFBDI       : RUMRTDR         YKQRGFIEXE      MBDBCCXRRHFG    YBHHNWWE       
NLHN            : NBTUNOA         PSAGHN          TSIIEDWQTPPQHKQ ONYLYNLIVUYJFGV FDOIRAMU        WAKAR           WMVL           
YURY            : RUKMNNVVDXXTDX  WPTSXPBUKQOI    VVXLAVWC       
KYLTWQMD        : GVJO            GSWFTVE         UEWNDCAA        WPLPM           ADQEHPWN       
NLUCVCAEEDOC    : MOMWEO          JXYSRHYAOUYKWJC RBVSHYRQTCSK   
AKGHLDYKCJMPFL  : TBOMDQ          KMJCPLJ        
TOCKCYMACOEG    : WYAYULDMPMOKI   PWDFGXPC        BJCNWVA        
SKMUUUCIXBVCMK  : NRHQWB          EJJOJCTFIFS     QJVDLHNYBTVGJ   MEYCA          
SVXOMAYOCLOECV  : TIRMDY          RQXBTSXYY       TXVH            MOFBHIG         HIOQKNMRUQJTQSN VVXLAVWC       
VOWIKUF         : IOKCHY          DOSHSHPNXCA     GSAEGWGB        BIORTN         
DFQB            : IMUSKTUBFSX     RYODEMQEALOALI  RFBJ            GDTO           
FLYXH           : CJXNGU          TYRXDRPXYWED    JSROCQNFHEDHVGF HRTNFL         
PTAOKCBAID      : DBNVYFJBC       RIDLWTKSRSMI    NGDCVEOBT       WAKAR           TCWXCSCDW      
UCMUKY          : QMREVEYSYX      XOUSOEEOSDOEE   PUELDCJDLJJTGFH
SOUXHYGMKFN     : DTOASCWXMW      MPGTDLGREQFIX   HFVUJIPWNIU    
FDOIRAMU        : WFRMBRJ         PYUJCF          YKWMPNFWCQ      NLHN            LCPWUOQPCNURSRO
XBASDOPP        : IINJILFMARR     WGOHGCMFSP      CESUGFP        
HIDFHKENY       : NWBXDQRSLPSK    DBNVYFJBC       MJJB            WHGXOALAKMPKVUJ EBAUW          
UMJDPYNIBADF    : PLOJKPAEHSI     NNEEN           UCBEFRBMUYOLQB  RBSLTSJLJ      
GFTJTJAK        : LCOFXKQRXYAYYOR PLPPIPDHKX      ULBYSQC         NDCVUNCSQT     
INYPADFATD      : PUXGCCTCB       ARCIYMEGGJEVOI  LKQYHOD         SYWXJB         
EGFFTPI         : QCKNSIOP        YWQYKTJJIA      NSILYM         
UNWCUQLO        : VNBTELVHNEYY    ESOCEPKTUCCOBS  UYNWSBCUJH      MLJGSEHQUJI     PSLCEVTNNQLDX   DTNAGRVUEFQEOJL
NCVWPUOSAWUU    : YVWET           GCHGWRCBTPR     JVXLW           MIADYDXXO      
JBIQI           : WYYTBMSYSNO     HIUV            XPYY           
GSAEGWGB        : QMUWCWC         YMQAI           AIWRMHVKA       VOWIKUF         QEARS           BYHRICQEO      
TRUITQHMOXHQUE  : NEYCV           GWFPYVX         SWAXNCPQC       AWWKAIYEPRB     CXPILLRIHH     
WNOFHYJP        : LXONUKOQT       IIAP            TVLAVTSAW       AIYEBHHXMQAEAC 
MTXLABCUVYF     : SRGNWGTTS       YQPSVYUT        MUPG           
PMGGKNXIRLFIBN  : OXJNTYUR        TMAWVIOOTECN    MFKAMRLVBL      GETUDF         
AYFSLCSACWEYSD  : SIANUJGAVEMBI   SLYRPRURAJOGXTR DUWLKQXS        AJNLGSJPIWQCKJG KVGYXBQIXDUAKF  REPK           
MSSTCEHAOCL     : RDUTVQQJKIAG    LASG            TQFFRFVTDMABLG 
KMJCPLJ         : JNXW            BUSSSGLL        AKGHLDYKCJMPFL  KOWFEWKEXUDTGGR
YLDYQADPUGW     : ICWXKQYCNEYD    MTDSDAGSEOC     BBTCSTHPFCBRA  
CPCEVL          : YSFIKY          OVUOEWAVMLWH    IQGHWAHVYBHOV   LRJBEXOPTBGNUR  JKUMBBIBHHA     VDIITQFIRT     
KNRJAHS         : LMKS            KRNJ            PWKRFDLUKMAII   SBUAKIDMLPYI    KELQFEFE       
WGOHGCMFSP      : QUTRNU          IMFKCXYVMWCKJ   DOSHSHPNXCA     XBASDOPP        BGNWJSFNCJAUYC 
JMTIUV          : CIEDV           JBKXREBARVRIVYH QJVDLHNYBTVGJ   BQJVCSOVCSMVD  
YAULGHBY        : NHPHYOYUYQQ     TEEQBUGALOUJ   
CGMGFS          : KRSJYWTFCQWOYCT QVXVAOQTXIK     AUXARF          YXLMUKBLCJSK   
OBABJSSUE       : CJYVQTQBQUPE    MRVSLWDHKVN    
QMBNLDPIQYP     : NMOYD           NSEOCRG         LWDABWG         XYLCQYVROQYN    NGGOWIM        
AJTIXDNQ        : OYOCQL          WPLPM           ROFJTVJGDA      GVGCI          
CUAFETYBAHRN    : JKTVPYNTEULK   
HYNXJEYB        : YSFIKY          YKYULB          TMAWVIOOTECN   
YKSHIXWCYYYBG   : HKUPCPHP        UWSWSXBQNJ      RDXHXMQHADOSRFG VMPJAXRKNJLNVK 
WHGXOALAKMPKVUJ : RGDBUIYXLPAH    HIDFHKENY       TYFRFFBBIIVM   
TIKORUNOYOPXR   : NVJGISJAAGXW    EJOPWLOVANKLY   UUAF           
DPGLNWMBWWN     : WYYTBMSYSNO     SQOMPTKJUY      XXUY            LYMSW           FFRGDKPC       
HLMSKIDWWU      : HRTRSVHBWE      JQVYQHYTHU      LIGABERDFOUOPWW
MJTDBUVYXL      : MKBMSRJTWUDBF   LVPNKVLIJ       UUVXWAMTUYWS    OHFVMCKPN      
MBDBCCXRRHFG    : MRRWIFX         ALIFXFBDI      
ROFPM           : HNHEDHJOOHSD    TKOQFTFK        WJDTQ           AJCABXRI        XGHAEREUJWVDS   QOYRMBVUFANHECM ITWFFXTXY       YOWKEKXRJ      
MBLGFMDDNCQT    : WWBXBTXVCUPNLGM RMSBNS          HHHLBC         
TYRXDRPXYWED    : IOEIOWRMRERBLE  FLYXH           WAKAR          
TIGIKSJV        : UFCSHBVF        WYYTBMSYSNO     LPKOPEGR        IXLYMGFOD      
QKFVXJMTA       : YIYFCJLJEKQ     URCS           
UREYJVYKSDPKY   : JDAC            UPKGADKFMDFJE   EPKMGOXRXRJK   
QHIMTGQKSV      : HFCNTDPKCAKIIRW SHYITAKYKEOGYEK
TIVPKFLFLMQK    : DOODHOE         SPKEQCLJ        AVWMGU          WVNOAJCGJIJFSJG CXPILLRIHH     
EFQTPQSJ        : TDKQOLQGXGHATTP CGMBV          
DVTMMFFKQY      : XFPIOGRGCUEYITB
MPGTDLGREQFIX   : IBDVYO          OOGDRF          RCQRB           GGNKDYANDJY     DOACBGLCE       SOUXHYGMKFN     XRTTBTCAPOPCTXJ
DOOXXPBVJN      : KRWWFKQK        STXPMVNIYCYSA   VKISDCSTO       MEPJNYBGKEMJADW BJUJK           QHDCTCEN        KWJRCM          TRKXURDXRLD    
QTWHUSWMBSPO    : VJWPBQMSQWHX    GNJVTE          OOIUASRW        TBFICJ          OBRQ           
JSROCQNFHEDHVGF : FONDGFUAO       LYXTEAMIALEQTWR FLYXH           NYRWDVJUJJVD    TPTIILCYMGNNRDM
WRBSOL          : PVJTRLL         NFWFBQMJROKGEO  RGAXYD          OVUIMG          TREKP          
JKBKDSYFFUWTWPJ : DRJPKRKERO      HEVCJYBQA       JBCVCPEWII      FKXY            WWNWLQUWGADUR   OQMRCPGENRL    
YQJIORNWOFYH    : NGTPJUUJXW      OTHQFDSCDOR     KYJBHYGNFVT     WIVDOPTDGAX    
MXEWYRATQFYNFVK : GRYJNGCVDCV     OOXTMCGJU       QMDXDRGFSOIU   
HQWXCFPUVM      : OWYFLG          XMEXBIELEABS    YBVFFJUXMPQ    
BNTXARFY        : PJQRVWELKM      TYUYTNUHBAJXF   BHKYTYXMWUWMK   RYRYHWAPSV      SLVNEYSYXAECXXP PPNEKUTXFVGNIQ 
WCOPHOEO        : APUNJKW         YAIDUGELJA      QUPMGNXXXU      CHHHFJXVFC     
QOVINWKSMHQYTUP : ATIFE           MHFPYMXHFAPW    UUAF            HMLCE           GJQVVRUOBKX     OBFSWO         
SRFARXW         : OARAYSLXL       KBQJWEIQURFVFPL DTWNSVAJNUV    
OPDD            : PEHKNUANX       LKMQGEVOWS      RSJCIKBF       
URMJOW          : FLMSSIGES       MDCAFR          UFTSEO          CMUJVBFF        YMHUBDY        
LKRXRJYLEO      : NHSHSSELUKDCI   GTXDTBBDKPSNU   KXNOXYJ         BGNWJSFNCJAUYC 
YHGABGY         : SXHK            OTHQFDSCDOR     VVAGTHVJS       GSFXXYXTABVI    REPK           
VQABMWVAG       : RHHVBDXOWAFMX   MVTTYKOYQHF     RIDLWTKSRSMI   
YFAJXX          : KXDNDAEGEMQV    LECHRH          UQWYJSQDYGTHJQC FALRNVGQPPAQLR  CAJEEMRKXYTEEV 
JYRPQTQXCQBL    : EUWUVVSHVUQEY   QJFFOQHB        TSIIEDWQTPPQHKQ WUJDXBHLTJCO    TRKXURDXRLD    
XJJAM           : SINESNEX        DWSLIPD         AIWRMHVKA       YXKVIJIVHJJT    LNUSUKIFHX      UNCMNFNWS       VHNMXQLQ        AJPPDTAUBACGYRL
XJJAM           : DHGJRGP        
XIBGWA          : YXEJWPQI        REPK            UGOKDBQNY      
WMMWQXW         : DWSLIPD         UOHKLU          OVXVAM          UFLRFGQWML      QHTWF          
NNEEN           : CYDGMNVJYGNFO   ARLEG           SRSPWCECTCOVUJ  UMJDPYNIBADF    VDNDWTR         HYYSOPIVJLPD   
XOUSOEEOSDOEE   : EPPW            NMWXQUAQVDBPGVI UCMUKY          BHKYTYXMWUWMK   BULHSSGCO      
BHKYTYXMWUWMK   : KKCMTD          XRKQB           EYGHGNQVYHM     IQGHWAHVYBHOV   BNTXARFY        XOUSOEEOSDOEE   MUPG            TSUX           
BHKYTYXMWUWMK   : WHGHBDPOD      
SALSQILFOQWHV   : CWFSITHDMBAMS  
NDJPKTQGU       : NRHQWB          FQXXIBPLXKFBQ   OKMSKDCXOVGXEB 
SRMPEYTXAF      : EAXUR           KSXJRJQJYGDT    RPUWJRBGS       TYGQGYUHX       YBVFFJUXMPQ    
SNFYEXV         : CMLOALVCEOXYTUD AAOBBDPFVKVHC   YTCY           
VJAYTRLPKRL     : YUUUHRPUFPGCYQ  JLJLGBIKPDT    
MDQD            : HMNQGITUCDHR    VINXWVXRYWPVFPF GVUJH           TUNGASQKGP     
PWKRFDLUKMAII   : ELNKFJRKJFIUHT  FTRJXOJC        KNRJAHS         BOVMPHTWTVCNPX 
FTQGNLSGVMRXAW  : CMSHYUPIUKDNFQ  LAMPRGFTRPCI    JWLV            PWDFGXPC       
DHHCTBJAMFKY    : YSPUQPEKGD      GEDRWXJSE       RCYQJVA         XEBBFLGAS       OBFSWO          GVWAUSVL       
TJVBGOHTAAAWNT  : IHMLBPAO        XKADATEWYE      HJSIVYRGACWA    UNYHPKCHP       FEWLPNNFTBTTPCK
PROUBXWVYHX     : FFNNCSIFEKK     APGS            LXGWLCBXF       FSUANCFRVAF     WHYXKTGLCP      YBSLAPURIU      LASG            DVRNIGOHPYLUJWW
OIPVCCTF        : YJBWXJFIKANKSUL YCNMULAGURWTXI  YMHUBDY         XGVPO          
INEJPHGFBFUSTP  : QUTRNU          NLLYBXL         ONRQRWYRCAHYAYW NMWXQUAQVDBPGVI LRYWXBXJHMNC    GMEUSFRNPSRLYLL
TPUTY           : QMDXDRGFSOIU    SNJYGSSJPC      LKUQYCXVGPKOMLL
KPBALGCHLMP     : IOKCHY          ROIUALLH        RFAWBWTYVMIRJA 
RYRYHWAPSV      : CDPLNRRRBNOPHSG IASYUYNIHRVVQB  DASWUJQUTGHI    ACNKXDS         BNTXARFY       
KUGCPCBIMS      : DWTPKUVX        VWPPB           GKFAITNBMV      JWLV            VLGHSKPWAAL     PWTLWLHOGOTJNV  OWAUUI          NGWNUXQ        
OERTLGGEHXDYW   : ANSFJXLFG       RUGQBSIVECNHP   XBPNBNJJCYF    
WADRXOES        : OOXTMCGJU       XEBBFLGAS       QJYKWFEINYX    
HIWKSLEEBK      : FROPKMDBJNQL    QGECKSMPHPDEEN 
UYFBD           : PNIQAEORACQ     IQGHWAHVYBHOV  
CGMBV           : OGXXE           EFQTPQSJ        SHUK            FUMBRFOKUKDWYJ 
BYFBQJT         : OIRITVESW       CVYTYPHDOWB     FXWLXM          JKPVCQLKSYSMETB
SELGWWKEXWDU    : OWAUUI          NBHCYEGQMVHC    YFJQLACN       
KWYYYINCE       : OXJNTYUR        PSLLJYOH        CWFSITHDMBAMS   HIGK            CBBHMBCVWTF     ROVHCVDS        SWOJESSVVOT    
EGGHW           : MHXBVXXJQQVI    FIPEJU          ISGFLGTCYWACP   AUXARF          SIMQPRD         VDIITQFIRT     
CKLIVRGVCMTC    : BTBEVOCWYQXJ    TYGQGYUHX       DCLBENIC       
PXCOXB          : PLOFRQGOP       KDIPRHFTDYRNTDE VSAJX           LTKWHDOYNL      VRITG          
IPRMQXUX        : UXWCPEAI        WUVKKQVPETXAYMS
RQKDCSBUBW      : CARMNCMSGBPHRP  XIPDLP          KLQTYYD         UFTSEO          HBJFVLKGPF      GDVHX           YEVOYOMBWRHOH  
NTBFLCJAA       : AMBAYKFPLSDHAV  JWLV            NJTTJXLQITDIQY  UWLJLBQHAUIT    ILMQMT         
RIDLWTKSRSMI    : LFDRSQQMB       VLWCWEULIMAY    CEPKNLJ         PTAOKCBAID      VQABMWVAG       KRLHIK         
RNXTIASJPML     : SINESNEX        NGLPYNA         UWEUQPDOFJXAYR  KPVNSS          OQMRCPGENRL    
XNHAPUTAXGYS    : HBWHYSXXAGIMP  
TMLHXQB         : UKYMNVBKMVCIUEL FACL            XKADATEWYE      RPNWOWDVHOOLOGH
OUVQQFJ         : JQHOJOVS        EATXHXQ         JGUG            OTHQFDSCDOR     TSNHIXR         OSINEEHHEBSC   
SHEIOEAKYCKH    : VMLNX           YPELGGDCULM     GENBKGWLIFQ     JIHSFCNTOETIGBJ WKCVOLGUAJQFT   PMXTIOP        
DAVSLFSEHGU     : BCTFRYSL        LRHDHLTI        YSLBGIJGYSEFT   FICGNMHP        MJJB            WPEYUMBDVRSUNNK
CMUJVBFF        : LSWGFUPO        URMJOW          OCOCGOFQ        GDVHX          
PVLQGKSRTWWTTRH : TNAPNW          NDJOPGUIPFAWAOF QVJSWCPDT       DOOHCB          CVDMGPWEQAPAX  
KLKQHPUVMFT     : WBFIVE          OWBBXXRANF      BCILYUVNVD      MLMKQATB       
MBUCWHUEROXONWI : DMQXHJEEKFUGDK  UYDKYPCTGLMUE   RRTNIKVENDGUW   RPRFDU         
PSLCEVTNNQLDX   : QILPVJGQSD      JGUG            SSTWXBGECYGGPW  UNWCUQLO       
QKIMNGVKMN      : OLGUBHO         AMOKCDVS        SHJWHTXRQ      
MEPJNYBGKEMJADW : BUIX            DOOXXPBVJN     
OCRYVCHK        : EXWYUACDREDL    NPOXCCD         VPVTW           QEYDEHHJ       
NGDCVEOBT       : PTAOKCBAID      LKTHAEPEU      
OTCWG           : PYYOPJKLMHLOYQN HIOQKNMRUQJTQSN GENBKGWLIFQ    
LPKOPEGR        : GANCTHACR       TIGIKSJV        IMOIXLKLLCTJJPU JGHSJIMC        SBUAKIDMLPYI    EAJTQXSWRKKREXC RNLOOOO         NYDJCXBJHOIDXQ 
FNAOXSFEXHDE    : OTIMKMXEQFLM    WRFTUA          HNMLSWDUNY      NYRWDVJUJJVD   
EBAUW           : HIDFHKENY       CEREOXUCPLIYD   OHFVMCKPN      
TDNFTXWL        : LASHVOGGDIWM    LLWAACHCIJQ    
FDCMTDBTXIBXQE  : LNQMRXMANTLKBVE TYXEOLRBD       CWYW           
PIFPDCTYGHECIDN : AMCWDSQRW       DIMI           
ISRWM           : LFONIODDTFMQU   KEAIKQQIAIHD    VREMMEU         ENYEQSFTXPJTF  
BJUJK           : XGHAEREUJWVDS   BTMQA           DOOXXPBVJN      XFHONI         
AOYRYFHCHCBP    : JMOOABG         RDXHXMQHADOSRFG KBQJWEIQURFVFPL YNYXEDDM        UBDCQUQHROYU    ROFJTVJGDA      XBSUKOTEPOQOTI 
HRTNFL          : APGS            QUTRNU          DHUWORCOONV     AARSRVGUPR      MRHA            HUFYKC          FLYXH          
BDVNAWWWGJRH    : FBUTEOC         LNAOFPCKCW      STWOIKH         TMVEPVGRJ      
SYWXJB          : INYPADFATD      ESKJND          TQFFRFVTDMABLG 
NEXYOQVCX       : PLOFRQGOP       WPTSXPBUKQOI    HBBGFNGC        GLTJWFMEEQJ     AHUMBRNYKUHXY   GDOBSMAU       
AYKVP           : UUVXWAMTUYWS    LYXWWUXF       
SOLAYFJYXKYW    : NNRUSWDXVM      RAVTGDMO        BCTJOMAWNLXTNJ  TEIEASOUIS      XKQFTXPTQU      AAXSV           KELQFEFE       
CHHHFJXVFC      : SIANUJGAVEMBI   LPKKLJQIYMBTOG  WCOPHOEO        KVGYXBQIXDUAKF  XUQHKFP         SDXSARWY       
MCVYBLNTBYVCEF  : JQHOJOVS        YYWRLMSUEC      GETUDF          AJPPDTAUBACGYRL XFMMWBBPWWBUCMR LXHWWPMTER     
ESADMDKWMQGMON  : OYOCQL          CITHGIK        
LCSIDT          : YXUQRLSMQMEIQ   WLHDEGSK        IUFBXPPIQ       SDTYQQOOYL      WAYECLGLHIEDC  
QOYRMBVUFANHECM : VMDYMMAFLYFRHSJ XMEXBIELEABS    UYDKYPCTGLMUE   ROFPM           UUVXWAMTUYWS    MEYCA          
YBHHNWWE        : GRSQTWKNKLCOCW  ALIFXFBDI       XLCGU          
YXSCRPUIQMVS    : BRFVBYIE        DTOASCWXMW      PTOLHRXXYNWRDXG
QANGHTIUKK      : NGLPYNA         FUNMGYWOSFLCS   HAFS            YXLMUKBLCJSK   
STMRRQCSOVVJNQ  : JDNU           
EGPYQIY         : TPLDLACBDXA     PSMKYSBX        NAUPDIATUAJ     MUNG            EAJTQXSWRKKREXC
OJAXELICG       : HKUPCPHP        YJYVVDLBVPT     EUVNIG          RUKMNNVVDXXTDX  YKQRGFIEXE      TYGQGYUHX      
QXVIAP          : NGTRTNIHWSRAHMF JYPM            AYQW           
VNILGD          : VRSROEW         REOGMUYS        PGMXH          
MUPG            : MTXLABCUVYF     BHKYTYXMWUWMK  
RMSBNS          : IDLGYGTTBRUX    IIQCYYLVTDVERCF ILXHFDSMBDAGJF  NWUDBGU         MBLGFMDDNCQT    ITWFFXTXY      
YDJFID          : LDOBDFAXQDUUKMR KPVNSS         
ELFVMEJXPQDI    : CIPSBRV         QBCSCYKEYM      VVEJHWVKYYNM    YACKRBSPQ       XENRPYKV       
XYLCQYVROQYN    : NNRUSWDXVM      MLAJHD          QMBNLDPIQYP     GTSIXVRHTE      JTWTTQ         
KUDNCJBHG       : ICWXKQYCNEYD    GOUGATTVVIY     XIQBWWP         APUNJKW        
NPOEIROOPNASG   : ENAXYOTJWECG    VLTBSIEDECEK    VUMGQUQIAH     
QAPHYFCMC       : JKKI            CBJJLEF         BIIUWOEIQH     
CEREOXUCPLIYD   : QCKNSIOP        RFAWBWTYVMIRJA  FLTVCWB         OYRXWVUBW       NSILYM          EBAUW           EKRFQKKW       
NUNPN           : UKYMNVBKMVCIUEL AEYYXED         FVMQAHEPF       TCWXCSCDW       IKBVPET        
TGULQWRU        : OWBHFGN         DMQXHJEEKFUGDK  BUSSSGLL        RGAXYD         
VDNDWTR         : KRKTHMUWT       LFLSU           NNEEN           MXRTJJONWYXFJJO GWSYWJO        
QVKEHJHHYFURU   : MBAUMGO         TLRXYCMWBSGS    XBGENYIKQFQE    QRPAKIHEMYJ    
LCPWUOQPCNURSRO : GVUQ            THFONKU         FDOIRAMU        YMQPGHHCUGC    
MFKAMRLVBL      : PLOFRQGOP       BKUMXJHN        GRMSKJNJQMDCB   PMGGKNXIRLFIBN  FUMBRFOKUKDWYJ 
YDWQQBINVWFLB   : NFWFBQMJROKGEO  NPOXCCD         GLDDTPDAL       VUMGQUQIAH      KIXXAJJXW      
HTPYICOPMQCH    : JBLPMRJYGH      JPTXFSU         QPSDWFRXX      
YKPCJU          : YXNPE           NRSITBI         YUUNBLXULW      RPRFDU         
BLALAVL         : QUTRNU          WQLBM           LPAVIFKXSRTG    RWGK            CMLOALVCEOXYTUD
KMCTGTUOVJFK    : CIPSBRV         JALUYW          KATXBJJM       
JTFKFU          : HSSITCL         MMPHYJETJBLF    SHDMCNXGSWY     JCCJQVWBASHCNNQ HHHLBC          KXNOXYJ        
OQMRCPGENRL     : JKBKDSYFFUWTWPJ RNXTIASJPML     FPHEUG         
EPTNJPCF        : EGLPQBFPVPSDKC  AUAQVMXNCX      SBJBIDWLLOHNNFR FPHEUG         
JSEVOJ          : NKUABGCVNMHJA   INOCMJXKEBRWUR  JCCJQVWBASHCNNQ XKADATEWYE     
TGTLWJDCYLG     : THHFGLVJDHR     GLCVNXNRHAATRS 
DSPKIJXUBCCDOU  : EOIXBBYOUV      QFWXIMFAP       PMVHDJPPGAIV    WKCVOLGUAJQFT  
KKSQG           : TNAPNW          NWBXDQRSLPSK    NGHWBVBME       CAEKEUGUPOGNUTD DTMPPFKFSR     
LRYWXBXJHMNC    : YXEJWPQI        KQHVRXHQEQKCKPX INEJPHGFBFUSTP  PEAVIRRNMKW    
ANOX            : NOBN            NDJLYQKU        IPTN            LKUQYCXVGPKOMLL
RAKUOIEYSWSB    : HDXBFTNOSACJ    GDCISRJVCFYNWXQ MYAHXED        
GTXDTBBDKPSNU   : TNAPNW          LJDLBCOPUN      QPSXXXCD        VVWHTVWNHMVN    LKRXRJYLEO      KFCTN          
BLSLDVVYKGFMYFH : LKVOIBDAG       FCYIKD          DGOSK           LASHVOGGDIWM   
ENYEQSFTXPJTF   : CQXKUOALOTRNBWN SIANUJGAVEMBI   IUFBXPPIQ       LYXTEAMIALEQTWR ISRWM           SYKSSSIML      
OIRITVESW       : EMDR            WLHDEGSK        BYFBQJT        
YCFBH           : MRHA            DJUMWXLMAWX     UCBEFRBMUYOLQB 
ENADRSXYMVR     : LIOFYGD         MIYDDMWYQW      ESPKUY         
PWDFGXPC        : SWUEMHNTHUUD    BEYDNR          TOCKCYMACOEG    FTQGNLSGVMRXAW  PCIXFUYXSMBWL   GDCISRJVCFYNWXQ GDQO           
TUQM            : UXALVVROTYJDX   HDXBFTNOSACJ    REJLAUTKOYGXL  
UUAF            : AYQW            JJVSNWIMEBAON   TIKORUNOYOPXR   QOVINWKSMHQYTUP WOBVOTMEELPPD  
ESKJND          : XMCWNC          NFXCU           XFRVADUFMIBA    SYWXJB          IIAP           
OSFGRVEWDMUSOOO : GOUGATTVVIY     YIYFCJLJEKQ     EVDRANWXOCRF    NMWXQUAQVDBPGVI JOMQWM         
HBJFVLKGPF      : XQBTG           WHYXKTGLCP      RQKDCSBUBW      RYEBOENQBORW    YQBXYMCDHDBXGEF
BSVK            : JKWEE           KMCJOGLY        DAYCUVCT        GDOBSMAU       
OPOGLUGQHB      : LUPRKQTUHI      IKBVPET         UWFIQHAYW       HUUNIBJE        NGGOWIM        
YSXLACWFA       : RJISFKWKFCN     LXGWLCBXF       NPYXVWDVVPULFI  JOMQWM          LQNCNEY        
RGAXYD          : KKCMTD          XIQBWWP         ULNUQFRSKO      WRBSOL          TGULQWRU        PFKQNYRG       
VNBMDSV         : KOKQQFNOQF      AJCTKAFJWV      NQHRA           XUQHKFP        
PCIXFUYXSMBWL   : WYAYULDMPMOKI   OBGPCDPQROKHQR  CYDGMNVJYGNFO   PWDFGXPC        MXRTJJONWYXFJJO
XVYE            : WHHPRM          SDMAAJPBJKY     JDNU            VLVOUF         
YGBPEOTSTOON    : SULCYQYNJ       PLOFRQGOP       GDCISRJVCFYNWXQ IQWEXSDJC       VSFNSLKEN      
SYEYTDY         : PPGJ            TFGTHXMRYYBTSW  AJCTKAFJWV     
RAKDHKYIQWHWAYD : UFCSHBVF        MWGUES         
UWLJLBQHAUIT    : HNBALKLYARXENH  XPIXYUCFFK      SHGSISTRNIFAJWE NTBFLCJAA       QWEAXAQOK      
HJSIVYRGACWA    : HAFS            TJVBGOHTAAAWNT  OEJLN          
WAKAR           : GDSFMDTUQGFDDGC AUAQVMXNCX      NLHN            PTAOKCBAID      TYRXDRPXYWED   
WFTL            : PNWQE           AWQG           
KSHIBDLIMESIFK  : QILPVJGQSD      FHABEKFX        PSEIYHDC        XPKEJUNFPVFONN 
IMOIXLKLLCTJJPU : GUJKWLIMDDASKPX NCFXK           XNHJKWPKGFBTKQO NAXPCJIONNYJ    LPKOPEGR        SFBAJXSRSFSNMCM VWUAK          
BPALQDWBSDUBJ   : BPNCAUFRTCLV    QTEVXCQKA       LARJWKKMYGUCAKT GDTO           
SRUJC           : LWHDRKA         XGBQBPB         MOFBHIG         VPVTW          
UMGGRARDSOVTE   : TRWQNPDRU       CBATCCQH        GLCVNXNRHAATRS  JQVYQHYTHU      KXTGXCW         IVASTTFX       
HUCEYUHTXSBSMV  : GWHRTFUHDSARMB  DEFFDIF         OARAYSLXL       JREHFTBDQ       XKADATEWYE      DCLBENIC       
ORYEXIVBAYT     : WFOFWTURSNQXAJL RQXBTSXYY       NSEDUBKOWKXD    SPRCHRH         TCDEVKVRQYWYEB  SSFBWGEKBEU     UWDA           
VPVTW           : PBKXKJMSAYWYBI  LTQB            OCRYVCHK        SRUJC          
XBSUKOTEPOQOTI  : EOQYACK         EMDR            LKCULIFM        AOYRYFHCHCBP   
SMGBKJELDVJ     : IOKCHY          OJYGHBPIBRTCP   SYKBJQEIURUQGUY KVGYXBQIXDUAKF 
TERNCUIAGW      : YJBWXJFIKANKSUL HBBGFNGC        DVISAGYCKFNQFI  EIGXWOENVVNHRY 
MPKFGGN         : MROEONLICAHJFD  NFNOVNMB        MFUV            BXRRGGFRDHYPIBE TCCOGNCDHDG    
ACWD            : ENAXYOTJWECG    CWFSITHDMBAMS   GRYVGOENCAP    
HJYKHIGC        : FQHXCUWIBBKSQ   RNVRMUT        
XRTTBTCAPOPCTXJ : HBLRS           NEYCV           GYCGFFMHTIYHQUJ VBQOJI          MPGTDLGREQFIX   FNDWBICWIOQGFII
MLMKQATB        : DSTSQ           CNAWKLGVW       IQGHWAHVYBHOV   KLKQHPUVMFT     TMVEPVGRJ      
EILMMDNFWH      : VXSNNPVFAAQLGOO VRSROEW         MMPHYJETJBLF    TBOMDQ          QJYKWFEINYX    
SJIKAB          : MGVSGTPJN      
TYXEOLRBD       : VXCPTDWODDL     EUVNIG          FDCMTDBTXIBXQE 
UEUBOIOELCJ     : SXAYLGYBBJB     FLCKDEIWKOLCUHI UHDOMCDXYN      MSPRMVJO        PIOOXEFD        CNAWKLGVW       KPFHLPSCLIIHIKH
LTDWCPWDFSFFX   : MVECXUJX        ISBJCWVF        OBRQ           
RPUWJRBGS       : DEFFDIF         DQCKCKOAIN      SRMPEYTXAF     
QJVDLHNYBTVGJ   : MGHVWLXAOMMY    TDYF            SKMUUUCIXBVCMK  JMTIUV          QWEAXAQOK      
JOMQWM          : CVISGBEPM       CGUHTVWKOEFXB   PRIXC           NWRWWNBI        AAXSV           OSFGRVEWDMUSOOO YSXLACWFA      
OEJLN           : HJSIVYRGACWA    WUVKKQVPETXAYMS
OVUIMG          : LKVOIBDAG       MWQYAKFGU       WDYEMYELSRSPQGX CBNRWYOD        WRBSOL          SJUWMKJTMFHTFDO
RSOIRQCQYNLI    : XIKMFPIWFQOGWFA DBRGWTSDQKLI    TAWHHJIOOBY    
XCAMOQQYEGAUEWD : JBCVCPEWII      RGHJVFTFVNDDIXX LNQMRXMANTLKBVE TJUBGLPBAYFCDW  HXWIQQHVKFRSKCV FUAFRHMGHR     
EKLY            : BYVNPRVU        GRFRPQV         XCXJYSNMBCT    
TSUX            : RQDEBOIWVM      SYKBJQEIURUQGUY DTMPPFKFSR      BHKYTYXMWUWMK  
TMVEPVGRJ       : LCOFXKQRXYAYYOR BEHBN           BDVNAWWWGJRH    MLMKQATB       
KAUQJWLN        : AONS            EAEPYSJRSM      RDXHXMQHADOSRFG EYNFUNMY        DTNAGRVUEFQEOJL
QHDCTCEN        : OKQKYBROJR      DVUGLWLFU       JQVYQHYTHU      DOOXXPBVJN      OHFVMCKPN       GWSYWJO        
YMHUBDY         : OLGUBHO         CCUP            URMJOW          OIPVCCTF       
YGKKCWNYNW      : IINJILFMARR     TMTJPSYKKWJ    
BKWRSATO        : JWIMCGNQHVYDHG  GRSQTWKNKLCOCW 
AECBSJVTOVMN    : NLSW            UBDCQUQHROYU   
WBIVOJLLHMXFFSH : LTQB            QHTWF           UIVSOLBGDSBHEGK
HMEMOFFAE       : MKBMSRJTWUDBF   RDUTVQQJKIAG    NMOYD           OEQLCK         
OCOCGOFQ        : DUIGMPAPTNIKJYM CVUCFMKNLDUV    QBCSCYKEYM      VRVJVRBDWFAFE   CMUJVBFF        ILMQMT          HYYSOPIVJLPD   
TAWHHJIOOBY     : RSOIRQCQYNLI    STGVSBKEHUTMM   TCDEVKVRQYWYEB  LKUQYCXVGPKOMLL
LLWAACHCIJQ     : OWYFLG          HMNQGITUCDHR    RQVJNRBDXRT     TDNFTXWL        TIOGMUPVGUOR   
YUUNBLXULW      : JYCCYH          NPOXCCD         ENKIXHITSKPFE   NOGQ            YKPCJU         
VHNMXQLQ        : HUXLB           SNLMVSHYSYO     XJJAM           LDVRQXTI        BIIUWOEIQH      LFHA           
WPEYUMBDVRSUNNK : NOGQ            DAVSLFSEHGU     KSWMECL        
AJNLGSJPIWQCKJG : XSXIUELJCR      RUKMNNVVDXXTDX  EBIOMNEMHVJN    AYFSLCSACWEYSD 
ALJUANAV        : LKVOIBDAG       XFPKTXFJ        JGOS            FYHNO           RKYRTUOPWQIUWGR AWWKAIYEPRB    
STWHENJ         : NXAQWJXEIH      MAJIHPK        
CWYW            : XOLQQHYHJGAAO   GRWKVOBAVSCNMDT FDCMTDBTXIBXQE 
QIGJKQTQBV      : GDOBSMAU       
NSEDUBKOWKXD    : NMTRGVYQS       ORSARBHRGCYD    RUMRTDR         ORYEXIVBAYT     QWEAXAQOK       KMUOVWTDTTIMD  
HTCEUCNLKTVWNRN : VLWCWEULIMAY    PNQVSLD         OWAUUI          RCHKNCJB       
PSEIYHDC        : OYGBUOOYHEEIFGU MFAEFCWHERM     NIAXDBHVKAFMHK  KSHIBDLIMESIFK 
TYFRFFBBIIVM    : WUFOQFW         HAFS            DTAM            WHGXOALAKMPKVUJ FMDKVLK         NQIQMKYUHV     
JWSHTIB         : ANSFJXLFG       DBRGWTSDQKLI    NFTSNCV         WUFJXSDJKMM     WPLPM          
YQEGYENFGI      : EOSYSYDKRL      PKTWFCBEGOA     GELBQLPORLGIGFV XMBVLPCGNRP     WXIQM           SHJWHTXRQ      
IPTN            : GGWCB           APUNJKW         WHHPRM          ANOX            RGKHUTW        
UOGFKSCVPWELFF  : RTEMHPVHEDVLR   MRVSLWDHKVN    
EWCKXIBFOLHWCBM : IDTGBUTHUB      BVBXVXYMKEDH    QIMBMPABTEUI   
XBGENYIKQFQE    : NGTRTNIHWSRAHMF YFAEIMNQFIVAL   QVKEHJHHYFURU   WVNOAJCGJIJFSJG AXCKIXYNIAPXYQ 
VBQUDEVLFB      : AESJAQ          KLYSOFGDGTQD    CWFSITHDMBAMS   PNQVSLD         SWOJESSVVOT     YMQPGHHCUGC     LXMBR          
QICULPUMSBQH    : RHHVBDXOWAFMX   AUAQVMXNCX      XGVPO          
YTQGKUQIY       : RQDEBOIWVM      UODKIPSLAWTVG   CCCQIDHTVXII   
GENCS           : GCDE            LKQYHOD        
FVMQAHEPF       : NUNPN           IVASTTFX        XUQHKFP         RAGSSHRCQCVMUUA
JGHSJIMC        : LECHRH          LPKOPEGR        OTBXWLNB       
YAHHYRN         : VVEJHWVKYYNM    NGWNUXQ         TRKXURDXRLD    
FRVBXTNQUWUKC   : LORHIPXKCWBYVLE
VLVOUF          : SGVXKMQT        NEIX            XVYE           
YTCY            : FQSOTKTFIINLXGV CDHEWGGJFAKIKSO ISBJCWVF        SNFYEXV        
MXVAEBUCCSWRLR  : AMOKCDVS       
GETUDF          : SINESNEX        AIHYQ           JBCVCPEWII      WRFTUA          ADIVX           NAXPCJIONNYJ    PMGGKNXIRLFIBN  MCVYBLNTBYVCEF 
TCWXCSCDW       : AESJAQ          SJVBBBWI        PTAOKCBAID      NUNPN           CYMFHCVO       
CSRIWMKYHJ      : NCFXK           QYAAFDDJFEHYRA  PXDXEMVQEQBSO   OAOPEYXEVVTBV   AVWMGU         
SBJBIDWLLOHNNFR : IGVJGCY         OOGDRF          IASYUYNIHRVVQB  WPTSXPBUKQOI    YKWMPNFWCQ      EPTNJPCF        QHNAVPBW       
KVGYXBQIXDUAKF  : HCRUQRENQ       AYFSLCSACWEYSD  CHHHFJXVFC      SMGBKJELDVJ     UDOMJIUMDYNLS  
FGDHQ           : MGHVWLXAOMMY    TMAWVIOOTECN   
EETSMIITAOEVWGV : DWTPKUVX        ILHJAID         EGFUWPA        
WEYD            : HEVCJYBQA       EBQSSKBFWOD    
YPHSVNX         : YVYOJBQGGKAIVVA HCRUQRENQ      
HHHLBC          : LAMPRGFTRPCI    DYCIBHRAFDN     HLNEHDI         AYQW            MBLGFMDDNCQT    JTFKFU          LYXHQJDUPFIMFC  LQRTQYENBJPYAR 
JKUMBBIBHHA     : NLIATWLR        OMWUHQQYRDWFO   CPCEVL         
NYMPYCWTX       : TKOQFTFK        LAMPRGFTRPCI    RBHXFEKDXBDVCJ 
SBUAKIDMLPYI    : ETOQT           AAVPDYJSCXVGSGV PTOLHRXXYNWRDXG KNRJAHS         LPKOPEGR        XFMXY          
DJMETT          : JYCCYH          YACKRBSPQ       QEARS           UUUUBLU        
DKFPAGRXDS      : MKOL            TLRXYCMWBSGS    MCAB           
XTIAHSDV        : QJFFOQHB        SNJOMNHPRH     
SVMUBYKFUGLX    : NSEOCRG         RNDHDR          UUUUBLU         RBSLTSJLJ      
SPRCHRH         : PRPQBTMEE       IEJSSGOGKYVXUE  XXQWFLMKGFWHBVN SAONALYPC       ORYEXIVBAYT     LKTHAEPEU      
FFWPF           : TAHOKSPFJULPEHG JLWYXMYMJI     
IIAP            : MRRWIFX         WNOFHYJP        ESKJND         
XEBBFLGAS       : DWSLIPD         SLYRPRURAJOGXTR GLAYBKF         GANCTHACR       HOHHXMIOLCWCLFG DHHCTBJAMFKY    WADRXOES       
AJPPDTAUBACGYRL : LXTDLFXILFED    XJJAM           MCVYBLNTBYVCEF 
DVISAGYCKFNQFI  : JOHURVVPNDPQJ   TERNCUIAGW      YKPPI          
GSFXXYXTABVI    : SFFXXQMRJG      BKUMXJHN        YHGABGY         LVIXXXGADIUTL  
QTITRQOSYNU     : JALUYW          FCVISJS        
SKDBVQJO        : HBWHYSXXAGIMP   OKMSKDCXOVGXEB 
HOWI            : VMLNX          
YJHHLAD         : RRERJ           SFAWJYWBT       SFRCUVBJVAQBL   CDXHEFI        
TUKKPKXMVTXY    : SFRCUVBJVAQBL   AMTSJ           XGVPO          
TREKP           : ROIUALLH        VWPPB           TMAWVIOOTECN    WRBSOL         
BOVMPHTWTVCNPX  : ATIFE           WWBXBTXVCUPNLGM PWKRFDLUKMAII   DVRNIGOHPYLUJWW RGKHUTW        
ANNADJTBJQW     : EHNDITXYE       GCDE            OUHNKIBGHKKAH   GVWAUSVL       
UJTLKKHWBRSALOD : TXJIRCFJQXU     TIAETTMYO       XMBVLPCGNRP    
GDCISRJVCFYNWXQ : RAKUOIEYSWSB    PWDFGXPC        YGBPEOTSTOON    UEHJHTERIUKY   
JMFWXPVBHPBSGGV : PNIQAEORACQ     PHWXVDWPAP      RJRANRWDU       XECQBHG         CMUKVCDJQIYGEPI
LYXHQJDUPFIMFC  : EUIAJ           RPRMHBORAGSE    HHHLBC          SHJWHTXRQ       VWUAK          
POOMOEKPN       : BTKMSMYSCKXV    MBAUMGO         SXKFEYHEYPYHRL  GYRJOAI        
TIJCEBOFYVYJ    : IASYUYNIHRVVQB  QQQQ           
TBIFPOHVE       : WBFIVE          SDMAAJPBJKY    
MSPQDFGG        : DRJPKRKERO      KRNJ            OBRQ           
OREV            : DPQGTULTQMUOBG  KEAIKQQIAIHD    QEBHBFK        
UBTQAFTW        : FCVISJS         RNDHDR          UXVYG          
DEVTNUXLHSBBXJH : RBHXFEKDXBDVCJ  VQTSDTHM       
MYXQ            : YIUWQVKMKECR    SAYRFEIWTX      OGKEUOLQEVDP   
SLVNEYSYXAECXXP : NFJVHITXVWMMIGR RWOMG           AEDXG           GNJIEAPP        WYTOGS          BNTXARFY        IHMBGNPK       
XDDSHEQS        : AGNADE          FPDRVECIVHC    
XFMXY           : LWHDRKA         SBUAKIDMLPYI   
RKGFRH          : PGMXH           PSPQNAOQHJXI   
SFAWJYWBT       : SLYRPRURAJOGXTR YJHHLAD        
EWNLDGEREMEDL   : VTHQFDIUX       TFGTHXMRYYBTSW 
UXWCPEAI        : JUNCGRJDVSBPT   CEPKNLJ         IPRMQXUX        DWMB           
DHWCEXXBCV      : FWCIWTBD        CJXD            KXNOXYJ         VRITG          
QYVWSCJXHWOEV   : WTBS           
GLTJWFMEEQJ     : NEXYOQVCX       ROVHCVDS        WUVKKQVPETXAYMS YFJQLACN       
OKGMCYOAYHEKHMI : YLNYE           SSDMRGMNUOY     SWAXNCPQC       ODRSWIW         JXYSRHYAOUYKWJC
SEJARDLOKXTQQ   : CEBH            RUGNTOACPJIEGIV RNDHDR         
SFRCUVBJVAQBL   : LRJWVSCEPGWUEEF RANGW           TFMFWGRQHEW     RUGNTOACPJIEGIV FACL            LASHVOGGDIWM    YJHHLAD         TUKKPKXMVTXY   
SFRCUVBJVAQBL   : DBFYIUMGSEC    
PTWIAJ          : SRGNWGTTS       ARCIYMEGGJEVOI  FRNAUFPL       
ROVHCVDS        : EUEYPMKRQYRNLG  LSWGFUPO        HOFVBDPC        KWYYYINCE       GLTJWFMEEQJ    
KOUEQPBRBWSTA   : HGTOY           ECAQLAOM        RYWH           
URCS            : YIUWQVKMKECR    WJDTQ           DUWLKQXS        EADVS           QKFVXJMTA      
CENTSKDWGIQV    : HYQKSLHLUOQLLDO VUMGQUQIAH      AFAUOCETC      
FQXXIBPLXKFBQ   : QUTRNU          HMHDPBNATUFIDB  FXTPW           IHDWTBP         NDJPKTQGU      
UUVXWAMTUYWS    : BNDEX           XXQWFLMKGFWHBVN VSOYESAD        UAQATN          MJTDBUVYXL      AYKVP           QOYRMBVUFANHECM
ILDBSVBQGC      : HMFPVMI         KHUOLFCHYGCST   PHKDIHWEPHRDV  
RDTXGMYBI       : MYFRRLXRM       BTUGIXAWXWSQP  
AHUMBRNYKUHXY   : OLGUBHO         ICSUOGIREE      NEXYOQVCX      
SWOJESSVVOT     : KWYYYINCE       VBQUDEVLFB      GUVR            RSJCIKBF       
DSGLPITMU       : QUDUPOWGDOJBLF  IUFBXPPIQ       SDMAAJPBJKY     UQWYJSQDYGTHJQC HJQUOU         
FIVRFFSESLEHVI  : FQHXCUWIBBKSQ   KOKQQFNOQF      AYQW            GYRJOAI        
QEBHBFK         : TAHOKSPFJULPEHG ARCIYMEGGJEVOI  MLLRFGD         NRSITBI         OREV            MYFRRLXRM      
LYMTUBQRGBQBHX  : CPEMRKPB        UFTSEO          HNHWH          
NQHRA           : ICMXMVXHSTK     QYAAFDDJFEHYRA  TNYMYKHAAC      VNBMDSV        
CDXHEFI         : BHGNWXPBYHS     WTOSDVFAON      YJHHLAD         SSFBWGEKBEU     GTSIXVRHTE     
QEARS           : XNDHEABO        RFAWBWTYVMIRJA  OLGUBHO         EYORFEFVCYH     GSAEGWGB        DJMETT         
MUNG            : MGDCPXGGANG     EGPYQIY         KBFMCTGIQC     
QWEAXAQOK       : RTGSVLYM        SUCLKYBBGBDBFQC UWLJLBQHAUIT    QJVDLHNYBTVGJ   NSEDUBKOWKXD   
RPNWOWDVHOOLOGH : YQPSVYUT        TMLHXQB         STGVSBKEHUTMM   JYJHCPW         DREFH           SOBAKYIPOFONGV 
UCBEFRBMUYOLQB  : HEJFWTF         UMJDPYNIBADF    YCFBH           BIIUWOEIQH      AIYEBHHXMQAEAC 
KRLHIK          : YORHVYTD        SPUSDWC         RIDLWTKSRSMI   
GRYVGOENCAP     : WNCXBV          ACWD           
GWUHLR          : YCWECPPUN       ETOQT           JOHURVVPNDPQJ   DHAS           
DFCEEMXRTIDGPW  : OARAYSLXL       FTRJXOJC        YPJCMHXRIJJM   
LDVRQXTI        : ANSFJXLFG       XFMBMRLPIBFMSHF VHNMXQLQ       
AIYKVSVYYX      : WINWQELNDPM     XGHAEREUJWVDS   URUNXWBJSVH    
FMEYI           : MJBQNAIOKRT     DOACBGLCE       KMDQJHBSOUX    
EOFC            : BHKGLAJJYXFK    KYJBHYGNFVT     VALEGNQ        
SHUK            : VQGUUECCTS      CGMBV          
SHJWHTXRQ       : FKGEACPFKIKXUS  QKIMNGVKMN      YQEGYENFGI      LYXHQJDUPFIMFC 
PPTNXYCDB       : QDHEEJSV        JGXPDGRPT       BVBXVXYMKEDH    PSPQNAOQHJXI    DYOQUJHWXTWS   
SFBAJXSRSFSNMCM : PBKIFE          IMOIXLKLLCTJJPU EWPNQUL        
YMQPGHHCUGC     : TKFLTIUF        GRFRPQV         LCPWUOQPCNURSRO VBQUDEVLFB      RYWH            PMXTIOP        
LFKGKOGWOBOJI   : QCKVRCXJQWT     UKGXHTBUWC      OWAUUI         
YXLMUKBLCJSK    : SGVXKMQT        NBTUNOA         PLOFRQGOP       ALTGPETDJJE     APKXQGFYCNW     CGMGFS          QANGHTIUKK      EMXFYYOJAUTAWUR
QQQQ            : JNOXBVQUOF      EYNFUNMY        NXAQWJXEIH      EPKMGOXRXRJK    TIJCEBOFYVYJ    FALRNVGQPPAQLR  BAUE           
VDIITQFIRT      : KDCHG           VMXJBGI         CSKIYJLO        FMJRRDITWSWPG   CPCEVL          EGGHW          
CDRAR           : UHDOMCDXYN      VUSFW           XRLENHL        
UEHJHTERIUKY    : KWSB            DHLQWNLHQANPGHL LNQMRXMANTLKBVE FXTPW           GDCISRJVCFYNWXQ
MUTWFNPLYJHQL   : LIVEKAYMTH      UXVYG           UGNAVNBHWHQCE  
KMDQJHBSOUX     : IHFYNH          MSITSYCGWQAGCX  FMEYI           ICICGSINPCDFTO  TBFICJ         
DUSEJHBF        : XXQWFLMKGFWHBVN EBNYRNYTREJLFK  BXRRGGFRDHYPIBE NCMBEUJNDLJJSF 
GUVR            : GDQXPQESPYKO    YXUQRLSMQMEIQ   JVMRFBAISD      SWOJESSVVOT     WRFXYMGUKYOQB   YWUAWHBFXPMMGT 
FALRNVGQPPAQLR  : GVJO            YFAJXX          QQQQ            JSVTMMSGSLPSLC 
LASG            : QURVFXCJCMHVTVI MSSTCEHAOCL     PROUBXWVYHX     YPJCMHXRIJJM    HFVUJIPWNIU    
WRFXYMGUKYOQB   : DENQNUQ         ARLFAGENBIFYQDN GKFAITNBMV      GUVR            YPJNTVNOURYBV   LNNKPBM        
KOBQH           : AGNADE          RXUGUTLPOWJCDQ  IPQRX           FPHEUG         
IJJVDYHERQCQIH  : OWYFLG          VLTBSIEDECEK    BIHRS           RJYS            AIYEBHHXMQAEAC 
ITWFFXTXY       : LXONUKOQT       ROFPM           RMSBNS         
KPCDYULJE       : RJLX            MMPHYJETJBLF    PGMXH          
ODRSWIW         : OKGMCYOAYHEKHMI
TFEEBBJIAFIB    : GLAYBKF         SSFBWGEKBEU    
STGVSBKEHUTMM   : KOYURXTEO       PYUJCF          ICSUOGIREE      TAWHHJIOOBY     RPNWOWDVHOOLOGH
LXMBR           : LNQMRXMANTLKBVE BUPF            MCAB            VBQUDEVLFB     
FVWJ            : GYCGFFMHTIYHQUJ AHKRKSDKEB      BSSOKRMIC      
ILMQMT          : MIYDDMWYQW      OBGPCDPQROKHQR  NTBFLCJAA       OCOCGOFQ       
ICICGSINPCDFTO  : EUEYPMKRQYRNLG  RWOMG           XBPNBNJJCYF     SAOB            KMDQJHBSOUX     WWRLLQAQIPCWER 
IQWEXSDJC       : DTAM            YGBPEOTSTOON    QJYKWFEINYX    
UODKIPSLAWTVG   : KRNJ            OVXVAM          YTQGKUQIY      
LKMQGEVOWS      : OTJG            IDLGYGTTBRUX    BIHELFAM        OPDD            FHUEOOGUA      
UNYHPKCHP       : PPPRLTSMQKQROKW FPDRVECIVHC     EVDRANWXOCRF    TJVBGOHTAAAWNT 
PHKDIHWEPHRDV   : RIBRTOFLNFD     MCQOCTK         ILDBSVBQGC     
JAHBWBXU        : EYGHGNQVYHM     BHGNWXPBYHS     LTQB           
WCHKGOAVEKG     : IGVJGCY         PXDXEMVQEQBSO   BSSOKRMIC       ASUBMOBBIOX    
SNJYGSSJPC      : UYRMGLLMEHADV   RMNBIQGHGEJ     VLAS            TPUTY          
PMXP            : GUJKWLIMDDASKPX JHDQWMBCMM      RYCGY          
WKCVOLGUAJQFT   : WFOFWTURSNQXAJL HUWDORQH        WXIKLVX         OUILQVNIJRQVDJF SHEIOEAKYCKH    DSPKIJXUBCCDOU 
ROPDNVW         : GXTUGGUEERI     MDCBETB         MGNAYXGSICMAP   QHNAVPBW       
HMLCE           : TOUWGGUYGW      QOVINWKSMHQYTUP LIJFQLNCPPVOARO
DTNAGRVUEFQEOJL : TRHCYJVD        RPVINXMRUOGQL   UNWCUQLO        KAUQJWLN        FGLYVGHDTIJRSAV
JDWY            : FQSOTKTFIINLXGV GRSQTWKNKLCOCW  QOEKPXYHX       EMXFYYOJAUTAWUR
MWGUES          : UYXWCKRJBUPQW   RAKDHKYIQWHWAYD DVRNIGOHPYLUJWW HUUNIBJE       
IYGNTTNCM       : EUVNIG          JMOXBESNHRFMKRM RKYRTUOPWQIUWGR
XSRQWGCJQ       : RXUGUTLPOWJCDQ 
OPOXCLEWRY      : ICRYHNIT        NMTRGVYQS       FNAWFPVVJERIAU  REPK            XQDBHJQJOX     
DYOQUJHWXTWS    : RTKIKRFSJKVGNM  VLAS            VVEJHWVKYYNM    PPTNXYCDB      
PPVSBMGQCVQGJX  : AONS            WNAMDYJCEQHP    KGXGAWGEEKIDSQ  TRKXURDXRLD    
CYLHABXU        : IHFYNH          PPGCYWWEVUCSKR 
FUMBRFOKUKDWYJ  : IPCFDCNADOMHRMX VREMMEU         CGMBV           MFKAMRLVBL      GDOBSMAU       
DHGJRGP         : PKRFEWEARROH    XJJAM          
GBDGEDEQ        : FPDRVECIVHC     RUGQBSIVECNHP   KATXBJJM        OBRQ           
YDKSICDGOGFOS   : KRSJYWTFCQWOYCT
TCDEVKVRQYWYEB  : UOECGVXVGLRNY   ORYEXIVBAYT     TAWHHJIOOBY    
UKCBWXJBBRQKWH  : NAUIJGRE        NRVWVUHG        YVYOJBQGGKAIVVA OSINEEHHEBSC   
RBHXFEKDXBDVCJ  : NVHN            QEVVOLDJ        YSLBGIJGYSEFT   KPVNSS          IPQRX           NYMPYCWTX       DEVTNUXLHSBBXJH
GEJKHGITKMLBW   : FROPKMDBJNQL    CPEMRKPB        ISWL            XPKEJUNFPVFONN 
ICDJLB          : LRJWVSCEPGWUEEF FLMSSIGES       NMWXQUAQVDBPGVI
RLUQOAMTJLAQUK  : IGVJGCY         TDKQOLQGXGHATTP XENRPYKV       
DVRNIGOHPYLUJWW : CEBH            LMYUGPFMTWACS   PROUBXWVYHX     BOVMPHTWTVCNPX  MWGUES         
PKAICDWVMIXFD   : HBLRS           MOFBHIG         NDJLYQKU        FICGNMHP        AWQG           
EIGXWOENVVNHRY  : VTHQFDIUX       CMRORTXSAALUE   SOMQPYU         TERNCUIAGW     
QEYDEHHJ        : NBTUNOA         CCRSSPPOHKL     OCRYVCHK       
DWMB            : UXWCPEAI       
RMIAS           : JWIMCGNQHVYDHG  VVAGTHVJS      
YKPPI           : KLYSOFGDGTQD    KDBAQPTPJO      JEPOHYAQN       DVISAGYCKFNQFI 
FSGEAYKY        : CIEDV           HDXBFTNOSACJ    AARSRVGUPR     
QIMBMPABTEUI    : MSITSYCGWQAGCX  DHLQWNLHQANPGHL GYCGFFMHTIYHQUJ EWCKXIBFOLHWCBM MVQSX          
WDYWN           : LYKTWQTLWDR     MVECXUJX        XDFB            JQVYQHYTHU     
MYFRRLXRM       : TRWQNPDRU       RDTXGMYBI       QEBHBFK         LIJFQLNCPPVOARO EEINFPAMQDDGS  
SRBBECPVCSPJNAY : SHYY            NKUABGCVNMHJA   MKQESBPDDBM     UWEUQPDOFJXAYR 
EAJTQXSWRKKREXC : FCYIKD          LPKOPEGR        EGPYQIY        
PEAVIRRNMKW     : THQBCWHBPD      LRYWXBXJHMNC    WJQOO          
KXNOXYJ         : PHIRHIMFDU      LKRXRJYLEO      JTFKFU          DHWCEXXBCV      TIOGMUPVGUOR   
XENRPYKV        : ELFVMEJXPQDI    RLUQOAMTJLAQUK  DINSYVUPVLETQ   QHTWF          
MVQSX           : GDQXPQESPYKO    WHUAC           WHHPRM          QIMBMPABTEUI   
EQERFOQIAOXQ    : EYORFEFVCYH     ATONXEVUNJ      NOGQ           
WCFWHTPYUCUTO   : CBATCCQH        AIHYQ          
KKPWO           : OGXXE           DPTQ            KVMMONGHOA      OAOPEYXEVVTBV   DMYXNLPKKUNFTD 
DINSYVUPVLETQ   : MROEONLICAHJFD  IPCFDCNADOMHRMX DTOASCWXMW      XENRPYKV       
QXDI            : QOYLIIQLWXKOQ   AIYEBHHXMQAEAC  WHGHBDPOD      
AKTTCNGOFFDPJLF : ANSFJXLFG       XPJMWFG         BQUQLMEMAP     
MEYCA           : SKMUUUCIXBVCMK  QOYRMBVUFANHECM
GTDPND          : LXONUKOQT      
XCXJYSNMBCT     : XDOQIDA         EKLY            OGCC           
HJQUOU          : ILFLBKBCPXLLGU  OYGBUOOYHEEIFGU DSGLPITMU       OLNNKFDGMWE    
STLTGTPM        : ENAXYOTJWECG    EKLH            KEYGHSAO       
FPHEUG          : GTKQQCSDQPWGQ   VBQOJI          MDCAFR          OQMRCPGENRL     EPTNJPCF        KOBQH          
TBFICJ          : FPDRVECIVHC     LYYJNOUNOO      QTWHUSWMBSPO    KMDQJHBSOUX    
LQNCNEY         : YSXLACWFA       RPHXCKDYGWGSEB 
ASIVCCLONRGX    : UBDCQUQHROYU    MFKQAWBPYCJDKO  OQGOK           OLNNKFDGMWE    
BGNWJSFNCJAUYC  : DDGMXYKQOTYHG   CKPEYPNTDITE    HCRUQRENQ       WGOHGCMFSP      LKRXRJYLEO      CVYTYPHDOWB    
GCHGWRCBTPR     : IUDMAKTWSC      EBJIGGHWMUFTX   KOKQQFNOQF      MAJIHPK         NCVWPUOSAWUU   
JYJHCPW         : LSWGFUPO        RPNWOWDVHOOLOGH DMYXNLPKKUNFTD 
YPJNTVNOURYBV   : HQWDSVLYLCFMKC  KFICFALXEKBD    XVVGCFFTHNRM    BVMGGDTAAEINA   EFRANSGDHIJK    WRFXYMGUKYOQB   DLGFILQ         OKMSKDCXOVGXEB 
JVXLW           : RMNBIQGHGEJ     TOUWGGUYGW      NCVWPUOSAWUU    CVUFYEOP        NYDJCXBJHOIDXQ 
EPGNQPXUIU      : IEYIHTHTSWQUYU  RRPRHOHIIL      TKOQFTFK        HRTRSVHBWE      HIGK            MHFPYMXHFAPW    PVPCYVPHYCH    
HNHWH           : NJQYBLD         OWBBXXRANF      DTWNSVAJNUV     LYMTUBQRGBQBHX 
MYAHXED         : SULCYQYNJ       RAKUOIEYSWSB    WSPFACIJQXTSTLF
NBHCYEGQMVHC    : USSKEFUPDVX     XGBQBPB         KXDNDAEGEMQV    QOYLIIQLWXKOQ   OMWUHQQYRDWFO   SELGWWKEXWDU   
EKRCUFJTM       : PEHKNUANX       RPVINXMRUOGQL   IJRDOTRYT      
HLOOMSTVJVFLWJT : BCTFRYSL        QMREVEYSYX      FNAWFPVVJERIAU 
VRWB            : RTGSVLYM        NGHWBVBME       ICSUOGIREE     
DLGFILQ         : KOYURXTEO       SLYRPRURAJOGXTR XMCWNC          YPJNTVNOURYBV  
XFMMWBBPWWBUCMR : HQWDSVLYLCFMKC  LYFFTKOCQG      KUCJQYNGAF      LASHVOGGDIWM    UNCMNFNWS       MCVYBLNTBYVCEF 
IHMBGNPK        : SLVNEYSYXAECXXP RPHXCKDYGWGSEB 
VRKHJPHQCVNF    : VCCQQGVXWKGAW   MGVWLIVGAROSIG  MOFWBWVPJMDWC   UKGXHTBUWC      KROQHCIMRDKIE  
GDVHX           : QUDUPOWGDOJBLF  QYAAFDDJFEHYRA  RQKDCSBUBW      CMUJVBFF       
WSPFACIJQXTSTLF : YEEECRNQYO      MYAHXED         SNJOMNHPRH     
WVNOAJCGJIJFSJG : SHYY            XSXIUELJCR      LXGWLCBXF       PRFWVSLMOOAKK   PRIXC           TIVPKFLFLMQK    XBGENYIKQFQE   
CVUFYEOP        : NGTRTNIHWSRAHMF DHUWORCOONV     RXGRLD          JVXLW          
IKBVPET         : DWGG            HJTNRKPCSHVK    NUNPN           OPOGLUGQHB     
TIOGMUPVGUOR    : MRRWIFX         LLWAACHCIJQ     KXNOXYJ        
GUXD            : CCDGQELD        CDGEQBKVIUIUS   QULRRB          QWPOHGQJCSL    
WJQOO           : PEAVIRRNMKW    
YPWPVS          : DBRGWTSDQKLI    QIXXGMTMWWKAGUY YHMY            EPKMGOXRXRJK    DWPMEUXCIW      ANWA            ANFRDB          GTSIXVRHTE     
SDTYQQOOYL      : LIVEKAYMTH      HBTB            TKFLTIUF        VQGUUECCTS      MRHA            EADVS           SIMQPRD         LCSIDT         
RNLOOOO         : IPCFDCNADOMHRMX LPKOPEGR        YPJCMHXRIJJM   
YHFPIEHHV       : NXAQWJXEIH     
BCXG            : LGFIPPYXJ       RSJCIKBF       
WWRLLQAQIPCWER  : FFNNCSIFEKK     WFRMBRJ         UPXUDMVSHRBTWX  IIUVVUSU        FPHJCSXOLYWNE   ICICGSINPCDFTO 
USUAIFGPND      : QUDUPOWGDOJBLF  FPFEDDSRQQSMC   PFKAK          
QHTWF           : MGVWLIVGAROSIG  XYCADASL        WMMWQXW         WBIVOJLLHMXFFSH XENRPYKV       
UWFIQHAYW       : MOFBHIG         MLAJHD          EFKQYQVRRQX     OPOGLUGQHB     
YEVOYOMBWRHOH   : XMCWNC          ARCIYMEGGJEVOI  RQKDCSBUBW     
KXTGXCW         : DWTPKUVX        GLAYBKF         TREDBD          XXQWFLMKGFWHBVN PKTWFCBEGOA     LIHQSFU         UMGGRARDSOVTE  
BEDRLFTLIU      : XIQBWWP         UCLIDEW         UEUUXJWMVQ     
GJQVVRUOBKX     : JKWEE           VMPJAXRKNJLNVK  QOVINWKSMHQYTUP
WYKDWMC         : ISGFLGTCYWACP   FQCYYKCGQP     
QJYKWFEINYX     : NGTRTNIHWSRAHMF WADRXOES        EILMMDNFWH      IQWEXSDJC      
LORHIPXKCWBYVLE : ICWXKQYCNEYD    OSEVGUUTI       FRVBXTNQUWUKC   NSGE           
BIORTN          : RDUTVQQJKIAG    WNXTBJV         DGEJJYYXAIDESKM VOWIKUF        
RSJCIKBF        : EFRANSGDHIJK    XMBVLPCGNRP     ONYLYNLIVUYJFGV OPDD            SWOJESSVVOT     BCXG            GDQO            RPHXCKDYGWGSEB 
RYEBOENQBORW    : FDIG            GBKGSOBDFQNGBKN HBJFVLKGPF      SHYITAKYKEOGYEK
XRDJIWDYCUR     : CDNDBFGJFC      ANFRDB         
XDAB            : WNXTBJV         DQCKCKOAIN      JTWTTQ         
WUJDXBHLTJCO    : ROFJTVJGDA      JYRPQTQXCQBL   
FMDKVLK         : IHFYNH          IEJSSGOGKYVXUE  BGIDEFBIWPDB    TYFRFFBBIIVM    KPFHLPSCLIIHIKH JKTVPYNTEULK   
KOWFEWKEXUDTGGR : UHDOMCDXYN      MRRWIFX         PJMU            GLGUSIL         AXMAHUONKY      XONVPQGV        TMTJPSYKKWJ     KMJCPLJ        
QGECKSMPHPDEEN  : KJSEYYJHQNNTRDT RKEFMJSJHW      HIWKSLEEBK     
QEDXIB          : OOKWTBWDORC     EBJIGGHWMUFTX   UDOMJIUMDYNLS   NYDJCXBJHOIDXQ 
OBFSWO          : UXALVVROTYJDX   TFMAG           QOVINWKSMHQYTUP DHHCTBJAMFKY    BTBEVOCWYQXJ    JKTVPYNTEULK   
RARXE           : LPAVIFKXSRTG    LKCULIFM        KGXGAWGEEKIDSQ 
KYJBHYGNFVT     : KDIPRHFTDYRNTDE PMVHDJPPGAIV    YQJIORNWOFYH    EOFC            YHVAH          
AWWKAIYEPRB     : XYQRMADAOHIQM   DUWLKQXS        TFMFWGRQHEW     TRUITQHMOXHQUE  ALJUANAV       
VSFNSLKEN       : YGBPEOTSTOON   
HUUNIBJE        : USSKEFUPDVX     LCOFXKQRXYAYYOR OPOGLUGQHB      MWGUES         
LDYVEHW         : SGVXKMQT        GVJO            XOLQQHYHJGAAO   DMQXHJEEKFUGDK  GDOBSMAU        XQDBHJQJOX     
XRLENHL         : WOSPOBKTQL      QPSXXXCD        CDRAR           GWSYWJO        
CXPILLRIHH      : SXAYLGYBBJB     SAYRFEIWTX      TRUITQHMOXHQUE  TIVPKFLFLMQK   
KSWMECL         : QUTRNU          QMUWCWC         WPEYUMBDVRSUNNK NYDJCXBJHOIDXQ  XKJGC          
IVASTTFX        : EBJIGGHWMUFTX   PJMU            UBXOMMPUKBYQF   UMGGRARDSOVTE   FVMQAHEPF       DLLXMIQDH      
OKMSKDCXOVGXEB  : EJGRVSWUHKWNBN  XQCJVH          NDJPKTQGU       SKDBVQJO        YPJNTVNOURYBV  
WAYECLGLHIEDC   : KDTSWLSOCWOWNUO LCSIDT         
BJCNWVA         : IQGHWAHVYBHOV   YBSLAPURIU      UOJCAERBCNW     TOCKCYMACOEG    RAGSSHRCQCVMUUA
AXQVGRA         : WTBS            GEDRWXJSE       JGJOSUMEO      
CAJEEMRKXYTEEV  : LCOFXKQRXYAYYOR YFAJXX         
HIUV            : MYYMHHXSNKTA    WWBXBTXVCUPNLGM VKSUS           JBIQI          
QVJSWCPDT       : QTNDGWFSPFUP    GLIF            PVLQGKSRTWWTTRH BAAQICGJBYSYKT  VWYHMSMWCQHDTFJ
NYRWDVJUJJVD    : LNAOFPCKCW      JSROCQNFHEDHVGF FNAOXSFEXHDE   
CBJJLEF         : KAAJGVLSCDR     QAPHYFCMC      
XECQBHG         : GDOUJEK         XXBMEWF         CBNRWYOD        HIOQKNMRUQJTQSN JMFWXPVBHPBSGGV
BBTCSTHPFCBRA   : YLNYE           IFIIDXVWBQDE    YLDYQADPUGW    
ICHRM           : TRCBBTFGXEHTV   YXUQRLSMQMEIQ   FKXY            SXKFEYHEYPYHRL  UOECGVXVGLRNY  
XTOVATPDB       : XTWLMYTXGBLVMSM AGHYTSQUN       LECHRH         
KEYGHSAO        : SXTFAQHMV       ISGFLGTCYWACP   STLTGTPM        OLNNKFDGMWE    
GTLXTRIY        : RRERJ           FBUTEOC         BEXRPTE         RPHXCKDYGWGSEB 
ANWA            : IINJILFMARR     YPWPVS         
MYIIOLJMXNOFUJF : NEAGWX          UHRGDYPV        QFWXIMFAP       XDOQIDA        
TNGHL           : HEVCJYBQA       NOGQ           
BTBEVOCWYQXJ    : MGDCPXGGANG     CKLIVRGVCMTC    OBFSWO         
MWIBVXPB        : ICFKWPREB       GSWFTVE         VSOYESAD        WTBS            BXRRGGFRDHYPIBE PTOLHRXXYNWRDXG AAOBBDPFVKVHC  
BIIUWOEIQH      : OYOCQL          QAPHYFCMC       VHNMXQLQ        UCBEFRBMUYOLQB 
UMBLQAKHXTIMRQ  : UGOKDBQNY      
NQIQMKYUHV      : NEYCV           VUWUSJQ         EXWUKNOQBDHIO   TYFRFFBBIIVM   
OHFVMCKPN       : HPPMXTYQRIDWSR  MQAXHHBMYS      RXUGUTLPOWJCDQ  QXKFNJBCH       MJTDBUVYXL      EBAUW           QHDCTCEN       
SYKSSSIML       : RKEFMJSJHW      VRVJVRBDWFAFE   JJVSNWIMEBAON   KVAMW           ENYEQSFTXPJTF   YWUAWHBFXPMMGT 
CDJSPTSNCQBSXG  : IINJILFMARR    
MIADYDXXO       : VRSROEW         NRRNGTCONLBQSBX NCVWPUOSAWUU   
SHYITAKYKEOGYEK : SHYY            QHIMTGQKSV      RYEBOENQBORW    GDOBSMAU        DREFH          
GDQO            : EMJGY           PWDFGXPC        RSJCIKBF        RBVSHYRQTCSK    KWJRCM         
DAUIYAGYOAR     : SGVXKMQT        MGDCPXGGANG    
BAUE            : XKADATEWYE      JODHEFIRPXR     QQQQ            GVGCI           GWSYWJO        
TORKUSP         : OWYFLG          UCMSBM          TUYVCX          SULCYQYNJ       UUUUBLU        
IXLYMGFOD       : TIGIKSJV       
NEWM            : RXUDVMWCNACVJ   RNVRMUT         JVMRFBAISD      BSSOKRMIC      
YHVAH           : HNHEDHJOOHSD    RTGSVLYM        BPNCAUFRTCLV    FRJG            KYJBHYGNFVT    
EUMUOXS         : ESPKUY          MHFPYMXHFAPW    HNMLSWDUNY      GDTO            VALEGNQ        
PBSPM           : OMAEDVUPWCI     QFVGRWDSNUDQ    VVWHTVWNHMVN   
CVYTYPHDOWB     : KEGKLKEBTGMVGN  VSAJX           BYFBQJT         BGNWJSFNCJAUYC 
EWPNQUL         : VBQOJI          SFBAJXSRSFSNMCM
PADK            : MKQESBPDDBM     LJDLBCOPUN      KJSEYYJHQNNTRDT AEYYXED         PHIRHIMFDU     
ULFKBY          : EAEPYSJRSM      IHMLBPAO        OPGTUYMNQ       RRTNIKVENDGUW  
WBJVSQCHNDW     : UJWAMXML        OFGJBP          YAIDUGELJA     
AMISHV          : GWHRTFUHDSARMB  TYUYTNUHBAJXF  
AXCKIXYNIAPXYQ  : HFLMIYD         HJTNRKPCSHVK    MLJGSEHQUJI     EYGHGNQVYHM     XBGENYIKQFQE   
ULBYSQC         : JBCVCPEWII      PICGJWTUDRDI    HFBDP           TLRXYCMWBSGS    GFTJTJAK        XQWLXNYNEJVJS  
LFCVXMRWORA     : EUHC            QJFFOQHB        MMPHYJETJBLF    GWMIQHSN        CNAENTV         UCYPR          
BAAQICGJBYSYKT  : MQXXTDSVWR      TKOQFTFK        CTVHCTKQMHYLE   QVJSWCPDT      
FNDWBICWIOQGFII : EQHNPRRLDVAKDW  EOIXBBYOUV      XRTTBTCAPOPCTXJ
LIJFQLNCPPVOARO : RQXBTSXYY       NJTTJXLQITDIQY  PWBNFF          HMLCE           MYFRRLXRM      
FRFGCHFLXXTD    : ICMXMVXHSTK    
CMUKVCDJQIYGEPI : FWCNLWUNSQKPBL  EVDRANWXOCRF    JMFWXPVBHPBSGGV
FQCYYKCGQP      : CIHTERYUEBYF    WYKDWMC        
OJMXNYVA        : OTEHCIAGLOYNL   YDGCEUYCPRFPYGD KVAMW           FRNAUFPL        QAQPPVNEGMUMY  
XFHONI          : BJUJK          
TYGQGYUHX       : JCOGWLDGYATA    FPDRVECIVHC     SHDMCNXGSWY     SRMPEYTXAF      CKLIVRGVCMTC    OJAXELICG      
LHXBQPMDN       : BVNQFB          WUPVCGCUSE      ISGFLGTCYWACP   HFBDP           HFCNTDPKCAKIIRW GMEUSFRNPSRLYLL NGWNUXQ        
FJCCI           : VVAGTHVJS       LRJWVSCEPGWUEEF DIMI           
LYXWWUXF        : OTJG            OUJYYKWSUI      ESPKUY          AYKVP          
EEINFPAMQDDGS   : SGJMHECEWMLU    CSKIYJLO        HBKOBRVANRC     MYFRRLXRM      
TUNGASQKGP      : BCTJOMAWNLXTNJ  FDIG            PYYUBSCQ        MDQD           
DOFBTSHBBVGTXSM : RAWYCCBVKEDGDD  GDOBSMAU       
XSTGORWURRNC    : NLSW            FWRQRQSHKNTHF  
GMEUSFRNPSRLYLL : SAKNGV          ATONXEVUNJ      HOFVBDPC        INEJPHGFBFUSTP  LHXBQPMDN       RPHXCKDYGWGSEB 
AMTSJ           : HYVDY           NRVWVUHG        HWEWKICOPQYREWG MTDSDAGSEOC     TUKKPKXMVTXY   
HDYFUQUYPBLTY   : YPELGGDCULM     FTRJXOJC        AAXSV           QYHLBCT        
BQUQLMEMAP      : LMKS            RAVTGDMO        NGHWBVBME       VAPA            BRUJKWFTYQPYOIQ AKTTCNGOFFDPJLF
AFAUOCETC       : RQXBTSXYY       TLFXVWSXOQPAVD  TOUWGGUYGW      CENTSKDWGIQV    XFPIOGRGCUEYITB
OUHNKIBGHKKAH   : QUTRNU          ANNADJTBJQW    
LVIXXXGADIUTL   : YWFNRCRO        EBJIGGHWMUFTX   XCSAMJUDPGEB    GSFXXYXTABVI   
PPNEKUTXFVGNIQ  : MTIDTOPKCVFOBAD BNTXARFY       
PUELDCJDLJJTGFH : IEJSSGOGKYVXUE  NFWFBQMJROKGEO  UFTSEO          UCMUKY         
VWUAK           : PEHCCVOGIIASE   TRCBBTFGXEHTV   UWSWSXBQNJ      MTIDTOPKCVFOBAD TAYUWLJJINAB    YCNMULAGURWTXI  IMOIXLKLLCTJJPU LYXHQJDUPFIMFC 
UIVSOLBGDSBHEGK : JGXPDGRPT       HCRUQRENQ       WBIVOJLLHMXFFSH
JXYSRHYAOUYKWJC : NEIX            NLUCVCAEEDOC    OKGMCYOAYHEKHMI
TAMJ            : NLLYBXL         HTXAMFQE        BCILYUVNVD      CNAENTV         OAOPEYXEVVTBV   JDIQDLJHQRK     JOHURVVPNDPQJ   VREMMEU        
PRRIUYOBLEMJFI  : EPIRJEGNFW      DPNOMDWCIPDTEUT QRPAKIHEMYJ    
MHGCE           : DQXBPXYAYXK     JBKJ            GLIF            XCSAMJUDPGEB    BTUGIXAWXWSQP  
OBRQ            : XIKMFPIWFQOGWFA CIPSBRV         TLSEGRHVVA      QTWHUSWMBSPO    LTDWCPWDFSFFX   MSPQDFGG        GBDGEDEQ       
LTKWHDOYNL      : JMOOABG         JEPOHYAQN       WYTOGS          PXCOXB          XFXFKWCFYVPC   
DOOHCB          : VRHWUGQMBOMWJ   EMJGY           HOHHXMIOLCWCLFG PVLQGKSRTWWTTRH
KFCTN           : YXUQRLSMQMEIQ   AHKRKSDKEB      GTXDTBBDKPSNU  
ASUBMOBBIOX     : NSEOCRG         WCHKGOAVEKG    
RPRFDU          : VRSROEW         EPBOJU          KSXJRJQJYGDT    MLXCUMANGHMLH   MBUCWHUEROXONWI YKPCJU         
SJUWMKJTMFHTFDO : WFFGXTFX        OVUIMG         
PFKQNYRG        : JKWEE           BCILYUVNVD      NFJVHITXVWMMIGR RGAXYD         
JAXMULFGGETQNND : NGTPJUUJXW      HBTB            GVKRTIMXKVW     BKUMXJHN       
XYAB            : BMKIIF         
JSVTMMSGSLPSLC  : ICRYHNIT        FBUTEOC         YQPSVYUT        PTOLHRXXYNWRDXG FALRNVGQPPAQLR 
WIVDOPTDGAX     : VMDYMMAFLYFRHSJ CBATCCQH        IVTP            YQJIORNWOFYH   
BYHRICQEO       : EGFUWPA         GSAEGWGB       
WUVKKQVPETXAYMS : NLLYBXL         IPRMQXUX        OEJLN           GLTJWFMEEQJ    
RBVSHYRQTCSK    : ONNERC          IOEIOWRMRERBLE  NLUCVCAEEDOC    GDQO           
KPFHLPSCLIIHIKH : BPEQNJYRGSW     UEUBOIOELCJ     FMDKVLK         OEQLCK         
FFRGDKPC        : QUDUPOWGDOJBLF  KKCMTD          KFJGKCF         DPGLNWMBWWN    
GVGCI           : AJTIXDNQ        BAUE            NGWNUXQ        
MXRTJJONWYXFJJO : XRKQB           VDNDWTR         PCIXFUYXSMBWL  
OTBXWLNB        : LOAEGWXVEKEH    NHSHSSELUKDCI   NJTTJXLQITDIQY  JGHSJIMC       
UXVYG           : AJCTBKSC        GBXIDA          UBTQAFTW        MUTWFNPLYJHQL   TVLAVTSAW      
LFCHQNWH        : PPGJ            OVXVAM          LWDABWG         BVBXVXYMKEDH    JNXW           
XFPIOGRGCUEYITB : DOODHOE         TYUYTNUHBAJXF   DVTMMFFKQY      AFAUOCETC      
OBVNJGBOKJIXIPK : JQNANYUMWT     
UDOMJIUMDYNLS   : QPSDWFRXX       KVGYXBQIXDUAKF  QEDXIB         
LKTHAEPEU       : NFNOVNMB        CWFSITHDMBAMS   EBNYRNYTREJLFK  YTRDFNCLKPMC    ONNERC          NGDCVEOBT       SPRCHRH        
NDCVUNCSQT      : MOFWBWVPJMDWC   VREMMEU         GFTJTJAK        VRITG          
CCCQIDHTVXII    : YJBWXJFIKANKSUL LCOFXKQRXYAYYOR RRERJ           RPJVOUFONIBMM   HLNEHDI         YTQGKUQIY      
PLYIPVMD        : HBTB           
RYWH            : JGOS            QXTUKMR         RWGK            AHKRKSDKEB      KOUEQPBRBWSTA   YMQPGHHCUGC    
RAWYCCBVKEDGDD  : DJLFRWUUYVD     DOFBTSHBBVGTXSM
LXHWWPMTER      : MCVYBLNTBYVCEF 
VSUFWNFVMKXQ    : TENLCBWYV       XVBYUMLNM       PKRFEWEARROH   
KWJRCM          : QYAAFDDJFEHYRA  TDYF            NFXCU           NWRWWNBI        DOOXXPBVJN      GDQO           
OLNNKFDGMWE     : UBJICKACO       LGFIPPYXJ       ONNERC          HJQUOU          ASIVCCLONRGX    KEYGHSAO       
QAQPPVNEGMUMY   : UAQATN          YCNMULAGURWTXI  OJMXNYVA        HYYSOPIVJLPD   
XQWLXNYNEJVJS   : PJQRVWELKM      KWGAPE          GWFPYVX         ULBYSQC        
GWSYWJO         : FQHXCUWIBBKSQ   ETOQT           NGHWBVBME       MQKDMLT         YNBI            VDNDWTR         QHDCTCEN        XRLENHL        
GWSYWJO         : BAUE           
GDTO            : JHDQWMBCMM      IDGDE           DFQB            BPALQDWBSDUBJ   EUMUOXS        
OEQLCK          : YLGP            HMEMOFFAE       KPFHLPSCLIIHIKH
PKYOXDBTMTET    : CDOKJOBL        QPSXXXCD        VBQOJI          KDIPRHFTDYRNTDE XDOQIDA         GLDDTPDAL      
XUQHKFP         : RFAWBWTYVMIRJA  FMRJ            CHHHFJXVFC      VNBMDSV         FVMQAHEPF      
YFJQLACN        : AJCABXRI        SELGWWKEXWDU    GLTJWFMEEQJ    
NGWNUXQ         : CEBH            PBKXKJMSAYWYBI  KUGCPCBIMS      YAHHYRN         LHXBQPMDN       GVGCI          
TGRYCJ          : UKYMNVBKMVCIUEL AKPXGX         
WCEJJWYLCICPL   : RRPRHOHIIL      MIYDDMWYQW     
FXWLXM          : LQJWLCJKWGAV    QGFFMN          FIPEJU          EUIAJ           JUNCGRJDVSBPT   BYFBQJT        
VDFPLAQNLNNN    : AMBAYKFPLSDHAV  CARMNCMSGBPHRP 
WWRYIVHML       : PPGJ            AVLGXHHFGXLVO   LAMPRGFTRPCI   
VQTSDTHM        : XMCWNC          HJKLVYDSMRQ     YKQRGFIEXE      NSILYM          DEVTNUXLHSBBXJH
KTHYT           : TRWQNPDRU      
OHOCUJC         : JPEQUVXYYDRSVLM PQOQNUGVKDUM    NPOXCCD         STXPMVNIYCYSA   PNVTN          
DBFYIUMGSEC     : SRSPWCECTCOVUJ  SFRCUVBJVAQBL   KBFMCTGIQC     
JVUXLHTUG       : VINXWVXRYWPVFPF EADVS          
VVXLAVWC        : PRULNFP         YURY            SVXOMAYOCLOECV 
DDXE            : PUXGCCTCB       WJDTQ          
URUNXWBJSVH     : NGLPYNA         TYUYTNUHBAJXF   CGUHTVWKOEFXB   AIYKVSVYYX     
EBBMTA          : UXALVVROTYJDX   WPTSXPBUKQOI    FKGEACPFKIKXUS  RGXKCWJ        
SNJOMNHPRH      : PDIBSTHDNTOSCJ  NKUABGCVNMHJA   JGXPDGRPT       HBBGFNGC        WTOSDVFAON      XTIAHSDV        WSPFACIJQXTSTLF
GDOBSMAU        : KRNJ            NEXYOQVCX       BSVK            QIGJKQTQBV      FUMBRFOKUKDWYJ  LDYVEHW         SHYITAKYKEOGYEK DOFBTSHBBVGTXSM
SSFBWGEKBEU     : QMDXDRGFSOIU    UOECGVXVGLRNY   ORYEXIVBAYT     CDXHEFI         TFEEBBJIAFIB   
RGKHUTW         : IPTN            BOVMPHTWTVCNPX 
BTUGIXAWXWSQP   : SHRFYG          RANGW           PTAXNNVWTPUWVCA KATXBJJM        RDTXGMYBI       MHGCE          
RPHXCKDYGWGSEB  : HBWHYSXXAGIMP   BCTJOMAWNLXTNJ  LQNCNEY         IHMBGNPK        RSJCIKBF        GTLXTRIY        GMEUSFRNPSRLYLL
EPPXMYJKB       : YXEJWPQI        KEGKLKEBTGMVGN  RQYTRYE         MLAJHD          UCYFVWNGVHQPS  
IAABPAUHHS      : KDTSWLSOCWOWNUO OPGTUYMNQ      
TVLAVTSAW       : ULNUQFRSKO      IHDWTBP         DKADFKRVXUKJRUX WNOFHYJP        UXVYG          
EMXFYYOJAUTAWUR : RDUTVQQJKIAG    OTJG            DNMOALWJHM      YXLMUKBLCJSK    JDWY           
RCHKNCJB        : WKYNV           IUDMAKTWSC      VRVJVRBDWFAFE   HTCEUCNLKTVWNRN
FUAFRHMGHR      : KRWWFKQK        UKYMNVBKMVCIUEL DMQXHJEEKFUGDK  XCAMOQQYEGAUEWD
GGSIDMIBJDBB    : PEHCCVOGIIASE   PYYUBSCQ       
KMUOVWTDTTIMD   : EUOBGCBWJMMM    EOIXBBYOUV      YDGCEUYCPRFPYGD XGMQN           DAYCUVCT        NSEDUBKOWKXD   
UNODVUVFB       : HWDSDQTP        OLGUBHO         ETOQT           CDOKJOBL        FPDRVECIVHC     YYWRLMSUEC      BSSOKRMIC      
PCUSDWAPLVFJUYM : KMCJOGLY        YWLGPSFW        DNYCYUEWQMR     NXAQWJXEIH      JKTVPYNTEULK   
UWDA            : QURVFXCJCMHVTVI EFKQYQVRRQX     GTGJ            ORYEXIVBAYT    
YPJCMHXRIJJM    : XYVWAJNRDWOLU   BPNCAUFRTCLV    LYDVFHOPHWTP    LRJBEXOPTBGNUR  GLIF            BMKIIF          DFCEEMXRTIDGPW  LASG           
YPJCMHXRIJJM    : RNLOOOO         JGJOSUMEO      
DREFH           : OGULMNV         RUMRTDR         RPNWOWDVHOOLOGH SHYITAKYKEOGYEK EKRFQKKW       
DMYXNLPKKUNFTD  : NDJLYQKU        AYMQWHDOL       KKPWO           JYJHCPW         VRITG          
XPYY            : MQXXTDSVWR      EVDRANWXOCRF    RIBRTOFLNFD     DBNVYFJBC       JBIQI          
JKTVPYNTEULK    : HNBALKLYARXENH  UBXOMMPUKBYQF   CUAFETYBAHRN    FMDKVLK         OBFSWO          PCUSDWAPLVFJUYM AIYEBHHXMQAEAC 
KIXXAJJXW       : JKKI            ADQEHPWN        YDWQQBINVWFLB  
RAGSSHRCQCVMUUA : VHCPTG          FVMQAHEPF       BJCNWVA        
CVDMGPWEQAPAX   : FROPKMDBJNQL    LQJWLCJKWGAV    EGLPQBFPVPSDKC  AWYU            LGFIPPYXJ       PVLQGKSRTWWTTRH DLLXMIQDH      
QRPAKIHEMYJ     : PCCUY           UEWNDCAA        CBBHMBCVWTF     QVKEHJHHYFURU   PRRIUYOBLEMJFI 
NGGOWIM         : IIQCYYLVTDVERCF HVLFIUMOOO      QMBNLDPIQYP     OPOGLUGQHB      KROQHCIMRDKIE  
UUUUBLU         : KOMDFEPRJTCWK   CEBH            MGVWLIVGAROSIG  DJMETT          SVMUBYKFUGLX    TORKUSP        
NSGE            : EATXHXQ         HMNQGITUCDHR    MSITSYCGWQAGCX  MGVWLIVGAROSIG  IEDRCMNGWRIP    LORHIPXKCWBYVLE
XGXIOEVPNHDT    : QQLQNO          YIYFCJLJEKQ     ICYXOLBNPJTD    NCMBEUJNDLJJSF  SJVBBBWI       
TTYGXVDU        : NBWNMLTNE       KDTSWLSOCWOWNUO
FGLYVGHDTIJRSAV : LQOPXS          DTNAGRVUEFQEOJL
PMXTIOP         : IUDMAKTWSC      XWMQKPGGHQBU    SHEIOEAKYCKH    YMQPGHHCUGC    
NYDJCXBJHOIDXQ  : LPKOPEGR        JVXLW           QEDXIB          KSWMECL        
RBSLTSJLJ       : DENQNUQ         UMJDPYNIBADF    SVMUBYKFUGLX   
LFHA            : MSVKGWRUEDDX    JBKJ            AQKFBIV         GYFXL           VHNMXQLQ       
LNTQXYPBIY      : WNXTBJV         HWDSDQTP        BHJXRNCANLMTX   BXWYAMLROIOMJTC AXMAHUONKY      IOEIOWRMRERBLE 
REPK            : LRJWVSCEPGWUEEF DVUGLWLFU       AYFSLCSACWEYSD  YHGABGY         XIBGWA          OPOXCLEWRY     
JLEWHYHSIFFPO   : SGJMHECEWMLU    YNFFGDOHKDBCB   XFRVADUFMIBA   
LBVHRVIJYRKQLPJ : HUXLB           GENBKGWLIFQ     BIHELFAM       
BULHSSGCO       : OWPAURXIUL      SHGSISTRNIFAJWE XOUSOEEOSDOEE  
JVHY            : LOQO            PSMKYSBX        JMOXBESNHRFMKRM FHABEKFX       
UCYFVWNGVHQPS   : MSVKGWRUEDDX    AXMAHUONKY      EPPXMYJKB      
BQJVCSOVCSMVD   : KRTFADELKK      PPGJ            KRWWFKQK        RCGXRHVPJX      ONYLYNLIVUYJFGV JMTIUV         
DCLBENIC        : TDKQOLQGXGHATTP KKCMTD          CKLIVRGVCMTC    HUCEYUHTXSBSMV 
XKJGC           : RNDHDR          KSWMECL        
YKASWXWRPSTIHR  : NGDB            DUWLKQXS        ITRK           
PVPCYVPHYCH     : FNAWFPVVJERIAU  MGVSGTPJN       IDKXPHYYEQJ     EPGNQPXUIU     
LNNKPBM         : GCDE            WRFXYMGUKYOQB  
ANFRDB          : NHPHYOYUYQQ     QYBOMDDDUJKOD   OJYGHBPIBRTCP   AAVPDYJSCXVGSGV YPWPVS          XRDJIWDYCUR    
LIGABERDFOUOPWW : APUNJKW         HLMSKIDWWU     
JKPVCQLKSYSMETB : HQCD            MOFWBWVPJMDWC   BYFBQJT        
EKRFQKKW        : BUSIUOXPJRBVD   SEMTFDHIGMGQ    CEREOXUCPLIYD   DREFH          
FNQFKRQX        : QTNDGWFSPFUP    IQGHWAHVYBHOV   XFXFKWCFYVPC   
OAAANSBGGFC     : YWFNRCRO        AESJAQ          VUMGQUQIAH     
XGVPO           : WMDXHDK         TFMFWGRQHEW     OIPVCCTF        QICULPUMSBQH    TUKKPKXMVTXY   
CYMFHCVO        : CDHEWGGJFAKIKSO HOUCUNJJ        TCWXCSCDW      
QHNAVPBW        : BHDATWJDDIJ     QFOXIMTGXTXBKNT DIWEQCVEKU      LVPNKVLIJ       SBJBIDWLLOHNNFR ROPDNVW         XPKEJUNFPVFONN 
VALEGNQ         : EOFC            EUMUOXS         XPKEJUNFPVFONN 
WMVL            : LGJORPE         PQOCUFQRQCGW    PJMU            RNDHDR          NLHN           
BMQGVTFMJVTY    : ILFLBKBCPXLLGU  YORHVYTD        MMDREAXU        NDQJTSL        
QOYPUVPGCXUUC   : QCKVRCXJQWT     FPDRVECIVHC     NDJLYQKU       
KBFMCTGIQC      : PSMKYSBX        MUNG            DBFYIUMGSEC    
DLLXMIQDH       : GBFWMGMJVSU     EPBOJU          NGHWBVBME       IVASTTFX        CVDMGPWEQAPAX  
XFXFKWCFYVPC    : LNHUDQYH        RYCGY           RIBRTOFLNFD     LTKWHDOYNL      FNQFKRQX       
FEWLPNNFTBTTPCK : RKATTBIA        QYBOMDDDUJKOD   CIYHHMGNMIKUA   LTQB            TJVBGOHTAAAWNT 
LQRTQYENBJPYAR  : KOYURXTEO       KLDQJDXKJ       QRWQW           EHNDITXYE       RKEFMJSJHW      HHHLBC         
HYYSOPIVJLPD    : PCCUY           GBXIDA          BXWYAMLROIOMJTC FLMSSIGES       MDCAFR          NNEEN           OCOCGOFQ        QAQPPVNEGMUMY  
TPTIILCYMGNNRDM : VMDYMMAFLYFRHSJ AGNADE          AMBAYKFPLSDHAV  DHNEMNXHWTYUGX  JSROCQNFHEDHVGF
WOBVOTMEELPPD   : IINJILFMARR     UUAF            SOBAKYIPOFONGV 
QXKNGS          : TKOTTLEINKVGS   HUXLB          
KROQHCIMRDKIE   : TKFLTIUF        NHPHYOYUYQQ     VRKHJPHQCVNF    NGGOWIM        
YBVFFJUXMPQ     : UOECGVXVGLRNY   HQWXCFPUVM      SRMPEYTXAF     
CESUGFP         : KIRBQAXSHV      XBASDOPP       
VWYHMSMWCQHDTFJ : VJWPBQMSQWHX    XXQWFLMKGFWHBVN DASWUJQUTGHI    EYGHGNQVYHM     SIMQPRD         QVJSWCPDT      
OGCC            : WWBXBTXVCUPNLGM XCXJYSNMBCT    
SOBAKYIPOFONGV  : TAHOKSPFJULPEHG DBOHYOQNMW      AEDXG           RPNWOWDVHOOLOGH WOBVOTMEELPPD  
AIYEBHHXMQAEAC  : HNBALKLYARXENH  NGTRTNIHWSRAHMF DIMI            PNWQE           KGXGAWGEEKIDSQ  WNOFHYJP        UCBEFRBMUYOLQB  IJJVDYHERQCQIH 
AIYEBHHXMQAEAC  : QXDI            JKTVPYNTEULK   
YWUAWHBFXPMMGT  : VLTBSIEDECEK    GUVR            SYKSSSIML      
GTSIXVRHTE      : JNXW            XYLCQYVROQYN    CDXHEFI         YPWPVS         
VKBXQCXOEUVGD   : YWFNRCRO        INOCMJXKEBRWUR  FAICXT         
XPKEJUNFPVFONN  : KSHIBDLIMESIFK  GEJKHGITKMLBW   QHNAVPBW        VALEGNQ        
TQFFRFVTDMABLG  : MSSTCEHAOCL     SYWXJB         
HFVUJIPWNIU     : TNYMYKHAAC      QPSDWFRXX       SOUXHYGMKFN     LASG           
WIJHDAMK        : CIHTERYUEBYF    RIBRTOFLNFD     UKGXHTBUWC     
UGNAVNBHWHQCE   : FITUHXXHCAI     MUTWFNPLYJHQL  
NOENCMIVLRH     : HAFS            QQWF            LUPRKQTUHI      FMNK           
WHGHBDPOD       : KRNJ            BHKYTYXMWUWMK   QXDI           
FHUEOOGUA       : EXWYUACDREDL    HYQCMWCUP       QXKFNJBCH       LKMQGEVOWS     
JGJOSUMEO       : QSUTVSIRLGIBXL  VEQU            THQBCWHBPD      AXQVGRA         YPJCMHXRIJJM   
XLCGU           : LCOFXKQRXYAYYOR MGHVWLXAOMMY    NTQUPCOFWUC     AWYU            YBHHNWWE       
LKUQYCXVGPKOMLL : TPUTY           ANOX            TAWHHJIOOBY    
RWNNRCTIW       : AGOF            KIRBQAXSHV      VVWHTVWNHMVN   
TCCOGNCDHDG     : OBGPCDPQROKHQR  AHKRKSDKEB      KUCJQYNGAF      MPKFGGN        
YOWKEKXRJ       : NMTRGVYQS       TEIEASOUIS      GRWKVOBAVSCNMDT RPRMHBORAGSE    ROFPM          
QYHLBCT         : UFCSHBVF        MFUV            HBBGFNGC        HDYFUQUYPBLTY   GVWAUSVL       
XQDBHJQJOX      : DMQXHJEEKFUGDK  NAXPCJIONNYJ    OPOXCLEWRY      LDYVEHW        
UGOKDBQNY       : ICFKWPREB       XMEXBIELEABS    XIBGWA          UMBLQAKHXTIMRQ 
YQBXYMCDHDBXGEF : PVREQVQSTRPS    WYYTBMSYSNO     OJYGHBPIBRTCP   UOECGVXVGLRNY   HBJFVLKGPF     
VRITG           : BRFVBYIE        PUXGCCTCB       PXCOXB          DHWCEXXBCV      NDCVUNCSQT      DMYXNLPKKUNFTD 
AWQG            : AIHYQ           WFTL            PKAICDWVMIXFD  
JTWTTQ          : XSXIUELJCR      GANCTHACR       XYLCQYVROQYN    XDAB           
TRKXURDXRLD     : DOOXXPBVJN      JYRPQTQXCQBL    YAHHYRN         PPVSBMGQCVQGJX 
FBQOWAUAW       : OWPAURXIUL      ESUJSLEFJQR    
GVWAUSVL        : IKPNWGRHELJEVDE ESDX            DHHCTBJAMFKY    ANNADJTBJQW     QYHLBCT        
SDXSARWY        : BHDATWJDDIJ     MFUV            XXNLRH          CHHHFJXVFC     
KELQFEFE        : TEEQBUGALOUJ    JDNU            KNRJAHS         SOLAYFJYXKYW   
