UHYTUGTE        : KMTFOGBGO       UOPDHHGPXGMAW   WILA            OHTQBHVNM       UEGWRGJEDNCX    MURVAGQI       
JELWQTU         : WWFOVPQTKRF     GUOIWSHKFVCJSE  UOPDHHGPXGMAW   UNVSTPJQJB      LMQRURAVJIUYF  
YWKCFDDBX       : QPVFP           YIDYJCJJ        AGKOSQFRFPND   
VKEJFNKBIQWPUH  : KSXREDK         CAMQDLDMC       MSOWASYWAPETG   FSLBKDTYSKHJE  
GGMCBL          : HOTTDCOKNX      BXNHKVXGGQIMXJV MPEIWTOS        MKFCBRJP       
BVGGY           : UFFWLWE        
HAAFKGOSU       : YKMTA           LMQRURAVJIUYF  
TFSRU           : YTPAYNAEC       GKEYIYRAEI      IOXCT           JRVYN           YEIUWPPUAKBBNQR
BQVHGXIRCLNISP  : HQREIEKESVYE    KMCFOB          GKCYMHHHT       IBOOGDMBLPT    
CRUIEBWWXBTET   : FEAMXJI         XAKJIEEOLIDTM   JCARLQAMNBNS    XQCGPNS         WIDQGTWLG       WDMASAFONJ     
BJMSFVYFG       : JENCWC          LRSKGESGGUQL    HDLWSJGNFXR     PMMUWTNDHLS     OGRQSEYF        HEBGKY         
KSISNANPR       : YPPVRWTEYHQMXG  BHEHETOFVUHO    HQMWXUAWCR      NGGNXPNUJIJRJ  
XYOXVMYRSU      : PIGXT           UYXIJGADOW      JEHBQOAYSUGKMWR
UERPLPQSWJDRRYF : HGWXCOSTV       QDITUB          FVTCDRAJXR     
OUMAVLQTKDUC    : WHXXUEG         CIEIHYPSDCTHRE 
PIVVCLHSECRNG   : AGOJV           BUNK           
HHOCVLRXHFQD    : OEXXSEWVEVXDFU  LILCBTMJSVFXW   RUXFTBNVYENEWP  TBISM           TCJHPSDPVQAHGQ 
WAWVRFRNJFW     : HUWLJ           MDSVOBVTIGCB    VHLY            CVYQPYELHE      ISXY            QXQAJAWLEVT     VYSHPJ          UEGIGXHQK      
JAVYIHGRXLNKFOT : ASSYKEQYJLYN    XOQHDNBJBCEQ    SVWUUJSN        IYNOITVQIABECE  RURGKEYB       
FXFEACASH       : KAFICVEKQBVSL   EDQNVRKDEPBRRMM MUEVTMEWHBQ     JSNJTPGI       
GSYGXIIT        : MRSIWJODXTFVYS  GJBVYJ         
SCQKAEAMJ       : EAPALXPMPTO     PWUXMNMNTC      PFMLSOQBMVOMN   KKXTALMFLKNOJRU FTCFSIXHIQSE    IEKC            SRJUW          
HVWHBB          : OXXKLQIYE       YIDYJCJJ        MEFTSKHYB      
FEAMXJI         : CRUIEBWWXBTET   SVWUUJSN        LTJXLFQQYW      JBJT           
RGIAASUELF      : LBWPQFFSRMLTUHS WLYUBDNVMN      GYPROSNHIVCEMQH TWAYHJPTDIO    
RFTBWDYV        : QTHVVBXX       
DYUIDUXEG       : GNITTA          EJBVJMFHL       FJKFLRJOIDQ     VJLI            CTJOFOTDJ      
EXMMAOHUTUCBMI  : OFBHWAJUSLKDXI  TIIRHVSCEESS    OCLAYUOSJYMJVQR FONQNWR         CDBTPSLNYIAH    IFGXIAPGYNWHJF 
PHDRDNUCKDIGDMO : TNRXMKKYIKWCDIF QRXKAHTALB      UTOJXAQDXLEVWWG
QPVFP           : YWKCFDDBX       YGWVJFKBEOU     JCARLQAMNBNS    TQILRUNXDPTK    SOMWOVXGQKJMR  
PNHMPKAAJ       : VWOAQI          RWYHYQNFVOKKPB  NABDETQJNCX     SLXEWDGPSESLNSF
HMJKDGPNMXVPM   : YQLYITMQNETMMB  HDLWSJGNFXR     MTCUQOYOQU      QPDAIEDQHODFW  
ADBXKSLCIUP     : EQECAMFIMA      HGFCEVLJYWCVCMS RKMHHVLEFWMM   
FRBPLLEXXHENVQN : GECABXCC        NJSEA           FEOIWVOEGTVXLPP GVIHRD          KMVROGE        
JAFLFIL         : TDQKEHDCB       MRGDRHRE        EUNQQUMYIMU     VSWCWVCPF      
EXUOSMPBETSQ    : RHVVLLCRURO     EGTOGEQAJYMA    OYKFPWJNDJIEOLU
WOFFU           : KXLGGR          JOTPUUQRIJ      TPJUVMKYYOOMGU  LKJLU           NUPLCBPPAXTIGOX JEQVYFEA       
DOJWX           : KJENXYOOWHF     GWJAVQYBGL      QMAMLWOXKFE     XTHJMRRTDPMSN   UMFCXNAAXREPKIJ PINKKI         
FLTNWOTW        : KCUQSAYXMUF     LGDYV           DHXBTRBFUHN     BGNKFPPIIKTM   
JSYBTE          : XSUPEIDRTPRLJ   DOGVAJPYLGA     VLIQCRT         WNAQ           
MWCJLKQ         : NCFO            BWEDKSAPB      
GTURTUEYGBOGPL  : CLWITXHBLUEQ    LURQLC          FYWNS           JGLVLUFWP       QRLDEEO         ONPC           
CUVC            : GHPHP           RJQRLNQCVLUYSR  FSSWVJMKWBR     QLYLC          
RIVEFXQQKJYQGW  : WQGT            ARHLVQTMBF      WGWP            RDVQGCIAICNXU  
ATPBBQPJJB      : WXTYEIREPJS     UGBTVKSD       
LXLPWDXSKDSBV   : FXYU            NOLMHFCPT       WIXQH           IBOOGDMBLPT    
KXWSUISQYTT     : TDQKEHDCB       LVCXX           SEKFIT         
MDBNQPOCFLF     : XKAUX           MPSPOB          SVFCNDGS       
GPJYSGFG        : GKEYIYRAEI      FJQJJWLJRBGRP   UKYGQPOMJCDDSFK EJSAIHUPMTTTMOA
DYBLURMOOFDRI   : VGIYOSJTPT      PXMFPWXVAOQMO   DVCGAKT         BWEDKSAPB       QPRDJEOGQKNSXY  VJVGPPARQXYXQFT
IXIMGVUKCMVDICJ : KGGMTGXQNIFUDH  BHMVRVHQPWUDFSH
IOPLCMGPCUWHMF  : VGIYOSJTPT      TJCYGF          GJBVYJ          MEDTBMYJBHK    
XGJMMHHYJWUPFA  : KUNKBS          BOPIPROKHGYAVOH
VIPLWR          : FPVYWIRN        PMMUWTNDHLS    
DJDAIMOQOM      : YBQLTAMD        VPHJXDKUGE      ILFLHQJIRAFVKAO GEYXQHSHXULXES  QBPUJNCQVFLJP  
ACJIJKTIFJ      : CFVGQRKDCQRRODG MRXUR           PNQRODCTLEEFT   ONFB           
FIJQAXPU        : DGDUMMXEIQWT    EORY            SNRCBRLLNUJOJR  JENCWC          EUIOBQV         PGXPXKPJRRHH    BDKIAJNQECJMRTI JASIUAUWROXJK  
FIJQAXPU        : VSGTYIWSRHFHBM 
UEEUPQJGHYDIBOQ : XJJORDEMEXWN    IUBEMYJLLCOKL   UNUUQKPUQXOR    RVSNL           FSLBKDTYSKHJE  
YKVGWLO         : AGOJV           UMYPG           EPIGFLFKEHQLDFT KKVRKJ         
VFIVWDWRJ       : NDRWIV          JIHWQVIJT       HLJJ            EBLGTVXRCHPAYXD
OYTXH           : NHSIQLRGNJ      CHAQUDFTDUT     WINFLDQHKNYKXYV GHNLNCF         RDVQGCIAICNXU  
YKMABFPCRLJ     : KGLNUJM         YFOIJRLASXWFIA  QKGTSPJLJQQTMGN RJMPAMKK        AJHSM          
WAWUHH          : BHRNDLBAOU      MLYHAJ          VBNGD           FEEPJKG         NLMWTQGUMYQ     YWVLJUFSB      
EKPVTSKVPKDT    : KHBTVMYMFHQQG  
QIMTPCW         : CFVGQRKDCQRRODG GHNLNCF         FTJOXGOBFSOWJOV
PIBPIXKPFET     : KTCIDPKE        XNIYVC         
VRNPEJHQPBD     : NEBRQHIWWONXO   LRSKGESGGUQL    MRTWQFYW        RQBYXKUMB      
LQCB            : IGBONLESSB      UUOLLMXQBOVUB   ODDXKTWKCEGHAWW MEJCUOUPESOXK   LUQYQJPXMVTBP   GCNFIRIKHAWOB  
BMLJNBTNN       : CRFIULWKKOD     MCBNGUDQ        KMVROGE        
UTFMQYD         : KTGEU           YTYDECOLFE      AUKOW           CYXFSENFJPGFH   FAVTHT          HSBKWJSHSTCBMLN LYVNXRQNAO     
FOPWESAOGSRJO   : KPSUIGTOJADTL   OIRTTR          KQPVCDOQMGQHA   GYIVEBJKDW      GIUXFM         
VCHKFBAUNVP     : LOCEMBTFOCGFKVF ROBXBXKRRNVGCF 
KIWNSCD         : YDOBHSPMX       CIKDYY          PIDLCRDCJSV    
YJDCY           : RPUDOUY         EGRVYIX         VUKXVNSKLMKPET 
USSLNQNUBUYCQMA : NBBPQVJFEOG     BPWMKGRKWQJGW   TQILRUNXDPTK    CFYUGVFTXQKGAYF HREAJAF        
HKQEYJJERK      : DPYKHJBIQTPW    JQMPPQ          OLRD           
WMMII           : ELQSMDHQMW      JIACFKKCAD      MUOGBTIOKRJAX  
DVVTKSVFRAXGAE  : TIIRHVSCEESS    WIDQGTWLG       ROOHDJ          DHKCXQBISUVGO  
MUWNEGRXRGWEUFO : YTBKJSTAUFFK    MXWU            QPUTBKOMPQQ     RDSTGMTDDCL    
INBD            : NIEBFSVRUGJAMJ  FJKFLRJOIDQ    
VBFQDGWF        : YTQSYHFEQKGSNF  WHXXUEG         PLEKJJOQQJSTBD  VPMHK          
NRINGOTAP       : JPREUPD         KMTFOGBGO       HNMLXKQOHTHASUK ELTSEOCLPDA     SALVGYRUUTPHW  
GMUEULJFYMKY    : QHMSVH          YYCXAFOHUMTUBAB KYXIHSYQOJEDESV GNVN            UXMBAEFJAFQFXB 
LHYQN           : OXXKLQIYE       QXQAJAWLEVT    
VAOQICYAY       : HOBSHXIHEYB    
PMIEHMYTVFS     : GUFCLRMCVN      XTHJMRRTDPMSN   USFANAATTWQTNRO
PSSEAUUPVTPK    : JKEFHPRMICN     WIDQGTWLG      
YNNYMMQB        : MXWU            RYXOMCMQFYLHPM  IXPNPVGAJBALI  
UJJUDHCXRRQNX   : TQILRUNXDPTK    MBENVIKUXKLQO   BTIW           
KTKGPBQCA       : JQRHTFTXUSBTL   MHEPFUD         ECREWGBTYLMV    OSCNMVUUTAOKTIF
RBUE            : BRELUSYRMOAC    TLDLEYYQTXNOSYJ HEPRFWFHEAUKEK  QHAYHLHXK      
YCMINJNX        : COMYKSWLX       HTROCXQSM      
LRGF            : QJBTYCOYFUD     IXJLYWYOEDAFCTW GOVMSYAYHOYWT   NCFO            URWXTBYD        DLRMP          
EAPALXPMPTO     : SCQKAEAMJ       KITQVQKQGKY     UHTIKD          SEHAIYPYHYFDQKM LILCBTMJSVFXW  
LRVSLUWAFMKS    : DGDUMMXEIQWT    DATQGOU         CLHPTCRYUANKTN 
XEDELKJOBLAYE   : MKFCBRJP        JLGYQEWHVGLE    HOEIRQXKFQ      BDKIAJNQECJMRTI WNGMMMOTTVB    
QAFRO           : AUFLOMAHYS      SERLI           FFYMRYAIWU      IXPNPVGAJBALI  
NHIK            : RWYHYQNFVOKKPB  DHCMBVRFF       YDAGWFCQIN      HHVKHSHPEOE     MRSKJAU        
KPSUIGTOJADTL   : FOPWESAOGSRJO   STKBIKHDUIUQXI  YTPAYNAEC       ISIP            RHVVLLCRURO     HRQGKHSOFS     
WXTYEIREPJS     : ATPBBQPJJB      JTHPM           BXNHKVXGGQIMXJV VVNLDYRTIEJIQ   KCXCVNEBDOTR    FHGKS          
YCWLIHBEFLK     : XJJORDEMEXWN    HFPY            NIRHJBLT        JEWM           
DVBGRPARNTQREK  : JKREDVMXHAH     QWMJIF         
TURIVTHIFQJJ    : YPUMDSFE        UHJCJBCNJEJDQM 
XVWBRBJLQLDGHV  : EJCUHABBMNNFEJB AFUTXVVWO       ULQADNG         RQBYXKUMB      
LHXHEPRAMY      : MDXBN           OCRXQTDKJGUPRM  OKWRCAJWMXBFTG 
RPUDOUY         : YJDCY           RPBVM           LUUJPTAS        UEXUOGDVPFQAYMR STUJSOOL        LROVQM         
XSOJGHUK        : UJLTMNDBRJQ     NXCNYORGKMQUN   VNMGQAQKOXE     EYXUIWDSWFI     NMJD           
CIPPPOYVESWQR   : BCCBVKSHSG      UFFWLWE         SQAFPX          QRVVCKAO        RGGU           
KJENXYOOWHF     : DOJWX           RXTTVEUBI       DATQGOU         TIIRHVSCEESS    CEWABIM         AOJUYL         
QNDBD           : YQNIHC          HUKVKNLVFS      YLKBKA          CPDXG           UTOJXAQDXLEVWWG
LTYEKAAOSWI     : RPJBQTKBO       RPDKDLQVE       WKCTLLSE        KMVROGE        
HUWLJ           : WAWVRFRNJFW     IGCYLC          VVNLDYRTIEJIQ   VHCOJTQDN       LPKSBRLDSDBQ   
NXLMIRVYHBCKJN  : EJCUHABBMNNFEJB ABUGGJO         PVRFQPERDDAI   
KTQLU           : UCKJGQTG        LXQVUPHJNQWB    ONRYLXLSXQJFBJP
GTSTBNQPYND     : LLRMJPAUQV      QXQAJAWLEVT    
CPITNJDP        : VJXOX           FGATYSKNWUR     OYJWLKB         JXTCH          
NBDWLXNYSXGM    : XAKJIEEOLIDTM   KQKRSDX         VFRYVOLVHWL     VFSI            VVCCLOYQOWHXCDN
CQFSGEIJEM      : FRYOL          
OIPALFPAGVYTTO  : FSEWTMI         TACEUJLUX       DWPYLB         
ONCDGETNYCU     : XBMEMHWIIBX     WWFOVPQTKRF     NCAEYN          KTCIDPKE        TFPS            LCRQVVUTLNATA   ROOHDJ         
LBWPQFFSRMLTUHS : RGIAASUELF      WKQDYJQBJKV     JNKOSB          UXUGEDC         ISXY            RPPONOIQ       
DJKRWMWESR      : JCARLQAMNBNS    OBFDC          
RVOCIQBAJGHCXTP : FJQJJWLJRBGRP   BIVFJKCLKO      FRYOL           DYEKQNXWDNNS    LGJJIVPDWNFJCY 
OWOFAYQTVFRCYL  : VLNYAETGN       CEWABIM         UTOJXAQDXLEVWWG
SHLW            : WRCXNGPAPQVL    LYPTVPOU        CGVRK          
EXRNFYSFUICJG   : YTQSYHFEQKGSNF  EKGNQI          BCNQKV          GMGTHSRS        RJUQS           UGKGMHTFC      
PIPI            : NQEWAWAQL       YQLYITMQNETMMB  MUOGBTIOKRJAX   KBGVHGFASNIUCY 
ONUQOGPIPEF     : KCUQSAYXMUF     NEJEOGOGOYWAKU  BWEOKS          DJAWYJLKBLQKVJG BUSMYD         
IGCYLC          : HUWLJ           BCCBVKSHSG      FJPPLMG         QKGTSPJLJQQTMGN
SYAUJI          : KNBGTHBFJQLI    ELSYOI          YTPAYNAEC       MXGO           
BRELUSYRMOAC    : RBUE            FSSWVJMKWBR     KNBYJJCE        ONAPG           MKCJ            SLRJXBAIDPPRWAL MRTWQFYW        OXNINGPQI      
PIGXT           : XYOXVMYRSU      CLWITXHBLUEQ    NKVXHWSQXJBKMUL EMAKFJOQLIVPR  
BSAFKTEKQPVFSNK : NBBPQVJFEOG     GCBDLWDULICD    OYGNRC          OXBEJWJCINOQ    QQEG           
KFECRUCWVR      : NXKFSK          KSXREDK         QNFUPJMDAVYJL   PAVSPVC         PIFGVJMLHRPCMHX XBNBYMJ        
CSYPV           : WPKDVOJUJDGBMN  CIKDYY          IEIRGPXPVG     
PDELJ           : DVCGAKT        
FANKSBWALDGP    : RONCN           NPAUX           SEQFKUVG        CVEKIQUIPAGHXH  ADLAISV        
BRTWLCBED       : PAVSPVC         NJTEM          
AXHFCUPVAPJ     : BPENYFRWJR      NBBPQVJFEOG     VEEPPNGHEVOFIO  GWLGNQSHRK      NQKUG           JICFHVXAV       MEMCTVYYJN     
KMKMXPSPPV      : MESKTSBDNTW     UTOJXAQDXLEVWWG
JUTNWA          : XCYMFFKQRSTF    TXCHI           XIEJQCFBBNJXHLA
NDRWIV          : VFIVWDWRJ       GIRQNBHEO       QRVVCKAO       
XSUPEIDRTPRLJ   : JSYBTE          SLBAAWGX        DQOWD           BHESTQUYSO      CGXVASNAO      
BHRNDLBAOU      : WAWUHH          WIUCTJW         LUGYS          
RONCN           : FANKSBWALDGP    CQLNDPPFWRWQ    FNJHVKNWTPJM   
DGDUMMXEIQWT    : FIJQAXPU        LRVSLUWAFMKS    JNFWBXXCWHTQ    WIMCSHBBAQ      JGHGMBHVCDVR    URFVCRV         WKCTLLSE        NDPPQUALFMSFJJ 
HXJYLM          : JPWXXMWOF       HASD           
OOCMDVDS        : RDVQGCIAICNXU   UDPFAFWLQDTHHRO UGBTVKSD       
QBDYEYMQW       : LVCKVNTGRAXFJ   IFOGFPD         BRSCQXVJPK     
YPPVRWTEYHQMXG  : KSISNANPR       XYTTFYCHVWTMRGT NUPLCBPPAXTIGOX DDCRBNGURAL     EMSJGWKHCFDHG   EBFYMBBKDE      NLMWTQGUMYQ    
KLMQEMHHQHL     : DUNGFMFKGKGN    LEKBESG         BYKJBQYXKOUDD   EAFLORY         RNRXHHXJUXAPE   GTSRBQJPMFJY    WSKLV          
TDQKEHDCB       : JAFLFIL         KXWSUISQYTT     SJYIKRMSQCBQJ  
VFYFYNEFEQS     : MSGH           
HYGRG           : PSGX            JGKJ            LYPTVPOU        OKKWHH          ULJWQ          
YTQSYHFEQKGSNF  : VBFQDGWF        EXRNFYSFUICJG   BESNVMABEXHKYV  LEKBESG         FMPI            FTJOXGOBFSOWJOV GRNSAUK        
OMWDSE          : VGRGHILJ        RVLIANLRGHUUWB  FYWNS           DKNBQ           FJCUCDYFU      
KYBTXJLGIKD     : NLINRHPYIDPJF   PAVSPVC        
FCINGAXP        : HASD           
LWSB            : SAQTLQXJTCSVQBK WILA            XSUQUHKBR       VQMDLIQPED     
SGDWNPW         : NRMNITPYPRE     MHEPFUD         YELHLSYHYSGTT   ANHJQ          
LWAXGKKJLS      : JXNKOVIJTMTLR  
UGUWGKRU        : KHBTVMYMFHQQG   JGKJ            MRSIWJODXTFVYS  RJQRLNQCVLUYSR  OBFDC           ISSDTOSOJXLN   
MVSFCVD         : SDNNW           VFRYVOLVHWL     WIDQGTWLG       OTFKRSIYYFIJ   
NCLAYLAHW       : WGWP            QVHTIUXBYSSYDUR
QKFDHNX         : TRPDOR          IDYQYWGEY       PSAAIWGETSKQC   TPWVGLNQJF      BUSMYD         
UKAPTNN         : WGWP            DMOGIDUSGCVAY  
URLAJYCUBEJBLIO : WPLRNEUX        XEREEEMHEFXXM   XFKLIYFVKBTJOO  LVVBL           EPKTNGR         PQYMCNIBGQWYIA 
STKBIKHDUIUQXI  : KPSUIGTOJADTL   CARUUDXGF       UOYXVVFLCNXFEI  LGUWHVWPBPHSOJ 
SAQTLQXJTCSVQBK : LWSB            TXCHI           IPEGROPHBCO     YCRQDQU         JENCWC          JEVYLUFF       
VGIYOSJTPT      : DYBLURMOOFDRI   IOPLCMGPCUWHMF  TRGSONYNLLATO  
GRYLMBDGNV      : DHCMBVRFF      
WPLRNEUX        : URLAJYCUBEJBLIO ACMR            AGYQHBXVT       WFWJ            LKGWMSQJ        YMRXA          
QHMSVH          : GMUEULJFYMKY    YAXQTHWNRYEY    MNHSAXV         NKVXHWSQXJBKMUL IJMVS           HSSNCVKEGBGG   
SWVJFNJTCMW     : TNAJ           
ASSYKEQYJLYN    : JAVYIHGRXLNKFOT PFMLSOQBMVOMN   VFRYVOLVHWL    
GBXFIAXIVHPLSJ  : YNSQMW          IRAQQDVE        EHXR            EAHXPN         
GGBIBTK         : BLXWIQMVYBOFM   LLMBNV          ACNILP         
BBLMPM          : RPJBQTKBO       IJWXVSCRXKULJNU
UTDSYOUYYSIO    : VBNGD           QRXKAHTALB      WYDT            MPIEETDXR       DHKCXQBISUVGO  
CYVKHXULTFXUJL  : QQWLSWHLCSCW    UFHJQWNUUAR     WSKBTQEHVV      EQIPHLP         ICIJBR         
YXMVTPQUG       : STUJSOOL        LBWSS          
TFGDUMHVK       : KYFMMOKNFLOG    OSCNMVUUTAOKTIF LIQCWAOM        MPIEETDXR      
FIMQFUQC        : LXWSTSFSVLT     XFFYSAQMP       SWSUKVKILHGHGKQ CATXWIF        
EMDDBYYQPUADO   : GKRSOSNYKCSX    ONAPG          
JRCVYXGSERI     : MRCBKA          MOCUVRTEINPOO   TPECXVOUMXMNKLM SYGXLIA         RGGU           
YDOBHSPMX       : KIWNSCD         VCTDGMWCISWVNT  XYNAICVBCM      LTRUSWKP        FVMQAN          VQTSXDDA        GEHILJLIBOSR    UUVBMB         
YDOBHSPMX       : ERBGSBQC        SUHWOEXEYAGHAMN
NXKFSK          : KFECRUCWVR      UOYXVVFLCNXFEI 
JPREUPD         : NRINGOTAP       XNTLUTFVAWGNQQW NUPLCBPPAXTIGOX HLJJ            JHPNB           LRSKGESGGUQL    PINKKI         
XYYRHWQKN       : RGQRQEKUXHWKAY  XYLK            YWGGQGVP        LKIXU          
TGKGFCTFOYAYJ   : WIXQH           ANHJQ           HLQCQSKX       
QDNLSTHSU       : GUDLAQQGKWNYA   VFSI           
LCFEOSYICKQJOMO : PACB            IJBFASKJBQA     LNHL            DMOGIDUSGCVAY  
NQEWAWAQL       : PIPI            COMYKSWLX       OVGTULCKJHUW    PPERNKAWYTK    
MUNHDBJJGAEFIG  : AGVNTVOQX       TNPMGCXYIJEOU  
BRIPGNDYTC      : IQQAYIHWVVB     NCJNRDCGNXX     ACSFBX         
RESFYFA         : EIREPCRM        GYIVEBJKDW      VSDOLHBFYEJJPFA
MDSVOBVTIGCB    : WAWVRFRNJFW     IGBC            JYMMKQJBJLCJ    TRPDOR          KWSRDRDBGVTI    UAVXMIQWHUMPP   PVSCNYUMF      
ULYDACDTGFNKXS  : OYGNRC          SSLRAPNRCGL     VFMTFMQ         FVYGXPPJG       VOILTTPSHMJWTOG APSWEEIKDDIAMTB
DUCPBUNPXLLHT   : JNKOSB          RKTQUALK        NLMWTQGUMYQ     KGSBS          
KDNVEQVGVSODG   : QLSQAYMMNTIGQ   GHPHP           YELHLSYHYSGTT   HGLCJCMDPWEA    RCLJHU         
BCKG            : MUMPNTJOKMU     AVYPLR          PCRTDREAK      
OXXKLQIYE       : HVWHBB          LHYQN           CCUBKSPGEMYQ    ANUPUPFHEKH     JUQHRVDQ        KTPAPLFGKAURDG 
SUCXKYCCWKAPYE  : JNFWBXXCWHTQ    RAQUD           QNFUPJMDAVYJL   VPHJXDKUGE     
AHBMOXC         : RNYATS          DQAB            VHHKNWRKHH      CAVKQGDS        ORUCBYHPGIN     HDFMIBHSKSUSVJ 
YOBRYC          : GBHQMMCCWFSLP   KNBYJJCE        IJMVS           EGTAYBYWLLYXJGO FXSMJUHJMTXAO   VVCWTPBCBVEXFB 
RXTTVEUBI       : KJENXYOOWHF     BUXGAB          EBEMYQOAFDP     AEQGCACINGKW    KCQAEWPQDG      EBLGTVXRCHPAYXD IMHMQNXOMFWSRHL
NLINRHPYIDPJF   : KYBTXJLGIKD     OKLNLFD         BTBTVGCDE       VYLUBEEKBVOUWU  BLGQO           ONRYLXLSXQJFBJP RPPONOIQ       
KTGEU           : UTFMQYD         HOBSHXIHEYB     RQBYXKUMB       CGXVASNAO       LPKSBRLDSDBQ   
CMGXJFFEG       : WPQNIAO         VHFOJNEIHUXO    XTXKLSCSUCMSB   PFMLSOQBMVOMN   BTBTVGCDE       OXAL            RJMPAMKK        BSCEVIK        
CMGXJFFEG       : QLTCEPU        
YTBKJSTAUFFK    : MUWNEGRXRGWEUFO IXSYQQINAWPD    KGGRGOLYEBQR    LKSEHA          HQAUHXIHWGMQAJ 
KNBGTHBFJQLI    : SYAUJI          GIITHJOXKKMFWS  MURVAGQI        LKSEHA          QSNOSOGGFYMBTGA GFGCHSPMTCOOMAW
QNGYDITHSFAMHU  : WNCAHYMJNUQE    AGIMTIY         CORMOKPDBVNXALP CVYQPYELHE      JICFHVXAV       WLTFJW          KRSTFEYEKV     
MIKWVL          : AATPY           NCHFDVH         IJWXVSCRXKULJNU
SUJAFALPCFDKE   : KDRGNWGGW       YUNGPB          YHFODVYLJOPS    JOQKISWOBQN    
UXPN            : CQLAIBQCNFY     NGGNXPNUJIJRJ   OXNINGPQI       QBPUJNCQVFLJP  
SDNNW           : MVSFCVD         PDRYSIXUGUMKU   WWYTMPAEBQIDME  LBWSS          
XKAUX           : MDBNQPOCFLF     NYCAFU          UWWLEUPXC       KGGLTYVUNSN     ECREWGBTYLMV    GQHGRPQ         MEFTSKHYB      
PTRPYRDQ        : SADPWSGW        XIEJQCFBBNJXHLA XGMLI           CUFROPETJFHJ   
ITINEELUTT      : RQYUBETVDWDBM   KKAPNXKODY      ROOHDJ          QBPUJNCQVFLJP  
YIDYJCJJ        : YWKCFDDBX       HVWHBB          EDKEIFYYP       BSSPRXMCY       MGUVBGMVEOHJE  
HRQBJICDLSBU    : GPHMEO          FFGDJOUL        MYBIBWOPDSAPR   DKVTMHCV        URCM           
KITQVQKQGKY     : EAPALXPMPTO     ERJEWXEGQCADBP  ISIP            WINFLDQHKNYKXYV DRYBKMJYNLL     RPDKDLQVE       NCGLREK        
JKPU            : SWEGPKRYEQKQ    FGXA            XEDNDR          QPUTBKOMPQQ     HOVJJHQHSTBUQ   FWDRX          
QCOJGARIEEEFYU  : LCKBOUJ        
JOIHHVXPG       : ADJUNVVHVAJM    UVWLTYHWITUKEP  ETETLIYFAXCDE   FCELN           VPMHK           FLFSCBPU        LKIXU          
ERJTOINQWW      : GHPHP           FEQCCVOS       
WPKDVOJUJDGBMN  : CSYPV           IBETQOPM        OFQMSFFSONCPC   QLYLC           SALVGYRUUTPHW  
IMDQNHKADYIQ    : YXROORKOUQUO    EYMLPGP         URWXTBYD        MGUVBGMVEOHJE   VRFSUH         
HQREIEKESVYE    : BQVHGXIRCLNISP  FEFLJPNB        HCFJ            OSLLDA          XBNBYMJ        
HHLU            : QPUTBKOMPQQ     BDODOAQ        
VJXOX           : CPITNJDP        MMVBPG          XLXBQQBRJSAVSE  QMJHGWYBN      
YAIAICURUMXDSIH : QWPIYA          RDSTGMTDDCL    
EIREPCRM        : RESFYFA         JCARLQAMNBNS    APCPGQNRNRHTTM  YOEQJQGCXBIX   
QWUFWAHWKHHOEY  : HKPCJBEFTEHUWGC
SYOL            : XHJCX           VHPPERDNK       HDJSFAUHOPGXHJ 
XWMGRSXTNLQEKN  : SADPWSGW        FNHVMSPQHD      VHHKNWRKHH     
HNSGADPRHQDBPU  : VTSHQCPCACK     KQTMNXOFLFX     LGUWHVWPBPHSOJ  RWND           
XSMNCGICAVNS    : EYXUIWDSWFI     BCWJGVLL        YWGGQGVP       
AGOJV           : PIVVCLHSECRNG   YKVGWLO         GCLXVV          JPBGRUNXCQWE    UCIDBVXTMAIOL   KQKRSDX        
PXMFPWXVAOQMO   : DYBLURMOOFDRI   NTBNUHWTS       SYOEY           ALMSHWSRCPLJ    QRLH            SCNRQA         
BEPJPSJ         : NQBD            MFSWEOHBHY      WEWKCCEXPVAULI  NLMWTQGUMYQ    
IEQJKFSIQL      : MCMRN           FMVAKFR        
ESYBRUBI        : COMYKSWLX       XROP           
PWCTERDTKPHTTXF : VWOAQI          FTNE            IFOGFPD         GRWMILOLAK      KODFSFHOEMRYWPV
FXPWJWD         : MRSIWJODXTFVYS  OFQMSFFSONCPC   LKUFGRWPAT      HUBVNRSCUBTG   
YGWVJFKBEOU     : QPVFP           VUKXVNSKLMKPET  TDHTCCF         WLLQ           
IBETQOPM        : WPKDVOJUJDGBMN 
UTWUK           : PRUEPOD         JFOOCR          DFSXKQPMBTGLY   HNTXGRT        
HJYMIHLF        : VONBUNYDAS      YELHLSYHYSGTT   FGUBVJBXALLLPFJ
QRRWGPIQQM      : FRGX            VFRYIJGJOQRMTV  GMOGVKWSLL      BOXSVQDOI      
JBCVQ           : WWFOVPQTKRF     FQUNXWR         PQAM            AWCAJIDGAHTPQB  PYTCCKCBACBJVDU
QNWDJE          : SBHSYWUO        YGXHFTP        
KSXREDK         : VKEJFNKBIQWPUH  KFECRUCWVR      WNAQ            LBLKO           HGOPVJTT       
WETFTEVMTJ      : OFQMSFFSONCPC   AWMARUSNARBN    EBFYMBBKDE     
ULSNLLDIOOODB   : LRSKGESGGUQL    RURGKEYB        EHJCCIG        
DUNGFMFKGKGN    : KLMQEMHHQHL     SFUMRXQKBL      XRRIDMVID       INGG           
THSPEEKUR       : OQMOCSQEDVVDMR  MFSWEOHBHY      VPJJIYIJKDAH    CUFROPETJFHJ    UPYNGA         
ACMR            : WPLRNEUX        ELSYOI          SEKFIT          MHCHPD          ETDUSQ         
QSCVOPFVCKI     : LAQAETIVMLHIDH 
VPBFJ           : OFBHWAJUSLKDXI  JWPRXURW        EUAWGUEANAS     DJYPWETYSYPHGT 
XBMEMHWIIBX     : ONCDGETNYCU     MUMPNTJOKMU     HTGELNLLVR      SOPCWDXQ        CVQNGTVQM      
UQUWMLPR        : QQLRC           RQYUBETVDWDBM   LWOAXK          FFGDJOUL        AITMXQJE       
TDQHBI          : HEDVLF          OVGTULCKJHUW    TYFQMEXCVC      NAWOUBBBEA     
IRQITEM         : LXQVUPHJNQWB    PGXPXKPJRRHH    GRWMILOLAK      RQBYXKUMB       KKVRKJ         
NLQXNOXIFTHSHWK : HJOGPYBDSK      JRVYN           HQAUHXIHWGMQAJ 
RPJBQTKBO       : LTYEKAAOSWI     BBLMPM         
JIHWQVIJT       : VFIVWDWRJ       RNYATS          YNSQMW          RDVQGCIAICNXU   EHWKGBKY        ETDUSQ         
BUIIQQBXPOQ     : FRYOL           DDUEDJUISSJW    DUDWOJKLGJHTG   NHKFKCJFMXI     PNQTQO         
GCLXVV          : AGOJV           XFKLIYFVKBTJOO  JIACFKKCAD      IXPNPVGAJBALI   GWHIUJBHCDQGNF 
KYLUHINFSA      : SEBCGXINPSHRDNJ ECREWGBTYLMV   
TBVCJOUNPLEGWKK : NKIQT           RIHF            XTEYAEALLVPHFOF
KGGMTGXQNIFUDH  : IXIMGVUKCMVDICJ EJNAGFVYFI      IKPTUVLETYGJDT  GNITTA          INQVGDLWJOKTNFF
WIUCTJW         : BHRNDLBAOU      FJPPLMG         WAQBKUSYOU     
YKNHIY          : TPJUVMKYYOOMGU  CTAWAOELTCXP    NAHSFQOHD       XYVVOVIA       
SLBAAWGX        : XSUPEIDRTPRLJ   QDKBYC          HTKJWALBYVKC    AGVNTVOQX      
VIUQM           : NAKKUBXS        IYNOITVQIABECE  DBAKJFTBCF      ABUGGJO        
OLMLNHXLQWXF    : CHDLFLSJMW      ADLAISV         DPYKHJBIQTPW    LSRDNWKAPJNLG  
IGBC            : MDSVOBVTIGCB    BMECGGKQFVHEJ   ITGFOALWNCNES   BAMJV          
CCUBKSPGEMYQ    : OXXKLQIYE       PACB            NBNQJEJ        
PCECQLAED       : NHQVRLUGHAVB    OLPSFH          TXASQHPCA       TSEONUPLV       SIMXLODG       
EKGNQI          : EXRNFYSFUICJG   LUUJPTAS        USROGBSBHCYAP   QOSEIL         
KMTFOGBGO       : UHYTUGTE        NRINGOTAP       XTPKDC          ITGFOALWNCNES   WYGLSAOJ        HBRSAOAXH      
SNXKFCPHUDJBI   : XFKLIYFVKBTJOO  RRVD            GMOGVKWSLL      ALMSHWSRCPLJ    FYBXAV         
GSRTLALYPH      : FVMOFSPWOQVROS  BCKUJGKXKGHVKAO LKGWMSQJ        UEJKJOKXNJCDMFB
GPHMEO          : HRQBJICDLSBU    XKIESKADMFJB    TEXCONTBXVQK    MNHSAXV         ODDXKTWKCEGHAWW VTJJ            EBBM           
TOSYR           : OKLNLFD         XROP           
JONSQY          : RPBVM           EGTOGEQAJYMA    YMRXA           USGPSBC         DTNMKBECTWS    
WTUSGWGHOPNU    : SUFDNKCUOLDIF   MXGO           
XJJORDEMEXWN    : UEEUPQJGHYDIBOQ YCWLIHBEFLK     BHMVRVHQPWUDFSH VBNGD           LURQLC          AJLHTSHWYIJ     RRNCACODCGMNXQS
MJFLLEGIWO      : TBLFHXI         TWMWJIYTGMPNGQN XFKLB           JQTQQCINT       FVYGXPPJG       JEQVYFEA        EAHXPN         
FXYU            : LXLPWDXSKDSBV   TNQUJGDQCJWN    WFWJ            KTPAPLFGKAURDG 
UALGLBXQHKVHHLV : MCPLQEMOFPG     NABMH           PAVSPVC         FLDYGCGOIHRYAVQ UEGIGXHQK      
UCKJGQTG        : KTQLU           SEHAIYPYHYFDQKM JOQKISWOBQN    
ELFE            : NXCNYORGKMQUN   WYGLSAOJ        QRXKAHTALB      WNOHFJXP       
TBLFHXI         : MJFLLEGIWO      SESQGVHTOJVI    IDYQYWGEY       WTOKCAI         TNPMGCXYIJEOU  
QRQOYBBV        : UYCBUBOCH       FVTCDRAJXR      WLLQ           
XAKJIEEOLIDTM   : CRUIEBWWXBTET   NBDWLXNYSXGM    PSGX            NIRHJBLT        JRHREPJALV      RGEUVFCHFU      VYXDTQPNS       WOMQCGSIWPUJDNE
NPAUX           : FANKSBWALDGP    THGGI           JXNKOVIJTMTLR  
EGRVYIX         : YJDCY           UHTIKD          GXKIDYQOREO     UEAUYDC        
LVCKVNTGRAXFJ   : QBDYEYMQW       OMRSOFB         ASTUTF          BSXMOKPFNIHQS  
YXROORKOUQUO    : IMDQNHKADYIQ    DTBHMHLO        NABDETQJNCX     JDIWOXCHAJLJINM MUEVTMEWHBQ     PEGIRCWQRFFETW 
TWMWJIYTGMPNGQN : MJFLLEGIWO      WQPWICXSX       ANUPUPFHEKH    
CQLAIBQCNFY     : UXPN            WELOBQGPVLYMO   LJFDM           VSDOLHBFYEJJPFA IIIXCRRW        FJCUCDYFU      
CNSWLGTWQUQXK   : BHEHETOFVUHO    WIGTPNBR        WCJPAAAAFPIBM   KCQAEWPQDG      DLRMP          
NQBD            : BEPJPSJ         EBKUI           AYVUITGPSOFLOO  KUPIMSANPBX     QLIGSSLKMWAYC   AJHSM          
DTPGESWIGFIMHV  : YLTOFIFQBMUF    TMLIJOGNXGVQTC 
EJNAGFVYFI      : KGGMTGXQNIFUDH  VCPKJBUU        VFSI            YADYMUXVXO      VHHKNWRKHH      RAMCHDLAYNWQK   BOUFWAQDH      
SYLVDPRUV       : YAXQTHWNRYEY    TAFJQY         
PSGX            : HYGRG           XAKJIEEOLIDTM   RKBIOXBLBQYPASH GFCVCFIEGV     
QKINPMYGPI      : OGOFP           GEYXQHSHXULXES 
NHQVRLUGHAVB    : PCECQLAED       LAEKNTVGGDNLGAW
TYKOF           : ILDNEVMC        OXDCMCUNPYF     FHGKS          
PWUXMNMNTC      : SCQKAEAMJ       WHXXUEG         EBFYMBBKDE      JICFHVXAV      
FRGX            : QRRWGPIQQM      JIGCOWLFNE      WWYTMPAEBQIDME  FMVAKFR         UJTAUCAYK      
AJLG            : UWWLEUPXC       BIVFJKCLKO      QJWQPOKWSUTO    INGG            EKLSULEKFYOD    EMXJNIOSB      
LETHXUTP        : NARQBGXGQ      
FFYADNNR        : THGGI           YBUGE           FVYGXPPJG       HDVBKGSB        RMWSVMX        
JUCOMIMDL       : LUGYS           OMRSOFB         FEEPJKG        
OTQAYMJ         : ANUPUPFHEKH     DVSTHNRUA       MBKQS          
HGOK            : QLSQAYMMNTIGQ   GQSQETACWXQUHEE PMCPWRESPPD     KLYHT           BLQAPRWQIYAIOH  NAJUJMTOKTWTC   CTJOFOTDJ       VJVGPPARQXYXQFT
VLNYAETGN       : OWOFAYQTVFRCYL  DATQGOU         ADLAISV         UVWJMDWGXLAO    AGKOSQFRFPND   
IFFTTIHSWBLA    : ESDGCQEDUYLDHFM NVKBYSVG        TXDHJLIEVPA    
YLCGRSQFPDVQFCK : GESQBYUNANR     FNBTLOR         OIRBSMHRCYX    
RBXWHRTPYMPD    : EMSJGWKHCFDHG   EBHLIFYSKFTOSEC
RFYDHIXDBFSG    : OFPGWIN         CDUHNLPPNYB    
JNFWBXXCWHTQ    : DGDUMMXEIQWT    SUCXKYCCWKAPYE  RGXNXTVRMU      LKUFGRWPAT      NRIMDQAMXISK   
VFRYIJGJOQRMTV  : QRRWGPIQQM      PBSHFEHNXJHVHXA WINFLDQHKNYKXYV JPLJAGULWRD    
OEXXSEWVEVXDFU  : HHOCVLRXHFQD    EGVRRCFBJMXWKLM PKIAONUUPQFFP   HUXPBBYMSI      EKVJELVXIPK     LBWSS          
FSEWTMI         : OIPALFPAGVYTTO  FDYOCLODSKMK   
WXQQMMOHBT      : LCKBOUJ         BRPCFK          SUHWOEXEYAGHAMN
COMYKSWLX       : YCMINJNX        NQEWAWAQL       ESYBRUBI        JQRHTFTXUSBTL   YOJGWCC        
IUKBC           : JNJFUVOVPHYE    GFCVCFIEGV     
UOQWNQ          : MMIKVHCKUNWQ    VNTRKEV        
HEDVLF          : TDQHBI          MXWU            QKPADJNRB       OKPNWWFLLRWNO  
THGGI           : NPAUX           FFYADNNR        MDFPTENAQYKQWO  BXNHKVXGGQIMXJV PPKCSCHNTNV     EAQHMFNVK      
BGFALNUVOWE     : SBHSYWUO        OHMDWXQPGBHTUC  OIRBSMHRCYX     QPDAIEDQHODFW  
OXKEQBLUHKJOCD  : GAAUPVXNU       CQDIWDIJ        KMCFOB         
JKGDNMINAV      : VNTRKEV         EWCQFKXKVSSW    FSLBKDTYSKHJE  
WMIDAYDMEUQR    : MWMNBWYBPUEIR   OXDCMCUNPYF    
XCYMFFKQRSTF    : JUTNWA          FJUNRTMJ        MYPWI           ISMVQOLAIDMTSBY RRNCACODCGMNXQS
CTIAFFOPJOPMDVJ : VHMXYOGHLFFJCTT GCIXPVBAWRWI    SYGXLIA        
NARQBGXGQ       : LETHXUTP        UIIEVWMFGH      SNQROYCONPKX    OYKFPWJNDJIEOLU
XKIESKADMFJB    : GPHMEO          LYSSRRFNUUV    
URMJUITPWVJ     : NAKKUBXS        KMCFOB          NAHVWFYVARUDPP 
YQNIHC          : QNDBD          
TMMOYOSLTCORYG  : IUBEMYJLLCOKL   XMLVPWNAFA      IFOGFPD         MRTWQFYW        UAIOLESXNKQ    
IDRESQADGATVI   : GLVRLMBAAHCOSTU PQYMCNIBGQWYIA  HEJTOQTOOKXPKGO
AQAMGOLUHYR     : RDYHALSI        NSKG            QTHVVBXX        YJKGSYHYP       FEOIWVOEGTVXLPP
NLMTRVWLASCD    : QLSQAYMMNTIGQ   HDNCPFJMKFQQ    ODDXKTWKCEGHAWW BNGIPCDYXFQHCHX RABBQW          SNQROYCONPKX    RMKQBBFVMVI    
KDRGNWGGW       : SUJAFALPCFDKE   SCUDRGGKCAAVP   UMYPG           DUDWOJKLGJHTG   PEGIRCWQRFFETW  UMQE           
MMIKVHCKUNWQ    : UOQWNQ          CHJSPUU         VTSHQCPCACK     XEDNDR          NLKSGKPMRUQRRXP FMVAKFR         LCRQVVUTLNATA   MBKQS          
UQTVJVBHHGBPTXY : FJVLOYLYN       LPJSMMOYNOBYC  
XTPKDC          : KMTFOGBGO       JKEFHPRMICN     ETWMXPQD        ASTUTF         
MESKTSBDNTW     : KMKMXPSPPV      LNEGVOEQ        QVWOQNI         XYVVOVIA       
FVMOFSPWOQVROS  : GSRTLALYPH      KAFICVEKQBVSL   UXPICRJA       
BXLJKRFUNX      : MFSWEOHBHY      UEXUOGDVPFQAYMR BUSMYD          QHAYHLHXK      
QLSQAYMMNTIGQ   : KDNVEQVGVSODG   HGOK            NLMTRVWLASCD    WGTWHIDOVKW    
WPQNIAO         : CMGXJFFEG      
NXSFFOUD        : IVUBXJESWEQN    WYDT           
MRGDRHRE        : JAFLFIL         TPJUVMKYYOOMGU  GBRGRR          JAYEWXKKHVG     FCJTC          
LOCEMBTFOCGFKVF : VCHKFBAUNVP     CJHUGKIPSSL     KTBR            CGREO           ENGUM           RLIYMFO         FWDRX          
ELSYOI          : SYAUJI          ACMR            BCNQKV          BJFQXRMR        QBPUJNCQVFLJP  
IQQAYIHWVVB     : BRIPGNDYTC      SWEGPKRYEQKQ    UFHJQWNUUAR     JSCJRGISYTJHD  
KCUQSAYXMUF     : FLTNWOTW        ONUQOGPIPEF     GUOIWSHKFVCJSE  SFUMRXQKBL      IEIRGPXPVG      UHJCJBCNJEJDQM  XNOEHXY         PRCEYWSPKEVAE  
KCUQSAYXMUF     : NWDALCNOMENKROR
YQLYITMQNETMMB  : HMJKDGPNMXVPM   PIPI            CAVKQGDS        LYVNXRQNAO     
JYMMKQJBJLCJ    : MDSVOBVTIGCB    MCMRN           MFSWEOHBHY      GIRQNBHEO       SRNVNIYT       
WQPWICXSX       : TWMWJIYTGMPNGQN LLOFAEILNIACS   SBQHMFYCYLEGYS  DHXBTRBFUHN     XROP            UMQE           
LLOFAEILNIACS   : WQPWICXSX       LTRUSWKP        YFDDHFPWINRJGB  URWXTBYD        GEXUBNSOLY      UUVLLEPM       
LVCXX           : KXWSUISQYTT     MYBIBWOPDSAPR   BOPIPROKHGYAVOH RVWB            OVSIDRKBBAWVNYE
WWFOVPQTKRF     : JELWQTU         ONCDGETNYCU     JBCVQ           MWMNBWYBPUEIR   MEFTSKHYB      
DVCGAKT         : DYBLURMOOFDRI   PDELJ           HQSJCOBFNLIBG  
UURNNGLSGLGFJN  : LTRUSWKP        SGQFAGQU       
HDNCPFJMKFQQ    : NLMTRVWLASCD    JFGENPEABEIAV   PIEGPLUHTSTQLF  OKKWHH          POOBFF          MRVJBOXRDFMGRMO LKSEHA         
BLXWIQMVYBOFM   : GGBIBTK         DACK            CPTB            IYPFWQJREDIYP   IJAFNHW        
KXLGGR          : WOFFU           LVLUMAHPCEWWSO 
KHBTVMYMFHQQG   : EKPVTSKVPKDT    UGUWGKRU        IXHSMTPQQGI    
YYCXAFOHUMTUBAB : GMUEULJFYMKY    FSGGIHKLDMQ     NXEIPA         
WNCAHYMJNUQE    : QNGYDITHSFAMHU  EBBM           
YTPAYNAEC       : TFSRU           KPSUIGTOJADTL   SYAUJI         
BPBW            : YLTOFIFQBMUF    JNNDQDABDUTFYF  UYCBUBOCH       CBESMIALUIOF    RCLJHU         
EALBOP          : HJNX            CGREO          
XOQHDNBJBCEQ    : JAVYIHGRXLNKFOT FMSUHYJKIQRES  
FEFLJPNB        : HQREIEKESVYE    NJDQOJXBSNQV    GWJAVQYBGL      UNGBPCHOLNCQNET BHWL            SXVTTBKJWMRSP  
KTWKHABWCA      : HFWFROTRUGY     VNWSWUSMVK      TNRXMKKYIKWCDIF FRRJNKEVAOJNMYX
UHTIKD          : EAPALXPMPTO     EGRVYIX         CIKDYY         
NJDQOJXBSNQV    : FEFLJPNB        BYHMSIYXPWUEWM  CORMOKPDBVNXALP TORPSMYALY      ABUGGJO        
BPENYFRWJR      : AXHFCUPVAPJ     OFGAUDMTTM      SCUDRGGKCAAVP   BTIW            AVFODC          QQEG           
GBHQMMCCWFSLP   : YOBRYC          CLEGAXMM        NQCDICNM        KUNKBS          WORIFBCBLO      EGTOGEQAJYMA    EBFYMBBKDE      CUUYWHEVV      
OKHFJQIBUYBCQXN : WOOKAHIGHHARJQT OSLLDA         
LVLUMAHPCEWWSO  : KXLGGR          QKPADJNRB       APKCQSOJQS      JNNDQDABDUTFYF  GHNLNCF         WIXQH           QLUS            ICIJBR         
JCARLQAMNBNS    : CRUIEBWWXBTET   QPVFP           DJKRWMWESR      EIREPCRM        ATXJWYFL        GKRSOSNYKCSX    DOCLX           OTWQSG         
NIEBFSVRUGJAMJ  : INBD            FNJHVKNWTPJM    TDLSP          
HXPRARLN        : PNQRODCTLEEFT   PCWPUH          CYDSQHYB       
NBBPQVJFEOG     : USSLNQNUBUYCQMA BSAFKTEKQPVFSNK AXHFCUPVAPJ     XNIYVC          ESVBDLUOVCSJDP  DJXGAMPERRKDB   BDODOAQ         XYTLRQWOCGO    
JFGENPEABEIAV   : HDNCPFJMKFQQ    KYFMMOKNFLOG    RCRC            ICIJBR         
CONQBBTCQK      : TESGFYM         TFKF           
BPFRYQDGWHTPOT  : WFWJ            PINKKI          GFGCHSPMTCOOMAW
SESQGVHTOJVI    : TBLFHXI         EQIPHLP        
MUMPNTJOKMU     : BCKG            XBMEMHWIIBX     WQGT            IYKAS           KNLVMHJN        JUPEFG         
WQANKQI         : CQCDAEPM        QHWMNEMYFEX     OBFDC           XEFRELATFBA     JRVYN           PVSCNYUMF      
KYXIHSYQOJEDESV : GMUEULJFYMKY    DFSXKQPMBTGLY   PVRFQPERDDAI    FVTCDRAJXR     
OFGAUDMTTM      : BPENYFRWJR      VLRVFJETEHJH    LMQRURAVJIUYF  
HFPY            : YCWLIHBEFLK     KYFMMOKNFLOG    OXHCQLC         PLEKJJOQQJSTBD  BOUFWAQDH      
OWAXRBOIKVM     : EGUPNUF         ULQADNG         GCHWCBMT        USFANAATTWQTNRO
QKJGRSIMXUGSHP  : JTHPM           OIRTTR          LKJLU           MMVBPG          ACNILP         
OFBHWAJUSLKDXI  : EXMMAOHUTUCBMI  VPBFJ           CUHAXLLONCFMJD  WLLQ           
NYCAFU          : XKAUX           LTRUSWKP        YUWBYHMVMJDEDWT FMVAKFR         YJSPHAFLHA     
NHSIQLRGNJ      : OYTXH           BNBTM           WLYUBDNVMN      CDBTPSLNYIAH   
QQLRC           : UQUWMLPR        WTOKCAI         ABUGGJO        
MPSPOB          : MDBNQPOCFLF     YDAGWFCQIN      TPECXVOUMXMNKLM RVSNL           IMHMQNXOMFWSRHL QBPUJNCQVFLJP  
EDKEIFYYP       : YIDYJCJJ        GECABXCC        RWYHYQNFVOKKPB  LAEKNTVGGDNLGAW
JIGCOWLFNE      : FRGX            ERBGSBQC       
FGATYSKNWUR     : CPITNJDP        QJKC            ACNILP         
FYKNALFU        : RKEYGTQOM       IKXJRUSPAKES    DQGQSX          NXKGSH          MIBVHCOMCA     
NCAEYN          : ONCDGETNYCU     CNPGKWEUPEKN   
MRDUADQYYBOXX   : GIUY            QMJHGWYBN      
AGIMTIY         : QNGYDITHSFAMHU  FEQCCVOS        XWQGGKHGAT     
GUOIWSHKFVCJSE  : JELWQTU         KCUQSAYXMUF     MRSIWJODXTFVYS  IOADVYDSHSMXQM  FCOUFFPTS       ETATQTE        
KGLNUJM         : YKMABFPCRLJ     ADLAISV         OBNHCOXBIATRLD  NFPCMACJLRJ    
JSOWOAXPG       : TRPDOR          BIVFJKCLKO     
EORY            : FIJQAXPU        FTNE            XFFYSAQMP       CATXWIF        
CFVGQRKDCQRRODG : ACJIJKTIFJ      QIMTPCW         BPWMKGRKWQJGW   YENHYVOHHXHDHPT XYNAICVBCM      WILA            NKVXHWSQXJBKMUL
NYKMPKMFSHLJ    : HSPMETJ         LXNRBGYNFKWMQM  FKRFGWMHPTIBW  
LJBSHHJYTODLGV  : RKBIOXBLBQYPASH DONERVCRMLPDCV  NXCNYORGKMQUN   USFANAATTWQTNRO JIACFKKCAD      EHWKGBKY        GYPROSNHIVCEMQH
MCWA            : YENHYVOHHXHDHPT YPUMDSFE        WCJPAAAAFPIBM  
HOTTDCOKNX      : GGMCBL          PBGJ            UIDLCFRUTVVVTX  LILCBTMJSVFXW  
BHMVRVHQPWUDFSH : IXIMGVUKCMVDICJ XJJORDEMEXWN    KGGLTYVUNSN     UQGPNMUGG       QRLH           
WFTBMKXJNAXXNW  : UFHJQWNUUAR    
RGXNXTVRMU      : JNFWBXXCWHTQ    SIQIKF         
RAHAUGF         : SSXVGS          SQAFPX          LPKSBRLDSDBQ   
KTCIDPKE        : PIBPIXKPFET     ONCDGETNYCU     JPJKMIQDFWOAT   ULJWQ          
ADARJBIKWECJ    : VHFOJNEIHUXO    GPUKUEHKX       VPHJXDKUGE      HTSH            CUUYWHEVV      
SEBCGXINPSHRDNJ : KYLUHINFSA      NRBFFTWVWBQIHW  RKTQUALK        YGXHFTP         HSSNCVKEGBGG   
RAQUD           : SUCXKYCCWKAPYE  RWYHYQNFVOKKPB  VNQSWIFQXMXY   
GESQBYUNANR     : YLCGRSQFPDVQFCK CHJSPUU         XIWHPLWXQSMF    TMPVFMHLNCUD   
PACB            : LCFEOSYICKQJOMO CCUBKSPGEMYQ    INFBPNOKHLMRPQ  NAHSFQOHD       KQPVCDOQMGQHA   XPLMKRSI       
RVULCKVREVKYYXI : JUQHRVDQ        IEIRGPXPVG      BHWL           
SBHSYWUO        : QNWDJE          BGFALNUVOWE     XEREEEMHEFXXM   POOBFF          VSWCWVCPF       KRSTFEYEKV     
YHQEIEVGBIIME   : JPFLLNDR        HOEIRQXKFQ     
QCNSENDJH       : FTCFSIXHIQSE    EPKTNGR         FEOQTTGWGIB     MVTGGYIJHM     
SADPWSGW        : PTRPYRDQ        XWMGRSXTNLQEKN  BHEHETOFVUHO    PRUEPOD         SEHAIYPYHYFDQKM
YBKDYQHJCT      : PYQO            SWEGPKRYEQKQ    PPERNKAWYTK     SEQUJ           UQGPNMUGG      
FMSUHYJKIQRES   : XOQHDNBJBCEQ    YPUMDSFE        NHQNXQRSY       ENGUM          
TRPDOR          : QKFDHNX         MDSVOBVTIGCB    JSOWOAXPG       GHXAJXNJO       NNUWRCFGNSQ     GEXUBNSOLY     
REITXPFALV      : XLXBQQBRJSAVSE  TNHKDMYM        WOOKAHIGHHARJQT XTEYAEALLVPHFOF MRSKJAU        
XQCGPNS         : CRUIEBWWXBTET   SBGGMKGJFEFW    SVKBDIXEY      
GKEYIYRAEI      : TFSRU           GPJYSGFG        IKPTUVLETYGJDT 
IDYQYWGEY       : QKFDHNX         TBLFHXI         FVTCDRAJXR      NDPPQUALFMSFJJ 
CGSSLBKYT       : LCVFVJU         KWSRDRDBGVTI    EINVVGRCUVO    
GHPHP           : CUVC            KDNVEQVGVSODG   ERJTOINQWW      HYMKOWAU       
BPWMKGRKWQJGW   : USSLNQNUBUYCQMA CFVGQRKDCQRRODG MYPWI           NIBP            EVHAUIRM        HUAFQIOPQX     
CARUUDXGF       : STKBIKHDUIUQXI  QSNOSOGGFYMBTGA YEIUWPPUAKBBNQR
TNAJ            : SWVJFNJTCMW     LBBCIJARUBQUPUA GKRSOSNYKCSX    OIPXPSUQOQWQV  
RDYHALSI        : AQAMGOLUHYR     NRBFFTWVWBQIHW  HGOPVJTT        EWCQFKXKVSSW   
FIVOQSASSSOOXMW : VONBUNYDAS      KQPVCDOQMGQHA   XNUXIGKHALNH   
HQSJCOBFNLIBG   : DVCGAKT         OCAABVBMW       VNWSWUSMVK      OTFKRSIYYFIJ   
GLYCCPU         : WPTBXUUJYFRJ    FTUUQACVYGUI    XGMLI           YADYMUXVXO      XLHCGBELIKN    
JQXAHXOECYWWKYL : JUIRLBKUUXCIP   BHESTQUYSO      URFVCRV         RMWSVMX        
HBAREGKK        : MVTGGYIJHM      KGSBS          
KMVCKYNDYPKXHQC : HPJGMDDBVEO     SRBKVDNHNNE     FQUNXWR         PLEKJJOQQJSTBD  GBYRCQSDMQR    
PYQO            : YBKDYQHJCT      RVJFMMBO        OTFKRSIYYFIJ   
FXOHP           : LYVNXRQNAO      EHXR           
PBGJ            : HOTTDCOKNX      VCTDGMWCISWVNT  PQQCACQS        GCNFIRIKHAWOB  
VGRGHILJ        : OMWDSE          KBFRRUBUCFUITH  ORUCBYHPGIN    
VHFOJNEIHUXO    : CMGXJFFEG       ADARJBIKWECJ    OCRXQTDKJGUPRM 
NWNJMQ          : HFWFROTRUGY     EQIPHLP         TPWVGLNQJF      FJCUCDYFU      
YENHYVOHHXHDHPT : CFVGQRKDCQRRODG MCWA            HBFBHAMRMHIGJJA KWCOXCTXNHWF    FWDRX          
DACK            : BLXWIQMVYBOFM   YBUGE           WQGT            IXHSMTPQQGI    
AATPY           : MIKWVL          GWLGNQSHRK      WEFR            FLPKDRXKOQMBPAJ VVCCLOYQOWHXCDN ABRJ           
BNBTM           : NHSIQLRGNJ      VWOAQI          YFOIJRLASXWFIA  TNRXMKKYIKWCDIF OLKSOGEQLRT    
HTGELNLLVR      : XBMEMHWIIBX     AYFRHVHIAIMS    NLMWTQGUMYQ    
LNMQQQE         : NTGBUPJ         NGGNXPNUJIJRJ  
TEKL            : LLMBNV          WOVHIMKBX       RYXOMCMQFYLHPM 
TNQUJGDQCJWN    : FXYU            YTYDECOLFE      VVCCLOYQOWHXCDN WPLRTRPDEWNWWE 
LCVFVJU         : CGSSLBKYT       QMAMLWOXKFE     YKPNX          
CLEGAXMM        : GBHQMMCCWFSLP  
PHYJEIRHCTT     : AJLHTSHWYIJ     LCRQVVUTLNATA   UEAUYDC        
KTOMRTKDPUFDBO  : QHBQFD          CHJSPUU         HTKJWALBYVKC    UVSB           
YBQLTAMD        : DJDAIMOQOM      CHJSPUU         UMFCXNAAXREPKIJ XTEYAEALLVPHFOF PFUQ           
VWOAQI          : PNHMPKAAJ       PWCTERDTKPHTTXF BNBTM           PLRX            ICBRC          
BESNVMABEXHKYV  : YTQSYHFEQKGSNF  CLMLEOKSKT      BAHOTOV         CUHAXLLONCFMJD 
BYHMSIYXPWUEWM  : NJDQOJXBSNQV    MPEIWTOS        NNUWRCFGNSQ     PCWPUH          MBKQS           MFOFCISVAHBXIR  ICBRC          
BPTTGSIGTPE     : QHOETQBJEETKGG  UPYNGA         
AGYQHBXVT       : WPLRNEUX        XTXKLSCSUCMSB   YHVQUXMGGJXMARG PPKCSCHNTNV     PQQHNWAW       
WSXUNFTCUWSO    : YUNGPB          TMLIJOGNXGVQTC  PCRTDREAK      
BHEHETOFVUHO    : KSISNANPR       CNSWLGTWQUQXK   SADPWSGW        WFWJ            INFBPNOKHLMRPQ  DHCMBVRFF      
IMACXWWXTLDON   : LAIGWMMVHUGLX   GIUXFM          KODFSFHOEMRYWPV ICBRC          
NIRHJBLT        : YCWLIHBEFLK     XAKJIEEOLIDTM   MNOYLLKFRN      WNGMMMOTTVB    
HKNDFWRLFG      : CVEKIQUIPAGHXH  WEFR            UUVBMB          XNOEHXY        
JGKJ            : HYGRG           UGUWGKRU        LKGWMSQJ        VPMHK          
HUKVKNLVFS      : QNDBD           FEQCCVOS        RIHF            JEVYLUFF        ETDUSQ         
IGBONLESSB      : LQCB            GECABXCC        NTGBUPJ         JAYEWXKKHVG    
EGVRRCFBJMXWKLM : OEXXSEWVEVXDFU  SWEGPKRYEQKQ    YYGSLAQLT       DQOWD          
HTROCXQSM       : YCMINJNX        IYPFWQJREDIYP   NAFAEGGKWKQ     URFVCRV         IBOOGDMBLPT    
WHXXUEG         : OUMAVLQTKDUC    VBFQDGWF        PWUXMNMNTC      YFOIJRLASXWFIA  YJKGSYHYP       BJFQXRMR       
YBUGE           : FFYADNNR        DACK            IXJLYWYOEDAFCTW TIIRHVSCEESS    NCGLREK        
SDEFOSDXMUOO    : NRMNITPYPRE     EBFYMBBKDE      HGOPVJTT       
FKIMH           : PRTQHLOCE       XEFRELATFBA     XGWY           
MIMQODRPYXUGQ   : BUYGOTGLSUXAHKA XNOEHXY         TSKILAGAMLXH   
MXQFCOTYDKULUF  : EQECAMFIMA      CIEIHYPSDCTHRE  LYVNXRQNAO     
FXMNKDCQVURTR   : GMEIDVKUWLMRX   JDIWOXCHAJLJINM CVQNGTVQM      
NRMNITPYPRE     : SGDWNPW         SDEFOSDXMUOO    JYLB           
MRXUR           : ACJIJKTIFJ      XGMLI           PIDLCRDCJSV     IOXCT           LJFOUIRWBQI     AKPQIOWGVXE     SXVTTBKJWMRSP  
SEQFKUVG        : FANKSBWALDGP    YKKFPHVLCP      EGTAYBYWLLYXJGO
NCJNRDCGNXX     : BRIPGNDYTC      QPJH            CWNLMUPVKUF    
PRTQHLOCE       : FKIMH           SSLRAPNRCGL     YFFYTRNHVU      GRWMILOLAK     
WIMCSHBBAQ      : DGDUMMXEIQWT    OPBDYEQH        KYIV            RJFOHTSNO      
LHXPLGDKHSCYMSG : ALMSHWSRCPLJ    UKYGQPOMJCDDSFK QUSQHTXBTKFHJI  HOVJJHQHSTBUQ  
JKEFHPRMICN     : PSSEAUUPVTPK    XTPKDC          MDYMGQEPPTPQE   GMEIDVKUWLMRX   GMBNDXS         JQKILWGS       
EGUPNUF         : OWAXRBOIKVM     MDYMGQEPPTPQE   AVYPLR          OSQAJRFYYB      BJRYFTOQRUKGTPR QRLDEEO        
CLMLEOKSKT      : BESNVMABEXHKYV  TPJUVMKYYOOMGU  MVWPXXNFSU      SSLRAPNRCGL    
TEXCONTBXVQK    : GPHMEO          RNQOHQGTNOYQ    WOMQCGSIWPUJDNE
WFSLDANFLAS     : CPIJN           MGNW            EHHUCSDOKO      UPXHCSOFRAVSYPL SIQIKF         
QDKBYC          : SLBAAWGX        XEREEEMHEFXXM   CVEKIQUIPAGHXH  FIIH            YIDTWLYUYYXYQC 
GAAUPVXNU       : OXKEQBLUHKJOCD  LGNMJB          JGLVLUFWP       IEOPAEG        
YUNGPB          : SUJAFALPCFDKE   WSXUNFTCUWSO    YPUMDSFE        NAHSFQOHD      
QOQCQJUI        : YJKGSYHYP       KCPMTCXDQU      CYXFSENFJPGFH  
FJQJJWLJRBGRP   : GPJYSGFG        RVOCIQBAJGHCXTP QQXHT           GXFXIGAYNKTURSI
GQXWYOXL        : RCRC           
NEJEOGOGOYWAKU  : ONUQOGPIPEF     QHWMNEMYFEX     AEQGCACINGKW   
UOPDHHGPXGMAW   : UHYTUGTE        JELWQTU         JAOXIMLQWMYCE   JRCALSULUJ      QLTCEPU        
NEBRQHIWWONXO   : VRNPEJHQPBD     HQNSGWEWERW     OFDQJIQAGQURYL  NUJFPIXXKYJYGB  BOFVVOF        
IJBFASKJBQA     : LCFEOSYICKQJOMO BDRINRHHHUV     XNOEHXY         ICFAFQBL        RRQRRNVHIQOK    ISSDTOSOJXLN   
AODWCQ          : AUKOW           LKGWMSQJ        ICUHMLVF       
FJUNRTMJ        : XCYMFFKQRSTF    RYXOMCMQFYLHPM 
MXWU            : MUWNEGRXRGWEUFO YNNYMMQB        HEDVLF          ERJEWXEGQCADBP  IXPNPVGAJBALI  
ADJUNVVHVAJM    : JOIHHVXPG       RNYATS          QYRYQI          VDNAHLFGTNFPFU  GBYRCQSDMQR     ANHJQ           BSIOG          
GPUKUEHKX       : ADARJBIKWECJ    VPHJXDKUGE      QJWQPOKWSUTO    IEKC            AAWOFCII       
WJKJHJHSLM      : IOADVYDSHSMXQM  ESIL            MOBDJMQOSLTVWOG IJWXVSCRXKULJNU
GCBDLWDULICD    : BSAFKTEKQPVFSNK HGWXCOSTV       AWMARUSNARBN    SQAFPX         
OYJWLKB         : CPITNJDP        UMLYPBQU        KYIV           
TLWCWGUISAOVBTJ : YOLDYYHXXOWGJT  AVFODC          ROBXBXKRRNVGCF 
YFOIJRLASXWFIA  : YKMABFPCRLJ     BNBTM           WHXXUEG         DAPXLXTNETDU    HGFCEVLJYWCVCMS DINWXNBF       
CNPGKWEUPEKN    : NCAEYN          OYGNRC          PFMXC           NGGNXPNUJIJRJ   SALELYKMGONOX   KODFSFHOEMRYWPV GWHIUJBHCDQGNF 
GXKIDYQOREO     : EGRVYIX         MPIEETDXR      
CORMOKPDBVNXALP : QNGYDITHSFAMHU  NJDQOJXBSNQV    JNGPTOKXN       UFHFEQHMC      
XEREEEMHEFXXM   : URLAJYCUBEJBLIO SBHSYWUO        QDKBYC          OPBDYEQH       
MQBFESRVVUT     : HRQGKHSOFS      FTJOXGOBFSOWJOV
UWWLEUPXC       : XKAUX           AJLG            BTBTVGCDE       EXISQXMWRDD    
CQDIWDIJ        : OXKEQBLUHKJOCD  HQNSGWEWERW     EWCQFKXKVSSW    ONRYLXLSXQJFBJP
VCTDGMWCISWVNT  : YDOBHSPMX       PBGJ            WOOKAHIGHHARJQT OSWQGBGWPK     
YAQQX           : JAOXIMLQWMYCE   KTBR            OXCDAATUGOUD    UXUGEDC         RABBQW         
MCMRN           : IEQJKFSIQL      JYMMKQJBJLCJ    HNTXGRT         KNRUUAI        
UVWLTYHWITUKEP  : JOIHHVXPG       IEIRGPXPVG      LVVBL          
ADDVFF          : XKYBKQXUDXKPAD  FEOQTTGWGIB    
XFKLIYFVKBTJOO  : URLAJYCUBEJBLIO GCLXVV          SNXKFCPHUDJBI   XGMLHYVCOPYTOIA GMBNDXS         GQJNLEQWNVWJO  
VNTRKEV         : UOQWNQ          JKGDNMINAV      NYNUDNAXRKWYJ   RXMNFB         
OVGTULCKJHUW    : NQEWAWAQL       TDQHBI          OYGNRC         
WDNJ            : AYFRHVHIAIMS    VVHPDVFSVTGGYB  OKKWHH          DHCMBVRFF       IEIRLDGQJABRQDA MTCUQOYOQU     
KTUYFSO         : TYFQMEXCVC     
KAFICVEKQBVSL   : FXFEACASH       FVMOFSPWOQVROS  BUXGAB          SLRJXBAIDPPRWAL CEMYQHWLSE      ICIJBR         
CJHUGKIPSSL     : LOCEMBTFOCGFKVF JNKOSB          AAWOFCII       
TQILRUNXDPTK    : QPVFP           USSLNQNUBUYCQMA UJJUDHCXRRQNX   LEKBESG        
MLYHAJ          : WAWUHH          FCELN           UCIDBVXTMAIOL   NTBNUHWTS       BNGIPCDYXFQHCHX
JRHREPJALV      : XAKJIEEOLIDTM   EYMLPGP         YKCPT          
HOBSHXIHEYB     : VAOQICYAY       KTGEU           NGEGYTLEIGJP   
CQCDAEPM        : WQANKQI         VSDOLHBFYEJJPFA KTKSSMJSDLDGJQM
JTHPM           : WXTYEIREPJS     QKJGRSIMXUGSHP  KFQATLGPTLQJQEC PLEKJJOQQJSTBD 
PANG            : CEWABIM         CRFIULWKKOD     BRSCQXVJPK      EAHXPN         
CHDLFLSJMW      : OLMLNHXLQWXF    UWNP            AITMXQJE       
QNFUPJMDAVYJL   : KFECRUCWVR      SUCXKYCCWKAPYE  VONBUNYDAS     
BCNQKV          : EXRNFYSFUICJG   ELSYOI          OTWQSG         
RBHYODL         : QDITUB         
ANUPUPFHEKH     : OXXKLQIYE       TWMWJIYTGMPNGQN OTQAYMJ         UHNLEXPE        ONQSCT          XLHCGBELIKN    
MQMAUQOLB       : VNQSWIFQXMXY   
JUNTTC          : VPHJXDKUGE     
HGWXCOSTV       : UERPLPQSWJDRRYF GCBDLWDULICD    FFQVPFEGF       GWPGAEPAKM      NKVXHWSQXJBKMUL
YJJBVBP         : ADGYPI         
XGMLHYVCOPYTOIA : XFKLIYFVKBTJOO  DOGVAJPYLGA     NUPLCBPPAXTIGOX VHLY            CLGIJPUCGM     
GECABXCC        : FRBPLLEXXHENVQN EDKEIFYYP       IGBONLESSB      XEDNDR          EAFLORY         PIYGNKFDHLYI   
MDFPTENAQYKQWO  : THGGI          
OPBDYEQH        : WIMCSHBBAQ      XEREEEMHEFXXM   JENCWC          RWND           
UJLTMNDBRJQ     : XSOJGHUK        YXLHLYAWEPS    
NGNG            : NYAIFUESONEYW   MPIEETDXR       QHAYHLHXK      
AYFRHVHIAIMS    : HTGELNLLVR      WDNJ            CMOEWQWCPNMHRP  RLHMVLDAQMLORN  LTJXLFQQYW      TNRXMKKYIKWCDIF
XQALKOAPPTB     : KTBR            GCHWCBMT        POOBFF         
HQMWXUAWCR      : KSISNANPR       VHHKNWRKHH      CLGIJPUCGM     
XYNAICVBCM      : YDOBHSPMX       CFVGQRKDCQRRODG CDJSPJDUE       OOWETGPOLPFK    XLHCGBELIKN    
OYQQOIKSPRJ     : LLVNGUE        
QHBQFD          : KTOMRTKDPUFDBO  PQYMCNIBGQWYIA 
LEKBESG         : KLMQEMHHQHL     YTQSYHFEQKGSNF  TQILRUNXDPTK    JSNJTPGI        TEXCEPXKOCEMNCO
TIOWYNPP        : IIIXCRRW       
YAXQTHWNRYEY    : QHMSVH          SYLVDPRUV       HKDOJANDOGGSHYE YEIUWPPUAKBBNQR
PKIAONUUPQFFP   : OEXXSEWVEVXDFU  GLVRLMBAAHCOSTU YDAGWFCQIN      NVBRJYRTOCFUYJA
SGUXHXXA        : SVWUUJSN       
GWJAVQYBGL      : DOJWX           FEFLJPNB        FFQVPFEGF       NXCNYORGKMQUN   CDFDN          
IAYFUPVBUNIPT   : ALMSHWSRCPLJ    PFUPG          
ODFMF           : FQUNXWR         DHCMBVRFF       AXWQVYGTTEMYSU 
UDLU            : EURPWJYIHR      ULLWBVAHNWIV    EVHAUIRM       
CVEKIQUIPAGHXH  : FANKSBWALDGP    HKNDFWRLFG      QDKBYC          AUFLOMAHYS      ULLUK           CBESMIALUIOF   
MRSIWJODXTFVYS  : GSYGXIIT        UGUWGKRU        FXPWJWD         GUOIWSHKFVCJSE  QWPIYA         
BXNHKVXGGQIMXJV : GGMCBL          WXTYEIREPJS     THGGI           NPNAERSXVYTSE   IVUBXJESWEQN    VTJJ            URCM           
VNXG            : YTYDECOLFE      KCPMTCXDQU      UMYPG           DOCK           
JUQHRVDQ        : OXXKLQIYE       RVULCKVREVKYYXI NKIQT          
WTOKCAI         : TBLFHXI         QQLRC           TUQLVDGDDYO     VVCWTPBCBVEXFB  UGBTVKSD       
GQSQETACWXQUHEE : HGOK            CLGIJPUCGM      VGDEFSAPY      
UNVSTPJQJB      : JELWQTU         MRCBKA          YADYMUXVXO      GJBVYJ          UAIOLESXNKQ    
NBNQJEJ         : CCUBKSPGEMYQ    ECREWGBTYLMV    PXNXPLNL       
KFDNCB          : XYKPAMRDKEWRW   ETETLIYFAXCDE   KIYH            EBHLIFYSKFTOSEC IMPFRLTFYYWHPTT
YKKFPHVLCP      : SEQFKUVG        HDGI            NPWHCU         
LGNMJB          : GAAUPVXNU       RXMNFB          GEUSYUJNAJOHJMW DDCRBNGURAL    
YTYDECOLFE      : UTFMQYD         TNQUJGDQCJWN    VNXG            SOMWOVXGQKJMR  
IKPTUVLETYGJDT  : KGGMTGXQNIFUDH  GKEYIYRAEI      XYKPAMRDKEWRW   GEHYSQVDC      
QJBTYCOYFUD     : LRGF            PBSHFEHNXJHVHXA WNOHFJXP        EKLSULEKFYOD    SCNRQA         
GIAWSMNMJL      : OKKWHH         
NFAT            : LMCWMUVG       
DOGVAJPYLGA     : JSYBTE          XGMLHYVCOPYTOIA ILFLHQJIRAFVKAO QUABP           WPWYSVABQIO     FALRRTXWQ      
BDRINRHHHUV     : IJBFASKJBQA     BOXSVQDOI       DJXGAMPERRKDB   INGG            RMWSVMX        
IWFNWBEARMV     : CEWABIM         SSLRAPNRCGL     MTCUQOYOQU      WNEEJRPIRR      CATXWIF        
XNTLUTFVAWGNQQW : JPREUPD         IRVQGU         
LTRUSWKP        : YDOBHSPMX       LLOFAEILNIACS   UURNNGLSGLGFJN  NYCAFU          KEHFD           OKLNLFD         GEHYSQVDC       QBPUJNCQVFLJP  
PRUEPOD         : UTWUK           SADPWSGW        BUXGAB          HHTMSXYA        OGRQSEYF       
IOADVYDSHSMXQM  : GUOIWSHKFVCJSE  WJKJHJHSLM      MURVAGQI       
KEHFD           : LTRUSWKP        YLKBKA          EBHLIFYSKFTOSEC QHXBACNLJ      
WELOBQGPVLYMO   : CQLAIBQCNFY     XKYBKQXUDXKPAD 
JNJEWCQ         : TNBBX           FVYGXPPJG      
SEKFIT          : KXWSUISQYTT     ACMR           
MNHSAXV         : QHMSVH          GPHMEO          JAYEWXKKHVG     VOOQMPYBLDPVNU 
ELQSMDHQMW      : WMMII           PNQRODCTLEEFT  
TVDKTXQEECA     : SPHTNQGSYTJXIWA XTXKLSCSUCMSB   IJNURKIMBTBY   
QQWLSWHLCSCW    : CYVKHXULTFXUJL  WEKFX           FXIV            PFUPG          
FGYUFAOBFBXDUE  : BDIHBCRJNGRBW   JAYEWXKKHVG     GDLGWSKWGGWTBA  QAMAF          
WFYPVXBOUICYD   : IRKQHAVRW       UFHFEQHMC      
VLNELI          : FGUBVJBXALLLPFJ
NYNUDNAXRKWYJ   : VNTRKEV         MBPFERLQ        GDNTOVHCT       URCM            FLCSUIGNOJTDK  
UHNLEXPE        : ANUPUPFHEKH     IEIRLDGQJABRQDA GBYRCQSDMQR     WSKLV          
VCPKJBUU        : EJNAGFVYFI      KEXCT          
WILA            : UHYTUGTE        LWSB            CFVGQRKDCQRRODG GWLGNQSHRK      JOTPUUQRIJ      CNKEN           TFKF           
LXQVUPHJNQWB    : KTQLU           IRQITEM         LMCWMUVG        FALRRTXWQ      
WRCXNGPAPQVL    : SHLW            SIRMQFYQUNQF    HFWFROTRUGY     GMGTHSRS        NFPCMACJLRJ    
SVWUUJSN        : JAVYIHGRXLNKFOT FEAMXJI         SGUXHXXA        BFKJQNYWMNYROL  IUBEMYJLLCOKL   AKYHJID        
PDRYSIXUGUMKU   : SDNNW           JMLRWR          RAMCHDLAYNWQK  
TLDLEYYQTXNOSYJ : RBUE            KRYIIGIYXTCF   
JYLB            : NRMNITPYPRE     RKBIOXBLBQYPASH WMPPISNEQADVR   LCKBOUJ         EXISQXMWRDD    
FLACU           : OQMOCSQEDVVDMR  IFOGFPD         WIXQH           HDFMIBHSKSUSVJ 
OHTQBHVNM       : UHYTUGTE        KGGRGOLYEBQR    MKFCBRJP        FEOIWVOEGTVXLPP EKLSULEKFYOD    OCQU           
OFQMSFFSONCPC   : WPKDVOJUJDGBMN  FXPWJWD         WETFTEVMTJ     
RJQRLNQCVLUYSR  : CUVC            UGUWGKRU        EUAWGUEANAS     NAJUJMTOKTWTC  
HOCMGOGNWBFMD   : JHPNB           HJAWPTDEE       CDFDN           DKVTMHCV        KKREACSQAFHG   
QKPADJNRB       : HEDVLF          LVLUMAHPCEWWSO  MRCBKA          BQSWNHHDBX      DGCPBRAS        ACSFBX         
NOLMHFCPT       : LXLPWDXSKDSBV   DATQGOU         OSQAJRFYYB      GQHGRPQ         NAFAEGGKWKQ     WKCTLLSE       
CAWKOVLTLQQCBI  : OXDCMCUNPYF     SATVXNEFIDI     YIDTWLYUYYXYQC 
FSSWVJMKWBR     : CUVC            BRELUSYRMOAC    CGVRK           RJFOHTSNO      
FJVLOYLYN       : UQTVJVBHHGBPTXY OXDCMCUNPYF     JLGYQEWHVGLE    ABUGGJO         DJXGAMPERRKDB  
NJSEA           : FRBPLLEXXHENVQN KQKRSDX         QWNYPPOQ        MVRXXEGHGF      RIHF           
ILDNEVMC        : TYKOF           UDPFAFWLQDTHHRO
BMECGGKQFVHEJ   : IGBC            DDKLPK          FWXQMKLNCYT    
RRVD            : SNXKFCPHUDJBI   AUFLOMAHYS      NXEIPA          CUUYWHEVV      
BFKJQNYWMNYROL  : SVWUUJSN        XIEJQCFBBNJXHLA YOJGWCC         HEBGKY         
SUFDNKCUOLDIF   : WTUSGWGHOPNU    DQAB            RGEUVFCHFU      HISTUERGY      
LUDRHMIXNGKB    : UFHFEQHMC      
CPTB            : BLXWIQMVYBOFM   GWLGNQSHRK      KGGLTYVUNSN    
QHOETQBJEETKGG  : BPTTGSIGTPE     EHWKGBKY       
JAOXIMLQWMYCE   : UOPDHHGPXGMAW   YAQQX           HOVJJHQHSTBUQ  
DPLMERJWUUDYON  : UXUGEDC        
UWRWMQGYC       : GMBNDXS         OXBEJWJCINOQ    PNQRODCTLEEFT   IJWXVSCRXKULJNU
WRXBV           : DVSTHNRUA       NKIQT           JSGWVCFWTI     
GNITTA          : DYUIDUXEG       KGGMTGXQNIFUDH 
SUXWW           : LBBCIJARUBQUPUA KDEAVHMTWYJDR   BLQAPRWQIYAIOH  WPLRTRPDEWNWWE  MRSKJAU        
MFMK            : MWMNBWYBPUEIR   MFSWEOHBHY      RHVVLLCRURO     EDVACHMHESI    
JWPRXURW        : VPBFJ           CHAQUDFTDUT     NQKUG          
RXMNFB          : VNTRKEV         LGNMJB          ARFOQSHHABODTL  HKPCJBEFTEHUWGC BCWJGVLL       
BUYGOTGLSUXAHKA : MIMQODRPYXUGQ   SATVXNEFIDI    
HPJGMDDBVEO     : KMVCKYNDYPKXHQC DOCLX           INHVWYIIMFQHRU 
JPJKMIQDFWOAT   : KTCIDPKE        SDAVFCYEELBL    NVKBYSVG        TDHTCCF         QXYMAXHRBLUXP   NYTJXYGN       
BCCBVKSHSG      : CIPPPOYVESWQR   IGCYLC          YAEI            NTGBUPJ         SNQROYCONPKX    EJSAIHUPMTTTMOA AKYHJID         JJUBCVGNLWYMR  
BCCBVKSHSG      : IJNURKIMBTBY    GJBVYJ         
XHJCX           : SYOL            HSBKWJSHSTCBMLN ICIJBR         
LPGXDROGY       : YNSQMW          KDOJVIYOYL      LYVNXRQNAO      MEMCTVYYJN     
XYKPAMRDKEWRW   : KFDNCB          IKPTUVLETYGJDT  ADGYPI          FDYOCLODSKMK   
FVMQAN          : YDOBHSPMX       LGUWHVWPBPHSOJ  NHKFKCJFMXI     BPVOWFJDEIFKH  
MDYMGQEPPTPQE   : JKEFHPRMICN     EGUPNUF        
RQYUBETVDWDBM   : ITINEELUTT      UQUWMLPR        PYYPSMJBILVX    YHVQUXMGGJXMARG
CAMQDLDMC       : VKEJFNKBIQWPUH  YAEI            NNUWRCFGNSQ     RGEUVFCHFU      SRNVNIYT        IERT           
ETETLIYFAXCDE   : JOIHHVXPG       KFDNCB          GBYRCQSDMQR     DKNBQ           RRNCACODCGMNXQS
BIVFJKCLKO      : RVOCIQBAJGHCXTP AJLG            JSOWOAXPG       LAQAETIVMLHIDH  UCOPYFISKW      TFWWGWUOVL     
QBKFFTJCXDNHE   : PRERQECCQFP     ITVYBXCQMPC    
JEWM            : YCWLIHBEFLK     LJFOUIRWBQI     ILYKVFQIVHME   
VQTSXDDA        : YDOBHSPMX       WQXVHHOH       
QQXHT           : FJQJJWLJRBGRP   IJIPCKXEP       JPWXXMWOF       DUDWOJKLGJHTG   TFWWGWUOVL     
OCDAEBFT        : HJOGPYBDSK      BDFTOPUCFFYDWHD FVFMBFY         KNRUUAI        
JORPNHYKXUDV    : BMDSNXX         IKXJRUSPAKES    CGREO          
IXSYQQINAWPD    : YTBKJSTAUFFK    KOCRSDQTFY     
VEEPPNGHEVOFIO  : AXHFCUPVAPJ     VKBTNRMO        NRWTMLS        
LMCWMUVG        : NFAT            LXQVUPHJNQWB    EUAWGUEANAS     OQHSQLHBVEDBQ   GJFAC          
FTNE            : PWCTERDTKPHTTXF EORY            UEGWRGJEDNCX    UMLYPBQU       
SEHAIYPYHYFDQKM : EAPALXPMPTO     UCKJGQTG        SADPWSGW        OQMOCSQEDVVDMR  MCPLQEMOFPG     CEWABIM         PPKCSCHNTNV     WNOHFJXP       
SEHAIYPYHYFDQKM : TAFJQY         
NAUPWJMVPBD     : BNGIPCDYXFQHCHX XNOEHXY         DDUEDJUISSJW   
QHWMNEMYFEX     : WQANKQI         NEJEOGOGOYWAKU  CSVJEYUINXY     ACNILP         
FFQVPFEGF       : HGWXCOSTV       GWJAVQYBGL      EDVACHMHESI     GXFXIGAYNKTURSI UEGIGXHQK      
XFKLB           : MJFLLEGIWO      EQECAMFIMA      JEVYLUFF       
OGOFP           : QKINPMYGPI      TJEJA           PRTYLLMMUR      NGGNXPNUJIJRJ  
TESGFYM         : CONQBBTCQK      PXJHVYJRXTAVPJ  AGKOSQFRFPND    VDNAHLFGTNFPFU  LMQRURAVJIUYF  
NSKG            : AQAMGOLUHYR     DVSTHNRUA      
CLWITXHBLUEQ    : GTURTUEYGBOGPL  PIGXT           RUDOVWJXPHTY   
KFQATLGPTLQJQEC : JTHPM           UENEGLOMT       YDAGWFCQIN      UXPICRJA       
LUGYS           : BHRNDLBAOU      JUCOMIMDL       IUBACSOVSXE     RRNCACODCGMNXQS
SSXVGS          : RAHAUGF         PINKKI          KRFV           
WEKFX           : QQWLSWHLCSCW    LAIGWMMVHUGLX   SGQFAGQU        IXPNPVGAJBALI  
YLTOFIFQBMUF    : DTPGESWIGFIMHV  BPBW            DJAWYJLKBLQKVJG KKVRKJ         
QLYLC           : CUVC            WPKDVOJUJDGBMN  SSLRAPNRCGL    
EDQNVRKDEPBRRMM : FXFEACASH       VLIQCRT         UEXUOGDVPFQAYMR RQBYXKUMB      
TUQLVDGDDYO     : WTOKCAI         XXPHWOQ         FLDYGCGOIHRYAVQ FCJTC          
KTBR            : LOCEMBTFOCGFKVF YAQQX           XQALKOAPPTB     GNQKSKGTJANP    YHVQUXMGGJXMARG
SFUMRXQKBL      : DUNGFMFKGKGN    KCUQSAYXMUF     HREAJAF         GDLGWSKWGGWTBA  FYBXAV          MRSKJAU        
NAKKUBXS        : VIUQM           URMJUITPWVJ     GEHYSQVDC      
GWLGNQSHRK      : AXHFCUPVAPJ     AATPY           WILA            CPTB            BJRYFTOQRUKGTPR UVWILYJNNDXOE  
MRCBKA          : JRCVYXGSERI     UNVSTPJQJB      QKPADJNRB       OQMOCSQEDVVDMR  BXRUIMPFQV     
UEGWRGJEDNCX    : UHYTUGTE        FTNE            QCDILVDB        WPTBXUUJYFRJ    RIUI           
JUIRLBKUUXCIP   : JQXAHXOECYWWKYL SVFCNDGS        PMMUWTNDHLS     WOVHIMKBX       UGBTVKSD       
LAIGWMMVHUGLX   : IMACXWWXTLDON   WEKFX           CTAWAOELTCXP    GLRY           
QWRATCTHDED     : JACBWFEWL       GRNSAUK         YENVSHSWK      
CHJSPUU         : MMIKVHCKUNWQ    GESQBYUNANR     KTOMRTKDPUFDBO  YBQLTAMD        XTEWEL          BPVOWFJDEIFKH  
EUNQQUMYIMU     : JAFLFIL         THCCBDKXYFGEMJS
JPBGRUNXCQWE    : AGOJV          
IYPFWQJREDIYP   : BLXWIQMVYBOFM   HTROCXQSM       DDUEDJUISSJW    HDGI            EWGYKROX        RCLJHU         
HCFJ            : HQREIEKESVYE    MEFTSKHYB      
WKUPIIN         : EDHUBXWIEC      CQLNDPPFWRWQ    LUQYQJPXMVTBP   OOPCGKFOKUCASK 
CMOEWQWCPNMHRP  : AYFRHVHIAIMS    BYOVBHSSPEQUQ   GOVMSYAYHOYWT   KOCRSDQTFY     
SHCCLKLAHYWWHG  : STUJSOOL        UMQE            EQREQJGW       
RKBIOXBLBQYPASH : PSGX            LJBSHHJYTODLGV  JYLB            DPUNQ          
NOUQCHEDPFA     : OXDCMCUNPYF     HKPCJBEFTEHUWGC IEOPAEG        
MIEESFP         : VTSHQCPCACK     LCRQVVUTLNATA  
EQVHKVWK        : SEQUJ           CUHAXLLONCFMJD  EJMO           
EDHUBXWIEC      : WKUPIIN         BSSPRXMCY       UUVLLEPM       
KFRWNVEJBVR     : LKJLU           ELTSEOCLPDA     GJFAC           CSVJEYUINXY     RPPONOIQ        XTWTTUPNYDY    
MNOYLLKFRN      : NIRHJBLT        PXJHVYJRXTAVPJ  IJWXVSCRXKULJNU OXNINGPQI       HBRSAOAXH       JEQVYFEA       
OQMOCSQEDVVDMR  : THSPEEKUR       FLACU           SEHAIYPYHYFDQKM MRCBKA          QNVJWSNLFOEDN  
VVHPDVFSVTGGYB  : WDNJ            BRPCFK          MSGH           
NPNAERSXVYTSE   : BXNHKVXGGQIMXJV KGSBS           NRIMDQAMXISK   
MPEIWTOS        : GGMCBL          BYHMSIYXPWUEWM  JPFLLNDR        RCLJHU         
JOTPUUQRIJ      : WOFFU           WILA            UNGBPCHOLNCQNET
KPBFNW          : WMPPISNEQADVR   INFBPNOKHLMRPQ  MXGO           
IRKQHAVRW       : WFYPVXBOUICYD   CPDXG           GTSRBQJPMFJY   
GSRPHNIDIBWSKGD : HJAWPTDEE       XPLMKRSI        EIITQPLLLPHUEOM
HJOGPYBDSK      : NLQXNOXIFTHSHWK OCDAEBFT        RVLIANLRGHUUWB  TMLIJOGNXGVQTC  HDGI           
QCDILVDB        : UEGWRGJEDNCX    IFOGFPD         PSAAIWGETSKQC   DHRH           
QJKC            : FGATYSKNWUR     XTHJMRRTDPMSN   MEDTBMYJBHK    
HUXPBBYMSI      : OEXXSEWVEVXDFU  GEHMQRROQHBB    JBJT           
RLHMVLDAQMLORN  : AYFRHVHIAIMS    IDXSPH          UFSWWDCHJYOXCTW FEQCCVOS        MFDVKBYUBGP    
KYFMMOKNFLOG    : TFGDUMHVK       JFGENPEABEIAV   HFPY            CMLMLIN         JASIUAUWROXJK   CGXVASNAO      
HQCCCKOA        : FLPKDRXKOQMBPAJ EQECAMFIMA      CEPFAQ          GYPROSNHIVCEMQH
SBQHMFYCYLEGYS  : WQPWICXSX       YDAGWFCQIN      BPVOWFJDEIFKH   DLRMP           VRFSUH         
LGDYV           : FLTNWOTW        TDHTCCF         DTNMKBECTWS    
YFDDHFPWINRJGB  : LLOFAEILNIACS   YFFYTRNHVU      TDHTCCF        
LADNLHV         : MVWPXXNFSU     
ATXJWYFL        : JCARLQAMNBNS    LIQCWAOM        QRXKAHTALB      FRRJNKEVAOJNMYX
MOCUVRTEINPOO   : JRCVYXGSERI     VSJHJNUJNSXIEY  VOOQMPYBLDPVNU 
DQTSCBORDJ      : QPJH            UEJKJOKXNJCDMFB CYDSQHYB       
OIRTTR          : FOPWESAOGSRJO   QKJGRSIMXUGSHP 
ITGFOALWNCNES   : IGBC            KMTFOGBGO       NFVLCDMBEGXJVN  QRXKAHTALB      TSKILAGAMLXH   
UMLYPBQU        : OYJWLKB         FTNE            EXGIJOYITWXGGBW CTKCKEFU        MUOGBTIOKRJAX  
LKUFGRWPAT      : FXPWJWD         JNFWBXXCWHTQ    JQTQQCINT       FYWNS           NBKDCCQ         SVKBDIXEY      
HIXVHNXWRQQ     : PBSHFEHNXJHVHXA VHHKNWRKHH      GEYXQHSHXULXES  HEBGKY         
FCOUFFPTS       : GUOIWSHKFVCJSE  CGREO           VNMGQAQKOXE    
PXJHVYJRXTAVPJ  : TESGFYM         MNOYLLKFRN      FQUNXWR         SLXEWDGPSESLNSF UXMBAEFJAFQFXB 
NGEGYTLEIGJP    : HOBSHXIHEYB    
EJBVJMFHL       : DYUIDUXEG       OKKWHH          IJMVS          
YLKBKA          : QNDBD           KEHFD           WEWKCCEXPVAULI 
WPTBXUUJYFRJ    : GLYCCPU         UEGWRGJEDNCX    PBSHFEHNXJHVHXA UXPICRJA       
SPHTNQGSYTJXIWA : TVDKTXQEECA     WNAQ            UFHJQWNUUAR    
WMPPISNEQADVR   : JYLB            KPBFNW          RNRXHHXJUXAPE   QXYMAXHRBLUXP  
RKEYGTQOM       : FYKNALFU        JQMPPQ          FGUBVJBXALLLPFJ
LYPTVPOU        : SHLW            HYGRG           BRGRLFWGRWX     VJDVFGLHPWNV    HSBKWJSHSTCBMLN
EKNY            : XROP            NFVLCDMBEGXJVN 
RPBVM           : RPUDOUY         JONSQY          VJLI            DGCPBRAS        EHFXBPHDMP     
KGGRGOLYEBQR    : YTBKJSTAUFFK    OHTQBHVNM       LUUJPTAS        UCOPYFISKW     
INXYC           : MYPWI           IPEGROPHBCO     LUGEDEEN        NUQIGKPDH       QHXBACNLJ       TFKF           
GIITHJOXKKMFWS  : KNBGTHBFJQLI    CLHPTCRYUANKTN 
OBFDC           : DJKRWMWESR      UGUWGKRU        WQANKQI        
ESDGCQEDUYLDHFM : IFFTTIHSWBLA    OTFKRSIYYFIJ   
TMFGYNE         : CIKDYY          CNUCGFSYOMPDTRY JHVDTGWW        MPIEETDXR       FALRRTXWQ      
BUXGAB          : RXTTVEUBI       KAFICVEKQBVSL   PRUEPOD         THCSJEVJBTC     DHHHNSARFD     
ETWMXPQD        : XTPKDC          BYOVBHSSPEQUQ   JNGPTOKXN       ULLWBVAHNWIV    XYLK           
SOPCWDXQ        : XBMEMHWIIBX     OGRQSEYF       
DATQGOU         : LRVSLUWAFMKS    KJENXYOOWHF     VLNYAETGN       NOLMHFCPT      
MBENVIKUXKLQO   : UJJUDHCXRRQNX   NAWOUBBBEA      BLGQO           JQMPPQ          IWSKK          
JFOOCR          : UTWUK           JAYEWXKKHVG     HBNCAMGDVPCL    QWPIYA         
VLRVFJETEHJH    : OFGAUDMTTM      VONBUNYDAS      IJIPCKXEP       NTBNUHWTS       YUQAHTBULKGTVJ  MHCHPD         
WFWJ            : WPLRNEUX        FXYU            BPFRYQDGWHTPOT  BHEHETOFVUHO    GXCOPNUYH      
UUOLLMXQBOVUB   : LQCB            RWYHYQNFVOKKPB 
HSPMETJ         : NYKMPKMFSHLJ    LRILIJB         HRQGKHSOFS      BRSCQXVJPK     
BSSPRXMCY       : YIDYJCJJ        EDHUBXWIEC      UTOJXAQDXLEVWWG
YPUMDSFE        : TURIVTHIFQJJ    MCWA            FMSUHYJKIQRES   YUNGPB          KMCFOB          AOHOWSFHWYH     CGREO          
BCKUJGKXKGHVKAO : GSRTLALYPH      OYWGD           QPDAIEDQHODFW  
SOMWOVXGQKJMR   : QPVFP           YTYDECOLFE      FMVAKFR         BCWJGVLL       
VTSHQCPCACK     : HNSGADPRHQDBPU  MMIKVHCKUNWQ    MIEESFP         WLTFJW         
AUKOW           : UTFMQYD         AODWCQ          SRBKVDNHNNE     QSNOSOGGFYMBTGA
EJCUHABBMNNFEJB : XVWBRBJLQLDGHV  NXLMIRVYHBCKJN  PNQRODCTLEEFT   YYLRQUFC        CGXVASNAO      
SRBKVDNHNNE     : KMVCKYNDYPKXHQC AUKOW           ICSWK          
FCELN           : JOIHHVXPG       MLYHAJ         
IXJLYWYOEDAFCTW : LRGF            YBUGE          
ETHTDUIJV       : PRYNHIYRJI      OXNINGPQI      
LBBCIJARUBQUPUA : TNAJ            SUXWW           UDKXGUVQ       
ADLAISV         : FANKSBWALDGP    OLMLNHXLQWXF    VLNYAETGN       KGLNUJM         KEXCT          
MYPWI           : XCYMFFKQRSTF    BPWMKGRKWQJGW   INXYC           IIHDX          
MWMNBWYBPUEIR   : WMIDAYDMEUQR    WWFOVPQTKRF     MFMK            RPPONOIQ       
ERJEWXEGQCADBP  : KITQVQKQGKY     MXWU           
MCPLQEMOFPG     : UALGLBXQHKVHHLV SEHAIYPYHYFDQKM
TORPSMYALY      : NJDQOJXBSNQV   
TPJUVMKYYOOMGU  : WOFFU           YKNHIY          MRGDRHRE        CLMLEOKSKT      VPMHK          
WBQDDMR         : NYAIFUESONEYW   PIFGVJMLHRPCMHX NAKLDYAVIWQDYGO
CNKEN           : WILA            JOLPGFVKLQLCVIG EUAWGUEANAS     GMBNDXS         BPVOWFJDEIFKH  
DVSTHNRUA       : OTQAYMJ         WRXBV           NSKG            OBGU            WIXQH          
VPHJXDKUGE      : DJDAIMOQOM      SUCXKYCCWKAPYE  ADARJBIKWECJ    GPUKUEHKX       JUNTTC          GNQKSKGTJANP   
JQRHTFTXUSBTL   : KTKGPBQCA       COMYKSWLX       IOXCT          
BYOVBHSSPEQUQ   : CMOEWQWCPNMHRP  ETWMXPQD        LYSSRRFNUUV    
BUNK            : PIVVCLHSECRNG   JOLPGFVKLQLCVIG WCJPAAAAFPIBM   WIXQH           IEOPAEG        
ISIP            : KPSUIGTOJADTL   KITQVQKQGKY     LPKSBRLDSDBQ   
ILFLHQJIRAFVKAO : DJDAIMOQOM      DOGVAJPYLGA     EJSAIHUPMTTTMOA
GIUY            : MRDUADQYYBOXX   NORNAERFSSMYBG  BDIHBCRJNGRBW   HKPCJBEFTEHUWGC LPKSBRLDSDBQ   
XUMIJUDTKSCXX   : PIDLCRDCJSV     QPJH           
FRYOL           : CQFSGEIJEM      RVOCIQBAJGHCXTP BUIIQQBXPOQ     NBKDCCQ         YTAF           
VHMXYOGHLFFJCTT : CTIAFFOPJOPMDVJ HHTMSXYA       
OXHCQLC         : HFPY            PMCPWRESPPD     QYKV            PVRFQPERDDAI    NMJD            MGUVBGMVEOHJE  
CIKDYY          : KIWNSCD         CSYPV           UHTIKD          TMFGYNE         RPDKDLQVE      
WGTWHIDOVKW     : QLSQAYMMNTIGQ   SVKBDIXEY      
NQCDICNM        : GBHQMMCCWFSLP   PIYGNKFDHLYI   
YOLDYYHXXOWGJT  : TLWCWGUISAOVBTJ GQHGRPQ         GEYXQHSHXULXES 
TYFQMEXCVC      : TDQHBI          KTUYFSO        
GEUSYUJNAJOHJMW : LGNMJB          QPUTBKOMPQQ     GRNSAUK        
UIDLCFRUTVVVTX  : HOTTDCOKNX      OXAL            FWDRX          
CFYUGVFTXQKGAYF : USSLNQNUBUYCQMA TDHTCCF         RLIYMFO        
UPPGTUAP        : NORNAERFSSMYBG  PMMUWTNDHLS     CWGWQCGXAYMDKUU
YLMULRXQSUXQC   : ARYYEKCK        ADGYPI         
PSFXVEFFBUU     : MEJCUOUPESOXK   PQYMCNIBGQWYIA  OSWQGBGWPK      HLQCQSKX       
ORMGILRWHGRHWK  : EJPRND          SYGXLIA        
WEFR            : AATPY           HKNDFWRLFG      MEJCUOUPESOXK   LLRMJPAUQV     
XYTTFYCHVWTMRGT : YPPVRWTEYHQMXG 
UNACTTL         : QUABP           JPFLLNDR        GYIVEBJKDW      FVTCDRAJXR     
GNQKSKGTJANP    : KTBR            VPHJXDKUGE      RGEUVFCHFU      NKVXHWSQXJBKMUL
PYYPSMJBILVX    : RQYUBETVDWDBM   FJCUCDYFU      
AUFLOMAHYS      : QAFRO           CVEKIQUIPAGHXH  RRVD            UYKTSC          LADEOTH         KKBGI          
GMEIDVKUWLMRX   : FXMNKDCQVURTR   JKEFHPRMICN     EYMLPGP         JRCALSULUJ     
TIIRHVSCEESS    : EXMMAOHUTUCBMI  DVVTKSVFRAXGAE  KJENXYOOWHF     YBUGE          
CTAWAOELTCXP    : YKNHIY          LAIGWMMVHUGLX   OSQAJRFYYB      TJEJA           TNRXMKKYIKWCDIF XLHCGBELIKN     GYPROSNHIVCEMQH
JETKDPSLIAJBEPF : STUJSOOL        CSVJEYUINXY     KUPIMSANPBX     JSCJRGISYTJHD  
KMCFOB          : BQVHGXIRCLNISP  OXKEQBLUHKJOCD  URMJUITPWVJ     YPUMDSFE        JHIOGYL         LIQCWAOM        AJHSM          
DFSXKQPMBTGLY   : UTWUK           KYXIHSYQOJEDESV YMRXA           DWOMKUYTYP      EIITQPLLLPHUEOM UBJYSQEHIQ      CWGWQCGXAYMDKUU
EMHHW           : GTSRBQJPMFJY    TMPVFMHLNCUD   
NORNAERFSSMYBG  : GIUY            UPPGTUAP       
LWOAXK          : UQUWMLPR        HEPRFWFHEAUKEK  OBNHCOXBIATRLD  SXVTTBKJWMRSP  
LKFSW           : LNEGVOEQ        VHPPERDNK       BDKIAJNQECJMRTI
AVYPLR          : BCKG            EGUPNUF         PVSCNYUMF       GEYXQHSHXULXES 
LXWSTSFSVLT     : FIMQFUQC        DFJVTFIQ       
LKJLU           : WOFFU           QKJGRSIMXUGSHP  KFRWNVEJBVR     QDITUB         
XHXQHOSFOISIOG  : UEAUYDC         ETATQTE        
NYAIFUESONEYW   : NGNG            WBQDDMR         FCJTC           LXNRBGYNFKWMQM  HEJTOQTOOKXPKGO
WPQGPJNECVU     : YXYDDHRXXJGLSP  LBWSS          
ODDXKTWKCEGHAWW : LQCB            GPHMEO          NLMTRVWLASCD    DQGQSX          NHKFKCJFMXI    
WWYTMPAEBQIDME  : SDNNW           FRGX            SEQUJ          
DHXBTRBFUHN     : FLTNWOTW        WQPWICXSX       SWRKCPJ         EBHLIFYSKFTOSEC
HKDOJANDOGGSHYE : YAXQTHWNRYEY    GUFCLRMCVN      VONBUNYDAS      WIXQH          
NKIQT           : TBVCJOUNPLEGWKK JUQHRVDQ        WRXBV           QAMAF          
UOYXVVFLCNXFEI  : STKBIKHDUIUQXI  NXKFSK          PXRJWMPLQJGHFB 
RNYATS          : AHBMOXC         JIHWQVIJT       ADJUNVVHVAJM   
UYXIJGADOW      : XYOXVMYRSU      GFCVCFIEGV      ETDUSQ         
NUPLCBPPAXTIGOX : WOFFU           YPPVRWTEYHQMXG  JPREUPD         XGMLHYVCOPYTOIA YUWBYHMVMJDEDWT SCNRQA         
QUABP           : DOGVAJPYLGA     UNACTTL         BYKJBQYXKOUDD  
BYKJBQYXKOUDD   : KLMQEMHHQHL     QUABP          
ESPGQLQYC       : BDIHBCRJNGRBW   YFFYTRNHVU      YOEQJQGCXBIX   
HTKJWALBYVKC    : SLBAAWGX        KTOMRTKDPUFDBO  XMQMWEMHLWDVK   IJWXVSCRXKULJNU GYPROSNHIVCEMQH
JACBWFEWL       : QWRATCTHDED     LPKSBRLDSDBQ   
OSQAJRFYYB      : EGUPNUF         NOLMHFCPT       CTAWAOELTCXP    LKSEHA          YEAQKAFOIJNLWNE
JXOUYNSMSIV     : BHWL            QAMAF           HUBVNRSCUBTG    IBOOGDMBLPT    
KWSRDRDBGVTI    : MDSVOBVTIGCB    CGSSLBKYT       WIGTPNBR       
LNHL            : LCFEOSYICKQJOMO OYWGD           FFYMRYAIWU      SRNVNIYT       
TWRITS          : SFYCRSOKJTNC    TNSD            SLRJXBAIDPPRWAL SBGGMKGJFEFW    VVCWTPBCBVEXFB  RFSA           
MFSWEOHBHY      : BEPJPSJ         THSPEEKUR       BXLJKRFUNX      JYMMKQJBJLCJ    MFMK            HWQXPHUOQYNDYDS BOPIPROKHGYAVOH
BDIHBCRJNGRBW   : FGYUFAOBFBXDUE  GIUY            ESPGQLQYC      
XOXRIXHPRETGOXP : YADYMUXVXO     
FQUNXWR         : JBCVQ           KMVCKYNDYPKXHQC ODFMF           PXJHVYJRXTAVPJ  KIYH            BLGQO          
GHXAJXNJO       : TRPDOR          TXASQHPCA       CMLMLIN         OSWQGBGWPK     
EYMLPGP         : IMDQNHKADYIQ    JRHREPJALV      GMEIDVKUWLMRX   AOJD           
MEJCUOUPESOXK   : LQCB            PSFXVEFFBUU     WEFR            AMHUSDJ        
GLVRLMBAAHCOSTU : IDRESQADGATVI   PKIAONUUPQFFP   SWEGPKRYEQKQ    VSDOLHBFYEJJPFA ISXY            OVSIDRKBBAWVNYE
FJPPLMG         : IGCYLC          WIUCTJW         DONERVCRMLPDCV 
FNBTLOR         : YLCGRSQFPDVQFCK KQPVCDOQMGQHA   DLRMP          
CQLNDPPFWRWQ    : RONCN           WKUPIIN         LNEGVOEQ        RHVVLLCRURO     GUDLAQQGKWNYA   XTEWEL          OSLLDA          NAWOUBBBEA     
CQLNDPPFWRWQ    : IUUDIDLEHSQXAOU
RCRC            : JFGENPEABEIAV   GQXWYOXL        TNHKDMYM        RWND           
JPHPYMDCIPS     : EGTOGEQAJYMA   
LURXIWNBEMSBFFV : IEIRGPXPVG      UPYNGA         
YAEI            : BCCBVKSHSG      CAMQDLDMC       FNJHVKNWTPJM   
LAQAETIVMLHIDH  : QSCVOPFVCKI     BIVFJKCLKO      OSCNMVUUTAOKTIF BJRYFTOQRUKGTPR
CWTJKPMRWIAVI   : NTBNUHWTS       LQEDGNYSY      
GBRGRR          : MRGDRHRE        FNJHVKNWTPJM    LQMBTXRMTGS     QRVVCKAO        BPVOWFJDEIFKH  
LCKBOUJ         : QCOJGARIEEEFYU  WXQQMMOHBT      JYLB            KCPMTCXDQU      VDNAHLFGTNFPFU 
CEWABIM         : KJENXYOOWHF     OWOFAYQTVFRCYL  PANG            IWFNWBEARMV     SEHAIYPYHYFDQKM PQQCACQS        PXRJWMPLQJGHFB 
UENEGLOMT       : KFQATLGPTLQJQEC UDPFAFWLQDTHHRO
GCIXPVBAWRWI    : CTIAFFOPJOPMDVJ DTBHMHLO        MFDVKBYUBGP    
APKCQSOJQS      : LVLUMAHPCEWWSO  UXPICRJA        TNRXMKKYIKWCDIF OTFKRSIYYFIJ   
WCKLOEEVGO      : MUEVTMEWHBQ     OYKFPWJNDJIEOLU TNRXMKKYIKWCDIF SUYPSMPW       
XKYBKQXUDXKPAD  : ADDVFF          WELOBQGPVLYMO   LPADV           DPYKHJBIQTPW    UFSWWDCHJYOXCTW KSVPHYFPIU      SUHWOEXEYAGHAMN
QMAMLWOXKFE     : DOJWX           LCVFVJU         CHAQUDFTDUT     UNGBPCHOLNCQNET
DNDAL           : INHVWYIIMFQHRU  NFVLCDMBEGXJVN  SXFDSKWMCN     
BMDSNXX         : JORPNHYKXUDV   
LNQOYH          : ESVJ            NAJUJMTOKTWTC  
BTPA            : DFAQWO          KCCRYNMER       KJFGQCXHF      
ONQSCT          : ANUPUPFHEKH     USGPSBC         AOJD           
IVUBXJESWEQN    : NXSFFOUD        BXNHKVXGGQIMXJV RURGKEYB       
GEHILJLIBOSR    : YDOBHSPMX      
LNEGVOEQ        : MESKTSBDNTW     LKFSW           CQLNDPPFWRWQ    CBXUA           NHQNXQRSY       PPKCSCHNTNV     VNMGQAQKOXE     IJAFNHW        
CBXUA           : LNEGVOEQ        BLQAPRWQIYAIOH  SCPPDLOSULEVSWM
NNUWRCFGNSQ     : TRPDOR          BYHMSIYXPWUEWM  CAMQDLDMC       JUXUHYOJMDRYOF  JQMPPQ          EHWKGBKY       
HLJJ            : VFIVWDWRJ       JPREUPD         KTKSSMJSDLDGJQM YOEQJQGCXBIX   
WQGT            : RIVEFXQQKJYQGW  MUMPNTJOKMU     DACK            VJLI            BCWJGVLL        ABRJ            GCSY           
KKAPNXKODY      : ITINEELUTT      HOEIRQXKFQ      EVHAUIRM        QWPIYA         
YXYDDHRXXJGLSP  : WPQGPJNECVU     DWOMKUYTYP      FYBXAV          HLQCQSKX       
SIRMQFYQUNQF    : WRCXNGPAPQVL    FLPKDRXKOQMBPAJ
UGKVEJBJSU      : RVJFMMBO        DKNBQ           UGBTVKSD        LPJSMMOYNOBYC  
SGQFAGQU        : UURNNGLSGLGFJN  WEKFX           PBRLEV          TFPS            EMSJGWKHCFDHG   WNOLJFYFQORBQXX OJXOXYLTNXOSQR  GCSY           
JHIOGYL         : KMCFOB         
PQAM            : JBCVQ           KIYH            HSMHHMAK        XTEYAEALLVPHFOF CNLPOSBYXCRUVID BLUWJODRJHT     IJAFNHW        
LKGWMSQJ        : WPLRNEUX        GSRTLALYPH      JGKJ            AODWCQ          WGWP            MVRXXEGHGF     
JQTQQCINT       : MJFLLEGIWO      LKUFGRWPAT      VBNGD           HOEIRQXKFQ     
UCIDBVXTMAIOL   : AGOJV           MLYHAJ          PRERQECCQFP     EWGYKROX       
VLIQCRT         : JSYBTE          EDQNVRKDEPBRRMM OSCNMVUUTAOKTIF GEHMQRROQHBB    JXTCH          
INFBPNOKHLMRPQ  : PACB            BHEHETOFVUHO    KPBFNW          ULQADNG        
PMCPWRESPPD     : HGOK            OXHCQLC         KRYIIGIYXTCF    ICIJBR         
TXCHI           : JUTNWA          SAQTLQXJTCSVQBK AFUTXVVWO       VQHY            QVHTIUXBYSSYDUR
MKFCBRJP        : GGMCBL          XEDELKJOBLAYE   OHTQBHVNM       MSOWASYWAPETG   CCMMJYAYH       RFSA           
DFAQWO          : BTPA            NTBNUHWTS      
OLPSFH          : PCECQLAED       MYBIBWOPDSAPR   WNOHFJXP        RGGU           
IPEGROPHBCO     : SAQTLQXJTCSVQBK INXYC           PPTAKNDAKBUJJG 
FJPUQTCSMBHIQS  : IYKAS           WMMIUDOVN      
LXFWJUDP        : NKVXHWSQXJBKMUL FMPI           
RHVVLLCRURO     : EXUOSMPBETSQ    KPSUIGTOJADTL   MFMK            CQLNDPPFWRWQ    OYWGD          
NTGBUPJ         : LNMQQQE         IGBONLESSB      BCCBVKSHSG      ERBGSBQC        PXWJGSL         VGDEFSAPY      
IKXJRUSPAKES    : FYKNALFU        JORPNHYKXUDV   
DQGQSX          : FYKNALFU        ODDXKTWKCEGHAWW WKQDYJQBJKV     LKSEHA         
KNBYJJCE        : BRELUSYRMOAC    YOBRYC          ERBGSBQC        MYBIBWOPDSAPR   QVHTIUXBYSSYDUR ACNILP         
NQJXOUS         : JPFLLNDR        XYLK           
PKLBOGVRWEIPD   : PFMXC           GKCYMHHHT       KKVRKJ         
DSYE            : EBKUI           XEDNDR          UFSWWDCHJYOXCTW OCAABVBMW       CVQNGTVQM      
KGGLTYVUNSN     : XKAUX           BHMVRVHQPWUDFSH CPTB            RDVQGCIAICNXU   VUNUCCJUYWJFQO 
JXNKOVIJTMTLR   : LWAXGKKJLS      NPAUX           FDXQIYWYPOCGM   TSKILAGAMLXH    QBPUJNCQVFLJP  
OMRSOFB         : LVCKVNTGRAXFJ   JUCOMIMDL       CVQNGTVQM       PNQTQO         
QVWOQNI         : MESKTSBDNTW     TRGSONYNLLATO   XTWTTUPNYDY     OVSIDRKBBAWVNYE
OTEEESBOEUDY    : IFOGFPD         GFUSXXLSIJUSPU 
XTXKLSCSUCMSB   : CMGXJFFEG       AGYQHBXVT       TVDKTXQEECA    
JOLPGFVKLQLCVIG : CNKEN           BUNK            NGGNXPNUJIJRJ   YADYMUXVXO      RUXFTBNVYENEWP  XTEYAEALLVPHFOF
RGQRQEKUXHWKAY  : XYYRHWQKN       WSKBTQEHVV      FNATEC          BOFVVOF        
LPADV           : XKYBKQXUDXKPAD  EAFLORY         OTWQSG          CGVRK           CBESMIALUIOF   
YHVQUXMGGJXMARG : AGYQHBXVT       RQYUBETVDWDBM   KTBR            LKIXU          
EBEMYQOAFDP     : RXTTVEUBI       NFPCMACJLRJ     RPPONOIQ       
GMOGVKWSLL      : QRRWGPIQQM      SNXKFCPHUDJBI   AKYHJID        
RWYHYQNFVOKKPB  : PNHMPKAAJ       NHIK            EDKEIFYYP       RAQUD           UUOLLMXQBOVUB   IGNAVADQFK      FVTCDRAJXR     
PIEGPLUHTSTQLF  : HDNCPFJMKFQQ    VFSI            HKYGCVD         NXCFCXUTMBYKC  
NABMH           : UALGLBXQHKVHHLV SERLI           XNIYVC          VNWSWUSMVK      IDARLASYL      
GUFCLRMCVN      : PMIEHMYTVFS     HKDOJANDOGGSHYE SCUDRGGKCAAVP   CUHAXLLONCFMJD  BALJO          
EUAWGUEANAS     : VPBFJ           RJQRLNQCVLUYSR  LMCWMUVG        CNKEN           TDLSP           IJNURKIMBTBY   
GWPGAEPAKM      : HGWXCOSTV       YADYMUXVXO      HPNEDKG         GQJNLEQWNVWJO  
OXCDAATUGOUD    : YAQQX           XYVVOVIA       
SJYIKRMSQCBQJ   : TDQKEHDCB       HISTUERGY       YKMTA           CCBXVVQTWXIPSQG
SVFCNDGS        : MDBNQPOCFLF     JUIRLBKUUXCIP   TDHTCCF        
GMBNDXS         : JKEFHPRMICN     XFKLIYFVKBTJOO  UWRWMQGYC       CNKEN           NABDETQJNCX     JICFHVXAV       MEDTBMYJBHK    
SFYCRSOKJTNC    : TWRITS          GEHYSQVDC       ISSDTOSOJXLN   
GUDLAQQGKWNYA   : QDNLSTHSU       CQLNDPPFWRWQ    VOILTTPSHMJWTOG GEYXQHSHXULXES 
DBVFTBHXS       : UXUGEDC         OTWQSG          YTAF           
PFMLSOQBMVOMN   : SCQKAEAMJ       ASSYKEQYJLYN    CMGXJFFEG       QWMJIF         
SADGB           : FAVTHT         
JGHGMBHVCDVR    : DGDUMMXEIQWT   
KDEAVHMTWYJDR   : SUXWW           CYXFSENFJPGFH   LAEKNTVGGDNLGAW
IYNOITVQIABECE  : JAVYIHGRXLNKFOT VIUQM           PSAAIWGETSKQC   YXLHLYAWEPS    
VONBUNYDAS      : HJYMIHLF        FIVOQSASSSOOXMW QNFUPJMDAVYJL   VLRVFJETEHJH    HKDOJANDOGGSHYE BGNKFPPIIKTM    TPECXVOUMXMNKLM WVLPPI         
VONBUNYDAS      : IIHDX          
BDFTOPUCFFYDWHD : OCDAEBFT        XXPHWOQ         WNOHFJXP       
MHEPFUD         : KTKGPBQCA       SGDWNPW         UDPFAFWLQDTHHRO
QTHVVBXX        : RFTBWDYV        AQAMGOLUHYR     ARNOPNCQAHCYWA  CNLPOSBYXCRUVID AOJUYL          QRXG            ERWYTDOPUBGTBD 
FTUUQACVYGUI    : GLYCCPU         NABDETQJNCX     RKTQUALK       
UUVBMB          : YDOBHSPMX       HKNDFWRLFG      BHJSAW         
SKROR           : TNSD            FMVAKFR         IJWXVSCRXKULJNU UFHFEQHMC      
KUNKBS          : XGJMMHHYJWUPFA  GBHQMMCCWFSLP   YEIUWPPUAKBBNQR
WPWYSVABQIO     : DOGVAJPYLGA     VJLI            BSXMOKPFNIHQS  
GKRSOSNYKCSX    : EMDDBYYQPUADO   JCARLQAMNBNS    TNAJ           
ONAPG           : BRELUSYRMOAC    EMDDBYYQPUADO   YCRQDQU         FSLBKDTYSKHJE   HQIFQGBHYAA     EHXR           
OYGNRC          : BSAFKTEKQPVFSNK ULYDACDTGFNKXS  CNPGKWEUPEKN    OVGTULCKJHUW    UAVXMIQWHUMPP   FKRFGWMHPTIBW   WDUMNLFPHOVKU  
UVWJMDWGXLAO    : VLNYAETGN      
KQFLI           : VTJJ            TNBBX           EWUQAOF        
YJKGSYHYP       : AQAMGOLUHYR     WHXXUEG         QOQCQJUI        UCOPYFISKW      XMFRNFALDXIVI   ECNHWKD        
EDVACHMHESI     : MFMK            FFQVPFEGF      
SWEGPKRYEQKQ    : JKPU            IQQAYIHWVVB     YBKDYQHJCT      EGVRRCFBJMXWKLM GLVRLMBAAHCOSTU KLYHT           NFSCJ          
FSGGIHKLDMQ     : YYCXAFOHUMTUBAB TNHKDMYM       
BXRUIMPFQV      : MRCBKA          PVSCNYUMF       AJHSM           RKMHHVLEFWMM   
DPYKHJBIQTPW    : HKQEYJJERK      OLMLNHXLQWXF    XKYBKQXUDXKPAD  FMVAKFR        
WKQDYJQBJKV     : LBWPQFFSRMLTUHS DQGQSX          LROVQM          URFVCRV         MFDVKBYUBGP    
WNAQ            : JSYBTE          KSXREDK         SPHTNQGSYTJXIWA IUBEMYJLLCOKL  
XTEWEL          : CHJSPUU         CQLNDPPFWRWQ    GOVMSYAYHOYWT   ONPC           
IUBEMYJLLCOKL   : UEEUPQJGHYDIBOQ TMMOYOSLTCORYG  SVWUUJSN        WNAQ            LKSEHA          NYMIT          
LUUJPTAS        : RPUDOUY         EKGNQI          KGGRGOLYEBQR    SATVXNEFIDI     DEPSGWFNBKUCK  
OQHSQLHBVEDBQ   : LMCWMUVG       
KCPMTCXDQU      : QOQCQJUI        VNXG            LCKBOUJ         TFWWGWUOVL      TACEUJLUX      
CNUCGFSYOMPDTRY : TMFGYNE         JPWXXMWOF       RJFOHTSNO       JBJT           
WAQBKUSYOU      : WIUCTJW         JMLRWR          XMLVPWNAFA      YNSQMW          XTEYAEALLVPHFOF KNLVMHJN       
UNUUQKPUQXOR    : UEEUPQJGHYDIBOQ FAVTHT          FEROXCONPIO     MDYFEBGHSDFEIWN FNATEC         
DIRYCR          : UYCBUBOCH       NYMIT           MIBVHCOMCA     
BRPCFK          : WXQQMMOHBT      VVHPDVFSVTGGYB  ESDGCRC         PNQTQO         
ECREWGBTYLMV    : KTKGPBQCA       XKAUX           KYLUHINFSA      NBNQJEJ         LSRDNWKAPJNLG  
MMVBPG          : VJXOX           QKJGRSIMXUGSHP  PRYNHIYRJI      EBBM            IBOOGDMBLPT    
OKLNLFD         : NLINRHPYIDPJF   TOSYR           LTRUSWKP        BAMJV          
KQKRSDX         : NBDWLXNYSXGM    AGOJV           NJSEA           KGSBS          
LBLKO           : KSXREDK         SCUDRGGKCAAVP   BHESTQUYSO      TSKILAGAMLXH   
ISMVQOLAIDMTSBY : XCYMFFKQRSTF    CUFROPETJFHJ   
QMPCEIHECUFNHT  : FAVTHT          RDVQGCIAICNXU   IRVQGU         
PODLFRA         : LKIXU          
AFUTXVVWO       : XVWBRBJLQLDGHV  TXCHI           SULCGLYGCSOJ    PFUPG          
MSOWASYWAPETG   : VKEJFNKBIQWPUH  MKFCBRJP        ICYAKJPFYNSXD   EAQHMFNVK       OLKSOGEQLRT    
IJIPCKXEP       : QQXHT           VLRVFJETEHJH   
BQSWNHHDBX      : QKPADJNRB       PRTYLLMMUR      YHFODVYLJOPS    IFKNNGIOVCMHJYT XRRIDMVID      
DQAB            : AHBMOXC         SUFDNKCUOLDIF   LQMBTXRMTGS    
PFMXC           : CNPGKWEUPEKN    PKLBOGVRWEIPD  
HNMLXKQOHTHASUK : NRINGOTAP       SVKBDIXEY      
XLXBQQBRJSAVSE  : VJXOX           REITXPFALV      KJFGQCXHF      
ARFOQSHHABODTL  : RXMNFB          XXPHWOQ         OBGU            EVHAUIRM       
VKBTNRMO        : VEEPPNGHEVOFIO 
VJOTCS          : UMYPG           WAKLLGSS        YIUAJVP        
ELTSEOCLPDA     : NRINGOTAP       KFRWNVEJBVR     DTBHMHLO        WYGLSAOJ        SBGGMKGJFEFW    RGGU           
YLIUXLO         : DHCMBVRFF       AWMARUSNARBN    HUAFQIOPQX     
DDCRBNGURAL     : YPPVRWTEYHQMXG  LGNMJB          KNTSTPB         ERWYTDOPUBGTBD 
NGRRWUDOAF      : TFTYSXVINUOL    AVFODC          FYUNRIQCL       IDARLASYL      
ASTUTF          : LVCKVNTGRAXFJ   XTPKDC          WPLRTRPDEWNWWE 
FLPKDRXKOQMBPAJ : AATPY           HQCCCKOA        SIRMQFYQUNQF    IJNURKIMBTBY    SXVTTBKJWMRSP  
RGEUVFCHFU      : XAKJIEEOLIDTM   SUFDNKCUOLDIF   CAMQDLDMC       GNQKSKGTJANP    HEJTOQTOOKXPKGO BVIPBYRSWNF    
AOHOWSFHWYH     : YPUMDSFE        SNQROYCONPKX    YEAQKAFOIJNLWNE
PAVSPVC         : KFECRUCWVR      BRTWLCBED       KYBTXJLGIKD     UALGLBXQHKVHHLV FDYOCLODSKMK   
PLEKJJOQQJSTBD  : VBFQDGWF        HFPY            KMVCKYNDYPKXHQC JTHPM           DJXGAMPERRKDB   CLHPTCRYUANKTN  DGCPBRAS       
XXPHWOQ         : TUQLVDGDDYO     BDFTOPUCFFYDWHD ARFOQSHHABODTL  WINFLDQHKNYKXYV
HREAJAF         : USSLNQNUBUYCQMA SFUMRXQKBL      MKCRVPKSDRD     ICBRC          
PQQCACQS        : PBGJ            CEWABIM         ONPC           
DONERVCRMLPDCV  : LJBSHHJYTODLGV  FJPPLMG         FIIH            IETRHPYQ        VNXYWFRRVOQQ    MSGH           
VBNGD           : WAWUHH          UTDSYOUYYSIO    XJJORDEMEXWN    JQTQQCINT       NQKUG          
RVLIANLRGHUUWB  : OMWDSE          HJOGPYBDSK      CATXWIF         GWHIUJBHCDQGNF 
UFHJQWNUUAR     : CYVKHXULTFXUJL  IQQAYIHWVVB     WFTBMKXJNAXXNW  SPHTNQGSYTJXIWA TNHKDMYM        YJSPHAFLHA      IJWXVSCRXKULJNU
NXEIPA          : YYCXAFOHUMTUBAB RRVD            NGGNXPNUJIJRJ   PCWPUH         
BAHOTOV         : BESNVMABEXHKYV 
LSRDNWKAPJNLG   : OLMLNHXLQWXF    ECREWGBTYLMV    WYRJGGUT       
FFGDJOUL        : HRQBJICDLSBU    UQUWMLPR        MVWPXXNFSU      BTIW           
XLSMGJK         : OXDCMCUNPYF     UHJCJBCNJEJDQM  RFSA            KBGVHGFASNIUCY 
VFRYVOLVHWL     : NBDWLXNYSXGM    MVSFCVD         ASSYKEQYJLYN    SSLRAPNRCGL     FONQNWR         JASIUAUWROXJK  
DBAKJFTBCF      : VIUQM           XMFRNFALDXIVI   FNATEC         
BTFPCPBYNISO    : WVLPPI         
KCCRYNMER       : BTPA            VNXYWFRRVOQQ    RMWSVMX        
PBRLEV          : SGQFAGQU        HFWFROTRUGY     GEYXQHSHXULXES 
QWNYPPOQ        : NJSEA           SSJR            BLQAPRWQIYAIOH 
EBKUI           : NQBD            DSYE           
WKOXBBCSPTVJGBF : JBPLSVYX        CEMYQHWLSE      UDKXGUVQ       
TFPS            : ONCDGETNYCU     SGQFAGQU        SNRCBRLLNUJOJR  BHJSAW          NFSCJ          
HJNX            : EALBOP          HEJTOQTOOKXPKGO AMHUSDJ        
OKKWHH          : HYGRG           HDNCPFJMKFQQ    WDNJ            GIAWSMNMJL      EJBVJMFHL       BALJO           PNQTQO         
VHLY            : WAWVRFRNJFW     XGMLHYVCOPYTOIA USPSSYP         LIQCWAOM       
EQECAMFIMA      : ADBXKSLCIUP     MXQFCOTYDKULUF  XFKLB           HQCCCKOA       
ESIL            : WJKJHJHSLM      PLRX            CCMMJYAYH       CTKCKEFU       
XMQMWEMHLWDVK   : HTKJWALBYVKC    KTXJQ           JRCALSULUJ     
GOVMSYAYHOYWT   : LRGF            CMOEWQWCPNMHRP  XTEWEL          UJGV           
HFWFROTRUGY     : KTWKHABWCA      NWNJMQ          WRCXNGPAPQVL    PBRLEV          RKTQUALK       
FEEPJKG         : WAWUHH          JUCOMIMDL       FXSMJUHJMTXAO   ECNHWKD        
ACHC            : BOXSVQDOI       HQFJXBXYOHOVY   KQQG            WDUMNLFPHOVKU  
OSCNMVUUTAOKTIF : KTKGPBQCA       TFGDUMHVK       LAQAETIVMLHIDH  VLIQCRT         PXRJWMPLQJGHFB  NBKDCCQ        
JNKOSB          : LBWPQFFSRMLTUHS DUCPBUNPXLLHT   CJHUGKIPSSL     GCHWCBMT       
FJKFLRJOIDQ     : DYUIDUXEG       INBD            TXDHJLIEVPA    
RNQOHQGTNOYQ    : TEXCONTBXVQK    NUKFELRPJJOWMT  QYKV            CTJOFOTDJ       QNVJWSNLFOEDN  
MBPFERLQ        : NYNUDNAXRKWYJ   QQEG            NXCFCXUTMBYKC  
SCUDRGGKCAAVP   : KDRGNWGGW       BPENYFRWJR      GUFCLRMCVN      LBLKO          
OXDCMCUNPYF     : TYKOF           WMIDAYDMEUQR    CAWKOVLTLQQCBI  FJVLOYLYN       NOUQCHEDPFA     XLSMGJK         FEROXCONPIO    
FXIV            : QQWLSWHLCSCW    QJWQPOKWSUTO    CRESPGIF        DRYBKMJYNLL     VSDOLHBFYEJJPFA BLGQO          
CYXFSENFJPGFH   : UTFMQYD         QOQCQJUI        KDEAVHMTWYJDR  
TFTYSXVINUOL    : NGRRWUDOAF      SIQVCYNNEKV     IFFIXQPWH       LJFDM           UPXHCSOFRAVSYPL
MVWPXXNFSU      : CLMLEOKSKT      LADNLHV         FFGDJOUL        GIUXFM          IXHSMTPQQGI     VHMLDECODQME   
YELHLSYHYSGTT   : SGDWNPW         KDNVEQVGVSODG   HJYMIHLF        VFMTFMQ         LJFOUIRWBQI     SYGXLIA        
CHAQUDFTDUT     : OYTXH           JWPRXURW        QMAMLWOXKFE     SNQROYCONPKX    GJQCVUQDM       UJTAUCAYK       TIIGMIWNSPI    
JAYEWXKKHVG     : MRGDRHRE        IGBONLESSB      MNHSAXV         FGYUFAOBFBXDUE  JFOOCR          NIBP            WIDQGTWLG       WLTFJW         
DHCMBVRFF       : NHIK            GRYLMBDGNV      BHEHETOFVUHO    WDNJ            ODFMF           YLIUXLO         ULJWQ          
YDAGWFCQIN      : NHIK            MPSPOB          PKIAONUUPQFFP   KFQATLGPTLQJQEC SBQHMFYCYLEGYS  UDKXGUVQ        JGLVLUFWP       AOJD           
HTSH            : ADARJBIKWECJ    IEIRGPXPVG      EHHUCSDOKO      HDLWSJGNFXR     HEBGKY         
DOCLX           : JCARLQAMNBNS    HPJGMDDBVEO     DYEKQNXWDNNS    RKQXAURW       
SATVXNEFIDI     : CAWKOVLTLQQCBI  BUYGOTGLSUXAHKA LUUJPTAS        QPDAIEDQHODFW  
JHPNB           : JPREUPD         HOCMGOGNWBFMD  
BTIW            : UJJUDHCXRRQNX   BPENYFRWJR      FFGDJOUL        FEROXCONPIO     RURGKEYB        AKPQIOWGVXE     FHWA           
PBSHFEHNXJHVHXA : VFRYIJGJOQRMTV  QJBTYCOYFUD     HIXVHNXWRQQ     WPTBXUUJYFRJ    UJGV            OOWETGPOLPFK   
IDXSPH          : RLHMVLDAQMLORN  DPBRAMG        
FIIH            : QDKBYC          DONERVCRMLPDCV  BJFQXRMR        BWEOKS          KBFRRUBUCFUITH  XGWY           
SERLI           : QAFRO           NABMH           HJCSAPJMKSLTQ  
SNRCBRLLNUJOJR  : FIJQAXPU        TFPS            VVCCLOYQOWHXCDN
JMLRWR          : PDRYSIXUGUMKU   WAQBKUSYOU      EQIPHLP        
HBFBHAMRMHIGJJA : YENHYVOHHXHDHPT BWEDKSAPB      
WORIFBCBLO      : GBHQMMCCWFSLP   ICYAKJPFYNSXD   YUQAHTBULKGTVJ 
FNJHVKNWTPJM    : RONCN           NIEBFSVRUGJAMJ  YAEI            GBRGRR         
SULCGLYGCSOJ    : AFUTXVVWO       WESJ           
TNHKDMYM        : REITXPFALV      RCRC            FSGGIHKLDMQ     UFHJQWNUUAR     UYCBUBOCH      
UYKTSC          : AUFLOMAHYS      WYGLSAOJ        QRXG            WLTFJW         
FGXA            : JKPU            OOPCGKFOKUCASK 
CJGDPKVEUPXKAL  : KNRUUAI         TAFJQY          QBPUJNCQVFLJP  
MKCJ            : BRELUSYRMOAC    YGXHFTP         SQVBFNPUG       UAIOLESXNKQ    
BTBTVGCDE       : NLINRHPYIDPJF   CMGXJFFEG       UWWLEUPXC       BGNKFPPIIKTM   
WINFLDQHKNYKXYV : OYTXH           KITQVQKQGKY     VFRYIJGJOQRMTV  XXPHWOQ         UUVLLEPM       
OIPXPSUQOQWQV   : TNAJ            QUSQHTXBTKFHJI  HSBKWJSHSTCBMLN
VVNLDYRTIEJIQ   : WXTYEIREPJS     HUWLJ           SQAFPX          PCRTDREAK      
JPWXXMWOF       : HXJYLM          QQXHT           CNUCGFSYOMPDTRY VJVGPPARQXYXQFT
HUKHNJKLHBX     : RRQRRNVHIQOK    OJXOXYLTNXOSQR  ETDUSQ         
ARHLVQTMBF      : RIVEFXQQKJYQGW  GBGVTG         
XEDNDR          : JKPU            MMIKVHCKUNWQ    GECABXCC        DSYE            QOSEIL          ITVYBXCQMPC    
WYRJGGUT        : LSRDNWKAPJNLG   IUBACSOVSXE     VVCCLOYQOWHXCDN
EURPWJYIHR      : UDLU            XNIYVC          SQAFPX         
WSKBTQEHVV      : CYVKHXULTFXUJL  RGQRQEKUXHWKAY  TFKF           
UXUGEDC         : LBWPQFFSRMLTUHS YAQQX           DPLMERJWUUDYON  DBVFTBHXS       RPIPG          
WGWP            : RIVEFXQQKJYQGW  NCLAYLAHW       UKAPTNN         LKGWMSQJ        WSKLV          
UBWDJPKIKUJEN   : FPVYWIRN        LGJJIVPDWNFJCY 
NLKSGKPMRUQRRXP : MMIKVHCKUNWQ    GRWMILOLAK     
XMLVPWNAFA      : TMMOYOSLTCORYG  WAQBKUSYOU      QPUTBKOMPQQ     QYKV           
OHMDWXQPGBHTUC  : BGFALNUVOWE     GEHYSQVDC       BJRYFTOQRUKGTPR
NUKFELRPJJOWMT  : RNQOHQGTNOYQ   
JLGYQEWHVGLE    : XEDELKJOBLAYE   FJVLOYLYN       KQQG            QLIGSSLKMWAYC  
IIMVDADKLUCUFR  : YQAERIHXWPIR    SEQUJ           HYMKOWAU       
TNSD            : TWRITS          SKROR           JUXUHYOJMDRYOF  XLHCGBELIKN    
AEQGCACINGKW    : RXTTVEUBI       NEJEOGOGOYWAKU  PRYNHIYRJI      IWSKK          
YUWBYHMVMJDEDWT : NYCAFU          NUPLCBPPAXTIGOX IEIRLDGQJABRQDA FONQNWR        
DTBHMHLO        : YXROORKOUQUO    GCIXPVBAWRWI    ELTSEOCLPDA     UXMBAEFJAFQFXB 
VFSI            : NBDWLXNYSXGM    QDNLSTHSU       EJNAGFVYFI      PIEGPLUHTSTQLF  UEXUOGDVPFQAYMR YKMTA          
KIYH            : KFDNCB          FQUNXWR         PQAM            KTKSSMJSDLDGJQM
ARYYEKCK        : YLMULRXQSUXQC   UFFWLWE         GMGTHSRS        IUUDIDLEHSQXAOU
CEPFAQ          : HQCCCKOA        JPFLLNDR        QCFIUVPA        WYDT            LADEOTH         TCXQMTMJTLSFCN 
OXBEJWJCINOQ    : BSAFKTEKQPVFSNK UWRWMQGYC       FNHVMSPQHD     
YCRQDQU         : SAQTLQXJTCSVQBK ONAPG           MGNW            FEOIWVOEGTVXLPP EQREQJGW        QPRDJEOGQKNSXY 
UFFWLWE         : BVGGY           CIPPPOYVESWQR   ARYYEKCK        HSMHHMAK        WOOKAHIGHHARJQT
NTBNUHWTS       : PXMFPWXVAOQMO   MLYHAJ          VLRVFJETEHJH    CWTJKPMRWIAVI   DFAQWO         
CISUARARIF      : WCJPAAAAFPIBM   TNBBX          
FVFMBFY         : OCDAEBFT        NYMIT          
JNNDQDABDUTFYF  : BPBW            LVLUMAHPCEWWSO  HGFCEVLJYWCVCMS VNXYWFRRVOQQ   
UFSWWDCHJYOXCTW : RLHMVLDAQMLORN  XKYBKQXUDXKPAD  DSYE            NVBRJYRTOCFUYJA
EMSJGWKHCFDHG   : YPPVRWTEYHQMXG  RBXWHRTPYMPD    SGQFAGQU        DWPYLB         
HBNCAMGDVPCL    : JFOOCR          UAVXMIQWHUMPP   IEOPAEG        
GHNLNCF         : OYTXH           QIMTPCW         LVLUMAHPCEWWSO 
IEIRGPXPVG      : CSYPV           KCUQSAYXMUF     RVULCKVREVKYYXI UVWLTYHWITUKEP  LURXIWNBEMSBFFV HTSH           
AWCAJIDGAHTPQB  : JBCVQ           FEOQTTGWGIB    
CPIJN           : WFSLDANFLAS     XGMLI           GDNTOVHCT       MCBNGUDQ        SVKBDIXEY      
PXNXPLNL        : NBNQJEJ         URFVCRV        
PNQRODCTLEEFT   : ACJIJKTIFJ      HXPRARLN        ELQSMDHQMW      UWRWMQGYC       EJCUHABBMNNFEJB LLRMJPAUQV     
ICYAKJPFYNSXD   : MSOWASYWAPETG   WORIFBCBLO      HJCSAPJMKSLTQ   FNATEC          UEJKJOKXNJCDMFB
NRBFFTWVWBQIHW  : SEBCGXINPSHRDNJ RDYHALSI        USPSSYP        
ERBGSBQC        : YDOBHSPMX       JIGCOWLFNE      NTGBUPJ         KNBYJJCE       
XEFRELATFBA     : WQANKQI         FKIMH           NFPCMACJLRJ     SUHWOEXEYAGHAMN WLLQ           
VYLUBEEKBVOUWU  : NLINRHPYIDPJF   VUNUCCJUYWJFQO 
YNSQMW          : GBXFIAXIVHPLSJ  JIHWQVIJT       LPGXDROGY       WAQBKUSYOU      USPSSYP         MDXBN           ULKMVPBLOS     
GDLGWSKWGGWTBA  : FGYUFAOBFBXDUE  SFUMRXQKBL     
HKYGCVD         : PIEGPLUHTSTQLF  PIDLCRDCJSV     NEOKEIFRNHNJQA  LGJJIVPDWNFJCY  AKVG           
JENCWC          : BJMSFVYFG       FIJQAXPU        SAQTLQXJTCSVQBK OPBDYEQH        EPIGFLFKEHQLDFT
XIEJQCFBBNJXHLA : JUTNWA          PTRPYRDQ        BFKJQNYWMNYROL  XIWHPLWXQSMF    PVSCNYUMF       JNJFUVOVPHYE   
UNGBPCHOLNCQNET : FEFLJPNB        JOTPUUQRIJ      QMAMLWOXKFE     QUSQHTXBTKFHJI 
OYWGD           : BCKUJGKXKGHVKAO LNHL            RHVVLLCRURO     GYIVEBJKDW      BOFVVOF        
HEPRFWFHEAUKEK  : RBUE            LWOAXK          XTHJMRRTDPMSN   GIRQNBHEO       SWRKCPJ         JASIUAUWROXJK  
NABDETQJNCX     : PNHMPKAAJ       YXROORKOUQUO    GMBNDXS         FTUUQACVYGUI   
CGREO           : LOCEMBTFOCGFKVF EALBOP          JORPNHYKXUDV    FCOUFFPTS       YPUMDSFE        KLYHT           CLHPTCRYUANKTN 
WIGTPNBR        : CNSWLGTWQUQXK   KWSRDRDBGVTI    ABRJ           
LVVBL           : URLAJYCUBEJBLIO UVWLTYHWITUKEP 
CPDXG           : QNDBD           IRKQHAVRW       NQTHFISN        LTQVG          
LLMBNV          : GGBIBTK         TEKL            RRNCACODCGMNXQS IMHMQNXOMFWSRHL
RKTQUALK        : DUCPBUNPXLLHT   SEBCGXINPSHRDNJ FTUUQACVYGUI    HFWFROTRUGY     BNGIPCDYXFQHCHX EXGIJOYITWXGGBW BVIPBYRSWNF     SVKBDIXEY      
OCAABVBMW       : HQSJCOBFNLIBG   DSYE           
EAFLORY         : KLMQEMHHQHL     GECABXCC        LPADV           VTWGLTMXH      
UMYPG           : YKVGWLO         KDRGNWGGW       VNXG            VJOTCS          BOPIPROKHGYAVOH
MXGO            : SYAUJI          WTUSGWGHOPNU    KPBFNW          USGPSBC         BRSCQXVJPK      XYVVOVIA       
SDAVFCYEELBL    : JPJKMIQDFWOAT  
BRGRLFWGRWX     : LYPTVPOU        VYSHPJ         
KKXTALMFLKNOJRU : SCQKAEAMJ      
SIQVCYNNEKV     : TFTYSXVINUOL    LUGEDEEN        IMHMQNXOMFWSRHL
JUXUHYOJMDRYOF  : NNUWRCFGNSQ     TNSD            VJLI            OCLAYUOSJYMJVQR CRESPGIF       
AWMARUSNARBN    : WETFTEVMTJ      GCBDLWDULICD    YLIUXLO         AVFODC         
NKVXHWSQXJBKMUL : PIGXT           QHMSVH          CFVGQRKDCQRRODG HGWXCOSTV       GNQKSKGTJANP    LXFWJUDP        HVQKJM         
ADGYPI          : YJJBVBP         XYKPAMRDKEWRW   YLMULRXQSUXQC   SSJR            YKMTA          
NCENVF          : HYMKOWAU        SPFXCGUNR       KJFGQCXHF       OLHJAMVQDQY    
USPSSYP         : VHLY            NRBFFTWVWBQIHW  YNSQMW          UVSB           
QPUTBKOMPQQ     : MUWNEGRXRGWEUFO JKPU            HHLU            GEUSYUJNAJOHJMW XMLVPWNAFA      ASTWYXU        
PIFGVJMLHRPCMHX : KFECRUCWVR      WBQDDMR        
HNTXGRT         : UTWUK           MCMRN           RJUQS          
CKVTBMQQXX      : IJMVS           LROVQM          WESJ           
VJLI            : DYUIDUXEG       RPBVM           WQGT            WPWYSVABQIO     JUXUHYOJMDRYOF  WMMIUDOVN       MEMCTVYYJN      OCQU           
FAVTHT          : UTFMQYD         SADGB           UNUUQKPUQXOR    QMPCEIHECUFNHT  CEMYQHWLSE      MYNSQSNJ       
QJWQPOKWSUTO    : AJLG            GPUKUEHKX       FXIV            IJMVS          
IFOGFPD         : QBDYEYMQW       PWCTERDTKPHTTXF TMMOYOSLTCORYG  FLACU           QCDILVDB        OTEEESBOEUDY    DOCK            QAMAF          
BNGIPCDYXFQHCHX : NLMTRVWLASCD    MLYHAJ          NAUPWJMVPBD     RKTQUALK        QDITUB         
UWNP            : CHDLFLSJMW      MURVAGQI       
DOCK            : VNXG            IFOGFPD         KGSBS           GXFXIGAYNKTURSI UEGIGXHQK      
KSVPHYFPIU      : XKYBKQXUDXKPAD  NQTHFISN        VVCWTPBCBVEXFB  KRFV            ETDUSQ         
LURQLC          : GTURTUEYGBOGPL  XJJORDEMEXWN    YTLSNBOVOX      OSWQGBGWPK     
UCOPYFISKW      : BIVFJKCLKO      KGGRGOLYEBQR    YJKGSYHYP       QLTCEPU        
WCJPAAAAFPIBM   : CNSWLGTWQUQXK   MCWA            BUNK            CISUARARIF      PRYNHIYRJI      RVWB            PKMOWK          IMPFRLTFYYWHPTT
XGMLI           : PTRPYRDQ        GLYCCPU         MRXUR           CPIJN           BALJO           JUPEFG          TWAYHJPTDIO    
GKCYMHHHT       : BQVHGXIRCLNISP  PKLBOGVRWEIPD   EJMO           
EQIPHLP         : CYVKHXULTFXUJL  SESQGVHTOJVI    NWNJMQ          JMLRWR          CDFDN          
LXYVBLRYSGMDR   : MPKHBMFQVU     
OTTDDBK         : EKVJELVXIPK    
HQNSGWEWERW     : NEBRQHIWWONXO   CQDIWDIJ       
PXRJWMPLQJGHFB  : UOYXVVFLCNXFEI  CEWABIM         OSCNMVUUTAOKTIF LYSSRRFNUUV     PLRX           
ICUHMLVF        : AODWCQ         
ULQADNG         : XVWBRBJLQLDGHV  OWAXRBOIKVM     INFBPNOKHLMRPQ  UAIOLESXNKQ    
LAEKNTVGGDNLGAW : NHQVRLUGHAVB    EDKEIFYYP       KDEAVHMTWYJDR  
WEWKCCEXPVAULI  : BEPJPSJ         YLKBKA         
AITMXQJE        : UQUWMLPR        CHDLFLSJMW      XBNBYMJ        
OTKWVHF         : KCQAEWPQDG     
OFDQJIQAGQURYL  : NEBRQHIWWONXO   IFFIXQPWH       SWRKCPJ         HHTMSXYA        IDARLASYL      
IFFIXQPWH       : TFTYSXVINUOL    OFDQJIQAGQURYL  ARNOPNCQAHCYWA  LIQCWAOM       
IEIRLDGQJABRQDA : WDNJ            UHNLEXPE        YUWBYHMVMJDEDWT IETRHPYQ        BUSMYD         
XTHJMRRTDPMSN   : DOJWX           PMIEHMYTVFS     QJKC            HEPRFWFHEAUKEK 
GXCOPNUYH       : WFWJ            TCJHPSDPVQAHGQ 
YKXPNAXNTIAICRE : WNEEJRPIRR      MDXBN          
JQAY            : WYGLSAOJ        WNEEJRPIRR      MGUVBGMVEOHJE  
HWQXPHUOQYNDYDS : MFSWEOHBHY      WKGVKDNJRMF     GWHIUJBHCDQGNF 
EGTOGEQAJYMA    : EXUOSMPBETSQ    JONSQY          GBHQMMCCWFSLP   JPHPYMDCIPS     UEGIGXHQK       ECNHWKD        
LRILIJB         : HSPMETJ         SPFXCGUNR       QQEG            HJCSAPJMKSLTQ   AKYHJID        
EPIGFLFKEHQLDFT : YKVGWLO         JENCWC         
YUQAHTBULKGTVJ  : VLRVFJETEHJH    WORIFBCBLO      RRNCACODCGMNXQS BUSMYD         
ABUGGJO         : NXLMIRVYHBCKJN  VIUQM           NJDQOJXBSNQV    QQLRC           FJVLOYLYN       QYRYQI          NVBRJYRTOCFUYJA SBPR           
ABUGGJO         : QLUS           
NVKBYSVG        : IFFTTIHSWBLA    JPJKMIQDFWOAT   USROGBSBHCYAP   RMWSVMX        
SARATUWFFEB     : KDOJVIYOYL      MFDVKBYUBGP     DWPYLB         
PPERNKAWYTK     : NQEWAWAQL       YBKDYQHJCT      EBLGTVXRCHPAYXD JEHBQOAYSUGKMWR VSGTYIWSRHFHBM 
FMVAKFR         : IEQJKFSIQL      FRGX            MMIKVHCKUNWQ    NYCAFU          SOMWOVXGQKJMR   SKROR           DPYKHJBIQTPW    SALVGYRUUTPHW  
FMVAKFR         : MEMCTVYYJN     
FLDYGCGOIHRYAVQ : UALGLBXQHKVHHLV TUQLVDGDDYO    
JQKILWGS        : JKEFHPRMICN     ROOHDJ          PQQHNWAW        FWXQMKLNCYT    
ESVJ            : LNQOYH          HJAWPTDEE       FMPI            JHVDTGWW        OFPGWIN        
YQAERIHXWPIR    : IIMVDADKLUCUFR  PPTAKNDAKBUJJG 
INHVWYIIMFQHRU  : HPJGMDDBVEO     DNDAL           SWRKCPJ         ONCMTWUOYSHLCQ  XRCEXUW        
NHQNXQRSY       : FMSUHYJKIQRES   LNEGVOEQ        MDXBN           VOOQMPYBLDPVNU  BWEDKSAPB       GCNFIRIKHAWOB  
QYRYQI          : ADJUNVVHVAJM    ABUGGJO        
GQHGRPQ         : XKAUX           NOLMHFCPT       YOLDYYHXXOWGJT  ISXY            PFUPG           GCSY           
VHPPERDNK       : SYOL            LKFSW           CRFIULWKKOD     VUNUCCJUYWJFQO 
OBNHCOXBIATRLD  : KGLNUJM         LWOAXK          JXTCH           FKRFGWMHPTIBW  
TJEJA           : OGOFP           CTAWAOELTCXP    QLUS           
HJAWPTDEE       : HOCMGOGNWBFMD   GSRPHNIDIBWSKGD ESVJ            NYMIT          
UHJCJBCNJEJDQM  : TURIVTHIFQJJ    KCUQSAYXMUF     XLSMGJK         NFVLCDMBEGXJVN  HVQKJM         
MVRXXEGHGF      : NJSEA           LKGWMSQJ        XRCEXUW         SRJUW          
CIEIHYPSDCTHRE  : OUMAVLQTKDUC    MXQFCOTYDKULUF  HDFMIBHSKSUSVJ 
BJFQXRMR        : ELSYOI          WHXXUEG         FIIH            ACNILP         
NWXU            : GDNTOVHCT       SSLRAPNRCGL     MUOGBTIOKRJAX  
EUIOBQV         : FIJQAXPU        GCHWCBMT        CLGIJPUCGM      THCCBDKXYFGEMJS
JPFLLNDR        : YHQEIEVGBIIME   MPEIWTOS        UNACTTL         NQJXOUS         CEPFAQ          VJVGPPARQXYXQFT FDYOCLODSKMK   
GCHWCBMT        : OWAXRBOIKVM     XQALKOAPPTB     JNKOSB          EUIOBQV         QHAYHLHXK      
ASTWYXU         : QPUTBKOMPQQ     QXYMAXHRBLUXP  
OXAL            : CMGXJFFEG       UIDLCFRUTVVVTX  HPNEDKG         WDUMNLFPHOVKU  
JDIWOXCHAJLJINM : YXROORKOUQUO    FXMNKDCQVURTR   MOBDJMQOSLTVWOG VTJJ            QLTCEPU        
HIWDCU          : HRQGKHSOFS      KBGVHGFASNIUCY 
ARNOPNCQAHCYWA  : QTHVVBXX        IFFIXQPWH       RIHF            JGLVLUFWP       OLKSOGEQLRT    
GDNTOVHCT       : NYNUDNAXRKWYJ   CPIJN           NWXU            LIQCWAOM        CTJOFOTDJ       RDSTGMTDDCL    
KQTMNXOFLFX     : HNSGADPRHQDBPU  TJCYGF          UTOJXAQDXLEVWWG
KOCRSDQTFY      : IXSYQQINAWPD    CMOEWQWCPNMHRP  LBWSS           ULJWQ          
SSLRAPNRCGL     : ULYDACDTGFNKXS  PRTQHLOCE       CLMLEOKSKT      IWFNWBEARMV     QLYLC           VFRYVOLVHWL     NWXU            WQXVHHOH       
UMFCXNAAXREPKIJ : DOJWX           YBQLTAMD        CRESPGIF       
PIDLCRDCJSV     : KIWNSCD         MRXUR           XUMIJUDTKSCXX   HKYGCVD         QHAYHLHXK      
YIDTWLYUYYXYQC  : QDKBYC          CAWKOVLTLQQCBI  DINWXNBF       
EMAKFJOQLIVPR   : PIGXT           GBGVTG          JASIUAUWROXJK  
MGNW            : WFSLDANFLAS     YCRQDQU        
KTXJQ           : XMQMWEMHLWDVK   XNOEHXY         UEQOYBLTQ       RIUI           
IOXCT           : TFSRU           MRXUR           JQRHTFTXUSBTL   GQYE            BLGQO          
GIRQNBHEO       : NDRWIV          JYMMKQJBJLCJ    HEPRFWFHEAUKEK  YFFYTRNHVU      CYEHIGPMVQHRYLW
AGKOSQFRFPND    : YWKCFDDBX       VLNYAETGN       TESGFYM         UXPICRJA        JSGWVCFWTI      VSWCWVCPF       DWPYLB         
FCJTC           : MRGDRHRE        TUQLVDGDDYO     NYAIFUESONEYW  
PRTYLLMMUR      : OGOFP           BQSWNHHDBX      QKGTSPJLJQQTMGN BALJO           DJYPWETYSYPHGT 
LTJXLFQQYW      : FEAMXJI         AYFRHVHIAIMS    ILYKVFQIVHME    MCBNGUDQ       
NAHSFQOHD       : YKNHIY          PACB            YUNGPB          PYTCCKCBACBJVDU
BWEOKS          : ONUQOGPIPEF     FIIH           
GMGTHSRS        : EXRNFYSFUICJG   WRCXNGPAPQVL    ARYYEKCK        HYMKOWAU       
KLYHT           : HGOK            SWEGPKRYEQKQ    CGREO           BVIPBYRSWNF     IIIXCRRW        WJXRIYUUKLOX   
KBFRRUBUCFUITH  : VGRGHILJ        FIIH            HRQGKHSOFS      UKQSVALFPPTUFF 
XNOEHXY         : KCUQSAYXMUF     HKNDFWRLFG      MIMQODRPYXUGQ   IJBFASKJBQA     NAUPWJMVPBD     KTXJQ          
SYOEY           : PXMFPWXVAOQMO   MOBDJMQOSLTVWOG POOBFF          HVQKJM         
XNIYVC          : PIBPIXKPFET     NBBPQVJFEOG     NABMH           EURPWJYIHR     
SEQUJ           : YBKDYQHJCT      EQVHKVWK        WWYTMPAEBQIDME  IIMVDADKLUCUFR  BCWJGVLL        OOPCGKFOKUCASK 
DDUEDJUISSJW    : BUIIQQBXPOQ     NAUPWJMVPBD     IYPFWQJREDIYP   FFYMRYAIWU     
LLRMJPAUQV      : GTSTBNQPYND     WEFR            PNQRODCTLEEFT   WYGLSAOJ       
MOBDJMQOSLTVWOG : WJKJHJHSLM      JDIWOXCHAJLJINM SYOEY           JNGPTOKXN      
KQPVCDOQMGQHA   : FOPWESAOGSRJO   PACB            FIVOQSASSSOOXMW FNBTLOR         UJTAUCAYK      
HOEIRQXKFQ      : XEDELKJOBLAYE   YHQEIEVGBIIME   KKAPNXKODY      JQTQQCINT      
BOXSVQDOI       : QRRWGPIQQM      BDRINRHHHUV     ACHC            HGLCJCMDPWEA    TOWYTWQVKFCEQQ 
SLRJXBAIDPPRWAL : BRELUSYRMOAC    KAFICVEKQBVSL   TWRITS         
AXWQVYGTTEMYSU  : ODFMF           FHGKS           OCQU           
LGUWHVWPBPHSOJ  : STKBIKHDUIUQXI  HNSGADPRHQDBPU  FVMQAN         
EKEDDAEJWXPJYIH : HISTUERGY       IGNAVADQFK      HUAFQIOPQX     
VNWSWUSMVK      : KTWKHABWCA      HQSJCOBFNLIBG   NABMH           RMWSVMX        
OBGU            : DVSTHNRUA       ARFOQSHHABODTL  SSJR            FVTCDRAJXR     
QYKV            : OXHCQLC         RNQOHQGTNOYQ    XMLVPWNAFA      EKVJELVXIPK    
PGXPXKPJRRHH    : FIJQAXPU        IRQITEM         FYUNRIQCL      
DFJVTFIQ        : LXWSTSFSVLT     NCFO            NCDMKF          ICBRC          
LYSSRRFNUUV     : XKIESKADMFJB    BYOVBHSSPEQUQ   PXRJWMPLQJGHFB  MHEUQUG        
NUIDGAWNJNQ     : IUUDIDLEHSQXAOU QWPIYA         
YOJGWCC         : COMYKSWLX       BFKJQNYWMNYROL  TDLSP           KKBGI          
DUDWOJKLGJHTG   : BUIIQQBXPOQ     KDRGNWGGW       QQXHT           EWCQFKXKVSSW   
YMRXA           : WPLRNEUX        JONSQY          DFSXKQPMBTGLY   TSEONUPLV      
LRSKGESGGUQL    : BJMSFVYFG       VRNPEJHQPBD     JPREUPD         ULSNLLDIOOODB   GTSRBQJPMFJY   
UIIEVWMFGH      : NARQBGXGQ       EBFYMBBKDE      UEJKJOKXNJCDMFB
WIXQH           : LXLPWDXSKDSBV   TGKGFCTFOYAYJ   LVLUMAHPCEWWSO  FLACU           DVSTHNRUA       BUNK            HKDOJANDOGGSHYE
USROGBSBHCYAP   : EKGNQI          NVKBYSVG        JEVYLUFF       
UYCBUBOCH       : QRQOYBBV        BPBW            DIRYCR          TNHKDMYM       
NGGNXPNUJIJRJ   : KSISNANPR       UXPN            LNMQQQE         CNPGKWEUPEKN    OGOFP           JOLPGFVKLQLCVIG NXEIPA          DWPYLB         
SSJR            : QWNYPPOQ        ADGYPI          OBGU           
BLQAPRWQIYAIOH  : HGOK            SUXWW           CBXUA           QWNYPPOQ        FWDRX          
EHHUCSDOKO      : WFSLDANFLAS     HTSH            EGOUCWEJXISLECT
GJFAC           : LMCWMUVG        KFRWNVEJBVR     KCXCVNEBDOTR    QRVVCKAO        GFCVCFIEGV     
NUJFPIXXKYJYGB  : NEBRQHIWWONXO   NIBP            QAMAF           URFVCRV        
NIBP            : BPWMKGRKWQJGW   JAYEWXKKHVG     NUJFPIXXKYJYGB  GJBVYJ         
EGOUCWEJXISLECT : EHHUCSDOKO      DJXGAMPERRKDB   APCPGQNRNRHTTM  RKQXAURW       
MRTWQFYW        : VRNPEJHQPBD     BRELUSYRMOAC    TMMOYOSLTCORYG  FNATEC         
FMPI            : YTQSYHFEQKGSNF  LXFWJUDP        ESVJ            GIUXFM         
TMLIJOGNXGVQTC  : DTPGESWIGFIMHV  WSXUNFTCUWSO    HJOGPYBDSK      EWUQAOF         QLTCEPU        
NXKGSH          : FYKNALFU        NAWOUBBBEA      QQEG            LGJJIVPDWNFJCY 
XIWHPLWXQSMF    : GESQBYUNANR     XIEJQCFBBNJXHLA MEMCTVYYJN     
VTJJ            : GPHMEO          BXNHKVXGGQIMXJV KQFLI           JDIWOXCHAJLJINM NFVLCDMBEGXJVN 
PINKKI          : DOJWX           JPREUPD         BPFRYQDGWHTPOT  SSXVGS         
LUGEDEEN        : INXYC           SIQVCYNNEKV     ONCMTWUOYSHLCQ 
NEOKEIFRNHNJQA  : HKYGCVD         JNJFUVOVPHYE    IMHMQNXOMFWSRHL
HISTUERGY       : SUFDNKCUOLDIF   SJYIKRMSQCBQJ   EKEDDAEJWXPJYIH AYVUITGPSOFLOO  UXMBAEFJAFQFXB  MKCRVPKSDRD    
MEFTSKHYB       : HVWHBB          XKAUX           WWFOVPQTKRF     HCFJ            FYWNS           ILYKVFQIVHME   
DJAWYJLKBLQKVJG : ONUQOGPIPEF     YLTOFIFQBMUF    VSGTYIWSRHFHBM 
NXCNYORGKMQUN   : XSOJGHUK        ELFE            LJBSHHJYTODLGV  GWJAVQYBGL     
PRERQECCQFP     : QBKFFTJCXDNHE   UCIDBVXTMAIOL   HYMKOWAU        CATXWIF        
RNRXHHXJUXAPE   : KLMQEMHHQHL     WMPPISNEQADVR  
EXISQXMWRDD     : UWWLEUPXC       JYLB            CDJSPJDUE      
IUBACSOVSXE     : LUGYS           WYRJGGUT        RPDKDLQVE      
JBPLSVYX        : WKOXBBCSPTVJGBF AAMMDLAFSYQQSA 
HSMHHMAK        : PQAM            UFFWLWE         RVSNL          
VUKXVNSKLMKPET  : YJDCY           YGWVJFKBEOU     VVCCLOYQOWHXCDN FTCFSIXHIQSE    NCFO           
VFMTFMQ         : ULYDACDTGFNKXS  YELHLSYHYSGTT   PVSCNYUMF      
FFYMRYAIWU      : QAFRO           LNHL            DDUEDJUISSJW    JGCW           
USIODWDNMHJ     : RWND            GJQCVUQDM      
FPVYWIRN        : VIPLWR          UBWDJPKIKUJEN   WMMIUDOVN       LMTFCJ          KBGVHGFASNIUCY 
XMFRNFALDXIVI   : YJKGSYHYP       DBAKJFTBCF      EHFXBPHDMP     
CFCRSJC         : GLRY            QRVVCKAO       
OTWQSG          : JCARLQAMNBNS    BCNQKV          LPADV           DBVFTBHXS       CUHAXLLONCFMJD 
GYIVEBJKDW      : FOPWESAOGSRJO   RESFYFA         UNACTTL         OYWGD          
BGNKFPPIIKTM    : FLTNWOTW        VONBUNYDAS      BTBTVGCDE      
LILCBTMJSVFXW   : HHOCVLRXHFQD    EAPALXPMPTO     HOTTDCOKNX      HGLCJCMDPWEA   
KCQAEWPQDG      : RXTTVEUBI       CNSWLGTWQUQXK   OTKWVHF         OOPCGKFOKUCASK  SRJUW          
NQTHFISN        : CPDXG           KSVPHYFPIU     
WOOKAHIGHHARJQT : OKHFJQIBUYBCQXN REITXPFALV      VCTDGMWCISWVNT  UFFWLWE        
QKGTSPJLJQQTMGN : YKMABFPCRLJ     IGCYLC          PRTYLLMMUR     
UEXUOGDVPFQAYMR : RPUDOUY         BXLJKRFUNX      EDQNVRKDEPBRRMM VFSI            FONQNWR         JIACFKKCAD     
YYLRQUFC        : EJCUHABBMNNFEJB BOFVVOF        
VVCCLOYQOWHXCDN : NBDWLXNYSXGM    AATPY           TNQUJGDQCJWN    SNRCBRLLNUJOJR  WYRJGGUT        VUKXVNSKLMKPET  DEPSGWFNBKUCK   FDYOCLODSKMK   
VPJJIYIJKDAH    : THSPEEKUR       TACEUJLUX       JNJFUVOVPHYE    SJCOIXJGPYFSY  
CUHAXLLONCFMJD  : OFBHWAJUSLKDXI  BESNVMABEXHKYV  EQVHKVWK        GUFCLRMCVN      OTWQSG         
PRYNHIYRJI      : ETHTDUIJV       MMVBPG          AEQGCACINGKW    WCJPAAAAFPIBM   ONPC           
TNBBX           : JNJEWCQ         KQFLI           CISUARARIF     
YFFYTRNHVU      : PRTQHLOCE       YFDDHFPWINRJGB  ESPGQLQYC       GIRQNBHEO       NWDALCNOMENKROR EHJCCIG        
IYKAS           : MUMPNTJOKMU     FJPUQTCSMBHIQS  BHJSAW         
PCWPUH          : HXPRARLN        BYHMSIYXPWUEWM  NXEIPA         
VDNAHLFGTNFPFU  : ADJUNVVHVAJM    TESGFYM         LCKBOUJ         EWGYKROX       
DPUNQ           : RKBIOXBLBQYPASH TPECXVOUMXMNKLM FXSMJUHJMTXAO  
NJTEM           : BRTWLCBED      
VJDVFGLHPWNV    : LYPTVPOU        NCDMKF          VOOQMPYBLDPVNU 
BDKIAJNQECJMRTI : FIJQAXPU        XEDELKJOBLAYE   LKFSW           IJMVS          
IETRHPYQ        : DONERVCRMLPDCV  IEIRLDGQJABRQDA UEAUYDC        
HGBWFVAIHIJSVC  : RIUI            NAFAEGGKWKQ     APSWEEIKDDIAMTB
ALMSHWSRCPLJ    : PXMFPWXVAOQMO   SNXKFCPHUDJBI   LHXPLGDKHSCYMSG IAYFUPVBUNIPT   UBJYSQEHIQ     
NAJUJMTOKTWTC   : HGOK            RJQRLNQCVLUYSR  LNQOYH         
NAKLDYAVIWQDYGO : WBQDDMR         MKCRVPKSDRD     QPRDJEOGQKNSXY  JBJT           
OCLAYUOSJYMJVQR : EXMMAOHUTUCBMI  JUXUHYOJMDRYOF  BOUFWAQDH      
TFWWGWUOVL      : BIVFJKCLKO      QQXHT           KCPMTCXDQU      FYBXAV          WVLPPI         
VSJHJNUJNSXIEY  : MOCUVRTEINPOO   IWSKK          
NUQIGKPDH       : INXYC          
CEMYQHWLSE      : KAFICVEKQBVSL   WKOXBBCSPTVJGBF FAVTHT          QPJH            CWNLMUPVKUF    
GBGVTG          : ARHLVQTMBF      EMAKFJOQLIVPR   FEQCCVOS        SHBICANHIAKMIMY ITVYBXCQMPC    
YHFODVYLJOPS    : SUJAFALPCFDKE   BQSWNHHDBX      UEJKJOKXNJCDMFB ACNILP         
TXASQHPCA       : PCECQLAED       GHXAJXNJO      
YGXHFTP         : QNWDJE          SEBCGXINPSHRDNJ MKCJ            WYDT           
SWRKCPJ         : DHXBTRBFUHN     HEPRFWFHEAUKEK  OFDQJIQAGQURYL  INHVWYIIMFQHRU  EAHXPN         
YYGSLAQLT       : EGVRRCFBJMXWKLM CDJSPJDUE       AVFODC          GVIHRD          PPTAKNDAKBUJJG 
ULLUK           : CVEKIQUIPAGHXH  XSUQUHKBR      
EKVJELVXIPK     : OEXXSEWVEVXDFU  OTTDDBK         QYKV           
FTCFSIXHIQSE    : SCQKAEAMJ       QCNSENDJH       VUKXVNSKLMKPET  SNQROYCONPKX   
OSLLDA          : HQREIEKESVYE    OKHFJQIBUYBCQXN CQLNDPPFWRWQ    RPIPG          
NVBRJYRTOCFUYJA : PKIAONUUPQFFP   UFSWWDCHJYOXCTW ABUGGJO         FONQNWR        
RABBQW          : NLMTRVWLASCD    YAQQX           NQKUG          
SLXEWDGPSESLNSF : PNHMPKAAJ       PXJHVYJRXTAVPJ  HHVKHSHPEOE    
HKPCJBEFTEHUWGC : QWUFWAHWKHHOEY  RXMNFB          NOUQCHEDPFA     GIUY            EBFYMBBKDE      OFPGWIN         WPLRTRPDEWNWWE 
RDVQGCIAICNXU   : RIVEFXQQKJYQGW  OYTXH           OOCMDVDS        JIHWQVIJT       KGGLTYVUNSN     QMPCEIHECUFNHT 
ICFAFQBL        : IJBFASKJBQA     EVHAUIRM        WOMQCGSIWPUJDNE
UQGPNMUGG       : BHMVRVHQPWUDFSH YBKDYQHJCT      VVCWTPBCBVEXFB 
CYEHIGPMVQHRYLW : GIRQNBHEO       JKREDVMXHAH     LMTFCJ         
SQAFPX          : CIPPPOYVESWQR   RAHAUGF         GCBDLWDULICD    VVNLDYRTIEJIQ   EURPWJYIHR      TNRXMKKYIKWCDIF EBCTWCCSIVVXCHJ
XPLMKRSI        : PACB            GSRPHNIDIBWSKGD
TPECXVOUMXMNKLM : JRCVYXGSERI     MPSPOB          VONBUNYDAS      DPUNQ           CUUYWHEVV      
EPKTNGR         : URLAJYCUBEJBLIO QCNSENDJH       TAFJQY         
UEQOYBLTQ       : KTXJQ          
XROP            : ESYBRUBI        TOSYR           WQPWICXSX       EKNY            PCRTDREAK      
DPBRAMG         : IDXSPH          GRWMILOLAK     
RVSNL           : UEEUPQJGHYDIBOQ MPSPOB          HSMHHMAK       
GRWMILOLAK      : PWCTERDTKPHTTXF IRQITEM         PRTQHLOCE       NLKSGKPMRUQRRXP DPBRAMG         WNEEJRPIRR     
RIUI            : UEGWRGJEDNCX    KTXJQ           HGBWFVAIHIJSVC 
JOQKISWOBQN     : SUJAFALPCFDKE   UCKJGQTG        BQCUINADT       NDPPQUALFMSFJJ 
FYWNS           : GTURTUEYGBOGPL  OMWDSE          LKUFGRWPAT      MEFTSKHYB       SSAGQVTXQY     
CDJSPJDUE       : XYNAICVBCM      EXISQXMWRDD     YYGSLAQLT       YIUAJVP         TAFJQY         
POOBFF          : HDNCPFJMKFQQ    SBHSYWUO        XQALKOAPPTB     SYOEY           MFOFCISVAHBXIR  OJXOXYLTNXOSQR 
NBKDCCQ         : LKUFGRWPAT      FRYOL           OSCNMVUUTAOKTIF SRNVNIYT       
JRVYN           : TFSRU           NLQXNOXIFTHSHWK WQANKQI         YOEQJQGCXBIX   
BQCUINADT       : JOQKISWOBQN    
UJGV            : GOVMSYAYHOYWT   PBSHFEHNXJHVHXA YADYMUXVXO      QRXKAHTALB      RAMCHDLAYNWQK   UAVXMIQWHUMPP  
LJFOUIRWBQI     : MRXUR           JEWM            YELHLSYHYSGTT  
NHKFKCJFMXI     : BUIIQQBXPOQ     FVMQAN          ODDXKTWKCEGHAWW HHTMSXYA        CNLPOSBYXCRUVID MEDTBMYJBHK    
RWND            : HNSGADPRHQDBPU  OPBDYEQH        RCRC            USIODWDNMHJ    
MURVAGQI        : UHYTUGTE        KNBGTHBFJQLI    IOADVYDSHSMXQM  UWNP            PFUPG          
PLRX            : VWOAQI          ESIL            PXRJWMPLQJGHFB  GTSRBQJPMFJY    YJSPHAFLHA      GEHYSQVDC      
HHTMSXYA        : PRUEPOD         VHMXYOGHLFFJCTT OFDQJIQAGQURYL  NHKFKCJFMXI     DEPSGWFNBKUCK  
WIDQGTWLG       : CRUIEBWWXBTET   DVVTKSVFRAXGAE  PSSEAUUPVTPK    MVSFCVD         JAYEWXKKHVG    
FEROXCONPIO     : UNUUQKPUQXOR    OXDCMCUNPYF     BTIW            TRGSONYNLLATO  
PVRFQPERDDAI    : NXLMIRVYHBCKJN  KYXIHSYQOJEDESV OXHCQLC        
ICSWK           : SRBKVDNHNNE     UVSB            HQIFQGBHYAA    
CRESPGIF        : FXIV            JUXUHYOJMDRYOF  UMFCXNAAXREPKIJ TDHTCCF         TSKILAGAMLXH   
STUJSOOL        : RPUDOUY         YXMVTPQUG       SHCCLKLAHYWWHG  JETKDPSLIAJBEPF NMJD            GFGCHSPMTCOOMAW
UDKXGUVQ        : LBBCIJARUBQUPUA WKOXBBCSPTVJGBF YDAGWFCQIN     
PPKCSCHNTNV     : THGGI           AGYQHBXVT       SEHAIYPYHYFDQKM LNEGVOEQ        QLIGSSLKMWAYC  
MRVJBOXRDFMGRMO : HDNCPFJMKFQQ    RPIPG           IMHMQNXOMFWSRHL
IGNAVADQFK      : RWYHYQNFVOKKPB  EKEDDAEJWXPJYIH WKGVKDNJRMF     MYNSQSNJ       
YADYMUXVXO      : EJNAGFVYFI      GLYCCPU         UNVSTPJQJB      XOXRIXHPRETGOXP JOLPGFVKLQLCVIG GWPGAEPAKM      UJGV           
PRCEYWSPKEVAE   : KCUQSAYXMUF     WNOLJFYFQORBQXX
AJLHTSHWYIJ     : XJJORDEMEXWN    PHYJEIRHCTT    
GIUXFM          : FOPWESAOGSRJO   IMACXWWXTLDON   MVWPXXNFSU      FMPI            AKVG           
HRQGKHSOFS      : KPSUIGTOJADTL   MQBFESRVVUT     HSPMETJ         HIWDCU          KBFRRUBUCFUITH  WBAMKVES       
AVFODC          : BPENYFRWJR      TLWCWGUISAOVBTJ NGRRWUDOAF      AWMARUSNARBN    YYGSLAQLT      
KYIV            : WIMCSHBBAQ      OYJWLKB        
FEQCCVOS        : ERJTOINQWW      AGIMTIY         HUKVKNLVFS      RLHMVLDAQMLORN  GBGVTG         
IJMVS           : QHMSVH          YOBRYC          EJBVJMFHL       CKVTBMQQXX      QJWQPOKWSUTO    BDKIAJNQECJMRTI BSXMOKPFNIHQS  
MYBIBWOPDSAPR   : HRQBJICDLSBU    LVCXX           OLPSFH          KNBYJJCE       
LCRQVVUTLNATA   : ONCDGETNYCU     MMIKVHCKUNWQ    PHYJEIRHCTT     MIEESFP         EHFXBPHDMP     
RUXFTBNVYENEWP  : HHOCVLRXHFQD    JOLPGFVKLQLCVIG WLYUBDNVMN      JGLVLUFWP      
QDITUB          : UERPLPQSWJDRRYF RBHYODL         LKJLU           BNGIPCDYXFQHCHX JNJFUVOVPHYE    RCLJHU         
RVJFMMBO        : PYQO            UGKVEJBJSU      KDOJVIYOYL     
TJCYGF          : IOPLCMGPCUWHMF  KQTMNXOFLFX     QRLH           
CGVRK           : SHLW            FSSWVJMKWBR     LPADV           NLMWTQGUMYQ    
IFKNNGIOVCMHJYT : BQSWNHHDBX      HDGI           
NAFAEGGKWKQ     : HTROCXQSM       NOLMHFCPT       HGBWFVAIHIJSVC  UEJKJOKXNJCDMFB
CCMMJYAYH       : MKFCBRJP        ESIL            KODFSFHOEMRYWPV FHWA           
NFPCMACJLRJ     : KGLNUJM         WRCXNGPAPQVL    EBEMYQOAFDP     XEFRELATFBA    
ROBXBXKRRNVGCF  : VCHKFBAUNVP     TLWCWGUISAOVBTJ WOMQCGSIWPUJDNE
FEOQTTGWGIB     : QCNSENDJH       ADDVFF          AWCAJIDGAHTPQB  WAKLLGSS        BAMJV           JXGTYJ         
TSEONUPLV       : PCECQLAED       YMRXA          
WNGMMMOTTVB     : XEDELKJOBLAYE   NIRHJBLT       
MUEVTMEWHBQ     : FXFEACASH       YXROORKOUQUO    WCKLOEEVGO     
PEGIRCWQRFFETW  : YXROORKOUQUO    KDRGNWGGW       IJNURKIMBTBY   
PSAAIWGETSKQC   : QKFDHNX         QCDILVDB        IYNOITVQIABECE  CDUHNLPPNYB    
JNGPTOKXN       : CORMOKPDBVNXALP ETWMXPQD        MOBDJMQOSLTVWOG
SUHWOEXEYAGHAMN : YDOBHSPMX       WXQQMMOHBT      XKYBKQXUDXKPAD  XEFRELATFBA     UEGIGXHQK      
HYMKOWAU        : GHPHP           IIMVDADKLUCUFR  NCENVF          GMGTHSRS        PRERQECCQFP     DMOGIDUSGCVAY  
WLYUBDNVMN      : RGIAASUELF      NHSIQLRGNJ      RUXFTBNVYENEWP  HQIFQGBHYAA     CRFIULWKKOD    
SNQROYCONPKX    : NARQBGXGQ       NLMTRVWLASCD    BCCBVKSHSG      AOHOWSFHWYH     CHAQUDFTDUT     FTCFSIXHIQSE   
WKGVKDNJRMF     : HWQXPHUOQYNDYDS IGNAVADQFK      EBHLIFYSKFTOSEC
RURGKEYB        : JAVYIHGRXLNKFOT ULSNLLDIOOODB   IVUBXJESWEQN    BTIW            EBLGTVXRCHPAYXD
TPWVGLNQJF      : QKFDHNX         NWNJMQ         
VNMGQAQKOXE     : XSOJGHUK        FCOUFFPTS       LNEGVOEQ        EWGYKROX       
UXPICRJA        : FVMOFSPWOQVROS  KFQATLGPTLQJQEC WPTBXUUJYFRJ    APKCQSOJQS      AGKOSQFRFPND    ONFB           
YXLHLYAWEPS     : UJLTMNDBRJQ     IYNOITVQIABECE  OFVQIMY         FWDRX          
EBLGTVXRCHPAYXD : VFIVWDWRJ       RXTTVEUBI       PPERNKAWYTK     RURGKEYB        PFUQ           
HDGI            : YKKFPHVLCP      IYPFWQJREDIYP   HJOGPYBDSK      IFKNNGIOVCMHJYT OKPNWWFLLRWNO  
RRQRRNVHIQOK    : IJBFASKJBQA     HUKHNJKLHBX     LKSEHA          IIIXCRRW        OIRBSMHRCYX     TSKILAGAMLXH   
UEAUYDC         : EGRVYIX         PHYJEIRHCTT     XHXQHOSFOISIOG  IETRHPYQ        KQQG           
FEOIWVOEGTVXLPP : FRBPLLEXXHENVQN AQAMGOLUHYR     OHTQBHVNM       YCRQDQU         RYXOMCMQFYLHPM  WDUMNLFPHOVKU  
OYKFPWJNDJIEOLU : EXUOSMPBETSQ    NARQBGXGQ       WCKLOEEVGO      TBISM          
RJFOHTSNO       : WIMCSHBBAQ      FSSWVJMKWBR     CNUCGFSYOMPDTRY RLIYMFO         RGAMBFDYDNYS    TUBGLFKXTMOXCO 
NCHFDVH         : MIKWVL          DQOWD           BJRYFTOQRUKGTPR
DWOMKUYTYP      : DFSXKQPMBTGLY   YXYDDHRXXJGLSP  TNRXMKKYIKWCDIF
UKYGQPOMJCDDSFK : GPJYSGFG        LHXPLGDKHSCYMSG
LJFDM           : CQLAIBQCNFY     TFTYSXVINUOL   
SCPPDLOSULEVSWM : CBXUA          
LXNRBGYNFKWMQM  : NYKMPKMFSHLJ    NYAIFUESONEYW   WNOHFJXP       
LQMBTXRMTGS     : GBRGRR          DQAB            DMOGIDUSGCVAY   RDSTGMTDDCL     HSSNCVKEGBGG    PFUPG          
BREKGCXXDF      : PFUQ           
RMKQBBFVMVI     : NLMTRVWLASCD   
RIHF            : TBVCJOUNPLEGWKK HUKVKNLVFS      NJSEA           ARNOPNCQAHCYWA 
NAWOUBBBEA      : TDQHBI          MBENVIKUXKLQO   CQLNDPPFWRWQ    NXKGSH         
JHVDTGWW        : TMFGYNE         ESVJ            GQYE           
ESVBDLUOVCSJDP  : NBBPQVJFEOG     SXFDSKWMCN     
XTEYAEALLVPHFOF : TBVCJOUNPLEGWKK REITXPFALV      YBQLTAMD        PQAM            JOLPGFVKLQLCVIG WAQBKUSYOU      EKLSULEKFYOD   
SALVGYRUUTPHW   : NRINGOTAP       WPKDVOJUJDGBMN  FMVAKFR         QRXG           
KWCOXCTXNHWF    : YENHYVOHHXHDHPT DHKCXQBISUVGO   LMQRURAVJIUYF  
CVYQPYELHE      : WAWVRFRNJFW     QNGYDITHSFAMHU 
EYXUIWDSWFI     : XSOJGHUK        XSMNCGICAVNS    HASD           
JEVYLUFF        : SAQTLQXJTCSVQBK HUKVKNLVFS      XFKLB           USROGBSBHCYAP   SCNRQA         
DEPSGWFNBKUCK   : LUUJPTAS        VVCCLOYQOWHXCDN HHTMSXYA       
LKSEHA          : YTBKJSTAUFFK    KNBGTHBFJQLI    HDNCPFJMKFQQ    OSQAJRFYYB      DQGQSX          IUBEMYJLLCOKL   RRQRRNVHIQOK   
EJSAIHUPMTTTMOA : GPJYSGFG        BCCBVKSHSG      ILFLHQJIRAFVKAO RRNCACODCGMNXQS SWSUKVKILHGHGKQ
VPMHK           : VBFQDGWF        JOIHHVXPG       JGKJ            TPJUVMKYYOOMGU  CVQNGTVQM      
TACEUJLUX       : OIPALFPAGVYTTO  KCPMTCXDQU      VPJJIYIJKDAH   
GTSRBQJPMFJY    : KLMQEMHHQHL     IRKQHAVRW       EMHHW           LRSKGESGGUQL    PLRX            ROOHDJ         
LIQCWAOM        : TFGDUMHVK       ATXJWYFL        KMCFOB          VHLY            IFFIXQPWH       GDNTOVHCT      
PQYMCNIBGQWYIA  : URLAJYCUBEJBLIO IDRESQADGATVI   QHBQFD          PSFXVEFFBUU     DHRH            RPIPG           XNUXIGKHALNH   
SPFXCGUNR       : NCENVF          LRILIJB         FVYGXPPJG      
ROOHDJ          : DVVTKSVFRAXGAE  ONCDGETNYCU     ITINEELUTT      JQKILWGS        GTSRBQJPMFJY    YKCPT           MRSKJAU        
ULLWBVAHNWIV    : UDLU            ETWMXPQD        WSKLV           UMQE           
BOPIPROKHGYAVOH : XGJMMHHYJWUPFA  LVCXX           MFSWEOHBHY      UMYPG           JXGTYJ         
AGVNTVOQX       : MUNHDBJJGAEFIG  SLBAAWGX       
EVHAUIRM        : BPWMKGRKWQJGW   UDLU            KKAPNXKODY      ARFOQSHHABODTL  ICFAFQBL       
HEJTOQTOOKXPKGO : IDRESQADGATVI   NYAIFUESONEYW   RGEUVFCHFU      HJNX           
AKPQIOWGVXE     : MRXUR           BTIW            EGTAYBYWLLYXJGO JBJT           
RQBYXKUMB       : VRNPEJHQPBD     XVWBRBJLQLDGHV  KTGEU           IRQITEM         EDQNVRKDEPBRRMM PMMUWTNDHLS     HUBVNRSCUBTG   
DRYBKMJYNLL     : KITQVQKQGKY     FXIV            HLQCQSKX       
FVTCDRAJXR      : UERPLPQSWJDRRYF QRQOYBBV        KYXIHSYQOJEDESV IDYQYWGEY       UNACTTL         RWYHYQNFVOKKPB  OBGU           
BSXMOKPFNIHQS   : LVCKVNTGRAXFJ   WPWYSVABQIO     IJMVS           QLUS           
CTJOFOTDJ       : DYUIDUXEG       HGOK            RNQOHQGTNOYQ    GDNTOVHCT      
GBYRCQSDMQR     : KMVCKYNDYPKXHQC ADJUNVVHVAJM    UHNLEXPE        ETETLIYFAXCDE  
EIITQPLLLPHUEOM : GSRPHNIDIBWSKGD DFSXKQPMBTGLY  
RVWB            : LVCXX           WCJPAAAAFPIBM   QXYMAXHRBLUXP   TCXQMTMJTLSFCN 
VSDOLHBFYEJJPFA : RESFYFA         CQLAIBQCNFY     CQCDAEPM        GLVRLMBAAHCOSTU FXIV           
QNVJWSNLFOEDN   : OQMOCSQEDVVDMR  RNQOHQGTNOYQ   
DJXGAMPERRKDB   : NBBPQVJFEOG     BDRINRHHHUV     FJVLOYLYN       PLEKJJOQQJSTBD  EGOUCWEJXISLECT HDVBKGSB       
IEKC            : SCQKAEAMJ       GPUKUEHKX       NDPPQUALFMSFJJ 
GLRY            : LAIGWMMVHUGLX   CFCRSJC        
DHRH            : QCDILVDB        PQYMCNIBGQWYIA  LBWSS          
FONQNWR         : EXMMAOHUTUCBMI  VFRYVOLVHWL     YUWBYHMVMJDEDWT UEXUOGDVPFQAYMR NVBRJYRTOCFUYJA MPKHBMFQVU     
MVTGGYIJHM      : QCNSENDJH       HBAREGKK        RJMPAMKK        ONFB            BAMJV          
JGCW            : FFYMRYAIWU      KTPAPLFGKAURDG 
DYEKQNXWDNNS    : RVOCIQBAJGHCXTP DOCLX          
HUAFQIOPQX      : BPWMKGRKWQJGW   YLIUXLO         EKEDDAEJWXPJYIH
FTJOXGOBFSOWJOV : QIMTPCW         YTQSYHFEQKGSNF  MQBFESRVVUT     VTWGLTMXH       IUUDIDLEHSQXAOU
CLHPTCRYUANKTN  : LRVSLUWAFMKS    GIITHJOXKKMFWS  PLEKJJOQQJSTBD  CGREO          
YJSPHAFLHA      : NYCAFU          UFHJQWNUUAR     PLRX            VQMDLIQPED     
GJQCVUQDM       : CHAQUDFTDUT     USIODWDNMHJ    
HGLCJCMDPWEA    : KDNVEQVGVSODG   BOXSVQDOI       LILCBTMJSVFXW   HQFJXBXYOHOVY   XLHCGBELIKN     KKBGI          
UJTAUCAYK       : FRGX            CHAQUDFTDUT     KQPVCDOQMGQHA   IRAQQDVE       
RPIPG           : UXUGEDC         OSLLDA          MRVJBOXRDFMGRMO PQYMCNIBGQWYIA  BDODOAQ         USGPSBC        
CSVJEYUINXY     : QHWMNEMYFEX     KFRWNVEJBVR     JETKDPSLIAJBEPF
EBFYMBBKDE      : YPPVRWTEYHQMXG  WETFTEVMTJ      PWUXMNMNTC      GBHQMMCCWFSLP   SDEFOSDXMUOO    UIIEVWMFGH      HKPCJBEFTEHUWGC NDPPQUALFMSFJJ 
QQEG            : BSAFKTEKQPVFSNK BPENYFRWJR      MBPFERLQ        LRILIJB         NXKGSH          NCDMKF         
TMPVFMHLNCUD    : GESQBYUNANR     EMHHW           WNOLJFYFQORBQXX CNLPOSBYXCRUVID MFOFCISVAHBXIR  UEJKJOKXNJCDMFB
VQHY            : TXCHI           BSIOG          
ILYKVFQIVHME    : JEWM            LTJXLFQQYW      MEFTSKHYB       EAQHMFNVK      
GQYE            : IOXCT           JHVDTGWW        FNHVMSPQHD      EWCQFKXKVSSW   
NMJD            : XSOJGHUK        OXHCQLC         STUJSOOL        FXSMJUHJMTXAO  
EGTAYBYWLLYXJGO : YOBRYC          SEQFKUVG        AKPQIOWGVXE     HQTTKT         
EXGIJOYITWXGGBW : UMLYPBQU        RKTQUALK        BVIPBYRSWNF    
JSNJTPGI        : FXFEACASH       LEKBESG         DHKCXQBISUVGO   TUBGLFKXTMOXCO 
HGOPVJTT        : KSXREDK         RDYHALSI        SDEFOSDXMUOO   
CDFDN           : GWJAVQYBGL      HOCMGOGNWBFMD   EQIPHLP         QSNOSOGGFYMBTGA
ANHJQ           : SGDWNPW         TGKGFCTFOYAYJ   ADJUNVVHVAJM   
WBAMKVES        : HRQGKHSOFS      PKMOWK          CWGWQCGXAYMDKUU
HDLWSJGNFXR     : BJMSFVYFG       HMJKDGPNMXVPM   HTSH            OOWETGPOLPFK    HHVKHSHPEOE    
FVYGXPPJG       : ULYDACDTGFNKXS  MJFLLEGIWO      FFYADNNR        JNJEWCQ         SPFXCGUNR      
IJWXVSCRXKULJNU : BBLMPM          MIKWVL          WJKJHJHSLM      UWRWMQGYC       MNOYLLKFRN      HTKJWALBYVKC    SKROR           UFHJQWNUUAR    
DAPXLXTNETDU    : YFOIJRLASXWFIA 
LROVQM          : RPUDOUY         WKQDYJQBJKV     CKVTBMQQXX     
JPLJAGULWRD     : VFRYIJGJOQRMTV 
SSAGQVTXQY      : FYWNS          
WNOLJFYFQORBQXX : SGQFAGQU        PRCEYWSPKEVAE   TMPVFMHLNCUD    TUBGLFKXTMOXCO 
USFANAATTWQTNRO : PMIEHMYTVFS     OWAXRBOIKVM     LJBSHHJYTODLGV  CNLPOSBYXCRUVID PQQHNWAW       
FDXQIYWYPOCGM   : JXNKOVIJTMTLR   VNQSWIFQXMXY   
KKVRKJ          : YKVGWLO         IRQITEM         YLTOFIFQBMUF    PKLBOGVRWEIPD  
KDOJVIYOYL      : LPGXDROGY       SARATUWFFEB     RVJFMMBO        CBESMIALUIOF    OLKSOGEQLRT    
CMLMLIN         : KYFMMOKNFLOG    GHXAJXNJO       IFGXIAPGYNWHJF 
WSKLV           : KLMQEMHHQHL     UHNLEXPE        WGWP            ULLWBVAHNWIV   
XRRIDMVID       : DUNGFMFKGKGN    BQSWNHHDBX     
FNHVMSPQHD      : XWMGRSXTNLQEKN  OXBEJWJCINOQ    GQYE            BHJSAW         
TNRXMKKYIKWCDIF : PHDRDNUCKDIGDMO KTWKHABWCA      BNBTM           AYFRHVHIAIMS    CTAWAOELTCXP    APKCQSOJQS      WCKLOEEVGO      SQAFPX         
TNRXMKKYIKWCDIF : DWOMKUYTYP      OLKSOGEQLRT    
GNVN            : GMUEULJFYMKY    BHJSAW          GQJNLEQWNVWJO  
LUQYQJPXMVTBP   : LQCB            WKUPIIN         THCSJEVJBTC    
NCFO            : MWCJLKQ         LRGF            DFJVTFIQ        VUKXVNSKLMKPET  SBGGMKGJFEFW    NXCFCXUTMBYKC  
PMMUWTNDHLS     : BJMSFVYFG       VIPLWR          JUIRLBKUUXCIP   UPPGTUAP        RQBYXKUMB       JEHBQOAYSUGKMWR
WQXVHHOH        : VQTSXDDA        SSLRAPNRCGL    
KCXCVNEBDOTR    : WXTYEIREPJS     GJFAC          
OOWETGPOLPFK    : XYNAICVBCM      PBSHFEHNXJHVHXA HDLWSJGNFXR     IMPFRLTFYYWHPTT
MTCUQOYOQU      : HMJKDGPNMXVPM   WDNJ            IWFNWBEARMV    
WYGLSAOJ        : KMTFOGBGO       ELFE            ELTSEOCLPDA     UYKTSC          JQAY            LLRMJPAUQV     
NQKUG           : AXHFCUPVAPJ     JWPRXURW        VBNGD           RABBQW          TCJHPSDPVQAHGQ 
IXHSMTPQQGI     : KHBTVMYMFHQQG   DACK            MVWPXXNFSU     
XBNBYMJ         : KFECRUCWVR      HQREIEKESVYE    AITMXQJE       
HJCSAPJMKSLTQ   : SERLI           ICYAKJPFYNSXD   LRILIJB        
OFPGWIN         : RFYDHIXDBFSG    ESVJ            HKPCJBEFTEHUWGC KEXCT          
BLGQO           : NLINRHPYIDPJF   MBENVIKUXKLQO   FQUNXWR         FXIV            IOXCT           EQREQJGW       
FXSMJUHJMTXAO   : YOBRYC          FEEPJKG         DPUNQ           NMJD            QRLH            FWXQMKLNCYT    
VHHKNWRKHH      : AHBMOXC         XWMGRSXTNLQEKN  EJNAGFVYFI      HQMWXUAWCR      HIXVHNXWRQQ    
ISXY            : WAWVRFRNJFW     LBWPQFFSRMLTUHS GLVRLMBAAHCOSTU GQHGRPQ         TEXCEPXKOCEMNCO
GEHYSQVDC       : IKPTUVLETYGJDT  LTRUSWKP        NAKKUBXS        SFYCRSOKJTNC    OHMDWXQPGBHTUC  PLRX            BHWL            GWHIUJBHCDQGNF 
WAKLLGSS        : VJOTCS          FEOQTTGWGIB    
GRNSAUK         : YTQSYHFEQKGSNF  QWRATCTHDED     GEUSYUJNAJOHJMW
NLMWTQGUMYQ     : WAWUHH          YPPVRWTEYHQMXG  DUCPBUNPXLLHT   BEPJPSJ         HTGELNLLVR      CGVRK          
BDODOAQ         : HHLU            NBBPQVJFEOG     RPIPG           SBPR           
UMQE            : KDRGNWGGW       WQPWICXSX       SHCCLKLAHYWWHG  ULLWBVAHNWIV    JGLVLUFWP       EBCTWCCSIVVXCHJ
EWGYKROX        : IYPFWQJREDIYP   UCIDBVXTMAIOL   VDNAHLFGTNFPFU  VNMGQAQKOXE     QHXBACNLJ      
NRWTMLS         : VEEPPNGHEVOFIO 
BVIPBYRSWNF     : RGEUVFCHFU      RKTQUALK        KLYHT           EXGIJOYITWXGGBW
RJUQS           : EXRNFYSFUICJG   HNTXGRT         BAMJV          
DKNBQ           : OMWDSE          ETETLIYFAXCDE   UGKVEJBJSU      KEXCT          
UPXHCSOFRAVSYPL : WFSLDANFLAS     TFTYSXVINUOL    SIQIKF         
DQOWD           : XSUPEIDRTPRLJ   EGVRRCFBJMXWKLM NCHFDVH         TRGSONYNLLATO  
QVHTIUXBYSSYDUR : NCLAYLAHW       TXCHI           KNBYJJCE       
BJRYFTOQRUKGTPR : EGUPNUF         GWLGNQSHRK      LAQAETIVMLHIDH  OHMDWXQPGBHTUC  NCHFDVH        
NAHVWFYVARUDPP  : URMJUITPWVJ     CNLPOSBYXCRUVID AJHSM          
SBPR            : ABUGGJO         BDODOAQ         NYTJXYGN       
JIACFKKCAD      : WMMII           GCLXVV          LJBSHHJYTODLGV  UEXUOGDVPFQAYMR TCXQMTMJTLSFCN 
NFVLCDMBEGXJVN  : ITGFOALWNCNES   EKNY            DNDAL           UHJCJBCNJEJDQM  VTJJ           
QRXKAHTALB      : PHDRDNUCKDIGDMO UTDSYOUYYSIO    ELFE            ATXJWYFL        ITGFOALWNCNES   UJGV            TNPMGCXYIJEOU   IFGXIAPGYNWHJF 
WDMASAFONJ      : CRUIEBWWXBTET  
AKYHJID         : SVWUUJSN        BCCBVKSHSG      GMOGVKWSLL      LRILIJB         KNRUUAI        
QUSQHTXBTKFHJI  : LHXPLGDKHSCYMSG OIPXPSUQOQWQV   UNGBPCHOLNCQNET
LBWSS           : YXMVTPQUG       SDNNW           OEXXSEWVEVXDFU  WPQGPJNECVU     KOCRSDQTFY      DHRH            OFVQIMY         IDARLASYL      
LBWSS           : SCNRQA         
CNLPOSBYXCRUVID : PQAM            QTHVVBXX        NHKFKCJFMXI     TMPVFMHLNCUD    USFANAATTWQTNRO NAHVWFYVARUDPP 
JGLVLUFWP       : GTURTUEYGBOGPL  GAAUPVXNU       YDAGWFCQIN      ARNOPNCQAHCYWA  RUXFTBNVYENEWP  UMQE            MDYFEBGHSDFEIWN
AOJUYL          : KJENXYOOWHF     QTHVVBXX        JQMPPQ         
MDYFEBGHSDFEIWN : UNUUQKPUQXOR    JGLVLUFWP       MPIEETDXR      
KJFGQCXHF       : BTPA            XLXBQQBRJSAVSE  NCENVF          RGAMBFDYDNYS    XWQGGKHGAT     
SALELYKMGONOX   : CNPGKWEUPEKN   
UDPFAFWLQDTHHRO : OOCMDVDS        ILDNEVMC        UENEGLOMT       MHEPFUD         GNLCXTUUVQVKBO 
EJPRND          : ORMGILRWHGRHWK  FJCUCDYFU      
APCPGQNRNRHTTM  : EIREPCRM        EGOUCWEJXISLECT
HDVBKGSB        : FFYADNNR        DJXGAMPERRKDB   TCXQMTMJTLSFCN 
YKMTA           : HAAFKGOSU       SJYIKRMSQCBQJ   VFSI            ADGYPI          SYGXLIA         EQREQJGW       
MBKQS           : OTQAYMJ         MMIKVHCKUNWQ    BYHMSIYXPWUEWM 
IIIXCRRW        : CQLAIBQCNFY     TIOWYNPP        KLYHT           RRQRRNVHIQOK    WNEEJRPIRR      UAIOLESXNKQ    
LGJJIVPDWNFJCY  : RVOCIQBAJGHCXTP UBWDJPKIKUJEN   HKYGCVD         NXKGSH          BLUWJODRJHT    
WNOHFJXP        : ELFE            QJBTYCOYFUD     SEHAIYPYHYFDQKM OLPSFH          BDFTOPUCFFYDWHD LXNRBGYNFKWMQM 
INUAITETBNDL    : VRFSUH          TOWYTWQVKFCEQQ 
VOILTTPSHMJWTOG : ULYDACDTGFNKXS  GUDLAQQGKWNYA  
EBCTWCCSIVVXCHJ : SQAFPX          UMQE            KKREACSQAFHG    LQEDGNYSY       IFGXIAPGYNWHJF 
YTLSNBOVOX      : LURQLC         
KODFSFHOEMRYWPV : PWCTERDTKPHTTXF IMACXWWXTLDON   CNPGKWEUPEKN    CCMMJYAYH      
TDHTCCF         : YGWVJFKBEOU     JPJKMIQDFWOAT   LGDYV           YFDDHFPWINRJGB  CFYUGVFTXQKGAYF SVFCNDGS        CRESPGIF        JJUBCVGNLWYMR  
RJMPAMKK        : YKMABFPCRLJ     CMGXJFFEG       MVTGGYIJHM      QRLH           
QRVVCKAO        : CIPPPOYVESWQR   NDRWIV          GBRGRR          GJFAC           CFCRSJC         SKPSHRDXEKRCAC  NYTJXYGN       
BLUWJODRJHT     : PQAM            LGJJIVPDWNFJCY  FGUBVJBXALLLPFJ
FNATEC          : RGQRQEKUXHWKAY  UNUUQKPUQXOR    DBAKJFTBCF      ICYAKJPFYNSXD   MRTWQFYW       
QPJH            : NCJNRDCGNXX     DQTSCBORDJ      XUMIJUDTKSCXX   CEMYQHWLSE      BHJSAW          ICBRC          
HDJSFAUHOPGXHJ  : SYOL           
QRLH            : PXMFPWXVAOQMO   BHMVRVHQPWUDFSH TJCYGF          FXSMJUHJMTXAO   RJMPAMKK        VOOQMPYBLDPVNU  UEGIGXHQK      
AKVG            : HKYGCVD         GIUXFM          TOWYTWQVKFCEQQ 
EWCQFKXKVSSW    : JKGDNMINAV      RDYHALSI        CQDIWDIJ        DUDWOJKLGJHTG   GQYE            HOVJJHQHSTBUQ   LPKSBRLDSDBQ   
CLGIJPUCGM      : XGMLHYVCOPYTOIA HQMWXUAWCR      GQSQETACWXQUHEE EUIOBQV         UVSB           
ONRYLXLSXQJFBJP : KTQLU           NLINRHPYIDPJF   CQDIWDIJ       
DKVTMHCV        : HRQBJICDLSBU    HOCMGOGNWBFMD   FJCUCDYFU      
SQVBFNPUG       : MKCJ            PIYGNKFDHLYI   
HGFCEVLJYWCVCMS : ADBXKSLCIUP     YFOIJRLASXWFIA  JNNDQDABDUTFYF 
CCBXVVQTWXIPSQG : SJYIKRMSQCBQJ   HQIFQGBHYAA    
WNEEJRPIRR      : IWFNWBEARMV     YKXPNAXNTIAICRE JQAY            GRWMILOLAK      IIIXCRRW        BPVOWFJDEIFKH  
THCSJEVJBTC     : BUXGAB          LUQYQJPXMVTBP   WPLRTRPDEWNWWE  MFDVKBYUBGP    
QCFIUVPA        : CEPFAQ          HPKRE           TCXQMTMJTLSFCN 
DGCPBRAS        : QKPADJNRB       RPBVM           PLEKJJOQQJSTBD  SIMXLODG       
HOVJJHQHSTBUQ   : JKPU            LHXPLGDKHSCYMSG JAOXIMLQWMYCE   EWCQFKXKVSSW    SUYPSMPW       
WYDT            : UTDSYOUYYSIO    NXSFFOUD        CEPFAQ          YGXHFTP         SHBICANHIAKMIMY
UVSB            : KTOMRTKDPUFDBO  USPSSYP         ICSWK           CLGIJPUCGM     
USGPSBC         : JONSQY          ONQSCT          MXGO            RPIPG          
RAMCHDLAYNWQK   : EJNAGFVYFI      PDRYSIXUGUMKU   UJGV           
RPPONOIQ        : LBWPQFFSRMLTUHS NLINRHPYIDPJF   KFRWNVEJBVR     MWMNBWYBPUEIR   EBEMYQOAFDP    
FJCUCDYFU       : OMWDSE          CQLAIBQCNFY     NWNJMQ          PYYPSMJBILVX    EJPRND          DKVTMHCV       
SYGXLIA         : JRCVYXGSERI     CTIAFFOPJOPMDVJ ORMGILRWHGRHWK  YELHLSYHYSGTT   YKMTA           ENGUM          
FSLBKDTYSKHJE   : VKEJFNKBIQWPUH  UEEUPQJGHYDIBOQ JKGDNMINAV      ONAPG          
SIMXLODG        : PCECQLAED       DGCPBRAS       
XGWY            : FKIMH           FIIH           
FYUNRIQCL       : NGRRWUDOAF      PGXPXKPJRRHH    XRCEXUW        
BHWL            : FEFLJPNB        RVULCKVREVKYYXI JXOUYNSMSIV     GEHYSQVDC       HQTTKT         
DDKLPK          : BMECGGKQFVHEJ   UGBTVKSD        APSWEEIKDDIAMTB CWGWQCGXAYMDKUU
ENGUM           : LOCEMBTFOCGFKVF FMSUHYJKIQRES   SYGXLIA         SXVTTBKJWMRSP  
RLIYMFO         : LOCEMBTFOCGFKVF CFYUGVFTXQKGAYF RJFOHTSNO       VSWCWVCPF      
NGGBSJI         : PFUQ            UAIOLESXNKQ    
UAVXMIQWHUMPP   : MDSVOBVTIGCB    OYGNRC          HBNCAMGDVPCL    UJGV            YKPNX           ESDGCRC        
EJMO            : EQVHKVWK        GKCYMHHHT      
YTAF            : FRYOL           DBVFTBHXS      
GNLCXTUUVQVKBO  : UDPFAFWLQDTHHRO PYTCCKCBACBJVDU TCJHPSDPVQAHGQ  FDYOCLODSKMK   
JJUBCVGNLWYMR   : BCCBVKSHSG      TDHTCCF        
SBGGMKGJFEFW    : XQCGPNS         TWRITS          ELTSEOCLPDA     NCFO            EQREQJGW       
QXQAJAWLEVT     : WAWVRFRNJFW     LHYQN           GTSTBNQPYND     PPTAKNDAKBUJJG  FRRJNKEVAOJNMYX
HQTTKT          : EGTAYBYWLLYXJGO BHWL           
MDXBN           : LHXHEPRAMY      YNSQMW          YKXPNAXNTIAICRE NHQNXQRSY       BWEDKSAPB      
KTKSSMJSDLDGJQM : CQCDAEPM        HLJJ            KIYH            NXCFCXUTMBYKC   FDYOCLODSKMK   
MFOFCISVAHBXIR  : BYHMSIYXPWUEWM  POOBFF          TMPVFMHLNCUD    DHHHNSARFD     
TNPMGCXYIJEOU   : MUNHDBJJGAEFIG  TBLFHXI         QRXKAHTALB      ICIJBR         
BALJO           : GUFCLRMCVN      OKKWHH          XGMLI           PRTYLLMMUR      JXTCH          
LAMJA           : ULKMVPBLOS     
NXCFCXUTMBYKC   : PIEGPLUHTSTQLF  MBPFERLQ        NCFO            KTKSSMJSDLDGJQM
WJXRIYUUKLOX    : KLYHT           VSGTYIWSRHFHBM 
DINWXNBF        : YFOIJRLASXWFIA  YIDTWLYUYYXYQC  CUFROPETJFHJ    ECNHWKD        
AAMMDLAFSYQQSA  : JBPLSVYX        AJHSM          
NWDALCNOMENKROR : KCUQSAYXMUF     YFFYTRNHVU      XTWTTUPNYDY    
QRXG            : QTHVVBXX        UYKTSC          SALVGYRUUTPHW  
JICFHVXAV       : AXHFCUPVAPJ     QNGYDITHSFAMHU  PWUXMNMNTC      GMBNDXS         IJNURKIMBTBY    UTOJXAQDXLEVWWG
OSWQGBGWPK      : VCTDGMWCISWVNT  PSFXVEFFBUU     GHXAJXNJO       LURQLC         
CDBTPSLNYIAH    : EXMMAOHUTUCBMI  NHSIQLRGNJ     
HQIFQGBHYAA     : ONAPG           ICSWK           WLYUBDNVMN      CCBXVVQTWXIPSQG JASIUAUWROXJK  
BHESTQUYSO      : XSUPEIDRTPRLJ   JQXAHXOECYWWKYL LBLKO          
NCDMKF          : DFJVTFIQ        VJDVFGLHPWNV    QQEG           
WMMIUDOVN       : FJPUQTCSMBHIQS  VJLI            FPVYWIRN        XRCEXUW         DHHHNSARFD     
VNXYWFRRVOQQ    : DONERVCRMLPDCV  KCCRYNMER       JNNDQDABDUTFYF 
GEHMQRROQHBB    : HUXPBBYMSI      VLIQCRT        
HQAUHXIHWGMQAJ  : YTBKJSTAUFFK    NLQXNOXIFTHSHWK
QAMAF           : FGYUFAOBFBXDUE  NKIQT           JXOUYNSMSIV     IFOGFPD         NUJFPIXXKYJYGB 
OXNINGPQI       : BRELUSYRMOAC    UXPN            MNOYLLKFRN      ETHTDUIJV      
AYVUITGPSOFLOO  : NQBD            HISTUERGY       KRSTFEYEKV     
HQFJXBXYOHOVY   : ACHC            HGLCJCMDPWEA    YKPNX          
GVIHRD          : FRBPLLEXXHENVQN YYGSLAQLT      
OLHJAMVQDQY     : NCENVF         
YIUAJVP         : VJOTCS          CDJSPJDUE      
KNTSTPB         : DDCRBNGURAL     FYBXAV         
KGSBS           : DUCPBUNPXLLHT   HBAREGKK        NPNAERSXVYTSE   KQKRSDX         DOCK            IERT            UEGIGXHQK       TOWYTWQVKFCEQQ 
KUPIMSANPBX     : NQBD            JETKDPSLIAJBEPF
BHJSAW          : UUVBMB          TFPS            IYKAS           FNHVMSPQHD      GNVN            QPJH            JKREDVMXHAH    
URCM            : HRQBJICDLSBU    BXNHKVXGGQIMXJV NYNUDNAXRKWYJ  
FYBXAV          : SNXKFCPHUDJBI   SFUMRXQKBL      YXYDDHRXXJGLSP  TFWWGWUOVL      KNTSTPB         MHEUQUG        
LTQVG           : CPDXG           PFUQ            SXVTTBKJWMRSP  
VVCWTPBCBVEXFB  : YOBRYC          WTOKCAI         TWRITS          KSVPHYFPIU      UQGPNMUGG      
JQMPPQ          : HKQEYJJERK      RKEYGTQOM       MBENVIKUXKLQO   NNUWRCFGNSQ     AOJUYL         
QOSEIL          : EKGNQI          XEDNDR         
QXYMAXHRBLUXP   : JPJKMIQDFWOAT   WMPPISNEQADVR   ASTWYXU         RVWB           
DTNMKBECTWS     : JONSQY          LGDYV          
PYTCCKCBACBJVDU : JBCVQ           NAHSFQOHD       GNLCXTUUVQVKBO  MPIEETDXR       SWSUKVKILHGHGKQ
DMOGIDUSGCVAY   : UKAPTNN         LCFEOSYICKQJOMO HYMKOWAU        LQMBTXRMTGS     WVLPPI         
KQQG            : ACHC            JLGYQEWHVGLE    UEAUYDC         GEYXQHSHXULXES 
URWXTBYD        : LRGF            IMDQNHKADYIQ    LLOFAEILNIACS   WOMGSO         
EAQHMFNVK       : THGGI           MSOWASYWAPETG   ILYKVFQIVHME   
QSNOSOGGFYMBTGA : KNBGTHBFJQLI    CARUUDXGF       AUKOW           CDFDN          
ACSFBX          : BRIPGNDYTC      QKPADJNRB       TAFJQY         
RFSA            : TWRITS          MKFCBRJP        XLSMGJK        
QMJHGWYBN       : VJXOX           MRDUADQYYBOXX   UGKGMHTFC      
JSGWVCFWTI      : WRXBV           AGKOSQFRFPND   
ONCMTWUOYSHLCQ  : INHVWYIIMFQHRU  LUGEDEEN       
BPVOWFJDEIFKH   : FVMQAN          CHJSPUU         SBQHMFYCYLEGYS  CNKEN           GBRGRR          WNEEJRPIRR     
SIQIKF          : RGXNXTVRMU      WFSLDANFLAS     UPXHCSOFRAVSYPL CBESMIALUIOF   
JASIUAUWROXJK   : FIJQAXPU        KYFMMOKNFLOG    VFRYVOLVHWL     HEPRFWFHEAUKEK  EMAKFJOQLIVPR   HQIFQGBHYAA    
HSBKWJSHSTCBMLN : UTFMQYD         XHJCX           LYPTVPOU        OIPXPSUQOQWQV  
PXWJGSL         : NTGBUPJ         JNJFUVOVPHYE    OKWRCAJWMXBFTG  IIHDX          
PFUQ            : YBQLTAMD        EBLGTVXRCHPAYXD BREKGCXXDF      NGGBSJI         LTQVG           OTFKRSIYYFIJ   
FHWA            : BTIW            CCMMJYAYH      
JXTCH           : CPITNJDP        VLIQCRT         OBNHCOXBIATRLD  BALJO          
YKPNX           : LCVFVJU         UAVXMIQWHUMPP   HQFJXBXYOHOVY  
INGG            : DUNGFMFKGKGN    AJLG            BDRINRHHHUV     LLVNGUE         WOMQCGSIWPUJDNE
MYNSQSNJ        : FAVTHT          IGNAVADQFK     
URFVCRV         : DGDUMMXEIQWT    JQXAHXOECYWWKYL HTROCXQSM       WKQDYJQBJKV     PXNXPLNL        NUJFPIXXKYJYGB 
TDLSP           : NIEBFSVRUGJAMJ  EUAWGUEANAS     YOJGWCC        
HPKRE           : QCFIUVPA        YWGGQGVP       
XFFYSAQMP       : FIMQFUQC        EORY           
WLTFJW          : QNGYDITHSFAMHU  VTSHQCPCACK     JAYEWXKKHVG     UYKTSC          XTWTTUPNYDY    
HVQKJM          : NKVXHWSQXJBKMUL UHJCJBCNJEJDQM  SYOEY          
PVSCNYUMF       : MDSVOBVTIGCB    WQANKQI         AVYPLR          BXRUIMPFQV      XIEJQCFBBNJXHLA VFMTFMQ        
LADEOTH         : AUFLOMAHYS      CEPFAQ         
HBRSAOAXH       : KMTFOGBGO       MNOYLLKFRN     
KTPAPLFGKAURDG  : OXXKLQIYE       FXYU            JGCW           
JNJFUVOVPHYE    : IUKBC           XIEJQCFBBNJXHLA NEOKEIFRNHNJQA  VPJJIYIJKDAH    QDITUB          PXWJGSL         NRIMDQAMXISK   
WOVHIMKBX       : TEKL            JUIRLBKUUXCIP   ESDGCRC         SKPSHRDXEKRCAC  QPDAIEDQHODFW  
JKREDVMXHAH     : DVBGRPARNTQREK  CYEHIGPMVQHRYLW BHJSAW          JEQVYFEA        THCCBDKXYFGEMJS
UGBTVKSD        : ATPBBQPJJB      OOCMDVDS        WTOKCAI         JUIRLBKUUXCIP   UGKVEJBJSU      DDKLPK         
RRNCACODCGMNXQS : XJJORDEMEXWN    XCYMFFKQRSTF    ETETLIYFAXCDE   LUGYS           LLMBNV          YUQAHTBULKGTVJ  EJSAIHUPMTTTMOA
ESDGCRC         : BRPCFK          UAVXMIQWHUMPP   WOVHIMKBX      
SXFDSKWMCN      : DNDAL           ESVBDLUOVCSJDP  HCJKVICQK      
CRFIULWKKOD     : BMLJNBTNN       PANG            VHPPERDNK       WLYUBDNVMN     
UXMBAEFJAFQFXB  : GMUEULJFYMKY    PXJHVYJRXTAVPJ  DTBHMHLO        HISTUERGY      
NFSCJ           : SWEGPKRYEQKQ    TFPS           
KRFV            : SSXVGS          KSVPHYFPIU      MRSKJAU        
RGGU            : CIPPPOYVESWQR   JRCVYXGSERI     OLPSFH          ELTSEOCLPDA    
BSCEVIK         : CMGXJFFEG       RKMHHVLEFWMM   
IRAQQDVE        : GBXFIAXIVHPLSJ  UJTAUCAYK      
OIRBSMHRCYX     : YLCGRSQFPDVQFCK BGFALNUVOWE     RRQRRNVHIQOK    KMVROGE        
WPLRTRPDEWNWWE  : TNQUJGDQCJWN    SUXWW           ASTUTF          HKPCJBEFTEHUWGC THCSJEVJBTC    
CAVKQGDS        : AHBMOXC         YQLYITMQNETMMB 
PCRTDREAK       : BCKG            WSXUNFTCUWSO    VVNLDYRTIEJIQ   XROP            EMXJNIOSB      
UEJKJOKXNJCDMFB : GSRTLALYPH      DQTSCBORDJ      ICYAKJPFYNSXD   UIIEVWMFGH      YHFODVYLJOPS    NAFAEGGKWKQ     TMPVFMHLNCUD   
VHCOJTQDN       : HUWLJ           YWVLJUFSB       IRVQGU         
VTWGLTMXH       : EAFLORY         FTJOXGOBFSOWJOV LMQRURAVJIUYF  
ORUCBYHPGIN     : AHBMOXC         VGRGHILJ       
PPTAKNDAKBUJJG  : IPEGROPHBCO     YQAERIHXWPIR    YYGSLAQLT       QXQAJAWLEVT     OFVQIMY        
YENVSHSWK       : QWRATCTHDED     CDUHNLPPNYB    
EBBM            : GPHMEO          WNCAHYMJNUQE    MMVBPG         
GFGCHSPMTCOOMAW : KNBGTHBFJQLI    BPFRYQDGWHTPOT  STUJSOOL       
YEIUWPPUAKBBNQR : TFSRU           CARUUDXGF       YAXQTHWNRYEY    KUNKBS          SKPSHRDXEKRCAC 
VYXDTQPNS       : XAKJIEEOLIDTM  
EHJCCIG         : ULSNLLDIOOODB   YFFYTRNHVU      SRJUW          
GFCVCFIEGV      : PSGX            IUKBC           UYXIJGADOW      GJFAC           ABRJ           
BRSCQXVJPK      : QBDYEYMQW       PANG            HSPMETJ         MXGO           
WOMGSO          : URWXTBYD        KEXCT          
BCWJGVLL        : XSMNCGICAVNS    RXMNFB          SOMWOVXGQKJMR   WQGT            SEQUJ           EINVVGRCUVO    
RUDOVWJXPHTY    : CLWITXHBLUEQ    DJYPWETYSYPHGT 
GEYXQHSHXULXES  : DJDAIMOQOM      QKINPMYGPI      HIXVHNXWRQQ     YOLDYYHXXOWGJT  AVYPLR          GUDLAQQGKWNYA   PBRLEV          KQQG           
RGAMBFDYDNYS    : RJFOHTSNO       KJFGQCXHF      
VSWCWVCPF       : JAFLFIL         SBHSYWUO        AGKOSQFRFPND    RLIYMFO        
WESJ            : SULCGLYGCSOJ    CKVTBMQQXX     
YEAQKAFOIJNLWNE : OSQAJRFYYB      AOHOWSFHWYH    
LYVNXRQNAO      : UTFMQYD         YQLYITMQNETMMB  FXOHP           MXQFCOTYDKULUF  LPGXDROGY       OCRXQTDKJGUPRM  UUVLLEPM       
EHWKGBKY        : JIHWQVIJT       LJBSHHJYTODLGV  QHOETQBJEETKGG  NNUWRCFGNSQ    
MHEUQUG         : LYSSRRFNUUV     FYBXAV          UKQSVALFPPTUFF 
KNLVMHJN        : MUMPNTJOKMU     WAQBKUSYOU      ICIJBR          IMPFRLTFYYWHPTT
CBESMIALUIOF    : BPBW            CVEKIQUIPAGHXH  LPADV           KDOJVIYOYL      SIQIKF         
FRRJNKEVAOJNMYX : KTWKHABWCA      ATXJWYFL        QXQAJAWLEVT    
MCBNGUDQ        : BMLJNBTNN       CPIJN           LTJXLFQQYW     
QLIGSSLKMWAYC   : NQBD            JLGYQEWHVGLE    PPKCSCHNTNV     PIYGNKFDHLYI   
BSIOG           : ADJUNVVHVAJM    VQHY           
OFVQIMY         : YXLHLYAWEPS     LBWSS           PPTAKNDAKBUJJG 
RPDKDLQVE       : LTYEKAAOSWI     KITQVQKQGKY     CIKDYY          IUBACSOVSXE    
JSCJRGISYTJHD   : IQQAYIHWVVB     JETKDPSLIAJBEPF OOPCGKFOKUCASK  KNRUUAI        
OCRXQTDKJGUPRM  : LHXHEPRAMY      VHFOJNEIHUXO    LYVNXRQNAO     
XSUQUHKBR       : LWSB            ULLUK          
DLRMP           : LRGF            CNSWLGTWQUQXK   SBQHMFYCYLEGYS  FNBTLOR         RYXOMCMQFYLHPM 
CTKCKEFU        : UMLYPBQU        ESIL            JRCALSULUJ     
MPIEETDXR       : UTDSYOUYYSIO    TFGDUMHVK       GXKIDYQOREO     NGNG            TMFGYNE         MDYFEBGHSDFEIWN PYTCCKCBACBJVDU FLCSUIGNOJTDK  
UBJYSQEHIQ      : DFSXKQPMBTGLY   ALMSHWSRCPLJ   
BUSMYD          : ONUQOGPIPEF     QKFDHNX         BXLJKRFUNX      IEIRLDGQJABRQDA YUQAHTBULKGTVJ 
FALRRTXWQ       : DOGVAJPYLGA     LXQVUPHJNQWB    TMFGYNE         ACNILP         
WKCTLLSE        : LTYEKAAOSWI     DGDUMMXEIQWT    NOLMHFCPT      
WLLQ            : YGWVJFKBEOU     QRQOYBBV        OFBHWAJUSLKDXI  XEFRELATFBA    
ONFB            : ACJIJKTIFJ      UXPICRJA        MVTGGYIJHM      GWHIUJBHCDQGNF 
IWSKK           : MBENVIKUXKLQO   AEQGCACINGKW    VSJHJNUJNSXIEY 
DHKCXQBISUVGO   : DVVTKSVFRAXGAE  UTDSYOUYYSIO    KWCOXCTXNHWF    JSNJTPGI        GJBVYJ         
INQVGDLWJOKTNFF : KGGMTGXQNIFUDH 
TIIGMIWNSPI     : CHAQUDFTDUT     KRSTFEYEKV      ERWYTDOPUBGTBD 
VYSHPJ          : WAWVRFRNJFW     BRGRLFWGRWX     TUBGLFKXTMOXCO 
VNQSWIFQXMXY    : RAQUD           MQMAUQOLB       FDXQIYWYPOCGM  
IJNURKIMBTBY    : TVDKTXQEECA     BCCBVKSHSG      EUAWGUEANAS     FLPKDRXKOQMBPAJ PEGIRCWQRFFETW  JICFHVXAV      
UGKGMHTFC       : EXRNFYSFUICJG   QMJHGWYBN       UAIOLESXNKQ    
PKMOWK          : WCJPAAAAFPIBM   WBAMKVES        ICBRC          
ETATQTE         : GUOIWSHKFVCJSE  XHXQHOSFOISIOG 
HHVKHSHPEOE     : NHIK            SLXEWDGPSESLNSF HDLWSJGNFXR    
KKREACSQAFHG    : HOCMGOGNWBFMD   EBCTWCCSIVVXCHJ
HASD            : HXJYLM          FCINGAXP        EYXUIWDSWFI    
UKQSVALFPPTUFF  : KBFRRUBUCFUITH  MHEUQUG        
XLHCGBELIKN     : GLYCCPU         ANUPUPFHEKH     XYNAICVBCM      CTAWAOELTCXP    TNSD            HGLCJCMDPWEA   
MGUVBGMVEOHJE   : YIDYJCJJ        IMDQNHKADYIQ    OXHCQLC         JQAY            ISSDTOSOJXLN    VRFSUH         
EBHLIFYSKFTOSEC : RBXWHRTPYMPD    KFDNCB          KEHFD           DHXBTRBFUHN     WKGVKDNJRMF     FDYOCLODSKMK   
VOOQMPYBLDPVNU  : MNHSAXV         MOCUVRTEINPOO   NHQNXQRSY       VJDVFGLHPWNV    QRLH           
TXDHJLIEVPA     : IFFTTIHSWBLA    FJKFLRJOIDQ    
IEOPAEG         : GAAUPVXNU       NOUQCHEDPFA     BUNK            HBNCAMGDVPCL    EHFXBPHDMP     
SWSUKVKILHGHGKQ : FIMQFUQC        EJSAIHUPMTTTMOA PYTCCKCBACBJVDU
XYVVOVIA        : YKNHIY          MESKTSBDNTW     OXCDAATUGOUD    MXGO           
XRCEXUW         : INHVWYIIMFQHRU  MVRXXEGHGF      FYUNRIQCL       WMMIUDOVN      
NRIMDQAMXISK    : JNFWBXXCWHTQ    NPNAERSXVYTSE   JNJFUVOVPHYE    KEXCT          
KKBGI           : AUFLOMAHYS      YOJGWCC         HGLCJCMDPWEA   
EQREQJGW        : SHCCLKLAHYWWHG  YCRQDQU         BLGQO           YKMTA           SBGGMKGJFEFW   
CUFROPETJFHJ    : PTRPYRDQ        THSPEEKUR       ISMVQOLAIDMTSBY DINWXNBF       
CVQNGTVQM       : XBMEMHWIIBX     FXMNKDCQVURTR   DSYE            OMRSOFB         VPMHK           NPWHCU         
JEHBQOAYSUGKMWR : XYOXVMYRSU      PPERNKAWYTK     PMMUWTNDHLS     EMXJNIOSB      
GYPROSNHIVCEMQH : RGIAASUELF      LJBSHHJYTODLGV  HQCCCKOA        CTAWAOELTCXP    HTKJWALBYVKC   
UPYNGA          : THSPEEKUR       BPTTGSIGTPE     LURXIWNBEMSBFFV RMWSVMX        
YWVLJUFSB       : WAWUHH          VHCOJTQDN      
IUUDIDLEHSQXAOU : CQLNDPPFWRWQ    ARYYEKCK        NUIDGAWNJNQ     FTJOXGOBFSOWJOV
OJXOXYLTNXOSQR  : SGQFAGQU        HUKHNJKLHBX     POOBFF         
BOUFWAQDH       : EJNAGFVYFI      HFPY            OCLAYUOSJYMJVQR
VHMLDECODQME    : MVWPXXNFSU     
JRCALSULUJ      : UOPDHHGPXGMAW   GMEIDVKUWLMRX   XMQMWEMHLWDVK   CTKCKEFU       
AJHSM           : YKMABFPCRLJ     NQBD            KMCFOB          BXRUIMPFQV      NAHVWFYVARUDPP  AAMMDLAFSYQQSA 
DJYPWETYSYPHGT  : VPBFJ           PRTYLLMMUR      RUDOVWJXPHTY    HDFMIBHSKSUSVJ 
XYTLRQWOCGO     : NBBPQVJFEOG     QLUS           
PIYGNKFDHLYI    : GECABXCC        NQCDICNM        SQVBFNPUG       QLIGSSLKMWAYC  
BAMJV           : IGBC            OKLNLFD         FEOQTTGWGIB     MVTGGYIJHM      RJUQS          
HUBVNRSCUBTG    : FXPWJWD         JXOUYNSMSIV     RQBYXKUMB      
EHXR            : GBXFIAXIVHPLSJ  FXOHP           ONAPG          
FWDRX           : JKPU            LOCEMBTFOCGFKVF YENHYVOHHXHDHPT UIDLCFRUTVVVTX  BLQAPRWQIYAIOH  YXLHLYAWEPS    
XYLK            : XYYRHWQKN       ETWMXPQD        NQJXOUS        
ISSDTOSOJXLN    : UGUWGKRU        IJBFASKJBQA     SFYCRSOKJTNC    MGUVBGMVEOHJE  
TEXCEPXKOCEMNCO : LEKBESG         ISXY           
NYMIT           : IUBEMYJLLCOKL   DIRYCR          FVFMBFY         HJAWPTDEE      
EKLSULEKFYOD    : AJLG            QJBTYCOYFUD     OHTQBHVNM       XTEYAEALLVPHFOF
TUBGLFKXTMOXCO  : RJFOHTSNO       JSNJTPGI        WNOLJFYFQORBQXX VYSHPJ          YKCPT          
MKCRVPKSDRD     : HREAJAF         HISTUERGY       NAKLDYAVIWQDYGO
SRNVNIYT        : JYMMKQJBJLCJ    CAMQDLDMC       LNHL            NBKDCCQ         SJCOIXJGPYFSY  
FGUBVJBXALLLPFJ : HJYMIHLF        VLNELI          RKEYGTQOM       BLUWJODRJHT    
RCLJHU          : KDNVEQVGVSODG   BPBW            IYPFWQJREDIYP   MPEIWTOS        QDITUB         
YKCPT           : JRHREPJALV      ROOHDJ          TUBGLFKXTMOXCO 
LPJSMMOYNOBYC   : UQTVJVBHHGBPTXY UGKVEJBJSU     
QHXBACNLJ       : KEHFD           INXYC           EWGYKROX        EINVVGRCUVO     CGXVASNAO      
QLUS            : LVLUMAHPCEWWSO  ABUGGJO         TJEJA           BSXMOKPFNIHQS   XYTLRQWOCGO    
QWMJIF          : DVBGRPARNTQREK  PFMLSOQBMVOMN   PQQHNWAW       
UVWILYJNNDXOE   : GWLGNQSHRK     
QRLDEEO         : GTURTUEYGBOGPL  EGUPNUF        
APSWEEIKDDIAMTB : ULYDACDTGFNKXS  HGBWFVAIHIJSVC  DDKLPK          TBISM           CATXWIF        
KRYIIGIYXTCF    : TLDLEYYQTXNOSYJ PMCPWRESPPD    
SHBICANHIAKMIMY : GBGVTG          WYDT            EWUQAOF        
QWPIYA          : YAIAICURUMXDSIH MRSIWJODXTFVYS  JFOOCR          KKAPNXKODY      NUIDGAWNJNQ    
FKRFGWMHPTIBW   : NYKMPKMFSHLJ    OYGNRC          OBNHCOXBIATRLD 
OGRQSEYF        : BJMSFVYFG       PRUEPOD         SOPCWDXQ       
GXFXIGAYNKTURSI : FJQJJWLJRBGRP   FFQVPFEGF       DOCK           
ICIJBR          : CYVKHXULTFXUJL  LVLUMAHPCEWWSO  JFGENPEABEIAV   KAFICVEKQBVSL   XHJCX           PMCPWRESPPD     TNPMGCXYIJEOU   KNLVMHJN       
HLQCQSKX        : TGKGFCTFOYAYJ   PSFXVEFFBUU     YXYDDHRXXJGLSP  DRYBKMJYNLL     YOEQJQGCXBIX   
IDARLASYL       : NABMH           NGRRWUDOAF      OFDQJIQAGQURYL  LBWSS          
UFHFEQHMC       : CORMOKPDBVNXALP WFYPVXBOUICYD   LUDRHMIXNGKB    SKROR          
GFUSXXLSIJUSPU  : OTEEESBOEUDY    SXVTTBKJWMRSP  
BWEDKSAPB       : MWCJLKQ         DYBLURMOOFDRI   HBFBHAMRMHIGJJA NHQNXQRSY       MDXBN          
UTOJXAQDXLEVWWG : PHDRDNUCKDIGDMO QNDBD           OWOFAYQTVFRCYL  KMKMXPSPPV      BSSPRXMCY       KQTMNXOFLFX     JICFHVXAV      
RYXOMCMQFYLHPM  : YNNYMMQB        TEKL            FJUNRTMJ        FEOIWVOEGTVXLPP DLRMP          
MIBVHCOMCA      : FYKNALFU        DIRYCR         
XWQGGKHGAT      : AGIMTIY         KJFGQCXHF       KEXCT          
OKPNWWFLLRWNO   : HEDVLF          HDGI           
RDSTGMTDDCL     : MUWNEGRXRGWEUFO YAIAICURUMXDSIH GDNTOVHCT       LQMBTXRMTGS     MHCHPD         
JUPEFG          : MUMPNTJOKMU     XGMLI          
VUNUCCJUYWJFQO  : KGGLTYVUNSN     VYLUBEEKBVOUWU  VHPPERDNK      
MUOGBTIOKRJAX   : WMMII           PIPI            UMLYPBQU        NWXU           
HPNEDKG         : GWPGAEPAKM      OXAL           
TBISM           : HHOCVLRXHFQD    OYKFPWJNDJIEOLU APSWEEIKDDIAMTB
JEQVYFEA        : WOFFU           MJFLLEGIWO      MNOYLLKFRN      JKREDVMXHAH    
MPKHBMFQVU      : LXYVBLRYSGMDR   FONQNWR        
ABRJ            : AATPY           WQGT            WIGTPNBR        GFCVCFIEGV     
LMTFCJ          : FPVYWIRN        CYEHIGPMVQHRYLW
GCNFIRIKHAWOB   : LQCB            PBGJ            NHQNXQRSY      
VSGTYIWSRHFHBM  : FIJQAXPU        PPERNKAWYTK     DJAWYJLKBLQKVJG WJXRIYUUKLOX   
NDPPQUALFMSFJJ  : DGDUMMXEIQWT    IDYQYWGEY       JOQKISWOBQN     IEKC            EBFYMBBKDE      ECNHWKD        
THCCBDKXYFGEMJS : EUNQQUMYIMU     EUIOBQV         JKREDVMXHAH    
WVLPPI          : VONBUNYDAS      BTFPCPBYNISO    TFWWGWUOVL      DMOGIDUSGCVAY  
BOFVVOF         : NEBRQHIWWONXO   RGQRQEKUXHWKAY  OYWGD           YYLRQUFC       
IMHMQNXOMFWSRHL : RXTTVEUBI       MPSPOB          LLMBNV          SIQVCYNNEKV     NEOKEIFRNHNJQA  MRVJBOXRDFMGRMO QPRDJEOGQKNSXY 
GJBVYJ          : GSYGXIIT        IOPLCMGPCUWHMF  UNVSTPJQJB      BCCBVKSHSG      NIBP            DHKCXQBISUVGO  
CATXWIF         : FIMQFUQC        EORY            IWFNWBEARMV     RVLIANLRGHUUWB  PRERQECCQFP     APSWEEIKDDIAMTB
TSKILAGAMLXH    : MIMQODRPYXUGQ   ITGFOALWNCNES   JXNKOVIJTMTLR   LBLKO           CRESPGIF        RRQRRNVHIQOK   
HSSNCVKEGBGG    : QHMSVH          SEBCGXINPSHRDNJ LQMBTXRMTGS    
HDFMIBHSKSUSVJ  : AHBMOXC         FLACU           CIEIHYPSDCTHRE  DJYPWETYSYPHGT 
VQMDLIQPED      : LWSB            YJSPHAFLHA     
MEDTBMYJBHK     : IOPLCMGPCUWHMF  QJKC            GMBNDXS         NHKFKCJFMXI    
CWGWQCGXAYMDKUU : UPPGTUAP        DFSXKQPMBTGLY   WBAMKVES        DDKLPK          ULKMVPBLOS     
AAWOFCII        : GPUKUEHKX       CJHUGKIPSSL    
KRSTFEYEKV      : QNGYDITHSFAMHU  SBHSYWUO        AYVUITGPSOFLOO  TIIGMIWNSPI    
PFUPG           : IAYFUPVBUNIPT   QQWLSWHLCSCW    AFUTXVVWO       GQHGRPQ         MURVAGQI        LQMBTXRMTGS    
VRFSUH          : IMDQNHKADYIQ    SBQHMFYCYLEGYS  INUAITETBNDL    MGUVBGMVEOHJE   KNRUUAI        
TWAYHJPTDIO     : RGIAASUELF      XGMLI          
ONPC            : GTURTUEYGBOGPL  XTEWEL          PQQCACQS        PRYNHIYRJI      IXPNPVGAJBALI  
MRSKJAU         : NHIK            REITXPFALV      SUXWW           SFUMRXQKBL      ROOHDJ          KRFV           
TCXQMTMJTLSFCN  : CEPFAQ          RVWB            JIACFKKCAD      HDVBKGSB        QCFIUVPA       
KEXCT           : VCPKJBUU        ADLAISV         OFPGWIN         DKNBQ           WOMGSO          NRIMDQAMXISK    XWQGGKHGAT     
EHFXBPHDMP      : RPBVM           XMFRNFALDXIVI   LCRQVVUTLNATA   IEOPAEG         JBJT           
QPRDJEOGQKNSXY  : DYBLURMOOFDRI   YCRQDQU         NAKLDYAVIWQDYGO IMHMQNXOMFWSRHL IRVQGU          YWGGQGVP       
EAHXPN          : GBXFIAXIVHPLSJ  MJFLLEGIWO      PANG            SWRKCPJ        
ULKMVPBLOS      : YNSQMW          LAMJA           CWGWQCGXAYMDKUU
IXPNPVGAJBALI   : YNNYMMQB        QAFRO           GCLXVV          MXWU            WEKFX           ONPC           
LQEDGNYSY       : CWTJKPMRWIAVI   EBCTWCCSIVVXCHJ
OOPCGKFOKUCASK  : WKUPIIN         FGXA            SEQUJ           KCQAEWPQDG      JSCJRGISYTJHD  
FLCSUIGNOJTDK   : NYNUDNAXRKWYJ   MPIEETDXR      
CYDSQHYB        : HXPRARLN        DQTSCBORDJ      NCGLREK        
OLKSOGEQLRT     : BNBTM           MSOWASYWAPETG   ARNOPNCQAHCYWA  KDOJVIYOYL      TNRXMKKYIKWCDIF
MEMCTVYYJN      : AXHFCUPVAPJ     LPGXDROGY       VJLI            FMVAKFR         XIWHPLWXQSMF   
ITVYBXCQMPC     : QBKFFTJCXDNHE   XEDNDR          GBGVTG         
EINVVGRCUVO     : CGSSLBKYT       BCWJGVLL        QHXBACNLJ      
RMWSVMX         : FFYADNNR        JQXAHXOECYWWKYL BDRINRHHHUV     KCCRYNMER       NVKBYSVG        VNWSWUSMVK      UPYNGA         
GWHIUJBHCDQGNF  : GCLXVV          CNPGKWEUPEKN    RVLIANLRGHUUWB  HWQXPHUOQYNDYDS GEHYSQVDC       ONFB           
LLVNGUE         : OYQQOIKSPRJ     INGG           
OTFKRSIYYFIJ    : MVSFCVD         HQSJCOBFNLIBG   PYQO            ESDGCQEDUYLDHFM APKCQSOJQS      PFUQ           
ULJWQ           : HYGRG           KTCIDPKE        DHCMBVRFF       KOCRSDQTFY      XTWTTUPNYDY    
FHGKS           : WXTYEIREPJS     TYKOF           AXWQVYGTTEMYSU 
IJAFNHW         : BLXWIQMVYBOFM   LNEGVOEQ        PQAM           
MHCHPD          : ACMR            VLRVFJETEHJH    RDSTGMTDDCL    
XNUXIGKHALNH    : FIVOQSASSSOOXMW PQYMCNIBGQWYIA 
ACNILP          : GGBIBTK         QKJGRSIMXUGSHP  FGATYSKNWUR     QHWMNEMYFEX     KNBYJJCE        BJFQXRMR        YHFODVYLJOPS    FALRRTXWQ      
CWNLMUPVKUF     : NCJNRDCGNXX     CEMYQHWLSE     
JBJT            : FEAMXJI         HUXPBBYMSI      CNUCGFSYOMPDTRY NAKLDYAVIWQDYGO AKPQIOWGVXE     EHFXBPHDMP     
TCJHPSDPVQAHGQ  : HHOCVLRXHFQD    GXCOPNUYH       NQKUG           GNLCXTUUVQVKBO 
GEXUBNSOLY      : LLOFAEILNIACS   TRPDOR          OCQU           
UAIOLESXNKQ     : TMMOYOSLTCORYG  UNVSTPJQJB      MKCJ            ULQADNG         IIIXCRRW        NGGBSJI         UGKGMHTFC      
AOJD            : EYMLPGP         ONQSCT          YDAGWFCQIN     
SVKBDIXEY       : XQCGPNS         LKUFGRWPAT      WGTWHIDOVKW     HNMLXKQOHTHASUK CPIJN           RKTQUALK       
SKPSHRDXEKRCAC  : QRVVCKAO        WOVHIMKBX       YEIUWPPUAKBBNQR
TFKF            : CONQBBTCQK      WILA            INXYC           WSKBTQEHVV     
JXGTYJ          : FEOQTTGWGIB     BOPIPROKHGYAVOH
YOEQJQGCXBIX    : EIREPCRM        ESPGQLQYC       HLJJ            JRVYN           HLQCQSKX       
SRJUW           : SCQKAEAMJ       MVRXXEGHGF      KCQAEWPQDG      EHJCCIG        
OCQU            : OHTQBHVNM       VJLI            AXWQVYGTTEMYSU  GEXUBNSOLY     
CUUYWHEVV       : GBHQMMCCWFSLP   ADARJBIKWECJ    RRVD            TPECXVOUMXMNKLM
MFDVKBYUBGP     : RLHMVLDAQMLORN  GCIXPVBAWRWI    WKQDYJQBJKV     SARATUWFFEB     THCSJEVJBTC    
RKQXAURW        : DOCLX           EGOUCWEJXISLECT IERT            OVSIDRKBBAWVNYE
TRGSONYNLLATO   : VGIYOSJTPT      QVWOQNI         FEROXCONPIO     DQOWD           HEBGKY         
ERWYTDOPUBGTBD  : QTHVVBXX        DDCRBNGURAL     TIIGMIWNSPI    
AMHUSDJ         : MEJCUOUPESOXK   HJNX           
EWUQAOF         : KQFLI           TMLIJOGNXGVQTC  SHBICANHIAKMIMY
SXVTTBKJWMRSP   : FEFLJPNB        MRXUR           LWOAXK          FLPKDRXKOQMBPAJ ENGUM           LTQVG           GFUSXXLSIJUSPU 
GQJNLEQWNVWJO   : XFKLIYFVKBTJOO  GWPGAEPAKM      GNVN           
XTWTTUPNYDY     : KFRWNVEJBVR     QVWOQNI         NWDALCNOMENKROR WLTFJW          ULJWQ          
PQQHNWAW        : AGYQHBXVT       JQKILWGS        USFANAATTWQTNRO QWMJIF         
NCGLREK         : KITQVQKQGKY     YBUGE           CYDSQHYB       
SJCOIXJGPYFSY   : VPJJIYIJKDAH    SRNVNIYT       
IRVQGU          : XNTLUTFVAWGNQQW QMPCEIHECUFNHT  VHCOJTQDN       QPRDJEOGQKNSXY 
DHHHNSARFD      : BUXGAB          MFOFCISVAHBXIR  WMMIUDOVN      
QHAYHLHXK       : RBUE            BXLJKRFUNX      NGNG            GCHWCBMT        PIDLCRDCJSV    
QLTCEPU         : CMGXJFFEG       UOPDHHGPXGMAW   UCOPYFISKW      JDIWOXCHAJLJINM TMLIJOGNXGVQTC 
KNRUUAI         : MCMRN           OCDAEBFT        CJGDPKVEUPXKAL  AKYHJID         JSCJRGISYTJHD   VRFSUH         
CDUHNLPPNYB     : RFYDHIXDBFSG    PSAAIWGETSKQC   YENVSHSWK      
WOMQCGSIWPUJDNE : XAKJIEEOLIDTM   TEXCONTBXVQK    ICFAFQBL        ROBXBXKRRNVGCF  INGG           
PNQTQO          : BUIIQQBXPOQ     OMRSOFB         BRPCFK          OKKWHH         
GCSY            : WQGT            SGQFAGQU        GQHGRPQ        
SCNRQA          : PXMFPWXVAOQMO   QJBTYCOYFUD     NUPLCBPPAXTIGOX JEVYLUFF        LBWSS          
VGDEFSAPY       : GQSQETACWXQUHEE NTGBUPJ        
TAFJQY          : SYLVDPRUV       SEHAIYPYHYFDQKM CJGDPKVEUPXKAL  EPKTNGR         CDJSPJDUE       ACSFBX         
HCJKVICQK       : SXFDSKWMCN     
IERT            : CAMQDLDMC       KGSBS           RKQXAURW       
YWGGQGVP        : XYYRHWQKN       XSMNCGICAVNS    HPKRE           QPRDJEOGQKNSXY 
QPDAIEDQHODFW   : HMJKDGPNMXVPM   BGFALNUVOWE     BCKUJGKXKGHVKAO SATVXNEFIDI     WOVHIMKBX      
VJVGPPARQXYXQFT : DYBLURMOOFDRI   HGOK            JPWXXMWOF       JPFLLNDR       
EMXJNIOSB       : AJLG            PCRTDREAK       JEHBQOAYSUGKMWR
HEBGKY          : BJMSFVYFG       BFKJQNYWMNYROL  HIXVHNXWRQQ     HTSH            TRGSONYNLLATO  
IFGXIAPGYNWHJF  : EXMMAOHUTUCBMI  CMLMLIN         QRXKAHTALB      EBCTWCCSIVVXCHJ
WDUMNLFPHOVKU   : OYGNRC          ACHC            OXAL            FEOIWVOEGTVXLPP
LMQRURAVJIUYF   : JELWQTU         HAAFKGOSU       OFGAUDMTTM      TESGFYM         KWCOXCTXNHWF    VTWGLTMXH      
IMPFRLTFYYWHPTT : KFDNCB          WCJPAAAAFPIBM   OOWETGPOLPFK    KNLVMHJN       
CGXVASNAO       : XSUPEIDRTPRLJ   KTGEU           KYFMMOKNFLOG    EJCUHABBMNNFEJB QHXBACNLJ      
KMVROGE         : FRBPLLEXXHENVQN BMLJNBTNN       LTYEKAAOSWI     OIRBSMHRCYX    
OVSIDRKBBAWVNYE : LVCXX           GLVRLMBAAHCOSTU QVWOQNI         RKQXAURW       
UEGIGXHQK       : WAWVRFRNJFW     UALGLBXQHKVHHLV FFQVPFEGF       DOCK            EGTOGEQAJYMA    SUHWOEXEYAGHAMN QRLH            KGSBS          
IBOOGDMBLPT     : BQVHGXIRCLNISP  LXLPWDXSKDSBV   HTROCXQSM       JXOUYNSMSIV     MMVBPG         
SUYPSMPW        : WCKLOEEVGO      HOVJJHQHSTBUQ  
KBGVHGFASNIUCY  : PIPI            XLSMGJK         HIWDCU          FPVYWIRN       
FLFSCBPU        : JOIHHVXPG      
OLRD            : HKQEYJJERK     
QBPUJNCQVFLJP   : DJDAIMOQOM      UXPN            ITINEELUTT      ELSYOI          MPSPOB          LTRUSWKP        JXNKOVIJTMTLR   CJGDPKVEUPXKAL 
LPKSBRLDSDBQ    : HUWLJ           KTGEU           RAHAUGF         ISIP            GIUY            JACBWFEWL       EWCQFKXKVSSW   
OKWRCAJWMXBFTG  : LHXHEPRAMY      PXWJGSL        
FWXQMKLNCYT     : BMECGGKQFVHEJ   JQKILWGS        FXSMJUHJMTXAO  
DWPYLB          : OIPALFPAGVYTTO  EMSJGWKHCFDHG   SARATUWFFEB     AGKOSQFRFPND    NGGNXPNUJIJRJ   NPWHCU         
FDYOCLODSKMK    : FSEWTMI         XYKPAMRDKEWRW   PAVSPVC         JPFLLNDR        VVCCLOYQOWHXCDN GNLCXTUUVQVKBO  KTKSSMJSDLDGJQM EBHLIFYSKFTOSEC
LKIXU           : XYYRHWQKN       JOIHHVXPG       YHVQUXMGGJXMARG PODLFRA        
NYTJXYGN        : JPJKMIQDFWOAT   SBPR            QRVVCKAO       
TOWYTWQVKFCEQQ  : BOXSVQDOI       INUAITETBNDL    AKVG            KGSBS          
ICBRC           : VWOAQI          BYHMSIYXPWUEWM  IMACXWWXTLDON   HREAJAF         DFJVTFIQ        QPJH            PKMOWK         
NPWHCU          : YKKFPHVLCP      CVQNGTVQM       DWPYLB         
IIHDX           : MYPWI           VONBUNYDAS      PXWJGSL        
ETDUSQ          : ACMR            JIHWQVIJT       HUKVKNLVFS      UYXIJGADOW      HUKHNJKLHBX     KSVPHYFPIU     
UUVLLEPM        : LLOFAEILNIACS   EDHUBXWIEC      WINFLDQHKNYKXYV LYVNXRQNAO     
RKMHHVLEFWMM    : ADBXKSLCIUP     BXRUIMPFQV      BSCEVIK        
MSGH            : VFYFYNEFEQS     VVHPDVFSVTGGYB  DONERVCRMLPDCV 
ECNHWKD         : YJKGSYHYP       FEEPJKG         EGTOGEQAJYMA    DINWXNBF        NDPPQUALFMSFJJ 
