SYQNOG          : GBDSTHSCITICK   IWFDNULDL       RYXNI           UJELERP         IIVUD          
RYFXETJI        : QRGVJVRGSBNHJP  LNHJWKGFKKRI    AUASRSQQFQDWH   MRGDXGPY        QTYPORIV        XDJTLRPWXATFHV 
DLTCJHPPXUN     : YPPBYIP         TFINFVVGYJVXMLR PRBVYKULU      
NVYGW           : VECI            ORECVB          GWNNWBA         YLMSCCYEM       ENQPYDGSPWGMK  
TNYCFAHDEBOMJT  : CLNKA           VOJABBNMOG      OBQOSMXYEIDWWIB BBOYNHSVHCH     WTLFUPLDYYV    
FYJNQBNLQEY     : HAJTYVRJA       OROYBPFRBC      VWJYWXOFTKTUD   HIXSGLKEOKXKV   NMJFGAHCOOH    
GHMYD           : NDXDEAGTPDY     CUXB            WACWNQIFYRUSBT  OOXNGGMOCN      MVSXNC         
XFIAONESDSCYVJX : AJIXALRMLMIVWN  JIFMBQ          FEYXXH         
WOJKCARBPX      : CYATVBL         WCIKKIXFH       MNFONUOTWRI     BHFBUMXJ       
CYOEYTMYLBFE    : UFLARDNGSNPF    CDUPTWKUX       NCKOURXSLTWR    LHQSYCSDHO     
XGFVPGCP        : PCYR            BKTY            FFBSCQFML      
NCANVD          : OUCOXUIFQYBSJN  HFDQYNKEFV      CADBYDIJR       UMRNVKSGAFNLHX  KRGN            VLDKYJ          UYGWBL         
VOJUDOTYDUKGAO  : BSNWUGEFSUR     KIRQEXFLOMHEAEG
BWUWPDBFCOJ     : ORGDXHEHCJ      LNHJWKGFKKRI    HFTSALDGB       JXKRLUVBHWNDRSG LHQSYCSDHO      FICVKGY         HOADPX          IANLM          
FIIKEWUACJVB    : OLCXCM          YAGXCF          XDGXE          
TOVTFKU         : QTWSIPNHAQCOA   POXLPWSAIJUE    WTLFUPLDYYV     SANPFFLCNTF    
FSSKTANJLPQTX   : BRYKDOIC        UCYDSMKICEQDW   WTLFUPLDYYV     TELPUTXYC       LAUX           
YWVBYHYDWS      : WPPVSOLX       
UNYFKC          : XTEWCJ          SCJDTRBPBIRBDUK CLEUXA         
DWXAWLLLECF     : HFDQYNKEFV      JKEXVTW         CDUPTWKUX       MXHMWQTEOQI    
DGCC            : VNWDTSE         YDHOSWQ         VWJYWXOFTKTUD   WDNBSKGLVF      BRWSHJOWFKAMUNT SHEUMPJHUJTVHHW HNLW           
DLJIICCFR       : VFBMEOQFAUQWWSE
LDGYIEWIDJTO    : NATOWPBYIVHMKF  NJIH            XDGXE           RSVMLDBVOMHH    LJXWUF          EYHFISKDYWHL    IQYQYDU        
VWRCDVENAP      : PWYRIDK         BTKDFHMKMYDJT   IHISJHIPXGY    
IBBNG           : UYYAEIM         FRYLGTVACXLWT   XXMEVRKYKT      FQWELMYVWILHTA 
PTBVSJCSUGCOWRN : DIRC            XNPRB           DLWGTGBAADCHORV SASJBSP         MXBPYD          PFDQGQHG       
LPAIVN          : FTMEEIUUESBID   DJSPNCSAIBBOUI  JRPPLG         
NMUQPI          : AOAAGFLWDF      WOPMCMH         CRNFWCJJGF      FCDAFMISH      
NATOWPBYIVHMKF  : LDGYIEWIDJTO    IUVH            WJETCNECHF      TPYKSQUKVDWP    SVCLBODEGA     
AYPPYANOMC      : GJXLJX          VSICSEKMXB      WKKRCHWNKKLAW   TOMTFIJGU       GTEHALBEQY      RLUTDVMJ       
ISVQSJRPB       : LWLAPHR         XNJSW           WHTIWGTERIH     ISNASWDIIP     
FCRNAAAKFGLGXDI : NMKVTEMFRJOVVMQ IJTCUYDTO       MXBWABJSR       LYCNSUAULNSN   
TWLVDVQYP       : FHWNCSFWTHFTLL  OCRXGSSI        WLMRNQDBX       CRQIBXBS        IGRYHDUD        QNEWWMICUCIKMTU
KJCLAHPTWP      : IPJD            BGDPRBP         VOSBLNQGTHE    
YDBFQK          : JHDNVGEMSHCLCUP KDWOI           ETMBUPA         VWFFPJN         PTFJ           
VSEPRSLWOF      : HFGRBSN         TEKGRXUO       
ERJNVWPFNMCFI   : OBLENGTG        IVWNUYKMWO      EKWHCVOR       
IMIBWNXRUNL     : UQTU            YOJTEPJAYAON    EHAPONQVBN      FCDXYDGRWHNY    EJEBTUXKTFFULGI
CJEHHLBQBWOTEE  : EQEEWQWJSQKYSKN YKKFIBGL       
IJOLUBTVAJVREKE : GQVBEAKI        MAEGK           JNFQJJJNUJTRBJ  NDXDEAGTPDY     PEXXD           UCYDSMKICEQDW  
MNYVWMW         : NOBIWPSA        AIGNPHALOELU    KVKWWMTHJWTOH   MKNSAIWLFYI    
NVDHAJNISFVPG   : OTKGHMNAKADC    MSTSNQONI       QCGQQNVAUWPH    RDINMMM         LVJEGBBKBELUGUH
MHBIBGU         : VVYKOOAKYX      RXBTPIUMRTJBY   JAWAYSAARO     
AJUBFSNEJE      : KFCFEDACSQIS    CCDSDDODMPWXEF  FXMSARPSOVYAN   DHOKMXGFRIJPI  
OLCXCM          : FIIKEWUACJVB    XBCPFWXVOP      IYWNE           TKBOS           GVUY            PXYQPE          SNKM           
JIHPAVYCGBKEIM  : OKIFKBCDXBQOX   NGNSUHOIBPXV    FYCPVARVLO      HQMEMU         
GQVBEAKI        : IJOLUBTVAJVREKE RQRQD           VKFCUIJHT      
BWHYBU          : WKCIJ           MJMCGFXN        CCDHPKRWWHHFX   ICPEA           XEYEKJNHFQ     
KFBCIYCMGFW     : QRGVJVRGSBNHJP  ESNUSG          QBCEU          
NLAVCVWJYJR     : WCNXDPYDIFOI    EXTYWHKINSVIEV  VGBOSUJMRGW     WIVAY           JKXUGTIERRKU   
KQLLRIEEQFH     : GYGFRK          IKLX            EKDHQKWPUH     
FLLNQKAGX       : BAQJYIEBFEPQ   
FBYCKXOEE       : LLBFMEB         GEOLKJKQF       RTTJLTYL       
VPNPBRURWE      : BRLUVCLBTCF     IMTJSOHEHTIAF   OTOPGA          OELXFVKCLCECVEA GQQOKCLCY      
EPER            : IMKKAL          LHTLUXTAOQSQ    VMXNACEQMVKYF   GMEN           
OROMUTP         : YGLLTNJDXW      QIFXJAO        
YATPHXQFPGWQXTI : UHLNQYQNPMSYLUR WHVRQJRTVCD     VFCWBIF         AEBBNYSFTJKY   
XBCPFWXVOP      : OLCXCM          DSMRVCUGEATBF   EDIHNPPN        CLEUXA         
LLBFMEB         : FBYCKXOEE       WPHOBO          EIKYPH         
NYVSPCPIDKRBK   : BKGHQWLU        CKUXFDPEEIMLJXN FCDAFMISH       SFNLHSAOJFRU   
FBBEYWV         : HXPXIAADPJHWWO  EJEBTUXKTFFULGI FDYRBMNLFUUSMOJ
IHDMPPSQUGS     : YFAOFGO        
YKSQSXBM        : EREBCXONIU      HKISSXRWGIBJYU  LRXFIUPK        LGJLCPKTSY      TXEFFYLY       
OGJPJNQGJIRRNG  : IAHRLRLMGX      RDINMMM         RGTKWK         
FYAA            : CEEVGCK         OVDUNPURU       BYMDTVTGGYQOIPB GDQAP           SJAC            NTQEUVBLFIB     YKAYDPYQXEE     WAGXCPFWYJU    
SQGDMWY         : BEPXWIPFH       DMIMGDMEMRSEES  PTFJ            KTXYAJWRSSNJH   AIGAWOI         VLNMG          
BLMPRVH         : SMYPYWDTELYK    PPAIQGR         AHIODIIHPIRVN  
LXKVIE          : BGHFXFCNCYMMSU  UYMSWL          KHAGXBV         YRILYSJBNCAO   
VKYCLBCSU       : RFMKDE          UJWY           
YAKXYUBLJS      : FRBREVMTS       ERJET           WHNKPDFMNVWO    WLMRNQDBX       GGCADMKGL       RHJUVWOK        DUBDKXNFT       SXOAD          
HAJTYVRJA       : FYJNQBNLQEY     TOURAKSDWDGDN   ONRCFIM         PTHCHWWHFVSMUD 
IMKKAL          : EPER            FJBKW           PWXIPRBVBJKH    ULEGLVBEVWB    
SGMTJWRIS       : PRKRKL          YXRMAMOH        QYHAWVYFMM      CRGDWABJNNE     CBCEAYYTAFVNV  
VEOCOPNIQJ      : WJSWCNFOKCJQ    YAGXCF          BNYNKWNJX       RMNV            YMTXRDFAIGF    
CLNKA           : TNYCFAHDEBOMJT  TLOFDBC         CQGQN           LMIYGVOFXSB    
UAJMUSYOCWIMRE  : DEXJVM          ALJKQTL         BXUSQPCPN       POAOHPOERPBJTNC NBJLUHRXHONUVRV DEPXEYTFGDML   
XVNMN           : CCKFPSRQBWBG    WXIIVQCH       
WEOBIAOTCMQEYDY : CSELXGWQND      NDTQMF          KRBNGYRYEL     
FNVEVKXDVVYJLMO : DJSPNCSAIBBOUI  FRYLGTVACXLWT   JBTVMYWWKROBBT 
SDKBFYUHOMLNR   : VYVWFHILMYAPGPM ETNPL           NVTQYTKRNUND   
HYAFDW          : RWCKCFWYMHXPH   UCTCTWSNX       CRQIBXBS        EWSXUOQWHCRQE   ATDHGLUHMT     
DCOCBXNPPVI     : NQSREHNXB       GPWQVHHTXQ      WPQGPNLNBCJBHX  YJJLLBJ        
ILYIJGYVUOPH    : MTOIHSRHEUH     BRLBSSWMF       LOKKQR          CHJI           
RIDWHUB         : NJRDWMCNIAALH   NSQENKHKAWRR   
JDMKQCAOMU      : SCJDTRBPBIRBDUK SOCCDGKSC       JVKWBCTCVAKBB  
XTIHDHFXVXFT    : HXQOHXMEEV      DVENT           IHISJHIPXGY     XBCMXOORBNKFMQ 
PYMWVPGGSSS     : MQRI           
WSBJ            : ECMTLTR         FQLMSCMEYNXVSLO ILWOPA          SXOAD          
YKKHTPQ         : CGQWQEFPVYFPT   JRWXXUXPEARNDV  XSNC            IOJJC          
NMAUIRLJGKFW    : BDXQYQWTMXHRJI  UHRTLWYCCP      YUUPXY          CIBRAGYNINJP   
LPKGC           : KVVUGMEYGBUQTIY DPMD            QYULMCTBAUFXTI 
BDTREGCLB       : OQIRVX          CUXB            TGJXJKSN        IAYDUPDPOXQWKK  UKHL            ANVSRDMXIHVDTA 
CDHQFEB         : AODUPUIJQ       ERJET           XMYHQKKVSOBK    QSLFI           EEDTGTKEYWGS   
RKFDRCWGUJMY    : ANNDK           TRPJBQ          BJRF            WKUODKFKH       BOQVEJCRMHMW   
OEQGKWKVXE      : TQGOAVPUKVLSGIF PIKAPWLVSFLKHB  WSIKHCISKJM    
DNSITVHOIPR     : UHLNQYQNPMSYLUR LOPUAXOFXQP     NJWGQFPI        QJLAQSIFDNKE   
TQGOAVPUKVLSGIF : OEQGKWKVXE      EKQTSVIWJ       ETMBUPA        
JJGMYBXSWFH     : JVGFIBWAHQ      AWKTDJDISWSXX   ULIITKB         RRNYPRLIDVF    
UBIRRQ          : DVQFUTFMW       SJAC            NBGARV          NHCDEBJFEDQWG  
SMYPYWDTELYK    : BLMPRVH         ISTOPPBIOLP     FYCHDHRIY       QCGJA           LOLXXMIPKPSA    HDVJAV         
IRKJU           : LHQSYCSDHO      BNYNKWNJX       SHPTDGVO       
DSPMANOKFIE     : RJXMD           VTNUVHGDXNV     VGIWQSFIPBJI    FCHKKTYNKI      TKOPITXSL       LAMLEDIYUP     
DQOSSMV         : YQEG            SHMI            CJBMGG          GSFBUENXJMQGR   IDYKJRPQ        KGFBRFEBBFPB    HOFLRD         
SKMFHW          : MJMCGFXN        WASILT          JJFMPFWSFHPTK   SIFO           
THUC            : FRVJNLSELQOXV   GOFXEDIQDYMJ    OGBRVEMAFH     
PUYRIPD         : KUMBHI          CKVJKYLCWCC     ETNPL          
YHFC            : HWUVYAUHSITNKJR IWCEDBKCIYW     JXILWKAJ        BRWSHJOWFKAMUNT FHUL           
UXUJT           : NJQSRWPV        LHYUAKJHVPC    
CGWJOTJIDE      : NGWGRDOWGBP     XQYQS           VFVMNQVMCA     
PTIRLSJQI       : VSXVBPT         NIRINOUOSHEKOXO LJQIJPQHWJXNFLF UYYAEIM        
ANNDK           : RKFDRCWGUJMY    QPOHUMMS        YCNEMYKIEKXVGT  OGBRVEMAFH      UHHJUPTGXWTQTFU
XTHG            : MINKSPSCU       CSATB           ACLICBDCUUU     DEEQHTFTFOY    
ODIFARPDX       : LNHJWKGFKKRI    NXFFOKFVXULH    ELVDXBNO        RNRMPVTUFFPGAT 
VRNPFGYYQ       : DLWGTGBAADCHORV CUPXHF          GGGLFIRDNHLKJW 
YFACRLBM        : NJIH            KVVUGMEYGBUQTIY DAKGNB          PRLYADIMNBOHTBM KLCL           
JMLP            : MYJMA           QHEF            HGQPVVQXLM      AOGPBLCGXHBACM  SWDU           
QPOHUMMS        : ANNDK           ANVY            NJIH            RFBID           XFLICX          KLCL           
BIMHKL          : FLQUQYMDWFJL    KEUBWKDFYQW    
UMGURXI         : OMSLFOIJY       RFPLDVCMNL      DEXJVM          MMJUKLQQHDRY    NJUAQLRE        CHJFKD          NYROGMFHGQMI    RNUEULWCLTSKRLQ
UMGURXI         : UHHJUPTGXWTQTFU
MFEARTWKJM      : ILTGBJEIC       LWNVPASNDAKSD   NTQD            CFWKUGYFRLX     CPCPFGL         DSIVYMAQM      
FBHA            : WAGPEHFUCKJWDC  JYWGEAQE        ULPYRF          LGJLCPKTSY     
IJWR            : SSDVGSWXGPCLA   KWCLBDDDNJQ     AKHLPHWUDVNE    WYKYOLMYID     
KSSWBPO         : RGYOODFITA      PFIHXLVOFF     
XJOFOQWIOKUDEC  : VTTTYG          UEMGJXHSUK     
LCOVNLQJXJE     : ASPIUCL        
LTMNTY          : BCGAXRWXV       XXHEMRKA        EYHFISKDYWHL    OSJNFLYIQ      
ANVY            : QPOHUMMS        HCJTSQBCVXOEYGG GIOKLGBPSRRH    ETNPL          
MJUR            : UNWIFJTTS       ODAIHNNOTVJFAT  BBOYNHSVHCH     GVUUC           LULOAINKYBDWEPB
WXECNBRBT       : DLWGTGBAADCHORV LJJGKWEEHJHXA   GGCADMKGL      
ADGXQD          : EMMUIAVLY       SHOXYFYMB      
GWLLW           : LOTHGHBBFOE     IHQMBLKXS       SFNLHSAOJFRU    GWDVPGHFW      
JYCVIWNYW       : NJIH            ENQPYDGSPWGMK   BSHBYHELCQP     MKNSAIWLFYI     QJKM           
EBBHS           : ORECVB          HWLFPTXREIEBS  
DWFIGFAJ        : WILWEOYM        MQRI            USPE            MVSXNC         
IGETGFDFJBP     : KDYPSEID        FKYGPV          BPTU            CDSPFDARTFOPJGY ICPEA           EEDTGTKEYWGS   
ORGDXHEHCJ      : BWUWPDBFCOJ     TIYSMOCOYWD     WDWWKRGTPQBXS   MQRI            PVAJWQ          WHIAQQDYIQLI   
AOSGTURME       : IPROBCILIGDY    GGCADMKGL       URRAAIYLN       WAGXCPFWYJU    
SAIAGP          : VGBOSUJMRGW     SXXMWKPOTTFS    CCDHPKRWWHHFX   RSVFTIYOHK     
HGTYACCALI      : MCCBYTEKPHJSNN  ENFACSLBCYL     YFUWXGJKJYK    
NSTPJOXGMPUS    : QRRV            HCNAIWYTUCLQ    CADBYDIJR       QBBBAGFR       
NUBPB           : SSVRS           OCRXGSSI        KPDWKBXDKYBA    QJKYUOHBFNHJARN
CJAVKAAO        : PAFUJWKIDUH     FEPGGCKHC       BRVNUSDYRUNHCG  LBFPOMXPFIXILKU
LWLAPHR         : ISVQSJRPB       CUCMUGRKFP      ONJECPDATYTPJ   TFINFVVGYJVXMLR TEQMIHPQBSW    
XQIKID          : ONQPKWWJR       CJBMGG          EGDEKFB         KQIGUYO        
BQBD            : NHDUMTSV        TSCOBHICIB      HVHTICAYWJQ     NCLLHWQMQKXH    ERRCN           JCKWSJ         
CUJNUHXWIMYVM   : LELIMVDBBRCFRPO NIRINOUOSHEKOXO BXRMUX          QDRTOQTQE       BRURPF          NVKOLLGYK      
XETQGRHO        : HKMOJADGLWCWI   LNUMURHOCGLJAGW TWSTEXHY        GARWXSJVMRXUBFF JEWOFULBFJL    
PRKRKL          : SGMTJWRIS       GYGFRK          HOWK            CKVJKYLCWCC    
RQRDEMMFL       : ECMTLTR         RLNHDAENGPTO    LPSWCTR        
TKTGW           : PCPUGTHIOQP     KUMBHI          UUXJEPXIKPLTMBX
NQKTITJNKBBEM   : QCGQQNVAUWPH    OWIDEUTGHI     
BGDS            : NQSREHNXB       OMSLFOIJY       RJVOSJBIPIXDGUT
KHARS           : OTKGHMNAKADC    PSJHCFNAVWKH    YMMAXXHIBN     
NFVWC           : PKQDWHYBETPLNU  TRJWFMBWLOEGL   VLNMG           WKEGM           JUFSVPQLANJCECY
KUBEF           : LNHNKI          EQOOUTNTGW      GATIGQWPR      
NVHRWNGJ        : RSVMLDBVOMHH    XSNC           
MPJACSA         : TIYSMOCOYWD     OELXFVKCLCECVEA FCHKKTYNKI      SQWUVW         
NCHSXGWOQRRV    : RFMKDE          JYGGVCDMMVCY    WPPVSOLX       
OLVWDSMJE       : DMCWYOFU        GPWQVHHTXQ      ETEIJFQQYF      RBCVOCMFUPTFUIX
XTPXXJBTWDESE   : WMNRAKNESMLQYSX HXBOWU         
PSCKKXKYLGXPYLB : RFOTA           CCDHPKRWWHHFX   HCJESRUOBBC     OBXAPFBVHVUJDU 
RACHAAQDUQJYL   : LWGJTNDMYEXM    SQWLTTGPLWIO    NMJFGAHCOOH     DKFCPRFIBHKJLV 
JBGNNSNXTAES    : VKWXEAGNCM      OTFUWL         
FGSLAUNHVPBB    : FLIBM           LCLWIH         
TKLFX           : HOWK            KUMBHI         
IGLWBAUVCCQTJ   : JBWDGT          IQYQYDU         BXUSQPCPN       NVKOLLGYK      
MWYIMGGDJHPD    : SFBDUYXGVFKY    RLNHDAENGPTO    EMCFAKNHU       BAOAPCDPCKXDYU 
CISARCNQ        : XNJSW           MUPABW          KCLOAVHDJ      
PNBRRTNCSBYTLOD : FOHHALESXOIMAPT XEQGRIPNY       PIJJCNDDSXG     KNYWUGDDR       TRJWFMBWLOEGL   VLDKYJ          VWHVRTLOLFF    
RMBHQV          : PCPUGTHIOQP     LDYGVCECSI      NAPXSFWKVGXKSG  XXPHJKLMR      
BRLUVCLBTCF     : VPNPBRURWE      AEFSSMWFVMK     OHVOKUAAPRWAL   CLPIBEKUEV      VPINFDNUEBNNY   GYDBXSRRIT     
TYCXUFAQ        : YDHOSWQ         LOKKQR          JNKPLY         
OTKGHMNAKADC    : NVDHAJNISFVPG   KHARS           FTWDTGFMWJKVD   WKCIJ           ITEOIR         
YXRMAMOH        : SGMTJWRIS       FKQEQBLHJAKP    UNMGAGOTDGU     IVWNUYKMWO     
JIDH            : MOINIYUVFE      VIESWGPQGFV     NYGMUELHVCH     AEJBKSNGQAYRPQ 
LHWCXQPE        : TLBUHOK         WFSSJYILFMWT    CFGJTOFKOJT     YMMAXXHIBN      SEHNRS          PVUGSICMBEINXV 
CUCMUGRKFP      : LWLAPHR         TOURAKSDWDGDN   HWODUVRGQY      IOCWVQIJKRXNQFI
TRPJBQ          : RKFDRCWGUJMY    NDXDEAGTPDY     RBCVOCMFUPTFUIX BXUSQPCPN      
KVEPHOMMMG      : VMYJCMWMIUJ    
RIGMLUJR        : KDCT            DMIMGDMEMRSEES  LRXFIUPK        KKRA            UVGHNTX         EJPOOVJKKHTTKE 
TYFWSYOEBFYNEG  : ICLD            QNEWWMICUCIKMTU XGNVQGNTNPWPWJX
NWSCJYE         : CRYXSOYKIFNTX   EIKYPH          ULEGLVBEVWB     TXEFFYLY       
HMRUKBMWX       : QFOVLDUDQE      XAJWN           UOWMUSCLXHLKK   APMUKCD         HDKF            VIESWGPQGFV     TFQGQSSHCHHGXI 
EWFG            : PCYR            YDKBVACWWE     
LHTLUXTAOQSQ    : EPER            XNJSW           GEOLKJKQF       IUSPACJDUWYI    DNCRKLW        
TXGCKX          : KKWTDJTAFHHBXSG CUKRDKILFYNEA  
UCMUC           : JYFULIHP        ETNHPAVK        CLQBGPVOG       NMJFGAHCOOH    
BYFHLTO         : DMHYM           UFMRQSUGVFX     PIKAPWLVSFLKHB  HEWNIWSJXVT     GMSJQIAJRUWFYR  MNOMARUQWIUAHR 
FLIBM           : FGSLAUNHVPBB    VUKOYLTTNF      DAKGNB          YMSYAWDQVSEF    IXIBLYGODCMXN   EEDTGTKEYWGS   
RFOTA           : PSCKKXKYLGXPYLB FOHHALESXOIMAPT TALSXNTEUKBDMOP NTQEUVBLFIB     HWIP            JOWMOKXTG       LCMCNVFMNBVR   
CEYDDWHPTJQUKX  : CRNFWCJJGF      LULOAINKYBDWEPB GRUHXOLVQOFDLO 
YRRHYGPASNTA    : GJGGLQHAENFXQEG OVPJPPFWQTRWAV 
QCSSGTVMS       : BYQSFUDKLQGT    BOPWUOMIGCVFBHW TOURAKSDWDGDN  
EMMUIAVLY       : ADGXQD          CPNCXWTXUM     
FGPLXRENOHTF    : XFVOEFQE        POABSUUPICTDMT  HCJESRUOBBC    
MXSJWFCALPPJX   : HWUVYAUHSITNKJR CKCDLUFTDT      GOFXEDIQDYMJ    DUWKOLSXBJB    
FLQUQYMDWFJL    : BIMHKL          KXUAQVLVOW      GCBSYESARIYKRS 
SFBDUYXGVFKY    : MWYIMGGDJHPD    BMPBPLPCFKV     GWCFEATIRTQMMAS RQRQD          
AOAAGFLWDF      : NMUQPI          GLCTUYU         WKGTQUISQ      
PIUWTGSNOTSL    : KAAKVOSJJST     DUSDXDDW        RNUEULWCLTSKRLQ DKSHPFIL       
QRRV            : NSTPJOXGMPUS    STYAOMQDYW      WGSLNITN        YFNTKULUS       RDMMOF         
QMFHPHNUVM      : GXEMGNDBOCUFCVB ILWOPA         
BKSLGPFOJUDFNQ  : IMGLUVEDPAEDJ   XRBXFKQCBUO     CBCEAYYTAFVNV  
GKTEPMTWWJEMGA  : OXAHUUMMD       QHEF            JJFMPFWSFHPTK   WHBURWDCSPAYWCJ
HDMAOSRWID      : PINTIBYCVSOLTIY TGJXJKSN        PXQMRX         
NJIH            : LDGYIEWIDJTO    YFACRLBM        QPOHUMMS        JYCVIWNYW       FTWDTGFMWJKVD   TKBOS           IWCEDBKCIYW     FFUVRKBFLH     
NJIH            : SXOAD          
QRGVJVRGSBNHJP  : RYFXETJI        KFBCIYCMGFW     VGEPITJLFEDMVF  EDAAMOPGPHTFVOH CTQMDLONWGU    
QTWSIPNHAQCOA   : TOVTFKU         PVAJWQ          IOKTVAWBPDY    
VNDPTBAPS       : YXPMVEQ         EHAPONQVBN      PHEGWHTHINPRBO  ENFACSLBCYL    
KVVUGMEYGBUQTIY : LPKGC           YFACRLBM        DETAQTIER       UMTWNPSJ       
YBIANGN         : KAAKVOSJJST     BYMDTVTGGYQOIPB OJRPQVVILNSLMG 
WJSWCNFOKCJQ    : VEOCOPNIQJ      JVPXSGQBTHPCY   FCDAFMISH       ICIJLPKHDKQFIX  ILYCOLO         XARIQR         
ORURMNLUMGUNQ   : WFSSJYILFMWT    KIRQEXFLOMHEAEG MDUBYTE         UCTCTWSNX       GWDQLBAC       
DXMWUVPRA       : ILTGBJEIC       TVDQDCVNF       BVRPQJWILEVX    WDDTLBLEUAUXNB  VNUTMCUEYCGRWD  NYKCEVWKNFKDQYT UHANYPKWIYBHJCM
YPPBYIP         : DLTCJHPPXUN     LXHJGYKNUVS     FFUVRKBFLH      SXYEDD         
BMINB           : SONTKUSIEDKO    SMQDRMJRFCUG   
LNCGETFJTRGQN   : RWCKCFWYMHXPH   VHFC            EJXUDWMNVADOW   YVOXLMICQ      
KQEJGVLFHBV     : JVGFIBWAHQ      SKJBGUTXYTC    
QGXRCJHF        : CPNCXWTXUM      EETBB          
LBWVWOE         : VNUG            BXRMUX          IYCDFQ         
FDXVHHEDSJKWHUN : BGHFXFCNCYMMSU  IAHRLRLMGX      YLLYSHPAIIBUN   XARIQR         
VFQHMXCBBY      : ALHRUOARXUB     YFXLB           JOWMOKXTG       GSJSPEXEYGM     DLBXNOXVKXSE   
XQDLXGL         : IMXIMABTQX      AJIXALRMLMIVWN  QBCEU           FJVAQY         
PSAVO           : MNBSTLW         YSCJTTJCVWLLGDF SEHNRS          CQOIJY         
ILTGBJEIC       : MFEARTWKJM      DXMWUVPRA       QYHAWVYFMM      DFBPSTAWG      
WCNXDPYDIFOI    : NLAVCVWJYJR     WKKRCHWNKKLAW   IABLBUNFQCIFH  
CEEVGCK         : FYAA            ETNHPAVK        PBPWWTOR        TRJWFMBWLOEGL   CPCPFGL         DEPXEYTFGDML   
KXNQ            : LNHJWKGFKKRI    ESVVFBPU        AETTE           QHEF            VSHLALYGSF      RMMQUQPVB      
AUHEJEH         : DRGOPMJAPJPW    TDUMMER         OAHCDVXIIML    
FKQEQBLHJAKP    : YXRMAMOH        WTJAYBTGWWW    
GVISQUQGOPGLY   : KCGEDITGXR      RQVFHBSYQOYQFE  TSVQDY          ITEOIR         
UDSWIF          : AIDWYHPRMWOQG   ESTXD           RMMQUQPVB       JCKWSJ          FTMRL           VBIFNTS        
PXPDGBDQRLWP    : ESRNKXKFN       EJPOOVJKKHTTKE 
RGTIPIAV        : YQCKOKLEG       ENQPYDGSPWGMK   BOQSLDCXK      
YJRCEONM        : OKIFKBCDXBQOX   TYPDORWI        EKBBONRMP       IAHRLRLMGX     
FKVIQX          : GEDUOGERUV      WAGPEHFUCKJWDC  XXHEMRKA        RMMQUQPVB       OYRHVVDSWU     
HRCGJYXQSIID    : DGXNAQKXU       GPWQVHHTXQ      IJTCUYDTO       JNGJ           
EYHQQMUHAHOF    : NJQSRWPV        QSSLFGQ         AEJBKSNGQAYRPQ  PRBVYKULU      
MPLMEVEHC       : WHNKPDFMNVWO    BRLBSSWMF       XQYQS           PVAJWQ         
IDHDL           : RDPKNJRNVP      PBGXKQOSJJWX   
IUVH            : NATOWPBYIVHMKF  YXPMVEQ         BRLBSSWMF       EQEEWQWJSQKYSKN HINFDYBUOVCLJB 
MBQK            : OMSLFOIJY       GWDQLBAC        NEOUKSOOJVCUHET
STYAOMQDYW      : QRRV            RCVTEQVUGGCNDF  HSGLB           VNJIWCHGG      
GEDUOGERUV      : FKVIQX          IGYRGYRWO       PSYOHFKTBHAMX   WTJAYBTGWWW    
RRIVHLPRVINVJD  : OYHQITM         LIRT            XRBXFKQCBUO     FBCR           
AGJWHPE         : QSLFI           YMTXRDFAIGF     TXEFFYLY       
MSTSNQONI       : NVDHAJNISFVPG   MXBPYD          YAVFIOKHBT      NTQEUVBLFIB     RTGOTSVCY       DVLKN          
XGQJVKI         : ELHJH           LPFMYGEGPESXDTS PPWIKSWVY       EDRNRIAYNKRSUP 
XEODQOJ         : NFOVNX          DHOKMXGFRIJPI   WTENJC         
NQSREHNXB       : DCOCBXNPPVI     BGDS            CYATVBL         MILSAKDNHY      XTEWCJ          YVLUPIEOTIFJRRC
OROYBPFRBC      : FYJNQBNLQEY     KFNIEBT         NVTQYTKRNUND   
JHDNVGEMSHCLCUP : YDBFQK          YAGXCF          TALSXNTEUKBDMOP IUSPACJDUWYI    UMTWNPSJ        LGGIHLGUOACJ   
IPMJEHA         : DVQFUTFMW       TETVMC         
IPJD            : KJCLAHPTWP      GGGLFIRDNHLKJW  VLDKYJ          KVQLB          
NHDUMTSV        : BQBD            OEEXAGMNMB      SANPFFLCNTF     NBGARV         
FOHHALESXOIMAPT : PNBRRTNCSBYTLOD RFOTA           VVYKOOAKYX      UDMGLFDBY       OYTS           
UDSGIMTPQ       : YVQT            OHVOKUAAPRWAL   JXILWKAJ       
DMHYM           : BYFHLTO         CHJFKD          IYCDFQ         
PWYRIDK         : VWRCDVENAP      TFCEMOAPWA      XFVOEFQE        EJEBTUXKTFFULGI DSIVYMAQM      
UVVUNRVI        : TNMBX           POABSUUPICTDMT  EKBBONRMP       OWQXFUYDANLW   
RPFEJXWBDJ      : GYGFRK          TFFRCFVLHY      KEOTABRN       
CYATVBL         : WOJKCARBPX      NQSREHNXB       GKNLLBUDVOC    
EYRYU           : HXQOHXMEEV      DJSPNCSAIBBOUI  UJELERP         SYIAASTSTL      YPHLFMIY       
WIHSSHKIM       : YSNDNAEPKA      QYULMCTBAUFXTI  FDAJQ           NDPMKJHFBNEBTFO
UMQX            : DLTKVN          VABEGQWGYLMRDL  PSYOHFKTBHAMX   YGFI           
DIRC            : PTBVSJCSUGCOWRN CTAWYLDWTH     
LALAI           : AEFSSMWFVMK     MVGQAWD        
YATVPQG         : DXVR            WPSWTLDWJW      NTQD            OTVHPCX         RPVCGGCDLUCQV  
MYFYKTQHHKFW    : VEFXCARKTTBUYOY
NRRYF           : GUGB            CHJFKD          WHIAQQDYIQLI   
KFCFEDACSQIS    : AJUBFSNEJE      GBDSTHSCITICK   EYHFISKDYWHL    UGMJPOC         BSELIODTPF      HDQUONW        
KXDU            : WFMYWGI         FCHKKTYNKI      LVJEGBBKBELUGUH
VECI            : NVYGW           ONJVNVAXMVFIT  
YXWQRXWLLEOQLTS : JNKPLY         
MKYGP           : FLJEDQLCEPUL    VKWXEAGNCM      UOFXKBGM       
GUGB            : NRRYF           HCJW            GREAYMU        
KDCT            : RIGMLUJR        XRVSPPLRAGFLAC  UBVVRXCN       
BSXSTWFFC       : CNFMUTQ         VGIWQSFIPBJI    PWXIPRBVBJKH   
XNPRB           : PTBVSJCSUGCOWRN VSRCRAWAMMIHNB  USHUMCVVHYHN   
ECMTLTR         : WSBJ            RQRDEMMFL       MCCBYTEKPHJSNN  LOTHGHBBFOE     HSGLB           OTFUWL         
WLGD            : WXNDK           IJNHBL         
CIOVGKREPWINU   : BYWTFO          TGHPHJIL        RMTOHWADY      
FOYLSCYN        : WXQYOWMWI       CJBMGG          TGMCJDBXCBGAH   EKBBONRMP      
UFMRQSUGVFX     : BYFHLTO         DJGJWLYNKHFH    NBBKIPW         WDWWKRGTPQBXS   RPVCGGCDLUCQV  
MILSAKDNHY      : NQSREHNXB       HCNAIWYTUCLQ    TFCEMOAPWA      TFFRCFVLHY     
WAGPEHFUCKJWDC  : FBHA            FKVIQX         
KAAKVOSJJST     : PIUWTGSNOTSL    YBIANGN         WPBFTUXGQQEJX   YFAOFGO         QCPJRHCVRIUY    OPTCCEYT        USPEWXFAKIEVDLT OYRHVVDSWU     
KAAKVOSJJST     : KCLOAVHDJ      
ICLD            : TYFWSYOEBFYNEG  XWFJVJ          HNCLSVNLRVI     DCCFTDYRNMNSGKH
NJQSRWPV        : UXUJT           EYHQQMUHAHOF    IMRMUKGIGG      TSCOBHICIB      CGXFIH         
YSNDNAEPKA      : WIHSSHKIM       BGHFXFCNCYMMSU  HXCVCLUSKPBDQ   LCCH            RDPKNJRNVP      MYXKFBIAKY      HWODUVRGQY     
FKNXG           : LOTHGHBBFOE     PXYQPE         
GKNLLBUDVOC     : CYATVBL         PQDTDIDLBVAF    TMKAUDGPPCTNE   NTQD            OBXAPFBVHVUJDU  JAWAYSAARO      FUYSCDUUFVQ    
NLKI            : CIHDYLAGPVHCUN  ELUICORPT       SHPTDGVO       
OVDUNPURU       : FYAA            KXYJHUVDNT      JIFMBQ          DNDXXGLHITG    
HUQHDBW         : GXEMGNDBOCUFCVB VABEGQWGYLMRDL  WPSWTLDWJW      YCNEMYKIEKXVGT  CKVJKYLCWCC    
PBMUWBWJQKVAMK  : XGNTS           IDYKJRPQ        IMCORXGXCJRK   
RFMKDE          : VKYCLBCSU       NCHSXGWOQRRV    TSVQDY          CTQMDLONWGU    
MODDVGHVVWWI    : VMXNACEQMVKYF   BLUTKNGYRSNRSVC IUVFMANJUNPLEW  YKBTHBFORF      PRBVYKULU      
TLOFDBC         : CLNKA           VSXVBPT         RIBIXLK        
NOBIWPSA        : MNYVWMW         PBKFYLRTJDODYE  NGQBGPJFWVQV   
AOLDUJMCFIYESS  : AIMIKM          KTPDVBDDONQ     FBIQMHFMGJWWS  
EJGJKK          : IMRMUKGIGG      JNVBBC         
BAQJYIEBFEPQ    : FLLNQKAGX       VSICSEKMXB      TSPRQ           SYTHC          
KDWOI           : YDBFQK          EREBCXONIU      TGJXJKSN        LEHFBTGYGXME   
PPAIQGR         : BLMPRVH         NEOUKSOOJVCUHET DFJCAKQNXXKVQ   MNHMKOR        
QFKFGMXPLHT     : XTEWCJ          HKWTYOPDRSCE    RSVMLDBVOMHH   
MAEGK           : IJOLUBTVAJVREKE UMTWNPSJ        LYCNSUAULNSN    GKMALHRYK       QJKM           
JJGTQW          : CUKRDKILFYNEA   LAUX           
QFCXA           : YXPMVEQ         YFUWXGJKJYK    
QFOVLDUDQE      : HMRUKBMWX       MTOIHSRHEUH     DMHIYQHGCDLK    CBGJVJTQINY    
FSBJB           : UFLARDNGSNPF    GARWXSJVMRXUBFF
BKXIHPH         : IHGJT           UYQHAVPSSHJ     ETEIJFQQYF     
IMXIMABTQX      : XQDLXGL         EXTYWHKINSVIEV  PWCJML          BKGHQWLU        KKRA            EFFHLRYUCSIW   
VUKOYLTTNF      : FLIBM           ONYGKXWUSDAOFDG WACWNQIFYRUSBT  PHVMN          
CJIATPRBLDPJNFL : OXNDPQNITFSFA   WTENJC          HMMHAKQQY      
YENHAK          : YOJTEPJAYAON    LWGJTNDMYEXM    RJVOSJBIPIXDGUT ACWMNIXNJWSQYFT
OJGKFTPBV       : CDOYNEAJCJW     IOKTVAWBPDY     XEOSCXJPUFJSBBL UMULV          
KXUAQVLVOW      : FLQUQYMDWFJL    BDGWLNJIWWFCIXU FEYXXH         
TIYSMOCOYWD     : ORGDXHEHCJ      MPJACSA        
DPQYGRW         : JXLB            DXNU            OQIRVX          LHJIWCRMRMCRNC  HWOLXUWG       
CUFFNDSJR       : EJGWXPPW        WSOEREFCHFH     RANHXBNNYBNQ    VROOUPDIX      
TLBUHOK         : LHWCXQPE        QCGQQNVAUWPH   
DJGJWLYNKHFH    : UFMRQSUGVFX     WKGTQUISQ      
KDYPSEID        : IGETGFDFJBP     SXXMWKPOTTFS    YDHOSWQ         HILQK           FFBSCQFML      
BYMDTVTGGYQOIPB : FYAA            YBIANGN         HKISSXRWGIBJYU  MKHEDSIISYH     POKVUQJBPRXOY  
DLTKVN          : UMQX            PBGU            MNHMKOR         GTCRU          
BOMTVVYUYXJ     : QORDIPBPIKUBV   ESRNKXKFN       DEEQHTFTFOY    
UGXBM           : IDYKJRPQ        WPBFTUXGQQEJX  
TDIJESOS        : YQLDILQM        CGQWQEFPVYFPT   BCUOJHNVP       BSHBYHELCQP     NRJMBYHUJF     
AODUPUIJQ       : CDHQFEB         UVDJHVJ         LJQIJPQHWJXNFLF MBERBNKMIGLKKQ  POKVUQJBPRXOY  
LNHJWKGFKKRI    : RYFXETJI        BWUWPDBFCOJ     ODIFARPDX       KXNQ            RRIPPWBWIKCKD   NVNMNHDAYJ      PGSHYLEE        OAHCDVXIIML    
XRQCMFUCHLID    : VKWXEAGNCM      OXAHUUMMD       BJSUAECMFJI     AYIGHEXR        UUXJEPXIKPLTMBX WORBMCSJ        POKVUQJBPRXOY  
DNNVVYJD        : WEWNJKRCQQ      YFTEBNK         NHOKFESSMV     
IPROBCILIGDY    : AOSGTURME       OBLENGTG        IYWNE           RRNYPRLIDVF     BHCTXNT        
SHGUOSFTVKJ     : QRNHOPSEDP      RLNHDAENGPTO    HOWK           
GFMRLXDDRRG     : TYPDORWI        TMDLJVRP        GVUUC           IIVUD           EAGDGDJ        
CSELXGWQND      : WEOBIAOTCMQEYDY EWSYYKKS        VTTTYG         
EXTYWHKINSVIEV  : NLAVCVWJYJR     IMXIMABTQX      AWKTDJDISWSXX   NMJFGAHCOOH    
JNFQJJJNUJTRBJ  : IJOLUBTVAJVREKE SNTUSJJPLJLA    MXBWABJSR      
POXLPWSAIJUE    : TOVTFKU         EWSKPYKH       
YCHJPMCYX       : SHMI            YVKYRTKUCBIVYC  JYQINGVUMYQ    
OTWLNXUNPLO     : NVIEGCJY        HBJOXCOBQG      AIGAWOI         NXOIXVJXQXQK    IYVMRSFNPMLJIX 
DLWGTGBAADCHORV : PTBVSJCSUGCOWRN VRNPFGYYQ       WXECNBRBT       KVIQOMGFEG      IYCDFQ          KJVCMBGIGQINJ   WORBMCSJ       
SUEKQBVGCQWTFLX : CKOAXGIHK       TPYKSQUKVDWP    RTGOTSVCY       FBNQK          
YVQT            : UDSGIMTPQ       TMDLJVRP        HYBW            JCKWSJ         
UVFX            : CUPXHF          YMSYAWDQVSEF    NRYVACYMDTAJM   XYHNSRKXTVHNE   VEYTQPIC        DEPXEYTFGDML   
OMSLFOIJY       : UMGURXI         BGDS            MBQK            PEXXD           MPGXUEYITTLXVP  JKEXVTW        
MUJQNGLURL      : ECAND           IOSNQXRSWSMYBK  NBGARV         
RHYNMTJTTKII    : RNHJGKDJUJUVHX  BTHBT           IXIBLYGODCMXN  
VNUG            : LBWVWOE         BYTGCWYFCS      VEFQA           APOASUAJD      
THOQRHGXUC      : LIREXHP         YVOXLMICQ      
HKMOJADGLWCWI   : XETQGRHO        PIPLXIJSBILPHM  PKHHUB          DMHIYQHGCDLK   
DEBXLDTUTK      : GWNNWBA         XARIQR         
BSNWUGEFSUR     : VOJUDOTYDUKGAO  EJGWXPPW        OYJBILCYGTBM   
YAGXCF          : FIIKEWUACJVB    VEOCOPNIQJ      JHDNVGEMSHCLCUP UHLNQYQNPMSYLUR NCKOURXSLTWR   
PINTIBYCVSOLTIY : HDMAOSRWID      QHEF            ONFYMNOITYUVOEQ RRNYPRLIDVF     ABWOEMSHCWRCASY
FHWNCSFWTHFTLL  : TWLVDVQYP       UJWY            EIKYPH          VWIJUCYAFMOEO  
CVSXFVWJRP      : FJVFXXQG        VEFXCARKTTBUYOY SHBRVMNKWILH    RTTJLTYL       
FLJEDQLCEPUL    : MKYGP           JWKRH           YVOXLMICQ       VEYTQPIC        DEPXEYTFGDML   
QSSLFGQ         : EYHQQMUHAHOF    TYNRDJUPGPC     FJVFXXQG        UCYDSMKICEQDW   XQYNXGYG       
ELHJH           : XGQJVKI         FENA            AKHLPHWUDVNE    CKVJKYLCWCC     TKOPITXSL       FEYXXH          VYURYX         
VYVWFHILMYAPGPM : SDKBFYUHOMLNR   HKISSXRWGIBJYU 
FENA            : ELHJH          
UGKE            : MJMCGFXN        OFDVYF          HFTSALDGB       EJGWXPPW        OXXMVT          OTVHPCX         NHOKFESSMV     
VNWDTSE         : DGCC            KHCV            YDKBVACWWE      XGMERSX        
RLBAXOYX        : XRVSPPLRAGFLAC  GGCUCJWNKS      PAGM            XQYNXGYG        VOEPMCTAKSCLQHC
FPSAUYNUSID     : JABOYMISVOJANP  VGIWQSFIPBJI    IANLM          
OQYENEXIJRA     : BGHFXFCNCYMMSU  DFEFRNQJW       NQAR           
SASJBSP         : PTBVSJCSUGCOWRN RNGQ            QCPJRHCVRIUY    GKAIFIEBNY     
LJJGKWEEHJHXA   : WXECNBRBT       EJXUDWMNVADOW   JAWAYSAARO     
CPNCXWTXUM      : EMMUIAVLY       QGXRCJHF        ESVVFBPU        FSMPNLITXUP    
PWCJML          : IMXIMABTQX      OXAUX           OVCCVJJB        OTFUWL          HMMHAKQQY       BPNBAXPMH      
XWFJVJ          : ICLD            ABWOEMSHCWRCASY EFLFQNDFDWFQN   LDGVLCONLD     
FTWDTGFMWJKVD   : OTKGHMNAKADC    NJIH            UQDKJAUV        OSJNFLYIQ       YKKYN          
QRNHOPSEDP      : SHGUOSFTVKJ     QBBBAGFR       
CUPXHF          : VRNPFGYYQ       UVFX            AQIAETYSQUV     YDHOSWQ         CUKRDKILFYNEA   XLXJNMW        
BDGWLNJIWWFCIXU : KXUAQVLVOW      XEQGRIPNY       YAIWGUU         CTQMDLONWGU    
FLOXRTPWYNOWUU  : FQLMSCMEYNXVSLO LNHNKI          LXHJGYKNUVS    
XAJWN           : HMRUKBMWX       BAMJBEISXE      BBOYNHSVHCH    
JYWGEAQE        : FBHA            VXAVM           IJFTG          
OKIFKBCDXBQOX   : JIHPAVYCGBKEIM  YJRCEONM        NOFEEKARJHKOY   PSJHCFNAVWKH    TSVQDY          LWJORDLRH       FIKEPSBQGVDA   
JBJLNIAN        : NDXDEAGTPDY     QCIOMHLAKWLGQ  
YMXFOQJL        : NRJMBYHUJF      NWVLPGUCXUPQBXS
VUNJVRMVSFKTQ   : IGRYHDUD        DCCFTDYRNMNSGKH
WCIKKIXFH       : WOJKCARBPX      GXEMGNDBOCUFCVB RMGRXVI         JCKWSJ         
DMCWYOFU        : OLVWDSMJE       KUMBHI          BTHBT           FBNQK          
SEFL            : SHNPUWQKUF      NIKVRY          IHISJHIPXGY     REIWYWWYPLGLSEA
DGXNAQKXU       : HRCGJYXQSIID    CNAQ           
KIEJNMYSBBPCPU  : VGEPITJLFEDMVF  KVXDTE          GSFBUENXJMQGR  
YQEG            : DQOSSMV         AQIAETYSQUV     NMYAXIYNXCFPMX  DGEULJDXISSHSPN LDGVLCONLD     
AJIXALRMLMIVWN  : XFIAONESDSCYVJX XQDLXGL         IJNT            KSBKSJTT        XSSDXYDS        IOFLCAYVYORKU  
KCGEDITGXR      : GVISQUQGOPGLY   BVKRPBCTMGVNSPQ LCLWIH         
AIMIKM          : AOLDUJMCFIYESS  VNRBPRPI        CQLWHF         
UNWIFJTTS       : MJUR            NDTQMF          EPOQVLOSYV      XLMU           
RGXEIFINNFVNWE  : CRYXSOYKIFNTX   GVAOJ           XVRCWWKODKNRFPL
FRBREVMTS       : YAKXYUBLJS      DVLKN           TKOPITXSL       RTMAUYNQTOAUQ   LAMLEDIYUP     
BEPXWIPFH       : SQGDMWY         WFSSJYILFMWT    TSVQDY          DFEFRNQJW       FICVKGY         FQWELMYVWILHTA 
NOFEEKARJHKOY   : OKIFKBCDXBQOX   ROCTM           PXYQPE          XDNTVDMBUYLOFN 
GFHUACQBGJYGRQL : WPPVSOLX        BXUSQPCPN       DNDXXGLHITG    
PCPUGTHIOQP     : TKTGW           RMBHQV          FDCQHCMMAOXVROC IJWRTVVTSG      RHJI           
HOMN            : YTUGY           SHEUMPJHUJTVHHW OTFUWL         
VKWXEAGNCM      : JBGNNSNXTAES    MKYGP           XRQCMFUCHLID    NIKVRY          IAYDUPDPOXQWKK  NRKUCCK         VPINFDNUEBNNY  
UYLKDDHJXOTOHKP : HBJOXCOBQG      RPICVNDQUJTXOK  VFVMNQVMCA     
BCGAXRWXV       : LTMNTY          DVORAWDYWTWYR   YVLUPIEOTIFJRRC ENUMK          
GLCTUYU         : AOAAGFLWDF      MNBSTLW         FJVAQY          YGXTQDXGN      
KXKRJKJDBSPQK   : UHKHLMMXIO      YGLLTNJDXW      RMMQUQPVB       RHJI            HQMEMU         
UQTU            : IMIBWNXRUNL     SOQWK           YTUGY           HMMHAKQQY      
TUGTBRXWNWTV    : YJUDQVVK        GKBVENVMYAIY    DKSHPFIL       
TICDUN          : RNEQ            IOEHLAYQSM      AEJBKSNGQAYRPQ 
VGBOSUJMRGW     : NLAVCVWJYJR     SAIAGP          WILWEOYM       
BGHFXFCNCYMMSU  : LXKVIE          FDXVHHEDSJKWHUN YSNDNAEPKA      OQYENEXIJRA    
YQCKOKLEG       : RGTIPIAV       
PUBWROAAVH      : HDVJAV         
BMOFLB          : JEGFQIHYJNLIPXJ ESVVFBPU        WHIAQQDYIQLI    SPKXSG         
GYGFRK          : KQLLRIEEQFH     PRKRKL          RPFEJXWBDJ      XRBXFKQCBUO     KFNIEBT         HWODUVRGQY     
GXEMGNDBOCUFCVB : QMFHPHNUVM      HUQHDBW         WCIKKIXFH       DETAQTIER       GSFBUENXJMQGR   VSHLALYGSF      NGSTRUBFO      
WEWNJKRCQQ      : DNNVVYJD        FJVQSDEKLDD     PHVMN          
YKVQQVU         : TDGKATGTC       MGMHTKJYQMFETH 
CIHDYLAGPVHCUN  : NLKI            IHISJHIPXGY     TSPRQ           SXOAD          
JXLB            : DPQYGRW         TMKAUDGPPCTNE   LGSM            YFEPBVBBEPY     BYBBD          
FTMEEIUUESBID   : LPAIVN          NDXS            JWKRH           VTTTYG         
NDVOJ           : VTNUVHGDXNV    
MTOIHSRHEUH     : ILYIJGYVUOPH    QFOVLDUDQE      SSVRS           HDKF            IEWETL          CNHAHYCJM      
OWPSFNN         : NHYXIVDONU      KPDWKBXDKYBA   
GRWJCLOYA       : FVMFKBV         MXBPYD          GPWQVHHTXQ      KVKWWMTHJWTOH   RPLCKF          OKOCRTUSVTGGDTY
NMWEUEWOM       : CQOIJY         
JVPXSGQBTHPCY   : WJSWCNFOKCJQ    STSCRIRAIAQF    QYHAWVYFMM      FKKCXVVVEJWONTN CKUXFDPEEIMLJXN KKRA            DKFCPRFIBHKJLV 
NDXDEAGTPDY     : GHMYD           IJOLUBTVAJVREKE TRPJBQ          JBJLNIAN        IUSPACJDUWYI    NQFIJX          RPNHLXA         FEGYIRIJPIUYPQ 
HXCVCLUSKPBDQ   : YSNDNAEPKA      VWJYWXOFTKTUD   DJSPNCSAIBBOUI  UYMCJOVB        VTFGEJ         
MIYNVORVRXYASO  : YFTEBNK         HEWNIWSJXVT     CVRVHRE         SQWUVW          IBHSH           GTXESOMCXBDI    XLVFR          
TYNRDJUPGPC     : QSSLFGQ         BMCVEECY       
SHNPUWQKUF      : SEFL            IJUXTDLXLP      QGRYHFM         DVLKN           DHOKMXGFRIJPI  
SADR            : UOWMUSCLXHLKK   QHEF            ATEQYFAY        ISXUTTSSDCOHDO 
VGEPITJLFEDMVF  : QRGVJVRGSBNHJP  KIEJNMYSBBPCPU  WPPVSOLX        JCKWSJ         
ONYGKXWUSDAOFDG : VUKOYLTTNF      YQLDILQM        GPALITBTNYCAFT 
BPLQXHCLN       : DVORAWDYWTWYR   MPGXUEYITTLXVP  TOMTFIJGU      
PAFUJWKIDUH     : CJAVKAAO        QXFGCXBPKARK    AEBBNYSFTJKY    XARIQR         
QCGQQNVAUWPH    : NVDHAJNISFVPG   NQKTITJNKBBEM   TLBUHOK         ALJKQTL         LBFPOMXPFIXILKU
PORDCBSEJQNGDYJ : JNATCENQHW      AEJBKSNGQAYRPQ  YFUWXGJKJYK    
IMRMUKGIGG      : NJQSRWPV        EJGJKK          SQWLTTGPLWIO    WKEGM          
DXNU            : DPQYGRW         WLWCNLOAUO      TRUNITBCPHUBHD 
EMSJQONAHEGK    : MDUBYTE         SGODUWFR       
RLNHDAENGPTO    : RQRDEMMFL       MWYIMGGDJHPD    SHGUOSFTVKJ    
YOJTEPJAYAON    : IMIBWNXRUNL     YENHAK          TYPDORWI        YFXLB          
XTGIYA          : MVPKRHHSLYOT    XWXNIOJFMAPCGEP DAKGNB          OXAUX           YKKYN           SNRRVCICUSX    
MHAMOQVEKMXMC   : UNMGAGOTDGU     VEFXCARKTTBUYOY TFCEMOAPWA      KQIGUYO        
IGYRGYRWO       : GEDUOGERUV      XOUKXINVYWXCALO TPYKSQUKVDWP    VSHLALYGSF      VWCFYDYYEDQE   
WKCIJ           : BWHYBU          OTKGHMNAKADC    SHPTDGVO       
FVMFKBV         : GRWJCLOYA       OHVOKUAAPRWAL   IGRYHDUD        KYDWSWEGLPM    
FJVFXXQG        : CVSXFVWJRP      QSSLFGQ         RDQGGSXG        HCJESRUOBBC     RDMMOF         
QYNR            : LLKG            LMIYGVOFXSB    
MINKSPSCU       : XTHG            ULTNT           XGBE           
AIHKLEVRPRYNPQ  : DEKYLY          TELPUTXYC       BRWSHJOWFKAMUNT VWCFYDYYEDQE   
VJUL            : AHLVJPMBY       USHUMCVVHYHN   
OBLENGTG        : ERJNVWPFNMCFI   IPROBCILIGDY    CLPIBEKUEV     
PIKAPWLVSFLKHB  : OEQGKWKVXE      BYFHLTO         VFOE            IHQMBLKXS       TFQLSDVRVPQP    YKEJALQJRXGKBV 
AXBJUOMLP       : FCDAFMISH       NHOKFESSMV      YPHLFMIY       
PDGMLQ          : QQTGMXBMJGTSJCQ KHICWJGQW       TEKGRXUO       
TDGKATGTC       : YKVQQVU         NNPBYXXQMPDKYDC
GJXLJX          : AYPPYANOMC      JABOYMISVOJANP  NTQEUVBLFIB     EFWSBNYQJGISP   ONFYMNOITYUVOEQ DKFCPRFIBHKJLV 
UVDJHVJ         : AODUPUIJQ       AHLVJPMBY      
YRONISJLBTNUDJ  : EBBE            TBTMHW          DEXJVM         
AQIAETYSQUV     : CUPXHF          YQEG            BJSUAECMFJI     JBTVMYWWKROBBT 
ERJET           : YAKXYUBLJS      CDHQFEB         SHSE            VYURYX         
UHLNQYQNPMSYLUR : YATPHXQFPGWQXTI DNSITVHOIPR     YAGXCF          YBMHJPPKEOQJOT 
UVSVQKSNKXH     : IUTS            RQRQD           EJEBTUXKTFFULGI
EDAAMOPGPHTFVOH : QRGVJVRGSBNHJP  RIKORYP        
JYGGVCDMMVCY    : NCHSXGWOQRRV    KVQXOTBNKKTEQ   MQRI           
MXBPYD          : PTBVSJCSUGCOWRN MSTSNQONI       GRWJCLOYA       GMEN            IANLM          
PSJHCFNAVWKH    : KHARS           OKIFKBCDXBQOX   USPEWXFAKIEVDLT DEKYLY         
SNTUSJJPLJLA    : JNFQJJJNUJTRBJ  WOPMCMH         IDYKJRPQ        KUPAYPYKNHH     UPPSTACRCPSKXYE NTLPDBVWSJ     
OQIRVX          : BDTREGCLB       DPQYGRW         AYIGHEXR        QOFLDWP        
HIPOXQMUBTQVH   : NYAQR           EMEO            PVAJWQ          VTTTYG          YSCJTTJCVWLLGDF
TDUD            : JJRQDPOOXCUVJ  
IMGLUVEDPAEDJ   : BKSLGPFOJUDFNQ  QYHAWVYFMM      JWKRH           IOCWVQIJKRXNQFI PGSHYLEE       
TAMKMHNIXLPLF   : RPICVNDQUJTXOK  GVUY           
IJNT            : AJIXALRMLMIVWN  RDPKNJRNVP      YRSUWPQY        TLFYWOGNGHUX    VGPRVWCMGYCBWDQ
WFSSJYILFMWT    : LHWCXQPE        ORURMNLUMGUNQ   BEPXWIPFH       RSNDPDPBXCAQNU  UGMJPOC         IOEHLAYQSM      BHFBUMXJ        FAQGRPBYYQ     
WGSLNITN        : QRRV            OFDVYF          ESFQ            SBIJFRUTARSIFS 
LCCH            : YSNDNAEPKA      PXWGF           NXFFOKFVXULH    EETBB          
LWGJTNDMYEXM    : RACHAAQDUQJYL   YENHAK          OSJNFLYIQ       FIKEPSBQGVDA   
MJDUIJP         : MQRI            WKEGM          
YXPMVEQ         : VNDPTBAPS       IUVH            QFCXA           XMYHQKKVSOBK    SOCCDGKSC       XLMU           
LELIMVDBBRCFRPO : CUJNUHXWIMYVM   EWSYYKKS        EJXUDWMNVADOW   RAEBXSMPTRA     DEKYLY          HXBOWU          QRNK           
BRYKDOIC        : FSSKTANJLPQTX   XXHEMRKA        HBTCESMW        ASPIUCL         XGNVQGNTNPWPWJX TDUMMER        
YQLDILQM        : TDIJESOS        ONYGKXWUSDAOFDG HEWNIWSJXVT     KSSMV           ICMUEMYJVWNYC   RWTMLGHLIDNRWJC
BYTGCWYFCS      : VNUG            FIMUECRPKCB     XEBAWPNEEX     
SXXMWKPOTTFS    : SAIAGP          KDYPSEID        SHMI           
SXUFQJFRLBYN    : AEFSSMWFVMK     RMTOHWADY       LQPSXMAMQHXMS  
AUASRSQQFQDWH   : RYFXETJI        UANMQU          SFRXFWKJHD     
QORDIPBPIKUBV   : BOMTVVYUYXJ     ORECVB          EYHFISKDYWHL    TOMTFIJGU      
AMTCJVUEQOWXHA  : CDUPTWKUX       DKSHPFIL       
OXNDPQNITFSFA   : CJIATPRBLDPJNFL FUATJIND        UDGEXPYTB       HXBOWU         
DXVR            : YATVPQG         OPIKGWRFJUI     PSYOHFKTBHAMX   YCPMSEF         FDYRBMNLFUUSMOJ
XCRVGIKD        : JHQEVFJCTXI     CRGTNOFDXKDBML  TONW            GKMTTPTSUQN     QBBBAGFR       
RFBID           : QPOHUMMS        GTXESOMCXBDI    YUUPXY          ILYCOLO        
NVIEGCJY        : OTWLNXUNPLO     VGIWQSFIPBJI    WHBURWDCSPAYWCJ
MVPKRHHSLYOT    : XTGIYA          FDCQHCMMAOXVROC AETTE           WSOEREFCHFH     YAVFIOKHBT      HLGIFSNLN      
BYQSFUDKLQGT    : QCSSGTVMS       BIOLFMN         PIPLXIJSBILPHM  DCCFTDYRNMNSGKH
OYHQITM         : RRIVHLPRVINVJD  WKUODKFKH       QEXTLU         
GEIPWVPNQAOPS   : RGTKWK         
UNMGAGOTDGU     : YXRMAMOH        MHAMOQVEKMXMC   BLUTKNGYRSNRSVC TRUNITBCPHUBHD  DVLKN           DALUNRWNVLG    
WGIJ            : MDBDKVYP        VOSBLNQGTHE    
PPOHNLWDE       : QYULMCTBAUFXTI 
STSCRIRAIAQF    : JVPXSGQBTHPCY   WXQYOWMWI       BRWSHJOWFKAMUNT
WASTI           : EQOOUTNTGW      XGMERSX        
DPSTGBJT        : UMTWNPSJ        CLPIBEKUEV      USPEWXFAKIEVDLT
OXAHUUMMD       : GKTEPMTWWJEMGA  XRQCMFUCHLID    GGGLFIRDNHLKJW 
OOGFTLDV        : LNHNKI          LHJIWCRMRMCRNC  KJVCMBGIGQINJ  
WFIDUDWBEIXHW   : NFAJWTBCIBJTKLF RDDG            SEHNRS          ETNPL           DXANKYDKBWT    
JHQEVFJCTXI     : XCRVGIKD        FDCQHCMMAOXVROC GEOLKJKQF       GDQAP           OOXNGGMOCN     
TVDQDCVNF       : DXMWUVPRA       EPOQVLOSYV      CJPKX          
QEVXMTFM        : TONW            PAGM            TXEFFYLY       
OVJURRETLF      : LPFMYGEGPESXDTS BXTTJUREFJAKST 
NYAQR           : HIPOXQMUBTQVH   JNATCENQHW      WAGXCPFWYJU    
VPSBI           : PQDTDIDLBVAF   
GHMUB           : SXOAD          
JVGFIBWAHQ      : JJGMYBXSWFH     KQEJGVLFHBV     RQVFHBSYQOYQFE  GVUY            ONFYMNOITYUVOEQ HXBOWU         
OUCOXUIFQYBSJN  : NCANVD          AHLVJPMBY       DEXJVM          GGCADMKGL       NGSTRUBFO       ABETE          
QAXUTIQANB      : UQDKJAUV        PQBNTCSO        ILWOPA          NSQENKHKAWRR    SMAOLVBVVAHU   
LBMEPC          : DAJGJ           XCDNKVSUTEIVRKS
TSCOBHICIB      : BQBD            NJQSRWPV        GGCUCJWNKS      USPEWXFAKIEVDLT LCCRNEKQAMYTYV 
VEFXCARKTTBUYOY : MYFYKTQHHKFW    CVSXFVWJRP      MHAMOQVEKMXMC   IHGJT           FMQUSQRARB      RRJFAOIFQ       RPBCNJNAH      
SOQWK           : UQTU            JEEDFBFTAR      VWDXAJPOFCN     EPGPEBUSSD      VGBNLFAQOQ      XEOSCXJPUFJSBBL FHUL           
YBMHJPPKEOQJOT  : UHLNQYQNPMSYLUR NFAJWTBCIBJTKLF WHTIWGTERIH     FCFSXH         
JEEDFBFTAR      : SOQWK           SYIAASTSTL     
QIMBTOD         : YKBTHBFORF     
VMXNACEQMVKYF   : EPER            MODDVGHVVWWI    LSDIDEIMN      
FKYGPV          : IGETGFDFJBP     IMTJSOHEHTIAF   CHJI           
JNATCENQHW      : PORDCBSEJQNGDYJ NYAQR           NEIRRXERXQ     
VWDXAJPOFCN     : SOQWK           OBQOSMXYEIDWWIB YCNEMYKIEKXVGT  PWXIPRBVBJKH    IXIBLYGODCMXN   KEOTABRN       
VSXVBPT         : PTIRLSJQI       TLOFDBC         ODAIHNNOTVJFAT  YCNEMYKIEKXVGT  SHBRVMNKWILH   
AHLVJPMBY       : VJUL            UVDJHVJ         OUCOXUIFQYBSJN  XSKKQPQHC      
RUIUTIH         : XGNTS           WASILT          PKQDWHYBETPLNU  TGMCJDBXCBGAH   NEOUKSOOJVCUHET
WOPMCMH         : NMUQPI          SNTUSJJPLJLA    WACWNQIFYRUSBT  MNHMKOR        
KJPETRNHQYYDAXO : BVRPQJWILEVX   
VYPR            : IWCEDBKCIYW     QGRYHFM         KYDWSWEGLPM     EETBB           POAOHPOERPBJTNC
YDHOSWQ         : DGCC            TYCXUFAQ        KDYPSEID        CUPXHF          IDYKJRPQ        BYBBD          
ESRNKXKFN       : PXPDGBDQRLWP    BOMTVVYUYXJ     IWWBHSO         KCLOAVHDJ       LAUX           
VNRBPRPI        : AIMIKM          XXHEMRKA        YRSUWPQY       
QBFBCKLQGIJNMCI : HBJOXCOBQG      TFCEMOAPWA      ATDHGLUHMT      EHVFVMH         ABETE          
NGNSUHOIBPXV    : JIHPAVYCGBKEIM  XNPTIMNNLI      HXJHYBUCUFOOGAL VWHVRTLOLFF    
JJAMRCQ         : BGDPRBP         DHOKMXGFRIJPI   GPCUJIICJYWBDL 
NIKVRY          : SEFL            VKWXEAGNCM      DPMD            DEXJVM          FODEUXPKG      
WHNKPDFMNVWO    : YAKXYUBLJS      MPLMEVEHC      
XMWJ            : UOWMUSCLXHLKK   VABEGQWGYLMRDL  LWJORDLRH       FQWELMYVWILHTA 
WXQYOWMWI       : FOYLSCYN        STSCRIRAIAQF    VSHLALYGSF      QIFXJAO        
RJVOSJBIPIXDGUT : BGDS            YENHAK          RSNDPDPBXCAQNU  UBVVRXCN        PHEGWHTHINPRBO  OUIQU           YFAOFGO         YGXTQDXGN      
SHSE            : ERJET           JXKRLUVBHWNDRSG CKVJKYLCWCC     CBCEAYYTAFVNV   HWIP            NRKUCCK         LOLXXMIPKPSA   
PCYR            : XGFVPGCP        EWFG            BKTY           
XEQGRIPNY       : PNBRRTNCSBYTLOD BDGWLNJIWWFCIXU EETBB           QOSEU           JQEPVVEX        VFVMNQVMCA     
WCTOKTRQOOM     : KXDB           
VFOE            : PIKAPWLVSFLKHB  LOSXLGPDDND     CBGJVJTQINY    
RFPLDVCMNL      : UMGURXI         ROCTM           GWDVPGHFW      
BMPBPLPCFKV     : SFBDUYXGVFKY   
YIGWQXBORIGDLCF : HOADPX         
SSDVGSWXGPCLA   : IJWR           
HBJOXCOBQG      : OTWLNXUNPLO     UYLKDDHJXOTOHKP QBFBCKLQGIJNMCI XJPCTTYLARUT    IHGJT           GMXWXYEHGVW     OEEXAGMNMB      UDMGLFDBY      
HBJOXCOBQG      : OWQXFUYDANLW    LBFPOMXPFIXILKU
YJUDQVVK        : TUGTBRXWNWTV    AWGFUAELKEMB    HMKT            OMNQAHXB       
SSVRS           : NUBPB           MTOIHSRHEUH     OELXFVKCLCECVEA JIKCPFXCEABG    RNRMPVTUFFPGAT 
JUNLTWMFL       : DTNEHDENO       MGMHTKJYQMFETH  TDUMMER         UVTXXNPGR      
HCNAIWYTUCLQ    : NSTPJOXGMPUS    MILSAKDNHY      DKFCPRFIBHKJLV 
XRVSPPLRAGFLAC  : KDCT            RLBAXOYX        UFUPHBVOIETBDH  DEKYLY         
FQLMSCMEYNXVSLO : WSBJ            FLOXRTPWYNOWUU  YSIRGXNSGHWFR   BXTTJUREFJAKST  RCVTEQVUGGCNDF  KVQLB          
LIREXHP         : THOQRHGXUC      ALJKQTL         HWOLXUWG        FDASJLND        IJYMLSOHSY     
HWUVYAUHSITNKJR : YHFC            MXSJWFCALPPJX   XNPTIMNNLI      RTGOTSVCY      
YSIRGXNSGHWFR   : FQLMSCMEYNXVSLO PSYOHFKTBHAMX   WILWEOYM        HCJESRUOBBC    
UYMSWL          : LXKVIE          LXXQO          
RSNDPDPBXCAQNU  : WFSSJYILFMWT    RJVOSJBIPIXDGUT PBGU            QHTCRCX         RPBCNJNAH      
LIRT            : RRIVHLPRVINVJD  QNTYB           JRPPLG          SECWROKQKODP    CYMDOHCYM      
PBKFYLRTJDODYE  : NOBIWPSA        YAIJYGQNWDVFO   BTKDFHMKMYDJT  
OHWPFBPXOKXCVRY : CVRVHRE         OGBRVEMAFH      USHUMCVVHYHN    TEKGRXUO       
JABOYMISVOJANP  : FPSAUYNUSID     GJXLJX          HDKF           
CAHTHJJ         : LOPUAXOFXQP     HLGIFSNLN       YMTXRDFAIGF    
AWGFUAELKEMB    : YJUDQVVK        DVQFUTFMW       DSMRVCUGEATBF  
BKBXBNAODKSDSML : PSYOHFKTBHAMX   IHGJT           CYMDOHCYM      
XTEWCJ          : UNYFKC          NQSREHNXB       QFKFGMXPLHT     NHYXIVDONU      SGSJOJIH       
CNFMUTQ         : BSXSTWFFC       RJXMD           NFOVNX         
XDGXE           : FIIKEWUACJVB    LDGYIEWIDJTO    HQMEMU          AHJJ           
XUAI            : XNPTIMNNLI      TEQMIHPQBSW     SXQPQUJXVCQKTB  NHOKFESSMV     
FDCQHCMMAOXVROC : PCPUGTHIOQP     MVPKRHHSLYOT    JHQEVFJCTXI     RNUEULWCLTSKRLQ UDUXVKJCIJ     
JXWOVCUVGR      : SCVWKGLUJQXRM   EBCTWULT       
BRFQWISQQXFFA   : TPOPEDBKFQOHM   NBJLUHRXHONUVRV
DVORAWDYWTWYR   : BCGAXRWXV       BPLQXHCLN       JJWNN          
GJPJDWBCIVU     : FTITKUU         BPNBAXPMH      
TBGTVJQMEQJHR   : VGIWQSFIPBJI    MNHMKOR         AHJJ           
CRGTNOFDXKDBML  : XCRVGIKD        XGNTS           RGYOODFITA      IRJIRPWHEX      XEOSCXJPUFJSBBL RLUTDVMJ        IJSOFGSUV      
IMTJSOHEHTIAF   : VPNPBRURWE      FKYGPV          VSICSEKMXB      IUVFMANJUNPLEW  ENUMK           WHBURWDCSPAYWCJ
UOWMUSCLXHLKK   : HMRUKBMWX       SADR            XMWJ            KPDWKBXDKYBA    BRLBSSWMF      
WVNHKH          : VABEGQWGYLMRDL  YPHLFMIY       
DXCKHXSIELF     : NXFFOKFVXULH    TPYKSQUKVDWP    ULIITKB        
KTPDVBDDONQ     : AOLDUJMCFIYESS  CRQIBXBS       
LOPUAXOFXQP     : DNSITVHOIPR     CAHTHJJ         RPJTNTTDHKKGMFI RXHIBXNVIQE    
PJQVWVOIPGNL    : DDWKFCLRLOPAJJ 
RQVFHBSYQOYQFE  : GVISQUQGOPGLY   JVGFIBWAHQ      LXHJGYKNUVS     CFPVU           EBGGMTXLRYN     SOCCDGKSC      
XWXNIOJFMAPCGEP : XTGIYA          MOINIYUVFE      FUATJIND       
XIOFQPYRIPQC    : EJXUDWMNVADOW   YGFI           
WVSTTJCKUK      : WLMRNQDBX       ETNPL           RIBIXLK         YPUIUVKIGJOSNLM
VABEGQWGYLMRDL  : UMQX            HUQHDBW         XMWJ            WVNHKH          UDMSLKWPITIA   
NDCRAANSVJE     : SNLFKXETLHGNNLH SJAC            BSELIODTPF      VWCFYDYYEDQE   
TALSXNTEUKBDMOP : RFOTA           JHDNVGEMSHCLCUP RVTJMBXWJH     
RDQGGSXG        : FJVFXXQG        XFLICX          LDYTAKFGEG      WTLFUPLDYYV     YULMS           YJJLLBJ         EQKPQIG        
OCRXGSSI        : TWLVDVQYP       NUBPB           VSRCRAWAMMIHNB  LVWTK          
NIRINOUOSHEKOXO : PTIRLSJQI       CUJNUHXWIMYVM   KHICWJGQW      
GWCFEATIRTQMMAS : SFBDUYXGVFKY    PQJP            RYXNI          
IKLX            : KQLLRIEEQFH     BKGHQWLU        UUPY           
GPWQVHHTXQ      : DCOCBXNPPVI     OLVWDSMJE       HRCGJYXQSIID    GRWJCLOYA       NJWGQFPI        YFEPBVBBEPY     HYMTGFCSGN      VBIFNTS        
VSICSEKMXB      : AYPPYANOMC      BAQJYIEBFEPQ    IMTJSOHEHTIAF   QJPEUTRDTWVH    TEKGRXUO       
NDTQMF          : WEOBIAOTCMQEYDY UNWIFJTTS       CHRIHBISNXTGRI  PMSHUTFGTV      FTITKUU         GYDBXSRRIT      NVTQYTKRNUND    RNRMPVTUFFPGAT 
MJMCGFXN        : BWHYBU          SKMFHW          UGKE            YRILYSJBNCAO   
UOFXKBGM        : MKYGP           ESNUSG          KXXKRKXKCOTEDVE NULRGOF         RXHIBXNVIQE     YMTXRDFAIGF    
MYJMA           : JMLP            VSRCRAWAMMIHNB  YPWJYMFMNLMF    XLXJNMW         LBFPOMXPFIXILKU
AEFSSMWFVMK     : BRLUVCLBTCF     LALAI           SXUFQJFRLBYN   
RIRHFGM         : RSVMLDBVOMHH    YCNEMYKIEKXVGT 
SNLFKXETLHGNNLH : NDCRAANSVJE     RNEQ           
XGNTS           : PBMUWBWJQKVAMK  RUIUTIH         CRGTNOFDXKDBML 
XNJSW           : ISVQSJRPB       CISARCNQ        LHTLUXTAOQSQ    ULIITKB         RMNV           
BJSUAECMFJI     : XRQCMFUCHLID    AQIAETYSQUV     HFGRBSN         EFLFQNDFDWFQN  
QOEGBNMBW       : NJWGQFPI        KVKWWMTHJWTOH   AWUSWLDFGARC    NDRCDKAIH       BWRISAJHKU     
XRBXFKQCBUO     : BKSLGPFOJUDFNQ  RRIVHLPRVINVJD  GYGFRK          EIKYPH          LOSXLGPDDND    
PQDTDIDLBVAF    : GKNLLBUDVOC     VPSBI           UTYXQP          GIUNPEPFV      
DVQFUTFMW       : UBIRRQ          IPMJEHA         AWGFUAELKEMB    XMYHQKKVSOBK    RIUCBMHSCBWFGV  CWNKINR        
UJWY            : VKYCLBCSU       FHWNCSFWTHFTLL  MNFONUOTWRI     DSIVYMAQM      
RNHJGKDJUJUVHX  : RHYNMTJTTKII    ARLLUJ         
MDBDKVYP        : WGIJ            RPICVNDQUJTXOK  PKHHUB         
XVEHSFS         : ICMUEMYJVWNYC  
TCVCOBMJKJ      : HBTCESMW        MNFONUOTWRI     FTMRL          
UHKHLMMXIO      : KXKRJKJDBSPQK   NQFIJX         
TMKAUDGPPCTNE   : GKNLLBUDVOC     JXLB           
OQVCBDYKNGXCUWN : OBCUJQM         MXHMWQTEOQI     CQGQN           NTLPDBVWSJ     
NHYXIVDONU      : OWPSFNN         XTEWCJ          TFQLSDVRVPQP    WCJOHHE         NRKUCCK         RPBCNJNAH      
HKWTYOPDRSCE    : QFKFGMXPLHT     WTJAYBTGWWW    
KFNIEBT         : OROYBPFRBC      GYGFRK          LAUX           
IUTS            : UVSVQKSNKXH     LJXWUF          BGDPRBP         AEJBKSNGQAYRPQ 
WJETCNECHF      : NATOWPBYIVHMKF  YUMNRNK         SVCLBODEGA     
WLMRNQDBX       : TWLVDVQYP       YAKXYUBLJS      WVSTTJCKUK      WWUWIHJNH       IOEHLAYQSM     
JERDXCYRXR      : TONW            FCFSXH          UADXNBCGWG      CLNOMD          YPHLFMIY       
JYMMOQQWYJ      : JEBAPOVQJIAG    PBBSWDDF        UJELERP         LSDIDEIMN       VBIFNTS        
KVQXOTBNKKTEQ   : JYGGVCDMMVCY    JEGFQIHYJNLIPXJ FEPGGCKHC       KLCL            WKEGM          
IRMGJEQKQF      : MNBSTLW         WTJAYBTGWWW    
KXYJHUVDNT      : OVDUNPURU       OYRHVVDSWU     
HVHTICAYWJQ     : BQBD            JJWNN           WACWNQIFYRUSBT  CFWKUGYFRLX     NBGARV         
RDPKNJRNVP      : IDHDL           YSNDNAEPKA      IJNT            TBTMHW          RTTJLTYL       
FWKBCAWUKUCEE   : KEOTABRN        LCMCNVFMNBVR   
HFDQYNKEFV      : NCANVD          DWXAWLLLECF     ESNUSG         
OPIKGWRFJUI     : DXVR            SJAC           
UFUPHBVOIETBDH  : XRVSPPLRAGFLAC  JYFULIHP        SJAC            PRBVYKULU       MDAAC           MNOMARUQWIUAHR 
HPMBECLRKJLSUH  : USPEWXFAKIEVDLT GKAIFIEBNY      EEDTGTKEYWGS   
FEICTRGSIQYD    : KIRQEXFLOMHEAEG JRPPLG          PHEGWHTHINPRBO  HINFDYBUOVCLJB  GVAOJ           DCCFTDYRNMNSGKH
CKJL            : SGODUWFR        JXILWKAJ        CCKFPSRQBWBG    YFUWXGJKJYK    
VOJABBNMOG      : TNYCFAHDEBOMJT  ONJVNVAXMVFIT   KUPAYPYKNHH     IVWNUYKMWO      SMQDRMJRFCUG    LAUX           
XJPCTTYLARUT    : HBJOXCOBQG      IVWNUYKMWO     
XOUKXINVYWXCALO : IGYRGYRWO       VGIWQSFIPBJI    MVSXNC         
TYPDORWI        : YJRCEONM        GFMRLXDDRRG     YOJTEPJAYAON    CKVJKYLCWCC     CLNOMD          GWDVPGHFW      
LLKG            : QYNR            NXFFOKFVXULH    ACLICBDCUUU     LYCNSUAULNSN   
DETAQTIER       : KVVUGMEYGBUQTIY GXEMGNDBOCUFCVB QBCEU          
DPMD            : LPKGC           NIKVRY          EKDHQKWPUH      IYVMRSFNPMLJIX 
CUXB            : GHMYD           BDTREGCLB       XEBAWPNEEX     
EREBCXONIU      : YKSQSXBM        KDWOI           JRPPLG          CIYN            OEEXAGMNMB      YPUIUVKIGJOSNLM
OBQOSMXYEIDWWIB : TNYCFAHDEBOMJT  VWDXAJPOFCN     VTNUVHGDXNV     KQLQWABNDSCB    YJYOI           LOLXXMIPKPSA   
FBCR            : RRIVHLPRVINVJD  PKQDWHYBETPLNU  TCQKBCLLNPKV    EHVFVMH         BSNMEWNVRHPA   
VWJYWXOFTKTUD   : FYJNQBNLQEY     DGCC            HXCVCLUSKPBDQ   VSRCRAWAMMIHNB 
PQJP            : GWCFEATIRTQMMAS JSKNDUHFWN      CBGJVJTQINY    
TSVQDY          : GVISQUQGOPGLY   RFMKDE          OKIFKBCDXBQOX   BEPXWIPFH      
JBWDGT          : IGLWBAUVCCQTJ   NFOVNX          JNGJ            HWOLXUWG        ENAFRKIBESB     MNOMARUQWIUAHR 
PSYOHFKTBHAMX   : GEDUOGERUV      UMQX            DXVR            YSIRGXNSGHWFR   BKBXBNAODKSDSML EDIHNPPN        BSHBYHELCQP     NWVLPGUCXUPQBXS
PSYOHFKTBHAMX   : UMPUPQPRXNUL   
XNPTIMNNLI      : NGNSUHOIBPXV    HWUVYAUHSITNKJR XUAI            AKHLPHWUDVNE    VIUXLQNTVNLQUA  VWCFYDYYEDQE   
OFDVYF          : UGKE            WGSLNITN        GMXRUTPUYOHVKPA EMCFAKNHU       ONFYMNOITYUVOEQ SANPFFLCNTF     POKVUQJBPRXOY  
TFCEMOAPWA      : PWYRIDK         MILSAKDNHY      MHAMOQVEKMXMC   QBFBCKLQGIJNMCI UDUXVKJCIJ     
UQDKJAUV        : FTWDTGFMWJKVD   QAXUTIQANB      VSHLALYGSF      PBBSWDDF       
KJVKYBNUDS      : UGMJPOC         WDAUQQMNS      
WXNDK           : WLGD            JKEXVTW         MVSSQEVXQHH    
EBBE            : YRONISJLBTNUDJ  OTOPGA         
XVLKHLHDBS      : EWSKPYKH       
WDNBSKGLVF      : DGCC            UYQHAVPSSHJ     NFAJWTBCIBJTKLF TKBOS           BOQSLDCXK       GPALITBTNYCAFT 
JJWNN           : DVORAWDYWTWYR   HVHTICAYWJQ    
RRIPPWBWIKCKD   : LNHJWKGFKKRI    BFSAYXQYXIMMD  
JIFMBQ          : XFIAONESDSCYVJX OVDUNPURU       KRGN            SHPTDGVO       
NMYAXIYNXCFPMX  : YQEG            KSSMV           WCJOHHE         OYRHVVDSWU      UHANYPKWIYBHJCM
JYFULIHP        : UCMUC           UFUPHBVOIETBDH  NYROGMFHGQMI    RJQFFAL        
QXFGCXBPKARK    : PAFUJWKIDUH     EJVFQQRYXHBR    WTENJC         
SYKWGB          : DGVNJXAVNRI     RPVCGGCDLUCQV  
EJVFQQRYXHBR    : QXFGCXBPKARK    FSMPNLITXUP     FYCPVARVLO      IXIBLYGODCMXN   PKHHUB          NYKCEVWKNFKDQYT
HXJHYBUCUFOOGAL : NGNSUHOIBPXV    UHRTLWYCCP     
BXRMUX          : CUJNUHXWIMYVM   LBWVWOE         HHJYYIIDCYK     JOWMOKXTG      
LPFMYGEGPESXDTS : XGQJVKI         OVJURRETLF      PEXXD           BRURPF          IMCORXGXCJRK    IUAELNBVQ      
PXWGF           : LCCH            BJRF            SHMI            KIQBATDUDWHQD   LPSWCTR        
RUASMONKTBCYPBG : UANMQU          YFNTKULUS      
KVXDTE          : KIEJNMYSBBPCPU  CBNDU           KWVAMUKWOHUPG   BAMJBEISXE      AWKTDJDISWSXX   ENAFRKIBESB     AHJJ           
ONQPKWWJR       : XQIKID          MKHEDSIISYH     TFFRCFVLHY      WPQGPNLNBCJBHX  KQNVRQJKLKIX    YMTXRDFAIGF    
LKEAA           : WPSWTLDWJW      QIFXJAO         NBGARV         
UBVVRXCN        : KDCT            RJVOSJBIPIXDGUT AIDWYHPRMWOQG   SGSJOJIH       
BOPWUOMIGCVFBHW : QCSSGTVMS       UCYDSMKICEQDW   SYSPNABRTOML   
THYVHQSLPP      : ECAND           JWWKGUFF        OHGMCN         
PTUAUJPSGGHP    : SANPFFLCNTF     XEBAWPNEEX     
LNUMURHOCGLJAGW : XETQGRHO        MMDA            BTHBT           AWUSWLDFGARC    GVAOJ           WKEGM          
VEFQA           : VNUG            MBFLVKG        
NJWGQFPI        : DNSITVHOIPR     GPWQVHHTXQ      QOEGBNMBW       DLLTCRDIH       WFFCKCDD       
BVRPQJWILEVX    : DXMWUVPRA       KJPETRNHQYYDAXO BAMJBEISXE     
CWVYCBRCIFNH    : WTJAYBTGWWW     DLIPVCGQEDPQ   
EMEO            : HIPOXQMUBTQVH   YAIWGUU         UGMJPOC        
GKBVENVMYAIY    : TUGTBRXWNWTV    GVAOJ          
KWCLBDDDNJQ     : IJWR            GTEHALBEQY      NBGARV          DNDXXGLHITG    
XXHEMRKA        : LTMNTY          FKVIQX          BRYKDOIC        VNRBPRPI        CWLXJM         
JEGFQIHYJNLIPXJ : BMOFLB          KVQXOTBNKKTEQ   RVTJMBXWJH      CFGJTOFKOJT    
DMIMGDMEMRSEES  : SQGDMWY         RIGMLUJR        ETEIJFQQYF      UEMGJXHSUK      IOKTVAWBPDY     GPCUJIICJYWBDL 
PWIWNSEODTBLLBX : UYQHAVPSSHJ     SVCLBODEGA      DCBRBHCAYU      ETEIJFQQYF      JIKCPFXCEABG   
EKQTSVIWJ       : TQGOAVPUKVLSGIF NDXS            YVKYRTKUCBIVYC  TMQCSUWUF       EEDTGTKEYWGS    HDQUONW         BHCTXNT        
QPJJRY          : HCJW            DVENT           OUIQU          
BYWTFO          : CIOVGKREPWINU   BKGHQWLU        SQWLTTGPLWIO    XQYNXGYG        BDIGSW         
ARLLUJ          : RNHJGKDJUJUVHX  IWFDNULDL       CKUXFDPEEIMLJXN
YVLUPIEOTIFJRRC : NQSREHNXB       BCGAXRWXV       IJUXTDLXLP      TPYKSQUKVDWP    GKAIFIEBNY     
BFSAYXQYXIMMD   : RRIPPWBWIKCKD   GKAIFIEBNY     
HFTSALDGB       : BWUWPDBFCOJ     UGKE            NQFIJX          YVOXLMICQ      
PIJJCNDDSXG     : PNBRRTNCSBYTLOD HOWK            SUGKVGIBOW      RRQNQHWMTOMYHJ  EFFHLRYUCSIW   
WWUWIHJNH       : WLMRNQDBX       MQRI           
SCMVPPEQPVC     : CLNOMD          POKVUQJBPRXOY  
GEOLKJKQF       : FBYCKXOEE       LHTLUXTAOQSQ    JHQEVFJCTXI     NTQD           
PBGXKQOSJJWX    : IDHDL           IGRYHDUD       
MQMGGIIJQ       : SECWROKQKODP    BHFBUMXJ        ICIJLPKHDKQFIX  REIWYWWYPLGLSEA
ADYJNRQWITDIF   : SJAC            QTYPORIV        SKJBGUTXYTC     XNLV           
YAIJYGQNWDVFO   : PBKFYLRTJDODYE  KEUBWKDFYQW    
OHVOKUAAPRWAL   : BRLUVCLBTCF     UDSGIMTPQ       FVMFKBV         GGGLFIRDNHLKJW  SFRXFWKJHD      SOVY           
KSBKSJTT        : AJIXALRMLMIVWN  QLOFDAMLL       WSOEREFCHFH    
KIRQEXFLOMHEAEG : VOJUDOTYDUKGAO  ORURMNLUMGUNQ   FEICTRGSIQYD    PAGM           
VXAVM           : JYWGEAQE        TPYKSQUKVDWP    WPPVSOLX        ULPYRF          JIKCPFXCEABG   
HFGRBSN         : VSEPRSLWOF      BJSUAECMFJI     HIXSGLKEOKXKV   EFDX            EKBBONRMP      
NXFFOKFVXULH    : ODIFARPDX       LCCH            DXCKHXSIELF     LLKG            MXBWABJSR      
LNHNKI          : KUBEF           FLOXRTPWYNOWUU  OOGFTLDV        GMXWXYEHGVW     UANMQU          KEUBWKDFYQW     XCDNKVSUTEIVRKS TELPUTXYC      
LNHNKI          : NEOUKSOOJVCUHET VPINFDNUEBNNY  
IUSPACJDUWYI    : LHTLUXTAOQSQ    JHDNVGEMSHCLCUP NDXDEAGTPDY     PXYQPE          KKRA            CNAQ           
EPOQVLOSYV      : UNWIFJTTS       TVDQDCVNF       TPOPEDBKFQOHM   VNJIWCHGG      
MMDA            : LNUMURHOCGLJAGW PBPWWTOR        YCSMSTVGGUJKUOA SYKFOSIJKH     
NQFIJX          : NDXDEAGTPDY     UHKHLMMXIO      HFTSALDGB       RMGRXVI        
LJQIJPQHWJXNFLF : PTIRLSJQI       AODUPUIJQ       PILAIKMOFTVCPH 
KDTWPYAOP       : JEBAPOVQJIAG    GWNNWBA         YAIWGUU         RWMHKHPWVJW     XLMU           
WACWNQIFYRUSBT  : GHMYD           VUKOYLTTNF      WOPMCMH         HVHTICAYWJQ    
AKHLPHWUDVNE    : IJWR            ELHJH           XNPTIMNNLI     
ETMBUPA         : YDBFQK          TQGOAVPUKVLSGIF OPTCCEYT       
IJNHBL          : WLGD            QBBBAGFR        WYKYOLMYID     
DFEFRNQJW       : OQYENEXIJRA     BEPXWIPFH       PCWKHADYMH      BXMDEHY        
FAMUHKYDXDXPD   : QCIOMHLAKWLGQ   DIMBPXKTVVDEV   VVYKOOAKYX      EJPOOVJKKHTTKE 
XMYHQKKVSOBK    : CDHQFEB         YXPMVEQ         DVQFUTFMW       UEMGJXHSUK      BAOAPCDPCKXDYU 
RWCKCFWYMHXPH   : HYAFDW          LNCGETFJTRGQN   WHTIWGTERIH     WXIIVQCH       
QYHAWVYFMM      : SGMTJWRIS       ILTGBJEIC       JVPXSGQBTHPCY   IMGLUVEDPAEDJ   TGJXJKSN        HIXSGLKEOKXKV   GYDBXSRRIT     
IHGJT           : BKXIHPH         VEFXCARKTTBUYOY HBJOXCOBQG      BKBXBNAODKSDSML
EQOOUTNTGW      : KUBEF           WASTI           OXAUX          
XFVOEFQE        : FGPLXRENOHTF    PWYRIDK         WILWEOYM        JWRHUB          NBJLUHRXHONUVRV AUPPKDFKYVIK   
QLOFDAMLL       : KSBKSJTT        CFWKUGYFRLX     DPUEIK         
XRAOIWIVRQTM    : QRNK           
BKGHQWLU        : NYVSPCPIDKRBK   IMXIMABTQX      IKLX            BYWTFO          VOEPMCTAKSCLQHC SANPFFLCNTF     CCKFPSRQBWBG    JIKCPFXCEABG   
WLWCNLOAUO      : DXNU            MJKJAAP         LRXFIUPK        XGNVQGNTNPWPWJX
WDDTLBLEUAUXNB  : DXMWUVPRA      
GBRBQRMOVD      : NYKCEVWKNFKDQYT
MDUBYTE         : ORURMNLUMGUNQ   EMSJQONAHEGK    XWXEJCDVTLSYMF  DPUEIK         
ORECVB          : NVYGW           EBBHS           QORDIPBPIKUBV   TEQMIHPQBSW     IOEHLAYQSM      GTCRU          
RCQUIWVCANVOES  : BPNBAXPMH      
EFWCHWVNBK      : CQLWHF          VLNMG          
HNCLSVNLRVI     : ICLD            YRXYCRACDMXQNV 
AIDWYHPRMWOQG   : UDSWIF          UBVVRXCN        FMQUSQRARB      CCKFPSRQBWBG    CVAGQMVAU      
MUPABW          : CISARCNQ        HXQOHXMEEV      WTJAYBTGWWW     YFNTKULUS       UGMJPOC         CLEUXA         
FKKCXVVVEJWONTN : JVPXSGQBTHPCY   TXGJHDRIYGGAIF  OAHCDVXIIML    
LHJIWCRMRMCRNC  : DPQYGRW         OOGFTLDV        SJFWLX          KNYWUGDDR      
UMTWNPSJ        : KVVUGMEYGBUQTIY JHDNVGEMSHCLCUP MAEGK           DPSTGBJT        HCJW           
FIMUECRPKCB     : BYTGCWYFCS      EKQMCTAEAXNDAP  RCVTEQVUGGCNDF  FYCRCGNA       
ESVVFBPU        : KXNQ            CPNCXWTXUM      BMOFLB          YCPMSEF        
BPTU            : IGETGFDFJBP     YKAYDPYQXEE    
HMKT            : YJUDQVVK        VWFFPJN         BMCVEECY        TJXGFBK        
PCWKHADYMH      : DFEFRNQJW       MCCBYTEKPHJSNN  LOKKQR         
VNUTMCUEYCGRWD  : DXMWUVPRA       JJUJYEIS        HKISSXRWGIBJYU  PIPLXIJSBILPHM 
ESTXD           : UDSWIF          GBDSTHSCITICK   IHQMBLKXS      
DDWKFCLRLOPAJJ  : PJQVWVOIPGNL    EPGPEBUSSD      GMXRUTPUYOHVKPA SANPFFLCNTF     KQNVRQJKLKIX   
OHSNJBHIFQNX    : WPPVSOLX        TGHPHJIL        XDNTVDMBUYLOFN 
NDXS            : FTMEEIUUESBID   EKQTSVIWJ       BPNBAXPMH      
UFLARDNGSNPF    : CYOEYTMYLBFE    FSBJB           FCHKKTYNKI      XEYEKJNHFQ     
GMXWXYEHGVW     : HBJOXCOBQG      LNHNKI          JEBAPOVQJIAG    IYCDFQ          LPSWCTR         UMPUPQPRXNUL   
JMKHGQELDEDISJE : XQYNXGYG        DEEQHTFTFOY     NVTQYTKRNUND    DNDXXGLHITG    
CJPKX           : TVDQDCVNF       IOEHLAYQSM     
HXQOHXMEEV      : XTIHDHFXVXFT    EYRYU           MUPABW          EDRNRIAYNKRSUP  XSNC           
ODAIHNNOTVJFAT  : MJUR            VSXVBPT         ESFQ           
JJUJYEIS        : VNUTMCUEYCGRWD  HELTFGDWGNI     ENAFRKIBESB    
PQHWWDQOI       : CNAQ           
WSIKHCISKJM     : OEQGKWKVXE      WEPLTTCJQIVUPTR VGBNLFAQOQ      UADXNBCGWG     
UYQHAVPSSHJ     : BKXIHPH         WDNBSKGLVF      PWIWNSEODTBLLBX
EJGWXPPW        : CUFFNDSJR       BSNWUGEFSUR     UGKE            QSLFI           EAGDGDJ        
BJRF            : RKFDRCWGUJMY    PXWGF           NQTVDLDDR       GPCUJIICJYWBDL 
KPDWKBXDKYBA    : NUBPB           OWPSFNN         UOWMUSCLXHLKK   VLDKYJ         
UJEVONENNTGMEHX : CADBYDIJR       GSJSPEXEYGM    
MRGDXGPY        : RYFXETJI        YKAYDPYQXEE     HQMEMU         
SJFWLX          : LHJIWCRMRMCRNC  FUATJIND        FDASJLND       
WEPLTTCJQIVUPTR : WSIKHCISKJM     UCTCTWSNX       FRYLGTVACXLWT   UPPSTACRCPSKXYE XLXJNMW        
LXHJGYKNUVS     : YPPBYIP         FLOXRTPWYNOWUU  RQVFHBSYQOYQFE  GGKBXSGRVSL     RRNYPRLIDVF     BAOAPCDPCKXDYU  CQOIJY         
JSLHWBUSWW      : HYBW            XLMU           
NFAJWTBCIBJTKLF : WFIDUDWBEIXHW   YBMHJPPKEOQJOT  WDNBSKGLVF      FTITKUU         DSIVYMAQM      
GDQAP           : FYAA            JHQEVFJCTXI     LOTHGHBBFOE     QCPJRHCVRIUY   
LWJORDLRH       : OKIFKBCDXBQOX   XMWJ            GUDQLDE         RPJTNTTDHKKGMFI
WILWEOYM        : DWFIGFAJ        VGBOSUJMRGW     YSIRGXNSGHWFR   XFVOEFQE        NQAR           
KHCV            : VNWDTSE         DEXJVM         
AETTE           : KXNQ            MVPKRHHSLYOT    GMXRUTPUYOHVKPA IOCWVQIJKRXNQFI
EPGPEBUSSD      : SOQWK           DDWKFCLRLOPAJJ  UYYAEIM         EKBBONRMP       HDQUONW        
RNGQ            : SASJBSP         HVVOM           IAHRLRLMGX     
WPHOBO          : LLBFMEB         RMGRXVI        
YFTEBNK         : DNNVVYJD        MIYNVORVRXYASO  IJUXTDLXLP      FCFSXH          RNRMPVTUFFPGAT 
TBTMHW          : YRONISJLBTNUDJ  RDPKNJRNVP      BMCVEECY        XDAXGTO        
APMUKCD         : HMRUKBMWX       GCBSYESARIYKRS  NBGARV         
UCTCTWSNX       : HYAFDW          ORURMNLUMGUNQ   WEPLTTCJQIVUPTR SCBOLIJKOYBUHYV RCOEBJCOLDHDA   AUPPKDFKYVIK   
JEBAPOVQJIAG    : JYMMOQQWYJ      KDTWPYAOP       GMXWXYEHGVW     BRURPF          CCKFPSRQBWBG   
BYHXLKEOHGIL    : DEEQHTFTFOY     BRWSHJOWFKAMUNT
FEPGGCKHC       : CJAVKAAO        KVQXOTBNKKTEQ   HILQK           BXUSQPCPN       ENUMK           WXIIVQCH       
WASILT          : SKMFHW          RUIUTIH         TKOPITXSL      
GWNNWBA         : NVYGW           DEBXLDTUTK      KDTWPYAOP       USHUMCVVHYHN    RDMMOF         
QJKYUOHBFNHJARN : NUBPB           XDNTVDMBUYLOFN  RTTJLTYL        JUFSVPQLANJCECY
QNTYB           : LIRT            AQUOX           UHHJUPTGXWTQTFU BWRISAJHKU     
PHMGV           : QHABYLHVMXLQL  
HXPXIAADPJHWWO  : FBBEYWV         HEWNIWSJXVT     DNCRKLW         XDJTLRPWXATFHV 
WIVAY           : NLAVCVWJYJR     EYHFISKDYWHL    LGGIHLGUOACJ    BTHBT          
UANMQU          : AUASRSQQFQDWH   RUASMONKTBCYPBG LNHNKI          GTXESOMCXBDI    BHCTXNT        
WSOEREFCHFH     : CUFFNDSJR       MVPKRHHSLYOT    KSBKSJTT        YKKYN           JNKPLY          VNPO           
OOXNGGMOCN      : GHMYD           JHQEVFJCTXI     YGLLTNJDXW     
PKQDWHYBETPLNU  : NFVWC           RUIUTIH         FBCR            NGQBGPJFWVQV    NBGARV         
PEXXD           : IJOLUBTVAJVREKE OMSLFOIJY       LPFMYGEGPESXDTS MNHMKOR         SPKXSG         
OBCUJQM         : OQVCBDYKNGXCUWN WTJAYBTGWWW     NRJMBYHUJF     
GBDSTHSCITICK   : SYQNOG          KFCFEDACSQIS    ESTXD           SYIAASTSTL     
SHMI            : DQOSSMV         YCHJPMCYX       SXXMWKPOTTFS    PXWGF           EKQMCTAEAXNDAP  PMSHUTFGTV      GRMNSRM        
KIQBATDUDWHQD   : PXWGF           ETEIJFQQYF      RHJUVWOK       
VWFFPJN         : YDBFQK          HMKT            ULPYRF          WORBMCSJ        SNRRVCICUSX    
RSVMLDBVOMHH    : LDGYIEWIDJTO    NVHRWNGJ        QFKFGMXPLHT     RIRHFGM         TMDLJVRP        OAHCDVXIIML    
HBTCESMW        : BRYKDOIC        TCVCOBMJKJ      JKXUGTIERRKU    HELTFGDWGNI     JQEPVVEX       
YTUGY           : HOMN            UQTU           
PPWIKSWVY       : XGQJVKI         DLLTCRDIH      
TNMBX           : UVVUNRVI        RPJTNTTDHKKGMFI
IYWNE           : OLCXCM          IPROBCILIGDY    GMSJQIAJRUWFYR  DFJCAKQNXXKVQ   DXMBXMXXDEX    
CBNDU           : KVXDTE          TONW           
KWVAMUKWOHUPG   : KVXDTE          DCBRBHCAYU      RTTJLTYL       
DUSDXDDW        : PIUWTGSNOTSL    BDXQYQWTMXHRJI  YUUPXY          YLLYSHPAIIBUN  
HOWK            : PRKRKL          TKLFX           SHGUOSFTVKJ     PIJJCNDDSXG     ORTRCUUQR       IJYMLSOHSY      DNKUBEJSCDOHKG 
BIOLFMN         : BYQSFUDKLQGT    YVKYRTKUCBIVYC  LHQSYCSDHO     
IBSYINOQE       : WDSC            CQOIJY         
MYXKFBIAKY      : YSNDNAEPKA      PILRGNS        
UCYDSMKICEQDW   : FSSKTANJLPQTX   IJOLUBTVAJVREKE QSSLFGQ         BOPWUOMIGCVFBHW CFPVU          
OMIFTCTUCHCFR   : FJBKW           OFGM            DGEULJDXISSHSPN YFXLB          
PQBNTCSO        : QAXUTIQANB      SPKXSG         
EWSKPYKH        : POXLPWSAIJUE    XVLKHLHDBS      WGVWCDOGXXRI   
YRSUWPQY        : IJNT            VNRBPRPI        LFERCUQNQH     
SHOXYFYMB       : ADGXQD          HWOLXUWG       
ISTOPPBIOLP     : SMYPYWDTELYK    DFNJOKIJS       IOKTVAWBPDY     EQKPQIG        
NIWIFMBGLU      : GMXRUTPUYOHVKPA
ASPIUCL         : LCOVNLQJXJE     BRYKDOIC        EHEP            GTCRU           QJKM           
KEUBWKDFYQW     : BIMHKL          YAIJYGQNWDVFO   LNHNKI          GCWRYG          JVKWBCTCVAKBB  
EHAPONQVBN      : IMIBWNXRUNL     VNDPTBAPS       GQQOKCLCY       NVTQYTKRNUND   
CJBMGG          : DQOSSMV         XQIKID          FOYLSCYN        TWSTEXHY        GOLUYI         
GSFBUENXJMQGR   : DQOSSMV         KIEJNMYSBBPCPU  GXEMGNDBOCUFCVB RRQNQHWMTOMYHJ  RXBPCOO        
QSLFI           : CDHQFEB         AGJWHPE         EJGWXPPW        YDYDTISAGWFPOUF WTENJC         
DJSPNCSAIBBOUI  : LPAIVN          FNVEVKXDVVYJLMO EYRYU           HXCVCLUSKPBDQ   NULRGOF         TETVMC         
RMGRXVI         : WCIKKIXFH       NQFIJX          WPHOBO          JWKRH           EHVFVMH        
NGWGRDOWGBP     : CGWJOTJIDE     
ORTRCUUQR       : HOWK            NCLLHWQMQKXH    DKFCPRFIBHKJLV 
JJRQDPOOXCUVJ   : TDUD            LVWTK          
BAMJBEISXE      : XAJWN           KVXDTE          BVRPQJWILEVX    YJYOI          
AYHSTK          : DIMBPXKTVVDEV   IABLBUNFQCIFH   MBFLVKG        
DEXJVM          : UAJMUSYOCWIMRE  UMGURXI         YRONISJLBTNUDJ  OUCOXUIFQYBSJN  NIKVRY          KHCV           
TOURAKSDWDGDN   : HAJTYVRJA       CUCMUGRKFP      QCSSGTVMS       YGLLTNJDXW      HVVOM          
BRLBSSWMF       : ILYIJGYVUOPH    MPLMEVEHC       IUVH            UOWMUSCLXHLKK   MXHMWQTEOQI     EHVFVMH        
SJAC            : FYAA            UBIRRQ          NDCRAANSVJE     OPIKGWRFJUI     UFUPHBVOIETBDH  ADYJNRQWITDIF   OFGM           
MCCBYTEKPHJSNN  : HGTYACCALI      ECMTLTR         PCWKHADYMH      RVTJMBXWJH     
POABSUUPICTDMT  : FGPLXRENOHTF    UVVUNRVI        SHPTDGVO       
TGJXJKSN        : BDTREGCLB       HDMAOSRWID      KDWOI           QYHAWVYFMM      BNGBS           ICMUEMYJVWNYC  
IWFDNULDL       : SYQNOG          ARLLUJ          WTLFUPLDYYV    
GGKBXSGRVSL     : LXHJGYKNUVS     AOGPBLCGXHBACM  YRILYSJBNCAO   
OTOPGA          : VPNPBRURWE      EBBE            DLIPVCGQEDPQ    ACHSBMAHJ       DRGOPMJAPJPW   
TWSTEXHY        : XETQGRHO        CJBMGG          BSELIODTPF      DPUEIK          DNTLKKAPVF     
MNBSTLW         : PSAVO           GLCTUYU         IRMGJEQKQF     
HDKF            : HMRUKBMWX       MTOIHSRHEUH     JABOYMISVOJANP  EFQXDUB         MNHMKOR         ODSJDHQPF       NAPXSFWKVGXKSG 
YLMSCCYEM       : NVYGW           EYHFISKDYWHL   
CHRIHBISNXTGRI  : NDTQMF          UMLWAUYCIVANYP 
MPGXUEYITTLXVP  : OMSLFOIJY       BPLQXHCLN       TOMTFIJGU       MEIOUVEB       
TTWLDFMNAALUG   : OXAUX           ICMUEMYJVWNYC  
FMQUSQRARB      : VEFXCARKTTBUYOY AIDWYHPRMWOQG   MBFLVKG        
LOTHGHBBFOE     : GWLLW           ECMTLTR         FKNXG           GDQAP          
BTKDFHMKMYDJT   : VWRCDVENAP      PBKFYLRTJDODYE  ELUICORPT       FBIQMHFMGJWWS   QOSEU          
ETNHPAVK        : UCMUC           CEEVGCK         LWNVPASNDAKSD   XSNC           
CRNFWCJJGF      : NMUQPI          CEYDDWHPTJQUKX 
JKEXVTW         : DWXAWLLLECF     OMSLFOIJY       WXNDK           EHVFVMH        
FRVJNLSELQOXV   : THUC            LHYUAKJHVPC     GPCUJIICJYWBDL 
LBIPNRVSOIEV    : LBTPGUHDKEXOEQ  OKOCRTUSVTGGDTY UNVQCWUTAIHN   
CRGDWABJNNE     : SGMTJWRIS       SWLFHGAFXXOJBXK GRMNSRM        
YVKYRTKUCBIVYC  : YCHJPMCYX       EKQTSVIWJ       BIOLFMN         YJYOI           HMMHAKQQY      
HILQK           : KDYPSEID        FEPGGCKHC       WDAUQQMNS       QJPEUTRDTWVH   
WPCYRNMFSJGQTGI : GUDQLDE         GKMTTPTSUQN     WTLFUPLDYYV     WIFQN          
QDRTOQTQE       : CUJNUHXWIMYVM   GUDQLDE         KVIUSWWOMVPFNV  EJEBTUXKTFFULGI
BRVNUSDYRUNHCG  : CJAVKAAO        WFMYWGI        
JWKRH           : FLJEDQLCEPUL    FTMEEIUUESBID   IMGLUVEDPAEDJ   RMGRXVI         CSATB          
IMSF            : JSKNDUHFWN      HLGIFSNLN       MQRI           
LBTPGUHDKEXOEQ  : LBIPNRVSOIEV    NQTVDLDDR       XLVFR           TELPUTXYC       UMPUPQPRXNUL   
RAQASAYD        : OKOCRTUSVTGGDTY
GGCUCJWNKS      : RLBAXOYX        TSCOBHICIB      YKKYN           XLVFR           PBMQTJKB       
TONW            : XCRVGIKD        QEVXMTFM        JERDXCYRXR      CBNDU           CVAGQMVAU      
UUPY            : IKLX            ONFYMNOITYUVOEQ RPVCGGCDLUCQV  
ESNUSG          : KFBCIYCMGFW     UOFXKBGM        HFDQYNKEFV      MVGQAWD         EDEOBIP         QCGJA          
TMQCSUWUF       : EKQTSVIWJ      
JRPPLG          : LPAIVN          LIRT            FEICTRGSIQYD    EREBCXONIU      AYIGHEXR        KJVCMBGIGQINJ   HYMTGFCSGN     
KHAGXBV         : LXKVIE          FTITKUU        
TKBOS           : OLCXCM          NJIH            WDNBSKGLVF      THDYELV        
IHQMBLKXS       : GWLLW           PIKAPWLVSFLKHB  ESTXD           OYJBILCYGTBM    IEWETL         
JNVBBC          : EJGJKK          CQGQN           GSJSPEXEYGM    
MMJUKLQQHDRY    : UMGURXI         PVAJWQ         
PHEGWHTHINPRBO  : VNDPTBAPS       RJVOSJBIPIXDGUT FEICTRGSIQYD   
ESFQ            : WGSLNITN        ODAIHNNOTVJFAT  HHJYYIIDCYK     ICIJLPKHDKQFIX 
ONRCFIM         : HAJTYVRJA       LGJLCPKTSY     
ALHRUOARXUB     : VFQHMXCBBY      PXQMRX          ATDHGLUHMT     
KRBNGYRYEL      : WEOBIAOTCMQEYDY
UYYAEIM         : IBBNG           PTIRLSJQI       EPGPEBUSSD     
IAYDUPDPOXQWKK  : BDTREGCLB       VKWXEAGNCM      JWRHUB          XSSDXYDS       
XQYQS           : CGWJOTJIDE      MPLMEVEHC       YCPMSEF         HTRERFBSSNPHM  
CADBYDIJR       : NCANVD          NSTPJOXGMPUS    UJEVONENNTGMEHX
UTYXQP          : PQDTDIDLBVAF    SGODUWFR        FXMSARPSOVYAN  
GGCADMKGL       : YAKXYUBLJS      WXECNBRBT       AOSGTURME       OUCOXUIFQYBSJN 
HEWNIWSJXVT     : BYFHLTO         MIYNVORVRXYASO  YQLDILQM        HXPXIAADPJHWWO  JKXUGTIERRKU   
PTFJ            : YDBFQK          SQGDMWY         EWSYYKKS        ENAFRKIBESB    
DAJGJ           : LBMEPC          OEEXAGMNMB     
IJUXTDLXLP      : SHNPUWQKUF      YVLUPIEOTIFJRRC YFTEBNK        
BXTTJUREFJAKST  : OVJURRETLF      FQLMSCMEYNXVSLO RDINMMM         PFDQGQHG       
UFVEWHN         : TCQKBCLLNPKV    NJRDWMCNIAALH   GTCRU          
HIXSGLKEOKXKV   : FYJNQBNLQEY     HFGRBSN         QYHAWVYFMM     
ECAND           : MUJQNGLURL      THYVHQSLPP      ANVSRDMXIHVDTA  LYCNSUAULNSN    HYMTGFCSGN     
IWCEDBKCIYW     : YHFC            NJIH            VYPR            CFWKUGYFRLX     UHHJUPTGXWTQTFU ENAFRKIBESB    
JXKRLUVBHWNDRSG : BWUWPDBFCOJ     SHSE            TCCNKJFMFGJG   
IJFTG           : JYWGEAQE        CHJFKD          RANHXBNNYBNQ    GCBSYESARIYKRS  EJXUDWMNVADOW  
ALJKQTL         : UAJMUSYOCWIMRE  QCGQQNVAUWPH    LIREXHP         TCQKBCLLNPKV   
LWNVPASNDAKSD   : MFEARTWKJM      ETNHPAVK        MXHMWQTEOQI     CNAQ           
LJXWUF          : LDGYIEWIDJTO    IUTS            YUMNRNK        
ENQPYDGSPWGMK   : NVYGW           JYCVIWNYW       RGTIPIAV        GOFXEDIQDYMJ   
EMUSP           : XCDNKVSUTEIVRKS
FJBKW           : IMKKAL          OMIFTCTUCHCFR   EWSYYKKS       
KVIQOMGFEG      : DLWGTGBAADCHORV VHSO            MBIUASEIXDYTDQI
NBBKIPW         : UFMRQSUGVFX     RTGOTSVCY       FHCODDHCYHSJ    FYCHDHRIY      
WKKRCHWNKKLAW   : AYPPYANOMC      WCNXDPYDIFOI    GVUY            MKSP            RLUTDVMJ       
KNYWUGDDR       : PNBRRTNCSBYTLOD LHJIWCRMRMCRNC  YMSYAWDQVSEF    ISXUTTSSDCOHDO 
GUDQLDE         : LWJORDLRH       WPCYRNMFSJGQTGI QDRTOQTQE       ODSJDHQPF      
NQAR            : OQYENEXIJRA     WILWEOYM        CQGQN           CBGJVJTQINY    
YGLLTNJDXW      : OROMUTP         KXKRJKJDBSPQK   OOXNGGMOCN      TOURAKSDWDGDN   LOSXLGPDDND     LAUX           
WTJAYBTGWWW     : FKQEQBLHJAKP    GEDUOGERUV      HKWTYOPDRSCE    IRMGJEQKQF      CWVYCBRCIFNH    MUPABW          OBCUJQM         TJXGFBK        
CDUPTWKUX       : CYOEYTMYLBFE    DWXAWLLLECF     AMTCJVUEQOWXHA  CHJI            IYVMRSFNPMLJIX 
GKMTTPTSUQN     : XCRVGIKD        WPCYRNMFSJGQTGI OCVRKIUCJFVH    LOKKQR         
QOJKU           : KJVCMBGIGQINJ  
KSSMV           : YQLDILQM        NMYAXIYNXCFPMX  IUNFUDQBDMFQ    RBRWI           SXOAD          
FSMPNLITXUP     : CPNCXWTXUM      EJVFQQRYXHBR    RJXMD           VGBNLFAQOQ      CIBRAGYNINJP   
MJKJAAP         : WLWCNLOAUO     
PAGM            : RLBAXOYX        QEVXMTFM        KIRQEXFLOMHEAEG MIYSKAY        
QHEF            : JMLP            GKTEPMTWWJEMGA  KXNQ            PINTIBYCVSOLTIY SADR            FCFSXH          SXYEDD          YFUWXGJKJYK    
VMYJCMWMIUJ     : KVEPHOMMMG      SOCCDGKSC      
OYJBILCYGTBM    : BSNWUGEFSUR     IHQMBLKXS       IHISJHIPXGY    
LFQRLWOAVADIYR  : JSKNDUHFWN      SXQPQUJXVCQKTB 
TCQKBCLLNPKV    : FBCR            UFVEWHN         ALJKQTL        
NJUAQLRE        : UMGURXI         GOFXEDIQDYMJ   
IFEIKMHC        : JQARMVANHVNTHF  JXILWKAJ        RXBTPIUMRTJBY  
DGVNJXAVNRI     : SYKWGB          JEWOFULBFJL     LGGIHLGUOACJ    POAOHPOERPBJTNC OHGMCN         
EWSYYKKS        : CSELXGWQND      LELIMVDBBRCFRPO PTFJ            FJBKW           WHTIWGTERIH     VBYTN          
SCVWKGLUJQXRM   : JXWOVCUVGR      EHEP            FRDV            RAEBXSMPTRA     NRKUCCK        
CKOAXGIHK       : SUEKQBVGCQWTFLX DGEULJDXISSHSPN RBCVOCMFUPTFUIX
DLIPVCGQEDPQ    : CWVYCBRCIFNH    OTOPGA          DEPXEYTFGDML   
BLUTKNGYRSNRSVC : MODDVGHVVWWI    UNMGAGOTDGU     BSELIODTPF      YULMS          
HKISSXRWGIBJYU  : YKSQSXBM        BYMDTVTGGYQOIPB VYVWFHILMYAPGPM VNUTMCUEYCGRWD  DTNEHDENO       DFNJOKIJS      
CGQWQEFPVYFPT   : YKKHTPQ         TDIJESOS        WCJOHHE        
SWLFHGAFXXOJBXK : CRGDWABJNNE     BDIGSW          UMULV          
TMDLJVRP        : GFMRLXDDRRG     YVQT            RSVMLDBVOMHH   
QQTGMXBMJGTSJCQ : PDGMLQ          VHFC            FCDAFMISH       WTENJC          LAMLEDIYUP     
QCIOMHLAKWLGQ   : JBJLNIAN        FAMUHKYDXDXPD   SGODUWFR        HTRERFBSSNPHM   XUKPIBUPXIT    
WHVRQJRTVCD     : YATPHXQFPGWQXTI FDYRBMNLFUUSMOJ
UMRNVKSGAFNLHX  : NCANVD         
THDYELV         : TKBOS           OYRHVVDSWU      CNAQ            AVOVYAYN       
EFQXDUB         : HDKF            ELUICORPT       AHJJ           
RPNHLXA         : NDXDEAGTPDY     XGMERSX        
AIGNPHALOELU    : MNYVWMW         SCJDTRBPBIRBDUK EFWSBNYQJGISP  
HVVOM           : RNGQ            TOURAKSDWDGDN   WKGTQUISQ      
RJXMD           : DSPMANOKFIE     CNFMUTQ         FSMPNLITXUP     NGQBGPJFWVQV    DVLKN           SXYEDD         
CKCDLUFTDT      : MXSJWFCALPPJX  
KTXYAJWRSSNJH   : SQGDMWY         BCUOJHNVP       IOKTVAWBPDY    
DSMRVCUGEATBF   : XBCPFWXVOP      AWGFUAELKEMB    YAIWGUU         BHFBUMXJ        TETVMC         
FYCPVARVLO      : JIHPAVYCGBKEIM  EJVFQQRYXHBR    YPWJYMFMNLMF    VBIFNTS        
EHEP            : ASPIUCL         SCVWKGLUJQXRM  
SSJFKFIHL       : YCNEMYKIEKXVGT  RMNV           
HGQPVVQXLM      : JMLP            ULIITKB         FDASJLND       
DLLTCRDIH       : NJWGQFPI        PPWIKSWVY       MVSXNC          BHFBUMXJ       
CCDHPKRWWHHFX   : BWHYBU          SAIAGP          PSCKKXKYLGXPYLB DIMBPXKTVVDEV   DHOKMXGFRIJPI   ACWMNIXNJWSQYFT
DTNEHDENO       : JUNLTWMFL       HKISSXRWGIBJYU  KUMBHI         
JSKNDUHFWN      : PQJP            IMSF            LFQRLWOAVADIYR  DNCRKLW         YFAOFGO        
MXHMWQTEOQI     : DWXAWLLLECF     OQVCBDYKNGXCUWN BRLBSSWMF       LWNVPASNDAKSD   LOSXLGPDDND    
GMSJQIAJRUWFYR  : BYFHLTO         IYWNE          
GOFXEDIQDYMJ    : THUC            MXSJWFCALPPJX   ENQPYDGSPWGMK   NJUAQLRE        IHISJHIPXGY    
FRYLGTVACXLWT   : IBBNG           FNVEVKXDVVYJLMO WEPLTTCJQIVUPTR TKOPITXSL       KEOTABRN        QCGJA          
CSATB           : XTHG            JWKRH           TDQA            DPUEIK         
YAVFIOKHBT      : MSTSNQONI       MVPKRHHSLYOT    TFQLSDVRVPQP    OOLMADSXFSSUJVU
GMXRUTPUYOHVKPA : OFDVYF          DDWKFCLRLOPAJJ  AETTE           NIWIFMBGLU      BGDPRBP         PILAIKMOFTVCPH  QTYPORIV       
SUGKVGIBOW      : PIJJCNDDSXG     LHYUAKJHVPC     DLBXNOXVKXSE   
YAIWGUU         : BDGWLNJIWWFCIXU EMEO            KDTWPYAOP       DSMRVCUGEATBF   VSRCRAWAMMIHNB  WORBMCSJ        NDRCDKAIH      
RRQNQHWMTOMYHJ  : PIJJCNDDSXG     GSFBUENXJMQGR   LGSM           
TGMCJDBXCBGAH   : FOYLSCYN        RUIUTIH         QCKHVXUKIX     
WKUODKFKH       : RKFDRCWGUJMY    OYHQITM         EQKPQIG        
EYHFISKDYWHL    : LDGYIEWIDJTO    LTMNTY          KFCFEDACSQIS    QORDIPBPIKUBV   WIVAY           YLMSCCYEM      
JJFMPFWSFHPTK   : SKMFHW          GKTEPMTWWJEMGA  HQMEMU         
AWKTDJDISWSXX   : JJGMYBXSWFH     EXTYWHKINSVIEV  KVXDTE         
FJVQSDEKLDD     : WEWNJKRCQQ      DEKYLY         
KVKWWMTHJWTOH   : MNYVWMW         GRWJCLOYA       QOEGBNMBW       QEXTLU          IXIBLYGODCMXN  
NCKOURXSLTWR    : CYOEYTMYLBFE    YAGXCF          RBCVOCMFUPTFUIX
KUMBHI          : PUYRIPD         TKTGW           TKLFX           DMCWYOFU        DTNEHDENO       DRGOPMJAPJPW    SOCCDGKSC       PGSHYLEE       
EFDX            : HFGRBSN         SGSJOJIH       
OWIDEUTGHI      : NQKTITJNKBBEM   DNDXXGLHITG    
CIYN            : EREBCXONIU      MBFLVKG         RNRMPVTUFFPGAT 
XFLICX          : QPOHUMMS        RDQGGSXG        VTTTYG          JAWAYSAARO      XVRCWWKODKNRFPL
JGAN            : YULMS           RWTMLGHLIDNRWJC
DNCRKLW         : LHTLUXTAOQSQ    HXPXIAADPJHWWO  JSKNDUHFWN      SONTKUSIEDKO    JOWMOKXTG      
IQYQYDU         : LDGYIEWIDJTO    IGLWBAUVCCQTJ  
DIMBPXKTVVDEV   : FAMUHKYDXDXPD   AYHSTK          CCDHPKRWWHHFX   WYKYOLMYID     
PBGU            : DLTKVN          RSNDPDPBXCAQNU  TFQLSDVRVPQP    NGQBGPJFWVQV   
SGSJOJIH        : XTEWCJ          UBVVRXCN        EFDX            HDVJAV         
OCVRKIUCJFVH    : GKMTTPTSUQN     CPCPFGL        
BMCVEECY        : TYNRDJUPGPC     HMKT            TBTMHW          LQPSXMAMQHXMS   GREAYMU        
WHTIWGTERIH     : ISVQSJRPB       YBMHJPPKEOQJOT  RWCKCFWYMHXPH   EWSYYKKS        QHTCRCX         SFRXFWKJHD     
CTAWYLDWTH      : DIRC            UDHJX          
ILWOPA          : WSBJ            QMFHPHNUVM      QAXUTIQANB     
RYXNI           : SYQNOG          GWCFEATIRTQMMAS
TCCNKJFMFGJG    : JXKRLUVBHWNDRSG CVRVHRE         JOWMOKXTG       JQEPVVEX        GVAOJ           LSDIDEIMN      
OELXFVKCLCECVEA : VPNPBRURWE      MPJACSA         SSVRS           FHCODDHCYHSJ   
MVGQAWD         : LALAI           ESNUSG         
CRQIBXBS        : TWLVDVQYP       HYAFDW          KTPDVBDDONQ    
OSJNFLYIQ       : LTMNTY          FTWDTGFMWJKVD   LWGJTNDMYEXM    AUPPKDFKYVIK   
GWDQLBAC        : ORURMNLUMGUNQ   MBQK            NMJFGAHCOOH    
WFMYWGI         : KXDU            BRVNUSDYRUNHCG  MNFONUOTWRI     CUKRDKILFYNEA  
ELUICORPT       : NLKI            BTKDFHMKMYDJT   EFQXDUB         WPSWTLDWJW      BWRISAJHKU     
QEXTLU          : OYHQITM         KVKWWMTHJWTOH   XNLV            SPKXSG          YFUWXGJKJYK    
EGDEKFB         : XQIKID         
TDQA            : CSATB           KQIGUYO        
RGYOODFITA      : KSSWBPO         CRGTNOFDXKDBML  HCJW            IRJIRPWHEX      ODSJDHQPF      
MGMHTKJYQMFETH  : YKVQQVU         JUNLTWMFL       LXXQO          
OMNQAHXB        : YJUDQVVK        BVKRPBCTMGVNSPQ
OEEXAGMNMB      : NHDUMTSV        HBJOXCOBQG      EREBCXONIU      DAJGJ           ULEGLVBEVWB    
HLGIFSNLN       : MVPKRHHSLYOT    CAHTHJJ         IMSF           
HCJW            : GUGB            QPJJRY          UMTWNPSJ        RGYOODFITA      FRRXHCMKKKT    
LGSM            : JXLB            RRQNQHWMTOMYHJ  HTRERFBSSNPHM  
IRJIRPWHEX      : CRGTNOFDXKDBML  RGYOODFITA      WDSC           
NMKVTEMFRJOVVMQ : FCRNAAAKFGLGXDI DEMPHHSMURBANA 
SMUXWOJFIY      : VBXBYRCH        APOASUAJD      
SECWROKQKODP    : LIRT            MQMGGIIJQ       FYCHDHRIY       CUKRDKILFYNEA  
OFGM            : OMIFTCTUCHCFR   SJAC            DVENT          
YUMNRNK         : WJETCNECHF      LJXWUF          KVIUSWWOMVPFNV  HYBW           
WPSWTLDWJW      : YATVPQG         HUQHDBW         LKEAA           ELUICORPT      
TPYKSQUKVDWP    : NATOWPBYIVHMKF  SUEKQBVGCQWTFLX IGYRGYRWO       DXCKHXSIELF     YVLUPIEOTIFJRRC VXAVM          
TFQLSDVRVPQP    : PIKAPWLVSFLKHB  NHYXIVDONU      YAVFIOKHBT      PBGU            CCDSDDODMPWXEF  WPQGPNLNBCJBHX 
TOMTFIJGU       : AYPPYANOMC      BPLQXHCLN       QORDIPBPIKUBV   MPGXUEYITTLXVP  WGVWCDOGXXRI   
WPPVSOLX        : YWVBYHYDWS      NCHSXGWOQRRV    GFHUACQBGJYGRQL VGEPITJLFEDMVF  VXAVM           OHSNJBHIFQNX    XCDNKVSUTEIVRKS
SQWLTTGPLWIO    : RACHAAQDUQJYL   IMRMUKGIGG      BYWTFO          ANVSRDMXIHVDTA 
YCNEMYKIEKXVGT  : ANNDK           HUQHDBW         VWDXAJPOFCN     VSXVBPT         RIRHFGM         SSJFKFIHL       YFNTKULUS       QFGHCNRMGJWP   
TRUNITBCPHUBHD  : DXNU            UNMGAGOTDGU    
BCUOJHNVP       : TDIJESOS        KTXYAJWRSSNJH   UDMGLFDBY      
GQQOKCLCY       : VPNPBRURWE      EHAPONQVBN      AEBBNYSFTJKY    CQLWHF          BNYNKWNJX       FODEUXPKG      
MTCQJM          : UOMNTROLSWQUXL  VGPRVWCMGYCBWDQ YOKLA           YRILYSJBNCAO   
NTQEUVBLFIB     : FYAA            RFOTA           MSTSNQONI       GJXLJX          MSIIWKALCXKWNK  GPCUJIICJYWBDL 
BVKRPBCTMGVNSPQ : KCGEDITGXR      OMNQAHXB        NULRGOF        
BDXQYQWTMXHRJI  : NMAUIRLJGKFW    DUSDXDDW        ELVDXBNO        UADXNBCGWG      DUBDKXNFT       BPNBAXPMH      
KHICWJGQW       : PDGMLQ          NIRINOUOSHEKOXO IGRYHDUD       
MKHEDSIISYH     : BYMDTVTGGYQOIPB ONQPKWWJR      
WDWWKRGTPQBXS   : ORGDXHEHCJ      UFMRQSUGVFX     YKAYDPYQXEE     VDAQCHMEBWDMQ   VOSBLNQGTHE    
JYQINGVUMYQ     : YCHJPMCYX      
IJWRTVVTSG      : PCPUGTHIOQP     YVOXLMICQ      
CCDSDDODMPWXEF  : AJUBFSNEJE      TFQLSDVRVPQP   
BRURPF          : CUJNUHXWIMYVM   LPFMYGEGPESXDTS JEBAPOVQJIAG    VGBNLFAQOQ      RVTJMBXWJH      ATDHGLUHMT     
OXXMVT          : UGKE            LRXFIUPK       
CHJFKD          : UMGURXI         DMHYM           NRRYF           IJFTG           WCJOHHE        
NTQD            : MFEARTWKJM      YATVPQG         GKNLLBUDVOC     GEOLKJKQF      
PBPWWTOR        : CEEVGCK         MMDA            EKQMCTAEAXNDAP  EKDHQKWPUH     
GARWXSJVMRXUBFF : XETQGRHO        FSBJB           IGRYHDUD        RNEQ            DLBXNOXVKXSE   
SVCLBODEGA      : NATOWPBYIVHMKF  WJETCNECHF      PWIWNSEODTBLLBX QHABYLHVMXLQL  
AQUOX           : QNTYB           ENFACSLBCYL    
IWWBHSO         : ESRNKXKFN       HHJYYIIDCYK    
TLCYSLTQNH      : DXANKYDKBWT     POKVUQJBPRXOY  
CKVJKYLCWCC     : PUYRIPD         PRKRKL          HUQHDBW         ELHJH           SHSE            TYPDORWI        OTFUWL         
NYROGMFHGQMI    : UMGURXI         JYFULIHP        GVAOJ          
XCDNKVSUTEIVRKS : LBMEPC          LNHNKI          EMUSP           WPPVSOLX        RTTJLTYL       
MOINIYUVFE      : JIDH            XWXNIOJFMAPCGEP VHSO            OVPJPPFWQTRWAV 
XSKKQPQHC       : AHLVJPMBY       IABLBUNFQCIFH  
AYIGHEXR        : XRQCMFUCHLID    OQIRVX          JRPPLG          LAUX           
SGODUWFR        : EMSJQONAHEGK    CKJL            UTYXQP          QCIOMHLAKWLGQ  
KXXKRKXKCOTEDVE : UOFXKBGM        WKGTQUISQ       CYMDOHCYM      
CLQBGPVOG       : UCMUC           ONJECPDATYTPJ   HONXWFYHK      
LEHFBTGYGXME    : KDWOI           PRLYADIMNBOHTBM
OSHV            : FICVKGY         FCHKKTYNKI      DEMPHHSMURBANA 
DAKGNB          : YFACRLBM        FLIBM           XTGIYA          TPOPEDBKFQOHM  
VSHLALYGSF      : KXNQ            GXEMGNDBOCUFCVB IGYRGYRWO       WXQYOWMWI       UQDKJAUV       
ONJVNVAXMVFIT   : VECI            VOJABBNMOG      IOCWVQIJKRXNQFI
IGRYHDUD        : TWLVDVQYP       VUNJVRMVSFKTQ   FVMFKBV         PBGXKQOSJJWX    KHICWJGQW       GARWXSJVMRXUBFF
IDYKJRPQ        : DQOSSMV         PBMUWBWJQKVAMK  UGXBM           SNTUSJJPLJLA    YDHOSWQ         LGGIHLGUOACJ   
FCFSXH          : YBMHJPPKEOQJOT  JERDXCYRXR      YFTEBNK         QHEF            PVAJWQ          UVGHNTX        
LDYTAKFGEG      : RDQGGSXG        LDYGVCECSI     
JBTVMYWWKROBBT  : FNVEVKXDVVYJLMO AQIAETYSQUV     SCJDTRBPBIRBDUK GRMNSRM        
GMEN            : EPER            MXBPYD          EBGGMTXLRYN    
RTGOTSVCY       : MSTSNQONI       SUEKQBVGCQWTFLX HWUVYAUHSITNKJR NBBKIPW         UMPUPQPRXNUL   
SIFO            : SKMFHW         
RNEQ            : TICDUN          SNLFKXETLHGNNLH GARWXSJVMRXUBFF WKGTQUISQ      
VFCWBIF         : YATPHXQFPGWQXTI QCGJA          
OTVHPCX         : YATVPQG         UGKE            VKFCUIJHT      
VTNUVHGDXNV     : DSPMANOKFIE     NDVOJ           OBQOSMXYEIDWWIB
RMMQUQPVB       : KXNQ            UDSWIF          FKVIQX          KXKRJKJDBSPQK   UMPUPQPRXNUL   
MQRI            : PYMWVPGGSSS     DWFIGFAJ        ORGDXHEHCJ      JYGGVCDMMVCY    MJDUIJP         WWUWIHJNH       IMSF            TFQGQSSHCHHGXI 
JKXUGTIERRKU    : NLAVCVWJYJR     HBTCESMW        HEWNIWSJXVT     YUUPXY          VBIFNTS        
XSFRITKD        : FCDAFMISH       VFBMEOQFAUQWWSE MEIOUVEB       
BBOYNHSVHCH     : TNYCFAHDEBOMJT  MJUR            XAJWN           HWIP           
WPBFTUXGQQEJX   : KAAKVOSJJST     UGXBM          
TRJWFMBWLOEGL   : NFVWC           PNBRRTNCSBYTLOD CEEVGCK         OVCCVJJB       
IUVFMANJUNPLEW  : MODDVGHVVWWI    IMTJSOHEHTIAF   CIBRAGYNINJP    SHBRVMNKWILH   
CVRVHRE         : MIYNVORVRXYASO  OHWPFBPXOKXCVRY TCCNKJFMFGJG    ANVSRDMXIHVDTA 
SBIJFRUTARSIFS  : WGSLNITN        RXBTPIUMRTJBY  
ONJECPDATYTPJ   : LWLAPHR         CLQBGPVOG       QOFLDWP        
VGIWQSFIPBJI    : DSPMANOKFIE     BSXSTWFFC       FPSAUYNUSID     NVIEGCJY        TBGTVJQMEQJHR   XOUKXINVYWXCALO GIUNPEPFV      
TPOPEDBKFQOHM   : BRFQWISQQXFFA   EPOQVLOSYV      DAKGNB          UHRTLWYCCP     
DCBRBHCAYU      : PWIWNSEODTBLLBX KWVAMUKWOHUPG  
JLJSVFOLUGRAHEF : BYBBD           SYTHC          
UOMNTROLSWQUXL  : MTCQJM          RJQFFAL         HOFLRD          GOLUYI          VFVMNQVMCA     
HWODUVRGQY      : CUCMUGRKFP      YSNDNAEPKA      GYGFRK          RIBIXLK        
QIFXJAO         : OROMUTP         WXQYOWMWI       LKEAA          
NJRDWMCNIAALH   : RIDWHUB         UFVEWHN        
CKUXFDPEEIMLJXN : NYVSPCPIDKRBK   JVPXSGQBTHPCY   ARLLUJ          XNHWXAORVXEQYR 
WCJOHHE         : NHYXIVDONU      NMYAXIYNXCFPMX  CGQWQEFPVYFPT   CHJFKD          EWSXUOQWHCRQE   XGBE            SYTHC          
UMLWAUYCIVANYP  : CHRIHBISNXTGRI  YKEJALQJRXGKBV  FDAJQ          
FBIQMHFMGJWWS   : AOLDUJMCFIYESS  BTKDFHMKMYDJT   ETEIJFQQYF      ULEGLVBEVWB    
BGDPRBP         : KJCLAHPTWP      JJAMRCQ         IUTS            GMXRUTPUYOHVKPA SWDU           
CRYXSOYKIFNTX   : NWSCJYE         RGXEIFINNFVNWE  RANHXBNNYBNQ    TLFYWOGNGHUX    CWNKINR         XXPHJKLMR      
DFNJOKIJS       : ISTOPPBIOLP     HKISSXRWGIBJYU  RXBPCOO        
PVAJWQ          : ORGDXHEHCJ      QTWSIPNHAQCOA   MPLMEVEHC       HIPOXQMUBTQVH   MMJUKLQQHDRY    FCFSXH          IDUEKWJYQ       AVOVYAYN       
PVAJWQ          : OVPJPPFWQTRWAV 
YKAYDPYQXEE     : FYAA            BPTU            MRGDXGPY        WDWWKRGTPQBXS   QGRYHFM         JNKPLY          BWRISAJHKU     
CFWKUGYFRLX     : MFEARTWKJM      HVHTICAYWJQ     QLOFDAMLL       IWCEDBKCIYW    
DVENT           : XTIHDHFXVXFT    QPJJRY          OFGM            TETVMC          IUAELNBVQ      
OUIQU           : RJVOSJBIPIXDGUT QPJJRY          DNTLKKAPVF      GGGLDYFWWHTQQG 
GTEHALBEQY      : AYPPYANOMC      KWCLBDDDNJQ     CTQMDLONWGU     SMAOLVBVVAHU   
LHQSYCSDHO      : CYOEYTMYLBFE    BWUWPDBFCOJ     IRKJU           BIOLFMN        
UKHL            : BDTREGCLB       RDDG           
RDDG            : WFIDUDWBEIXHW   UKHL            NULRGOF        
YMSYAWDQVSEF    : FLIBM           UVFX            KNYWUGDDR       ACLICBDCUUU     FBNQK           GKAIFIEBNY      HDQUONW        
YFNTKULUS       : QRRV            RUASMONKTBCYPBG MUPABW          YCNEMYKIEKXVGT  VIESWGPQGFV     SYSPNABRTOML   
DGEULJDXISSHSPN : YQEG            OMIFTCTUCHCFR   CKOAXGIHK       NBJLUHRXHONUVRV
NGSTRUBFO       : GXEMGNDBOCUFCVB OUCOXUIFQYBSJN 
ACHSBMAHJ       : OTOPGA          BOQVEJCRMHMW   
RPLCKF          : GRWJCLOYA       QGRYHFM         LVJEGBBKBELUGUH
FUATJIND        : OXNDPQNITFSFA   XWXNIOJFMAPCGEP SJFWLX          IJTCUYDTO      
KGFBRFEBBFPB    : DQOSSMV         VIUXLQNTVNLQUA  DUWKOLSXBJB     PBMQTJKB       
AOGPBLCGXHBACM  : JMLP            GGKBXSGRVSL     NMJFGAHCOOH     QCGJA          
RPICVNDQUJTXOK  : UYLKDDHJXOTOHKP TAMKMHNIXLPLF   MDBDKVYP        WPQGPNLNBCJBHX  OKOCRTUSVTGGDTY
EKQMCTAEAXNDAP  : FIMUECRPKCB     SHMI            PBPWWTOR        NVKOLLGYK      
IHISJHIPXGY     : VWRCDVENAP      XTIHDHFXVXFT    SEFL            CIHDYLAGPVHCUN  OYJBILCYGTBM    GOFXEDIQDYMJ   
EQEEWQWJSQKYSKN : CJEHHLBQBWOTEE  IUVH            YKEJALQJRXGKBV  CFPVU          
NFOVNX          : XEODQOJ         CNFMUTQ         JBWDGT          VIUXLQNTVNLQUA 
YFAOFGO         : IHDMPPSQUGS     KAAKVOSJJST     RJVOSJBIPIXDGUT JSKNDUHFWN      CBSABTR        
LFERCUQNQH      : YRSUWPQY        PBMQTJKB       
RANHXBNNYBNQ    : CUFFNDSJR       IJFTG           CRYXSOYKIFNTX   YFEPBVBBEPY     HDVJAV          UMPUPQPRXNUL   
URRAAIYLN       : AOSGTURME       SONTKUSIEDKO    RWKGCPLCW      
FRDV            : SCVWKGLUJQXRM   HHJYYIIDCYK     LOSXLGPDDND     BSHBYHELCQP    
TFINFVVGYJVXMLR : DLTCJHPPXUN     LWLAPHR        
GJGGLQHAENFXQEG : YRRHYGPASNTA    NEOUKSOOJVCUHET
JQARMVANHVNTHF  : IFEIKMHC        AEBBNYSFTJKY    AEJBKSNGQAYRPQ  BAPHWXWFHICBVF 
NQTVDLDDR       : BJRF            LBTPGUHDKEXOEQ  QYULMCTBAUFXTI  CBSABTR        
KQLQWABNDSCB    : OBQOSMXYEIDWWIB TLFYWOGNGHUX    UNVQCWUTAIHN    TDUMMER        
RJQFFAL         : JYFULIHP        UOMNTROLSWQUXL  LBNOUJLPGG     
NCLLHWQMQKXH    : BQBD            ORTRCUUQR      
OGBRVEMAFH      : THUC            ANNDK           OHWPFBPXOKXCVRY NEIRRXERXQ     
OXAUX           : PWCJML          XTGIYA          EQOOUTNTGW      TTWLDFMNAALUG   ICMUEMYJVWNYC   IJYMLSOHSY     
NNPBYXXQMPDKYDC : TDGKATGTC       DEMPHHSMURBANA 
ETEIJFQQYF      : OLVWDSMJE       BKXIHPH         DMIMGDMEMRSEES  PWIWNSEODTBLLBX KIQBATDUDWHQD   FBIQMHFMGJWWS  
YCPMSEF         : DXVR            ESVVFBPU        XQYQS          
FFUVRKBFLH      : NJIH            YPPBYIP        
TLFYWOGNGHUX    : IJNT            CRYXSOYKIFNTX   KQLQWABNDSCB    LQPSXMAMQHXMS   GTCRU          
ANVSRDMXIHVDTA  : BDTREGCLB       ECAND           SQWLTTGPLWIO    CVRVHRE         XEBAWPNEEX     
IJTCUYDTO       : FCRNAAAKFGLGXDI HRCGJYXQSIID    FUATJIND        OKOCRTUSVTGGDTY QGKYLYKIYWOFJ  
JWRHUB          : XFVOEFQE        IAYDUPDPOXQWKK 
IYCDFQ          : LBWVWOE         DMHYM           DLWGTGBAADCHORV GMXWXYEHGVW     RHJUVWOK        RHJI            CLNOMD         
PBBSWDDF        : JYMMOQQWYJ      UQDKJAUV        IOJJC          
YKKYN           : FTWDTGFMWJKVD   XTGIYA          WSOEREFCHFH     GGCUCJWNKS      CLNOMD         
PXQMRX          : HDMAOSRWID      ALHRUOARXUB    
UHRTLWYCCP      : NMAUIRLJGKFW    HXJHYBUCUFOOGAL TPOPEDBKFQOHM   ENFACSLBCYL    
EKDHQKWPUH      : KQLLRIEEQFH     DPMD            PBPWWTOR        OKOCRTUSVTGGDTY CIBRAGYNINJP   
JNGJ            : HRCGJYXQSIID    JBWDGT         
UDGEXPYTB       : OXNDPQNITFSFA  
VGBNLFAQOQ      : SOQWK           WSIKHCISKJM     FSMPNLITXUP     BRURPF         
LHYUAKJHVPC     : UXUJT           FRVJNLSELQOXV   SUGKVGIBOW      FIKEPSBQGVDA    BDIGSW         
YJYOI           : OBQOSMXYEIDWWIB BAMJBEISXE      YVKYRTKUCBIVYC  RPVCGGCDLUCQV  
QGRYHFM         : SHNPUWQKUF      VYPR            YKAYDPYQXEE     RPLCKF          VEYTQPIC       
FEGYIRIJPIUYPQ  : NDXDEAGTPDY     RIUCBMHSCBWFGV  LMIYGVOFXSB     XLXJNMW        
USPE            : DWFIGFAJ        PWXIPRBVBJKH    JEWOFULBFJL    
HONXWFYHK       : CLQBGPVOG       VPINFDNUEBNNY  
VSRCRAWAMMIHNB  : XNPRB           OCRXGSSI        MYJMA           VWJYWXOFTKTUD   YAIWGUU         FIKEPSBQGVDA    DMHIYQHGCDLK   
GVUY            : OLCXCM          TAMKMHNIXLPLF   JVGFIBWAHQ      WKKRCHWNKKLAW   XDAXGTO         SMAOLVBVVAHU   
NGQBGPJFWVQV    : NOBIWPSA        PKQDWHYBETPLNU  RJXMD           PBGU           
JXILWKAJ        : YHFC            UDSGIMTPQ       CKJL            IFEIKMHC        SHEUMPJHUJTVHHW
JWWKGUFF        : THYVHQSLPP      SXYEDD          WFFCKCDD       
ULPYRF          : FBHA            VXAVM           VWFFPJN        
YFEPBVBBEPY     : JXLB            GPWQVHHTXQ      RANHXBNNYBNQ    WDSC           
PILAIKMOFTVCPH  : LJQIJPQHWJXNFLF GMXRUTPUYOHVKPA GVAOJ           MKNSAIWLFYI    
QBBBAGFR        : NSTPJOXGMPUS    QRNHOPSEDP      XCRVGIKD        IJNHBL          HINFDYBUOVCLJB  NRYVACYMDTAJM  
DVLKN           : MSTSNQONI       FRBREVMTS       SHNPUWQKUF      UNMGAGOTDGU     RJXMD           QJPEUTRDTWVH    GKMALHRYK      
CDSPFDARTFOPJGY : IGETGFDFJBP     YKKFIBGL       
WAGXCPFWYJU     : FYAA            AOSGTURME       NYAQR          
VIUXLQNTVNLQUA  : XNPTIMNNLI      KGFBRFEBBFPB    NFOVNX          NTLPDBVWSJ      BXMDEHY        
GGGLFIRDNHLKJW  : VRNPFGYYQ       IPJD            OXAHUUMMD       OHVOKUAAPRWAL  
TSPRQ           : BAQJYIEBFEPQ    CIHDYLAGPVHCUN  XSSDXYDS       
IEWETL          : MTOIHSRHEUH     IHQMBLKXS       ICIJLPKHDKQFIX  RBRWI          
QNEWWMICUCIKMTU : TWLVDVQYP       TYFWSYOEBFYNEG 
QCPJRHCVRIUY    : KAAKVOSJJST     SASJBSP         GDQAP          
GVUUC           : MJUR            GFMRLXDDRRG     VWHVRTLOLFF    
ROCTM           : NOFEEKARJHKOY   RFPLDVCMNL      UVGHNTX         JIKCPFXCEABG   
EWSXUOQWHCRQE   : HYAFDW          WCJOHHE         CFGJTOFKOJT    
LOKKQR          : ILYIJGYVUOPH    TYCXUFAQ        PCWKHADYMH      GKMTTPTSUQN    
NMJFGAHCOOH     : FYJNQBNLQEY     RACHAAQDUQJYL   UCMUC           EXTYWHKINSVIEV  GWDQLBAC        AOGPBLCGXHBACM 
HHJYYIIDCYK     : BXRMUX          ESFQ            IWWBHSO         FRDV            KLCL            EDRNRIAYNKRSUP  SKJBGUTXYTC     DFJCAKQNXXKVQ  
HHJYYIIDCYK     : UYGWBL         
KYDWSWEGLPM     : FVMFKBV         VYPR            HOADPX          YMTXRDFAIGF     DEPXEYTFGDML   
RVTJMBXWJH      : TALSXNTEUKBDMOP JEGFQIHYJNLIPXJ MCCBYTEKPHJSNN  BRURPF          KUPAYPYKNHH    
KRGN            : NCANVD          JIFMBQ          NRKUCCK        
FXMSARPSOVYAN   : AJUBFSNEJE      UTYXQP          PRLYADIMNBOHTBM QHABYLHVMXLQL   SHPTDGVO       
RIKORYP         : EDAAMOPGPHTFVOH XSSDXYDS        UVTXXNPGR      
VBYTN           : EWSYYKKS       
ACLICBDCUUU     : XTHG            LLKG            YMSYAWDQVSEF    CDOYNEAJCJW    
RWMHKHPWVJW     : KDTWPYAOP      
YURAP           : LULOAINKYBDWEPB LPSWCTR         RBCVOCMFUPTFUIX VKFCUIJHT       UHANYPKWIYBHJCM
RRJFAOIFQ       : VEFXCARKTTBUYOY ULTNT           LOLXXMIPKPSA   
BOQSLDCXK       : RGTIPIAV        WDNBSKGLVF     
VIESWGPQGFV     : JIDH            HMRUKBMWX       YFNTKULUS       LOSXLGPDDND     YFFU           
AIGAWOI         : SQGDMWY         OTWLNXUNPLO     TJXGFBK         PGSHYLEE       
UJELERP         : SYQNOG          EYRYU           JYMMOQQWYJ      VBIFNTS        
SCBOLIJKOYBUHYV : UCTCTWSNX       HCJESRUOBBC    
HCJESRUOBBC     : PSCKKXKYLGXPYLB FGPLXRENOHTF    FJVFXXQG        YSIRGXNSGHWFR   SCBOLIJKOYBUHYV UADXNBCGWG     
VROOUPDIX       : CUFFNDSJR      
SONTKUSIEDKO    : BMINB           DNCRKLW         URRAAIYLN      
FICVKGY         : BWUWPDBFCOJ     BEPXWIPFH       OSHV           
CQGQN           : CLNKA           OQVCBDYKNGXCUWN JNVBBC          NQAR            IANLM          
VVYKOOAKYX      : MHBIBGU         FOHHALESXOIMAPT FAMUHKYDXDXPD   PIPLXIJSBILPHM  SKJBGUTXYTC     QJLAQSIFDNKE   
HCJTSQBCVXOEYGG : ANVY           
NYGMUELHVCH     : JIDH            MKSP            LOSXLGPDDND     REIWYWWYPLGLSEA
DHOKMXGFRIJPI   : AJUBFSNEJE      XEODQOJ         SHNPUWQKUF      JJAMRCQ         CCDHPKRWWHHFX  
VHFC            : LNCGETFJTRGQN   QQTGMXBMJGTSJCQ KQIGUYO        
UDHJX           : CTAWYLDWTH      CBCEAYYTAFVNV   VBXBYRCH        QOFLDWP        
WHIAQQDYIQLI    : ORGDXHEHCJ      NRRYF           BMOFLB         
SCJDTRBPBIRBDUK : UNYFKC          JDMKQCAOMU      AIGNPHALOELU    JBTVMYWWKROBBT  UMPUPQPRXNUL    ISXUTTSSDCOHDO 
UYMCJOVB        : HXCVCLUSKPBDQ  
ULIITKB         : JJGMYBXSWFH     DXCKHXSIELF     XNJSW           HGQPVVQXLM      UGMJPOC         APOASUAJD      
TEQMIHPQBSW     : LWLAPHR         XUAI            ORECVB          WGVWCDOGXXRI   
ELVDXBNO        : ODIFARPDX       BDXQYQWTMXHRJI  NTLPDBVWSJ     
QHTCRCX         : RSNDPDPBXCAQNU  WHTIWGTERIH    
DUWKOLSXBJB     : MXSJWFCALPPJX   KGFBRFEBBFPB   
GCBSYESARIYKRS  : FLQUQYMDWFJL    APMUKCD         IJFTG           FAQGRPBYYQ      QCKHVXUKIX     
LULOAINKYBDWEPB : MJUR            CEYDDWHPTJQUKX  YURAP          
VDAQCHMEBWDMQ   : WDWWKRGTPQBXS  
YCSMSTVGGUJKUOA : MMDA            VFVMNQVMCA     
PXYQPE          : OLCXCM          FKNXG           NOFEEKARJHKOY   IUSPACJDUWYI    FUYSCDUUFVQ    
EKBBONRMP       : YJRCEONM        UVVUNRVI        FOYLSCYN        HFGRBSN         EPGPEBUSSD      TFQGQSSHCHHGXI 
ICPEA           : BWHYBU          IGETGFDFJBP     OJRPQVVILNSLMG 
KVIUSWWOMVPFNV  : QDRTOQTQE       YUMNRNK         FBNQK          
RHJUVWOK        : YAKXYUBLJS      KIQBATDUDWHQD   IYCDFQ          CDOYNEAJCJW    
KUPAYPYKNHH     : SNTUSJJPLJLA    VOJABBNMOG      RVTJMBXWJH     
EFWSBNYQJGISP   : GJXLJX          AIGNPHALOELU    BKTY            RXHIBXNVIQE     VOSBLNQGTHE    
OPTCCEYT        : KAAKVOSJJST     ETMBUPA        
YKEJALQJRXGKBV  : PIKAPWLVSFLKHB  UMLWAUYCIVANYP  EQEEWQWJSQKYSKN
RIUCBMHSCBWFGV  : DVQFUTFMW       FEGYIRIJPIUYPQ  IJSOFGSUV      
NULRGOF         : UOFXKBGM        DJSPNCSAIBBOUI  BVKRPBCTMGVNSPQ RDDG            ULTNT           QYULMCTBAUFXTI  FHCODDHCYHSJ   
XWXEJCDVTLSYMF  : MDUBYTE         NSQENKHKAWRR   
FIKEPSBQGVDA    : OKIFKBCDXBQOX   LWGJTNDMYEXM    LHYUAKJHVPC     VSRCRAWAMMIHNB  SHBRVMNKWILH   
TFFRCFVLHY      : RPFEJXWBDJ      MILSAKDNHY      ONQPKWWJR       XDJTLRPWXATFHV 
EMCFAKNHU       : MWYIMGGDJHPD    OFDVYF          RAEBXSMPTRA    
MKSP            : WKKRCHWNKKLAW   NYGMUELHVCH     BSELIODTPF     
BNGBS           : TGJXJKSN        GOLUYI         
GATIGQWPR       : KUBEF           PRBVYKULU      
VFNBHXPQSPFF    : LBNOUJLPGG      QHABYLHVMXLQL   QOFLDWP        
UGMJPOC         : KFCFEDACSQIS    WFSSJYILFMWT    KJVKYBNUDS      EMEO            MUPABW          ULIITKB         TGHPHJIL       
UDMGLFDBY       : FOHHALESXOIMAPT HBJOXCOBQG      BCUOJHNVP      
AEBBNYSFTJKY    : YATPHXQFPGWQXTI PAFUJWKIDUH     GQQOKCLCY       JQARMVANHVNTHF  PWXIPRBVBJKH   
IIHR            : FCHKKTYNKI      WDAUQQMNS      
VTTTYG          : XJOFOQWIOKUDEC  CSELXGWQND      FTMEEIUUESBID   HIPOXQMUBTQVH   XFLICX          RMNV           
MNFONUOTWRI     : WOJKCARBPX      UJWY            TCVCOBMJKJ      WFMYWGI         CBGJVJTQINY    
LPSWCTR         : RQRDEMMFL       PXWGF           GMXWXYEHGVW     YURAP           EDIHNPPN        TETVMC         
CBCEAYYTAFVNV   : SGMTJWRIS       BKSLGPFOJUDFNQ  SHSE            UDHJX          
EJXUDWMNVADOW   : LNCGETFJTRGQN   LJJGKWEEHJHXA   LELIMVDBBRCFRPO XIOFQPYRIPQC    IJFTG           REIWYWWYPLGLSEA
IOSNQXRSWSMYBK  : MUJQNGLURL      OVPJPPFWQTRWAV 
WPQGPNLNBCJBHX  : DCOCBXNPPVI     ONQPKWWJR       TFQLSDVRVPQP    RPICVNDQUJTXOK  YMTXRDFAIGF     IJSOFGSUV       JUFSVPQLANJCECY
PIPLXIJSBILPHM  : HKMOJADGLWCWI   BYQSFUDKLQGT    VNUTMCUEYCGRWD  VVYKOOAKYX      YLLYSHPAIIBUN  
ULTNT           : MINKSPSCU       RRJFAOIFQ       NULRGOF        
CGXFIH          : NJQSRWPV        BHBCNOQDNGPDOU 
RHJI            : PCPUGTHIOQP     KXKRJKJDBSPQK   IYCDFQ          YGFI            WFFCKCDD       
CTQMDLONWGU     : QRGVJVRGSBNHJP  RFMKDE          BDGWLNJIWWFCIXU GTEHALBEQY     
LRXFIUPK        : YKSQSXBM        RIGMLUJR        WLWCNLOAUO      OXXMVT          EIKYPH         
PRLYADIMNBOHTBM : YFACRLBM        LEHFBTGYGXME    FXMSARPSOVYAN  
RAEBXSMPTRA     : LELIMVDBBRCFRPO SCVWKGLUJQXRM   EMCFAKNHU       NRYVACYMDTAJM   CHJI           
KKRA            : RIGMLUJR        IMXIMABTQX      JVPXSGQBTHPCY   IUSPACJDUWYI    VTIMVMQFYJHHIM 
FCHKKTYNKI      : DSPMANOKFIE     MPJACSA         KXDU            UFLARDNGSNPF    OSHV            IIHR            GSJSPEXEYGM    
NXOIXVJXQXQK    : OTWLNXUNPLO    
QBCEU           : KFBCIYCMGFW     XQDLXGL         DETAQTIER       FJVAQY          XSSDXYDS        FAQGRPBYYQ     
IAHRLRLMGX      : OGJPJNQGJIRRNG  FDXVHHEDSJKWHUN YJRCEONM        RNGQ           
PMSHUTFGTV      : NDTQMF          SHMI            GVAOJ           JVKWBCTCVAKBB  
KJVCMBGIGQINJ   : DLWGTGBAADCHORV OOGFTLDV        JRPPLG          QOJKU           KCLOAVHDJ       RXHIBXNVIQE     HDQUONW        
HWIP            : RFOTA           SHSE            BBOYNHSVHCH    
EIKYPH          : LLBFMEB         NWSCJYE         FHWNCSFWTHFTLL  XRBXFKQCBUO     LRXFIUPK        PFIHXLVOFF      REIWYWWYPLGLSEA
UPPSTACRCPSKXYE : SNTUSJJPLJLA    WEPLTTCJQIVUPTR
ONFYMNOITYUVOEQ : PINTIBYCVSOLTIY GJXLJX          JVGFIBWAHQ      OFDVYF          UUPY            PFDQGQHG       
TGHPHJIL        : CIOVGKREPWINU   OHSNJBHIFQNX    UGMJPOC         ABWOEMSHCWRCASY
BYBBD           : JXLB            YDHOSWQ         JLJSVFOLUGRAHEF
RQRQD           : GQVBEAKI        SFBDUYXGVFKY    UVSVQKSNKXH    
IOEHLAYQSM      : TICDUN          WFSSJYILFMWT    WLMRNQDBX       ORECVB          CJPKX           RXBTPIUMRTJBY  
ATDHGLUHMT      : HYAFDW          QBFBCKLQGIJNMCI ALHRUOARXUB     BRURPF         
PWXIPRBVBJKH    : IMKKAL          BSXSTWFFC       VWDXAJPOFCN     USPE            AEBBNYSFTJKY    KVQLB          
VHSO            : KVIQOMGFEG      MOINIYUVFE      VTIMVMQFYJHHIM 
FCDAFMISH       : NMUQPI          NYVSPCPIDKRBK   WJSWCNFOKCJQ    AXBJUOMLP       QQTGMXBMJGTSJCQ XSFRITKD       
FCDXYDGRWHNY    : IMIBWNXRUNL     LQPSXMAMQHXMS  
XGNVQGNTNPWPWJX : TYFWSYOEBFYNEG  BRYKDOIC        WLWCNLOAUO      KLCL            SYTHC          
SQWUVW          : MPJACSA         MIYNVORVRXYASO  VWIJUCYAFMOEO  
CDOYNEAJCJW     : OJGKFTPBV       ACLICBDCUUU     RHJUVWOK        ULEGLVBEVWB     HOFLRD         
CFPVU           : RQVFHBSYQOYQFE  UCYDSMKICEQDW   EQEEWQWJSQKYSKN
ULEGLVBEVWB     : IMKKAL          NWSCJYE         OEEXAGMNMB      FBIQMHFMGJWWS   CDOYNEAJCJW     WIFQN          
VFBMEOQFAUQWWSE : DLJIICCFR       XSFRITKD        FHCODDHCYHSJ    SOIGVAJKVNADLO 
QYULMCTBAUFXTI  : LPKGC           WIHSSHKIM       PPOHNLWDE       NQTVDLDDR       NULRGOF         BNYNKWNJX      
RNUEULWCLTSKRLQ : UMGURXI         PIUWTGSNOTSL    FDCQHCMMAOXVROC DFJCAKQNXXKVQ   DEPXEYTFGDML   
CPCPFGL         : MFEARTWKJM      CEEVGCK         OCVRKIUCJFVH   
HINFDYBUOVCLJB  : IUVH            FEICTRGSIQYD    QBBBAGFR       
UVGHNTX         : RIGMLUJR        FCFSXH          ROCTM           CHJI           
XQYNXGYG        : QSSLFGQ         RLBAXOYX        BYWTFO          JMKHGQELDEDISJE FAQGRPBYYQ     
IVWNUYKMWO      : ERJNVWPFNMCFI   YXRMAMOH        VOJABBNMOG      XJPCTTYLARUT   
HQMEMU          : JIHPAVYCGBKEIM  KXKRJKJDBSPQK   XDGXE           MRGDXGPY        JJFMPFWSFHPTK  
CRKWP           : DXANKYDKBWT     UMULV          
XGBE            : MINKSPSCU       WCJOHHE        
HTRERFBSSNPHM   : XQYQS           QCIOMHLAKWLGQ   LGSM           
XBCMXOORBNKFMQ  : XTIHDHFXVXFT    FYCRCGNA       
SXQPQUJXVCQKTB  : XUAI            LFQRLWOAVADIYR  WFFCKCDD       
RBCVOCMFUPTFUIX : OLVWDSMJE       TRPJBQ          CKOAXGIHK       NCKOURXSLTWR    YURAP           VWHVRTLOLFF    
BXUSQPCPN       : UAJMUSYOCWIMRE  IGLWBAUVCCQTJ   TRPJBQ          GFHUACQBGJYGRQL FEPGGCKHC       SWDU            MNHMKOR        
IABLBUNFQCIFH   : WCNXDPYDIFOI    AYHSTK          XSKKQPQHC       XDAXGTO         FEYXXH          AWUSWLDFGARC   
UDMSLKWPITIA    : VABEGQWGYLMRDL  UNVQCWUTAIHN    FDYRBMNLFUUSMOJ
NRYVACYMDTAJM   : UVFX            QBBBAGFR        RAEBXSMPTRA    
RRNYPRLIDVF     : JJGMYBXSWFH     IPROBCILIGDY    PINTIBYCVSOLTIY LXHJGYKNUVS    
EBGGMTXLRYN     : RQVFHBSYQOYQFE  GMEN            LGGIHLGUOACJ   
NTLPDBVWSJ      : SNTUSJJPLJLA    OQVCBDYKNGXCUWN VIUXLQNTVNLQUA  ELVDXBNO        BRWSHJOWFKAMUNT BHCTXNT        
IBHSH           : MIYNVORVRXYASO  RCVTEQVUGGCNDF 
AEJBKSNGQAYRPQ  : JIDH            EYHQQMUHAHOF    TICDUN          PORDCBSEJQNGDYJ IUTS            JQARMVANHVNTHF  SANPFFLCNTF    
JEWOFULBFJL     : XETQGRHO        DGVNJXAVNRI     USPE           
SFRXFWKJHD      : AUASRSQQFQDWH   OHVOKUAAPRWAL   WHTIWGTERIH     CHJI           
QTYPORIV        : RYFXETJI        ADYJNRQWITDIF   GMXRUTPUYOHVKPA ETNPL          
MVSSQEVXQHH     : WXNDK           YSPA           
MBIUASEIXDYTDQI : KVIQOMGFEG      DXANKYDKBWT    
YFXLB           : VFQHMXCBBY      YOJTEPJAYAON    OMIFTCTUCHCFR  
GTXESOMCXBDI    : MIYNVORVRXYASO  RFBID           UANMQU          LDGVLCONLD     
EDEOBIP         : ESNUSG          SOIGVAJKVNADLO 
LGGIHLGUOACJ    : JHDNVGEMSHCLCUP WIVAY           DGVNJXAVNRI     IDYKJRPQ        EBGGMTXLRYN     SKJBGUTXYTC    
ICMUEMYJVWNYC   : YQLDILQM        XVEHSFS         TGJXJKSN        TTWLDFMNAALUG   OXAUX           UHANYPKWIYBHJCM
BKTY            : XGFVPGCP        PCYR            EFWSBNYQJGISP   ATEQYFAY        IANLM          
CFGJTOFKOJT     : LHWCXQPE        JEGFQIHYJNLIPXJ EWSXUOQWHCRQE  
RXBPCOO         : GSFBUENXJMQGR   DFNJOKIJS       YDYDTISAGWFPOUF VBIFNTS        
KLCL            : YFACRLBM        QPOHUMMS        KVQXOTBNKKTEQ   HHJYYIIDCYK     XGNVQGNTNPWPWJX
HOADPX          : BWUWPDBFCOJ     YIGWQXBORIGDLCF KYDWSWEGLPM     MIYSKAY        
VGPRVWCMGYCBWDQ : IJNT            MTCQJM          DPUEIK         
TFQGQSSHCHHGXI  : HMRUKBMWX       MQRI            EKBBONRMP       QCGJA          
VOEPMCTAKSCLQHC : RLBAXOYX        BKGHQWLU        KVQLB           TDUMMER        
CHJI            : ILYIJGYVUOPH    FKYGPV          CDUPTWKUX       RAEBXSMPTRA     UVGHNTX         SFRXFWKJHD     
EDIHNPPN        : XBCPFWXVOP      PSYOHFKTBHAMX   LPSWCTR         GIOKLGBPSRRH    XARIQR          QGKYLYKIYWOFJ  
CLPIBEKUEV      : BRLUVCLBTCF     OBLENGTG        DPSTGBJT       
IHHSM           : FFBSCQFML      
WTLFUPLDYYV     : TNYCFAHDEBOMJT  TOVTFKU         FSSKTANJLPQTX   RDQGGSXG        IWFDNULDL       WPCYRNMFSJGQTGI BAPHWXWFHICBVF  NVKOLLGYK      
WTLFUPLDYYV     : XNHWXAORVXEQYR 
MVSXNC          : GHMYD           DWFIGFAJ        XOUKXINVYWXCALO DLLTCRDIH      
SOVY            : OHVOKUAAPRWAL   XDAXGTO         WGVWCDOGXXRI    MBFLVKG         JCKWSJ          COHNGXECHQPOKL  DALUNRWNVLG    
KKWTDJTAFHHBXSG : TXGCKX         
RCOEBJCOLDHDA   : UCTCTWSNX       YUUPXY         
RMTOHWADY       : CIOVGKREPWINU   SXUFQJFRLBYN    YPWJYMFMNLMF   
LGJLCPKTSY      : YKSQSXBM        FBHA            ONRCFIM         RIBIXLK        
VLDKYJ          : NCANVD          PNBRRTNCSBYTLOD IPJD            KPDWKBXDKYBA    PBMQTJKB       
CLEUXA          : UNYFKC          XBCPFWXVOP      MUPABW         
HWOLXUWG        : DPQYGRW         LIREXHP         JBWDGT          SHOXYFYMB       BHBCNOQDNGPDOU  WXIIVQCH       
IIVUD           : SYQNOG          GFMRLXDDRRG    
UEMGJXHSUK      : XJOFOQWIOKUDEC  DMIMGDMEMRSEES  XMYHQKKVSOBK   
BHFBUMXJ        : WOJKCARBPX      WFSSJYILFMWT    MQMGGIIJQ       DSMRVCUGEATBF   DLLTCRDIH       OBXAPFBVHVUJDU 
XEYEKJNHFQ      : BWHYBU          UFLARDNGSNPF    CVCDFHJJXIPX   
CWNKINR         : DVQFUTFMW       CRYXSOYKIFNTX   TKOPITXSL      
ICIJLPKHDKQFIX  : WJSWCNFOKCJQ    MQMGGIIJQ       ESFQ            IEWETL         
OKOCRTUSVTGGDTY : GRWJCLOYA       LBIPNRVSOIEV    RAQASAYD        RPICVNDQUJTXOK  IJTCUYDTO       EKDHQKWPUH     
EDRNRIAYNKRSUP  : XGQJVKI         HXQOHXMEEV      HHJYYIIDCYK     USPEWXFAKIEVDLT
LBNOUJLPGG      : RJQFFAL         VFNBHXPQSPFF   
OJRPQVVILNSLMG  : YBIANGN         ICPEA          
GCUWAHAPVW      : YRXYCRACDMXQNV  PKTYBDRYSFDKR   CYMDOHCYM      
JNKPLY          : TYCXUFAQ        YXWQRXWLLEOQLTS WSOEREFCHFH     YKAYDPYQXEE    
ERRCN           : BQBD           
OBXAPFBVHVUJDU  : PSCKKXKYLGXPYLB GKNLLBUDVOC     BHFBUMXJ        EJEBTUXKTFFULGI
BSELIODTPF      : KFCFEDACSQIS    NDCRAANSVJE     TWSTEXHY        BLUTKNGYRSNRSVC MKSP            WDAUQQMNS      
HYBW            : YVQT            JSLHWBUSWW      YUMNRNK         YVOXLMICQ      
RXBTPIUMRTJBY   : MHBIBGU         IFEIKMHC        SBIJFRUTARSIFS  IOEHLAYQSM     
FDAJQ           : WIHSSHKIM       UMLWAUYCIVANYP  LBFPOMXPFIXILKU
ATEQYFAY        : SADR            BKTY            SNKM           
XDAXGTO         : TBTMHW          GVUY            IABLBUNFQCIFH   SOVY            GRMNSRM        
RDINMMM         : NVDHAJNISFVPG   OGJPJNQGJIRRNG  BXTTJUREFJAKST 
RPVCGGCDLUCQV   : YATVPQG         UFMRQSUGVFX     SYKWGB          UUPY            YJYOI           PGSHYLEE       
BTHBT           : RHYNMTJTTKII    DMCWYOFU        LNUMURHOCGLJAGW WIVAY           HOFLRD         
WIFQN           : WPCYRNMFSJGQTGI ULEGLVBEVWB    
EBCTWULT        : JXWOVCUVGR      VNJIWCHGG      
UADXNBCGWG      : JERDXCYRXR      WSIKHCISKJM     BDXQYQWTMXHRJI  HCJESRUOBBC    
SNKM            : OLCXCM          ATEQYFAY        DMHIYQHGCDLK   
IXIBLYGODCMXN   : FLIBM           RHYNMTJTTKII    VWDXAJPOFCN     EJVFQQRYXHBR    KVKWWMTHJWTOH  
YKKFIBGL        : CJEHHLBQBWOTEE  CDSPFDARTFOPJGY RMRWYUNX       
FRRXHCMKKKT     : HCJW           
YUUPXY          : NMAUIRLJGKFW    RFBID           DUSDXDDW        JKXUGTIERRKU    RCOEBJCOLDHDA  
YMMAXXHIBN      : KHARS           LHWCXQPE        YSCJTTJCVWLLGDF
ISNASWDIIP      : ISVQSJRPB       IDUEKWJYQ       TELPUTXYC      
EETBB           : QGXRCJHF        LCCH            VYPR            XEQGRIPNY       YVOXLMICQ      
BAOAPCDPCKXDYU  : MWYIMGGDJHPD    XMYHQKKVSOBK    LXHJGYKNUVS    
TKOPITXSL       : DSPMANOKFIE     ELHJH           FRBREVMTS       WASILT          FRYLGTVACXLWT   CWNKINR         NEIRRXERXQ     
YSPA            : MVSSQEVXQHH     YKBTHBFORF      DFBPSTAWG      
ABWOEMSHCWRCASY : PINTIBYCVSOLTIY XWFJVJ          TGHPHJIL        LCCRNEKQAMYTYV 
PKHHUB          : HKMOJADGLWCWI   MDBDKVYP        EJVFQQRYXHBR   
POAOHPOERPBJTNC : UAJMUSYOCWIMRE  VYPR            DGVNJXAVNRI     AHIODIIHPIRVN   PTHCHWWHFVSMUD 
RCVTEQVUGGCNDF  : STYAOMQDYW      FQLMSCMEYNXVSLO FIMUECRPKCB     IBHSH           OAHCDVXIIML    
UUXJEPXIKPLTMBX : TKTGW           XRQCMFUCHLID   
SANPFFLCNTF     : TOVTFKU         NHDUMTSV        OFDVYF          PTUAUJPSGGHP    BKGHQWLU        DDWKFCLRLOPAJJ  AEJBKSNGQAYRPQ 
YKBTHBFORF      : MODDVGHVVWWI    QIMBTOD         YSPA            CQLWHF          HDVJAV         
CWLXJM          : XXHEMRKA        XLVFR           MKNSAIWLFYI    
CIBRAGYNINJP    : NMAUIRLJGKFW    FSMPNLITXUP     IUVFMANJUNPLEW  EKDHQKWPUH     
IDUEKWJYQ       : PVAJWQ          ISNASWDIIP      GIUNPEPFV      
YULMS           : RDQGGSXG        BLUTKNGYRSNRSVC JGAN            QUFYYFNSBL     
YSCJTTJCVWLLGDF : PSAVO           HIPOXQMUBTQVH   YMMAXXHIBN      RTMAUYNQTOAUQ   TXGJHDRIYGGAIF 
GCWRYG          : KEUBWKDFYQW    
RWTMLGHLIDNRWJC : YQLDILQM        JGAN            GRMNSRM        
FBNQK           : SUEKQBVGCQWTFLX DMCWYOFU        YMSYAWDQVSEF    KVIUSWWOMVPFNV 
VBXBYRCH        : SMUXWOJFIY      UDHJX           SPKXSG         
UHHJUPTGXWTQTFU : ANNDK           UMGURXI         QNTYB           IWCEDBKCIYW    
LVJEGBBKBELUGUH : NVDHAJNISFVPG   KXDU            RPLCKF          KXDB            GWDVPGHFW      
CQLWHF          : AIMIKM          EFWCHWVNBK      GQQOKCLCY       YKBTHBFORF      SXYEDD         
FEYXXH          : XFIAONESDSCYVJX KXUAQVLVOW      ELHJH           IABLBUNFQCIFH   HELTFGDWGNI     CVAGQMVAU      
USPEWXFAKIEVDLT : KAAKVOSJJST     PSJHCFNAVWKH    DPSTGBJT        TSCOBHICIB      HPMBECLRKJLSUH  EDRNRIAYNKRSUP 
OVCCVJJB        : PWCJML          TRJWFMBWLOEGL   NDPMKJHFBNEBTFO
NDPMKJHFBNEBTFO : WIHSSHKIM       OVCCVJJB       
LMIYGVOFXSB     : CLNKA           QYNR            FEGYIRIJPIUYPQ 
DEEQHTFTFOY     : XTHG            BOMTVVYUYXJ     JMKHGQELDEDISJE BYHXLKEOHGIL   
DEKYLY          : AIHKLEVRPRYNPQ  PSJHCFNAVWKH    LELIMVDBBRCFRPO XRVSPPLRAGFLAC  FJVQSDEKLDD     RWKGCPLCW      
YLLYSHPAIIBUN   : FDXVHHEDSJKWHUN DUSDXDDW        PIPLXIJSBILPHM  DFJCAKQNXXKVQ  
BFRUKLDANLDTXCF : IJYMLSOHSY      NVTQYTKRNUND   
HELTFGDWGNI     : JJUJYEIS        HBTCESMW        FEYXXH         
KVQLB           : IPJD            FQLMSCMEYNXVSLO PWXIPRBVBJKH    VOEPMCTAKSCLQHC RWKGCPLCW       LAMLEDIYUP     
JOWMOKXTG       : RFOTA           VFQHMXCBBY      BXRMUX          DNCRKLW         TCCNKJFMFGJG   
XLVFR           : MIYNVORVRXYASO  LBTPGUHDKEXOEQ  GGCUCJWNKS      CWLXJM          RLUTDVMJ       
BAPHWXWFHICBVF  : JQARMVANHVNTHF  WTLFUPLDYYV     XDJTLRPWXATFHV  GPALITBTNYCAFT 
FTITKUU         : GJPJDWBCIVU     NDTQMF          NFAJWTBCIBJTKLF KHAGXBV        
DRGOPMJAPJPW    : AUHEJEH         OTOPGA          KUMBHI         
OWQXFUYDANLW    : UVVUNRVI        HBJOXCOBQG      IOFLCAYVYORKU  
FJVAQY          : XQDLXGL         GLCTUYU         QBCEU          
YOKLA           : MTCQJM         
EJEBTUXKTFFULGI : IMIBWNXRUNL     FBBEYWV         PWYRIDK         UVSVQKSNKXH     QDRTOQTQE       OBXAPFBVHVUJDU 
FHCODDHCYHSJ    : NBBKIPW         OELXFVKCLCECVEA NULRGOF         VFBMEOQFAUQWWSE
SXYEDD          : YPPBYIP         QHEF            RJXMD           JWWKGUFF        CQLWHF          WDAUQQMNS      
XDJTLRPWXATFHV  : RYFXETJI        HXPXIAADPJHWWO  TFFRCFVLHY      BAPHWXWFHICBVF  HWLFPTXREIEBS  
MBERBNKMIGLKKQ  : AODUPUIJQ      
LOSXLGPDDND     : VFOE            XRBXFKQCBUO     YGLLTNJDXW      MXHMWQTEOQI     FRDV            VIESWGPQGFV     NYGMUELHVCH    
UNVQCWUTAIHN    : LBIPNRVSOIEV    KQLQWABNDSCB    UDMSLKWPITIA   
NBGARV          : UBIRRQ          NHDUMTSV        MUJQNGLURL      HVHTICAYWJQ     LKEAA           KWCLBDDDNJQ     APMUKCD         PKQDWHYBETPLNU 
IOKTVAWBPDY     : QTWSIPNHAQCOA   OJGKFTPBV       DMIMGDMEMRSEES  ISTOPPBIOLP     KTXYAJWRSSNJH  
SWDU            : JMLP            BGDPRBP         BXUSQPCPN      
YPWJYMFMNLMF    : MYJMA           FYCPVARVLO      RMTOHWADY       KQNVRQJKLKIX   
BNYNKWNJX       : VEOCOPNIQJ      IRKJU           GQQOKCLCY       QYULMCTBAUFXTI  RMRWYUNX        ILYCOLO        
OYRHVVDSWU      : FKVIQX          KAAKVOSJJST     KXYJHUVDNT      NMYAXIYNXCFPMX  THDYELV        
ITEOIR          : OTKGHMNAKADC    GVISQUQGOPGLY   LOLXXMIPKPSA    DEMPHHSMURBANA  LAMLEDIYUP     
WYKYOLMYID      : IJWR            IJNHBL          DIMBPXKTVVDEV   RTMAUYNQTOAUQ   TXEFFYLY       
GKAIFIEBNY      : SASJBSP         HPMBECLRKJLSUH  YVLUPIEOTIFJRRC BFSAYXQYXIMMD   YMSYAWDQVSEF    IJSOFGSUV      
KQIGUYO         : XQIKID          MHAMOQVEKMXMC   TDQA            VHFC            XYHNSRKXTVHNE   DMHIYQHGCDLK   
CLNOMD          : JERDXCYRXR      TYPDORWI        SCMVPPEQPVC     IYCDFQ          YKKYN           BSNMEWNVRHPA   
CCKFPSRQBWBG    : XVNMN           CKJL            BKGHQWLU        AIDWYHPRMWOQG   JEBAPOVQJIAG    VPINFDNUEBNNY   QCKHVXUKIX      FTMRL          
QHABYLHVMXLQL   : PHMGV           SVCLBODEGA      FXMSARPSOVYAN   VFNBHXPQSPFF    LVWTK          
FYCHDHRIY       : SMYPYWDTELYK    NBBKIPW         SECWROKQKODP   
APOASUAJD       : VNUG            SMUXWOJFIY      ULIITKB         SFNLHSAOJFRU   
KEOTABRN        : RPFEJXWBDJ      VWDXAJPOFCN     FWKBCAWUKUCEE   FRYLGTVACXLWT   GSJSPEXEYGM     VTIMVMQFYJHHIM 
ENAFRKIBESB     : JBWDGT          KVXDTE          JJUJYEIS        PTFJ            IWCEDBKCIYW     FDYRBMNLFUUSMOJ
USHUMCVVHYHN    : XNPRB           VJUL            OHWPFBPXOKXCVRY GWNNWBA         CVAGQMVAU      
BOQVEJCRMHMW    : RKFDRCWGUJMY    ACHSBMAHJ      
PBMQTJKB        : GGCUCJWNKS      KGFBRFEBBFPB    LFERCUQNQH      VLDKYJ         
YFFU            : VIESWGPQGFV     LCLWIH         
EEDTGTKEYWGS    : CDHQFEB         IGETGFDFJBP     FLIBM           HPMBECLRKJLSUH  EKQTSVIWJ       HSGLB           QJLAQSIFDNKE   
PFIHXLVOFF      : KSSWBPO         EIKYPH         
IMCORXGXCJRK    : PBMUWBWJQKVAMK  LPFMYGEGPESXDTS
FODEUXPKG       : NIKVRY          GQQOKCLCY      
TELPUTXYC       : FSSKTANJLPQTX   AIHKLEVRPRYNPQ  LNHNKI          LBTPGUHDKEXOEQ  ISNASWDIIP     
BSHBYHELCQP     : JYCVIWNYW       TDIJESOS        PSYOHFKTBHAMX   FRDV            QRNK           
IUNFUDQBDMFQ    : KSSMV          
DKFCPRFIBHKJLV  : RACHAAQDUQJYL   JVPXSGQBTHPCY   GJXLJX          HCNAIWYTUCLQ    ORTRCUUQR      
ENUMK           : BCGAXRWXV       IMTJSOHEHTIAF   FEPGGCKHC      
SFNLHSAOJFRU    : NYVSPCPIDKRBK   GWLLW           APOASUAJD      
VKFCUIJHT       : GQVBEAKI        OTVHPCX         YURAP          
FFBSCQFML       : XGFVPGCP        KDYPSEID        IHHSM          
AWUSWLDFGARC    : QOEGBNMBW       LNUMURHOCGLJAGW IABLBUNFQCIFH   BSNMEWNVRHPA   
YGFI            : UMQX            XIOFQPYRIPQC    RHJI           
NEOUKSOOJVCUHET : MBQK            PPAIQGR         RUIUTIH         LNHNKI          GJGGLQHAENFXQEG
XSSDXYDS        : AJIXALRMLMIVWN  IAYDUPDPOXQWKK  TSPRQ           RIKORYP         QBCEU          
NRKUCCK         : VKWXEAGNCM      SHSE            NHYXIVDONU      SCVWKGLUJQXRM   KRGN            NAPXSFWKVGXKSG  AHIODIIHPIRVN  
RGTKWK          : OGJPJNQGJIRRNG  GEIPWVPNQAOPS   XGMERSX        
SMQDRMJRFCUG    : BMINB           VOJABBNMOG     
XYHNSRKXTVHNE   : UVFX            KQIGUYO        
XDNTVDMBUYLOFN  : NOFEEKARJHKOY   OHSNJBHIFQNX    QJKYUOHBFNHJARN
NRJMBYHUJF      : TDIJESOS        YMXFOQJL        OBCUJQM        
HOFLRD          : DQOSSMV         UOMNTROLSWQUXL  CDOYNEAJCJW     BTHBT           QCGJA           WHBURWDCSPAYWCJ
IANLM           : BWUWPDBFCOJ     FPSAUYNUSID     MXBPYD          CQGQN           BKTY            SHPTDGVO       
IOCWVQIJKRXNQFI : CUCMUGRKFP      IMGLUVEDPAEDJ   AETTE           ONJVNVAXMVFIT   XEBAWPNEEX      MDAAC          
NYKCEVWKNFKDQYT : DXMWUVPRA       EJVFQQRYXHBR    GBRBQRMOVD      HKHPKJMYYXWNHT 
NWVLPGUCXUPQBXS : YMXFOQJL        PSYOHFKTBHAMX   CNHAHYCJM       TETVMC         
WDSC            : IBSYINOQE       IRJIRPWHEX      YFEPBVBBEPY     GGGLDYFWWHTQQG  CYMDOHCYM      
RMRWYUNX        : YKKFIBGL        BNYNKWNJX      
OOLMADSXFSSUJVU : YAVFIOKHBT     
MSIIWKALCXKWNK  : NTQEUVBLFIB    
FYCRCGNA        : FIMUECRPKCB     XBCMXOORBNKFMQ 
GSJSPEXEYGM     : VFQHMXCBBY      UJEVONENNTGMEHX JNVBBC          FCHKKTYNKI      KEOTABRN        IYVMRSFNPMLJIX  HXBOWU          SYKFOSIJKH     
RPJTNTTDHKKGMFI : LOPUAXOFXQP     LWJORDLRH       TNMBX           UMULV           YDKBVACWWE      IUAELNBVQ      
SKJBGUTXYTC     : KQEJGVLFHBV     ADYJNRQWITDIF   HHJYYIIDCYK     VVYKOOAKYX      LGGIHLGUOACJ    HNLW           
BRWSHJOWFKAMUNT : DGCC            YHFC            AIHKLEVRPRYNPQ  STSCRIRAIAQF    BYHXLKEOHGIL    NTLPDBVWSJ      IOFLCAYVYORKU  
SEHNRS          : LHWCXQPE        PSAVO           WFIDUDWBEIXHW  
XNLV            : ADYJNRQWITDIF   QEXTLU          IOJJC          
FAQGRPBYYQ      : WFSSJYILFMWT    GCBSYESARIYKRS  QBCEU           XQYNXGYG       
FDYRBMNLFUUSMOJ : FBBEYWV         DXVR            WHVRQJRTVCD     UDMSLKWPITIA    ENAFRKIBESB    
CUKRDKILFYNEA   : TXGCKX          JJGTQW          CUPXHF          WFMYWGI         SECWROKQKODP    WGVWCDOGXXRI   
DFJCAKQNXXKVQ   : PPAIQGR         IYWNE           HHJYYIIDCYK     RNUEULWCLTSKRLQ YLLYSHPAIIBUN   NBJLUHRXHONUVRV RSVFTIYOHK      LYCNSUAULNSN   
KCLOAVHDJ       : CISARCNQ        KAAKVOSJJST     ESRNKXKFN       KJVCMBGIGQINJ  
QOSEU           : XEQGRIPNY       BTKDFHMKMYDJT  
MXBWABJSR       : FCRNAAAKFGLGXDI JNFQJJJNUJTRBJ  NXFFOKFVXULH    UDUXVKJCIJ     
QCGJA           : SMYPYWDTELYK    ESNUSG          FRYLGTVACXLWT   VFCWBIF         AOGPBLCGXHBACM  TFQGQSSHCHHGXI  HOFLRD         
MNHMKOR         : PPAIQGR         DLTKVN          WOPMCMH         TBGTVJQMEQJHR   PEXXD           HDKF            BXUSQPCPN      
JIKCPFXCEABG    : SSVRS           PWIWNSEODTBLLBX VXAVM           BKGHQWLU        ROCTM          
LAUX            : FSSKTANJLPQTX   JJGTQW          ESRNKXKFN       KFNIEBT         VOJABBNMOG      YGLLTNJDXW      AYIGHEXR       
XEBAWPNEEX      : BYTGCWYFCS      CUXB            PTUAUJPSGGHP    ANVSRDMXIHVDTA  IOCWVQIJKRXNQFI
VTFGEJ          : HXCVCLUSKPBDQ   OHGMCN         
MIYSKAY         : PAGM            HOADPX         
NBJLUHRXHONUVRV : UAJMUSYOCWIMRE  BRFQWISQQXFFA   XFVOEFQE        DGEULJDXISSHSPN DFJCAKQNXXKVQ   DCCFTDYRNMNSGKH
PRBVYKULU       : DLTCJHPPXUN     EYHQQMUHAHOF    MODDVGHVVWWI    UFUPHBVOIETBDH  GATIGQWPR       HDVJAV         
EHVFVMH         : QBFBCKLQGIJNMCI FBCR            RMGRXVI         BRLBSSWMF       JKEXVTW        
XEOSCXJPUFJSBBL : OJGKFTPBV       SOQWK           CRGTNOFDXKDBML  UHANYPKWIYBHJCM
WMNRAKNESMLQYSX : XTPXXJBTWDESE   PILRGNS        
WORBMCSJ        : XRQCMFUCHLID    DLWGTGBAADCHORV VWFFPJN         YAIWGUU        
EFLFQNDFDWFQN   : XWFJVJ          BJSUAECMFJI    
JAWAYSAARO      : MHBIBGU         GKNLLBUDVOC     LJJGKWEEHJHXA   XFLICX          RMNV           
TDUMMER         : AUHEJEH         BRYKDOIC        JUNLTWMFL       KQLQWABNDSCB    VOEPMCTAKSCLQHC GIOKLGBPSRRH   
RWKGCPLCW       : URRAAIYLN       DEKYLY          KVQLB          
PILRGNS         : MYXKFBIAKY      WMNRAKNESMLQYSX
NSQENKHKAWRR    : RIDWHUB         QAXUTIQANB      XWXEJCDVTLSYMF  XXPHJKLMR      
JQEPVVEX        : XEQGRIPNY       HBTCESMW        TCCNKJFMFGJG   
GPCUJIICJYWBDL  : JJAMRCQ         DMIMGDMEMRSEES  BJRF            FRVJNLSELQOXV   NTQEUVBLFIB    
NVNMNHDAYJ      : LNHJWKGFKKRI   
WGVWCDOGXXRI    : EWSKPYKH        TOMTFIJGU       TEQMIHPQBSW     SOVY            CUKRDKILFYNEA  
BHBCNOQDNGPDOU  : CGXFIH          HWOLXUWG       
PHVMN           : VUKOYLTTNF      WEWNJKRCQQ      NHCDEBJFEDQWG  
JRWXXUXPEARNDV  : YKKHTPQ        
SOIGVAJKVNADLO  : VFBMEOQFAUQWWSE EDEOBIP        
DXMBXMXXDEX     : IYWNE           JUFSVPQLANJCECY
UDUXVKJCIJ      : FDCQHCMMAOXVROC TFCEMOAPWA      MXBWABJSR       HMMHAKQQY       DLBXNOXVKXSE   
SHEUMPJHUJTVHHW : DGCC            HOMN            JXILWKAJ       
MBFLVKG         : VEFQA           AYHSTK          FMQUSQRARB      CIYN            SOVY            KXDB           
HSGLB           : STYAOMQDYW      ECMTLTR         EEDTGTKEYWGS   
CVAGQMVAU       : AIDWYHPRMWOQG   TONW            FEYXXH          USHUMCVVHYHN    IJSOFGSUV       OVPJPPFWQTRWAV 
LQPSXMAMQHXMS   : SXUFQJFRLBYN    BMCVEECY        TLFYWOGNGHUX    FCDXYDGRWHNY   
LCCRNEKQAMYTYV  : TSCOBHICIB      ABWOEMSHCWRCASY
VPINFDNUEBNNY   : BRLUVCLBTCF     VKWXEAGNCM      LNHNKI          HONXWFYHK       CCKFPSRQBWBG   
GIOKLGBPSRRH    : ANVY            EDIHNPPN        TDUMMER         YRXYCRACDMXQNV 
NHOKFESSMV      : DNNVVYJD        UGKE            AXBJUOMLP       XUAI           
JCKWSJ          : BQBD            UDSWIF          YVQT            WCIKKIXFH       VGEPITJLFEDMVF  SOVY           
BSNMEWNVRHPA    : FBCR            CLNOMD          AWUSWLDFGARC    QRNK           
EJPOOVJKKHTTKE  : RIGMLUJR        PXPDGBDQRLWP    FAMUHKYDXDXPD   GRUHXOLVQOFDLO 
DPUEIK          : QLOFDAMLL       MDUBYTE         TWSTEXHY        CSATB           VGPRVWCMGYCBWDQ HWLFPTXREIEBS  
OHGMCN          : THYVHQSLPP      DGVNJXAVNRI     VTFGEJ          QCKHVXUKIX     
COHNGXECHQPOKL  : SOVY           
QFGHCNRMGJWP    : YCNEMYKIEKXVGT 
YDYDTISAGWFPOUF : QSLFI           RXBPCOO         XLMU           
GIUNPEPFV       : PQDTDIDLBVAF    VGIWQSFIPBJI    IDUEKWJYQ      
NHCDEBJFEDQWG   : UBIRRQ          PHVMN          
VLNMG           : SQGDMWY         NFVWC           EFWCHWVNBK     
QOFLDWP         : OQIRVX          ONJECPDATYTPJ   UDHJX           VFNBHXPQSPFF    VYURYX         
CNAQ            : DGXNAQKXU       IUSPACJDUWYI    PQHWWDQOI       LWNVPASNDAKSD   THDYELV        
CVCDFHJJXIPX    : XEYEKJNHFQ      BXMDEHY        
DNTLKKAPVF      : TWSTEXHY        OUIQU          
NDRCDKAIH       : QOEGBNMBW       YAIWGUU        
LOLXXMIPKPSA    : SMYPYWDTELYK    SHSE            OBQOSMXYEIDWWIB RRJFAOIFQ       ITEOIR         
EKWHCVOR        : ERJNVWPFNMCFI  
RMNV            : VEOCOPNIQJ      XNJSW           SSJFKFIHL       VTTTYG          JAWAYSAARO      XXPHJKLMR       QJKM           
NEIRRXERXQ      : JNATCENQHW      OGBRVEMAFH      TKOPITXSL      
ODSJDHQPF       : HDKF            GUDQLDE         RGYOODFITA     
RDMMOF          : QRRV            FJVFXXQG        GWNNWBA         XUKPIBUPXIT    
FDASJLND        : LIREXHP         SJFWLX          HGQPVVQXLM     
RXHIBXNVIQE     : LOPUAXOFXQP     UOFXKBGM        EFWSBNYQJGISP   KJVCMBGIGQINJ  
ILYCOLO         : WJSWCNFOKCJQ    RFBID           BNYNKWNJX       PGSHYLEE       
SPKXSG          : BMOFLB          PEXXD           PQBNTCSO        QEXTLU          VBXBYRCH       
ETNPL           : SDKBFYUHOMLNR   PUYRIPD         ANVY            WFIDUDWBEIXHW   WVSTTJCKUK      QTYPORIV       
YVOXLMICQ       : LNCGETFJTRGQN   THOQRHGXUC      FLJEDQLCEPUL    HFTSALDGB       IJWRTVVTSG      HYBW            EETBB          
MEIOUVEB        : MPGXUEYITTLXVP  XSFRITKD        JPFTTBRHWIFUA  
VNPO            : WSOEREFCHFH     JPFTTBRHWIFUA  
AUPPKDFKYVIK    : XFVOEFQE        UCTCTWSNX       OSJNFLYIQ      
SOCCDGKSC       : JDMKQCAOMU      YXPMVEQ         RQVFHBSYQOYQFE  VMYJCMWMIUJ     KUMBHI         
WDAUQQMNS       : KJVKYBNUDS      HILQK           IIHR            BSELIODTPF      SXYEDD         
DKSHPFIL        : PIUWTGSNOTSL    TUGTBRXWNWTV    AMTCJVUEQOWXHA  IJYMLSOHSY     
VTIMVMQFYJHHIM  : KKRA            VHSO            KEOTABRN        DALUNRWNVLG    
DFBPSTAWG       : ILTGBJEIC       YSPA           
GVAOJ           : RGXEIFINNFVNWE  FEICTRGSIQYD    LNUMURHOCGLJAGW GKBVENVMYAIY    TCCNKJFMFGJG    NYROGMFHGQMI    PILAIKMOFTVCPH  PMSHUTFGTV     
GVAOJ           : QUFYYFNSBL     
MDAAC           : UFUPHBVOIETBDH  IOCWVQIJKRXNQFI IUAELNBVQ      
QJLAQSIFDNKE    : DNSITVHOIPR     VVYKOOAKYX      EEDTGTKEYWGS   
EAGDGDJ         : GFMRLXDDRRG     EJGWXPPW       
DALUNRWNVLG     : UNMGAGOTDGU     SOVY            VTIMVMQFYJHHIM 
YGXTQDXGN       : GLCTUYU         RJVOSJBIPIXDGUT DLBXNOXVKXSE   
OTFUWL          : JBGNNSNXTAES    ECMTLTR         PWCJML          HOMN            CKVJKYLCWCC    
IOFLCAYVYORKU   : AJIXALRMLMIVWN  OWQXFUYDANLW    BRWSHJOWFKAMUNT
LDYGVCECSI      : RMBHQV          LDYTAKFGEG     
MNOMARUQWIUAHR  : BYFHLTO         UFUPHBVOIETBDH  JBWDGT         
XLMU            : UNWIFJTTS       YXPMVEQ         KDTWPYAOP       JSLHWBUSWW      YDYDTISAGWFPOUF
XXMEVRKYKT      : IBBNG          
YJJLLBJ         : DCOCBXNPPVI     RDQGGSXG       
YRXYCRACDMXQNV  : HNCLSVNLRVI     GCUWAHAPVW      GIOKLGBPSRRH   
RSVFTIYOHK      : SAIAGP          DFJCAKQNXXKVQ  
VWCFYDYYEDQE    : IGYRGYRWO       AIHKLEVRPRYNPQ  NDCRAANSVJE     XNPTIMNNLI     
WTENJC          : XEODQOJ         CJIATPRBLDPJNFL QXFGCXBPKARK    QSLFI           QQTGMXBMJGTSJCQ
BWRISAJHKU      : QOEGBNMBW       QNTYB           ELUICORPT       YKAYDPYQXEE    
GRMNSRM         : SHMI            CRGDWABJNNE     JBTVMYWWKROBBT  XDAXGTO         RWTMLGHLIDNRWJC
XSNC            : YKKHTPQ         NVHRWNGJ        HXQOHXMEEV      ETNHPAVK       
KXDB            : WCTOKTRQOOM     LVJEGBBKBELUGUH MBFLVKG        
HWLFPTXREIEBS   : EBBHS           XDJTLRPWXATFHV  DPUEIK          OYTS           
UHANYPKWIYBHJCM : DXMWUVPRA       NMYAXIYNXCFPMX  YURAP           ICMUEMYJVWNYC   XEOSCXJPUFJSBBL AVOVYAYN       
JVKWBCTCVAKBB   : JDMKQCAOMU      KEUBWKDFYQW     PMSHUTFGTV     
NVKOLLGYK       : CUJNUHXWIMYVM   IGLWBAUVCCQTJ   EKQMCTAEAXNDAP  WTLFUPLDYYV    
XLXJNMW         : CUPXHF          MYJMA           WEPLTTCJQIVUPTR FEGYIRIJPIUYPQ 
IJYMLSOHSY      : LIREXHP         HOWK            OXAUX           BFRUKLDANLDTXCF DKSHPFIL       
VEYTQPIC        : UVFX            FLJEDQLCEPUL    QGRYHFM        
HMMHAKQQY       : CJIATPRBLDPJNFL PWCJML          UQTU            YVKYRTKUCBIVYC  UDUXVKJCIJ     
SHBRVMNKWILH    : CVSXFVWJRP      VSXVBPT         IUVFMANJUNPLEW  FIKEPSBQGVDA   
RIBIXLK         : TLOFDBC         WVSTTJCKUK      HWODUVRGQY      LGJLCPKTSY     
SYIAASTSTL      : EYRYU           JEEDFBFTAR      GBDSTHSCITICK  
ENFACSLBCYL     : HGTYACCALI      VNDPTBAPS       AQUOX           UHRTLWYCCP     
RTMAUYNQTOAUQ   : FRBREVMTS       YSCJTTJCVWLLGDF WYKYOLMYID     
QJPEUTRDTWVH    : VSICSEKMXB      HILQK           DVLKN          
AHJJ            : XDGXE           TBGTVJQMEQJHR   KVXDTE          EFQXDUB        
GYDBXSRRIT      : BRLUVCLBTCF     NDTQMF          QYHAWVYFMM      XNHWXAORVXEQYR 
YPHLFMIY        : EYRYU           AXBJUOMLP       WVNHKH          JERDXCYRXR     
LSDIDEIMN       : VMXNACEQMVKYF   JYMMOQQWYJ      TCCNKJFMFGJG    NVTQYTKRNUND   
NVTQYTKRNUND    : SDKBFYUHOMLNR   OROYBPFRBC      NDTQMF          JMKHGQELDEDISJE EHAPONQVBN      BFRUKLDANLDTXCF LSDIDEIMN       SHPTDGVO       
DMHIYQHGCDLK    : QFOVLDUDQE      HKMOJADGLWCWI   VSRCRAWAMMIHNB  SNKM            KQIGUYO        
PVUGSICMBEINXV  : LHWCXQPE       
LBFPOMXPFIXILKU : CJAVKAAO        QCGQQNVAUWPH    HBJOXCOBQG      MYJMA           FDAJQ          
CQOIJY          : PSAVO           NMWEUEWOM       LXHJGYKNUVS     IBSYINOQE       FTMRL          
XARIQR          : WJSWCNFOKCJQ    FDXVHHEDSJKWHUN DEBXLDTUTK      PAFUJWKIDUH     EDIHNPPN       
BDIGSW          : BYWTFO          SWLFHGAFXXOJBXK LHYUAKJHVPC     VOSBLNQGTHE    
RPBCNJNAH       : VEFXCARKTTBUYOY RSNDPDPBXCAQNU  NHYXIVDONU     
DXANKYDKBWT     : WFIDUDWBEIXHW   TLCYSLTQNH      CRKWP           MBIUASEIXDYTDQI
OYTS            : FOHHALESXOIMAPT HWLFPTXREIEBS  
CNHAHYCJM       : MTOIHSRHEUH     NWVLPGUCXUPQBXS YDKBVACWWE     
YPUIUVKIGJOSNLM : WVSTTJCKUK      EREBCXONIU     
DNDXXGLHITG     : OVDUNPURU       GFHUACQBGJYGRQL KWCLBDDDNJQ     JMKHGQELDEDISJE OWIDEUTGHI     
DUBDKXNFT       : YAKXYUBLJS      BDXQYQWTMXHRJI  FQWELMYVWILHTA  LXXQO          
QCKHVXUKIX      : TGMCJDBXCBGAH   GCBSYESARIYKRS  CCKFPSRQBWBG    OHGMCN          UYGWBL         
LVWTK           : OCRXGSSI        JJRQDPOOXCUVJ   QHABYLHVMXLQL   HXBOWU         
DEMPHHSMURBANA  : NMKVTEMFRJOVVMQ OSHV            NNPBYXXQMPDKYDC ITEOIR          GWDVPGHFW      
SMAOLVBVVAHU    : QAXUTIQANB      GTEHALBEQY      GVUY           
EFFHLRYUCSIW    : IMXIMABTQX      PIJJCNDDSXG    
LYCNSUAULNSN    : FCRNAAAKFGLGXDI MAEGK           LLKG            ECAND           DFJCAKQNXXKVQ  
RNRMPVTUFFPGAT  : ODIFARPDX       SSVRS           NDTQMF          YFTEBNK         CIYN           
KQNVRQJKLKIX    : ONQPKWWJR       DDWKFCLRLOPAJJ  YPWJYMFMNLMF   
DNKUBEJSCDOHKG  : HOWK           
NAPXSFWKVGXKSG  : RMBHQV          HDKF            NRKUCCK        
TJXGFBK         : HMKT            WTJAYBTGWWW     AIGAWOI        
UMULV           : OJGKFTPBV       SWLFHGAFXXOJBXK CRKWP           RPJTNTTDHKKGMFI
RLUTDVMJ        : AYPPYANOMC      CRGTNOFDXKDBML  WKKRCHWNKKLAW   XLVFR           PFDQGQHG       
WHBURWDCSPAYWCJ : GKTEPMTWWJEMGA  NVIEGCJY        IMTJSOHEHTIAF   HOFLRD          RBRWI          
WXIIVQCH        : XVNMN           RWCKCFWYMHXPH   FEPGGCKHC       HWOLXUWG       
VNJIWCHGG       : STYAOMQDYW      EPOQVLOSYV      EBCTWULT       
YDKBVACWWE      : EWFG            VNWDTSE         RPJTNTTDHKKGMFI CNHAHYCJM      
LDGVLCONLD      : XWFJVJ          YQEG            GTXESOMCXBDI   
YMTXRDFAIGF     : VEOCOPNIQJ      AGJWHPE         CAHTHJJ         UOFXKBGM        ONQPKWWJR       KYDWSWEGLPM     WPQGPNLNBCJBHX 
HDVJAV          : SMYPYWDTELYK    PUBWROAAVH      SGSJOJIH        RANHXBNNYBNQ    YKBTHBFORF      PRBVYKULU      
IJSOFGSUV       : CRGTNOFDXKDBML  RIUCBMHSCBWFGV  WPQGPNLNBCJBHX  GKAIFIEBNY      CVAGQMVAU      
AHIODIIHPIRVN   : BLMPRVH         POAOHPOERPBJTNC NRKUCCK        
EQKPQIG         : RDQGGSXG        ISTOPPBIOLP     WKUODKFKH       JPFTTBRHWIFUA  
RBRWI           : KSSMV           IEWETL          WHBURWDCSPAYWCJ
TETVMC          : IPMJEHA         DJSPNCSAIBBOUI  DSMRVCUGEATBF   DVENT           LPSWCTR         NWVLPGUCXUPQBXS
PKTYBDRYSFDKR   : GCUWAHAPVW      UYGWBL         
DCCFTDYRNMNSGKH : ICLD            VUNJVRMVSFKTQ   BYQSFUDKLQGT    FEICTRGSIQYD    NBJLUHRXHONUVRV
VYURYX          : ELHJH           ERJET           QOFLDWP         CBGJVJTQINY    
SXOAD           : YAKXYUBLJS      WSBJ            NJIH            CIHDYLAGPVHCUN  GHMUB           KSSMV          
UYGWBL          : NCANVD          HHJYYIIDCYK     QCKHVXUKIX      PKTYBDRYSFDKR  
HNLW            : DGCC            SKJBGUTXYTC    
YRILYSJBNCAO    : LXKVIE          MJMCGFXN        GGKBXSGRVSL     MTCQJM         
UMPUPQPRXNUL    : PSYOHFKTBHAMX   GMXWXYEHGVW     LBTPGUHDKEXOEQ  RTGOTSVCY       RMMQUQPVB       RANHXBNNYBNQ    SCJDTRBPBIRBDUK
CBSABTR         : YFAOFGO         NQTVDLDDR      
GTCRU           : DLTKVN          ORECVB          ASPIUCL         UFVEWHN         TLFYWOGNGHUX   
VWHVRTLOLFF     : PNBRRTNCSBYTLOD NGNSUHOIBPXV    GVUUC           RBCVOCMFUPTFUIX
FUYSCDUUFVQ     : GKNLLBUDVOC     PXYQPE         
IYVMRSFNPMLJIX  : OTWLNXUNPLO     DPMD            CDUPTWKUX       GSJSPEXEYGM     DSIVYMAQM      
WFFCKCDD        : NJWGQFPI        JWWKGUFF        RHJI            SXQPQUJXVCQKTB 
HXBOWU          : XTPXXJBTWDESE   LELIMVDBBRCFRPO OXNDPQNITFSFA   JVGFIBWAHQ      GSJSPEXEYGM     LVWTK          
FTMRL           : UDSWIF          TCVCOBMJKJ      CCKFPSRQBWBG    CQOIJY         
ACWMNIXNJWSQYFT : YENHAK          CCDHPKRWWHHFX  
LAMLEDIYUP      : DSPMANOKFIE     FRBREVMTS       QQTGMXBMJGTSJCQ KVQLB           ITEOIR         
HKHPKJMYYXWNHT  : NYKCEVWKNFKDQYT
AVOVYAYN        : THDYELV         PVAJWQ          UHANYPKWIYBHJCM
FQWELMYVWILHTA  : IBBNG           BEPXWIPFH       XMWJ            DUBDKXNFT      
TXGJHDRIYGGAIF  : FKKCXVVVEJWONTN YSCJTTJCVWLLGDF
WKGTQUISQ       : AOAAGFLWDF      DJGJWLYNKHFH    HVVOM           KXXKRKXKCOTEDVE RNEQ           
DEPXEYTFGDML    : UAJMUSYOCWIMRE  CEEVGCK         UVFX            FLJEDQLCEPUL    DLIPVCGQEDPQ    KYDWSWEGLPM     RNUEULWCLTSKRLQ
WKEGM           : NFVWC           IMRMUKGIGG      MJDUIJP         KVQXOTBNKKTEQ   LNUMURHOCGLJAGW
LCLWIH          : FGSLAUNHVPBB    KCGEDITGXR      YFFU            IUAELNBVQ      
DSIVYMAQM       : MFEARTWKJM      PWYRIDK         UJWY            NFAJWTBCIBJTKLF IYVMRSFNPMLJIX 
QGKYLYKIYWOFJ   : IJTCUYDTO       EDIHNPPN        PTHCHWWHFVSMUD 
SNRRVCICUSX     : XTGIYA          VWFFPJN        
HYMTGFCSGN      : GPWQVHHTXQ      JRPPLG          ECAND          
SYSPNABRTOML    : BOPWUOMIGCVFBHW YFNTKULUS      
OVPJPPFWQTRWAV  : YRRHYGPASNTA    MOINIYUVFE      PVAJWQ          IOSNQXRSWSMYBK  CVAGQMVAU      
GKMALHRYK       : MAEGK           DVLKN          
TEKGRXUO        : VSEPRSLWOF      PDGMLQ          OHWPFBPXOKXCVRY VSICSEKMXB     
GGGLDYFWWHTQQG  : OUIQU           WDSC           
QRNK            : LELIMVDBBRCFRPO XRAOIWIVRQTM    BSHBYHELCQP     BSNMEWNVRHPA   
XGMERSX         : VNWDTSE         WASTI           RPNHLXA         RGTKWK         
POKVUQJBPRXOY   : BYMDTVTGGYQOIPB AODUPUIJQ       XRQCMFUCHLID    OFDVYF          SCMVPPEQPVC     TLCYSLTQNH      TXEFFYLY       
GPALITBTNYCAFT  : ONYGKXWUSDAOFDG WDNBSKGLVF      BAPHWXWFHICBVF 
GOLUYI          : CJBMGG          UOMNTROLSWQUXL  BNGBS          
RTTJLTYL        : FBYCKXOEE       CVSXFVWJRP      RDPKNJRNVP      QJKYUOHBFNHJARN KWVAMUKWOHUPG   XCDNKVSUTEIVRKS
HDQUONW         : KFCFEDACSQIS    EKQTSVIWJ       EPGPEBUSSD      YMSYAWDQVSEF    KJVCMBGIGQINJ  
BXMDEHY         : DFEFRNQJW       VIUXLQNTVNLQUA  CVCDFHJJXIPX   
XNHWXAORVXEQYR  : CKUXFDPEEIMLJXN WTLFUPLDYYV     GYDBXSRRIT     
IUAELNBVQ       : LPFMYGEGPESXDTS DVENT           RPJTNTTDHKKGMFI MDAAC           LCLWIH         
JUFSVPQLANJCECY : NFVWC           QJKYUOHBFNHJARN WPQGPNLNBCJBHX  DXMBXMXXDEX    
GREAYMU         : GUGB            BMCVEECY       
SHPTDGVO        : IRKJU           NLKI            WKCIJ           JIFMBQ          POABSUUPICTDMT  FXMSARPSOVYAN   IANLM           NVTQYTKRNUND   
BHCTXNT         : IPROBCILIGDY    EKQTSVIWJ       UANMQU          NTLPDBVWSJ     
XVRCWWKODKNRFPL : RGXEIFINNFVNWE  XFLICX         
FHUL            : YHFC            SOQWK          
JPFTTBRHWIFUA   : MEIOUVEB        VNPO            EQKPQIG         VOSBLNQGTHE    
SYTHC           : BAQJYIEBFEPQ    JLJSVFOLUGRAHEF WCJOHHE         XGNVQGNTNPWPWJX
XUKPIBUPXIT     : QCIOMHLAKWLGQ   RDMMOF         
ABETE           : OUCOXUIFQYBSJN  QBFBCKLQGIJNMCI
CBGJVJTQINY     : QFOVLDUDQE      VFOE            PQJP            NQAR            MNFONUOTWRI     VYURYX         
SYKFOSIJKH      : MMDA            GSJSPEXEYGM    
GRUHXOLVQOFDLO  : CEYDDWHPTJQUKX  EJPOOVJKKHTTKE 
CYMDOHCYM       : LIRT            BKBXBNAODKSDSML KXXKRKXKCOTEDVE GCUWAHAPVW      WDSC           
TXEFFYLY        : YKSQSXBM        NWSCJYE         AGJWHPE         QEVXMTFM        WYKYOLMYID      POKVUQJBPRXOY  
VWIJUCYAFMOEO   : FHWNCSFWTHFTLL  SQWUVW         
QUFYYFNSBL      : YULMS           GVAOJ           PGSHYLEE       
ISXUTTSSDCOHDO  : SADR            KNYWUGDDR       SCJDTRBPBIRBDUK
PGSHYLEE        : LNHJWKGFKKRI    IMGLUVEDPAEDJ   KUMBHI          AIGAWOI         RPVCGGCDLUCQV   ILYCOLO         QUFYYFNSBL     
DLBXNOXVKXSE    : VFQHMXCBBY      SUGKVGIBOW      GARWXSJVMRXUBFF UDUXVKJCIJ      YGXTQDXGN      
LXXQO           : UYMSWL          MGMHTKJYQMFETH  DUBDKXNFT      
VFVMNQVMCA      : CGWJOTJIDE      UYLKDDHJXOTOHKP XEQGRIPNY       UOMNTROLSWQUXL  YCSMSTVGGUJKUOA
PFDQGQHG        : PTBVSJCSUGCOWRN BXTTJUREFJAKST  ONFYMNOITYUVOEQ RLUTDVMJ       
REIWYWWYPLGLSEA : SEFL            MQMGGIIJQ       NYGMUELHVCH     EJXUDWMNVADOW   EIKYPH         
UVTXXNPGR       : JUNLTWMFL       RIKORYP        
MKNSAIWLFYI     : MNYVWMW         JYCVIWNYW       PILAIKMOFTVCPH  CWLXJM         
XXPHJKLMR       : RMBHQV          CRYXSOYKIFNTX   NSQENKHKAWRR    RMNV           
IOJJC           : YKKHTPQ         PBBSWDDF        XNLV           
PTHCHWWHFVSMUD  : HAJTYVRJA       POAOHPOERPBJTNC QGKYLYKIYWOFJ  
VBIFNTS         : UDSWIF          GPWQVHHTXQ      JYMMOQQWYJ      FYCPVARVLO      JKXUGTIERRKU    UJELERP         RXBPCOO        
LCMCNVFMNBVR    : RFOTA           FWKBCAWUKUCEE  
VOSBLNQGTHE     : KJCLAHPTWP      WGIJ            WDWWKRGTPQBXS   EFWSBNYQJGISP   BDIGSW          JPFTTBRHWIFUA  
QJKM            : JYCVIWNYW       MAEGK           ASPIUCL         RMNV           
OAHCDVXIIML     : AUHEJEH         LNHJWKGFKKRI    FKKCXVVVEJWONTN RSVMLDBVOMHH    RCVTEQVUGGCNDF 
GWDVPGHFW       : GWLLW           RFPLDVCMNL      TYPDORWI        LVJEGBBKBELUGUH DEMPHHSMURBANA 
YFUWXGJKJYK     : HGTYACCALI      QFCXA           PORDCBSEJQNGDYJ CKJL            QHEF            QEXTLU         
BPNBAXPMH       : PWCJML          GJPJDWBCIVU     RCQUIWVCANVOES  NDXS            BDXQYQWTMXHRJI 
