IAFLTCXJDLHH    : RLMDJUBWYOIOYXG LQYK            LLYUYOV        
FVRUHXRBV       : XYLJRDOUKTNIQ   KDTUMWPI        OAGVVPQTLPJFWU 
JLCJWPJTXJB     : LFERSYOPNIV     DGTNSBUPWUX     NBHOCEJEYPKVU   QFPQ            TJWBKM          ULIKEYQLDIYW    DPCGQJPHKDJ    
GDKPIXYPCELT    : SLTY            BEAUDKIS        EHJPFTE         QIFMST          DEUDSJPHE      
VRTWQKI         : RKVLKEUED       JNYYB           JYNIVGTG        BTLCWJUWPVLSSQ 
OSCECXFOYRU     : HLTYMOCCWLQW    GPXV            KWRIV           FUKTPLQWQLGM   
EMNCLDERRATNUPM : RIMCVB          ADBBNFIKO       XLFDCXIY        TJWBKM          TGIPDVCUS       YUKMWSOUAMIU    MPQQAFVUS      
BVRPQTUST       : KKHHWVWHIUHHS   KRAXJBFKXJ      PIHSPMXADUNIFYX UPSEVJXPE      
JUTEAXSNCESJ    : DOHQC           ALVJHOWSXSEE   
KJSAGJPRMNMCGG  : AHWWXOM         FHIHHQJ         PNWXKKLVOGAKKW  KRAXJBFKXJ      SRHCOYDNHIWFAA  VYCYIL         
YDBLXWRX        : UPNX            KMYS            GIFUJOUXHCXNQ   NBYQYLDNM       AJBERVVXY      
LNAPHLMTWGW     : CGYAKDLSLFDWE   RWHLTEHWXU      BPKOONORBDJVT  
RMXECKIITIJW    : HTDA            XYHIFQ         
UULNV           : JVVQVMVKHQAKQW  SYOQMIRNQL      OAELVP         
YJKQSXGNVM      : KLLVYXUEMQFD    RXHXYPUJB       JPJRCKPYPFQ    
CGYAKDLSLFDWE   : LNAPHLMTWGW     YRMOEMHAPQU     WVXRW           RIKKYRBCEDFDT   KGQRM           PITBTNMJJVGT   
SBDIWNJJBACY    : LYENSWWN        JELFLR          WFNFHSC         YVRLS          
RWUEYBFALINH    : OTHC            OXEPGEKUYQJ     LRKFPYGSB       LYEABQSABOMGSN  MSCIMATYP      
UKTYCO          : DRSGNOBJHTJMIQ  CLCNMOKX        IKDGIKIKSCECRU  KFVRG          
HYAVIJYILXRGVM  : CBDP            DUEMVHJV       
UQSWE           : GWCOUN          IIRXQ           BARQBAMO        NWWI           
KLCHYX          : BRGKLTNXUO      FQHHYIFQPPKI   
BMJLLJJVSIE     : LEWQXRJRKCBYN   CPBTKX          JGMEOJBM        CIWYUJ         
GXMENACEUY      : RHOKRT          MDBSR           HANA           
AMWCTVADY       : ADBBNFIKO       FYJUSLHCWCDBGN  FLQVW           MSCIMATYP      
MKCVT           : LYENSWWN        YCMW           
QCHWLFMPSO      : FMMRLAHGA       KCSVBDHFKAI     RCAEQH          PWGVE          
YJTI            : RLYKQFUWGIJ     OUFU            AVXAIYEHVAV     YNJMJXSBJQAA    WSOKUSWJCWTV    WLORNYCNBAFHOYM
GHOCDQFCI       : UETBMYPSUUEW    OHGPVQGRDNH     CIWKMUMLRPOV   
PMPJNGOUG       : RTTX            SADWME          NLPOXAUVALJJ    RJVTKK          IRITNIHPCEHQQ   SKFDTDAJB      
AUPVJK          : AHWWXOM         DLOBPYNQFMVVY   TUJMO           GPXV            WIGPVOOJNV      CDPMK          
UEFEMMUORMUW    : DYOQJEN         LIAUJLIKNBHUJDK WHSHRXEMOESQJS  HIYLLTA         LYSBYNN        
OMJFXWNMTVM     : OPMFHN          QVMDIJ          MATO           
QFSCPPW         : KTDBVRDKMTBLX   LTBHNN          HOTJOP         
VEGKYUDNRCKHOUO : XQVLENVY        RSRJNJVTOCEFE   ADBBNFIKO       BICJXLFYR       ULTBVW          LRBJHTCNWIRK    UQMIRJKWSDAB   
TECQDONVTIYJAVF : KBMFX           CXOWETNIYD      VKMOIVGTTI      WFQHDYQH        DMOJUWXHWGHFP  
ANJAJOPDQBM     : KAYTKBMJQRFCEGR KYTHFPNUREOJE   AUMGGGHPNDRDAC  NSXRBMBH       
XDTRIVKNNXJJII  : KPFCHWKS        CPCAS           BDXHK          
JHBHHPQJBFAGVBT : AVBBQLVACQ      AMEDRVPGXINWM   PNWXKKLVOGAKKW  RSUYJGO        
BWAUHXGUNGF     : OTEMNWQKFXXPTCR WKIHPNUIVPJWUK 
PPTBWUIHMCSPH   : YABPVYCMW       FUUXYHRSPCBV   
WGVQLWN         : IMUOUW          PRAULRS         UTCYJBGEJMILFBY MVKTJEYPHUPS    RRTX            KPNQGQOQYMP    
UXMBS           : ROFIWVXEIKBEWF  QCMMKDAXBR      SKFDTDAJB       KFVRG          
HAAYQTAP        : JGHIAPVOFVJMB   EYDVCUSO        YFJF            NFFTJAWM        QUXDGWJIAABBES  SGJX           
LYENSWWN        : SBDIWNJJBACY    MKCVT           UHKHKU          FXMXOGXQKO      FYQY            PMFY           
FMMRLAHGA       : QCHWLFMPSO      JGESLARSVOUSPU  WOCUTVEJPCMD   
HTWRTWQMTT      : VPXAI           CGCEMIKTY       BFDD            HYOQFXEOQVCQU  
LFERSYOPNIV     : JLCJWPJTXJB     MGMA            SAEGHBEHP      
UPNX            : YDBLXWRX        QFPQ            BGVKXAWBS      
UXTETQVQPPD     : SSVRAJLGQKENTE  MESRNVIXAUGXVV  HYGDCGAPAUGJOU  KLHYPQY        
JKUORPHQEYGPUIM : KWVJVEBOHIKKGXF QHLTVLYWCRIHF   CXCEGIWXAJGDFDT XYHIFQ          TPMIB           WFAXVBQXJQD    
YMKTN           : KFJSDX          LSOXDFNGINX     MKCBFE          FUUXYHRSPCBV   
AHWWXOM         : KJSAGJPRMNMCGG  AUPVJK          SXCMI           NBECVKCOJIWCAWK FCIJJA         
YVOVMG          : KTEOXFDWCGYEQK 
TASUIKQTWF      : EIVV            RGVQX           HDRMINIJHTP     GQCQPGOG        UVIAJISTWDACCJ 
MPMAVMJUL       : LOSWEJV         RKVLKEUED       KMYS            YSGESITHF      
KAOLXFHKMVGOQ   : QYUDMAKNRJMS    SMEY            BYHFCPNVUBEQ    GLBGIPTH       
WDUQCAJOQXQ     : QRCGCQDRBQDECBM QYGOMQQG        UBGSVMQ         SRHCOYDNHIWFAA 
NBKBLUCAGAFP    : CJMSYTELSMG     NOBVDBBUD       AVXAIYEHVAV     UVGJTEOOSJROI   VNVXUNNWR       WUVBQPNGAYUN   
TNTKGVIJQBMTNB  : BLTUOGNCVG      JRNCOAQV        RLXYCUOIEHO    
NSBDT           : WLQFRSC         VKLWQLNT        CKOPSIXKME      XISK            VJCWAOQWC       BSBLTDIIDNVY   
FHIHHQJ         : KJSAGJPRMNMCGG  YEQNIEBYF       SUMMRWDLY       QJTCXALPGPBYADU EBDEDAMDP      
JWLYRVGPGPJKCD  : DLQNEFDBJMWD    FCHUJNXMY       VJSFGNEUESGX    QYQBN           HNBI           
GPNB            : NRLGDH          MSGYSWEGRPAI    XRCVIQHVNT      EKLVMMKL       
RWHYERINL       : KDVROXEYCAA     VXCF           
CURPTLOCBWSMH   : WAELAKFPU       TMPVQYH         VBNREAI         UHEDGIP         OYLMHIIEGVLEYA 
RHDJXED         : VMWXSX          HTNAMABVXBNMAI  ROBGVLNXW      
BMOHEYURQAOKPLV : VAYNIRDHYOXR    BEJVDRYMDTGAX   PPNCTDBXQYFDETI
NACGMLGF        : OUFU            GEGWJKJJAS      IGWEMGMPGVL     HSSINBGSOPFOPU 
JOTQTJ          : GACNYWF         RJVTKK          GKNHRX          FYQHEGUIMMJXHC 
GACNYWF         : JOTQTJ          PBEHCMGTEJ      NBRKDAMHQW      PHKP            WBTNQFHQQO      UIOSDRTN       
WUDPGBVVBADQMLV : SLTY            CHGMXGMSMYJG    QUXDGWJIAABBES 
UMCNJN          : DMBLAXV         AMLIKOQDLEVE    MVKTJEYPHUPS    IMXG           
PPMFQJLKJIPY    : IYVHEELYJXPKTMW QTXLQVEVL       NBHOCEJEYPKVU   PYHD           
RWMU            : KBCQDDILOXT     QDGB            ENOD           
RLMDJUBWYOIOYXG : IAFLTCXJDLHH    PRPYFXRRDFMJP   FSWXQHLGMNQL    FFWIWE         
GWXRHHCAIURF    : FPKTABQUPU      RSUYJGO         CHECANC        
MFCBRFKOIJPARE  : SKNYJLSTUWTDR   YSIPJFESJMIXQ   IRITNIHPCEHQQ   RGBLFQODSB      HNBI           
SKNYJLSTUWTDR   : MFCBRFKOIJPARE  YCUOWKEDWAUH    KYTHFPNUREOJE   VOEHLSCMDA      VJCWAOQWC       WSBH           
KBCQDDILOXT     : RWMU            JPYQOTUSRISNVHL AEGNNATX        RARWHXSRQGV    
NVUUXNHL        : XWPGVC          OVKVTXMBDBVBNBM OSQAPRXCPHXSCE  DBKXDGNVWYKFJK  QXJMXWO         KKPDNYCMMK     
RWHLTEHWXU      : LNAPHLMTWGW     FRMAQVQNFTRX    TFKLTVBV        NBHOCEJEYPKVU   CRANBOUSLFK     RNWCMLMXJEXRQXT
YWADBJQRJMTY    : YNNJSMCPJGTKBP  OVKVTXMBDBVBNBM UQDJLHVY        YJFF            CDPMK          
OTHC            : RWUEYBFALINH    IIIEIHUPSDFIV   JOMFTSYCLKKEIV  UPIKRT         
SSVRAJLGQKENTE  : UXTETQVQPPD     DBBBJSJMXF      QOAS           
UJNG            : IBUCHUMCXTSF    YQLWDSMVITJIDX 
FRMAQVQNFTRX    : RWHLTEHWXU      ILRBK           PROWB           XVBISPIUFUFPL  
PRPYFXRRDFMJP   : RLMDJUBWYOIOYXG QKJCEHWAEBTRRU  TCEWFHHJ        HFDNQFS        
SGRSLJHNCGFRLBL : PPFOCJMVTM      ASMIYGRLQRDBEE  MOEHEJOFRS     
PBEHCMGTEJ      : GACNYWF         BICJXLFYR       BVND            WFBCMWHR        NTXTHG          VHPXECVWMNX     LXMNELKWUQLSMD 
SSTCL           : XJTNDG          WXBUGXUQWRAHV   TSNB            KMYS            GOCHJ          
VGNHPEMVJEIM    : BQUXOKKWYWJR    RDTLRJWWGSQ     BASE            RARWHXSRQGV     DFCOKIVFB      
UETBMYPSUUEW    : GHOCDQFCI       GBHBKGAEENIS    ACKHAQFWNBB     AMLIKOQDLEVE   
WQSKS           : NBRKDAMHQW      KGOI            ICDJSXXKMDUEQ   DFRTIA         
SGYIMLFVPPK     : JTNSW           TGIPDVCUS       FTVSF          
MPFPCE          : PLDCDF          SQWPXSWR        HJTWV           TJWBKM          EHJPFTE         YUKMWSOUAMIU   
UYDYXSXQLKJDFS  : MSEERN          HTNAMABVXBNMAI  UHXQJFKJ       
NFNUE           : VMUM            YJURQUMJYRRGVHB JPHHYJMHKPA     PFIUKSLKHLB     DLITKBNF        BWSNGBRGLM     
MOQYEXRI        : PQKGRXUG        CPUHQTIIKBNDWD  AEGNNATX        YXGBENEWAF     
XFDDGE          : RKEINTKBNPP     CBKMRT          TSKVLCEVRBPGYMN
GUIQHNVCPMH     : XQVLENVY        ACKHAQFWNBB     XGCPRNFLVPBGNW  YFJF            QILIEDXIYW      LWIJFFHL       
HNMWD           : TRNESYYQGCYJQP  JCVYLYBTJT      SDXVBHRRLANQA   UJVIUVFUTHKNW  
XJDP            : PHKP            OIBKPOK         WSOKUSWJCWTV    IIBT           
HPANSJR         : YRMOEMHAPQU     WWGPSAGV        FUWTGAWJRIFDT   YRBRWL          WFNFHSC         XHOINUD        
POAHVPFX        : UFHWKMQWAIQ    
RIMCVB          : EMNCLDERRATNUPM DVKWWHMVEMD     PVTUPUHSQPSO    FUWLGPRD       
BHWN            : YQDDMIUWBPURMG  VQRYDJJPCKBOBK  PIAWVRLKXO      DPSRI          
PKUFKIBTCSKQUTN : FXMXOGXQKO      GDJS            DQXOFCM        
YNRTVGXUJ       : OPTSKR         
XQVLENVY        : VEGKYUDNRCKHOUO GUIQHNVCPMH     QCNC            LIAUJLIKNBHUJDK KUQKKWBQDE      JJJRJU          DQXOFCM        
JHWFLRRCMNRYNIS : NJXXKSVGEKJ     DJTGKTP         OCRCDMQ         UCOVSPKW       
GBHBKGAEENIS    : UETBMYPSUUEW    XTJQDMT         NJXXKSVGEKJ     EKVL            VIUSTYRVQKU    
HQXQ            : NAETXNONSWTPUNP LDPXIHJQ        ASMIYGRLQRDBEE 
DEFXGTLBSBJ     : OVKVTXMBDBVBNBM RSXKKGXAPLJDDQM
KPMTTWCTBHJLCX  : NRLGDH          GDQBFMPX        BICJXLFYR       TSKVLCEVRBPGYMN
SVNICRPA        : HLTYMOCCWLQW    WMWQW           BGOOEALIG       MXXYDQRTH       CUUIDNDGCXYMVL  AXHI           
JLACNJNABCWUB   : XLLYNP          FYJUSLHCWCDBGN  WKRNLSKPBBPMCGJ FYRERVSRPASK   
QDGB            : RWMU            KKQXIK          ROBGVLNXW       VRJQQPUFEJBJ   
KBMFX           : TECQDONVTIYJAVF LTBHNN          PGHBKPUSR      
PCSFCROPT       : WUVBQPNGAYUN   
FFIIGKF         : RKVLKEUED       KHSB            EATTTS          YTWMXMRWSCBXQ   MSCIMATYP      
MESRNVIXAUGXVV  : UXTETQVQPPD     AVOE            TGIPADNVQNQ     TSKVLCEVRBPGYMN
OCGI            : PUJQVMSPAPT     MDBSR           LTBHNN          YAXBHGSOGPKXUP  CQUAVUNACWQW    YAVIUVUWLFVBOL 
VEMEJUMRIRVWVR  : ICPPUKYPGJNYKSU GNCKPXL         HCYXQJKBQWVD   
JNYKNWSNUQRLS   : PUQVC           QKFTLKDLUBCRRA  WFAXVBQXJQD    
TOUADBLANDIFA   : MNCHRAKQ        LHQW           
DRXPHXCXW       : KPFCHWKS        RXBCSDCWUKN     WDQHV           COXDFTONJQXYQLV KHLMRV         
NRLGDH          : GPNB            KPMTTWCTBHJLCX  MXAD           
YXBYB           : DICPXVRUHKNTP   SYOQMIRNQL      MYATGYNSAJJUV  
KBPP            : HJYSJNP         CKOPSIXKME      TQYXNWRSWY      UJSQH           WINSECOQO       QOAS            JRKWRXTDH      
WPTBJUSRS       : ANCDRGDONVQHMH  UUTIODVMPP      RBXVNHIHYLWVYW 
RRRFJDLM        : QUBM            ERKMM           MJEDRMBXGSSMC  
QLKRMN          : KAYTKBMJQRFCEGR RWKRLKWL        LHSPNXYDIKIMM  
YRMOEMHAPQU     : CGYAKDLSLFDWE   HPANSJR         BPKOONORBDJVT  
KPFCHWKS        : XDTRIVKNNXJJII  DRXPHXCXW      
VFROSEJ         : SFFUH           RVFHM           WYFN           
SGGKUXQ         : EPJJI           RTGAYUWAWVUFXMQ YDUMUKOVWQLNMDL
FSWXQHLGMNQL    : RLMDJUBWYOIOYXG XJTNDG          HCNW            GOCHJ          
JOWRINMMWUFDDRB : HMEWXSXQ        RIGMAFGDHV      EBRGPUWV       
IIIEIHUPSDFIV   : OTHC            GBNRPPDBRHIK    CLCNMOKX       
JGHIAPVOFVJMB   : HAAYQTAP        KOAWCCRYMHTTO   YTPKGVRK        ENNACDBWQEWDMQ  MSGYSWEGRPAI   
FCSPLCTVLQLEUSO : BRGKLTNXUO      XRCVIQHVNT     
KAYTKBMJQRFCEGR : ANJAJOPDQBM     QLKRMN          ICPPUKYPGJNYKSU AVYMK           SRHCOYDNHIWFAA  KOYOO          
LNCWPXSBPG      : KTFRBRULBYUBQ   OSQAPRXCPHXSCE  RVPDBBBSW       YCMW           
MAXDMYF         : NUSBTB          WDQFKNFTSLOL    SUABHWBSJVQBRKW DGBTXJWJQ       QTDLYQEWNHTEK  
LGUUWOAAVJTH    : TXPIRLMWITGQ    RTFFRODVSMNKIN  HYPOHOWMG       BUIVD          
HLTYMOCCWLQW    : OSCECXFOYRU     SVNICRPA        RIWNXVLHJ       TUVFHMFCNYBCJE  CKOPSIXKME     
TLLYUWI         : IGWEMGMPGVL    
SFFUH           : VFROSEJ         FYQY            PQWCLECM       
GEKDNWW         : PAMAXTMLCACVUTR HCNW            PDIMPKMMQ       MNAEGQFYUS      SDUFLPB         CWYNECT        
JNRNLE          : XXJB            WHSHRXEMOESQJS  PGXSQDFHHC      WSOKUSWJCWTV   
KOAWCCRYMHTTO   : JGHIAPVOFVJMB   HYOAWVBWETOB    HOCLKSCBFJXH   
CRXIDCXCYN      : NSMLIBX         COXDFTONJQXYQLV
NGBBKH          : PMRYTIDY        RVXTM          
BJIFNAE         : DNNPLPIL        ULTBVW          FYJUSLHCWCDBGN  RARWHXSRQGV    
KBUBQYVQHBSHD   : EQHC           
VQICTLO         : DLQNEFDBJMWD    TITPLQPEIAR     HTDA            LNUDEQPPRH      BVSJILA        
WRMI            : ISMMW           MMPIMU          YXGMCSWAXVC     TQLYVAFJPCGB   
DKDDWEXYWWWO    : UDUIIXKIIJ      EDJFVRCEITPLP   PDIMPKMMQ       RNWCMLMXJEXRQXT
XHOBCKTMOPX     : MVYACYFAIR      CYJYSITSRRHLL   KKQXIK          QEIGTHMDBAALPNP
SXWHGVKQBO      : YAVFIOGCBWJ    
GOPFMMTUKEJNGVJ : IKWKUK          BVMQWVIXBOYLCO  QONGAAJLM       LVTCIRQR        SGTGWQGUHOQ     IFKQEWGKB       ECVNOOMEUCMRM   OCIAI          
KYTPTRODAM      : WESKOYBYBNBFTMC WHSHRXEMOESQJS  WLORNYCNBAFHOYM SICQKVUQHPN     DAHVENM         QWRNIVEBKX     
ROFIWVXEIKBEWF  : UXMBS           TUJMO           OWVG            FIODHXQEFYK     IHMXQMBCMFWMJK 
MNMV            : EXXKCKYLNWASHM  CRANBOUSLFK     GESUIEEFR       CDPMK           QUXDGWJIAABBES  PXULIIGLLRJMV   FUKTPLQWQLGM   
WWGPSAGV        : HPANSJR         UWMVAMUNFHFYDCR MNAEGQFYUS     
VMUM            : NFNUE           NGQWMPOY        OWVG            XLLUVLMA        XQIWRID        
DLOBPYNQFMVVY   : AUPVJK          OQWCPHMS        BOIYKAXWMYYL    YSGESITHF      
KWVJVEBOHIKKGXF : JKUORPHQEYGPUIM CGCFEF          CORSRKEDN       WSOKUSWJCWTV    FPNVWVJUOFYH   
RKEINTKBNPP     : XFDDGE          CRANBOUSLFK     CSKDQRPQTEY     KOUAIBVYAXX     VQFNRDLFMWO     PMFY            FOLIOBJ        
NOXANWKJBLXKV   : SGHYTHGCBJR     ICSGEAPTAXIU    DEUDSJPHE       GFLXGCDWCQHA   
UCIA            : RVRUXEWHVW      MCCNBJKEUIMXL   QOHM           
DMBLAXV         : UMCNJN          OVKVTXMBDBVBNBM WVXRW           YMNUVBTDPPP     FMMCLAJ        
LOSWEJV         : MPMAVMJUL       EOHATJLKDP      WXXVEABGTTHOQEW HKADHBORM      
WSRITFGFC       : EKDEDWITVUW     XGRBIKTQYQVKVJN
CGCFEF          : KWVJVEBOHIKKGXF HSICHNCMQKXDJ   XFLH           
FTSFPVQGPOL     : KNVWCJBBBC      SSYVJETG        GLROTVPEQTKVALP IPQNNVMEOJUYQ   HOTJOP          ICDJSXXKMDUEQ  
KSYFMJYRQGTKJDO : XCTUCUPYXSGWTBH
HUIOOBWGANP     : TYGPWSOTUHF     TGIPADNVQNQ     OVMXME         
EDSQ            : RIWNXVLHJ       XISK            YAVFIOGCBWJ    
TVKEXCWGYJRCX   : NHMVKNOVWXQ     IGCUGHDPOTEBX  
LURCL           : KCSVBDHFKAI     GBDNRV          WBYUBBDX        CPCAS           KNCSFUF         SQKBYVCYHMDI   
YUUPKMTNILLC    : VGBY            TDKJKTPANT     
VGJXDQY         : CPJMASRQ        XOWXM           OAARGFBFEYMMQ   DTQN           
IBNROIJRW       : QEGFTXVSYA      QQTHO           WLQFRSC         SKWGE           RBXI            FLQVW           GOGJYRNFP      
QRCGCQDRBQDECBM : WDUQCAJOQXQ     IQDJGCKPPFDRKBO EXXKCKYLNWASHM  GESUIEEFR       BLUHMIMN        SKWGE          
BSDBH           : BEAUDKIS        PCVVHOQICWEWJ   WDQHV           WQVCOKYME      
EUFTG           : ETYTJVT         TCEWFHHJ        YYVTMXKWOAVSC  
LFXEWANBSSUUJXB : SMECIJJHWW      UQDJLHVY        VLVLXACUCR     
BNXCIDDQP       : NSMLIBX         KPOSVOATLTQUBS  QOHM            ALHLEYYNOLQVQA 
NWCVOPBMVAOJD   : RVTT            QTXLQVEVL       MSGYSWEGRPAI    RLXYCUOIEHO    
CXENVHCYXACGE   : IFELXQ          DBBBJSJMXF      OWPOXTNMBDFR    UHXQJFKJ        SHBS            OKPLFDCLA      
YVPPS           : FYPHPQMUMCKVU   JYNVOA          PIHFLDUPIX      LYVCGYTQGGOXS   NMTBVFF        
LJJPVGPMRT      : YRBRWL          SJYEPWULIL      OKUYCUDGS       ANEGUPGB        PGHBKPUSR      
WRDMQNOP        : XYNHN           TWKKMHYF        TPSHFTN         GILXIXCCJQ      MNUWJMSAGG     
RTTX            : PMPJNGOUG       SDJSQPVP        SCTOCRBQWYUQ    LKBDJNBXTOQXJVJ
TTRJOKWBVOWCHM  : AEXJ            DYOQJEN         NRBXITMQQBDLCF  JCWKIUOJQTTPK  
BLTUOGNCVG      : TNTKGVIJQBMTNB  OFICDTA         JPJRCKPYPFQ    
PAKNCEJWPAJO    : DGTNSBUPWUX     OPMFHN          CBOBAVCJIIHG    MPTKTLFJQCUH    VMWXSX          OFIEAJA        
FEBKLNHOYBLPJAU : AQXITPBEUTRDQH  SKSKSWQUCDFMY   ULKCTB          OHLO            BOYJMOUJLIPUJA 
IKWKUK          : GOPFMMTUKEJNGVJ UUTIODVMPP      PUQVC           VHPXECVWMNX    
BVMQWVIXBOYLCO  : GOPFMMTUKEJNGVJ UNAK            RGBLFQODSB      DGBTXJWJQ       LJVOCLP         WJRJPFBYDO     
QNVCGIEBPOL     : LEWQXRJRKCBYN   QARPTDAYX       CRANBOUSLFK    
AHCPIYECV       : EOHATJLKDP      RDQDJWYLFMXYKJ  XSTNRW          QIQS           
KTDBVRDKMTBLX   : QFSCPPW         BOIYKAXWMYYL    MXNGGHGQSB      TKKJDYSRPONCA  
TFKLTVBV        : RWHLTEHWXU      ULIKEYQLDIYW    UBGSVMQ         JFRBXXGJGYLF    QFYCBKCAIH      CGTFCHFDAFNH   
ENOD            : RWMU            CYJYSITSRRHLL   PAMAXTMLCACVUTR YFJF            QFFKMFVMMDE     IOJG           
SBTDUXGSRJEEDHP : VQRYDJJPCKBOBK  URBNDH          LHSPNXYDIKIMM  
QJIBXFYBBFFR    : MEQLFSSLIGUVRAM RVFHM           QKFTLKDLUBCRRA  CHECANC         SDXVBHRRLANQA   XIFQDBXMIYX    
KJONGTL         : KWCDJRDWOOH     WURGBTEY        TXPIRLMWITGQ   
AEXJ            : TTRJOKWBVOWCHM  QXGBX           RLLOSHINKXTN    VPYOOUFHCMDRRUX YAHYN           QCTPQPDXUCNGEBY
CORSRKEDN       : KWVJVEBOHIKKGXF SAMTGXH        
INGLSLDOYP      : SLJHSKGXIFL    
MVYACYFAIR      : XHOBCKTMOPX     TSNB            GWMESJBE        SCKLBBVJV      
WMWQW           : SVNICRPA        YBSV            UFHQSBMRQJXLQF 
TLIEYO          : HOTJOP         
TDVKENPSL       : KNVWCJBBBC      AVYMK           NRBXITMQQBDLCF  FUWLGPRD        DXKESAT         WOUMFYYQTYUDFX 
TPPYRXSWWFVNDAK : MABEK           LTJJRQ          GYFFDFTG        WERLQNE         YQLWDSMVITJIDX 
LORAHLD         : VPYOOUFHCMDRRUX MMCJ            EJLYCPJI        TPMIB           ENLVOQMXJDO    
XJTNDG          : SSTCL           FSWXQHLGMNQL    LVXKDXQKXSYD    OXHGL           FNSI            ISRQUJQQCMBMAW  CYLHOSOOMQMRPW  JCWKIUOJQTTPK  
XJTNDG          : DEUDSJPHE      
WVTXQTQNQYJ     : GBKPFCIPD       OWCMDQGVHUQ     PSOTN           OWPOXTNMBDFR    SCKLBBVJV       BPPT           
CMQUXGM         : NUSBTB         
NAETXNONSWTPUNP : HQXQ            UPHRYNDA        CHGMXGMSMYJG    LCRTPOMCYCJA    JAQMHU          GIFUJOUXHCXNQ   UTCFD          
HJYAILGMXXHVGV  : DOHQC           EKVL            RRTX            FYQHEGUIMMJXHC  RSUYJGO        
VVCQVSH         : RHOKRT          WFNFHSC         CRANBOUSLFK    
LGFEBSTPC       : TBTBFB          OGBUSTCXLLXBVT  JTNSW           OVMXME          SDUFLPB        
QCNC            : XQVLENVY        ISMMW           LVTCIRQR        MDBSR           AVYMK           IYCNVWRCCP      LEKS           
ACKHAQFWNBB     : UETBMYPSUUEW    GUIQHNVCPMH    
YTPKGVRK        : JGHIAPVOFVJMB   KLLVYXUEMQFD   
KGOOKGSAKGBPQKP : OPMFHN          QMMEBDBO        YUSW            JUSOE          
QOATQGTKVGSTYDS : MSQVDAFLEM      GLROTVPEQTKVALP DGMWV           QVGADARRASWUIF  LJBXHTBJXIABS  
KIDWQVWDC       : WPEDFDVNWY     
SVLLGE          : QONGAAJLM       LQYK            METMWQ          LHXXBFUNHABK   
GXSOTGMDYGC     : QQTHO           SFGRGQLIQVJVGJI FUUXYHRSPCBV    QREXLHM        
YNNJSMCPJGTKBP  : YWADBJQRJMTY    KNVWCJBBBC      HMEWXSXQ        LYELBDIGYIBT    SDJXLED        
OXEPGEKUYQJ     : RWUEYBFALINH    RRPVDYKMXKMDD   UVGJTEOOSJROI  
QRGVT           : WVXRW           IPWGOGBFV      
LDPXIHJQ        : HQXQ            MDVORKCYXJCHU   XYNHN           FUWTGAWJRIFDT   QTDLYQEWNHTEK   QIGHTRSCTUAKY  
VRTTHRAYYFLVE   : SSWVLXSME      
GIVXQRRMDXEBIL  : JVRKPCWSSGVVORU SSTKX           VATHJSXNENFTKGO XJIBX           VCAFOO         
YNJQJD          : JLVUENKDFN      OYQV            RVBLNLO         JTHYKWBNPQD    
BEBCLPYRSHA     : XYNHN           SJYEPWULIL      IMRR            WOGGB          
HSICHNCMQKXDJ   : CGCFEF          KCSVBDHFKAI     OQYKBNRSRR      RDTLRJWWGSQ     QILIEDXIYW      JMFILKGHDFY     IKKJDGFTQK     
MCWSFBYIDKXECS  : SNJQOGUL        XOWXM           BEJVDRYMDTGAX   VKDFWKQ         LXMNELKWUQLSMD 
EJVYTAGJ        : FXTHPOKAXWTEFK  DNOVMX          GYFFDFTG        KTPFPGC         KFVRG          
SAMTGXH         : CORSRKEDN       WDQHV           TMGMKFRMHCCII   IBBPPP          NHFOTYR        
AHNHIMQNYOSDKI  : SLTY            WLORNYCNBAFHOYM KARHDVAQEGLRUAN
TEIQEPA         : PDIXXDKTXJAIX   LPJGXUS         OAGVVPQTLPJFWU  IPQNNVMEOJUYQ   IRGIWWR         PUQVC           XCORNFW        
IBUCHUMCXTSF    : UJNG            CPJMASRQ        UBGSVMQ         OULT           
FXTHPOKAXWTEFK  : EJVYTAGJ        AUWWHXMNHDMRXJ  MWJHFLKW        RTUETX         
UNRGOPK         : YBROTXCCQPOKCO  BASE            BFTFD           YWDPTGNOVQTSHQN CWYNECT        
MWCKSUQYDOTKE   : EHAYMCQFNWWNTEE OSFSUPEF        CGCEMIKTY       WWGTJWW         GFLXGCDWCQHA   
WGITBN          : KFJSDX          KMARQIXYGJJRTJ  YAAOQ           YFCTGO         
NYWBSFRKQRXP    : JUSOE           UWMVAMUNFHFYDCR JBKIILRVIA      NMTBVFF         LCKQVKVVGKR    
ILRBK           : FRMAQVQNFTRX    FFDBOURMYG      PPNCTDBXQYFDETI
SGHYTHGCBJR     : NOXANWKJBLXKV   SJLBSODSAYJURJL MGMA            VKLWQLNT        EONSJCT        
YQDDMIUWBPURMG  : BHWN            AWHUPC         
EHPCA           : WBVPHIVNLJRGIN  UTKERUFBIDBUTJ  XHOINUD        
JCSS            : KHSB            CQGHFVVFSUBUAA 
WWRPCQGFTS      : OKBAUHWAKWUJ    KNLPTFWSPPO     LHSPNXYDIKIMM   AIPMUKLXGYO    
RSRJNJVTOCEFE   : VEGKYUDNRCKHOUO TKAXBJI         XVBISPIUFUFPL  
GQIYLQVIK       : DAHJDBGKVUCMSQT FDCY            VHPXECVWMNX     SRLSDO          QBYGHQ         
LEWQXRJRKCBYN   : BMJLLJJVSIE     QNVCGIEBPOL     UJVIUVFUTHKNW  
UDCBK           : MDVORKCYXJCHU   OAGVVPQTLPJFWU 
IQBQR           : YVNSOLOIKXD     OAARGFBFEYMMQ   ORGNRLQ         KMARQIXYGJJRTJ 
KNVWCJBBBC      : FTSFPVQGPOL     TDVKENPSL       YNNJSMCPJGTKBP  KHKUBECKPNNKB   ELUQYQHGRUTJCXP EQQWJAMMIFBXKS  LFUNQRCTDVRSRNA
KTEOXFDWCGYEQK  : YVOVMG          ICOLWXBHGPNJM   OLKMJAGNTHR     TYMFVRAK        PDYSNSKQOLJP   
JLFBBRQ         : FOHINY         
PUJQVMSPAPT     : OCGI            FXXEPE         
NBRKDAMHQW      : GACNYWF         WQSKS           XTJQDMT         JKOCMTAJMPXIC  
CKCDOTUOLPXDON  : SQWPXSWR        AUMGGGHPNDRDAC  GEQDHBKKERK     PUQVC           LHXXBFUNHABK   
ENNACDBWQEWDMQ  : JGHIAPVOFVJMB   ULTBVW          IPSWMEILM       VYCYIL          NHFOTYR        
ISMMW           : WRMI            QCNC            TXIFIQIMJF      FDCY            DQYHNOSUVHIEY  
JTRULSXAGYG     : BWURLVJCM       GRYJHNCXYDG     VKFRRICW        JBKIILRVIA     
OGXSJUJOS       : HBQJXMMKWERQME  QYULPXGQYP      VKMOIVGTTI      IMKHJUKUL      
DLQNEFDBJMWD    : JWLYRVGPGPJKCD  VQICTLO         LLEIJ           SEKHTR          MATO            BKBA           
JVILEH          : BTLCWJUWPVLSSQ  PWGVE           IKKJDGFTQK     
AVBBQLVACQ      : JHBHHPQJBFAGVBT OUFU            YYVTMXKWOAVSC   WVQWWDCUWMSOV   FUKTPLQWQLGM   
FCHUJNXMY       : JWLYRVGPGPJKCD  OQWCPHMS        QFIBOBKRVWCJHM  BWSNGBRGLM     
KCSVBDHFKAI     : QCHWLFMPSO      LURCL           HSICHNCMQKXDJ   ASMIYGRLQRDBEE  JDUI            YMOUIWSAVBWC   
EJAPH           : EOHATJLKDP      SUABHWBSJVQBRKW WHRODS          QOHM            UGAUEPKSVEJ     KYGWEYTCIVQIN  
TBTBFB          : LGFEBSTPC       HYOAWVBWETOB    QKJCEHWAEBTRRU  XOWXM          
OQWCPHMS        : DLOBPYNQFMVVY   FCHUJNXMY      
KTFRBRULBYUBQ   : LNCWPXSBPG      CXOWETNIYD      AVYMK           HTCMKL          VPKH           
FKGYL           : BFFWYMYPXYEKJ   QQTHO           HHPV            JTHYKWBNPQD    
BJBRGDKQRD      : DUFMOAEJHSUC    UHKHKU          TXPIRLMWITGQ    MXPMNUQB        TGIPADNVQNQ    
EYDVCUSO        : HAAYQTAP        QEDKOHDUOF      CGCEMIKTY       GFLXGCDWCQHA   
RLYKQFUWGIJ     : YJTI            GEQDHBKKERK    
SKCBPORJRNNSS   : QXGBX           WLQFRSC         CWIJSBVUTTKYRQA
UNFLMYX         : YRREXGDEUAIJF   HVRYP           KOCOBPVMCYMLHPW TDKJKTPANT      VMWQIPYK        ORJYSC         
MOUHM           : BGOOEALIG       LAANSB          SDXVBHRRLANQA  
SXLN            : UVIGACQ         JTDI            AWHUPC          VLVLXACUCR      VPKH           
POAEJLXY        : EOHATJLKDP      LLAEHPYEDORCF   SMEY            HLYHEPQFRI      DQXOFCM         EBRGPUWV       
SROQHTCTVAKIRHR : MEQLFSSLIGUVRAM DQUDNUTUG       QLOCWM          VIUSTYRVQKU     FCAAIRMD       
LMEXA           : IIBLTI          QGQBKCDYPAY     PMNCLCPVHURBVE  GESUIEEFR      
PROWB           : FRMAQVQNFTRX    OSQAPRXCPHXSCE  WGJRAYLA       
UAFOT           : KDVROXEYCAA     KFJSDX          KGKXMVNNMDVODT  TRNESYYQGCYJQP  NAKH            WGJRAYLA       
HBQJXMMKWERQME  : OGXSJUJOS       VYGFPPYJUC      GCEGIL         
QEGFTXVSYA      : IBNROIJRW       LVXKDXQKXSYD    YGJR            VAXTKQLN        NXIINVVQNRXH    ERKMM          
BFFWYMYPXYEKJ   : FKGYL           XYNHN           HXKA            IFELXQ          FYQHEGUIMMJXHC 
QBUFHYVLFBIGYB  : TXIFIQIMJF     
YRLEYIELJVMID   : EIVV            HYGDCGAPAUGJOU 
TGSXDXFE        : MBXTRBABUS      LMFKQU          JCVYLYBTJT     
TKXCSX          : YVKVHTDUGCJ     LRKFPYGSB       NLPOXAUVALJJ    CCRGDNYMYN      HHPV            VIUSTYRVQKU     DFRTIA          QOAS           
AYXLEWUK        : CRANBOUSLFK     IJJDUNMRGYXYMCQ LWIJFFHL        CGTFCHFDAFNH   
GIXP            : WAELAKFPU       HJTWV           MRCEDHWYUHHRF   AVYMK           KYGWEYTCIVQIN  
WLURLXQ         : TXSVFCLPRC      WURGBTEY        LMFKQU          CJLLFWBQD       HCGHKGS         BGPG           
DNNPLPIL        : BJIFNAE         MDVORKCYXJCHU   OTEMNWQKFXXPTCR UPSEVJXPE       RNWCMLMXJEXRQXT
KLSWRSTEEAMERBD : JUQMOBNDFGTS    FFDBOURMYG      LHSPNXYDIKIMM   WBTNQFHQQO     
XVRVMJBAYSNO    : LLAEHPYEDORCF   DAOWRSXW        AOCLG           TPMIB          
AMON            : CYPUFFLIO      
LFAHLGHXK       : FAUNOWO        
BOIYKAXWMYYL    : DLOBPYNQFMVVY   KTDBVRDKMTBLX   TSNB            TONSEIAKWJ      WXXVEABGTTHOQEW RRTX            BELP            KAXCAHPJHHDDH  
MDVORKCYXJCHU   : LDPXIHJQ        UDCBK           DNNPLPIL        UVIGACQ         ONMUOJCYQNUFVT  RBXI            FOLIOBJ        
RVTT            : NWCVOPBMVAOJD   IQDJGCKPPFDRKBO KOYOO           PDYSNSKQOLJP   
KCWUEUTQV       : TXSVFCLPRC      TYGPWSOTUHF     HTNAMABVXBNMAI  RVRUXEWHVW      GEQDHBKKERK     VATHJSXNENFTKGO VPHSBXOEQITRA  
FOHINY          : JLFBBRQ         QQTHO           RYORDHVQXCDD    CUUIDNDGCXYMVL  MJEDRMBXGSSMC  
ADBBNFIKO       : EMNCLDERRATNUPM AMWCTVADY       VEGKYUDNRCKHOUO SMECIJJHWW      QYURU           HLYHEPQFRI      GOCHJ          
IKTGUXFRDCNVA   : YMKB            VMVRJFGOQSYY    PDIMPKMMQ       LKBDJNBXTOQXJVJ
BRRJFQLFUPIKUR  : LVXKDXQKXSYD    LYELBDIGYIBT    YJURQUMJYRRGVHB FODFTATOKJ     
LTGVQMSOTMT     : RYORDHVQXCDD    WINSECOQO      
AQXITPBEUTRDQH  : FEBKLNHOYBLPJAU LOMRW          
BFFYQAFPQ       : BIIW            UUOMGOMHEKJI   
IHPXCNXUNJ      : FCIJJA          BGJOWAUKOPWU    PQWCLECM       
EKUBGPG         : CXOWETNIYD      QUBM            AXHI           
WUBCCCVCJLUFVFU : AMEDRVPGXINWM   MBXTRBABUS      MVKTJEYPHUPS    GEAQLCWVPFUGX  
JKSEYCU         : PCVVHOQICWEWJ   BFDD            VUJKOFWL       
OSEWINUH        : GDJS            GVVJGGGYHWURU   WQVCOKYME       VMVRJFGOQSYY    MVYFQEJAFUKEC   VPHSBXOEQITRA  
YMKB            : IKTGUXFRDCNVA   EXXKCKYLNWASHM  EUACNPND       
PLTMQRROMBYH    : MBTRACBRNKVRSS  UQMIRJKWSDAB    OSXECMMMTEB    
XLFDCXIY        : EMNCLDERRATNUPM WHRODS          TLAKI          
XWPGVC          : NVUUXNHL        TYMFVRAK       
YMKMGXEBPUNT    : WFBCMWHR        GCEGIL          HSSINBGSOPFOPU 
UDUIIXKIIJ      : DKDDWEXYWWWO    RIWNXVLHJ       QKJCEHWAEBTRRU  OWCMDQGVHUQ    
GGHOELIEYSQH    : QIGHTRSCTUAKY  
WIJTVFOSIJBRHL  : WXBUGXUQWRAHV   OWCMDQGVHUQ     BNYQA           ILXX           
SXTYGBOLMWR     : FWWGWMBOKPV     LAUSBKQAYAJL    KMARQIXYGJJRTJ  SYOQMIRNQL     
RKVLKEUED       : VRTWQKI         MPMAVMJUL       FFIIGKF         SFGRGQLIQVJVGJI VJSFGNEUESGX    DTXCYV         
UVIGACQ         : SXLN            MDVORKCYXJCHU   OPCUJCJWQKGR    MTJCUVV         WERDJ          
FJLYISC         : KSKUDIAESWBA    BXOATPEFCS     
GQVX            : XVIYLG          YJURQUMJYRRGVHB BYHFCPNVUBEQ    KHLMRV         
OKBAUHWAKWUJ    : WWRPCQGFTS      UJQYNQCR        GQIR           
CJMSYTELSMG     : NBKBLUCAGAFP   
MMPIMU          : WRMI            USIXSYFVAPU     AWHUPC          WJMILXVGMVMQT   RBXVNHIHYLWVYW  WJRJPFBYDO     
WXBUGXUQWRAHV   : SSTCL           WIJTVFOSIJBRHL 
TQLPU           : TBEFUTBRLFIGQFG WKABMGYPEDRTFT  TWBBPT          PXULIIGLLRJMV   HOCLKSCBFJXH    QBYGHQ         
KKHHWVWHIUHHS   : BVRPQTUST       SRHCOYDNHIWFAA 
CYJYSITSRRHLL   : XHOBCKTMOPX     ENOD            CVQF            JGESLARSVOUSPU 
DGTNSBUPWUX     : JLCJWPJTXJB     PAKNCEJWPAJO    PDIXXDKTXJAIX   OYQV           
RHOKRT          : GXMENACEUY      VVCQVSH        
DUFMOAEJHSUC    : BJBRGDKQRD      GEYYE           JSBAS           RFSOOLNWW       NBYQYLDNM       GFLXGCDWCQHA   
DVKWWHMVEMD     : RIMCVB          BPQVTRTKHYOLUKA NLBIBBSW        NXRVEVHM        KLLYPW          QIGHTRSCTUAKY  
TUJMO           : AUPVJK          ROFIWVXEIKBEWF  LFUNQRCTDVRSRNA XQIWRID        
PLDCDF          : MPFPCE         
MNCHRAKQ        : TOUADBLANDIFA   IGCUGHDPOTEBX   JBKLBJP         BYXYUHYNQE      XSVCRVQWHM     
JNUWKBJPX       : INKNQPYFFDM     LOMRW           CIWKMUMLRPOV    TXIFIQIMJF      BNYQA          
KHSB            : FFIIGKF         JCSS            KGOI            QXJMXWO         QSFOUDJENDGNKD  KUIDKGKO       
INKNQPYFFDM     : JNUWKBJPX       OWPOXTNMBDFR    XJIBX          
DYOQJEN         : UEFEMMUORMUW    TTRJOKWBVOWCHM  VIBJMUX         XNYS           
QQTHO           : IBNROIJRW       GXSOTGMDYGC     FKGYL           FOHINY          UVGJTEOOSJROI   DLITKBNF       
TXSVFCLPRC      : WLURLXQ         KCWUEUTQV       SJLBSODSAYJURJL UQDJLHVY       
QHLTVLYWCRIHF   : JKUORPHQEYGPUIM BYDMBBYATUCJF   DFCOKIVFB      
XYNHN           : WRDMQNOP        LDPXIHJQ        BEBCLPYRSHA     BFFWYMYPXYEKJ   XJBNAWAATHEY   
EOHATJLKDP      : LOSWEJV         AHCPIYECV       EJAPH           POAEJLXY        FCIJJA          FUXXPNMDRON     OKPLFDCLA      
TYGPWSOTUHF     : HUIOOBWGANP     KCWUEUTQV       OPTSKR          QOFDSNXNYCGENH 
OXDNLMECQSJSOUE : CHGMXGMSMYJG    IBBPPP          QKFTLKDLUBCRRA  DNJQPWHBOVIRXVT
XVTTUBJRVAOQ    : JYFOUBNYCTVYVQ  CQUAVUNACWQW   
VVYV            : DOHQC           FXXEPE          PBGJK           LLYUYOV        
OKNSMHNV        : RIRKG           KGQRM           QKFTLKDLUBCRRA 
FQHGQD          : QIQS            LYEABQSABOMGSN  RBXVNHIHYLWVYW 
KBEVUAVLSG      : GDQBFMPX        JYNIVGTG        JBKLBJP         VSIG           
OHGPVQGRDNH     : GHOCDQFCI       YGHRLWIOKB      GBNRPPDBRHIK    DICPXVRUHKNTP   HLYHEPQFRI      MAGMYKIQ       
PMRYTIDY        : NGBBKH          JDUI            MNIN            BGJOWAUKOPWU    WSBH            SEFAWCXP        IMXG           
GDQBFMPX        : KPMTTWCTBHJLCX  KBEVUAVLSG      WKABMGYPEDRTFT  WBTNQFHQQO     
WPEDFDVNWY      : KIDWQVWDC       YENM            LRBJHTCNWIRK    CVTB           
EATTTS          : FFIIGKF         KDTUMWPI        JBHRC          
CXOWETNIYD      : TECQDONVTIYJAVF KTFRBRULBYUBQ   EKUBGPG         RMGRKCEYGHDCEWW TOXBWAAXJCJG   
YAWQHD          : KDTUMWPI        VBNREAI         KGQRM           RVBLNLO        
KYMHBQNBKHX     : GWCOUN          XLLYNP          BDMPFP          QOHM            WVQWWDCUWMSOV  
WAELAKFPU       : CURPTLOCBWSMH   GIXP            SADWME          LRKFPYGSB       KFJSDX         
USIXSYFVAPU     : MMPIMU          OXHGL           LYELBDIGYIBT    MTIYXJHDU      
YXGMCSWAXVC     : WRMI            LOFBTFAKDIUSLES FCAAIRMD        HHXETPUFJHUMJ  
ICPPUKYPGJNYKSU : VEMEJUMRIRVWVR  KAYTKBMJQRFCEGR LSOXDFNGINX     QILIEDXIYW      DGBTXJWJQ       QFYCBKCAIH     
KRBLQHBUAXUXTWD : JXJNYBQWFGSP    HCGHKGS         FYQAVFYIWI      EBRGPUWV        PGHBKPUSR      
AUWWHXMNHDMRXJ  : FXTHPOKAXWTEFK  TIJEHCTDBG      IOYYWEIOAJAQWRJ
JEGWWNXRNXO     : FLQVW           LKBDJNBXTOQXJVJ
SLTY            : GDKPIXYPCELT    WUDPGBVVBADQMLV AHNHIMQNYOSDKI  FUXXPNMDRON    
OVKVTXMBDBVBNBM : NVUUXNHL        YWADBJQRJMTY    DEFXGTLBSBJ     DMBLAXV         WXHDJOCGIIJC   
KKQXIK          : QDGB            XHOBCKTMOPX     QMMEBDBO       
JYFCKYBYPALN    : UPHRYNDA        MSEERN          CKEPT          
LAAO            : CBDP            KFJSDX          WWGTJWW         JMFILKGHDFY     GTNEMKDRPAO    
VQRYDJJPCKBOBK  : BHWN            SBTDUXGSRJEEDHP VYGFPPYJUC      VFMQQRGRBASRQ   CCRGDNYMYN      MKCBFE          QCMMKDAXBR     
GOAFPBWRNKOYL   : UULJYOMBBEQQBRM JRJH            IGWEMGMPGVL    
OPMFHN          : OMJFXWNMTVM     PAKNCEJWPAJO    KGOOKGSAKGBPQKP ICSGEAPTAXIU    OGBUSTCXLLXBVT 
SADWME          : PMPJNGOUG       WAELAKFPU       KHNAMQUWBHFPYF 
NOBVDBBUD       : NBKBLUCAGAFP    OWVG            TMPVQYH         UEVWYILQGIXRM   RBXI            FXXEPE         
PQKGRXUG        : MOQYEXRI        EARIH           QDJAIBD         IRGIWWR         OYOYQP         
JNYYB           : VRTWQKI         EPXFXDHMMSGKO   SUMMRWDLY       VATHJSXNENFTKGO BUIVD          
YEQNIEBYF       : FHIHHQJ         EIVV            IOWISNLCPWFSFGE SDUFLPB         GFLXGCDWCQHA   
EHAYMCQFNWWNTEE : MWCKSUQYDOTKE   JOMFTSYCLKKEIV  VKMOIVGTTI      MVYFQEJAFUKEC  
TDFUXGBQ        : TRNESYYQGCYJQP  GTKRKILKPGWLRT 
LVXKDXQKXSYD    : XJTNDG          QEGFTXVSYA      BRRJFQLFUPIKUR 
EQHC            : KBUBQYVQHBSHD   UHLMKMOX        QSFOUDJENDGNKD  WBTNQFHQQO      FUWLGPRD       
BIKHEQMAOSD     : UPSEVJXPE       UGAUEPKSVEJ     SHBS           
PPFOCJMVTM      : SGRSLJHNCGFRLBL OSXECMMMTEB     PYUTHNHUU      
VPXAI           : HTWRTWQMTT      VKFRRICW        QFFKMFVMMDE     HYPOHOWMG      
CPJMASRQ        : VGJXDQY         IBUCHUMCXTSF    FXMQG           DICPXVRUHKNTP   LJVOCLP        
THAYRQOWHTGTP   : FAUNOWO         RGVQX           VPKH           
GEYYE           : DUFMOAEJHSUC    OWJYAUVPKFL    
HMEWXSXQ        : JOWRINMMWUFDDRB YNNJSMCPJGTKBP  PFMQQGIDICGXD   YNJMJXSBJQAA    GHHQOJBSB       YDUMUKOVWQLNMDL
QXGBX           : AEXJ            SKCBPORJRNNSS   BYDMBBYATUCJF   FPNVWVJUOFYH    IMRR           
SQWPXSWR        : MPFPCE          CKCDOTUOLPXDON  WESKOYBYBNBFTMC PBYQLRDPIIQJRD  QRQAWGRMWYWD    NGSIUUXLU      
CBOBAVCJIIHG    : PAKNCEJWPAJO    XEQYXOTIXJLYVLC NUSBTB          VCSOFHPWTMVVHBE
HYOAWVBWETOB    : KOAWCCRYMHTTO   TBTBFB          HTDA            GHHQOJBSB       MATO            DMOJUWXHWGHFP  
MWJHFLKW        : FXTHPOKAXWTEFK  HTCVEJ          CYLHOSOOMQMRPW 
MSQVDAFLEM      : QOATQGTKVGSTYDS VAXTKQLN       
SNJQOGUL        : MCWSFBYIDKXECS  RGVQX           MDBSR           FODFTATOKJ     
YVKVHTDUGCJ     : TKXCSX          QYURU          
WCOACUNGJACWL   : VGOI            LVOXFQU        
OSQAPRXCPHXSCE  : NVUUXNHL        LNCWPXSBPG      PROWB           RJVTKK          QTDLYQEWNHTEK   HHXETPUFJHUMJ   MFIUQYIPTGHC   
LWUNO           : APXODERFYJS     XANMVL         
SJLBSODSAYJURJL : SGHYTHGCBJR     TXSVFCLPRC      RSUUP           SSUOBJHH       
JPYQOTUSRISNVHL : KBCQDDILOXT     CBDP            FFRTTWNOX       OQYKBNRSRR      IXDNTAOU       
QYULPXGQYP      : OGXSJUJOS       BLUHMIMN        SSWVLXSME       UIBMSIFMUBY     FYRERVSRPASK    TIMAUWF        
QBYAMPBF        : JAQMHU         
VAYNIRDHYOXR    : BMOHEYURQAOKPLV LSOXDFNGINX     HPDWLO          WHGNF           YCMW           
UGGVO           : HCLVJHKVLPI     CQYDODXL        BARQBAMO        VTQIJWBKHDAFX   MTDONHBKCJI     BGFGJCJMNIAT   
UHLMKMOX        : EQHC            HFAPWYMJ        VMWXSX          GESUIEEFR      
SDKOGMEOGIVGYWA : PNNOBFDBREALQVR RTUETX          BGJOWAUKOPWU    NSMDUVGEJAJ    
RIWNXVLHJ       : HLTYMOCCWLQW    EDSQ            UDUIIXKIIJ      DCDUV           HTXGPFV         RIGMAFGDHV     
RYORDHVQXCDD    : FOHINY          LTGVQMSOTMT     GRYJHNCXYDG     EEIGMIT         JJJRJU          WSBPCOQHGYKPGE  BQLBUCISJD      OFIEAJA        
RYORDHVQXCDD    : ONYMTTHGAQBI    JYUQ           
JNPR            : FXMQG           WBVPHIVNLJRGIN  KLHYPQY        
OUDGDCWDXIKK    : HJTWV           TUVLGHI         XGRBIKTQYQVKVJN FCIJJA          YXGBENEWAF      UAEJEBG        
FJWWO           : SGYCRNTPAHJP    PXULIIGLLRJMV   NYXDHSAMLXFYG  
UFHWKMQWAIQ     : POAHVPFX        WWMFIQGL       
WLQFRSC         : NSBDT           IBNROIJRW       SKCBPORJRNNSS   BICJXLFYR       WQTC            PCVVHOQICWEWJ   SYOQMIRNQL     
SKKDSP          : HJTWV           MBXTRBABUS      FPRXOEPEEDR     IXDNTAOU       
SMECIJJHWW      : LFXEWANBSSUUJXB ADBBNFIKO       RFSOOLNWW      
TWKKMHYF        : WRDMQNOP        NSMLIBX         GQCQPGOG        SSWVLXSME      
QARPTDAYX       : QNVCGIEBPOL     TSNB            DYNJBLRLOICJODH
OSFSUPEF        : MWCKSUQYDOTKE   CRANBOUSLFK     DXFYKKALB      
BEAUDKIS        : GDKPIXYPCELT    BSDBH           XLEKTUHCJJX     ULKCTB         
HXKA            : BFFWYMYPXYEKJ   YRREXGDEUAIJF   CKOPSIXKME      ICDGFU          DEUDSJPHE      
CPUHQTIIKBNDWD  : MOQYEXRI        MDBSR           AUMGGGHPNDRDAC 
EDLKFJPPTIM     : CLCNMOKX        DICPXVRUHKNTP   FYQAVFYIWI     
HWDICUDL        : WRFNNKMOEY      DUAPHGISA      
YTWMXMRWSCBXQ   : FFIIGKF         SAEGHBEHP       BLUHMIMN        EHLTXMNLYQQGKK 
DCDUV           : RIWNXVLHJ       WESKOYBYBNBFTMC LBPOO           UUOMGOMHEKJI    OTYKSYHA       
IYVHEELYJXPKTMW : PPMFQJLKJIPY    OIBKPOK         ILXX            CVTB           
BPQVTRTKHYOLUKA : DVKWWHMVEMD     VJSFGNEUESGX   
LVOPCBRNBH      : WIMKRHO        
WVXRW           : CGYAKDLSLFDWE   DMBLAXV         QRGVT           DICDJ          
ITLDPWKPNXMYX   : CJLLFWBQD       GDJS            VMWXSX          WNSERQQVB       SSTKX          
KVGDXJW         : FNSI            QIGHTRSCTUAKY  
KGOI            : WQSKS           KHSB            FUKTPLQWQLGM   
MABEK           : TPPYRXSWWFVNDAK NBHOCEJEYPKVU   FQHHYIFQPPKI   
PNNOBFDBREALQVR : SDKOGMEOGIVGYWA FFDBOURMYG      CQGHFVVFSUBUAA  QGNESOFQQOALDIB QKFTLKDLUBCRRA 
WESKOYBYBNBFTMC : KYTPTRODAM      SQWPXSWR        DCDUV           EHLTXMNLYQQGKK 
CRBFWG          : NHMVKNOVWXQ     VGBY            SAEGHBEHP       ICDGFU          IAQDVBCNREGRI  
QKJCEHWAEBTRRU  : PRPYFXRRDFMJP   TBTBFB          UDUIIXKIIJ      YVRLS           HCNW           
RYJSEDHI        : GWCOUN          JXJNYBQWFGSP    NMQQKYG         UNAK            QVGADARRASWUIF  EFJCQSTR        MAGMYKIQ        VTQIJWBKHDAFX  
RYJSEDHI        : XAGL           
MBTRACBRNKVRSS  : PLTMQRROMBYH    DGKSBBJUVTNYTL  XLMK           
YVNSOLOIKXD     : IQBQR           XVIYLG          KYTHFPNUREOJE   UVSHYCMPDYH     FYRERVSRPASK   
DLWVAXRTBTVSJI  : UMGWMQRHHX      LRBJHTCNWIRK    DQXOFCM         PYHD           
DBKXDGNVWYKFJK  : NVUUXNHL        JRJH            MTIYXJHDU      
XOWXM           : VGJXDQY         MCWSFBYIDKXECS  TBTBFB          PFORCS          ICDGFU          XOFBLBVQCI     
XEQYXOTIXJLYVLC : CBOBAVCJIIHG    IMXG            OCIAI          
ABCY            : WISNRHLWMQABNU  RRTX           
HJYSJNP         : KBPP            YFEC            VLVLXACUCR      QYURU          
AOIGG           : TITPLQPEIAR     FYQY            RTUETX          SSNVXVBHRXFMJU 
GWCOUN          : UQSWE           KYMHBQNBKHX     RYJSEDHI        DNRCA           AGWMYGRECYAMSPX URCNWVARIU      XLEKTUHCJJX     RGBLFQODSB     
GWCOUN          : UQMIRJKWSDAB   
UJQYNQCR        : OKBAUHWAKWUJ    YRREXGDEUAIJF   JXPTNOFLVARMFE  MNUWJMSAGG      QQDQBK          FUKTPLQWQLGM   
QCEPUNFNXHEI    : JPWHPTFWYQLBYT 
MPTKTLFJQCUH    : PAKNCEJWPAJO    IMCK            MXXYDQRTH       GKNHRX          MATO            PIHFLDUPIX      FCAAIRMD       
LBGDTYHXOD      : MEQLFSSLIGUVRAM JVYLNSOHMNTTMLT
TSNB            : SSTCL           MVYACYFAIR      BOIYKAXWMYYL    QARPTDAYX       YQLWDSMVITJIDX 
VQMOLWKY        : UPIKRT          DWGSMDMSRVW     XCORNFW        
UPHRYNDA        : NAETXNONSWTPUNP JYFCKYBYPALN    ADWB            WINSECOQO      
JVVQVMVKHQAKQW  : UULNV           HCLVJHKVLPI     JBKIILRVIA      AXHI           
DNRCA           : GWCOUN          IPQNNVMEOJUYQ   OQNSSWVKNONYCS  BGFGJCJMNIAT   
GWIPPJDUK       : AMHUNLJCSEUE   
EIVV            : TASUIKQTWF      YRLEYIELJVMID   YEQNIEBYF       KYTHFPNUREOJE  
ITPRLRFCQL      : XANMVL         
EDJFVRCEITPLP   : DKDDWEXYWWWO    THIPVHBRDGGO    TQLYVAFJPCGB    ONYMTTHGAQBI    PDYSNSKQOLJP   
LTJJRQ          : TPPYRXSWWFVNDAK XJBNAWAATHEY    UUOMGOMHEKJI    EFBPMAGTSWJ     AGSCMPPEFLG    
MGMA            : LFERSYOPNIV     SGHYTHGCBJR     MYOPRKRN        VPYOOUFHCMDRRUX EHJPFTE         WYFN            JBHRC           MYATGYNSAJJUV  
TEPFLVIWDEO     : EHVCXOIVOOLSP  
KWCDJRDWOOH     : KJONGTL         INHBRQMB        KEXP            NSQUE          
FAUNOWO         : LFAHLGHXK       THAYRQOWHTGTP   PPQFMQRHEY      CTBBLWKENVHOT  
BGOOEALIG       : SVNICRPA        MOUHM           VPYOOUFHCMDRRUX TLAKI          
QTAS            : PMEXKDJWLHHCE   KUGH           
LNAJCRQ         : IMRR            AXHI           
YSIPJFESJMIXQ   : MFCBRFKOIJPARE  JLVUENKDFN      FEBLETXSDA      LHQW            HOMYHNWHXIJC    KHLMRV         
MYOPRKRN        : MGMA            HANA            UCUWIQQLHWKVMK 
GBKPFCIPD       : WVTXQTQNQYJ     OCRCDMQ         LYEABQSABOMGSN  HOCLKSCBFJXH    LYSBYNN        
ASMIYGRLQRDBEE  : SGRSLJHNCGFRLBL HQXQ            KCSVBDHFKAI     CXCEGIWXAJGDFDT SDAEJQU        
VWDQKKWLWOQY    : FPNVWVJUOFYH    BYXYUHYNQE      IIBT            BPPT            AXHI            OULT           
IFELXQ          : CXENVHCYXACGE   BFFWYMYPXYEKJ  
XYLJRDOUKTNIQ   : FVRUHXRBV       ANCDRGDONVQHMH  WBKNSYVTNKRVJK 
YBFXODOHEN      : YGHRLWIOKB      EPJJI           REMJROLRPGAO   
JTDI            : SXLN            LMFKQU          HVRYP           DDFTVJVKOYUC   
WIMKRHO         : LVOPCBRNBH      RAIJBKFUBX      NBHOCEJEYPKVU   AGSCMPPEFLG     SSWVLXSME      
CBDP            : HYAVIJYILXRGVM  LAAO            JPYQOTUSRISNVHL LQQIKIDWBILN    QETPENLACKOI    ICKIMYR         FXXEPE         
VKLWQLNT        : NSBDT           SGHYTHGCBJR     YCLQMRTIUINXAFU TIQFCELSDU      ABPPYKK         PYUTHNHUU      
WXQQ            : HPDWLO          YAOFDLPAJR      BJAWNYD         KUIDKGKO       
NUSBTB          : MAXDMYF         CMQUXGM         CBOBAVCJIIHG   
FUWTGAWJRIFDT   : HPANSJR         LDPXIHJQ        GVVJGGGYHWURU  
TITPLQPEIAR     : VQICTLO         AOIGG           GCEGIL          FOLIOBJ        
SSYVJETG        : FTSFPVQGPOL     FYQY            IFKQEWGKB       NNERKMMVUGKJXB 
AGWMYGRECYAMSPX : GWCOUN          MOEHEJOFRS      ICDJSXXKMDUEQ  
FFWIWE          : RLMDJUBWYOIOYXG QTXLQVEVL       WOBKSUNTVFUB   
SDACKVIMXRKKS   : RGVQX           GPXV           
FWWGWMBOKPV     : SXTYGBOLMWR     VYGFPPYJUC      AOAFAEWDXHBIUU  IAQDVBCNREGRI   RNMEVBEQDW     
OEPSIIYKMJG     : UENPMAY         XIFQDBXMIYX    
VGOI            : WCOACUNGJACWL   SDJSQPVP        BYHFCPNVUBEQ   
HDBGB           : MSEERN          SJYEPWULIL      KPOSVOATLTQUBS  PIHSPMXADUNIFYX XCTUCUPYXSGWTBH
FPKTABQUPU      : GWXRHHCAIURF    NBHOCEJEYPKVU   YYVTMXKWOAVSC   EBDEDAMDP      
JDUI            : KCSVBDHFKAI     PMRYTIDY        NHMVKNOVWXQ     TBQSMPMF        WJRJPFBYDO     
HTXGPFV         : RIWNXVLHJ       NGDYSPLUYYOIS   JCEYQUSXTNNK    KEXKVXRVSOWM    UQMIRJKWSDAB    SCKLBBVJV      
YFEC            : HJYSJNP         LLAEHPYEDORCF   FXMXOGXQKO     
HJTWV           : MPFPCE          GIXP            OUDGDCWDXIKK    SKKDSP         
AWHUPC          : YQDDMIUWBPURMG  SXLN            MMPIMU          QXJMXWO         HSSINBGSOPFOPU 
BICJXLFYR       : VEGKYUDNRCKHOUO PBEHCMGTEJ      KPMTTWCTBHJLCX  WLQFRSC         XQVPFYNMSJBWMKO
EPXFXDHMMSGKO   : JNYYB           KDVROXEYCAA     DOHQC           GEGWJKJJAS      WKRJU          
MOEHEJOFRS      : SGRSLJHNCGFRLBL AGWMYGRECYAMSPX DBJUTF          YJFF           
RGVQX           : TASUIKQTWF      THAYRQOWHTGTP   SNJQOGUL        SDACKVIMXRKKS   WLXHARIHIXML    BFPHHRV        
WQTC            : WLQFRSC         EAJGUQSJOJJUUP  CCRGDNYMYN      YVRLS           DQXOFCM        
YLDLELXV        : LHSPNXYDIKIMM   SYOQMIRNQL      GOGJYRNFP       KUIDKGKO       
KKNTOYKT        : MDBSR           XSUOY           JYYGKCLNSMXGEU 
DMLL            : QEIGTHMDBAALPNP KYVXHEPJI      
EKDEDWITVUW     : WSRITFGFC       KDTUMWPI        GICBHU          JFRBXXGJGYLF   
BIIW            : BFFYQAFPQ       LQIYLB          TQYXNWRSWY      VJSFGNEUESGX   
THIPVHBRDGGO    : EDJFVRCEITPLP   YRBRWL          ONMUOJCYQNUFVT  BYXYUHYNQE      KTPFPGC         ABPPYKK        
OUFU            : YJTI            NACGMLGF        AVBBQLVACQ      XGCPRNFLVPBGNW 
IRKCQFBBGLJG    : RDQDJWYLFMXYKJ  JCVYLYBTJT     
DNOVMX          : EJVYTAGJ        NASCVTJJFJ      LRBJHTCNWIRK   
GBDNRV          : LURCL           SGTGWQGUHOQ     RNMEVBEQDW      NFWUMLXRTNNSSEY JKOCMTAJMPXIC  
PBYQLRDPIIQJRD  : SQWPXSWR        JXPTNOFLVARMFE 
XJBNAWAATHEY    : XYNHN           LTJJRQ          LQQIKIDWBILN    JHAPX          
XVYPYB          : FFDBOURMYG      JVWPXG          YCMW           
LSKBDVUOPALNJMB : RXBCSDCWUKN     KPOSVOATLTQUBS  JCVYLYBTJT      VYVYODKGYQ      LXMNELKWUQLSMD 
JELFLR          : SBDIWNJJBACY    SUMMRWDLY       QYQBN          
IQDJGCKPPFDRKBO : QRCGCQDRBQDECBM RVTT            DTQN            NLFTVAMUK      
QONGAAJLM       : GOPFMMTUKEJNGVJ SVLLGE         
YRBRWL          : HPANSJR         LJJPVGPMRT      THIPVHBRDGGO    PKWQALRBPLRQDG  XIMTHOFP        JVWPXG          VKMOIVGTTI     
CVQF            : CYJYSITSRRHLL   RBXVNHIHYLWVYW  UGAUEPKSVEJ    
JUQMOBNDFGTS    : KLSWRSTEEAMERBD JYBU           
TUVFHMFCNYBCJE  : HLTYMOCCWLQW    EUACNPND        MFIUQYIPTGHC   
CLILGYAX        : LJBXHTBJXIABS   FXXEPE         
PDIXXDKTXJAIX   : TEIQEPA         DGTNSBUPWUX    
MNIN            : PMRYTIDY        DICPXVRUHKNTP   DGKSBBJUVTNYTL  KARHDVAQEGLRUAN
RRPVDYKMXKMDD   : OXEPGEKUYQJ     LPJGXUS         PMNCLCPVHURBVE 
LBPOO           : DCDUV           INHBRQMB        WKIHPNUIVPJWUK  FMMCLAJ         XNYS           
PAMAXTMLCACVUTR : GEKDNWW         ENOD            MXXYDQRTH      
SCOT            : UIUPNPVFEUBBXU  EBDEDAMDP      
BWURLVJCM       : JTRULSXAGYG     QVNDIBA         SSNVXVBHRXFMJU  NSXRBMBH       
RMGRKCEYGHDCEWW : CXOWETNIYD      EARIH          
SYTOQW          : HDRMINIJHTP     BOYJMOUJLIPUJA  CVTB           
LQYK            : IAFLTCXJDLHH    SVLLGE          BWSNGBRGLM     
CYUTMEOYG       : OAARGFBFEYMMQ   KDTUMWPI        WBVPHIVNLJRGIN 
ANCDRGDONVQHMH  : WPTBJUSRS       XYLJRDOUKTNIQ   APXODERFYJS     ROXM            ROBGVLNXW       CTBBLWKENVHOT  
AVXAIYEHVAV     : YJTI            NBKBLUCAGAFP    YENM            FFDBOURMYG      FYQHEGUIMMJXHC 
QXJMXWO         : NVUUXNHL        KHSB            AWHUPC          VXCF           
OXHGL           : XJTNDG          USIXSYFVAPU     JXJNYBQWFGSP    RAIJBKFUBX      BRGKLTNXUO     
WURGBTEY        : KJONGTL         WLURLXQ         SJYEPWULIL      KHKUBECKPNNKB   DWGSMDMSRVW     QIGHTRSCTUAKY  
OAAWWDUWTSGGTFX : FFDBOURMYG      GSYRVI          ICYVOCJ        
WXHDJOCGIIJC    : OVKVTXMBDBVBNBM
LYELBDIGYIBT    : YNNJSMCPJGTKBP  BRRJFQLFUPIKUR  USIXSYFVAPU     RXBCSDCWUKN     MLPY            RXHXYPUJB       IHMXQMBCMFWMJK 
JPWHPTFWYQLBYT  : QCEPUNFNXHEI    VFMQQRGRBASRQ   ONDON           VKUIIFHWHD      UUJLCDN         RBXVNHIHYLWVYW 
JYBU            : JUQMOBNDFGTS    GYFFDFTG        KUGH           
IIBLTI          : LMEXA           TOOOOCDMJEUOI  
CLHS            : UVIAJISTWDACCJ  GESUIEEFR       JDCBV           WJMILXVGMVMQT   VMWQIPYK       
WRFNNKMOEY      : HWDICUDL        ADWB            MRCEDHWYUHHRF   FXMQG           KEXP            FXVPHD         
DUEMVHJV        : HYAVIJYILXRGVM  WIGPVOOJNV      IGWEMGMPGVL     LYSBYNN         UIOSDRTN       
SXCMI           : AHWWXOM         UPIKRT          QIQS            BKBA           
QTXLQVEVL       : PPMFQJLKJIPY    NWCVOPBMVAOJD   FFWIWE          YWIQ            LVOXFQU        
JXJNYBQWFGSP    : KRBLQHBUAXUXTWD RYJSEDHI        OXHGL           WKIHPNUIVPJWUK  PSXCSBWK        KEASHAGYKNUXY   NGSIUUXLU      
PHKP            : GACNYWF         XJDP            YGHRLWIOKB     
YABPVYCMW       : PPTBWUIHMCSPH   MEQLFSSLIGUVRAM HCYXQJKBQWVD    OQNSSWVKNONYCS 
LIAUJLIKNBHUJDK : UEFEMMUORMUW    XQVLENVY        YVRLS           RFSOOLNWW       MNDTGVIGH       LEKS           
UUOMGOMHEKJI    : BFFYQAFPQ       DCDUV           LTJJRQ          GDFATQJFGFGV   
GQIR            : OKBAUHWAKWUJ    NGQWMPOY        JKWPCEPSMBJSWK 
DDFNNSRXOBBBF   : NAKH           
VUIDJWMP        : BGJOWAUKOPWU    VAXTKQLN       
VYGFPPYJUC      : HBQJXMMKWERQME  VQRYDJJPCKBOBK  FWWGWMBOKPV     HGSPFHCV       
LRKFPYGSB       : RWUEYBFALINH    TKXCSX          WAELAKFPU       FCAAIRMD        BHIK           
OWJYAUVPKFL     : GEYYE           IJWVGQTML       CWIJSBVUTTKYRQA VTQIJWBKHDAFX  
MSEERN          : UYDYXSXQLKJDFS  JYFCKYBYPALN    HDBGB           TBSTSOKD        PSXCSBWK       
VFMQQRGRBASRQ   : VQRYDJJPCKBOBK  JPWHPTFWYQLBYT  RXHXYPUJB      
BQUXOKKWYWJR    : VGNHPEMVJEIM    BASE            BARQBAMO        VIUSTYRVQKU     WKRNLSKPBBPMCGJ CVTB           
NMQQKYG         : RYJSEDHI        RBXVNHIHYLWVYW  LLQXL          
RAIJBKFUBX      : WIMKRHO         OXHGL           CQYDODXL        GBIENDJTT       ATFYSMJBFML     WKQRPWHCTVSIW   ICYVOCJ        
TUVLGHI         : OUDGDCWDXIKK    XLHLCJKCTX      BGJOWAUKOPWU    RXHXYPUJB       PSXCSBWK        QBYGHQ         
GRYJHNCXYDG     : JTRULSXAGYG     RYORDHVQXCDD    ONDON           CPAUYEQHYXMHJG 
UHKHKU          : LYENSWWN        BJBRGDKQRD      ADWB            SDJXLED         VIBJMUX         VMWQIPYK       
GWMESJBE        : MVYACYFAIR      NBECVKCOJIWCAWK TXAQLIUKY       FGSNMLTA       
KMYS            : YDBLXWRX        MPMAVMJUL       SSTCL          
YENM            : WPEDFDVNWY      AVXAIYEHVAV     RPRM            FXMXOGXQKO      RWOXMLNDHS      PSDAW          
ONMUOJCYQNUFVT  : MDVORKCYXJCHU   THIPVHBRDGGO    TJWBKM          ITCWHU          UIUPNPVFEUBBXU  WNAQY          
AMEDRVPGXINWM   : JHBHHPQJBFAGVBT WUBCCCVCJLUFVFU SRLSDO          FOLIOBJ        
LVTCIRQR        : GOPFMMTUKEJNGVJ QCNC            RXBCSDCWUKN     BDMPFP          KXYSXKHWVUGHFK 
RLLOSHINKXTN    : AEXJ            PIAWVRLKXO      QDWSSTCB        EGMU           
REXPOLOERDCLFM  : TGIPADNVQNQ     XYHIFQ         
XGCPRNFLVPBGNW  : GUIQHNVCPMH     OUFU            UWDRBWPSDYGXBV 
FOCEHR          : WVDMFGWAJFEUQFA QMOBM          
XXJB            : JNRNLE          OPWG            CWIJSBVUTTKYRQA
XIODIUFYNTGBRXE : PCVVHOQICWEWJ   YCLQMRTIUINXAFU
MBXTRBABUS      : TGSXDXFE        WUBCCCVCJLUFVFU SKKDSP          KSKUDIAESWBA   
UEDWEOLI        : QFIBOBKRVWCJHM  RTUETX          UTCYJBGEJMILFBY FLQVW          
GPXV            : OSCECXFOYRU     AUPVJK          SDACKVIMXRKKS   QPPNO           EBDEDAMDP      
GYFFDFTG        : TPPYRXSWWFVNDAK EJVYTAGJ        JYBU            ULTBVW          HFSVGSRMDJ      KEBMENWENXE    
NBHOCEJEYPKVU   : JLCJWPJTXJB     PPMFQJLKJIPY    RWHLTEHWXU      MABEK           WIMKRHO         FPKTABQUPU      AOAFAEWDXHBIUU 
HFAPWYMJ        : UHLMKMOX        GVVJGGGYHWURU   BGKOGGU         JMQXDL          LWIJFFHL       
LOMRW           : AQXITPBEUTRDQH  JNUWKBJPX       AEGNNATX        METMWQ          WFBCMWHR        TOOOOCDMJEUOI  
ADWB            : UPHRYNDA        WRFNNKMOEY      UHKHKU          FYPHPQMUMCKVU   UIBMSIFMUBY    
NGQWMPOY        : VMUM            GQIR            OGBUSTCXLLXBVT  QFYCBKCAIH     
LAUSBKQAYAJL    : SXTYGBOLMWR     BYXYUHYNQE      NYXDHSAMLXFYG  
WFNFHSC         : SBDIWNJJBACY    HPANSJR         VVCQVSH         AJQXMA          DTLRNTA         CQWPCVFBXH      YHMJYPQVYFRBGU 
FPRXOEPEEDR     : SKKDSP          KSKUDIAESWBA    YSGESITHF       MVYFQEJAFUKEC  
XLHLCJKCTX      : TUVLGHI         EARIH           UFHQSBMRQJXLQF  CPCAS           ICYVOCJ        
SDJXLED         : YNNJSMCPJGTKBP  UHKHKU          KUGH           
KUQKKWBQDE      : XQVLENVY        RIRKG          
KDVROXEYCAA     : RWHYERINL       UAFOT           EPXFXDHMMSGKO   DWGSMDMSRVW     WOKKUPXIMAAIVP  SCKLBBVJV      
SDJSQPVP        : RTTX            VGOI            UCUWIQQLHWKVMK 
RGNEE           : VMWXSX          VOEHLSCMDA     
WHSHRXEMOESQJS  : UEFEMMUORMUW    JNRNLE          KYTPTRODAM     
JLVUENKDFN      : YNJQJD          YSIPJFESJMIXQ   JFNMHMPM       
MDBSR           : GXMENACEUY      OCGI            QCNC            SNJQOGUL        CPUHQTIIKBNDWD  KKNTOYKT        QDWSSTCB        WXXVEABGTTHOQEW
MDBSR           : OKEWIMHRVAMPGXF
AMHUNLJCSEUE    : GWIPPJDUK       UVDKSBLPHDF     TOOOOCDMJEUOI  
LPKIKOXWTFM     : TRNESYYQGCYJQP  UEVWYILQGIXRM  
RPRM            : YENM            MXAD            IIBT            ALVJHOWSXSEE   
PNWXKKLVOGAKKW  : KJSAGJPRMNMCGG  JHBHHPQJBFAGVBT LQIYLB          XOFBLBVQCI      OULT           
CHGMXGMSMYJG    : WUDPGBVVBADQMLV NAETXNONSWTPUNP OXDNLMECQSJSOUE KLLVYXUEMQFD    DVMCAHP         SRLSDO         
ETYTJVT         : EUFTG           LAANSB          KLLYPW         
IIRXQ           : UQSWE           UQDJLHVY        KFVRG          
ICSGEAPTAXIU    : NOXANWKJBLXKV   OPMFHN          PWTTMKBEUIPHHH 
HHTYLPYHBWEWG   : QPGKNHNIMRHHC   TJJRFCNH        WGJRAYLA        PSXCSBWK       
QEDKOHDUOF      : EYDVCUSO        ICOLWXBHGPNJM  
KFJSDX          : YMKTN           WGITBN          UAFOT           WAELAKFPU       LAAO            SSTKX           VPKH           
KRAXJBFKXJ      : BVRPQTUST       KJSAGJPRMNMCGG 
EXXKCKYLNWASHM  : MNMV            QRCGCQDRBQDECBM YMKB            IYETWH         
SFGRGQLIQVJVGJI : GXSOTGMDYGC     RKVLKEUED       JFGGJXNTNSPJE   VPKH           
QGQBKCDYPAY     : LMEXA           FMLKYRJSBHHGK   DXFYKKALB      
JOMFTSYCLKKEIV  : OTHC            EHAYMCQFNWWNTEE FLQVW           KYGWEYTCIVQIN  
RIKKYRBCEDFDT   : CGYAKDLSLFDWE   PDIMPKMMQ      
FFRTTWNOX       : JPYQOTUSRISNVHL EEIGMIT         SDUFLPB        
CIDGTCGNK       : FJOHKNCUCYQS    WERDJ          
XLLYNP          : JLACNJNABCWUB   KYMHBQNBKHX     BDMPFP          FUXXPNMDRON    
VVYDBEUUATK     : XBRGTNF        
RDQDJWYLFMXYKJ  : AHCPIYECV       IRKCQFBBGLJG    LCRTPOMCYCJA    PMEXKDJWLHHCE   WHRODS         
JYFOUBNYCTVYVQ  : XVTTUBJRVAOQ    JRJH           
KKPDNYCMMK      : NVUUXNHL        DOHQC           OQYKBNRSRR      KYVXHEPJI       HWGXYLLG        XBRGTNF        
KLLVYXUEMQFD    : YJKQSXGNVM      YTPKGVRK        CHGMXGMSMYJG    MRCEDHWYUHHRF   AVOE           
JYNIVGTG        : VRTWQKI         KBEVUAVLSG      LWCADLLR        KXYSXKHWVUGHFK 
LMFKQU          : TGSXDXFE        WLURLXQ         JTDI            RVFHM           NGDYSPLUYYOIS   RVBLNLO        
BTJPI           : LTVHKTJGXTLK    WKABMGYPEDRTFT  BYHFCPNVUBEQ   
OGBUSTCXLLXBVT  : LGFEBSTPC       OPMFHN          NGQWMPOY        TBEFUTBRLFIGQFG IIEBUONOTIA     OOHRRUS         WJRJPFBYDO     
RCAEQH          : QCHWLFMPSO      NRXOQGADYTO     CHECANC        
ICOLWXBHGPNJM   : KTEOXFDWCGYEQK  QEDKOHDUOF      BDMPFP          PWTTMKBEUIPHHH 
DOHQC           : JUTEAXSNCESJ    HJYAILGMXXHVGV  VVYV            EPXFXDHMMSGKO   KKPDNYCMMK      JYUQ           
RXBCSDCWUKN     : DRXPHXCXW       LSKBDVUOPALNJMB LYELBDIGYIBT    LVTCIRQR        TPSHFTN         PXULIIGLLRJMV   TIMAUWF        
MEQLFSSLIGUVRAM : QJIBXFYBBFFR    SROQHTCTVAKIRHR LBGDTYHXOD      YABPVYCMW       EHJPFTE        
QPGKNHNIMRHHC   : HHTYLPYHBWEWG   DIBOOBICLLGN    YAOFDLPAJR      XQIWRID        
MRCEDHWYUHHRF   : GIXP            WRFNNKMOEY      KLLVYXUEMQFD    WAIXLXUPENFTFP  GARA            VWJNU          
RSXKKGXAPLJDDQM : DEFXGTLBSBJ     RIRKG           WWMFIQGL        BVSPJNFKHPMBOEJ
OAARGFBFEYMMQ   : VGJXDQY         IQBQR           CYUTMEOYG       AVAHMFGWRYVGFJV TLAKI          
NLPOXAUVALJJ    : PMPJNGOUG       TKXCSX          QYUDMAKNRJMS    VTQIJWBKHDAFX   DUAPHGISA       JVYLNSOHMNTTMLT
PBDXPDAJLH      : TBSTSOKD        WFAXVBQXJQD    
QMMEBDBO        : KGOOKGSAKGBPQKP KKQXIK          BQLBUCISJD      NRBXITMQQBDLCF 
QFPQ            : JLCJWPJTXJB     UPNX           
LSOXDFNGINX     : YMKTN           ICPPUKYPGJNYKSU VAYNIRDHYOXR    YAAOQ           BNYQA          
PIAWVRLKXO      : BHWN            RLLOSHINKXTN    WOKSYBWQFNMRPMF HYPOHOWMG       ONYMTTHGAQBI   
YGHRLWIOKB      : OHGPVQGRDNH     YBFXODOHEN      PHKP            TQLYVAFJPCGB    NAXNIGHXD       FUKTPLQWQLGM   
KGKXMVNNMDVODT  : UAFOT           PGXSQDFHHC      LVOXFQU         TXPIRLMWITGQ    QBYGHQ         
QEIGTHMDBAALPNP : XHOBCKTMOPX     DMLL            JRKWRXTDH       OYLMHIIEGVLEYA 
XVIYLG          : GQVX            YVNSOLOIKXD    
YUSW            : KGOOKGSAKGBPQKP WKABMGYPEDRTFT  VKMOIVGTTI     
XSUOY           : KKNTOYKT        LHXXBFUNHABK   
UULJYOMBBEQQBRM : GOAFPBWRNKOYL   XRCVIQHVNT      DIQWCAFSAIIX    GXGIHJSR       
QARFBMAX        : VBNREAI         VOEHLSCMDA      QDJAIBD         RGBLFQODSB     
XSTNRW          : AHCPIYECV       EKVL           
PKWQALRBPLRQDG  : YRBRWL          KHKUBECKPNNKB   SSWVLXSME      
TJWBKM          : JLCJWPJTXJB     EMNCLDERRATNUPM MPFPCE          ONMUOJCYQNUFVT  IOWISNLCPWFSFGE OCIAI           LCKQVKVVGKR    
LLAEHPYEDORCF   : POAEJLXY        XVRVMJBAYSNO    YFEC            UWDRBWPSDYGXBV 
PYUFKOXPWD      : RWKRLKWL        AYBWWMSLRT     
GBNRPPDBRHIK    : IIIEIHUPSDFIV   OHGPVQGRDNH     HYPOHOWMG       LLEIJ          
OPWG            : XXJB            WISNRHLWMQABNU  DICDJ           YFCTGO          EJPEEBANBKMC   
EAJGUQSJOJJUUP  : WQTC            TJJRFCNH        JCWKIUOJQTTPK  
KHNAMQUWBHFPYF  : SADWME          METMWQ          YGJR           
SJYEPWULIL      : LJJPVGPMRT      BEBCLPYRSHA     HDBGB           WURGBTEY        LWQOABCCVEXQ    HTCMKL          LWIJFFHL       
RIRKG           : OKNSMHNV        KUQKKWBQDE      RSXKKGXAPLJDDQM HEFPBWSRAAOYY  
RVFHM           : VFROSEJ         QJIBXFYBBFFR    LMFKQU          IIEBUONOTIA     UVSHYCMPDYH     LXMNELKWUQLSMD 
EPJJI           : SGGKUXQ         YBFXODOHEN      LVQVE           HNBI           
OHDBIJSHGEQU    : DRSGNOBJHTJMIQ  GVVJGGGYHWURU   YUKMWSOUAMIU    IYETWH         
KDTUMWPI        : FVRUHXRBV       EATTTS          YAWQHD          EKDEDWITVUW     CYUTMEOYG       FDCY           
WXFDNOMVAEDFH   : HTNAMABVXBNMAI  NYXDHSAMLXFYG  
PCVVHOQICWEWJ   : BSDBH           JKSEYCU         WLQFRSC         XIODIUFYNTGBRXE SHBS           
ORGNRLQ         : IQBQR           WNSERQQVB       HCNW            DAHJDBGKVUCMSQT DEUDSJPHE      
CGCEMIKTY       : HTWRTWQMTT      MWCKSUQYDOTKE   EYDVCUSO        DJTGKTP        
VWXFMRQOOUNXYFR : JBHRC           HJWM            LWCADLLR        JYNVOA         
SKSKSWQUCDFMY   : FEBKLNHOYBLPJAU IMUOUW         
OWCMDQGVHUQ     : WVTXQTQNQYJ     UDUIIXKIIJ      WIJTVFOSIJBRHL  FDCY            NFWUMLXRTNNSSEY
URCNWVARIU      : GWCOUN          BPPT           
YRREXGDEUAIJF   : UNFLMYX         HXKA            UJQYNQCR        EBTDOFBPRWLXBX  CYLHOSOOMQMRPW 
QBINUGJMKYKGBEO : XOMKG           YVRLS           ONDON          
TPPLTNTYUQCFDHH : WERLQNE        
LPJGXUS         : TEIQEPA         RRPVDYKMXKMDD   ERKMM           MNAEGQFYUS     
TFRWKJUGBLSX    : EJLYCPJI        NSQUE           QUXDGWJIAABBES  WFAXVBQXJQD    
OWVG            : ROFIWVXEIKBEWF  VMUM            NOBVDBBUD       YWIQ           
CJLLFWBQD       : WLURLXQ         ITLDPWKPNXMYX   JBKIILRVIA     
MXNGGHGQSB      : KTDBVRDKMTBLX   LATIMCQ         MXPMNUQB        WBTNQFHQQO     
UMRUO           : PFIUKSLKHLB    
TMPVQYH         : CURPTLOCBWSMH   NOBVDBBUD       GQCQPGOG        LHSPNXYDIKIMM   NNERKMMVUGKJXB 
GEGWJKJJAS      : NACGMLGF        EPXFXDHMMSGKO   QETPENLACKOI    PFIUKSLKHLB     QGNESOFQQOALDIB
HYGDCGAPAUGJOU  : UXTETQVQPPD     YRLEYIELJVMID   QBYGHQ         
KMARQIXYGJJRTJ  : WGITBN          IQBQR           SXTYGBOLMWR    
JTNSW           : SGYIMLFVPPK     LGFEBSTPC       LVOXFQU         WJRJPFBYDO     
BWIBTOLILMTX    : YBROTXCCQPOKCO  WBVPHIVNLJRGIN  METMWQ          BFYHJQ          BYXYUHYNQE      IOYYWEIOAJAQWRJ
NRXOQGADYTO     : RCAEQH          QVNDIBA         YSGESITHF      
GICBHU          : EKDEDWITVUW     KPOSVOATLTQUBS  NCSHLYTH        WDUGPCORPX      KPNQGQOQYMP     KNCSFUF        
GDFATQJFGFGV    : UUOMGOMHEKJI    SMEY            RTFFRODVSMNKIN 
XTJQDMT         : GBHBKGAEENIS    NBRKDAMHQW     
GLROTVPEQTKVALP : FTSFPVQGPOL     QOATQGTKVGSTYDS GELQHY          FUXXPNMDRON     VRJQQPUFEJBJ    IHMXQMBCMFWMJK 
UXYC            : KPOSVOATLTQUBS  DBJUTF          BGPG            WOKKUPXIMAAIVP 
WWGTJWW         : MWCKSUQYDOTKE   LAAO            RBXI            MYATGYNSAJJUV  
TBEFUTBRLFIGQFG : TQLPU           OGBUSTCXLLXBVT  XVHIEVQ         WBKWIOVYFNLATSD BGFGJCJMNIAT   
WBYUBBDX        : LURCL           OIBKPOK        
JRJH            : GOAFPBWRNKOYL   DBKXDGNVWYKFJK  JYFOUBNYCTVYVQ  WDUGPCORPX      BDXHK           RTGAYUWAWVUFXMQ
HDRMINIJHTP     : TASUIKQTWF      SYTOQW          OLKMJAGNTHR     LJBXHTBJXIABS  
CIWKMUMLRPOV    : GHOCDQFCI       JNUWKBJPX       MATO           
QFIBOBKRVWCJHM  : FCHUJNXMY       UEDWEOLI        HHXETPUFJHUMJ   OYLMHIIEGVLEYA 
EEIGMIT         : RYORDHVQXCDD    FFRTTWNOX       EONSJCT         NOOXWYTADVTXFKS GARA           
DGMWV           : QOATQGTKVGSTYDS IJWVGQTML       LHQW            KATVAHV        
ULTBVW          : VEGKYUDNRCKHOUO BJIFNAE         ENNACDBWQEWDMQ  GYFFDFTG        DIBOOBICLLGN    YMOUIWSAVBWC    XBRGTNF        
XIMTHOFP        : YRBRWL          EARIH           AVOE            QVMDIJ          OSXECMMMTEB     JHAPX           QMOBM          
XVHIEVQ         : TBEFUTBRLFIGQFG QREFO           QVMDIJ          FUUXYHRSPCBV   
UVGJTEOOSJROI   : NBKBLUCAGAFP    OXEPGEKUYQJ     QQTHO           NHMVKNOVWXQ     JNBHILDUIXHPEX  BFTFD           NHFOTYR         MVYFQEJAFUKEC  
OQYKBNRSRR      : HSICHNCMQKXDJ   JPYQOTUSRISNVHL KKPDNYCMMK      EBTDOFBPRWLXBX  VMWXSX         
YBSV            : WMWQW           DSESHS         
TSQAD           : JMFILKGHDFY     OOHRRUS         UJVIUVFUTHKNW  
HTDA            : RMXECKIITIJW    VQICTLO         HYOAWVBWETOB   
XOMKG           : QBINUGJMKYKGBEO ECVNOOMEUCMRM   KLHYPQY        
LQIYLB          : BIIW            PNWXKKLVOGAKKW  XISK           
DRSGNOBJHTJMIQ  : UKTYCO          OHDBIJSHGEQU    VRJQQPUFEJBJ   
NSMLIBX         : CRXIDCXCYN      BNXCIDDQP       TWKKMHYF        OLKMJAGNTHR     BQCSOQHYL       CWIJSBVUTTKYRQA MNDTGVIGH       XFLH           
JJJRJU          : XQVLENVY        RYORDHVQXCDD    QLOCWM          RBXVNHIHYLWVYW  HSUOB          
CYPUFFLIO       : AMON            FXMQG           FGSNMLTA        GLBGIPTH       
CBKMRT          : XFDDGE          SLJHSKGXIFL    
NHMVKNOVWXQ     : TVKEXCWGYJRCX   CRBFWG          JDUI            UVGJTEOOSJROI   HIYLLTA        
TONSEIAKWJ      : BOIYKAXWMYYL    ICDJSXXKMDUEQ  
SNADDUXEI       : IIBT            PIHFLDUPIX      ICYVOCJ        
SGTGWQGUHOQ     : GOPFMMTUKEJNGVJ GBDNRV          CUUIDNDGCXYMVL  BOYJMOUJLIPUJA  HOMYHNWHXIJC   
CLCNMOKX        : UKTYCO          IIIEIHUPSDFIV   EDLKFJPPTIM     UCUWIQQLHWKVMK  OULT           
FNSI            : XJTNDG          KVGDXJW         WSBH            DHTJNVCYAYUSGR  BNYQA           BPPT           
PIUARQIM        : EBTDOFBPRWLXBX  RWOXMLNDHS      FMLKYRJSBHHGK   BXOATPEFCS      ILXX           
FFDBOURMYG      : ILRBK           KLSWRSTEEAMERBD PNNOBFDBREALQVR XVYPYB          AVXAIYEHVAV     OAAWWDUWTSGGTFX AHEUVHEA       
MSGYSWEGRPAI    : GPNB            JGHIAPVOFVJMB   NWCVOPBMVAOJD  
WISNRHLWMQABNU  : ABCY            OPWG            JXPTNOFLVARMFE 
NBECVKCOJIWCAWK : AHWWXOM         GWMESJBE        CCRGDNYMYN      EKDVSEILSTMBF   VTQIFUGPFD     
UUTIODVMPP      : WPTBJUSRS       IKWKUK          TWBBPT          BFPHHRV         PMFY           
SDLGQM          : UHEDGIP         WOUMFYYQTYUDFX 
TKAXBJI         : RSRJNJVTOCEFE   VWJNU          
NJXXKSVGEKJ     : JHWFLRRCMNRYNIS GBHBKGAEENIS    RJVTKK          PXERMSGXGMGR   
YBROTXCCQPOKCO  : UNRGOPK         BWIBTOLILMTX    QIQS            OOHRRUS        
EBTDOFBPRWLXBX  : YRREXGDEUAIJF   OQYKBNRSRR      PIUARQIM        KPNQGQOQYMP    
FXMXOGXQKO      : LYENSWWN        PKUFKIBTCSKQUTN YFEC            YENM            AJKDFVF        
YCLQMRTIUINXAFU : VKLWQLNT        XIODIUFYNTGBRXE
FXMQG           : CPJMASRQ        JNPR            WRFNNKMOEY      CYPUFFLIO       YAAOQ           DSNJYPKQITN    
FEBLETXSDA      : YSIPJFESJMIXQ   SDXVBHRRLANQA  
QQKIKSFU        : QUBM            AOCLG           IIBT           
FVQB            : QDJAIBD        
WBVPHIVNLJRGIN  : EHPCA           JNPR            CYUTMEOYG       BWIBTOLILMTX    LAANSB          UQDJLHVY        ICYVOCJ        
IIEBUONOTIA     : OGBUSTCXLLXBVT  RVFHM          
GQCQPGOG        : TASUIKQTWF      TWKKMHYF        TMPVQYH         VKUIIFHWHD      IYCNVWRCCP     
AEGNNATX        : KBCQDDILOXT     MOQYEXRI        LOMRW           VNVXUNNWR       PXERMSGXGMGR    EYGHLBD        
HIYLLTA         : UEFEMMUORMUW    NHMVKNOVWXQ     GVVJGGGYHWURU   QDJAIBD         DFRTIA         
IVKKVSCAJRGBAWD : BQCSOQHYL      
DQUDNUTUG       : SROQHTCTVAKIRHR GIFUJOUXHCXNQ   FDCY            PYHD           
JRMLTXIEIGWM    : QUBM            FJOHKNCUCYQS    KEXP           
JFNMHMPM        : JLVUENKDFN      CPCAS           CWIJSBVUTTKYRQA CNITJYNDIGSDL   BSBLTDIIDNVY   
IJWVGQTML       : OWJYAUVPKFL     DGMWV           TOXBWAAXJCJG    AJKDFVF         NRBXITMQQBDLCF 
FYQY            : LYENSWWN        SFFUH           AOIGG           SSYVJETG        HXWOKXIR        HFSVGSRMDJ     
YFJF            : HAAYQTAP        GUIQHNVCPMH     ENOD            VBNREAI        
WMNECCLQTAIDJH  : AJQXMA          JUSOE           OVMXME         
QYUDMAKNRJMS    : KAOLXFHKMVGOQ   NLPOXAUVALJJ    DSNJYPKQITN     UCUWIQQLHWKVMK 
YYTVNJARMNIGO   : YMOUIWSAVBWC    EHVCXOIVOOLSP  
LAANSB          : MOUHM           ETYTJVT         WBVPHIVNLJRGIN 
WONJCFTRX       : KOCOBPVMCYMLHPW NRBXITMQQBDLCF 
QYGOMQQG        : WDUQCAJOQXQ    
EONSJCT         : SGHYTHGCBJR     EEIGMIT         TIQFCELSDU     
PMNCLCPVHURBVE  : LMEXA           RRPVDYKMXKMDD   LKBDJNBXTOQXJVJ
ULIKEYQLDIYW    : JLCJWPJTXJB     TFKLTVBV        VSJPP          
DSESHS          : YBSV            WOGGB          
VWNRGLLHJP      : FCAUXNPSGBFCNBO EBDEDAMDP       VCSOFHPWTMVVHBE GLBGIPTH       
GDJS            : PKUFKIBTCSKQUTN OSEWINUH        ITLDPWKPNXMYX   EKVL            BGFGJCJMNIAT   
IMUOUW          : WGVQLWN         SKSKSWQUCDFMY  
OAGVVPQTLPJFWU  : FVRUHXRBV       TEIQEPA         UDCBK           NAXNIGHXD      
GGJINOTGYFS     : YCUOWKEDWAUH   
TPSHFTN         : WRDMQNOP        RXBCSDCWUKN     LLQXL          
RDTLRJWWGSQ     : VGNHPEMVJEIM    HSICHNCMQKXDJ   AWPXMOI         MTJCUVV         NWWI           
YAAOQ           : WGITBN          LSOXDFNGINX     FXMQG           QOHM           
VPYOOUFHCMDRRUX : AEXJ            LORAHLD         MGMA            BGOOEALIG       MNUWJMSAGG      WOKKUPXIMAAIVP 
IPWGOGBFV       : QRGVT           VOEHLSCMDA     
HVRYP           : UNFLMYX         JTDI            QFFKMFVMMDE     KLHYPQY         UIOSDRTN       
QREFO           : XVHIEVQ         QYQBN           PYUTHNHUU      
PRAULRS         : WGVQLWN         DICDJ           AWPXMOI        
DBBBJSJMXF      : SSVRAJLGQKENTE  CXENVHCYXACGE   AYBWWMSLRT     
GBJHSWA         : SUABHWBSJVQBRKW CQWPCVFBXH      PYHD           
DICPXVRUHKNTP   : YXBYB           OHGPVQGRDNH     CPJMASRQ        EDLKFJPPTIM     MNIN            VGBY            FCAUXNPSGBFCNBO
WSBPCOQHGYKPGE  : RYORDHVQXCDD    YCUOWKEDWAUH    HCLVJHKVLPI     TKSNC          
ISRQUJQQCMBMAW  : XJTNDG          NLBIBBSW       
RVXTM           : NGBBKH         
IFKQEWGKB       : GOPFMMTUKEJNGVJ SSYVJETG        QUXDGWJIAABBES  IKKJDGFTQK      QOHM           
SUMMRWDLY       : FHIHHQJ         JNYYB           JELFLR         
ONSLRM          : MXXYDQRTH       XJIBX          
PGXSQDFHHC      : JNRNLE          KGKXMVNNMDVODT  JSBAS           BXOATPEFCS      JTHYKWBNPQD    
TGIPDVCUS       : EMNCLDERRATNUPM SGYIMLFVPPK     KYTHFPNUREOJE   NASCVTJJFJ     
ITCWHU          : ONMUOJCYQNUFVT  KOUAIBVYAXX     NAKH           
YJURQUMJYRRGVHB : NFNUE           BRRJFQLFUPIKUR  GQVX            GNCKPXL        
QSFOUDJENDGNKD  : KHSB            EQHC            WGFNUPO         AIPMUKLXGYO     CGTFCHFDAFNH   
LNUDEQPPRH      : VQICTLO         EFBPMAGTSWJ     IAQDVBCNREGRI  
XGRBIKTQYQVKVJN : WSRITFGFC       OUDGDCWDXIKK    VKFRRICW       
WAIXLXUPENFTFP  : MRCEDHWYUHHRF   LJVOCLP        
GVVJGGGYHWURU   : OSEWINUH        FUWTGAWJRIFDT   HFAPWYMJ        OHDBIJSHGEQU    HIYLLTA         QFYCBKCAIH     
HCGHKGS         : WLURLXQ         KRBLQHBUAXUXTWD KYVXHEPJI       QYQBN           OVMXME          JRKWRXTDH       VMWQIPYK        EQQWJAMMIFBXKS 
CKOPSIXKME      : NSBDT           KBPP            HLTYMOCCWLQW    HXKA            RVPDBBBSW      
KPOSVOATLTQUBS  : BNXCIDDQP       HDBGB           LSKBDVUOPALNJMB GICBHU          UXYC            AWPXMOI         QVNDIBA        
KFKEPO          : MTIYXJHDU       RGBLFQODSB      RWOXMLNDHS     
EHJPFTE         : GDKPIXYPCELT    MPFPCE          MGMA            MEQLFSSLIGUVRAM FLQVW          
CPBTKX          : BMJLLJJVSIE     VGBY           
LTVHKTJGXTLK    : BTJPI           LJVOCLP         ICYVOCJ         AWUNNDVVYNQD   
EARIH           : PQKGRXUG        RMGRKCEYGHDCEWW XLHLCJKCTX      XIMTHOFP        LWQOABCCVEXQ   
AOAFAEWDXHBIUU  : FWWGWMBOKPV     NBHOCEJEYPKVU   OLKMJAGNTHR     XHOINUD         VPYEEAOMTVL    
DIBOOBICLLGN    : QPGKNHNIMRHHC   ULTBVW          FBSAVFKXBLIHR   KPNQGQOQYMP     BUIVD          
RWKRLKWL        : QLKRMN          PYUFKOXPWD      LOFBTFAKDIUSLES
TRNESYYQGCYJQP  : HNMWD           UAFOT           TDFUXGBQ        LPKIKOXWTFM     VBFHBCW         KLLYPW         
CRANBOUSLFK     : RWHLTEHWXU      MNMV            RKEINTKBNPP     QNVCGIEBPOL     VVCQVSH         AYXLEWUK        OSFSUPEF        AWUNNDVVYNQD   
QILIEDXIYW      : GUIQHNVCPMH     HSICHNCMQKXDJ   ICPPUKYPGJNYKSU AGSCMPPEFLG     WKQRPWHCTVSIW   TLAKI          
PFMQQGIDICGXD   : HMEWXSXQ        HPKAHO          XSVCRVQWHM     
UVIAJISTWDACCJ  : TASUIKQTWF      CLHS            BEBVUT         
BVSJILA         : VQICTLO         EIEFRVGBBL      CGTFCHFDAFNH   
VGBY            : YUUPKMTNILLC    CRBFWG          DICPXVRUHKNTP   CPBTKX          RVRUXEWHVW      QDJAIBD        
BEJVDRYMDTGAX   : BMOHEYURQAOKPLV MCWSFBYIDKXECS  QIFMST          BFDD            DQYHNOSUVHIEY  
CCRGDNYMYN      : TKXCSX          VQRYDJJPCKBOBK  WQTC            NBECVKCOJIWCAWK RGBLFQODSB      PXERMSGXGMGR    FMLKYRJSBHHGK  
RJVTKK          : PMPJNGOUG       JOTQTJ          OSQAPRXCPHXSCE  NJXXKSVGEKJ     RVRUXEWHVW      GBIENDJTT       HOTJOP          SEFAWCXP       
PVTUPUHSQPSO    : RIMCVB          YNJMJXSBJQAA    BJAWNYD         AUEIKOKW       
XSSEWGFLHSDC    : YCMW           
YVRLS           : SBDIWNJJBACY    QKJCEHWAEBTRRU  WQTC            LIAUJLIKNBHUJDK QBINUGJMKYKGBEO HSUOB           SEFAWCXP        LCKQVKVVGKR    
HOEXLNSD        : VKDFWKQ         WGJRAYLA        PDIMPKMMQ       KCYIDIWLVTQU    NHFOTYR         SDAEJQU         TIMAUWF        
OTEMNWQKFXXPTCR : BWAUHXGUNGF     DNNPLPIL        HLYHEPQFRI      QIGHTRSCTUAKY   XAGL           
DPSRI           : BHWN            JVWPXG          YYKTYPBVALW     EBRGPUWV       
YAHYN           : AEXJ            CSKDQRPQTEY     DINSL           HIUKGEY         RTGAYUWAWVUFXMQ
UQDJLHVY        : YWADBJQRJMTY    LFXEWANBSSUUJXB TXSVFCLPRC      IIRXQ           WBVPHIVNLJRGIN 
OLKMJAGNTHR     : KTEOXFDWCGYEQK  HDRMINIJHTP     NSMLIBX         AOAFAEWDXHBIUU  QIFMST          JXAOYRCP        XHOINUD        
DJTGKTP         : JHWFLRRCMNRYNIS CGCEMIKTY       YLVESFQ         WUVBQPNGAYUN   
INHBRQMB        : KWCDJRDWOOH     LBPOO           QVMDIJ          WMDJFOBMPAPGO  
NGDYSPLUYYOIS   : HTXGPFV         LMFKQU          CKEPT           CUUIDNDGCXYMVL 
LCRTPOMCYCJA    : NAETXNONSWTPUNP RDQDJWYLFMXYKJ  NSXRBMBH       
APXODERFYJS     : LWUNO           ANCDRGDONVQHMH  KQOWECCL        UHEDGIP        
IRITNIHPCEHQQ   : PMPJNGOUG       MFCBRFKOIJPARE 
RSUUP           : SJLBSODSAYJURJL GLBGIPTH       
KNLPTFWSPPO     : WWRPCQGFTS      SRHCOYDNHIWFAA  JDCBV           ONYMTTHGAQBI   
KYVXHEPJI       : DMLL            KKPDNYCMMK      HCGHKGS        
DBJUTF          : MOEHEJOFRS      UXYC            UTKERUFBIDBUTJ  PNURQRMXHX      NWWI           
JCEYQUSXTNNK    : HTXGPFV         WWMFIQGL        ALVJHOWSXSEE    SDAEJQU        
QUBM            : RRRFJDLM        EKUBGPG         QQKIKSFU        JRMLTXIEIGWM    WFBCMWHR       
KSKUDIAESWBA    : FJLYISC         MBXTRBABUS      FPRXOEPEEDR     KEXKVXRVSOWM    NFWUMLXRTNNSSEY
METMWQ          : SVLLGE          LOMRW           KHNAMQUWBHFPYF  BWIBTOLILMTX    JUSOE           OPCUJCJWQKGR   
VLVLXACUCR      : LFXEWANBSSUUJXB SXLN            HJYSJNP         XSVCRVQWHM      LSEVWGDQKJQJ    LYVCGYTQGGOXS  
MMCJ            : LORAHLD         OHLO            VAXTKQLN        SGYCRNTPAHJP    KEBMENWENXE    
LLUG            : XANMVL         
VIBJMUX         : DYOQJEN         UHKHKU          JBKLBJP         YSGESITHF       BJAWNYD        
OFICDTA         : BLTUOGNCVG      IIBT            XNYS            CTBBLWKENVHOT  
YWIQ            : QTXLQVEVL       OWVG           
WDQHV           : DRXPHXCXW       BSDBH           SAMTGXH        
UTKERUFBIDBUTJ  : EHPCA           DBJUTF          SSTKX          
VMWXSX          : RHDJXED         PAKNCEJWPAJO    UHLMKMOX        ITLDPWKPNXMYX   RGNEE           OQYKBNRSRR      WMDJFOBMPAPGO  
BQLBUCISJD      : RYORDHVQXCDD    QMMEBDBO       
VKFRRICW        : JTRULSXAGYG     VPXAI           XGRBIKTQYQVKVJN
WQVCOKYME       : BSDBH           OSEWINUH        JVYLNSOHMNTTMLT QOAS           
LHQW            : TOUADBLANDIFA   YSIPJFESJMIXQ   DGMWV           IMCK            ATFYSMJBFML    
NCSHLYTH        : GICBHU          HOTJOP          LLEIJ          
BYDMBBYATUCJF   : QHLTVLYWCRIHF   QXGBX           WSOKUSWJCWTV   
XLEKTUHCJJX     : BEAUDKIS        GWCOUN         
WWMFIQGL        : UFHWKMQWAIQ     RSXKKGXAPLJDDQM JCEYQUSXTNNK    XQVPFYNMSJBWMKO PPNCTDBXQYFDETI
IMCK            : MPTKTLFJQCUH    LHQW            GESUIEEFR       IOWISNLCPWFSFGE BPPT           
WNSERQQVB       : ITLDPWKPNXMYX   ORGNRLQ         NAKH            AOCLG          
QLOCWM          : SROQHTCTVAKIRHR JJJRJU          PWTTMKBEUIPHHH 
ULKCTB          : FEBKLNHOYBLPJAU BEAUDKIS        DTXCYV         
GESUIEEFR       : MNMV            QRCGCQDRBQDECBM LMEXA           UHLMKMOX        CLHS            IMCK            UHANBQWX       
LLOCHPMAD       : PWTTMKBEUIPHHH  GXGIHJSR        CNITJYNDIGSDL  
FBSAVFKXBLIHR   : DIBOOBICLLGN    CUUIDNDGCXYMVL 
FCIJJA          : AHWWXOM         IHPXCNXUNJ      EOHATJLKDP      OUDGDCWDXIKK   
VNVXUNNWR       : NBKBLUCAGAFP    AEGNNATX       
CSKDQRPQTEY     : RKEINTKBNPP     YAHYN          
XDIBLSK         : JHAPX          
AGBXFVLSV       : TJJRFCNH        IBBPPP          JCWKIUOJQTTPK   FYRERVSRPASK   
MXXYDQRTH       : SVNICRPA        MPTKTLFJQCUH    PAMAXTMLCACVUTR ONSLRM          IAROSALLDNLGFDF
AJQXMA          : WFNFHSC         WMNECCLQTAIDJH  AVOE            XIFQDBXMIYX    
YUKMWSOUAMIU    : EMNCLDERRATNUPM MPFPCE          OHDBIJSHGEQU   
OHLO            : FEBKLNHOYBLPJAU MMCJ            QOAS           
OIBKPOK         : XJDP            IYVHEELYJXPKTMW WBYUBBDX        HJEYXLD        
FJOHKNCUCYQS    : CIDGTCGNK       JRMLTXIEIGWM    UNAK            CQWPCVFBXH     
QIFMST          : GDKPIXYPCELT    BEJVDRYMDTGAX   OLKMJAGNTHR     VINSDD         
EKDVSEILSTMBF   : NBECVKCOJIWCAWK URBNDH          MJEDRMBXGSSMC  
IPQNNVMEOJUYQ   : FTSFPVQGPOL     TEIQEPA         DNRCA          
SMEY            : KAOLXFHKMVGOQ   POAEJLXY        GDFATQJFGFGV    IYCNVWRCCP      XHOINUD        
JUSOE           : KGOOKGSAKGBPQKP NYWBSFRKQRXP    WMNECCLQTAIDJH  METMWQ          HOMYHNWHXIJC   
JAQMHU          : NAETXNONSWTPUNP QBYAMPBF        OSXECMMMTEB     FODFTATOKJ     
YNJMJXSBJQAA    : YJTI            HMEWXSXQ        PVTUPUHSQPSO    QUXDGWJIAABBES 
UMGWMQRHHX      : DLWVAXRTBTVSJI  BPKOONORBDJVT   HSOKPEXYO       UCUWIQQLHWKVMK 
SAEGHBEHP       : LFERSYOPNIV     YTWMXMRWSCBXQ   CRBFWG          YFCTGO          PMEXKDJWLHHCE  
VBNREAI         : CURPTLOCBWSMH   YAWQHD          QARFBMAX        YFJF            UTCYJBGEJMILFBY VATHJSXNENFTKGO OKUYCUDGS      
CKEPT           : JYFCKYBYPALN    NGDYSPLUYYOIS   QVNDIBA         TYMFVRAK        DXKESAT        
EKVL            : GBHBKGAEENIS    HJYAILGMXXHVGV  XSTNRW          GDJS            QPPNO           ENHS            YHMJYPQVYFRBGU  AUEIKOKW       
TYMWDSGHYPYOMA  : BEBVUT          KOCOBPVMCYMLHPW VJCWAOQWC       WGYIJIJGYKMWG  
GHHQOJBSB       : HMEWXSXQ        HYOAWVBWETOB    NNHFODYJKPW     KTPFPGC         IHMXQMBCMFWMJK 
UFHQSBMRQJXLQF  : WMWQW           XLHLCJKCTX     
IGCUGHDPOTEBX   : TVKEXCWGYJRCX   MNCHRAKQ        OOHRRUS         WERDJ          
CUUIDNDGCXYMVL  : SVNICRPA        FOHINY          SGTGWQGUHOQ     NGDYSPLUYYOIS   FBSAVFKXBLIHR   ONDON           HOMYHNWHXIJC    AOCLG          
CUUIDNDGCXYMVL  : TLAKI          
DYNJBLRLOICJODH : QARPTDAYX       YAOFDLPAJR      LWQOABCCVEXQ    IYCNVWRCCP      UQMIRJKWSDAB   
GELQHY          : GLROTVPEQTKVALP GKNHRX          VIUSTYRVQKU    
QCTPQPDXUCNGEBY : AEXJ            WFAXVBQXJQD    
QJTCXALPGPBYADU : FHIHHQJ         LWQOABCCVEXQ    CYLHOSOOMQMRPW  AUEIKOKW       
HPKAHO          : PFMQQGIDICGXD   IIBT            CNITJYNDIGSDL   ENLVOQMXJDO    
DSNJYPKQITN     : FXMQG           QYUDMAKNRJMS    YAOFDLPAJR     
UNAK            : BVMQWVIXBOYLCO  RYJSEDHI        FJOHKNCUCYQS    IJJDUNMRGYXYMCQ VHPXECVWMNX    
PNURQRMXHX      : DBJUTF         
POXUHOGHERX     : SKFDTDAJB       VAXTKQLN        KWRIV          
NLBIBBSW        : DVKWWHMVEMD     ISRQUJQQCMBMAW  DAHJDBGKVUCMSQT ECVNOOMEUCMRM  
HTNAMABVXBNMAI  : RHDJXED         UYDYXSXQLKJDFS  KCWUEUTQV       WXFDNOMVAEDFH   DXFYKKALB      
OPCUJCJWQKGR    : UVIGACQ         METMWQ          JGESLARSVOUSPU  KOCOBPVMCYMLHPW YQLWDSMVITJIDX 
BRGKLTNXUO      : KLCHYX          FCSPLCTVLQLEUSO OXHGL           ICDGFU          LYVCGYTQGGOXS  
UPIKRT          : OTHC            VQMOLWKY        SXCMI           BDXHK          
IJJDUNMRGYXYMCQ : AYXLEWUK        UNAK            LJVOCLP        
OCRCDMQ         : JHWFLRRCMNRYNIS GBKPFCIPD       JBHRC          
KHKUBECKPNNKB   : KNVWCJBBBC      WURGBTEY        PKWQALRBPLRQDG 
DICDJ           : WVXRW           OPWG            PRAULRS        
HCNW            : FSWXQHLGMNQL    GEKDNWW         QKJCEHWAEBTRRU  ORGNRLQ         UGAUEPKSVEJ    
FYJUSLHCWCDBGN  : AMWCTVADY       JLACNJNABCWUB   BJIFNAE        
TCEWFHHJ        : PRPYFXRRDFMJP   EUFTG           NASCVTJJFJ      HJEYXLD        
QDWSSTCB        : RLLOSHINKXTN    MDBSR           CQGHFVVFSUBUAA 
LVOXFQU         : WCOACUNGJACWL   QTXLQVEVL       KGKXMVNNMDVODT  JTNSW           PBGJK           BUIVD          
TXPIRLMWITGQ    : LGUUWOAAVJTH    KJONGTL         BJBRGDKQRD      KGKXMVNNMDVODT  BNYQA          
TJJRFCNH        : HHTYLPYHBWEWG   EAJGUQSJOJJUUP  AGBXFVLSV      
JSBAS           : DUFMOAEJHSUC    PGXSQDFHHC      QKFTLKDLUBCRRA 
QPPNO           : GPXV            EKVL            LTBHNN          UVDKSBLPHDF    
XISK            : NSBDT           EDSQ            LQIYLB         
EGMU            : RLLOSHINKXTN    PXERMSGXGMGR   
IGUALXQSB       : SDUFLPB         HSSINBGSOPFOPU 
OFBHLTAEJQLHYHT : GYRMOHHGFLLI    NRBXITMQQBDLCF 
LATIMCQ         : MXNGGHGQSB     
DDFTVJVKOYUC    : JTDI            UTCFD          
WGFNUPO         : QSFOUDJENDGNKD 
JVRKPCWSSGVVORU : GIVXQRRMDXEBIL  RMDRW          
PFORCS          : XOWXM           KFVRG          
YCUOWKEDWAUH    : SKNYJLSTUWTDR   GGJINOTGYFS     WSBPCOQHGYKPGE  IXDNTAOU       
YGJR            : QEGFTXVSYA      KHNAMQUWBHFPYF  HJWM           
HQDBL           : VIWVYHAENFYGP  
SSTKX           : GIVXQRRMDXEBIL  ITLDPWKPNXMYX   KFJSDX          UTKERUFBIDBUTJ  QREXLHM        
AWPXMOI         : RDTLRJWWGSQ     PRAULRS         KPOSVOATLTQUBS  QMOBM          
RFSOOLNWW       : DUFMOAEJHSUC    SMECIJJHWW      LIAUJLIKNBHUJDK AVYMK           KOCOBPVMCYMLHPW
KEXP            : KWCDJRDWOOH     WRFNNKMOEY      JRMLTXIEIGWM    BDMPFP          KNBRSHTTHKIKK   GEAQLCWVPFUGX  
LTBHNN          : QFSCPPW         KBMFX           OCGI            QPPNO           NTXTHG         
BQCSOQHYL       : NSMLIBX         IVKKVSCAJRGBAWD SCTOCRBQWYUQ    BWSNGBRGLM     
HHPV            : FKGYL           TKXCSX         
DTQN            : VGJXDQY         IQDJGCKPPFDRKBO VBFHBCW         WFQHDYQH       
WLXHARIHIXML    : RGVQX           UJSQH          
QFFKMFVMMDE     : ENOD            VPXAI           HVRYP           NOOXWYTADVTXFKS GXNHYYDXSSWPGWA EQQWJAMMIFBXKS 
WIGPVOOJNV      : AUPVJK          DUEMVHJV        ONDON           KEBMENWENXE    
HGSPFHCV        : VYGFPPYJUC      RVPDBBBSW       RNMEVBEQDW      GOGJYRNFP      
HCLVJHKVLPI     : UGGVO           JVVQVMVKHQAKQW  WSBPCOQHGYKPGE  WINSECOQO       VTQIJWBKHDAFX   FXXEPE         
XRCVIQHVNT      : GPNB            FCSPLCTVLQLEUSO UULJYOMBBEQQBRM QGNESOFQQOALDIB
TOXBWAAXJCJG    : CXOWETNIYD      IJWVGQTML       FTVSF           MPQQAFVUS      
SQLEGTQGNSE     : NOOXWYTADVTXFKS YMNUVBTDPPP     IRGIWWR         NSMDUVGEJAJ    
KOUAIBVYAXX     : RKEINTKBNPP     ITCWHU          AVAHMFGWRYVGFJV JRNCOAQV       
AVOE            : MESRNVIXAUGXVV  KLLVYXUEMQFD    XIMTHOFP        AJQXMA          WOSBKVCS        MMWJMXJ         BGPG            CTBBLWKENVHOT  
URBNDH          : SBTDUXGSRJEEDHP EKDVSEILSTMBF   MTIYXJHDU      
WYFN            : VFROSEJ         MGMA            KNBRSHTTHKIKK  
MKCBFE          : YMKTN           VQRYDJJPCKBOBK  CYLHOSOOMQMRPW 
JBKLBJP         : MNCHRAKQ        KBEVUAVLSG      VIBJMUX         UVDKSBLPHDF    
HEFPBWSRAAOYY   : RIRKG           WFAXVBQXJQD    
MTIYXJHDU       : USIXSYFVAPU     DBKXDGNVWYKFJK  KFKEPO          URBNDH          FUWLGPRD        IOJG           
EIEFRVGBBL      : BVSJILA         DTXCYV         
EKLVMMKL        : GPNB            QLBXJL          LVQVE          
JBHRC           : EATTTS          MGMA            VWXFMRQOOUNXYFR OCRCDMQ        
EJLYCPJI        : LORAHLD         TFRWKJUGBLSX   
BFDD            : HTWRTWQMTT      JKSEYCU         BEJVDRYMDTGAX   UTCFD           OYQV            VCSOFHPWTMVVHBE NYXDHSAMLXFYG  
QVMDIJ          : OMJFXWNMTVM     XIMTHOFP        XVHIEVQ         INHBRQMB        MRHGEGGBJI     
WVDMFGWAJFEUQFA : FOCEHR          PWGVE           WINSECOQO       TQLYVAFJPCGB    JFXRHVPJON     
PIHSPMXADUNIFYX : BVRPQTUST       HDBGB           FQHHYIFQPPKI    MVYFQEJAFUKEC  
WDQFKNFTSLOL    : MAXDMYF         NSXRBMBH        WOBKSUNTVFUB   
QVGADARRASWUIF  : QOATQGTKVGSTYDS RYJSEDHI        DHHMJHSMLIRIKY  DUAPHGISA      
JFGGJXNTNSPJE   : SFGRGQLIQVJVGJI BYXYUHYNQE      DIQWCAFSAIIX   
WXXVEABGTTHOQEW : LOSWEJV         BOIYKAXWMYYL    MDBSR          
HICPRNPFJEBYN   : HSSINBGSOPFOPU 
IKDGIKIKSCECRU  : UKTYCO          JMQXDL          WJRJPFBYDO      ENLVOQMXJDO    
QRQAWGRMWYWD    : SQWPXSWR        JJEIA           FQHHYIFQPPKI    BHIK           
VSIG            : KBEVUAVLSG      RVRUXEWHVW      GSYRVI          SSNVXVBHRXFMJU  CQUAVUNACWQW    KNCSFUF        
NOOXWYTADVTXFKS : EEIGMIT         QFFKMFVMMDE     SQLEGTQGNSE     SKFDTDAJB       VJSFGNEUESGX    XSVCRVQWHM     
MRHGEGGBJI      : QVMDIJ          JVWPXG          TIJEHCTDBG      RTUETX          YAVIUVUWLFVBOL 
CQGHFVVFSUBUAA  : JCSS            PNNOBFDBREALQVR QDWSSTCB       
YFCTGO          : WGITBN          OPWG            SAEGHBEHP       WBTNQFHQQO     
NXRVEVHM        : DVKWWHMVEMD    
JGESLARSVOUSPU  : FMMRLAHGA       CYJYSITSRRHLL   OPCUJCJWQKGR    LRXLBDJ        
QCMMKDAXBR      : UXMBS           VQRYDJJPCKBOBK  ICDGFU         
HPDWLO          : VAYNIRDHYOXR    WXQQ            RNMEVBEQDW     
QIQS            : AHCPIYECV       FQHGQD          SXCMI           YBROTXCCQPOKCO  REMJROLRPGAO    RMDRW          
LQQIKIDWBILN    : CBDP            XJBNAWAATHEY    DHHMJHSMLIRIKY  WKIHPNUIVPJWUK  IHMXQMBCMFWMJK 
OPTSKR          : YNRTVGXUJ       TYGPWSOTUHF     XVBISPIUFUFPL  
AVYMK           : KAYTKBMJQRFCEGR TDVKENPSL       QCNC            KTFRBRULBYUBQ   GIXP            RFSOOLNWW       TIJEHCTDBG      GSBH           
FUUXYHRSPCBV    : PPTBWUIHMCSPH   YMKTN           GXSOTGMDYGC     XVHIEVQ         FMLKYRJSBHHGK  
DGKSBBJUVTNYTL  : MBTRACBRNKVRSS  MNIN            UIBMSIFMUBY    
IXDNTAOU        : JPYQOTUSRISNVHL SKKDSP          YCUOWKEDWAUH    VMVRJFGOQSYY    HFSVGSRMDJ     
GNCKPXL         : VEMEJUMRIRVWVR  YJURQUMJYRRGVHB LWCADLLR        XLLUVLMA        IMRR            UDVRMJTXKAPIW  
GXNHYYDXSSWPGWA : QFFKMFVMMDE    
COXDFTONJQXYQLV : DRXPHXCXW       CRXIDCXCYN     
JMFILKGHDFY     : HSICHNCMQKXDJ   LAAO            TSQAD          
FYPHPQMUMCKVU   : YVPPS           ADWB           
VMVRJFGOQSYY    : IKTGUXFRDCNVA   OSEWINUH        IXDNTAOU        IGYYOQNHRCAHAPK
EFBPMAGTSWJ     : LTJJRQ          LNUDEQPPRH      LRBJHTCNWIRK    HANA           
JNBHILDUIXHPEX  : UVGJTEOOSJROI   AYBWWMSLRT      RTGAYUWAWVUFXMQ JJKGNXT         AXHI           
YXGBENEWAF      : MOQYEXRI        OUDGDCWDXIKK   
VXCF            : RWHYERINL       QXJMXWO         XJIBX          
NSQUE           : KWCDJRDWOOH     TFRWKJUGBLSX    VJSFGNEUESGX   
BYNB            : UJSQH           IMRR           
DHHMJHSMLIRIKY  : QVGADARRASWUIF  LQQIKIDWBILN    YQLWDSMVITJIDX 
GYRMOHHGFLLI    : OFBHLTAEJQLHYHT LJBXHTBJXIABS  
YLVESFQ         : DJTGKTP         RVPDBBBSW       BSBLTDIIDNVY   
MLPY            : LYELBDIGYIBT    AHEUVHEA        HNBI            AXHI           
JJEIA           : QRQAWGRMWYWD    OTYKSYHA        SGJX           
HTCVEJ          : MWJHFLKW        FGSNMLTA       
JXPTNOFLVARMFE  : UJQYNQCR        PBYQLRDPIIQJRD  WISNRHLWMQABNU  AXHI           
WDUGPCORPX      : GICBHU          JRJH           
RVPDBBBSW       : LNCWPXSBPG      CKOPSIXKME      HGSPFHCV        YLVESFQ        
ICDGFU          : HXKA            CRBFWG          XOWXM           BRGKLTNXUO      QCMMKDAXBR      ECVNOOMEUCMRM   AJBERVVXY      
KYTHFPNUREOJE   : ANJAJOPDQBM     SKNYJLSTUWTDR   YVNSOLOIKXD     EIVV            TGIPDVCUS       WOGGB          
BASE            : VGNHPEMVJEIM    UNRGOPK         BQUXOKKWYWJR    SEKHTR         
VIWVYHAENFYGP   : HQDBL           YJFF            UIOSDRTN       
DWGSMDMSRVW     : VQMOLWKY        WURGBTEY        KDVROXEYCAA     HANA           
YAOFDLPAJR      : WXQQ            QPGKNHNIMRHHC   DYNJBLRLOICJODH DSNJYPKQITN    
JVWPXG          : XVYPYB          YRBRWL          DPSRI           MRHGEGGBJI      UHEDGIP        
YJFF            : YWADBJQRJMTY    MOEHEJOFRS      VIWVYHAENFYGP   QYQBN          
TKSNC           : WSBPCOQHGYKPGE  DLITKBNF        MPQQAFVUS      
MXPMNUQB        : BJBRGDKQRD      MXNGGHGQSB      WBKNSYVTNKRVJK 
SKFDTDAJB       : PMPJNGOUG       UXMBS           POXUHOGHERX     NOOXWYTADVTXFKS IIBT            SDAEJQU        
RARWHXSRQGV     : KBCQDDILOXT     VGNHPEMVJEIM    BJIFNAE        
TUYGKWYLKS      : WERLQNE         OQNSSWVKNONYCS  NNERKMMVUGKJXB 
RVRUXEWHVW      : UCIA            KCWUEUTQV       VGBY            RJVTKK          VSIG           
UHANBQWX        : GESUIEEFR       DMOJUWXHWGHFP   LKBDJNBXTOQXJVJ BVSPJNFKHPMBOEJ VUJKOFWL       
SUABHWBSJVQBRKW : MAXDMYF         EJAPH           GBJHSWA        
OTYKSYHA        : DCDUV           JJEIA           UWDRBWPSDYGXBV  JRNCOAQV        IMKHJUKUL      
XCTUCUPYXSGWTBH : KSYFMJYRQGTKJDO HDBGB           KCYIDIWLVTQU    CWYNECT        
TIJEHCTDBG      : AUWWHXMNHDMRXJ  MRHGEGGBJI      AVYMK           UAEJEBG        
CQYDODXL        : UGGVO           RAIJBKFUBX     
UBGSVMQ         : WDUQCAJOQXQ     TFKLTVBV        IBUCHUMCXTSF   
NAKH            : UAFOT           DDFNNSRXOBBBF   ITCWHU          WNSERQQVB      
WOSBKVCS        : AVOE            BGVKXAWBS      
HJWM            : VWXFMRQOOUNXYFR YGJR            CYLHOSOOMQMRPW 
AMLIKOQDLEVE    : UMCNJN          UETBMYPSUUEW    OSXECMMMTEB    
VOEHLSCMDA      : SKNYJLSTUWTDR   RGNEE           QARFBMAX        IPWGOGBFV       SCTOCRBQWYUQ    JBKIILRVIA     
XVBISPIUFUFPL   : FRMAQVQNFTRX    RSRJNJVTOCEFE   OPTSKR          LYEABQSABOMGSN 
UWDRBWPSDYGXBV  : XGCPRNFLVPBGNW  LLAEHPYEDORCF   OTYKSYHA       
CPCAS           : XDTRIVKNNXJJII  LURCL           XLHLCJKCTX      JFNMHMPM       
UIUPNPVFEUBBXU  : SCOT            ONMUOJCYQNUFVT  JFRBXXGJGYLF   
WKABMGYPEDRTFT  : TQLPU           GDQBFMPX        BTJPI           YUSW            RLXYCUOIEHO    
ROXM            : ANCDRGDONVQHMH  IOWISNLCPWFSFGE SEKHTR         
NFFTJAWM        : HAAYQTAP       
RTUETX          : FXTHPOKAXWTEFK  SDKOGMEOGIVGYWA AOIGG           UEDWEOLI        MRHGEGGBJI      JYNVOA         
DAHJDBGKVUCMSQT : GQIYLQVIK       ORGNRLQ         NLBIBBSW        AIPMUKLXGYO    
VBFHBCW         : TRNESYYQGCYJQP  DTQN            WBKNSYVTNKRVJK  WOBKSUNTVFUB   
TQYXNWRSWY      : KBPP            BIIW            FQHHYIFQPPKI   
CAIMXGQNBI      : KCYIDIWLVTQU    OAELVP         
KGLPQMTNONEN    : PMFY           
TMGMKFRMHCCII   : SAMTGXH         RRTX           
VKDFWKQ         : MCWSFBYIDKXECS  HOEXLNSD       
BGJOWAUKOPWU    : IHPXCNXUNJ      PMRYTIDY        SDKOGMEOGIVGYWA VUIDJWMP        TUVLGHI         QBYGHQ         
JCVYLYBTJT      : HNMWD           TGSXDXFE        IRKCQFBBGLJG    LSKBDVUOPALNJMB DINSL           UWMVAMUNFHFYDCR
VAXTKQLN        : QEGFTXVSYA      MSQVDAFLEM      VUIDJWMP        MMCJ            POXUHOGHERX    
UEVWYILQGIXRM   : NOBVDBBUD       LPKIKOXWTFM     FCAUXNPSGBFCNBO GEMNFJKBAJIBL  
QYURU           : ADBBNFIKO       YVKVHTDUGCJ     HJYSJNP         DFCOKIVFB       BKBA           
ONDON           : JPWHPTFWYQLBYT  GRYJHNCXYDG     QBINUGJMKYKGBEO CUUIDNDGCXYMVL  WIGPVOOJNV     
BGKOGGU         : HFAPWYMJ        GARA            SHBS           
DTLRNTA         : WFNFHSC         IAROSALLDNLGFDF
NNHFODYJKPW     : GHHQOJBSB       NTXTHG          DXKESAT        
GKNHRX          : JOTQTJ          MPTKTLFJQCUH    GELQHY          PBGJK          
AGSCMPPEFLG     : LTJJRQ          WIMKRHO         QILIEDXIYW     
AVAHMFGWRYVGFJV : OAARGFBFEYMMQ   KOUAIBVYAXX     IMKHJUKUL       CHECANC        
BVND            : PBEHCMGTEJ      SHBS            QMOBM          
JFRBXXGJGYLF    : TFKLTVBV        EKDEDWITVUW     UIUPNPVFEUBBXU 
SRHCOYDNHIWFAA  : KJSAGJPRMNMCGG  WDUQCAJOQXQ     KAYTKBMJQRFCEGR KKHHWVWHIUHHS   KNLPTFWSPPO     PQWCLECM       
QDJAIBD         : PQKGRXUG        QARFBMAX        FVQB            HIYLLTA         VGBY            DLITKBNF        HANA           
BLUHMIMN        : QRCGCQDRBQDECBM QYULPXGQYP      YTWMXMRWSCBXQ   XQAGYNCWFPQDYFL PWGVE          
HWGXYLLG        : KKPDNYCMMK      FMMCLAJ         JBKIILRVIA      KEBMENWENXE    
IOWISNLCPWFSFGE : YEQNIEBYF       TJWBKM          IMCK            ROXM            PXERMSGXGMGR   
PQLF            : QDKQ           
PMEXKDJWLHHCE   : QTAS            RDQDJWYLFMXYKJ  SAEGHBEHP       HPKXCTQMHG     
UTCYJBGEJMILFBY : WGVQLWN         UEDWEOLI        VBNREAI         DNJQPWHBOVIRXVT
KOYOO           : KAYTKBMJQRFCEGR RVTT            IOYYWEIOAJAQWRJ
TXIFIQIMJF      : ISMMW           QBUFHYVLFBIGYB  JNUWKBJPX       VJSFGNEUESGX    RBXVNHIHYLWVYW  KGQRM          
LHSPNXYDIKIMM   : QLKRMN          SBTDUXGSRJEEDHP WWRPCQGFTS      KLSWRSTEEAMERBD YLDLELXV        TMPVQYH         WGYIJIJGYKMWG  
WBTNQFHQQO      : GACNYWF         KLSWRSTEEAMERBD GDQBFMPX        EQHC            MXNGGHGQSB      YFCTGO          MYATGYNSAJJUV  
HYOQFXEOQVCQU   : HTWRTWQMTT     
AIPMUKLXGYO     : WWRPCQGFTS      QSFOUDJENDGNKD  DAHJDBGKVUCMSQT
GIFUJOUXHCXNQ   : YDBLXWRX        NAETXNONSWTPUNP DQUDNUTUG      
KUGH            : QTAS            JYBU            SDJXLED         UAEJEBG        
IPSWMEILM       : ENNACDBWQEWDMQ 
CDPMK           : AUPVJK          YWADBJQRJMTY    MNMV            BJKJTHTOSEXGHWE
WBKWIOVYFNLATSD : TBEFUTBRLFIGQFG LRBJHTCNWIRK    QWRNIVEBKX     
LWCADLLR        : JYNIVGTG        VWXFMRQOOUNXYFR GNCKPXL        
QVNDIBA         : BWURLVJCM       NRXOQGADYTO     KPOSVOATLTQUBS  CKEPT          
NASCVTJJFJ      : DNOVMX          TGIPDVCUS       TCEWFHHJ        YSGESITHF      
BPKOONORBDJVT   : LNAPHLMTWGW     YRMOEMHAPQU     UMGWMQRHHX      KNBRSHTTHKIKK   IGYYOQNHRCAHAPK
LWQOABCCVEXQ    : SJYEPWULIL      EARIH           DYNJBLRLOICJODH QJTCXALPGPBYADU XJIBX          
JXAOYRCP        : OLKMJAGNTHR     WOCUTVEJPCMD    GEQDHBKKERK    
PFXQIJOE        : GLBGIPTH       
BDMPFP          : KYMHBQNBKHX     LVTCIRQR        XLLYNP          ICOLWXBHGPNJM   KEXP           
HLYHEPQFRI      : POAEJLXY        ADBBNFIKO       OHGPVQGRDNH     OTEMNWQKFXXPTCR GTKRKILKPGWLRT 
JKWPCEPSMBJSWK  : GQIR            TSKVLCEVRBPGYMN
JDCBV           : CLHS            KNLPTFWSPPO     DAHVENM        
PWTTMKBEUIPHHH  : ICSGEAPTAXIU    ICOLWXBHGPNJM   QLOCWM          LLOCHPMAD      
LYEABQSABOMGSN  : RWUEYBFALINH    FQHGQD          GBKPFCIPD       XVBISPIUFUFPL   VIUSTYRVQKU     PSXCSBWK        VHPXECVWMNX     SQKBYVCYHMDI   
FDCY            : GQIYLQVIK       ISMMW           KDTUMWPI        OWCMDQGVHUQ     DQUDNUTUG      
QLBXJL          : EKLVMMKL        KQOWECCL        GARA           
QUXDGWJIAABBES  : HAAYQTAP        WUDPGBVVBADQMLV MNMV            TFRWKJUGBLSX    IFKQEWGKB       YNJMJXSBJQAA    XOFBLBVQCI      JFXRHVPJON     
KNBRSHTTHKIKK   : KEXP            WYFN            BPKOONORBDJVT  
YYKTYPBVALW     : DPSRI           WGYIJIJGYKMWG  
NXIINVVQNRXH    : QEGFTXVSYA      BWSNGBRGLM     
FTVSF           : SGYIMLFVPPK     TOXBWAAXJCJG   
RGBLFQODSB      : MFCBRFKOIJPARE  BVMQWVIXBOYLCO  GWCOUN          QARFBMAX        KFKEPO          CCRGDNYMYN      LEKS           
XQAGYNCWFPQDYFL : BLUHMIMN        DXKESAT        
DGBTXJWJQ       : MAXDMYF         BVMQWVIXBOYLCO  ICPPUKYPGJNYKSU JPHHYJMHKPA    
BTLCWJUWPVLSSQ  : VRTWQKI         JVILEH          UUJLCDN        
MVKTJEYPHUPS    : WGVQLWN         UMCNJN          WUBCCCVCJLUFVFU
AJKDFVF         : FXMXOGXQKO      IJWVGQTML       GILXIXCCJQ     
FCAUXNPSGBFCNBO : VWNRGLLHJP      DICPXVRUHKNTP   UEVWYILQGIXRM   OFEQAKSEVKCDNBX
BEBVUT          : UVIAJISTWDACCJ  TYMWDSGHYPYOMA  EBRGPUWV       
WFBCMWHR        : PBEHCMGTEJ      YMKMGXEBPUNT    LOMRW           QUBM            JMQXDL         
LRBJHTCNWIRK    : VEGKYUDNRCKHOUO WPEDFDVNWY      DLWVAXRTBTVSJI  DNOVMX          EFBPMAGTSWJ     WBKWIOVYFNLATSD IAROSALLDNLGFDF
GEMNFJKBAJIBL   : UEVWYILQGIXRM   MCFHPTWSN       KUIDKGKO       
AUMGGGHPNDRDAC  : ANJAJOPDQBM     CKCDOTUOLPXDON  CPUHQTIIKBNDWD  KPNQGQOQYMP    
KOCOBPVMCYMLHPW : UNFLMYX         WONJCFTRX       TYMWDSGHYPYOMA  OPCUJCJWQKGR    RFSOOLNWW       MTJCUVV        
RRTX            : WGVQLWN         HJYAILGMXXHVGV  BOIYKAXWMYYL    ABCY            TMGMKFRMHCCII   GCEGIL         
DINSL           : YAHYN           JCVYLYBTJT      HFDNQFS         JKOCMTAJMPXIC  
WOKSYBWQFNMRPMF : PIAWVRLKXO      QETPENLACKOI    JGMEOJBM       
TWBBPT          : TQLPU           UUTIODVMPP      PQWCLECM       
NRBXITMQQBDLCF  : TTRJOKWBVOWCHM  TDVKENPSL       QMMEBDBO        IJWVGQTML       WONJCFTRX       OFBHLTAEJQLHYHT
SKWGE           : IBNROIJRW       QRCGCQDRBQDECBM LLEIJ           TKKJDYSRPONCA   GFLXGCDWCQHA   
UJSQH           : KBPP            WLXHARIHIXML    BYNB           
SYOQMIRNQL      : UULNV           YXBYB           SXTYGBOLMWR     WLQFRSC         YLDLELXV        DQXOFCM        
HFDNQFS         : PRPYFXRRDFMJP   DINSL           LVQVE           EBDEDAMDP       DXFYKKALB      
BFYHJQ          : BWIBTOLILMTX    XLLUVLMA        SCKLBBVJV      
VJSFGNEUESGX    : JWLYRVGPGPJKCD  RKVLKEUED       BPQVTRTKHYOLUKA BIIW            NOOXWYTADVTXFKS NSQUE           TXIFIQIMJF      PYHD           
VJSFGNEUESGX    : ECIYXQFJTQJJLM 
WKIHPNUIVPJWUK  : BWAUHXGUNGF     LBPOO           JXJNYBQWFGSP    LQQIKIDWBILN    TXAQLIUKY      
GBIENDJTT       : RAIJBKFUBX      RJVTKK          BDXHK           GXGIHJSR        XOFBLBVQCI      PUQVC          
RXHXYPUJB       : YJKQSXGNVM      LYELBDIGYIBT    VFMQQRGRBASRQ   TUVLGHI         PSOTN           TLAKI          
BOYJMOUJLIPUJA  : FEBKLNHOYBLPJAU SYTOQW          SGTGWQGUHOQ    
WGJRAYLA        : PROWB           UAFOT           HHTYLPYHBWEWG   HOEXLNSD       
JYYGKCLNSMXGEU  : KKNTOYKT       
PDIMPKMMQ       : GEKDNWW         DKDDWEXYWWWO    IKTGUXFRDCNVA   RIKKYRBCEDFDT   HOEXLNSD        YYVTMXKWOAVSC  
GSYRVI          : OAAWWDUWTSGGTFX VSIG            WUVBQPNGAYUN   
WJMILXVGMVMQT   : MMPIMU          CLHS           
JYNVOA          : YVPPS           VWXFMRQOOUNXYFR RTUETX          BKBA            TPMIB          
ERKMM           : RRRFJDLM        QEGFTXVSYA      LPJGXUS         FYQAVFYIWI      ALHLEYYNOLQVQA 
HIUKGEY         : YAHYN          
RWOXMLNDHS      : YENM            PIUARQIM        KFKEPO          DTXCYV         
GILXIXCCJQ      : WRDMQNOP        AJKDFVF         RTFFRODVSMNKIN 
TXAQLIUKY       : GWMESJBE        WKIHPNUIVPJWUK  WINSECOQO      
KQOWECCL        : APXODERFYJS     QLBXJL          MNDTGVIGH      
RTFFRODVSMNKIN  : LGUUWOAAVJTH    GDFATQJFGFGV    GILXIXCCJQ      XANMVL         
YYVTMXKWOAVSC   : EUFTG           AVBBQLVACQ      FPKTABQUPU      PDIMPKMMQ      
GARA            : MRCEDHWYUHHRF   EEIGMIT         BGKOGGU         QLBXJL          QGNESOFQQOALDIB
WUVBQPNGAYUN    : NBKBLUCAGAFP    PCSFCROPT       DJTGKTP         GSYRVI          KFVRG          
VKUIIFHWHD      : JPWHPTFWYQLBYT  GQCQPGOG        FUXXPNMDRON     AUEIKOKW       
KEXKVXRVSOWM    : HTXGPFV         KSKUDIAESWBA    LYVCGYTQGGOXS  
MUGLRUMO        : UPSEVJXPE      
HYPOHOWMG       : LGUUWOAAVJTH    VPXAI           PIAWVRLKXO      GBNRPPDBRHIK    BYXYUHYNQE      XLLUVLMA        YWDPTGNOVQTSHQN
QETPENLACKOI    : CBDP            GEGWJKJJAS      WOKSYBWQFNMRPMF QBYGHQ         
JRNCOAQV        : TNTKGVIJQBMTNB  KOUAIBVYAXX     OTYKSYHA        SDAEJQU        
RLXYCUOIEHO     : TNTKGVIJQBMTNB  NWCVOPBMVAOJD   WKABMGYPEDRTFT  DFRTIA         
WSOKUSWJCWTV    : YJTI            XJDP            JNRNLE          KWVJVEBOHIKKGXF BYDMBBYATUCJF  
VKMOIVGTTI      : TECQDONVTIYJAVF OGXSJUJOS       EHAYMCQFNWWNTEE YRBRWL          YUSW            TBSTSOKD       
PWGVE           : QCHWLFMPSO      JVILEH          WVDMFGWAJFEUQFA BLUHMIMN        KCYIDIWLVTQU    KAXCAHPJHHDDH   JHAPX          
WERLQNE         : TPPYRXSWWFVNDAK TPPLTNTYUQCFDHH TUYGKWYLKS      AXHI           
WINSECOQO       : KBPP            LTGVQMSOTMT     UPHRYNDA        HCLVJHKVLPI     WVDMFGWAJFEUQFA TXAQLIUKY       GXGIHJSR       
YMOUIWSAVBWC    : KCSVBDHFKAI     ULTBVW          YYTVNJARMNIGO   TGIPADNVQNQ    
TIQFCELSDU      : VKLWQLNT        EONSJCT        
WBKNSYVTNKRVJK  : XYLJRDOUKTNIQ   MXPMNUQB        VBFHBCW         XIFQDBXMIYX    
HOTJOP          : QFSCPPW         FTSFPVQGPOL     TLIEYO          RJVTKK          NCSHLYTH       
FUWLGPRD        : RIMCVB          TDVKENPSL       EQHC            MTIYXJHDU      
OFIEAJA         : PAKNCEJWPAJO    RYORDHVQXCDD    UWMVAMUNFHFYDCR
YMNUVBTDPPP     : DMBLAXV         SQLEGTQGNSE     UQMIRJKWSDAB    IGWEMGMPGVL    
FMMCLAJ         : DMBLAXV         LBPOO           HWGXYLLG        MATO            UCOVSPKW       
ROBGVLNXW       : RHDJXED         QDGB            ANCDRGDONVQHMH  KCYIDIWLVTQU   
UVDKSBLPHDF     : AMHUNLJCSEUE    QPPNO           JBKLBJP         MPQQAFVUS      
KLLYPW          : DVKWWHMVEMD     ETYTJVT         TRNESYYQGCYJQP  EGPAJTQEYY     
BARQBAMO        : UQSWE           UGGVO           BQUXOKKWYWJR   
LLEIJ           : DLQNEFDBJMWD    GBNRPPDBRHIK    NCSHLYTH        SKWGE           SRLSDO         
SEKHTR          : DLQNEFDBJMWD    BASE            ROXM            DVMCAHP        
CQWPCVFBXH      : WFNFHSC         GBJHSWA         FJOHKNCUCYQS    REMJROLRPGAO   
PXERMSGXGMGR    : NJXXKSVGEKJ     AEGNNATX        CCRGDNYMYN      EGMU            IOWISNLCPWFSFGE HJEYXLD         VTQIFUGPFD     
CWIJSBVUTTKYRQA : SKCBPORJRNNSS   OWJYAUVPKFL     XXJB            NSMLIBX         JFNMHMPM       
XCHVIAIEIJKWR   : TPMIB           AXHI           
UTCFD           : NAETXNONSWTPUNP DDFTVJVKOYUC    BFDD            MAGMYKIQ       
IAQDVBCNREGRI   : CRBFWG          FWWGWMBOKPV     LNUDEQPPRH     
NRPYVA          : PIHFLDUPIX     
IYCNVWRCCP      : QCNC            GQCQPGOG        SMEY            DYNJBLRLOICJODH LCKQVKVVGKR    
EGPAJTQEYY      : KLLYPW          WOGGB          
HOMYHNWHXIJC    : YSIPJFESJMIXQ   SGTGWQGUHOQ     JUSOE           CUUIDNDGCXYMVL  WLORNYCNBAFHOYM VTQIFUGPFD      UCOVSPKW       
FYQHEGUIMMJXHC  : JOTQTJ          HJYAILGMXXHVGV  BFFWYMYPXYEKJ   AVXAIYEHVAV    
IBBPPP          : SAMTGXH         OXDNLMECQSJSOUE AGBXFVLSV       SDAEJQU        
WFQHDYQH        : TECQDONVTIYJAVF DTQN           
XHOINUD         : HPANSJR         EHPCA           AOAFAEWDXHBIUU  OLKMJAGNTHR     SMEY           
JPHHYJMHKPA     : NFNUE           DGBTXJWJQ       LOFBTFAKDIUSLES
HTCMKL          : KTFRBRULBYUBQ   SJYEPWULIL      ENLVOQMXJDO    
KCYIDIWLVTQU    : HOEXLNSD        XCTUCUPYXSGWTBH CAIMXGQNBI      PWGVE           ROBGVLNXW       LWIJFFHL        QOAS           
ICKIMYR         : CBDP           
QREXLHM         : GXSOTGMDYGC     SSTKX          
SGJX            : HAAYQTAP        JJEIA          
TBQSMPMF        : JDUI            HKADHBORM       LKBDJNBXTOQXJVJ TDDE            LHXXBFUNHABK   
RNMEVBEQDW      : FWWGWMBOKPV     GBDNRV          HGSPFHCV        HPDWLO          IGWEMGMPGVL     XLMK            PGHBKPUSR       XCORNFW        
HXWOKXIR        : FYQY            BUIVD          
ICDJSXXKMDUEQ   : WQSKS           FTSFPVQGPOL     AGWMYGRECYAMSPX TONSEIAKWJ      LEKS           
KPNQGQOQYMP     : WGVQLWN         GICBHU          EBTDOFBPRWLXBX  DIBOOBICLLGN    AUMGGGHPNDRDAC  SGYCRNTPAHJP    OQNSSWVKNONYCS 
WNAQY           : ONMUOJCYQNUFVT  DFRTIA          TYMFVRAK        ELUQYQHGRUTJCXP
SCTOCRBQWYUQ    : RTTX            BQCSOQHYL       VOEHLSCMDA     
IGYYOQNHRCAHAPK : VMVRJFGOQSYY    BPKOONORBDJVT  
PSOTN           : WVTXQTQNQYJ     RXHXYPUJB      
WHGNF           : VAYNIRDHYOXR    OFEQAKSEVKCDNBX
LVQVE           : EPJJI           EKLVMMKL        HFDNQFS        
UUJLCDN         : JPWHPTFWYQLBYT  BTLCWJUWPVLSSQ  IHMXQMBCMFWMJK 
MNUWJMSAGG      : WRDMQNOP        UJQYNQCR        VPYOOUFHCMDRRUX YHMJYPQVYFRBGU 
FPNVWVJUOFYH    : KWVJVEBOHIKKGXF QXGBX           VWDQKKWLWOQY    CQUAVUNACWQW   
TQLYVAFJPCGB    : WRMI            EDJFVRCEITPLP   YGHRLWIOKB      WVDMFGWAJFEUQFA RIGMAFGDHV      GEAQLCWVPFUGX  
BDXHK           : XDTRIVKNNXJJII  JRJH            UPIKRT          GBIENDJTT       ECIYXQFJTQJJLM 
AYBWWMSLRT      : PYUFKOXPWD      DBBBJSJMXF      JNBHILDUIXHPEX  EUACNPND       
UQMIRJKWSDAB    : VEGKYUDNRCKHOUO PLTMQRROMBYH    GWCOUN          HTXGPFV         DYNJBLRLOICJODH YMNUVBTDPPP    
QDKQ            : PQLF            VPYEEAOMTVL     NWWI           
UWMVAMUNFHFYDCR : WWGPSAGV        NYWBSFRKQRXP    JCVYLYBTJT      OFIEAJA         UHXQJFKJ        KNCSFUF        
LJBXHTBJXIABS   : QOATQGTKVGSTYDS CLILGYAX        HDRMINIJHTP     GYRMOHHGFLLI    UPSEVJXPE      
PPQFMQRHEY      : FAUNOWO        
MATO            : OMJFXWNMTVM     DLQNEFDBJMWD    HYOAWVBWETOB    MPTKTLFJQCUH    CIWKMUMLRPOV    FMMCLAJ         MCCNBJKEUIMXL   VJCWAOQWC      
MATO            : PBGJK          
MCCNBJKEUIMXL   : UCIA            MATO           
RBXI            : IBNROIJRW       MDVORKCYXJCHU   NOBVDBBUD       WWGTJWW        
MYATGYNSAJJUV   : YXBYB           MGMA            WWGTJWW         WBTNQFHQQO     
WKRJU           : EPXFXDHMMSGKO   FMLKYRJSBHHGK   GTKRKILKPGWLRT 
EFJCQSTR        : RYJSEDHI        WOGGB          
EBDEDAMDP       : FHIHHQJ         FPKTABQUPU      SCOT            GPXV            VWNRGLLHJP      HFDNQFS         JJKGNXT        
FYQAVFYIWI      : KRBLQHBUAXUXTWD EDLKFJPPTIM     ERKMM           JHAPX          
VPKH            : KTFRBRULBYUBQ   SXLN            THAYRQOWHTGTP   KFJSDX          SFGRGQLIQVJVGJI VPYEEAOMTVL    
DAOWRSXW        : XVRVMJBAYSNO    DPCGQJPHKDJ     UIBMSIFMUBY     FOLIOBJ        
CYLHOSOOMQMRPW  : XJTNDG          MWJHFLKW        YRREXGDEUAIJF   QJTCXALPGPBYADU MKCBFE          HJWM           
BCPSOWMRWD      : WKRNLSKPBBPMCGJ
OWPOXTNMBDFR    : CXENVHCYXACGE   WVTXQTQNQYJ     INKNQPYFFDM    
RIGMAFGDHV      : JOWRINMMWUFDDRB RIWNXVLHJ       TQLYVAFJPCGB   
VSJPP           : ULIKEYQLDIYW   
EHLTXMNLYQQGKK  : YTWMXMRWSCBXQ   WESKOYBYBNBFTMC
SSNVXVBHRXFMJU  : AOIGG           BWURLVJCM       VSIG           
XANMVL          : LWUNO           ITPRLRFCQL      LLUG            RTFFRODVSMNKIN  BXOATPEFCS     
MXAD            : NRLGDH          RPRM            AHEUVHEA       
GOCHJ           : SSTCL           FSWXQHLGMNQL    ADBBNFIKO       YAVFIOGCBWJ     VHPXECVWMNX    
UHXQJFKJ        : UYDYXSXQLKJDFS  CXENVHCYXACGE   UWMVAMUNFHFYDCR MTJCUVV        
YSGESITHF       : MPMAVMJUL       DLOBPYNQFMVVY   FPRXOEPEEDR     NRXOQGADYTO     VIBJMUX         NASCVTJJFJ      LYSBYNN         FODFTATOKJ     
IRGIWWR         : TEIQEPA         PQKGRXUG        SQLEGTQGNSE     WSBH           
BYXYUHYNQE      : MNCHRAKQ        VWDQKKWLWOQY    THIPVHBRDGGO    LAUSBKQAYAJL    BWIBTOLILMTX    JFGGJXNTNSPJE   HYPOHOWMG       PYHD           
CPAUYEQHYXMHJG  : GRYJHNCXYDG     BHIK           
REMJROLRPGAO    : YBFXODOHEN      QIQS            CQWPCVFBXH      GLBGIPTH       
SSWVLXSME       : VRTTHRAYYFLVE   QYULPXGQYP      TWKKMHYF        WIMKRHO         PKWQALRBPLRQDG 
TDKJKTPANT      : YUUPKMTNILLC    UNFLMYX         MNAEGQFYUS     
AOCLG           : XVRVMJBAYSNO    QQKIKSFU        WNSERQQVB       CUUIDNDGCXYMVL 
TGIPADNVQNQ     : MESRNVIXAUGXVV  HUIOOBWGANP     BJBRGDKQRD      REXPOLOERDCLFM  YMOUIWSAVBWC   
RBXVNHIHYLWVYW  : WPTBJUSRS       MMPIMU          FQHGQD          CVQF            JPWHPTFWYQLBYT  NMQQKYG         JJJRJU          TXIFIQIMJF     
DIQWCAFSAIIX    : UULJYOMBBEQQBRM JFGGJXNTNSPJE   TYMFVRAK        LYVCGYTQGGOXS   EJPEEBANBKMC   
VQFNRDLFMWO     : RKEINTKBNPP     BELP           
IMKHJUKUL       : OGXSJUJOS       OTYKSYHA        AVAHMFGWRYVGFJV OCIAI          
WLORNYCNBAFHOYM : YJTI            KYTPTRODAM      AHNHIMQNYOSDKI  HOMYHNWHXIJC   
HCYXQJKBQWVD    : VEMEJUMRIRVWVR  YABPVYCMW       GLBGIPTH       
JMQXDL          : HFAPWYMJ        IKDGIKIKSCECRU  WFBCMWHR        QBYGHQ         
DPCGQJPHKDJ     : JLCJWPJTXJB     DAOWRSXW        OQNSSWVKNONYCS 
FLQVW           : AMWCTVADY       IBNROIJRW       JEGWWNXRNXO     UEDWEOLI        JOMFTSYCLKKEIV  EHJPFTE         MCFHPTWSN      
WOCUTVEJPCMD    : FMMRLAHGA       JXAOYRCP       
RSUYJGO         : JHBHHPQJBFAGVBT GWXRHHCAIURF    HJYAILGMXXHVGV 
QTDLYQEWNHTEK   : MAXDMYF         LDPXIHJQ        OSQAPRXCPHXSCE  MPQQAFVUS      
BGVKXAWBS       : UPNX            WOSBKVCS        HHXETPUFJHUMJ  
UPSEVJXPE       : BVRPQTUST       DNNPLPIL        BIKHEQMAOSD     MUGLRUMO        LJBXHTBJXIABS   PDVAPYWRQU      FUKTPLQWQLGM   
BFTFD           : UNRGOPK         UVGJTEOOSJROI   MCFHPTWSN       FYRERVSRPASK    AUEIKOKW        PPNCTDBXQYFDETI
OYOYQP          : PQKGRXUG       
MAGMYKIQ        : OHGPVQGRDNH     RYJSEDHI        UTCFD           HANA            OULT           
XLLUVLMA        : VMUM            GNCKPXL         BFYHJQ          HYPOHOWMG       GTNEMKDRPAO    
PFIUKSLKHLB     : NFNUE           UMRUO           GEGWJKJJAS     
VPYEEAOMTVL     : AOAFAEWDXHBIUU  QDKQ            VPKH            PUQVC           YDUMUKOVWQLNMDL
IIBT            : XJDP            VWDQKKWLWOQY    RPRM            SNADDUXEI       QQKIKSFU        OFICDTA         HPKAHO          SKFDTDAJB      
BJKJTHTOSEXGHWE : CDPMK          
VJCWAOQWC       : NSBDT           SKNYJLSTUWTDR   TYMWDSGHYPYOMA  MATO           
HKADHBORM       : LOSWEJV         TBQSMPMF        QOHM           
BJAWNYD         : WXQQ            PVTUPUHSQPSO    VIBJMUX         XNYS           
VIUSTYRVQKU     : GBHBKGAEENIS    SROQHTCTVAKIRHR TKXCSX          BQUXOKKWYWJR    GELQHY          LYEABQSABOMGSN 
GCEGIL          : HBQJXMMKWERQME  YMKMGXEBPUNT    TITPLQPEIAR     RRTX            KHLMRV         
WGYIJIJGYKMWG   : TYMWDSGHYPYOMA  LHSPNXYDIKIMM   YYKTYPBVALW     WSBH           
TBSTSOKD        : MSEERN          PBDXPDAJLH      VKMOIVGTTI      UIBMSIFMUBY     MMWJMXJ        
DMOJUWXHWGHFP   : TECQDONVTIYJAVF HYOAWVBWETOB    UHANBQWX       
QYQBN           : JWLYRVGPGPJKCD  JELFLR          QREFO           HCGHKGS         YJFF           
IKKJDGFTQK      : HSICHNCMQKXDJ   JVILEH          IFKQEWGKB      
VYVGUUGE        : EYGHLBD         GFLXGCDWCQHA   
MNAEGQFYUS      : GEKDNWW         WWGPSAGV        LPJGXUS         TDKJKTPANT     
DFCOKIVFB       : VGNHPEMVJEIM    QHLTVLYWCRIHF   QYURU           LHXXBFUNHABK    NYXDHSAMLXFYG  
LWIJFFHL        : GUIQHNVCPMH     AYXLEWUK        HFAPWYMJ        SJYEPWULIL      KCYIDIWLVTQU   
YAXBHGSOGPKXUP  : OCGI            MTJCUVV         AWUNNDVVYNQD   
JBKIILRVIA      : NYWBSFRKQRXP    JTRULSXAGYG     JVVQVMVKHQAKQW  CJLLFWBQD       VOEHLSCMDA      HWGXYLLG        XLMK            LLYUYOV        
QGNESOFQQOALDIB : PNNOBFDBREALQVR GEGWJKJJAS      XRCVIQHVNT      GARA           
GXGIHJSR        : UULJYOMBBEQQBRM LLOCHPMAD       GBIENDJTT       WINSECOQO      
GJNOMVHU        : MMWJMXJ         JKOCMTAJMPXIC  
MNDTGVIGH       : LIAUJLIKNBHUJDK NSMLIBX         KQOWECCL       
OKEWIMHRVAMPGXF : MDBSR          
MCFHPTWSN       : GEMNFJKBAJIBL   FLQVW           BFTFD           IOJG           
OVMXME          : HUIOOBWGANP     LGFEBSTPC       WMNECCLQTAIDJH  HCGHKGS         ALVJHOWSXSEE    LEKS           
SDUFLPB         : GEKDNWW         LGFEBSTPC       YEQNIEBYF       FFRTTWNOX       IGUALXQSB      
CQUAVUNACWQW    : OCGI            XVTTUBJRVAOQ    VSIG            FPNVWVJUOFYH   
LKBDJNBXTOQXJVJ : RTTX            IKTGUXFRDCNVA   JEGWWNXRNXO     PMNCLCPVHURBVE  UHANBQWX        TBQSMPMF        XFLH           
YWDPTGNOVQTSHQN : UNRGOPK         HYPOHOWMG       OYQV            BELP           
DQXOFCM         : PKUFKIBTCSKQUTN XQVLENVY        POAEJLXY        DLWVAXRTBTVSJI  WQTC            SYOQMIRNQL     
QFYCBKCAIH      : TFKLTVBV        ICPPUKYPGJNYKSU NGQWMPOY        GVVJGGGYHWURU   ILXX           
CNITJYNDIGSDL   : JFNMHMPM        LLOCHPMAD       HPKAHO          SHBS            FODFTATOKJ     
EBRGPUWV        : JOWRINMMWUFDDRB POAEJLXY        KRBLQHBUAXUXTWD DPSRI           BEBVUT         
BYHFCPNVUBEQ    : KAOLXFHKMVGOQ   GQVX            VGOI            BTJPI           UHEDGIP        
FGSNMLTA        : GWMESJBE        CYPUFFLIO       HTCVEJ          DLITKBNF       
XBRGTNF         : VVYDBEUUATK     KKPDNYCMMK      ULTBVW         
KGQRM           : CGYAKDLSLFDWE   OKNSMHNV        YAWQHD          TXIFIQIMJF      BPPT           
KARHDVAQEGLRUAN : AHNHIMQNYOSDKI  MNIN           
XNYS            : DYOQJEN         LBPOO           OFICDTA         BJAWNYD        
UIBMSIFMUBY     : QYULPXGQYP      ADWB            DGKSBBJUVTNYTL  DAOWRSXW        TBSTSOKD       
SICQKVUQHPN     : KYTPTRODAM     
DLITKBNF        : NFNUE           QQTHO           TKSNC           QDJAIBD         FGSNMLTA        WSBH           
RTGAYUWAWVUFXMQ : SGGKUXQ         JRJH            YAHYN           JNBHILDUIXHPEX  MSCIMATYP      
HJEYXLD         : OIBKPOK         TCEWFHHJ        PXERMSGXGMGR    BHIK           
VYVYODKGYQ      : LSKBDVUOPALNJMB SCKLBBVJV      
XOFBLBVQCI      : XOWXM           PNWXKKLVOGAKKW  QUXDGWJIAABBES  GBIENDJTT       OSXECMMMTEB    
XSVCRVQWHM      : MNCHRAKQ        PFMQQGIDICGXD   VLVLXACUCR      NOOXWYTADVTXFKS
FMLKYRJSBHHGK   : QGQBKCDYPAY     PIUARQIM        CCRGDNYMYN      FUUXYHRSPCBV    WKRJU          
KHLMRV          : DRXPHXCXW       GQVX            YSIPJFESJMIXQ   GCEGIL         
KTPFPGC         : EJVYTAGJ        THIPVHBRDGGO    GHHQOJBSB       KATVAHV         CVTB           
UYEJKOJEXEFHL   : SRLSDO          ANEGUPGB        DNJQPWHBOVIRXVT
SGYCRNTPAHJP    : FJWWO           MMCJ            KPNQGQOQYMP     FXVPHD          PMFY           
BXOATPEFCS      : FJLYISC         PIUARQIM        PGXSQDFHHC      XANMVL         
HSUOB           : JJJRJU          YVRLS          
DVMCAHP         : CHGMXGMSMYJG    SEKHTR          CIWYUJ         
WSBH            : SKNYJLSTUWTDR   PMRYTIDY        FNSI            IRGIWWR         WGYIJIJGYKMWG   DLITKBNF        WOKKUPXIMAAIVP 
PIHFLDUPIX      : YVPPS           MPTKTLFJQCUH    SNADDUXEI       NRPYVA         
AHEUVHEA        : FFDBOURMYG      MLPY            MXAD            ILXX           
SEFAWCXP        : PMRYTIDY        RJVTKK          YVRLS           PSDAW          
FXVPHD          : WRFNNKMOEY      SGYCRNTPAHJP    YQLWDSMVITJIDX  YCMW           
KATVAHV         : DGMWV           KTPFPGC         NMTBVFF        
LSEVWGDQKJQJ    : VLVLXACUCR     
OYQV            : YNJQJD          DGTNSBUPWUX     BFDD            YWDPTGNOVQTSHQN
OOHRRUS         : OGBUSTCXLLXBVT  TSQAD           YBROTXCCQPOKCO  IGCUGHDPOTEBX  
SSUOBJHH        : SJLBSODSAYJURJL
HPKXCTQMHG      : PMEXKDJWLHHCE   XFLH           
BELP            : BOIYKAXWMYYL    VQFNRDLFMWO     YWDPTGNOVQTSHQN EJPEEBANBKMC   
VINSDD          : QIFMST         
VYCYIL          : KJSAGJPRMNMCGG  ENNACDBWQEWDMQ  IOYYWEIOAJAQWRJ
PSXCSBWK        : JXJNYBQWFGSP    MSEERN          TUVLGHI         HHTYLPYHBWEWG   LYEABQSABOMGSN  LEKS           
GSBH            : AVYMK           VWJNU           WJRJPFBYDO     
PXULIIGLLRJMV   : MNMV            TQLPU           FJWWO           RXBCSDCWUKN     CXCEGIWXAJGDFDT
WHRODS          : EJAPH           XLFDCXIY        RDQDJWYLFMXYKJ 
VTQIJWBKHDAFX   : UGGVO           RYJSEDHI        OWJYAUVPKFL     NLPOXAUVALJJ    HCLVJHKVLPI     LCKQVKVVGKR    
PITBTNMJJVGT    : CGYAKDLSLFDWE  
VWJNU           : MRCEDHWYUHHRF   TKAXBJI         GSBH            WJRJPFBYDO     
GEQDHBKKERK     : CKCDOTUOLPXDON  RLYKQFUWGIJ     KCWUEUTQV       JXAOYRCP        XCORNFW        
HSOKPEXYO       : UMGWMQRHHX      LXMNELKWUQLSMD 
FIODHXQEFYK     : ROFIWVXEIKBEWF  WFAXVBQXJQD    
DUAPHGISA       : HWDICUDL        NLPOXAUVALJJ    QVGADARRASWUIF  BVSPJNFKHPMBOEJ
LOFBTFAKDIUSLES : YXGMCSWAXVC     RWKRLKWL        JPHHYJMHKPA    
IYETWH          : EXXKCKYLNWASHM  OHDBIJSHGEQU    UAEJEBG        
YAVFIOGCBWJ     : SXWHGVKQBO      EDSQ            GOCHJ           KEBMENWENXE    
QOFDSNXNYCGENH  : TYGPWSOTUHF    
HFSVGSRMDJ      : GYFFDFTG        FYQY            IXDNTAOU       
IMRR            : BEBCLPYRSHA     QXGBX           LNAJCRQ         GNCKPXL         BYNB           
LJVOCLP         : BVMQWVIXBOYLCO  CPJMASRQ        WAIXLXUPENFTFP  LTVHKTJGXTLK    IJJDUNMRGYXYMCQ UVSHYCMPDYH     PDYSNSKQOLJP   
NTXTHG          : PBEHCMGTEJ      LTBHNN          NNHFODYJKPW     KLHYPQY        
ONYMTTHGAQBI    : RYORDHVQXCDD    EDJFVRCEITPLP   PIAWVRLKXO      KNLPTFWSPPO    
VATHJSXNENFTKGO : GIVXQRRMDXEBIL  KCWUEUTQV       JNYYB           VBNREAI        
MTJCUVV         : UVIGACQ         RDTLRJWWGSQ     KOCOBPVMCYMLHPW UHXQJFKJ        YAXBHGSOGPKXUP 
DFRTIA          : WQSKS           TKXCSX          HIYLLTA         RLXYCUOIEHO     WNAQY          
ECVNOOMEUCMRM   : GOPFMMTUKEJNGVJ XOMKG           NLBIBBSW        ICDGFU          NWWI            CUGSK           ALHLEYYNOLQVQA 
GFHAOJVKH       : UVSHYCMPDYH     UIOSDRTN       
QOHM            : UCIA            BNXCIDDQP       EJAPH           KYMHBQNBKHX     YAAOQ           IFKQEWGKB       HKADHBORM      
HOCLKSCBFJXH    : KOAWCCRYMHTTO   TQLPU           GBKPFCIPD       HHXETPUFJHUMJ  
PUQVC           : JNYKNWSNUQRLS   IKWKUK          TEIQEPA         CKCDOTUOLPXDON  GBIENDJTT       VPYEEAOMTVL     DQYHNOSUVHIEY  
YQLWDSMVITJIDX  : UJNG            TPPYRXSWWFVNDAK TSNB            OPCUJCJWQKGR    DHHMJHSMLIRIKY  FXVPHD          CTBBLWKENVHOT  
QKFTLKDLUBCRRA  : JNYKNWSNUQRLS   QJIBXFYBBFFR    OXDNLMECQSJSOUE OKNSMHNV        PNNOBFDBREALQVR JSBAS          
TYMFVRAK        : KTEOXFDWCGYEQK  XWPGVC          CKEPT           WNAQY           DIQWCAFSAIIX   
KEASHAGYKNUXY   : JXJNYBQWFGSP    OAELVP         
JVYLNSOHMNTTMLT : LBGDTYHXOD      NLPOXAUVALJJ    WQVCOKYME      
CHECANC         : GWXRHHCAIURF    QJIBXFYBBFFR    RCAEQH          AVAHMFGWRYVGFJV
MMWJMXJ         : AVOE            TBSTSOKD        GJNOMVHU       
TKKJDYSRPONCA   : KTDBVRDKMTBLX   SKWGE           NGSIUUXLU      
BFPHHRV         : RGVQX           UUTIODVMPP     
BKBA            : DLQNEFDBJMWD    SXCMI           QYURU           JYNVOA         
OAELVP          : UULNV           CAIMXGQNBI      KEASHAGYKNUXY  
FUXXPNMDRON     : EOHATJLKDP      SLTY            XLLYNP          GLROTVPEQTKVALP VKUIIFHWHD      VUJKOFWL       
TDDE            : TBQSMPMF       
BSBLTDIIDNVY    : NSBDT           JFNMHMPM        YLVESFQ         VCAFOO         
UGAUEPKSVEJ     : EJAPH           BIKHEQMAOSD     CVQF            HCNW           
BGPG            : WLURLXQ         UXYC            AVOE            ENHS            HSSINBGSOPFOPU 
NHFOTYR         : SAMTGXH         ENNACDBWQEWDMQ  UVGJTEOOSJROI   HOEXLNSD       
KWRIV           : OSCECXFOYRU     POXUHOGHERX     PYUTHNHUU      
FCAAIRMD        : SROQHTCTVAKIRHR YXGMCSWAXVC     MPTKTLFJQCUH    LRKFPYGSB       XLMK           
QOAS            : SSVRAJLGQKENTE  KBPP            TKXCSX          WQVCOKYME       OHLO            KCYIDIWLVTQU   
PYHD            : PPMFQJLKJIPY    DLWVAXRTBTVSJI  DQUDNUTUG       GBJHSWA         VJSFGNEUESGX    BYXYUHYNQE     
MTDONHBKCJI     : UGGVO           KAIKSHABG      
RMDRW           : JVRKPCWSSGVVORU QIQS            SRLSDO         
HANA            : GXMENACEUY      MYOPRKRN        EFBPMAGTSWJ     DWGSMDMSRVW     QDJAIBD         MAGMYKIQ        KUIDKGKO       
NSMDUVGEJAJ     : SDKOGMEOGIVGYWA SQLEGTQGNSE    
PSDAW           : YENM            SEFAWCXP        QGBLLRFEENF    
KYGWEYTCIVQIN   : EJAPH           GIXP            JOMFTSYCLKKEIV  LFUNQRCTDVRSRNA
ECIYXQFJTQJJLM  : VJSFGNEUESGX    BDXHK          
JCWKIUOJQTTPK   : TTRJOKWBVOWCHM  XJTNDG          EAJGUQSJOJJUUP  AGBXFVLSV       IOYYWEIOAJAQWRJ
FQHHYIFQPPKI    : KLCHYX          MABEK           PIHSPMXADUNIFYX QRQAWGRMWYWD    TQYXNWRSWY      OKPLFDCLA      
VTQIFUGPFD      : NBECVKCOJIWCAWK PXERMSGXGMGR    HOMYHNWHXIJC    ORJYSC         
RVBLNLO         : YNJQJD          YAWQHD          LMFKQU         
CXCEGIWXAJGDFDT : JKUORPHQEYGPUIM ASMIYGRLQRDBEE  PXULIIGLLRJMV  
IOYYWEIOAJAQWRJ : AUWWHXMNHDMRXJ  BWIBTOLILMTX    KOYOO           VYCYIL          JCWKIUOJQTTPK  
PMFY            : LYENSWWN        RKEINTKBNPP     UUTIODVMPP      KGLPQMTNONEN    SGYCRNTPAHJP   
CWYNECT         : GEKDNWW         UNRGOPK         XCTUCUPYXSGWTBH EHVCXOIVOOLSP  
WKRNLSKPBBPMCGJ : JLACNJNABCWUB   BQUXOKKWYWJR    BCPSOWMRWD     
SLJHSKGXIFL     : INGLSLDOYP      CBKMRT         
HHXETPUFJHUMJ   : YXGMCSWAXVC     OSQAPRXCPHXSCE  QFIBOBKRVWCJHM  BGVKXAWBS       HOCLKSCBFJXH    NAXNIGHXD      
ALVJHOWSXSEE    : JUTEAXSNCESJ    RPRM            JCEYQUSXTNNK    OVMXME         
MJEDRMBXGSSMC   : RRRFJDLM        FOHINY          EKDVSEILSTMBF  
JRKWRXTDH       : KBPP            QEIGTHMDBAALPNP HCGHKGS         GTKRKILKPGWLRT 
DAHVENM         : KYTPTRODAM      JDCBV          
XQVPFYNMSJBWMKO : BICJXLFYR       WWMFIQGL       
IGWEMGMPGVL     : NACGMLGF        TLLYUWI         GOAFPBWRNKOYL   DUEMVHJV        YMNUVBTDPPP     RNMEVBEQDW     
KAIKSHABG       : MTDONHBKCJI     SRLSDO          AUEIKOKW       
NBYQYLDNM       : YDBLXWRX        DUFMOAEJHSUC    JJKGNXT        
WJRJPFBYDO      : BVMQWVIXBOYLCO  MMPIMU          JDUI            OGBUSTCXLLXBVT  JTNSW           IKDGIKIKSCECRU  GSBH            VWJNU          
PQWCLECM        : SFFUH           IHPXCNXUNJ      SRHCOYDNHIWFAA  TWBBPT          YHMJYPQVYFRBGU 
UCOVSPKW        : JHWFLRRCMNRYNIS FMMCLAJ         HOMYHNWHXIJC    WOUMFYYQTYUDFX 
WMDJFOBMPAPGO   : INHBRQMB        VMWXSX         
WOKKUPXIMAAIVP  : KDVROXEYCAA     UXYC            VPYOOUFHCMDRRUX WSBH            JTHYKWBNPQD    
UVSHYCMPDYH     : YVNSOLOIKXD     RVFHM           LJVOCLP         GFHAOJVKH       WVQWWDCUWMSOV  
RNWCMLMXJEXRQXT : RWHLTEHWXU      DKDDWEXYWWWO    DNNPLPIL        EJPEEBANBKMC   
VMWQIPYK        : UNFLMYX         CLHS            UHKHKU          HCGHKGS         GTNEMKDRPAO    
NAXNIGHXD       : YGHRLWIOKB      OAGVVPQTLPJFWU  HHXETPUFJHUMJ  
LRXLBDJ         : JGESLARSVOUSPU  YAVIUVUWLFVBOL  PPNCTDBXQYFDETI
VHPXECVWMNX     : PBEHCMGTEJ      IKWKUK          GQIYLQVIK       UNAK            LYEABQSABOMGSN  GOCHJ          
IMXG            : UMCNJN          PMRYTIDY        XEQYXOTIXJLYVLC
IOJG            : ENOD            MTIYXJHDU       MCFHPTWSN      
SRLSDO          : GQIYLQVIK       AMEDRVPGXINWM   CHGMXGMSMYJG    LLEIJ           UYEJKOJEXEFHL   RMDRW           KAIKSHABG      
OKUYCUDGS       : LJJPVGPMRT      VBNREAI        
SHBS            : CXENVHCYXACGE   BIKHEQMAOSD     PCVVHOQICWEWJ   BGKOGGU         BVND            CNITJYNDIGSDL  
NSXRBMBH        : ANJAJOPDQBM     BWURLVJCM       LCRTPOMCYCJA    WDQFKNFTSLOL   
VCSOFHPWTMVVHBE : CBOBAVCJIIHG    VWNRGLLHJP      BFDD           
DXKESAT         : TDVKENPSL       CKEPT           NNHFODYJKPW     XQAGYNCWFPQDYFL
XLMK            : MBTRACBRNKVRSS  RNMEVBEQDW      JBKIILRVIA      FCAAIRMD       
TSKVLCEVRBPGYMN : XFDDGE          KPMTTWCTBHJLCX  MESRNVIXAUGXVV  JKWPCEPSMBJSWK 
QQDQBK          : UJQYNQCR       
DEUDSJPHE       : GDKPIXYPCELT    NOXANWKJBLXKV   XJTNDG          HXKA            ORGNRLQ        
UCUWIQQLHWKVMK  : MYOPRKRN        SDJSQPVP        CLCNMOKX        QYUDMAKNRJMS    UMGWMQRHHX     
GOGJYRNFP       : IBNROIJRW       YLDLELXV        HGSPFHCV       
XYHIFQ          : RMXECKIITIJW    JKUORPHQEYGPUIM REXPOLOERDCLFM  OFEQAKSEVKCDNBX
KNCSFUF         : LURCL           GICBHU          VSIG            UWMVAMUNFHFYDCR KAXCAHPJHHDDH  
TPMIB           : JKUORPHQEYGPUIM LORAHLD         XVRVMJBAYSNO    JYNVOA          XCHVIAIEIJKWR   XQIWRID        
ORJYSC          : UNFLMYX         VTQIFUGPFD     
ATFYSMJBFML     : RAIJBKFUBX      LHQW           
QGBLLRFEENF     : PSDAW           PGHBKPUSR       KEBMENWENXE    
FYRERVSRPASK    : JLACNJNABCWUB   QYULPXGQYP      YVNSOLOIKXD     AGBXFVLSV       BFTFD          
ELUQYQHGRUTJCXP : KNVWCJBBBC      WNAQY          
FXXEPE          : PUJQVMSPAPT     VVYV            NOBVDBBUD       CBDP            CLILGYAX        HCLVJHKVLPI    
LYSBYNN         : UEFEMMUORMUW    GBKPFCIPD       DUEMVHJV        YSGESITHF      
SCKLBBVJV       : MVYACYFAIR      WVTXQTQNQYJ     HTXGPFV         KDVROXEYCAA     BFYHJQ          VYVYODKGYQ     
EHVCXOIVOOLSP   : TEPFLVIWDEO     YYTVNJARMNIGO   CWYNECT        
RICQXPIQ        : EQQWJAMMIFBXKS 
SDXVBHRRLANQA   : HNMWD           QJIBXFYBBFFR    MOUHM           FEBLETXSDA      PDVAPYWRQU     
BVSPJNFKHPMBOEJ : RSXKKGXAPLJDDQM UHANBQWX        DUAPHGISA      
YCMW            : MKCVT           LNCWPXSBPG      VAYNIRDHYOXR    XVYPYB          XSSEWGFLHSDC    FXVPHD          KXYSXKHWVUGHFK  AUEIKOKW       
NGSIUUXLU       : SQWPXSWR        JXJNYBQWFGSP    TKKJDYSRPONCA   PDYSNSKQOLJP   
OSXECMMMTEB     : PLTMQRROMBYH    PPFOCJMVTM      XIMTHOFP        JAQMHU          AMLIKOQDLEVE    XOFBLBVQCI     
UHEDGIP         : CURPTLOCBWSMH   SDLGQM          APXODERFYJS     JVWPXG          BYHFCPNVUBEQ   
JGMEOJBM        : BMJLLJJVSIE     WOKSYBWQFNMRPMF
VRJQQPUFEJBJ    : QDGB            GLROTVPEQTKVALP DRSGNOBJHTJMIQ 
WERDJ           : UVIGACQ         CIDGTCGNK       IGCUGHDPOTEBX  
OCIAI           : GOPFMMTUKEJNGVJ XEQYXOTIXJLYVLC TJWBKM          IMKHJUKUL       DHTJNVCYAYUSGR 
EYGHLBD         : AEGNNATX        VYVGUUGE       
MVYFQEJAFUKEC   : OSEWINUH        EHAYMCQFNWWNTEE FPRXOEPEEDR     UVGJTEOOSJROI   PIHSPMXADUNIFYX
KLHYPQY         : UXTETQVQPPD     JNPR            XOMKG           HVRYP           NTXTHG          QWRNIVEBKX     
NFWUMLXRTNNSSEY : GBDNRV          OWCMDQGVHUQ     KSKUDIAESWBA   
GEAQLCWVPFUGX   : WUBCCCVCJLUFVFU KEXP            TQLYVAFJPCGB    DHTJNVCYAYUSGR 
GLBGIPTH        : KAOLXFHKMVGOQ   CYPUFFLIO       VWNRGLLHJP      RSUUP           PFXQIJOE        REMJROLRPGAO    HCYXQJKBQWVD    FOLIOBJ        
NWWI            : UQSWE           RDTLRJWWGSQ     DBJUTF          QDKQ            ECVNOOMEUCMRM  
DHTJNVCYAYUSGR  : FNSI            OCIAI           GEAQLCWVPFUGX  
ENHS            : EKVL            BGPG           
PBGJK           : VVYV            LVOXFQU         GKNHRX          MATO           
YHMJYPQVYFRBGU  : WFNFHSC         EKVL            MNUWJMSAGG      PQWCLECM       
ENLVOQMXJDO     : LORAHLD         HPKAHO          IKDGIKIKSCECRU  HTCMKL         
KAXCAHPJHHDDH   : BOIYKAXWMYYL    PWGVE           KNCSFUF        
WKQRPWHCTVSIW   : RAIJBKFUBX      QILIEDXIYW     
LLQXL           : NMQQKYG         TPSHFTN        
BNYQA           : WIJTVFOSIJBRHL  JNUWKBJPX       LSOXDFNGINX     FNSI            TXPIRLMWITGQ   
XFLH            : CGCFEF          NSMLIBX         LKBDJNBXTOQXJVJ HPKXCTQMHG     
KUIDKGKO        : KHSB            WXQQ            YLDLELXV        GEMNFJKBAJIBL   HANA           
JJKGNXT         : JNBHILDUIXHPEX  EBDEDAMDP       NBYQYLDNM      
WFAXVBQXJQD     : JKUORPHQEYGPUIM JNYKNWSNUQRLS   PBDXPDAJLH      TFRWKJUGBLSX    QCTPQPDXUCNGEBY HEFPBWSRAAOYY   FIODHXQEFYK    
BUIVD           : LGUUWOAAVJTH    JNYYB           DIBOOBICLLGN    LVOXFQU         HXWOKXIR       
ILXX            : WIJTVFOSIJBRHL  IYVHEELYJXPKTMW PIUARQIM        QFYCBKCAIH      AHEUVHEA       
JHAPX           : XJBNAWAATHEY    XIMTHOFP        XDIBLSK         PWGVE           FYQAVFYIWI     
JFXRHVPJON      : WVDMFGWAJFEUQFA QUXDGWJIAABBES 
HSSINBGSOPFOPU  : NACGMLGF        YMKMGXEBPUNT    AWHUPC          IGUALXQSB       HICPRNPFJEBYN   BGPG           
WVQWWDCUWMSOV   : AVBBQLVACQ      KYMHBQNBKHX     UVSHYCMPDYH     MPQQAFVUS      
EQQWJAMMIFBXKS  : KNVWCJBBBC      HCGHKGS         QFFKMFVMMDE     RICQXPIQ       
GTNEMKDRPAO     : LAAO            XLLUVLMA        VMWQIPYK       
SDAEJQU         : ASMIYGRLQRDBEE  HOEXLNSD        JCEYQUSXTNNK    SKFDTDAJB       JRNCOAQV        IBBPPP         
BWSNGBRGLM      : NFNUE           FCHUJNXMY       LQYK            BQCSOQHYL       NXIINVVQNRXH   
TIMAUWF         : QYULPXGQYP      RXBCSDCWUKN     HOEXLNSD       
OFEQAKSEVKCDNBX : FCAUXNPSGBFCNBO WHGNF           XYHIFQ         
JYUQ            : RYORDHVQXCDD    DOHQC          
JPJRCKPYPFQ     : YJKQSXGNVM      BLTUOGNCVG      GFLXGCDWCQHA   
LHXXBFUNHABK    : SVLLGE          CKCDOTUOLPXDON  XSUOY           TBQSMPMF        DFCOKIVFB      
EUACNPND        : YMKB            TUVFHMFCNYBCJE  AYBWWMSLRT     
GFLXGCDWCQHA    : NOXANWKJBLXKV   MWCKSUQYDOTKE   EYDVCUSO        DUFMOAEJHSUC    YEQNIEBYF       SKWGE           VYVGUUGE        JPJRCKPYPFQ    
GFLXGCDWCQHA    : LYVCGYTQGGOXS  
IHMXQMBCMFWMJK  : ROFIWVXEIKBEWF  LYELBDIGYIBT    GLROTVPEQTKVALP GHHQOJBSB       LQQIKIDWBILN    UUJLCDN        
ANEGUPGB        : LJJPVGPMRT      UYEJKOJEXEFHL  
LYVCGYTQGGOXS   : YVPPS           VLVLXACUCR      BRGKLTNXUO      KEXKVXRVSOWM    DIQWCAFSAIIX    GFLXGCDWCQHA    UAEJEBG        
CIWYUJ          : BMJLLJJVSIE     DVMCAHP        
AJBERVVXY       : YDBLXWRX        ICDGFU         
LXMNELKWUQLSMD  : PBEHCMGTEJ      MCWSFBYIDKXECS  LSKBDVUOPALNJMB RVFHM           HSOKPEXYO      
UDVRMJTXKAPIW   : GNCKPXL        
HNBI            : JWLYRVGPGPJKCD  MFCBRFKOIJPARE  EPJJI           MLPY           
QMOBM           : FOCEHR          XIMTHOFP        AWPXMOI         BVND           
UAEJEBG         : OUDGDCWDXIKK    TIJEHCTDBG      KUGH            IYETWH          LYVCGYTQGGOXS  
YAVIUVUWLFVBOL  : OCGI            MRHGEGGBJI      LRXLBDJ        
WOUMFYYQTYUDFX  : TDVKENPSL       SDLGQM          UCOVSPKW       
OYLMHIIEGVLEYA  : CURPTLOCBWSMH   QEIGTHMDBAALPNP QFIBOBKRVWCJHM 
DXFYKKALB       : OSFSUPEF        QGQBKCDYPAY     HTNAMABVXBNMAI  HFDNQFS        
KXYSXKHWVUGHFK  : LVTCIRQR        JYNIVGTG        YCMW           
CVTB            : WPEDFDVNWY      IYVHEELYJXPKTMW SYTOQW          BQUXOKKWYWJR    KTPFPGC        
KFVRG           : UKTYCO          UXMBS           EJVYTAGJ        IIRXQ           PFORCS          WUVBQPNGAYUN   
CGTFCHFDAFNH    : TFKLTVBV        AYXLEWUK        QSFOUDJENDGNKD  BVSJILA        
LEKS            : QCNC            LIAUJLIKNBHUJDK RGBLFQODSB      ICDJSXXKMDUEQ   OVMXME          PSXCSBWK       
UIOSDRTN        : GACNYWF         DUEMVHJV        HVRYP           VIWVYHAENFYGP   GFHAOJVKH      
PGHBKPUSR       : KBMFX           LJJPVGPMRT      KRBLQHBUAXUXTWD RNMEVBEQDW      QGBLLRFEENF    
AUEIKOKW        : PVTUPUHSQPSO    EKVL            QJTCXALPGPBYADU VKUIIFHWHD      BFTFD           KAIKSHABG       YCMW           
VPHSBXOEQITRA   : KCWUEUTQV       OSEWINUH       
ABPPYKK         : VKLWQLNT        THIPVHBRDGGO   
MFIUQYIPTGHC    : OSQAPRXCPHXSCE  TUVFHMFCNYBCJE 
IAROSALLDNLGFDF : MXXYDQRTH       DTLRNTA         LRBJHTCNWIRK   
NLFTVAMUK       : IQDJGCKPPFDRKBO NYXDHSAMLXFYG  
OQNSSWVKNONYCS  : DNRCA           YABPVYCMW       TUYGKWYLKS      KPNQGQOQYMP     DPCGQJPHKDJ    
PYUTHNHUU       : PPFOCJMVTM      VKLWQLNT        QREFO           KWRIV          
QWRNIVEBKX      : KYTPTRODAM      WBKWIOVYFNLATSD KLHYPQY        
JTHYKWBNPQD     : YNJQJD          FKGYL           PGXSQDFHHC      WOKKUPXIMAAIVP 
NYXDHSAMLXFYG   : FJWWO           LAUSBKQAYAJL    WXFDNOMVAEDFH   BFDD            DFCOKIVFB       NLFTVAMUK       ALHLEYYNOLQVQA 
EJPEEBANBKMC    : OPWG            DIQWCAFSAIIX    BELP            RNWCMLMXJEXRQXT
CUGSK           : ECVNOOMEUCMRM  
TOOOOCDMJEUOI   : IIBLTI          LOMRW           AMHUNLJCSEUE   
FOLIOBJ         : RKEINTKBNPP     MDVORKCYXJCHU   TITPLQPEIAR     AMEDRVPGXINWM   DAOWRSXW        GLBGIPTH       
NNERKMMVUGKJXB  : SSYVJETG        TMPVQYH         TUYGKWYLKS     
DQYHNOSUVHIEY   : ISMMW           BEJVDRYMDTGAX   PUQVC          
QBYGHQ          : GQIYLQVIK       TQLPU           TUVLGHI         KGKXMVNNMDVODT  HYGDCGAPAUGJOU  BGJOWAUKOPWU    QETPENLACKOI    JMQXDL         
UENPMAY         : OEPSIIYKMJG    
BPPT            : WVTXQTQNQYJ     VWDQKKWLWOQY    URCNWVARIU      FNSI            IMCK            KGQRM          
XIFQDBXMIYX     : QJIBXFYBBFFR    OEPSIIYKMJG     AJQXMA          WBKNSYVTNKRVJK 
AXHI            : SVNICRPA        EKUBGPG         JVVQVMVKHQAKQW  LNAJCRQ         VWDQKKWLWOQY    JNBHILDUIXHPEX  MLPY            JXPTNOFLVARMFE 
AXHI            : WERLQNE         XCHVIAIEIJKWR  
YDUMUKOVWQLNMDL : SGGKUXQ         HMEWXSXQ        VPYEEAOMTVL     ALHLEYYNOLQVQA  LCKQVKVVGKR    
KEBMENWENXE     : GYFFDFTG        MMCJ            WIGPVOOJNV      HWGXYLLG        YAVFIOGCBWJ     QGBLLRFEENF    
FODFTATOKJ      : BRRJFQLFUPIKUR  SNJQOGUL        JAQMHU          YSGESITHF       CNITJYNDIGSDL  
ICYVOCJ         : OAAWWDUWTSGGTFX RAIJBKFUBX      XLHLCJKCTX      SNADDUXEI       WBVPHIVNLJRGIN  LTVHKTJGXTLK   
PPNCTDBXQYFDETI : BMOHEYURQAOKPLV ILRBK           WWMFIQGL        BFTFD           LRXLBDJ        
QIGHTRSCTUAKY   : LDPXIHJQ        GGHOELIEYSQH    DVKWWHMVEMD     KVGDXJW         WURGBTEY        OTEMNWQKFXXPTCR
WOBKSUNTVFUB    : FFWIWE          WDQFKNFTSLOL    VBFHBCW        
AWUNNDVVYNQD    : LTVHKTJGXTLK    CRANBOUSLFK     YAXBHGSOGPKXUP 
LFUNQRCTDVRSRNA : KNVWCJBBBC      TUJMO           KYGWEYTCIVQIN  
OKPLFDCLA       : CXENVHCYXACGE   EOHATJLKDP      FQHHYIFQPPKI   
MPQQAFVUS       : EMNCLDERRATNUPM TOXBWAAXJCJG    TKSNC           UVDKSBLPHDF     QTDLYQEWNHTEK   WVQWWDCUWMSOV  
OULT            : IBUCHUMCXTSF    VWDQKKWLWOQY    PNWXKKLVOGAKKW  CLCNMOKX        MAGMYKIQ       
DNJQPWHBOVIRXVT : OXDNLMECQSJSOUE UTCYJBGEJMILFBY UYEJKOJEXEFHL  
JKOCMTAJMPXIC   : NBRKDAMHQW      GBDNRV          DINSL           GJNOMVHU       
BHIK            : LRKFPYGSB       QRQAWGRMWYWD    CPAUYEQHYXMHJG  HJEYXLD        
XJIBX           : GIVXQRRMDXEBIL  INKNQPYFFDM     ONSLRM          VXCF            LWQOABCCVEXQ   
MSCIMATYP       : RWUEYBFALINH    AMWCTVADY       FFIIGKF         RTGAYUWAWVUFXMQ
LLYUYOV         : IAFLTCXJDLHH    VVYV            JBKIILRVIA     
SQKBYVCYHMDI    : LURCL           LYEABQSABOMGSN 
PDVAPYWRQU      : UPSEVJXPE       SDXVBHRRLANQA  
CTBBLWKENVHOT   : FAUNOWO         ANCDRGDONVQHMH  OFICDTA         AVOE            YQLWDSMVITJIDX 
PDYSNSKQOLJP    : KTEOXFDWCGYEQK  RVTT            EDJFVRCEITPLP   LJVOCLP         NGSIUUXLU      
BGFGJCJMNIAT    : UGGVO           DNRCA           TBEFUTBRLFIGQFG GDJS           
XCORNFW         : TEIQEPA         VQMOLWKY        RNMEVBEQDW      GEQDHBKKERK    
ALHLEYYNOLQVQA  : BNXCIDDQP       ERKMM           ECVNOOMEUCMRM   NYXDHSAMLXFYG   YDUMUKOVWQLNMDL
UJVIUVFUTHKNW   : HNMWD           LEWQXRJRKCBYN   TSQAD          
NMTBVFF         : YVPPS           NYWBSFRKQRXP    KATVAHV        
GTKRKILKPGWLRT  : TDFUXGBQ        HLYHEPQFRI      WKRJU           JRKWRXTDH      
WOGGB           : BEBCLPYRSHA     DSESHS          KYTHFPNUREOJE   EGPAJTQEYY      EFJCQSTR       
FUKTPLQWQLGM    : OSCECXFOYRU     MNMV            AVBBQLVACQ      KGOI            UJQYNQCR        YGHRLWIOKB      UPSEVJXPE      
XAGL            : RYJSEDHI        OTEMNWQKFXXPTCR
VUJKOFWL        : JKSEYCU         UHANBQWX        FUXXPNMDRON    
DTXCYV          : RKVLKEUED       ULKCTB          EIEFRVGBBL      RWOXMLNDHS     
TLAKI           : XLFDCXIY        BGOOEALIG       OAARGFBFEYMMQ   QILIEDXIYW      CUUIDNDGCXYMVL  RXHXYPUJB      
XQIWRID         : VMUM            TUJMO           QPGKNHNIMRHHC   TPMIB          
VCAFOO          : GIVXQRRMDXEBIL  BSBLTDIIDNVY   
LCKQVKVVGKR     : NYWBSFRKQRXP    TJWBKM          YVRLS           IYCNVWRCCP      VTQIJWBKHDAFX   YDUMUKOVWQLNMDL
