PKWBHUYXGBX     : RYFIREHWMH      ALWOM           QJVQPPITWGBYAEO LVDNUYPU        DAFAKVNSCMJWWVS
XKUU            : BKAVHSKRPAIH    TIDFPFNOXHURNM  CRLEFHQ         EUDOTO         
DLOFEXGKIX      : VWFQ            ENHSHNLKESOHHTL
RVCJIYLPVKPD    : BMLGEHA         NPKFNHRWCD      EAJXUAORRJIBGSX
NPKXMHBPS       : XBOVPFBLHYB     ODFFQDRUB       NHQQWASDLYB    
WXNDKXC         : UUALLJDGBUJG    XXTWODURO       JQGJLIAFA      
RXQCI           : VWFQ            JQSOQXNEVTRNMY  NQDWNM         
NXOA            : HCAOYQ          YELBPIDVS       MKLGRAXAEISS    SMOIRLUIBXOC   
TMDLYDXIENCTLC  : QIVHKFPAWSTSO   AVTMJCWHW       MKLGRAXAEISS    NQDWNM          NJTMIIMX       
QOISDCSVEB      : KXIFM           TWHKEVWOM       MEROGHEMJRLJ    FHGK           
TBGUQAJVML      : VMADDDQIFACYLXD IQSXNV          WIOFU           ARXUCO          PHFDXTTRKPIRVWL
MTDDVWQAHHOR    : OJQIAVNHITAM    RGPSLLJRR       TABPPEYLWXH     OHDAMF         
RTVOBXFUBLRUMC  : EAGYSTERFPJS    PVDUUQOPA       UGMA           
BPSNJ           : YWEJAEJO        RBGINE          NQDWNM         
QIVHKFPAWSTSO   : TMDLYDXIENCTLC  AONRTNG         PEENFOMKOYU    
TOQPSCJPQNGTDB  : NQKGFSB         HDCEJ           QUBPIJWXETWMOU  PEENFOMKOYU     ELSYLRHXA      
PABXVJK         : JLCH           
BKAVHSKRPAIH    : XKUU            PMSDHUNGYXH     RTLIQWBYGNHGS  
NQKGFSB         : TOQPSCJPQNGTDB  RBABPHAEKGU    
ULAUMASXLTB     : PRFBXUDBJAQ     WIOFU          
VWFQ            : DLOFEXGKIX      RXQCI           QKGPWYKIACMOS   SMINMXPBOKDXUQE TMEMVKCGR       AVNODW          VBVDIDIVDBR     ISJNLIJSIEWI   
XIKIPFXJR       : CUHNQIOOITGQTO  OQCAJMS         YBBLR           YPSIJDJPVY      OTTVEUVFUMSKF   GRBFHOCLFBCW    OBSHALXPCEDTYDP
OKIYFTCC        : ATBOFYD         GXBIVFXMI       JDANVLJUCMKXL   DAFAKVNSCMJWWVS
CUHNQIOOITGQTO  : XIKIPFXJR       OJQIAVNHITAM    ITNVBVMG        ALWOM           HHGCX          
FHKDQC          : UUALLJDGBUJG   
FOSGWOI         : NGLQEJVHSV      AONRTNG         RYFIREHWMH      HHERID          HOECUMALHMO     OBSHALXPCEDTYDP UGNOEPKJAPRWTS 
XNUHDNPRD       : TFPKTX          UULMAC          TVKIQEHUBDC     JVBPT           URAJXPVHPLB    
OJQIAVNHITAM    : MTDDVWQAHHOR    CUHNQIOOITGQTO  PJLNMKCS        WUSWGQOE       
HCAOYQ          : NXOA            AQENWDJOQWPOSDI LMTOBHU         WUSWGQOE       
XOOUXSLOMOO     : ALWOM           ETOEFV          SADWROBYX       MJRCSJJK        TMHUYWLWP       QXSKXX         
AIMCG           : RPRGJGWOEI      AFILY           PAQGLUNUBRT     OTTVEUVFUMSKF   JQGJLIAFA      
MPVM            : WEEQBNDBGTTLT   FAMNIL          UEHTN          
DUEFJFVKGNADLU  : ULIAR           QXRQSFMWAOHE   
CHDT            : RKXRC           SSOOVPUOIUKWJ  
FCXIKAUA        : SADWROBYX      
HDCEJ           : TOQPSCJPQNGTDB  DJBI            QDPTTJLIGYOIQ   GRBFHOCLFBCW    OHDAMF          EBBC           
PRFBXUDBJAQ     : ULAUMASXLTB     IUCEKMSDEROQLL  EAJXUAORRJIBGSX
HVHSELSMWT      : RFGFWGNRADF     TWHKEVWOM       SJVVQCPTWMD     VWFXCITRL       EBBC            ISJNLIJSIEWI   
WSSCWXO         : VXHITRMNAAMIAOS UBFVODEVSLSYJS  YASNKOPPVJMTWR  SVLBFRP         MJRTDOVGWBKLRXH FSMBPRBRDWL     VPJGPIEWD       HUVPDEAOIP     
NGLQEJVHSV      : FOSGWOI         KYPOX           HHBYBXOLPSGB    RXIWWXHRND     
EEWOY           : SRHTNLTUO       MEROGHEMJRLJ    SSOOVPUOIUKWJ  
AUPW            : SQLEY           SADWROBYX      
YUJTYIRNOITAYAL : YELBPIDVS      
IERILXHAA       : CLEDEJXVFS      BOWAORPKWMINBA  DELOLVUFEABRPS  NOUKPKGGYQSI    FWCBSOLLUSIXX   RBABPHAEKGU    
AUAXLBUW        : MNKVM           UVSMLXLJ        SVLBFRP         JMUH            RTLIQWBYGNHGS   KWWNMHIGSQYPSAX
TFPKTX          : XNUHDNPRD       VXHITRMNAAMIAOS KDALOVYCD       DBYNXEOVCUQNP   QXSKXX         
VXHITRMNAAMIAOS : WSSCWXO         TFPKTX          PMSDHUNGYXH     DNLA           
JVBUWVTURYLC    : SMMGCVOJ        MOLOOPRQTQEFMT 
JJQHSYDKOTKOIU  : RFCFNG          GTAXBDFO        ULFAQHSAHGFU    DBYNXEOVCUQNP   XPLUENYNRNTFEMT
WQSGMVDLRWHLX   : RTLIQWBYGNHGS  
OQCAJMS         : XIKIPFXJR       LIOLATHDAHNJA   IQSXNV          IUCEKMSDEROQLL  MARABHIGFDYWCYF SRHTNLTUO       NOUKPKGGYQSI    TMEMVKCGR      
RDALPOTNGQEBY   : CVQFWQBCBV      ODFFQDRUB       PHFDXTTRKPIRVWL
WEEQBNDBGTTLT   : MPVM            SLIWMCNAPITY    VEVJXGQ        
AONRTNG         : QIVHKFPAWSTSO   FOSGWOI         ISVQNITDBVWE    RTLIQWBYGNHGS  
EAWLTDO         : GENMGKOHSFYWW   GRBFHOCLFBCW   
VMADDDQIFACYLXD : TBGUQAJVML      LFXASP          RFCFNG          JVQVTIAKSFJP    NULKIBCYHV     
OSFIGNUNOTYKXP  : ULIAR           DBYNXEOVCUQNP   JGDTBNHNH      
VCFY            : ITNVBVMG        VACMFKJADOTVB   AUYHE          
JQSOQXNEVTRNMY  : RXQCI           UEHTN           TABPPEYLWXH    
TNQJ            : MIHBDANCMVSOYJ  YBBLR           JBCHHHDNXS     
LIOLATHDAHNJA   : OQCAJMS        
AQENWDJOQWPOSDI : HCAOYQ          LRUJSGVUXXX     GENMGKOHSFYWW   AUYHE           DJBMENQQLCUUTT  QXSKXX         
JVMXHMUOPWXFIX  : EUDOTO         
IQSXNV          : TBGUQAJVML      OQCAJMS         MJRTDOVGWBKLRXH QYKFCGMLA       OHDAMF          HSBXAWGAAUEB   
EOFUEXAMAKIM    : AAUFHS          SWWLDHRCXY      QXWIM           DELOLVUFEABRPS  NFBHPO          DNLA           
RYFIREHWMH      : PKWBHUYXGBX     FOSGWOI         RFGFWGNRADF     UGMA            WCHPJJV        
UBFVODEVSLSYJS  : WSSCWXO         UPUNIREPJWD     OHDAMF         
LFXASP          : VMADDDQIFACYLXD SMOIRLUIBXOC    EAJXUAORRJIBGSX
AAUFHS          : EOFUEXAMAKIM    OYQOYYFGVAN     FHGK            FWCBSOLLUSIXX   SLIWMCNAPITY    RILHTTQOF      
RGPSLLJRR       : MTDDVWQAHHOR    SVLWSHVUH       LPPOGQJJCHQW   
KDALOVYCD       : TFPKTX          LOPKDCGR        NHQQWASDLYB     PHFDXTTRKPIRVWL QXSKXX         
CVQFWQBCBV      : RDALPOTNGQEBY   WIOFU           RFGFWGNRADF     XBOVPFBLHYB     HHGCX          
SCLNQ           : MNKVM           EUDOTO          JVBPT           JFKMYHP         DNLA           
WIOFU           : TBGUQAJVML      ULAUMASXLTB     CVQFWQBCBV     
HIIDHKHIODY     : GMAPM           MJRTDOVGWBKLRXH SMMGCVOJ        VPJGPIEWD      
CPXEQTDL        : OFKA            YBBLR           VPJGPIEWD      
OYQOYYFGVAN     : AAUFHS          UULMAC          VPJGPIEWD      
ITNVBVMG        : CUHNQIOOITGQTO  VCFY            SRHTNLTUO       SSOOVPUOIUKWJ  
JJNHPEDSSEKRUY  : LVRLSL          DELOLVUFEABRPS  VBVDIDIVDBR    
UEYSEP          : FAMNIL          XYEWWCFGGSSOGH 
PJLNMKCS        : OJQIAVNHITAM    RPRGJGWOEI      MARABHIGFDYWCYF QDUAXNOGWL     
MEUVW           : QDUAXNOGWL      SVLBFRP         NUMCXXJKOMTGP  
APUECOB         : ULIAR           FGNUWXGSVM      QUBPIJWXETWMOU  VWFXCITRL      
IXIJROBPGKDTYN  : DBYNXEOVCUQNP   HHBYBXOLPSGB   
SVLWSHVUH       : RGPSLLJRR       CMPRBJKL        DJWEXVJ         PHFDXTTRKPIRVWL
RNQHRSRPDD      : MNKVM           FAMNIL          QPSKCX          HQPKU          
RFYYRFURU       : WQMLYL          JVQVTIAKSFJP    JCDDTO          EBBC           
KSDJMLG         : GOOAU           SLIWMCNAPITY    UGNOEPKJAPRWTS 
UUALLJDGBUJG    : WXNDKXC         FHKDQC          DIPDHOPQPDW     ARXUCO          VWFXCITRL       FSMBPRBRDWL    
CLEDEJXVFS      : IERILXHAA       BMLGEHA         DAFAKVNSCMJWWVS ISVQNITDBVWE    GRBFHOCLFBCW   
AVTMJCWHW       : TMDLYDXIENCTLC  IUCEKMSDEROQLL  IOTIOUNVLYK     RLOLHRBD       
ULIAR           : DUEFJFVKGNADLU  OSFIGNUNOTYKXP  APUECOB         QXRQSFMWAOHE    TNBOONNWSA      NPKFNHRWCD      OVPXYQMDKLHUC  
UERAIEF         : LLWHYGGNKUN     RTLIQWBYGNHGS   KWWNMHIGSQYPSAX
KQJGXCQYBK      : GYKPLUX         UEHTN           BUQCDAQHYLFLOKF ODFFQDRUB       NJTMIIMX       
MNKVM           : AUAXLBUW        SCLNQ           RNQHRSRPDD      YBBLR           HQPKU           OVPXYQMDKLHUC  
QXRQSFMWAOHE    : DUEFJFVKGNADLU  ULIAR           LRDEBB          IUCEKMSDEROQLL  YSSW            OHDAMF          JQGJLIAFA      
SQLEY           : AUPW            MARABHIGFDYWCYF QDKBAXOTUDOXLG  IOTIOUNVLYK     SPJWP           OUTHMOGCIQNNA  
JPKMCYYPJVD     : XYEWWCFGGSSOGH  HQPKU           ROIOBY          JFKMYHP         WCHPJJV         QJUQC          
ODNGXTUWT       : EAGYSTERFPJS    YELBPIDVS      
EAGYSTERFPJS    : RTVOBXFUBLRUMC  ODNGXTUWT       QYKFCGMLA       ODFFQDRUB       DTDSYSEAUEWNBG 
LRDEBB          : QXRQSFMWAOHE    TWHKEVWOM       XXTWODURO      
WQMLYL          : RFYYRFURU       JVQVTIAKSFJP   
TIDFPFNOXHURNM  : XKUU            YASNKOPPVJMTWR  BOWAORPKWMINBA  JVQVTIAKSFJP    HHERID          DJBMENQQLCUUTT 
GOOAU           : KSDJMLG         ALWOM           FSMBPRBRDWL     JLCH            LPPOGQJJCHQW   
DVCBORONFVJP    : AXCDKYVBAF      NFBHPO         
RFGFWGNRADF     : HVHSELSMWT      RYFIREHWMH      CVQFWQBCBV      AUYHE          
LVRLSL          : JJNHPEDSSEKRUY  WUSWGQOE        LPPOGQJJCHQW   
RPRGJGWOEI      : AIMCG           PJLNMKCS        SRHTNLTUO       OPDEXTHANQFAFE  SKHAFJAGIGIJCM 
FAMNIL          : MPVM            UEYSEP          RNQHRSRPDD      UPUNIREPJWD    
XEXBLBOJTCD     : SADWROBYX       QYKFCGMLA      
SWWLDHRCXY      : EOFUEXAMAKIM    SJVVQCPTWMD     OBSHALXPCEDTYDP UJJBMPOX       
FGNUWXGSVM      : APUECOB         JCDDTO         
YASNKOPPVJMTWR  : WSSCWXO         TIDFPFNOXHURNM  RPWTCTK         MKLGRAXAEISS   
QUBPIJWXETWMOU  : TOQPSCJPQNGTDB  APUECOB         ROIOBY          SSOOVPUOIUKWJ   HVHXDOBBJWSV   
IUCEKMSDEROQLL  : PRFBXUDBJAQ     OQCAJMS         AVTMJCWHW       QXRQSFMWAOHE    QKGPWYKIACMOS   LVDNUYPU       
QCITUQDTQJP     : XIRVXYWLHXNGGMQ DJBI            AVNODW         
YELBPIDVS       : NXOA            YUJTYIRNOITAYAL ODNGXTUWT       QDPTTJLIGYOIQ   LMTOBHU         JVBPT          
QXWIM           : EOFUEXAMAKIM    PMSDHUNGYXH     UXUBYESQ        KWWNMHIGSQYPSAX RILHTTQOF      
VACMFKJADOTVB   : VCFY            MIHBDANCMVSOYJ  TNBOONNWSA      NUMCXXJKOMTGP  
MARABHIGFDYWCYF : OQCAJMS         PJLNMKCS        SQLEY           XYEWWCFGGSSOGH  SRHTNLTUO       ETOEFV          DJBI            ENNHFFAMAWBOY  
RERVSWGC        : XIRVXYWLHXNGGMQ UJJTXDDVE      
LRUJSGVUXXX     : AQENWDJOQWPOSDI GYKPLUX         KXIFM           JVQVTIAKSFJP    AFILY           NOUKPKGGYQSI   
GENMGKOHSFYWW   : EAWLTDO         AQENWDJOQWPOSDI PEENFOMKOYU    
PVDUUQOPA       : RTVOBXFUBLRUMC 
XYEWWCFGGSSOGH  : UEYSEP          JPKMCYYPJVD     MARABHIGFDYWCYF QPSKCX         
BOWAORPKWMINBA  : IERILXHAA       TIDFPFNOXHURNM  TMEMVKCGR      
KYPOX           : NGLQEJVHSV      GNDTFGSUVMLXFRM
QDUAXNOGWL      : PJLNMKCS        MEUVW           HSBXAWGAAUEB   
MIHBDANCMVSOYJ  : TNQJ            VACMFKJADOTVB   LMTOBHU         RXIWWXHRND      UXUBYESQ        NNQE           
XBOVPFBLHYB     : NPKXMHBPS       CVQFWQBCBV      JCDDTO          OVPXYQMDKLHUC  
GYKPLUX         : KQJGXCQYBK      LRUJSGVUXXX     TVKIQEHUBDC    
AXCDKYVBAF      : DVCBORONFVJP    IOTIOUNVLYK     EUDOTO          BSDHYXERBJQUAR  NOUKPKGGYQSI    OPDEXTHANQFAFE  NJTMIIMX       
XIRVXYWLHXNGGMQ : QCITUQDTQJP     RERVSWGC        RFCFNG          DBYNXEOVCUQNP   DJBMENQQLCUUTT 
ALWOM           : PKWBHUYXGBX     CUHNQIOOITGQTO  XOOUXSLOMOO     GOOAU           JBCHHHDNXS     
SRHTNLTUO       : EEWOY           OQCAJMS         ITNVBVMG        RPRGJGWOEI      MARABHIGFDYWCYF MBEQYONXEBFMJ  
DIPDHOPQPDW     : UUALLJDGBUJG    QJVQPPITWGBYAEO YPSIJDJPVY      DJBMENQQLCUUTT  WUSWGQOE       
RPWTCTK         : YASNKOPPVJMTWR  RBGINE          QJUQC           RILHTTQOF       BJGUCHRQQ      
QDKBAXOTUDOXLG  : SQLEY           NWHUJVALWPL     GNDTFGSUVMLXFRM
UVSMLXLJ        : AUAXLBUW        OUTHMOGCIQNNA   SSOOVPUOIUKWJ   OBSHALXPCEDTYDP
CJLGD           : IOTIOUNVLYK     UJVWXFPVIIASH   JXGQPHWPJEAVDJQ YSSW           
YWEJAEJO        : BPSNJ           PAQGLUNUBRT     SLIWMCNAPITY    TMEMVKCGR      
ETOEFV          : XOOUXSLOMOO     MARABHIGFDYWCYF CRLEFHQ         HUVPDEAOIP     
ATBOFYD         : OKIYFTCC        CMPRBJKL        SPJWP           LLWHYGGNKUN    
RFCFNG          : JJQHSYDKOTKOIU  VMADDDQIFACYLXD XIRVXYWLHXNGGMQ UPUNIREPJWD     TMHUYWLWP      
OFKA            : CPXEQTDL        PJTGEMTKFQLPY  
QJVQPPITWGBYAEO : PKWBHUYXGBX     DIPDHOPQPDW     SMMGCVOJ       
GTAXBDFO        : JJQHSYDKOTKOIU  NFQXFXQOVKENSAK PMSDHUNGYXH     HHERID          KWWNMHIGSQYPSAX
NFQXFXQOVKENSAK : GTAXBDFO        JXGQPHWPJEAVDJQ VEVJXGQ        
DJBI            : HDCEJ           QCITUQDTQJP     MARABHIGFDYWCYF JBCHHHDNXS     
IOTIOUNVLYK     : AVTMJCWHW       SQLEY           AXCDKYVBAF      CJLGD           BUQCDAQHYLFLOKF FWCBSOLLUSIXX   NNQE            NULKIBCYHV     
RKXRC           : CHDT            FWCBSOLLUSIXX  
PMSDHUNGYXH     : BKAVHSKRPAIH    VXHITRMNAAMIAOS QXWIM           GTAXBDFO       
ARXUCO          : TBGUQAJVML      UUALLJDGBUJG    CRLEFHQ         LLWHYGGNKUN     WUSWGQOE       
QKGPWYKIACMOS   : VWFQ            IUCEKMSDEROQLL  TWHKEVWOM       CRLEFHQ         EUDOTO          RBABPHAEKGU    
KXIFM           : QOISDCSVEB      LRUJSGVUXXX     JMUH            RXIWWXHRND      JBCHHHDNXS      PHFDXTTRKPIRVWL
GMAPM           : HIIDHKHIODY     UJJBMPOX       
PJTGEMTKFQLPY   : OFKA            SJVVQCPTWMD     NWHUJVALWPL    
TNBOONNWSA      : ULIAR           VACMFKJADOTVB   NFBHPO          NJTMIIMX        DNLA           
CMPRBJKL        : SVLWSHVUH       ATBOFYD         JMUH            RJNMTPXRFC      UGNOEPKJAPRWTS 
QPSKCX          : RNQHRSRPDD      XYEWWCFGGSSOGH  SADWROBYX       BSDHYXERBJQUAR  BJGUCHRQQ      
NNDCITFY        : MEROGHEMJRLJ   
SMINMXPBOKDXUQE : VWFQ            UGMA            DTDSYSEAUEWNBG 
GXBIVFXMI       : OKIYFTCC        AOBSBJ         
UEHTN           : MPVM            JQSOQXNEVTRNMY  KQJGXCQYBK      BSDHYXERBJQUAR  XXTWODURO       OBSHALXPCEDTYDP MBEQYONXEBFMJ  
JVQVTIAKSFJP    : VMADDDQIFACYLXD RFYYRFURU       WQMLYL          TIDFPFNOXHURNM  LRUJSGVUXXX     GRBFHOCLFBCW    EBBC           
PEENFOMKOYU     : QIVHKFPAWSTSO   TOQPSCJPQNGTDB  GENMGKOHSFYWW  
TABPPEYLWXH     : MTDDVWQAHHOR    JQSOQXNEVTRNMY  JDANVLJUCMKXL   GRBFHOCLFBCW   
ASBFEQ          : ISJNLIJSIEWI    QXSKXX         
TWHKEVWOM       : QOISDCSVEB      HVHSELSMWT      LRDEBB          QKGPWYKIACMOS  
MEROGHEMJRLJ    : QOISDCSVEB      EEWOY           NNDCITFY        OUTHMOGCIQNNA  
SJVVQCPTWMD     : HVHSELSMWT      SWWLDHRCXY      PJTGEMTKFQLPY   MJRTDOVGWBKLRXH AVNODW         
RBGINE          : BPSNJ           RPWTCTK         RTLIQWBYGNHGS  
SVLBFRP         : WSSCWXO         AUAXLBUW        MEUVW           OTTVEUVFUMSKF  
JDANVLJUCMKXL   : OKIYFTCC        TABPPEYLWXH     AUYHE           NJTMIIMX       
BUQCDAQHYLFLOKF : KQJGXCQYBK      IOTIOUNVLYK     NUMCXXJKOMTGP  
CRLEFHQ         : XKUU            ETOEFV          ARXUCO          QKGPWYKIACMOS   QDPTTJLIGYOIQ   BMLGEHA         GNDTFGSUVMLXFRM
EUDOTO          : XKUU            JVMXHMUOPWXFIX  SCLNQ           AXCDKYVBAF      QKGPWYKIACMOS   JMUH           
ULFAQHSAHGFU    : JJQHSYDKOTKOIU  HHERID          MBEQYONXEBFMJ  
SADWROBYX       : XOOUXSLOMOO     FCXIKAUA        AUPW            XEXBLBOJTCD     QPSKCX          DELOLVUFEABRPS  TMHUYWLWP       NJTMIIMX       
QDPTTJLIGYOIQ   : HDCEJ           YELBPIDVS       CRLEFHQ         HOECUMALHMO    
BSDHYXERBJQUAR  : AXCDKYVBAF      QPSKCX          UEHTN          
BMLGEHA         : RVCJIYLPVKPD    CLEDEJXVFS      CRLEFHQ         JXGQPHWPJEAVDJQ
UJVWXFPVIIASH   : CJLGD           NISMUARCODCXM   JLCH            RILHTTQOF      
YBBLR           : XIKIPFXJR       TNQJ            CPXEQTDL        MNKVM           LOPKDCGR       
LMTOBHU         : HCAOYQ          YELBPIDVS       MIHBDANCMVSOYJ 
OXUMJSJJAYF     : VPJGPIEWD      
HHERID          : FOSGWOI         TIDFPFNOXHURNM  GTAXBDFO        ULFAQHSAHGFU    LVDNUYPU       
LOPKDCGR        : KDALOVYCD       YBBLR           ISVQNITDBVWE   
NPKFNHRWCD      : RVCJIYLPVKPD    ULIAR          
DELOLVUFEABRPS  : IERILXHAA       EOFUEXAMAKIM    JJNHPEDSSEKRUY  SADWROBYX       PUAVHMDCQ      
UULMAC          : XNUHDNPRD       OYQOYYFGVAN     SSOOVPUOIUKWJ  
MJRTDOVGWBKLRXH : WSSCWXO         IQSXNV          HIIDHKHIODY     SJVVQCPTWMD    
ENNHFFAMAWBOY   : MARABHIGFDYWCYF YPSIJDJPVY      HVHXDOBBJWSV   
RLOLHRBD        : AVTMJCWHW       JLCH            ENHSHNLKESOHHTL
AFILY           : AIMCG           LRUJSGVUXXX    
SMMGCVOJ        : JVBUWVTURYLC    HIIDHKHIODY     QJVQPPITWGBYAEO UXUBYESQ       
DJWEXVJ         : SVLWSHVUH       HQPKU           RJNMTPXRFC     
JXGQPHWPJEAVDJQ : CJLGD           NFQXFXQOVKENSAK BMLGEHA         XPLUENYNRNTFEMT HSBXAWGAAUEB   
XXTWODURO       : WXNDKXC         LRDEBB          UEHTN          
YPSIJDJPVY      : XIKIPFXJR       DIPDHOPQPDW     ENNHFFAMAWBOY  
SPJWP           : SQLEY           ATBOFYD        
BBXSAXP         : PUAVHMDCQ       DNLA           
OUTHMOGCIQNNA   : SQLEY           UVSMLXLJ        MEROGHEMJRLJ    JUXLABXVOR      ENHSHNLKESOHHTL
JCDDTO          : RFYYRFURU       FGNUWXGSVM      XBOVPFBLHYB     HOECUMALHMO     OVPXYQMDKLHUC  
LVDNUYPU        : PKWBHUYXGBX     IUCEKMSDEROQLL  HHERID         
MKLGRAXAEISS    : NXOA            TMDLYDXIENCTLC  YASNKOPPVJMTWR 
VWFXCITRL       : HVHSELSMWT      APUECOB         UUALLJDGBUJG    ROIOBY         
NOUKPKGGYQSI    : IERILXHAA       OQCAJMS         LRUJSGVUXXX     AXCDKYVBAF      NISMUARCODCXM  
UGMA            : RTVOBXFUBLRUMC  RYFIREHWMH      SMINMXPBOKDXUQE RTLIQWBYGNHGS   ISJNLIJSIEWI   
FSMBPRBRDWL     : WSSCWXO         UUALLJDGBUJG    GOOAU           FWCBSOLLUSIXX   JVBPT          
DAFAKVNSCMJWWVS : PKWBHUYXGBX     OKIYFTCC        CLEDEJXVFS      HHBYBXOLPSGB    XPLUENYNRNTFEMT
ISVQNITDBVWE    : AONRTNG         CLEDEJXVFS      LOPKDCGR        GRBFHOCLFBCW   
JUXLABXVOR      : OUTHMOGCIQNNA  
DDXBAQGK        : OHDAMF         
DBYNXEOVCUQNP   : TFPKTX          JJQHSYDKOTKOIU  OSFIGNUNOTYKXP  IXIJROBPGKDTYN  XIRVXYWLHXNGGMQ WCHPJJV        
YSSW            : QXRQSFMWAOHE    CJLGD           LLWHYGGNKUN    
HQPKU           : RNQHRSRPDD      MNKVM           JPKMCYYPJVD     DJWEXVJ        
NWHUJVALWPL     : QDKBAXOTUDOXLG  PJTGEMTKFQLPY   RXIWWXHRND     
HHGCX           : CUHNQIOOITGQTO  CVQFWQBCBV      NHQQWASDLYB    
UPUNIREPJWD     : UBFVODEVSLSYJS  FAMNIL          RFCFNG         
NQDWNM          : RXQCI           TMDLYDXIENCTLC  BPSNJ           OHDAMF         
PAQGLUNUBRT     : AIMCG           YWEJAEJO        DJBMENQQLCUUTT  DTDSYSEAUEWNBG 
MJRCSJJK        : XOOUXSLOMOO     UJJTXDDVE      
GNDTFGSUVMLXFRM : KYPOX           QDKBAXOTUDOXLG  CRLEFHQ         EAJXUAORRJIBGSX
HHBYBXOLPSGB    : NGLQEJVHSV      IXIJROBPGKDTYN  DAFAKVNSCMJWWVS WCHPJJV         WUSWGQOE        HSBXAWGAAUEB   
QYKFCGMLA       : IQSXNV          EAGYSTERFPJS    XEXBLBOJTCD    
JMUH            : AUAXLBUW        KXIFM           CMPRBJKL        EUDOTO          HOECUMALHMO     URAJXPVHPLB    
OTTVEUVFUMSKF   : XIKIPFXJR       AIMCG           SVLBFRP         NUMCXXJKOMTGP   PHFDXTTRKPIRVWL
NISMUARCODCXM   : UJVWXFPVIIASH   NOUKPKGGYQSI    DNLA           
TVKIQEHUBDC     : XNUHDNPRD       GYKPLUX        
RXIWWXHRND      : NGLQEJVHSV      MIHBDANCMVSOYJ  KXIFM           NWHUJVALWPL     QXSKXX         
FHGK            : QOISDCSVEB      AAUFHS          LLWHYGGNKUN    
FWCBSOLLUSIXX   : IERILXHAA       AAUFHS          IOTIOUNVLYK     RKXRC           FSMBPRBRDWL    
VPJGPIEWD       : WSSCWXO         HIIDHKHIODY     CPXEQTDL        OYQOYYFGVAN     OXUMJSJJAYF     URAJXPVHPLB    
AUYHE           : VCFY            AQENWDJOQWPOSDI RFGFWGNRADF     JDANVLJUCMKXL  
SLIWMCNAPITY    : WEEQBNDBGTTLT   AAUFHS          KSDJMLG         YWEJAEJO        SMOIRLUIBXOC   
TMEMVKCGR       : VWFQ            OQCAJMS         BOWAORPKWMINBA  YWEJAEJO       
JLCH            : PABXVJK         GOOAU           UJVWXFPVIIASH   RLOLHRBD       
LLWHYGGNKUN     : UERAIEF         ATBOFYD         ARXUCO          YSSW            FHGK           
DJBMENQQLCUUTT  : AQENWDJOQWPOSDI TIDFPFNOXHURNM  XIRVXYWLHXNGGMQ DIPDHOPQPDW     PAQGLUNUBRT    
HXNSKBSRA       : HOECUMALHMO     OVPXYQMDKLHUC  
XPLUENYNRNTFEMT : JJQHSYDKOTKOIU  JXGQPHWPJEAVDJQ DAFAKVNSCMJWWVS WCHPJJV        
HOECUMALHMO     : FOSGWOI         QDPTTJLIGYOIQ   JCDDTO          JMUH            HXNSKBSRA      
GRBFHOCLFBCW    : XIKIPFXJR       HDCEJ           EAWLTDO         CLEDEJXVFS      JVQVTIAKSFJP    TABPPEYLWXH     ISVQNITDBVWE   
VEVJXGQ         : WEEQBNDBGTTLT   NFQXFXQOVKENSAK
NUMCXXJKOMTGP   : MEUVW           VACMFKJADOTVB   BUQCDAQHYLFLOKF OTTVEUVFUMSKF  
OHDAMF          : MTDDVWQAHHOR    HDCEJ           IQSXNV          UBFVODEVSLSYJS  QXRQSFMWAOHE    DDXBAQGK        NQDWNM         
JVBPT           : XNUHDNPRD       SCLNQ           YELBPIDVS       FSMBPRBRDWL    
ODFFQDRUB       : NPKXMHBPS       RDALPOTNGQEBY   KQJGXCQYBK      EAGYSTERFPJS    RBABPHAEKGU    
ENHSHNLKESOHHTL : DLOFEXGKIX      RLOLHRBD        OUTHMOGCIQNNA   JQGJLIAFA      
ROIOBY          : JPKMCYYPJVD     QUBPIJWXETWMOU  VWFXCITRL      
JFKMYHP         : SCLNQ           JPKMCYYPJVD    
NFBHPO          : EOFUEXAMAKIM    DVCBORONFVJP    TNBOONNWSA     
AVNODW          : VWFQ            QCITUQDTQJP     SJVVQCPTWMD     WCHPJJV        
OPDEXTHANQFAFE  : RPRGJGWOEI      AXCDKYVBAF      PHFDXTTRKPIRVWL
UXUBYESQ        : QXWIM           MIHBDANCMVSOYJ  SMMGCVOJ       
SMOIRLUIBXOC    : NXOA            LFXASP          SLIWMCNAPITY   
WCHPJJV         : RYFIREHWMH      JPKMCYYPJVD     DBYNXEOVCUQNP   HHBYBXOLPSGB    XPLUENYNRNTFEMT AVNODW          IDJJRSBTMJHVF  
SSOOVPUOIUKWJ   : CHDT            EEWOY           ITNVBVMG        QUBPIJWXETWMOU  UVSMLXLJ        UULMAC         
OVPXYQMDKLHUC   : ULIAR           MNKVM           XBOVPFBLHYB     JCDDTO          HXNSKBSRA       HVHXDOBBJWSV   
EAJXUAORRJIBGSX : RVCJIYLPVKPD    PRFBXUDBJAQ     LFXASP          GNDTFGSUVMLXFRM
NNQE            : MIHBDANCMVSOYJ  IOTIOUNVLYK    
PUAVHMDCQ       : DELOLVUFEABRPS  BBXSAXP        
JQGJLIAFA       : WXNDKXC         AIMCG           QXRQSFMWAOHE    ENHSHNLKESOHHTL
OBSHALXPCEDTYDP : XIKIPFXJR       FOSGWOI         SWWLDHRCXY      UVSMLXLJ        UEHTN          
RTLIQWBYGNHGS   : BKAVHSKRPAIH    AUAXLBUW        WQSGMVDLRWHLX   AONRTNG         UERAIEF         RBGINE          UGMA            LPPOGQJJCHQW   
RJNMTPXRFC      : CMPRBJKL        DJWEXVJ        
KWWNMHIGSQYPSAX : AUAXLBUW        UERAIEF         QXWIM           GTAXBDFO        BJGUCHRQQ      
JGDTBNHNH       : OSFIGNUNOTYKXP 
MBEQYONXEBFMJ   : SRHTNLTUO       UEHTN           ULFAQHSAHGFU   
ELSYLRHXA       : TOQPSCJPQNGTDB 
RBABPHAEKGU     : NQKGFSB         IERILXHAA       QKGPWYKIACMOS   ODFFQDRUB      
UJJBMPOX        : SWWLDHRCXY      GMAPM          
UJJTXDDVE       : RERVSWGC        MJRCSJJK       
NHQQWASDLYB     : NPKXMHBPS       KDALOVYCD       HHGCX           NULKIBCYHV     
TMHUYWLWP       : XOOUXSLOMOO     RFCFNG          SADWROBYX      
JBCHHHDNXS      : TNQJ            ALWOM           DJBI            KXIFM           SKHAFJAGIGIJCM 
QJUQC           : JPKMCYYPJVD     RPWTCTK        
EBBC            : HDCEJ           HVHSELSMWT      RFYYRFURU       JVQVTIAKSFJP   
NJTMIIMX        : TMDLYDXIENCTLC  KQJGXCQYBK      AXCDKYVBAF      TNBOONNWSA      JDANVLJUCMKXL   SADWROBYX       WUSWGQOE       
VBVDIDIVDBR     : VWFQ            JJNHPEDSSEKRUY 
MOLOOPRQTQEFMT  : JVBUWVTURYLC   
UGNOEPKJAPRWTS  : FOSGWOI         KSDJMLG         CMPRBJKL       
PHFDXTTRKPIRVWL : TBGUQAJVML      RDALPOTNGQEBY   KDALOVYCD       SVLWSHVUH       KXIFM           OTTVEUVFUMSKF   OPDEXTHANQFAFE  HVHXDOBBJWSV   
URAJXPVHPLB     : XNUHDNPRD       JMUH            VPJGPIEWD      
HVHXDOBBJWSV    : QUBPIJWXETWMOU  ENNHFFAMAWBOY   OVPXYQMDKLHUC   PHFDXTTRKPIRVWL
DNLA            : VXHITRMNAAMIAOS EOFUEXAMAKIM    SCLNQ           TNBOONNWSA      BBXSAXP         NISMUARCODCXM  
WUSWGQOE        : OJQIAVNHITAM    HCAOYQ          LVRLSL          DIPDHOPQPDW     ARXUCO          HHBYBXOLPSGB    NJTMIIMX       
HSBXAWGAAUEB    : IQSXNV          QDUAXNOGWL      JXGQPHWPJEAVDJQ HHBYBXOLPSGB   
DTDSYSEAUEWNBG  : EAGYSTERFPJS    SMINMXPBOKDXUQE PAQGLUNUBRT    
SKHAFJAGIGIJCM  : RPRGJGWOEI      JBCHHHDNXS      HUVPDEAOIP      NULKIBCYHV     
ISJNLIJSIEWI    : VWFQ            HVHSELSMWT      ASBFEQ          UGMA           
AOBSBJ          : GXBIVFXMI      
HUVPDEAOIP      : WSSCWXO         ETOEFV          SKHAFJAGIGIJCM 
RILHTTQOF       : AAUFHS          QXWIM           RPWTCTK         UJVWXFPVIIASH  
LPPOGQJJCHQW    : RGPSLLJRR       GOOAU           LVRLSL          RTLIQWBYGNHGS  
IDJJRSBTMJHVF   : WCHPJJV        
NULKIBCYHV      : VMADDDQIFACYLXD IOTIOUNVLYK     NHQQWASDLYB     SKHAFJAGIGIJCM 
QXSKXX          : XOOUXSLOMOO     TFPKTX          AQENWDJOQWPOSDI KDALOVYCD       ASBFEQ          RXIWWXHRND     
BJGUCHRQQ       : RPWTCTK         QPSKCX          KWWNMHIGSQYPSAX
