IDASCAVWHXX     : OOUYOOUWVEBCE   CPFDIIHRID      STECSYG         MXMMIVC         KUCLTUJOAQV    
XTGU            : OKAR            RYGDWVFP        UTNLVNC         TTWPJ           UOUKCSSEAVSOBP  OQRHVC         
VSSTFGMDMXNQHI  : VXCU            NQNXVEJTPFKUUDC GFKKV           OAUVCTYWRTFUUBP USSEEK         
NKUPKTM         : JMLLJ           ILWPEI          CMAVPM          JKGNLQGTLSMRKM  MKMBJAHOWONJT  
RKXRGGNUCIN     : JGHSKCYNUB      NVEWVPK        
PVMSIKHAURCIDYX : JEYCLVNREGQ     AJTCJPUKPAVLO   QNLNBTOWTKEJHKP HHFKGORYOT      EUDS            WXGEIPTXMQCBB   OAMG            SGODJ          
UMKMW           : TIFDC           MANISCBQCBFPCL 
HERUBVD         : WUMJNVWWVR      WRYBQTX         WERTSXKIFYJ     BBOYXGWKBAV     AGVUSALXPG      BYMLCYGGOEEOAOB
WUMJNVWWVR      : HERUBVD         EFITUDSOJMEFBA  EOGH            AEELEVTWN      
ACUBC           : WOXLLISRCPSY    QNYRHCSGBRY     IYXRIIKFFX      BBOYXGWKBAV     BPBF           
WOXLLISRCPSY    : ACUBC           FDNPTTJ         FMMES           ENUWMGWNXJMPDIP KRIOCICULD      UOIDGHFAOJPFIT 
JVPWFE          : EYMQQNXOHG      WXFAH          
CDQVUSXRTA      : PBELVGXWJLOKWC  BCEWATNBILKV    OBDYUKHRUDKYPHN HJRHKD         
SQFF            : QNAEGWIWJ       XFTS            NJJCHGNDUG      LSHHPSIQTOOY    NFTDJMBHVWXY    CVLIYIQEWHWNXXS FSADJSURQXRYF  
NAWSQQRLAPC     : FDNPTTJ         TOVNUYF         NEFDB           FJQU            IISAPTDX       
WIRCLKXJDYBABG  : UKEVPQWFVCD     TOKBL           XFTS            LFBDPJUN        QXWXPYJFYLWPGSW LLTSPQDPVRBTD  
SLAXCDUWTNO     : NAUWRVVH        EWIJAXUQYXELV   EGTQ            LLJBOHNO        CQRQSBHHOHG     FIXGLQ          FURJY           GNWY           
OGJPDRIF        : MNRKFOLVL       COWFCNBYG       KRVBDIKIJKXTEVO SOYNECT        
UGRBFSBI        : NEFDB           QNAEGWIWJ       EKPGFAQJAIEKBW  CMAVPM          ESWHBWHR       
VDPYBTCYQXM     : WGRUUHHNHCX     FGLCLB          YSFBUQFTST      EWIJAXUQYXELV   MHVNJQX        
FDNPTTJ         : WOXLLISRCPSY    NAWSQQRLAPC     JBWXNYRTRO      RAYTUGYFLVX     QWHWNKYMCHW     BHYMPGUVITAD   
YRYFJAMFDXJCB   : UNDWO           OAUVCTYWRTFUUBP
BDVFEOFQYKWMAQI : LAYHDRLQP       LQBSCHIENCROD   EGTQ            DFRGNWCHJSOQW   NPGAYDPJ        VIJSX          
UKEVPQWFVCD     : WIRCLKXJDYBABG  YPNVWJV         AYUTSA         
EEGFJEMNTRHSDEH : USSEEK         
WSTTDYPUROAPRFW : BCEWATNBILKV    RYGDWVFP        JQHCURYBUYLWKIY PJGUNSNXMEEBNV 
MFEVMQM         : HCAJC           FMMES           USSEEK          LGPNUVLOJEWB   
LVBQCKV         : FVNKFAFXABMOVUP YMCSWRKHRLW    
DQSG            : OIPMUXVVR       RAYTUGYFLVX     KVGVBVBEGKOY    STJNWVO         YPCYUJKBXOSKQQ  JFPHDECN       
KELAEBRMAPYFTWR : WPOYMXINRB      LCQWPNUU        EGTQ            PEQVI           NDOUBOODAI     
LAYHDRLQP       : BDVFEOFQYKWMAQI WRYBQTX         TOKBL           KHSFNLB         SHKEYPPTGBEMOP 
TIFDC           : UMKMW           SEWFP           QXOYLVSQGFRNC   SWDDI           RVWFJKIX       
HNSNQMAQCYYWW   : JXKIIBQWSKSRQ   SMBMUWOLI       MXMMIVC         HPXFDKPYPV      EHTBMHFMRNB     XGNXCHOGYQHO   
MKVNSYFEPURM    : QNAEGWIWJ       LCNTVGEG        FKOCU           LLJBOHNO       
YRIRBW          : JJHBSGDCNAMU   
QNYRHCSGBRY     : ACUBC           QWEEUBKINWQNDE  JQHCURYBUYLWKIY LXPGSPTKSLJHKV 
DUDXWKEOHX      : LNUJJCYVLGOXJ   LEIVKPDABBCBL   IYXRIIKFFX      TSCNBI         
NAUWRVVH        : SLAXCDUWTNO     AJTCJPUKPAVLO  
JGHSKCYNUB      : RKXRGGNUCIN     RPPVRCXYDHHQIG  BNCNVOFRXWDU    TSCNBI          DGOGUTNEGV      MGVENDQQEFPEMP  AGFVUE         
XXIXUSCKBBNO    : LSHHPSIQTOOY    MIPDHFLWODQMF   YLQJBLP         QWHWNKYMCHW    
LNUJJCYVLGOXJ   : DUDXWKEOHX      UXFJOYEUHF      TFHNJQFPKP      DEMSISO         GGRFBCIQLXV     TUGHEFPUJ      
MGRR            : UXFJOYEUHF      FCJRR           HDRBKNVEHFQGU   BYYUJPLLUDCF   
PBELVGXWJLOKWC  : CDQVUSXRTA      HJEEMMECMYVSNMG GVPU            FAWXUODIOF     
HOMIKXPBWB      : BGGN            XQLWPTV         GMCRLBU         YPCYUJKBXOSKQQ  WLRRYJ          CJLHTSFBBOBNAC 
LHJDNAE         : JFNTMMLEISF     HXSRKNQCFR      VMYJBNQSFT     
NBANAKBQWBTFKK  : OGLBQ           HCAJC           JJKUEQSVYPJBRDU BJGJJ          
SWSIX           : AJRCGRETKBBDF   PSQOXDMXDOH    
LQBSCHIENCROD   : BDVFEOFQYKWMAQI VMWUNJNCSGAK   
RPJIOKEUUOPN    : KIKF            QACUDL          LLJBOHNO        VIJSX           FGTWJPPWCPVFK  
IYKBKDEEF       : CLPDUUHF        JCYJOFG         GGRFBCIQLXV    
OKAR            : XTGU            IAGDPKQCOEHUQJ 
QWMKM           : MYXHCAKVAH      MHLPTHOL        YNCWAYALUWU    
TBIAX           : LCQWPNUU        JJHBSGDCNAMU   
PPSDBRPCDU      : VSGTPVLVOWANS   KRIOCICULD      WONFHJPBTGDC    GGRFBCIQLXV     OOQHXTL         JLVRVKBKSEMUW   FTQLYJAMQQE    
JBWXNYRTRO      : FDNPTTJ         UPNCGATYPOXY    RJHOWXAM       
DDGWHOY         : MASAVK          JXKIIBQWSKSRQ   QWEEUBKINWQNDE  MDYRNANN        NOMFRQCW       
TOVNUYF         : NAWSQQRLAPC     XQGFCYVSXUD    
DKGLVJKWY       : TOKBL           LSVOMBKBGUQMD   PKIPKIRXDOS    
OSCE            : PBEAI           LFBDPJUN        XWHNKNJVWY      BCPQHWULM      
FJIEQXDWRUUH    : IIOVPUBQUHR     EDUSXTMWAKF     SHAIDEQIWWDWO   UNETBUKSUFOE   
TPCYAKKYVXVUH   : CIJFTYIR        QQPL            FKOCU           NFTDJMBHVWXY   
OJQQQB          : OWFSYYN        
WRYBQTX         : HERUBVD         LAYHDRLQP       FSXOHAEBVMFCW   UVJRBOSJSP      BYYUJPLLUDCF   
DPJSTIVHVUDT    : NRTUBJEDJBYXSNJ UIDLGS          UOUKCSSEAVSOBP  FLTKQBCRCQFESM 
YBDPNWI         : WPOYMXINRB      RTNAHLNF        BJGJJ          
XJERL           : GWAS            BJGJJ           CVLIYIQEWHWNXXS
LHHYKWLGSTEARB  : CYLKLX          WLSHES          RVWFJKIX        QWTHN          
LTFPWWFVFN      : NRVWCBSWCELJLSC FCJRR           TDQNLMOYDH      FSXOHAEBVMFCW   XFFMF          
QTOC            : TFHNJQFPKP      JPTVBVLRAQBYVH  CSXLPQW        
CLKBY           : VDPSOF          BJGJJ           BYMLCYGGOEEOAOB
OFDJJDBKJPEOFD  : TDQNLMOYDH      SMLELCGYGLVYMS  GEQMCPFEYYL     MENKARISIEVA    FNIVJ           UTYAMNLIGBAKTX 
MASAVK          : DDGWHOY         GEQMCPFEYYL     IRRUGS         
MOXODLSCUHHA    : ODIFSRLOHFEFTJ  XOHKWHSAWD     
SEWFP           : TIFDC           CIBTV           TOKBL           SRKOXNF         WERTSXKIFYJ     AGFVUE         
LHTQUI          : MYXHCAKVAH      IONRSVUMR      
QIPDFERE        : HCAJC           UIDLGS          WSHJEIAKV       XGJA           
WPOYMXINRB      : KELAEBRMAPYFTWR YBDPNWI        
QIJDT           : EDDMKCYFRMP     IIWKHQEPOBQGBI  KMJOFBAAQNXKJWP
YLOHEFRVI       : XCKSU           RYGDWVFP        LIRTKPVE        EDDMKCYFRMP     VMYJBNQSFT     
BCEWATNBILKV    : CDQVUSXRTA      WSTTDYPUROAPRFW BNWJMBHHFDV     SOYNECT        
NRVWCBSWCELJLSC : LTFPWWFVFN      NJJCHGNDUG      HYDLB          
DCKGGJ          : MIDOLOFJCX      NDFEBNYCOOX     PJEJQGOEH       UNETBUKSUFOE   
CYLKLX          : LHHYKWLGSTEARB  GWWHOQKNBYYMJAA SRKOXNF         YMCSWRKHRLW     LCUOFEPRWXMSH  
SMBR            : YBAOK           FXTL            KHSFNLB         OBXUDVGDIQVAT  
FUEDXLOJW       : SMBMUWOLI       DFRGNWCHJSOQW   EUDS            MENKARISIEVA   
NGNPTT          : BRMSAKWRUIHHBDX NQNXVEJTPFKUUDC GCPDJ           COWFCNBYG       GVPU            BHYMPGUVITAD   
DEAD            : QNAEGWIWJ       JMLLJ          
LQQULDXDQEBXH   : UVJRBOSJSP      AEYAR           OAMG           
JXKIIBQWSKSRQ   : HNSNQMAQCYYWW   DDGWHOY         WERTSXKIFYJ     VDSGXU         
TTQFMJCXNBEGFF  : CGQGMXNROX      CSIAPAUJEIUAWA  GSCQJSIFOD      ESBNLT          MANISCBQCBFPCL 
OIPMUXVVR       : DQSG           
RCNLUN          : PKMBKP          YGJVO           HKIRMVNVED      UODGY          
OGLBQ           : NBANAKBQWBTFKK  TUJVHWEEIOASPB 
CGQGMXNROX      : TTQFMJCXNBEGFF  QNAEGWIWJ       GMCRLBU         XHBH            JPKVWQPTBHL    
CSIAPAUJEIUAWA  : TTQFMJCXNBEGFF  NETN            LRLOWNL        
FNUVEWCWFPXUJMS : BRMSAKWRUIHHBDX FOTPSGQQOBA     UTYAMNLIGBAKTX 
OLYODBLM        : JEYCLVNREGQ     FTGLTSELTPOH    YLQJBLP         BHYMPGUVITAD   
UJITKYY         : CIJFTYIR        KVGVBVBEGKOY   
VXCU            : VSSTFGMDMXNQHI  OWFSYYN         HOUYRVEWIYVNHHA
CARAWBMPUE      : ATHPVFEMI       IUBOLBTUQATJH  
TUJVHWEEIOASPB  : OGLBQ           VXCFYUOIURUQS  
MYXHCAKVAH      : QWMKM           LHTQUI          IPNELJO         REWQWJEDWG      IWEDA           BCPQHWULM       TJOEUJ         
PXSTE           : FVNKFAFXABMOVUP HELXR           GQLK           
ONMXMSCVHC      : XQLWPTV         YWGYDKHUGGHXKLB
XEKMFJ          : JQHCURYBUYLWKIY CTHNXHVTAWHH    LFBDPJUN        HNEYFLWYXAHUBY  CVLIYIQEWHWNXXS
HJEEMMECMYVSNMG : PBELVGXWJLOKWC  FUHDCNHVTEMQ   
LVVNRESIE       : NEFDB           ADIQ            BJGJJ           EJDDHXPFYTKAOB 
VQEFMOQRUDGY    : PFNQFJN         FMMES           ELYMRTQIJ       GGRFBCIQLXV     JFPHDECN       
UAFPN           : XLWRKI          PJEJQGOEH       FJQU           
VSGTPVLVOWANS   : PPSDBRPCDU     
UXFJOYEUHF      : LNUJJCYVLGOXJ   MGRR            OWFSYYN         LSHHPSIQTOOY   
EFITUDSOJMEFBA  : WUMJNVWWVR      JNFCKLGHMRQCOHQ HCBHULXCNVTM    EXHKWC          KWBNJGMDVMQJNQJ
XCKSU           : YLOHEFRVI       LLTSPQDPVRBTD  
QCQHC           : LUHQHOGFVLSNLK  MJUPCABKYYTMJRM
EJCHQHRKFUDTE   : JPTVBVLRAQBYVH  CSXLPQW         FSADJSURQXRYF  
AJRCGRETKBBDF   : SWSIX           TMWYCCDDDOLQYD  TALXPH          LXPGSPTKSLJHKV  BNWJMBHHFDV     FTQLYJAMQQE    
MHRRTUBKEUULPBF : BGGN            LFXBHGDBGSR     QQWKENCXQON     UOIDGHFAOJPFIT  OUUEPRRH       
TFHNJQFPKP      : LNUJJCYVLGOXJ   QTOC            HYDLB          
NUWIHGBBCXE     : KRIOCICULD      IUBOLBTUQATJH  
EYMQQNXOHG      : JVPWFE          OPVLAL          GLTQDIN        
UPNCGATYPOXY    : JBWXNYRTRO     
HCAJC           : MFEVMQM         NBANAKBQWBTFKK  QIPDFERE        SYLFEKR         JFPHDECN        VIJSX           NPCMEUT        
BGGN            : HOMIKXPBWB      MHRRTUBKEUULPBF UJANMOXIU       KHSFNLB         FNIVJ          
YBAOK           : SMBR           
LFXBHGDBGSR     : MHRRTUBKEUULPBF DFRGNWCHJSOQW   QACUDL          RVWFJKIX       
RPPVRCXYDHHQIG  : JGHSKCYNUB      CQSMU           LEBTUUEIVDJK    NPGAYDPJ        HCHSMBHQXXV    
IUCOIJPLSVOVEK  : FMMES           ENUWMGWNXJMPDIP QRVJ            HDRBKNVEHFQGU   LAJOL          
NEFDB           : NAWSQQRLAPC     UGRBFSBI        LVVNRESIE       BBOYXGWKBAV    
FYWII           : VLQMLMQDOPWJ    VDPSOF          MTHPXHGYQRC     HXSRKNQCFR      VDKPTRUDNHGUBGS
BRMSAKWRUIHHBDX : NGNPTT          FNUVEWCWFPXUJMS ESBNLT         
IIOVPUBQUHR     : FJIEQXDWRUUH    JSXOUFKFUEE     REWQWJEDWG     
RBAT            : OOUYOOUWVEBCE   BEVC            FUHDCNHVTEMQ    PBEAI           HJRHKD          BPBF            UTYAMNLIGBAKTX 
OOUYOOUWVEBCE   : IDASCAVWHXX     RBAT            ALVOASOYWRBB    DQTFKBGWFNR     CSXLPQW         FNIVJ           IXULHWTVTIMGC   GQLK           
MNRKFOLVL       : OGJPDRIF        ATHPVFEMI       HCBHULXCNVTM    QXOYLVSQGFRNC  
PFNQFJN         : VQEFMOQRUDGY    OKJTPPLQVQN     QVRTTECYDUXRID  UVJRBOSJSP     
ALVOASOYWRBB    : OOUYOOUWVEBCE   NJJCHGNDUG      VXCFYUOIURUQS  
NQNXVEJTPFKUUDC : VSSTFGMDMXNQHI  NGNPTT          VMWUNJNCSGAK    LRLOWNL        
RYGDWVFP        : XTGU            WSTTDYPUROAPRFW YLOHEFRVI       VNYBKGOFOTV     LCQWPNUU        GMCRLBU         DFRGNWCHJSOQW   NLETLH         
RYGDWVFP        : CVLIYIQEWHWNXXS FLTKQBCRCQFESM 
EOGH            : WUMJNVWWVR      QQPL            AJILWVIRN       HCHSMBHQXXV    
CUJQUHWHEN      : DQTFKBGWFNR     IIWKHQEPOBQGBI  JCYJOFG         BYYUJPLLUDCF    OQRHVC         
OKJTPPLQVQN     : PFNQFJN         OWFSYYN         AQCITOH         AGVUSALXPG     
YDGDRONJR       : OWFSYYN         PPBEH           FIXGLQ         
UIGF            : AUQHW           AGVUSALXPG     
NJWCAIL         : NVEWVPK         SXAWLMYGVSOC   
ADIQ            : LVVNRESIE       EDDMKCYFRMP     CVLIYIQEWHWNXXS OUUEPRRH       
BEVC            : RBAT            VRXKTCJOYSICJB  BCPQHWULM      
CIBTV           : SEWFP           WERTSXKIFYJ     XAOOCC         
LEIVKPDABBCBL   : DUDXWKEOHX      WXFAH           HOUYRVEWIYVNHHA SIJXDKVXK      
WLSHES          : LHHYKWLGSTEARB  QRVJ            FUHDCNHVTEMQ    QTREX           BGXDARRSHW      WONFHJPBTGDC    PCNM            NPGAYDPJ       
IONRSVUMR       : LHTQUI          QRVJ            AUNMVLCKHIIWUO  IISAPTDX        UOUKCSSEAVSOBP 
XYPVJH          : BYMRC           VRXKTCJOYSICJB 
MIDOLOFJCX      : DCKGGJ          LCNTVGEG        AUXNHVCD       
GSCQJSIFOD      : TTQFMJCXNBEGFF  KVGVBVBEGKOY    ESWHBWHR        JCYJOFG        
HMUGFQRMQEVTVHK : RAYTUGYFLVX     VKOEORRPTG      EDUSXTMWAKF     UTYAMNLIGBAKTX  NJPDRPEUI       OQRHVC         
SMBMUWOLI       : HNSNQMAQCYYWW   FUEDXLOJW       CLPDUUHF        XOHKWHSAWD     
VNYBKGOFOTV     : RYGDWVFP        FIWJTQCKUMTAIU 
IPNELJO         : MYXHCAKVAH      PPBEH           WCPQRVHPEOSK    MKMBJAHOWONJT  
MHLPTHOL        : QWMKM           QVUJVQD        
XUTNTWXC        : UJANMOXIU       AEYAR          
FSHCASRPW       : DDMUYFGIJFJP    PLXCJDWLGGGE   
BNCNVOFRXWDU    : JGHSKCYNUB     
BOKUOL          : NDFEBNYCOOX     RTNAHLNF        NPGAYDPJ        XHBH           
CQSMU           : RPPVRCXYDHHQIG  OWFSYYN        
FMMES           : WOXLLISRCPSY    MFEVMQM         VQEFMOQRUDGY    IUCOIJPLSVOVEK  RUCPMBDI       
SWDOLJGLGMHDN   : IDQWOWDCTCRC    GMCRLBU         IISAPTDX       
PKMBKP          : RCNLUN          VMWUNJNCSGAK    TSCNBI          UFOICD         
GCPDJ           : NGNPTT          CIJFTYIR        JNVKAJDXYQYJT   WSHJEIAKV       BCPQHWULM      
QNAEGWIWJ       : SQFF            UGRBFSBI        MKVNSYFEPURM    DEAD            CGQGMXNROX      QACUDL         
GWAS            : XJERL           HOUYRVEWIYVNHHA JEYCLVNREGQ     RUCPMBDI       
FIFWS           : FIWJTQCKUMTAIU  UTNLVNC         JSXOUFKFUEE     LSVOMBKBGUQMD   LLJBOHNO        CJLHTSFBBOBNAC  LPBQYNYK        LONPASUHTNOSH  
FIFWS           : WXGCF           FFXVXY          WERVLJTQACUDJ  
YGJVO           : RCNLUN          STJNWVO         KRVBDIKIJKXTEVO QOSDRVBD        UODGY           PLXCJDWLGGGE   
LRWSINSNTQXT    : JNFCKLGHMRQCOHQ WCWPKSJBNJSCDFX QRDVTTYJOCCVEXA SOYNECT        
RAYTUGYFLVX     : FDNPTTJ         DQSG            HMUGFQRMQEVTVHK AUQHW           MKMBJAHOWONJT  
WGRUUHHNHCX     : VDPYBTCYQXM     HLBFPIMCW       SYLFEKR         LDDAFEWI        GNWY           
VLQMLMQDOPWJ    : FYWII           WQPLN           LIRTKPVE       
XQLWPTV         : HOMIKXPBWB      ONMXMSCVHC      FCJRR           OTKEKJ          HUVCLNNW        SHKEYPPTGBEMOP 
NRTUBJEDJBYXSNJ : DPJSTIVHVUDT    QTREX           BJGJJ           VIJSX          
ENUWMGWNXJMPDIP : WOXLLISRCPSY    IUCOIJPLSVOVEK  FXOGUNCBRR      QVRTTECYDUXRID  OTKEKJ          KGAVP          
CLPDUUHF        : IYKBKDEEF       SMBMUWOLI       OBDYUKHRUDKYPHN SECUTLQNI       SWDDI           UNETBUKSUFOE   
IDQWOWDCTCRC    : SWDOLJGLGMHDN   FCJRR           HQRVSGYLUJKJ    SIDBXPB        
FCJRR           : MGRR            LTFPWWFVFN      XQLWPTV         IDQWOWDCTCRC    PTXVUHJ        
CIJFTYIR        : TPCYAKKYVXVUH   UJITKYY         GCPDJ           GMCRLBU        
RYQBEHASGFXCI   : OBDYUKHRUDKYPHN HYDLB           IOFHPDV         GNWY           
FIWJTQCKUMTAIU  : VNYBKGOFOTV     FIFWS           SIJXDKVXK      
CPFDIIHRID      : IDASCAVWHXX     IXLSDXYTPB      TWAJKF         
OBDYUKHRUDKYPHN : CDQVUSXRTA      CLPDUUHF        RYQBEHASGFXCI   PPBEH           KGCAXPI         NPGAYDPJ       
KVGVBVBEGKOY    : DQSG            UJITKYY         GSCQJSIFOD      FIXGLQ          VQCNEGF        
RALUFK          : HLBFPIMCW       YNCWAYALUWU     MJUPCABKYYTMJRM
STJNWVO         : DQSG            YGJVO          
DCAN            : MXMMIVC         KUCLTUJOAQV    
HLBFPIMCW       : WGRUUHHNHCX     RALUFK          USSEEK          HNEYFLWYXAHUBY  DJRKUNVNR       LMXWASDMKV     
WQPLN           : VLQMLMQDOPWJ    OPVLAL         
VDPSOF          : CLKBY           FYWII           GWEXSETNLDHW    VIJSX          
MTHPXHGYQRC     : FYWII           FGLCLB          DFRGNWCHJSOQW   FAWXUODIOF     
JMLLJ           : NKUPKTM         DEAD            IXLSDXYTPB      TJOEUJ         
LCQWPNUU        : KELAEBRMAPYFTWR TBIAX           RYGDWVFP        PKIPKIRXDOS     VRXKTCJOYSICJB  LXPGSPTKSLJHKV  OBBWOGIHCNJY   
NLJGXGN         : DDMUYFGIJFJP   
GWWHOQKNBYYMJAA : CYLKLX          FURJY          
QWEEUBKINWQNDE  : QNYRHCSGBRY     DDGWHOY         WXFAH           IRRUGS          NJPDRPEUI      
LEBTUUEIVDJK    : RPPVRCXYDHHQIG  HOKNAMC         QWHWNKYMCHW    
JNFCKLGHMRQCOHQ : EFITUDSOJMEFBA  LRWSINSNTQXT    AUQHW          
OWFSYYN         : OJQQQB          VXCU            UXFJOYEUHF      OKJTPPLQVQN     YDGDRONJR       CQSMU           VEYS            GVPU           
FXTL            : SMBR            MRIVXKO         IRRUGS          IISNVDTSECL    
ECSRHUFSBMIUFK  : UFDKJSFMJ      
NDFEBNYCOOX     : DCKGGJ          BOKUOL          DQTFKBGWFNR     SXTGR          
MRIVXKO         : FXTL            UFASQNDMYEIS   
UJANMOXIU       : BGGN            XUTNTWXC        NJJCHGNDUG      SYLFEKR         VLAJIPRDPQCD    FSBVUXFELFEAWIF
VKOEORRPTG      : HMUGFQRMQEVTVHK GBEIVCVLUS      DJRKUNVNR      
TDQNLMOYDH      : LTFPWWFVFN      OFDJJDBKJPEOFD  SOYNECT        
MJJYXIJS        : UOIDGHFAOJPFIT  PSQOXDMXDOH     KFQSNM          JPKVWQPTBHL    
GFKKV           : VSSTFGMDMXNQHI  FVNKFAFXABMOVUP XWHNKNJVWY      NDTSSBPYN       CSGVLW         
ELYMRTQIJ       : VQEFMOQRUDGY    BGXDARRSHW      HJRHKD          BJGJJ           UNETBUKSUFOE   
WXFAH           : JVPWFE          LEIVKPDABBCBL   QWEEUBKINWQNDE  AWPBYUIS       
OQLQPTAKNISXUOD : NFTDJMBHVWXY    LONPASUHTNOSH  
DDMUYFGIJFJP    : FSHCASRPW       NLJGXGN         YSFBUQFTST      ILWPEI          BNWJMBHHFDV    
QQWKENCXQON     : MHRRTUBKEUULPBF EDUSXTMWAKF     EHKSSATMO       VMVEK          
HOUYRVEWIYVNHHA : VXCU            LEIVKPDABBCBL   GWAS            RJHOWXAM       
QRVJ            : IUCOIJPLSVOVEK  WLSHES          IONRSVUMR       IOFHPDV        
UTNLVNC         : XTGU            FIFWS           QQPL            WLRRYJ         
EDUSXTMWAKF     : FJIEQXDWRUUH    HMUGFQRMQEVTVHK QQWKENCXQON     IGWXJNKUWLMG   
GTJNTYGLWQ      : SMLELCGYGLVYMS  XFFMF           BYMRC           XQGFCYVSXUD     WLRRYJ          KRVBDIKIJKXTEVO AQCITOH        
SMLELCGYGLVYMS  : OFDJJDBKJPEOFD  GTJNTYGLWQ      KQFPYR          FLTKQBCRCQFESM  YMCSWRKHRLW    
JSXOUFKFUEE     : IIOVPUBQUHR     FIFWS           JJHBSGDCNAMU    FSADJSURQXRYF  
REWQWJEDWG      : MYXHCAKVAH      IIOVPUBQUHR     DGOGUTNEGV      QVUJVQD        
VMWUNJNCSGAK    : LQBSCHIENCROD   NQNXVEJTPFKUUDC PKMBKP          WCPQRVHPEOSK    QXOYLVSQGFRNC  
FUHDCNHVTEMQ    : HJEEMMECMYVSNMG RBAT            WLSHES          SXAWLMYGVSOC   
RTNAHLNF        : YBDPNWI         BOKUOL          BHXJNH         
DQTFKBGWFNR     : OOUYOOUWVEBCE   CUJQUHWHEN      NDFEBNYCOOX     VRXKTCJOYSICJB  LYODNSIVOEN     NSVVMPHN       
STECSYG         : IDASCAVWHXX     UIDLGS          FSBVUXFELFEAWIF
PYYMMCVA        : BHAAQNLFXJC     KQFPYR          AUXNHVCD       
BHUSD           : PNHEHJSQKIC     SUKAKDUEFW     
FGLCLB          : VDPYBTCYQXM     MTHPXHGYQRC     KGAVP          
AUQHW           : UIGF            RAYTUGYFLVX     JNFCKLGHMRQCOHQ QFBUEPQWGED     SIJXDKVXK      
GGSXFUMTW       : LSHHPSIQTOOY    JPTVBVLRAQBYVH  MHVNJQX         ESAPY          
TOKBL           : WIRCLKXJDYBABG  LAYHDRLQP       DKGLVJKWY       SEWFP           PBEAI           JFPHDECN       
HOKNAMC         : LEBTUUEIVDJK    QACUDL         
JEYCLVNREGQ     : PVMSIKHAURCIDYX OLYODBLM        GWAS            IIWKHQEPOBQGBI  UFOICD         
BDDXOXOABBFIP   : SHAIDEQIWWDWO   UODGY          
YSFBUQFTST      : VDPYBTCYQXM     DDMUYFGIJFJP    SEBFGQPYS       NPCMEUT        
ILWPEI          : NKUPKTM         DDMUYFGIJFJP    SRKOXNF         HEGMO          
KMRYMIYPJHBCCA  : PTXVUHJ        
HDRBKNVEHFQGU   : MGRR            IUCOIJPLSVOVEK  XLWRKI         
PNHEHJSQKIC     : BHUSD           NOHM            SEBFGQPYS      
JETJBE          : XWHNKNJVWY      JCYJOFG         KNNDMW          TJOEUJ          FURJY          
SHAIDEQIWWDWO   : FJIEQXDWRUUH    BDDXOXOABBFIP   PEQVI           XGJA           
ESBNLT          : TTQFMJCXNBEGFF  BRMSAKWRUIHHBDX SUKAKDUEFW      VDKPTRUDNHGUBGS
UWSGDPQFVFADH   : QNLNBTOWTKEJHKP XWHNKNJVWY      KYTT            BYYUJPLLUDCF   
GMCRLBU         : HOMIKXPBWB      CGQGMXNROX      RYGDWVFP        SWDOLJGLGMHDN   CIJFTYIR        TLIRJ           XGJA            XAOOCC         
QQPL            : TPCYAKKYVXVUH   EOGH            UTNLVNC         HCELHJLBBEWM    OOQHXTL        
FXOGUNCBRR      : ENUWMGWNXJMPDIP OTKEKJ          BPBF            NJPDRPEUI       HNEYFLWYXAHUBY 
YPCYUJKBXOSKQQ  : DQSG            HOMIKXPBWB      LSHHPSIQTOOY   
JJKUEQSVYPJBRDU : NBANAKBQWBTFKK  TALXPH          KGAVP           UFASQNDMYEIS    LONPASUHTNOSH  
EKPGFAQJAIEKBW  : UGRBFSBI        EHKSSATMO       SEBFGQPYS       VLAJIPRDPQCD    BYYUJPLLUDCF   
KHSFNLB         : LAYHDRLQP       SMBR            BGGN            FVNKFAFXABMOVUP UOIDGHFAOJPFIT 
LSVOMBKBGUQMD   : DKGLVJKWY       FIFWS           LSHHPSIQTOOY    XOHKWHSAWD     
FOTPSGQQOBA     : FNUVEWCWFPXUJMS
JNVKAJDXYQYJT   : GCPDJ           VQCNEGF         WSHJEIAKV      
GKTJGCXCRTI     : ESWHBWHR       
MXMMIVC         : IDASCAVWHXX     HNSNQMAQCYYWW   DCAN            AWPBYUIS        WSHJEIAKV       FAWXUODIOF      VMVEK          
GEQMCPFEYYL     : OFDJJDBKJPEOFD  MASAVK          EUDS           
LIRTKPVE        : YLOHEFRVI       VLQMLMQDOPWJ    USSEEK          QXOYLVSQGFRNC  
HPXFDKPYPV      : HNSNQMAQCYYWW   COWFCNBYG       NETN            KIKF           
TMWYCCDDDOLQYD  : AJRCGRETKBBDF   DEYOOXYYODOD    AJILWVIRN      
LUHQHOGFVLSNLK  : QCQHC           QNLNBTOWTKEJHKP IIWKHQEPOBQGBI  NDOUBOODAI     
VEYS            : OWFSYYN         PEQVI          
EWIJAXUQYXELV   : SLAXCDUWTNO     VDPYBTCYQXM     QACUDL          UVJRBOSJSP     
EDDMKCYFRMP     : QIJDT           YLOHEFRVI       ADIQ            QOSDRVBD        BCPQHWULM      
IWEDA           : MYXHCAKVAH      AJTCJPUKPAVLO   OAUVCTYWRTFUUBP HELXR           AEYAR           GQLK           
AJTCJPUKPAVLO   : PVMSIKHAURCIDYX NAUWRVVH        IWEDA           PBEAI           TTWPJ           KGCAXPI        
QTREX           : WLSHES          NRTUBJEDJBYXSNJ FLTKQBCRCQFESM 
JQHCURYBUYLWKIY : WSTTDYPUROAPRFW QNYRHCSGBRY     XEKMFJ          JKGNLQGTLSMRKM  TTWPJ           QXOYLVSQGFRNC   GGRFBCIQLXV    
ATHPVFEMI       : CARAWBMPUE      MNRKFOLVL       HKIRMVNVED      FTGLTSELTPOH    FJQU           
HCBHULXCNVTM    : EFITUDSOJMEFBA  MNRKFOLVL       FAWXUODIOF     
QNLNBTOWTKEJHKP : PVMSIKHAURCIDYX UWSGDPQFVFADH   LUHQHOGFVLSNLK  QFBUEPQWGED    
UNDWO           : YRYFJAMFDXJCB  
TALXPH          : AJRCGRETKBBDF   JJKUEQSVYPJBRDU FIXGLQ          HASAGILSY      
EHKSSATMO       : QQWKENCXQON     EKPGFAQJAIEKBW 
IYXRIIKFFX      : ACUBC           DUDXWKEOHX      CMAVPM          SIDBXPB        
CMAVPM          : NKUPKTM         UGRBFSBI        IYXRIIKFFX      HYDLB          
FVNKFAFXABMOVUP : LVBQCKV         PXSTE           GFKKV           KHSFNLB         IRWBRGEOOW     
PBEAI           : OSCE            RBAT            TOKBL           AJTCJPUKPAVLO  
AUNMVLCKHIIWUO  : IONRSVUMR       XFTS            IUBOLBTUQATJH  
COWFCNBYG       : OGJPDRIF        NGNPTT          HPXFDKPYPV     
QJCSROSOCGKOIUV : OAMG            KNNDMW         
GVPU            : PBELVGXWJLOKWC  NGNPTT          OWFSYYN         FGTWJPPWCPVFK  
RJSYNIDN        : EUDS            NJPDRPEUI       LGPNUVLOJEWB   
BGXDARRSHW      : WLSHES          ELYMRTQIJ       NETN           
TLIRJ           : GMCRLBU         IIWKHQEPOBQGBI  UOIDGHFAOJPFIT 
XFTS            : SQFF            WIRCLKXJDYBABG  AUNMVLCKHIIWUO 
NETN            : CSIAPAUJEIUAWA  HPXFDKPYPV      BGXDARRSHW     
ESITTOTWQMRKVOJ : DJRKUNVNR      
CTHNXHVTAWHH    : XEKMFJ          XGJA            VXCFYUOIURUQS  
WCWPKSJBNJSCDFX : LRWSINSNTQXT    FSBVUXFELFEAWIF SIDBXPB         SGODJ          
OPVLAL          : EYMQQNXOHG      WQPLN           VRXKTCJOYSICJB 
HHFKGORYOT      : PVMSIKHAURCIDYX KYTT            LKVKXTR         TUGHEFPUJ       SIDBXPB        
EGTQ            : SLAXCDUWTNO     BDVFEOFQYKWMAQI KELAEBRMAPYFTWR AGFVUE          AUXNHVCD        WERVLJTQACUDJ  
HCELHJLBBEWM    : QQPL            XFFMF           PCNM            EXHKWC          MKMBJAHOWONJT  
IXLSDXYTPB      : CPFDIIHRID      JMLLJ          
LCNTVGEG        : MKVNSYFEPURM    MIDOLOFJCX      ESAPY          
IRRUGS          : MASAVK          QWEEUBKINWQNDE  FXTL            FSXOHAEBVMFCW   UTYAMNLIGBAKTX 
KRIOCICULD      : WOXLLISRCPSY    PPSDBRPCDU      NUWIHGBBCXE     DEMSISO         HEGMO          
FSXOHAEBVMFCW   : WRYBQTX         LTFPWWFVFN      IRRUGS          UIDLGS          KGAVP          
WONFHJPBTGDC    : PPSDBRPCDU      WLSHES          OOQHXTL        
YPNVWJV         : UKEVPQWFVCD     GBEIVCVLUS      VLAJIPRDPQCD   
QVRTTECYDUXRID  : PFNQFJN         ENUWMGWNXJMPDIP IRWBRGEOOW      JFPHDECN        OOQHXTL        
TSCNBI          : DUDXWKEOHX      JGHSKCYNUB      PKMBKP          ATJUJBCXLEHUNST IISAPTDX       
NJJCHGNDUG      : SQFF            NRVWCBSWCELJLSC ALVOASOYWRBB    UJANMOXIU       EJDDHXPFYTKAOB  UODGY           OQRHVC         
OAUVCTYWRTFUUBP : VSSTFGMDMXNQHI  YRYFJAMFDXJCB   IWEDA           QRDVTTYJOCCVEXA BHXJNH          SEBFGQPYS       AQCITOH         MDYRNANN       
QSKIHTTLBBY     : VDKPTRUDNHGUBGS IISNVDTSECL    
XFFMF           : LTFPWWFVFN      GTJNTYGLWQ      HCELHJLBBEWM   
IIWKHQEPOBQGBI  : QIJDT           CUJQUHWHEN      JEYCLVNREGQ     LUHQHOGFVLSNLK  TLIRJ          
LSHHPSIQTOOY    : SQFF            XXIXUSCKBBNO    UXFJOYEUHF      GGSXFUMTW       YPCYUJKBXOSKQQ  LSVOMBKBGUQMD   IGWXJNKUWLMG    AQCITOH        
LSHHPSIQTOOY    : EJDDHXPFYTKAOB  HXSRKNQCFR     
DEYOOXYYODOD    : TMWYCCDDDOLQYD  PTXVUHJ        
HKIRMVNVED      : RCNLUN          ATHPVFEMI       MENKARISIEVA    PQID           
OTKEKJ          : XQLWPTV         ENUWMGWNXJMPDIP FXOGUNCBRR     
PPBEH           : YDGDRONJR       IPNELJO         OBDYUKHRUDKYPHN
DGOGUTNEGV      : JGHSKCYNUB      REWQWJEDWG      RVWFJKIX       
SRKOXNF         : SEWFP           CYLKLX          ILWPEI          LCUOFEPRWXMSH  
JPTVBVLRAQBYVH  : QTOC            EJCHQHRKFUDTE   GGSXFUMTW      
DEMSISO         : LNUJJCYVLGOXJ   KRIOCICULD      FKOCU           UOIDGHFAOJPFIT  KGCAXPI        
MIPDHFLWODQMF   : XXIXUSCKBBNO    CSXLPQW         PLXCJDWLGGGE   
BYMRC           : XYPVJH          GTJNTYGLWQ      PCNM            LLTSPQDPVRBTD   SWDDI          
PJGUNSNXMEEBNV  : WSTTDYPUROAPRFW GBEIVCVLUS      KMJOFBAAQNXKJWP
WERTSXKIFYJ     : HERUBVD         SEWFP           JXKIIBQWSKSRQ   CIBTV           HUVCLNNW       
ODIFSRLOHFEFTJ  : MOXODLSCUHHA    BHXJNH          EQAA            LLTSPQDPVRBTD   RJHOWXAM       
UWKBVOVPJTCRY   : UOIDGHFAOJPFIT  GGRFBCIQLXV    
DFRGNWCHJSOQW   : BDVFEOFQYKWMAQI FUEDXLOJW       LFXBHGDBGSR     RYGDWVFP        MTHPXHGYQRC     LFBDPJUN        LMQYJAJSSPCMAAB RJHOWXAM       
KIKF            : RPJIOKEUUOPN    HPXFDKPYPV      GWEXSETNLDHW   
UIDLGS          : DPJSTIVHVUDT    QIPDFERE        STECSYG         FSXOHAEBVMFCW   GWEXSETNLDHW   
AWPBYUIS        : WXFAH           MXMMIVC        
XQGFCYVSXUD     : TOVNUYF         GTJNTYGLWQ      USSEEK         
FKOCU           : MKVNSYFEPURM    TPCYAKKYVXVUH   DEMSISO         FNIVJ           RUCPMBDI        VMVEK          
PCNM            : WLSHES          HCELHJLBBEWM    BYMRC           NDTSSBPYN       CSGVLW         
LEGMAQFEP       : SUKAKDUEFW      CVLIYIQEWHWNXXS
KUCLTUJOAQV     : IDASCAVWHXX     DCAN           
IAGDPKQCOEHUQJ  : OKAR            TTWPJ           UODGY          
YNCWAYALUWU     : QWMKM           RALUFK         
XOHKWHSAWD      : MOXODLSCUHHA    SMBMUWOLI       LSVOMBKBGUQMD   JJHBSGDCNAMU    NVEWVPK         ENBAGBNGTUOOCU 
CSXLPQW         : QTOC            EJCHQHRKFUDTE   OOUYOOUWVEBCE   MIPDHFLWODQMF   XLWRKI          KUWOPXMCTH     
PKIPKIRXDOS     : DKGLVJKWY       LCQWPNUU        YMCSWRKHRLW    
OJWCGHW         : UVJRBOSJSP      QOSDRVBD        UTYAMNLIGBAKTX 
GBEIVCVLUS      : VKOEORRPTG      YPNVWJV         PJGUNSNXMEEBNV  NLETLH         
LFBDPJUN        : WIRCLKXJDYBABG  OSCE            XEKMFJ          DFRGNWCHJSOQW   ENBAGBNGTUOOCU  PQID           
JJHBSGDCNAMU    : YRIRBW          TBIAX           JSXOUFKFUEE     XOHKWHSAWD      SYLFEKR        
QFBUEPQWGED     : AUQHW           QNLNBTOWTKEJHKP
HUVCLNNW        : XQLWPTV         WERTSXKIFYJ     RUCPMBDI        LKVKXTR        
QRDVTTYJOCCVEXA : LRWSINSNTQXT    OAUVCTYWRTFUUBP PSQOXDMXDOH    
QACUDL          : RPJIOKEUUOPN    LFXBHGDBGSR     QNAEGWIWJ       HOKNAMC         EWIJAXUQYXELV   GWEXSETNLDHW   
AJILWVIRN       : EOGH            TMWYCCDDDOLQYD  EUDS            SEBFGQPYS       KWBNJGMDVMQJNQJ
XLWRKI          : UAFPN           HDRBKNVEHFQGU   CSXLPQW         QVUJVQD         BHYMPGUVITAD   
NLETLH          : RYGDWVFP        GBEIVCVLUS      GQLK           
EHTBMHFMRNB     : HNSNQMAQCYYWW   EQAA            YMCSWRKHRLW    
LLJBOHNO        : SLAXCDUWTNO     MKVNSYFEPURM    RPJIOKEUUOPN    FIFWS           CQRQSBHHOHG     BPBF           
XWHNKNJVWY      : OSCE            GFKKV           JETJBE          UWSGDPQFVFADH   USSEEK         
EUDS            : PVMSIKHAURCIDYX FUEDXLOJW       GEQMCPFEYYL     RJSYNIDN        AJILWVIRN      
IGWXJNKUWLMG    : EDUSXTMWAKF     LSHHPSIQTOOY    YWGYDKHUGGHXKLB MGVENDQQEFPEMP 
BHAAQNLFXJC     : PYYMMCVA        SYLFEKR         UTYAMNLIGBAKTX 
MJUPCABKYYTMJRM : QCQHC           RALUFK         
ESWHBWHR        : UGRBFSBI        GSCQJSIFOD      GKTJGCXCRTI     CQRQSBHHOHG     SJEBMELICRF     XHBH           
SYLFEKR         : HCAJC           WGRUUHHNHCX     UJANMOXIU       JJHBSGDCNAMU    BHAAQNLFXJC     PTXVUHJ        
HJRHKD          : CDQVUSXRTA      RBAT            ELYMRTQIJ      
KYTT            : UWSGDPQFVFADH   HHFKGORYOT      OBXUDVGDIQVAT   FGTWJPPWCPVFK   HEGMO          
IRWBRGEOOW      : FVNKFAFXABMOVUP QVRTTECYDUXRID  PRNH           
JXNOCBIRI       : KGAVP           TUGHEFPUJ      
KQFPYR          : SMLELCGYGLVYMS  PYYMMCVA        SJEBMELICRF     BNWJMBHHFDV     XHBH            FGTWJPPWCPVFK  
UOIDGHFAOJPFIT  : WOXLLISRCPSY    MHRRTUBKEUULPBF MJJYXIJS        KHSFNLB         TLIRJ           DEMSISO         UWKBVOVPJTCRY   UFDKJSFMJ      
JKGNLQGTLSMRKM  : NKUPKTM         JQHCURYBUYLWKIY
BHXJNH          : RTNAHLNF        OAUVCTYWRTFUUBP ODIFSRLOHFEFTJ  OBBWOGIHCNJY   
SHKEYPPTGBEMOP  : LAYHDRLQP       XQLWPTV         PJEJQGOEH      
WLRRYJ          : HOMIKXPBWB      UTNLVNC         GTJNTYGLWQ      PRNH           
NVEWVPK         : RKXRGGNUCIN     NJWCAIL         XOHKWHSAWD      MGVENDQQEFPEMP 
JFNTMMLEISF     : LHJDNAE        
FTGLTSELTPOH    : OLYODBLM        ATHPVFEMI       NDOUBOODAI     
SEKIPNUUDOJS    : AGVUSALXPG      AUXNHVCD       
NDTSSBPYN       : GFKKV           PCNM            AGVUSALXPG      UFDKJSFMJ      
TTWPJ           : XTGU            AJTCJPUKPAVLO   JQHCURYBUYLWKIY IAGDPKQCOEHUQJ  FIXGLQ          LRLOWNL        
WXGEIPTXMQCBB   : PVMSIKHAURCIDYX KGCAXPI        
EQAA            : ODIFSRLOHFEFTJ  EHTBMHFMRNB     BPBF           
SECUTLQNI       : CLPDUUHF        FNIVJ           VDKPTRUDNHGUBGS
YWGYDKHUGGHXKLB : ONMXMSCVHC      IGWXJNKUWLMG   
RRJU            : XGNXCHOGYQHO    VMVEK           QRPMQM         
FBGCUTSKFC      : VLAJIPRDPQCD   
CJLHTSFBBOBNAC  : HOMIKXPBWB      FIFWS           FFXVXY         
UVJRBOSJSP      : WRYBQTX         LQQULDXDQEBXH   PFNQFJN         EWIJAXUQYXELV   OJWCGHW         QOSDRVBD       
LAJOL           : IUCOIJPLSVOVEK 
AYUTSA          : UKEVPQWFVCD     NJPDRPEUI       CVLIYIQEWHWNXXS
VRXKTCJOYSICJB  : BEVC            XYPVJH          LCQWPNUU        DQTFKBGWFNR     OPVLAL          GLTQDIN        
CQRQSBHHOHG     : SLAXCDUWTNO     LLJBOHNO        ESWHBWHR       
BBOYXGWKBAV     : HERUBVD         ACUBC           NEFDB           HEGMO          
BPBF            : ACUBC           RBAT            FXOGUNCBRR      LLJBOHNO        EQAA            UFASQNDMYEIS    KNNDMW         
CSGVLW          : GFKKV           PCNM            PRNH           
MGVENDQQEFPEMP  : JGHSKCYNUB      IGWXJNKUWLMG    NVEWVPK         AEYAR          
PRNH            : IRWBRGEOOW      WLRRYJ          CSGVLW         
FIXGLQ          : SLAXCDUWTNO     YDGDRONJR       KVGVBVBEGKOY    TALXPH          TTWPJ          
HELXR           : PXSTE           IWEDA          
UXHAOYGVQ       : NPGAYDPJ       
KGCAXPI         : OBDYUKHRUDKYPHN AJTCJPUKPAVLO   DEMSISO         WXGEIPTXMQCBB   CAOSYOVN       
USSEEK          : VSSTFGMDMXNQHI  EEGFJEMNTRHSDEH MFEVMQM         HLBFPIMCW       LIRTKPVE        XQGFCYVSXUD     XWHNKNJVWY     
NOHM            : PNHEHJSQKIC     UFASQNDMYEIS    TWAJKF         
BJGJJ           : NBANAKBQWBTFKK  YBDPNWI         XJERL           CLKBY           LVVNRESIE       NRTUBJEDJBYXSNJ ELYMRTQIJ      
KRVBDIKIJKXTEVO : OGJPDRIF        YGJVO           GTJNTYGLWQ      FCHDMLFWNYW     VMVEK          
ATJUJBCXLEHUNST : TSCNBI          VQCNEGF         LCUOFEPRWXMSH  
LPBQYNYK        : FIFWS          
AGFVUE          : JGHSKCYNUB      SEWFP           EGTQ            SJEBMELICRF    
QOSDRVBD        : YGJVO           EDDMKCYFRMP     OJWCGHW         UVJRBOSJSP      VDSGXU          EJDDHXPFYTKAOB 
LXPGSPTKSLJHKV  : QNYRHCSGBRY     AJRCGRETKBBDF   LCQWPNUU       
MENKARISIEVA    : OFDJJDBKJPEOFD  FUEDXLOJW       HKIRMVNVED     
AEELEVTWN       : WUMJNVWWVR     
KGAVP           : ENUWMGWNXJMPDIP FGLCLB          JJKUEQSVYPJBRDU FSXOHAEBVMFCW   JXNOCBIRI       RVWFJKIX       
SXAWLMYGVSOC    : NJWCAIL         FUHDCNHVTEMQ    GGRFBCIQLXV    
PEQVI           : KELAEBRMAPYFTWR SHAIDEQIWWDWO   VEYS           
AEYAR           : LQQULDXDQEBXH   XUTNTWXC        IWEDA           MGVENDQQEFPEMP  WXGCF          
MANISCBQCBFPCL  : UMKMW           TTQFMJCXNBEGFF  LDDAFEWI        PQID            HNEYFLWYXAHUBY  RJHOWXAM       
WCPQRVHPEOSK    : IPNELJO         VMWUNJNCSGAK    RJHOWXAM       
SEBFGQPYS       : YSFBUQFTST      PNHEHJSQKIC     EKPGFAQJAIEKBW  OAUVCTYWRTFUUBP AJILWVIRN       LCUOFEPRWXMSH   LGPNUVLOJEWB   
QXWXPYJFYLWPGSW : WIRCLKXJDYBABG  RUCPMBDI        XGNXCHOGYQHO    KWBNJGMDVMQJNQJ OUUEPRRH       
YLQJBLP         : XXIXUSCKBBNO    OLYODBLM        IISNVDTSECL    
QVUJVQD         : MHLPTHOL        REWQWJEDWG      XLWRKI         
OAMG            : PVMSIKHAURCIDYX LQQULDXDQEBXH   QJCSROSOCGKOIUV RJHOWXAM        CAOSYOVN       
VLAJIPRDPQCD    : UJANMOXIU       EKPGFAQJAIEKBW  YPNVWJV         FBGCUTSKFC      SIJXDKVXK      
NFTDJMBHVWXY    : SQFF            TPCYAKKYVXVUH   OQLQPTAKNISXUOD PQID           
OBXUDVGDIQVAT   : SMBR            KYTT            JCYJOFG         OBBWOGIHCNJY    JVFCOPYJWGNC    YMCSWRKHRLW     IXULHWTVTIMGC  
QXOYLVSQGFRNC   : TIFDC           MNRKFOLVL       VMWUNJNCSGAK    LIRTKPVE        JQHCURYBUYLWKIY GQLK            VMYJBNQSFT     
LDDAFEWI        : WGRUUHHNHCX     MANISCBQCBFPCL  WSHJEIAKV      
FNIVJ           : OFDJJDBKJPEOFD  BGGN            OOUYOOUWVEBCE   FKOCU           SECUTLQNI      
RUCPMBDI        : FMMES           GWAS            FKOCU           HUVCLNNW        QXWXPYJFYLWPGSW
VQCNEGF         : KVGVBVBEGKOY    JNVKAJDXYQYJT   ATJUJBCXLEHUNST
LLTSPQDPVRBTD   : WIRCLKXJDYBABG  XCKSU           BYMRC           ODIFSRLOHFEFTJ  MDYRNANN       
LYODNSIVOEN     : DQTFKBGWFNR    
UTYAMNLIGBAKTX  : OFDJJDBKJPEOFD  FNUVEWCWFPXUJMS RBAT            HMUGFQRMQEVTVHK IRRUGS          OJWCGHW         BHAAQNLFXJC     UFASQNDMYEIS   
UTYAMNLIGBAKTX  : QRPMQM         
WSHJEIAKV       : QIPDFERE        GCPDJ           JNVKAJDXYQYJT   MXMMIVC         LDDAFEWI        EXHKWC         
SUKAKDUEFW      : BHUSD           ESBNLT          LEGMAQFEP      
SJEBMELICRF     : ESWHBWHR        KQFPYR          AGFVUE         
AQCITOH         : OKJTPPLQVQN     GTJNTYGLWQ      OAUVCTYWRTFUUBP LSHHPSIQTOOY    PJEJQGOEH      
JCYJOFG         : IYKBKDEEF       CUJQUHWHEN      GSCQJSIFOD      JETJBE          OBXUDVGDIQVAT   IUBOLBTUQATJH   FSADJSURQXRYF  
KEOFPSGCY       : AKYTXFGY       
NDOUBOODAI      : KELAEBRMAPYFTWR LUHQHOGFVLSNLK  FTGLTSELTPOH    EXHKWC          HASAGILSY      
HYDLB           : NRVWCBSWCELJLSC TFHNJQFPKP      RYQBEHASGFXCI   CMAVPM         
AGVUSALXPG      : HERUBVD         OKJTPPLQVQN     UIGF            SEKIPNUUDOJS    NDTSSBPYN      
UFDKJSFMJ       : ECSRHUFSBMIUFK  UOIDGHFAOJPFIT  NDTSSBPYN      
PJEJQGOEH       : DCKGGJ          UAFPN           SHKEYPPTGBEMOP  AQCITOH        
ENBAGBNGTUOOCU  : XOHKWHSAWD      LFBDPJUN        JPKVWQPTBHL    
NPGAYDPJ        : BDVFEOFQYKWMAQI RPPVRCXYDHHQIG  WLSHES          BOKUOL          OBDYUKHRUDKYPHN UXHAOYGVQ      
BCPQHWULM       : OSCE            MYXHCAKVAH      BEVC            GCPDJ           EDDMKCYFRMP    
NUACDTYSK       : UFASQNDMYEIS   
NJPDRPEUI       : HMUGFQRMQEVTVHK QWEEUBKINWQNDE  FXOGUNCBRR      RJSYNIDN        AYUTSA         
FJQU            : NAWSQQRLAPC     UAFPN           ATHPVFEMI       DJRKUNVNR      
AUXNHVCD        : MIDOLOFJCX      PYYMMCVA        EGTQ            SEKIPNUUDOJS   
GGRFBCIQLXV     : LNUJJCYVLGOXJ   IYKBKDEEF       PPSDBRPCDU      VQEFMOQRUDGY    JQHCURYBUYLWKIY UWKBVOVPJTCRY   SXAWLMYGVSOC   
OBBWOGIHCNJY    : LCQWPNUU        BHXJNH          OBXUDVGDIQVAT   SGODJ          
XGJA            : QIPDFERE        SHAIDEQIWWDWO   GMCRLBU         CTHNXHVTAWHH   
IISAPTDX        : NAWSQQRLAPC     IONRSVUMR       SWDOLJGLGMHDN   TSCNBI          IXULHWTVTIMGC  
QWHWNKYMCHW     : FDNPTTJ         XXIXUSCKBBNO    LEBTUUEIVDJK   
LKVKXTR         : HHFKGORYOT      HUVCLNNW        WXGCF          
VDSGXU          : JXKIIBQWSKSRQ   QOSDRVBD        SIJXDKVXK       FLTKQBCRCQFESM 
SXTGR           : NDFEBNYCOOX    
PQID            : HKIRMVNVED      LFBDPJUN        MANISCBQCBFPCL  NFTDJMBHVWXY   
UFASQNDMYEIS    : MRIVXKO         JJKUEQSVYPJBRDU BPBF            NOHM            UTYAMNLIGBAKTX  NUACDTYSK       FSBVUXFELFEAWIF KFQSNM         
EXHKWC          : EFITUDSOJMEFBA  HCELHJLBBEWM    WSHJEIAKV       NDOUBOODAI      HXSRKNQCFR     
RDFAWXRNJUI     : MDYRNANN        CAOSYOVN       
AKYTXFGY        : KEOFPSGCY       FURJY           YMCSWRKHRLW    
PTXVUHJ         : FCJRR           KMRYMIYPJHBCCA  DEYOOXYYODOD    SYLFEKR         FGTWJPPWCPVFK   FURJY          
LRLOWNL         : CSIAPAUJEIUAWA  NQNXVEJTPFKUUDC TTWPJ           LGPNUVLOJEWB   
FCHDMLFWNYW     : KRVBDIKIJKXTEVO BNWJMBHHFDV     BYYUJPLLUDCF   
GWEXSETNLDHW    : VDPSOF          KIKF            UIDLGS          QACUDL          FTQLYJAMQQE    
UOUKCSSEAVSOBP  : XTGU            DPJSTIVHVUDT    IONRSVUMR       KWBNJGMDVMQJNQJ
BNWJMBHHFDV     : BCEWATNBILKV    AJRCGRETKBBDF   DDMUYFGIJFJP    KQFPYR          FCHDMLFWNYW    
JFPHDECN        : DQSG            VQEFMOQRUDGY    HCAJC           TOKBL           QVRTTECYDUXRID 
XGNXCHOGYQHO    : HNSNQMAQCYYWW   RRJU            QXWXPYJFYLWPGSW
QDQALVF         : SOYNECT        
OOQHXTL         : PPSDBRPCDU      QQPL            WONFHJPBTGDC    QVRTTECYDUXRID  SIJXDKVXK      
IUBOLBTUQATJH   : CARAWBMPUE      NUWIHGBBCXE     AUNMVLCKHIIWUO  JCYJOFG        
XAOOCC          : CIBTV           GMCRLBU        
HNEYFLWYXAHUBY  : XEKMFJ          HLBFPIMCW       FXOGUNCBRR      MANISCBQCBFPCL  BHYMPGUVITAD    SGODJ          
FSBVUXFELFEAWIF : UJANMOXIU       STECSYG         WCWPKSJBNJSCDFX UFASQNDMYEIS    VIJSX          
PSQOXDMXDOH     : SWSIX           MJJYXIJS        QRDVTTYJOCCVEXA SOYNECT        
SIJXDKVXK       : LEIVKPDABBCBL   FIWJTQCKUMTAIU  AUQHW           VLAJIPRDPQCD    VDSGXU          OOQHXTL         LONPASUHTNOSH  
CVLIYIQEWHWNXXS : SQFF            XJERL           XEKMFJ          RYGDWVFP        ADIQ            LEGMAQFEP       AYUTSA         
VXCFYUOIURUQS   : TUJVHWEEIOASPB  ALVOASOYWRBB    CTHNXHVTAWHH    SWDDI           ESAPY          
TUGHEFPUJ       : LNUJJCYVLGOXJ   HHFKGORYOT      JXNOCBIRI      
EJDDHXPFYTKAOB  : LVVNRESIE       NJJCHGNDUG      LSHHPSIQTOOY    QOSDRVBD       
JVFCOPYJWGNC    : OBXUDVGDIQVAT   FURJY          
LONPASUHTNOSH   : FIFWS           OQLQPTAKNISXUOD JJKUEQSVYPJBRDU SIJXDKVXK       NOMFRQCW       
SWDDI           : TIFDC           CLPDUUHF        BYMRC           VXCFYUOIURUQS  
KNNDMW          : JETJBE          QJCSROSOCGKOIUV BPBF           
UNETBUKSUFOE    : FJIEQXDWRUUH    DCKGGJ          CLPDUUHF        ELYMRTQIJ      
ESRLSMK         : LMXWASDMKV     
RVWFJKIX        : TIFDC           LHHYKWLGSTEARB  LFXBHGDBGSR     DGOGUTNEGV      KGAVP           XHBH            KWBNJGMDVMQJNQJ OUUEPRRH       
KUWOPXMCTH      : CSXLPQW        
KMJOFBAAQNXKJWP : QIJDT           PJGUNSNXMEEBNV  GNWY           
HXSRKNQCFR      : LHJDNAE         FYWII           LSHHPSIQTOOY    EXHKWC         
JLVRVKBKSEMUW   : PPSDBRPCDU      LMXWASDMKV     
VIJSX           : BDVFEOFQYKWMAQI RPJIOKEUUOPN    HCAJC           NRTUBJEDJBYXSNJ VDPSOF          FSBVUXFELFEAWIF
BYYUJPLLUDCF    : MGRR            WRYBQTX         CUJQUHWHEN      UWSGDPQFVFADH   EKPGFAQJAIEKBW  FCHDMLFWNYW    
BYMLCYGGOEEOAOB : HERUBVD         CLKBY          
MHVNJQX         : VDPYBTCYQXM     GGSXFUMTW       MKMBJAHOWONJT  
FLTKQBCRCQFESM  : DPJSTIVHVUDT    RYGDWVFP        SMLELCGYGLVYMS  QTREX           VDSGXU         
HQRVSGYLUJKJ    : IDQWOWDCTCRC   
DJRKUNVNR       : HLBFPIMCW       VKOEORRPTG      ESITTOTWQMRKVOJ FJQU           
FTQLYJAMQQE     : PPSDBRPCDU      AJRCGRETKBBDF   GWEXSETNLDHW   
LMQYJAJSSPCMAAB : DFRGNWCHJSOQW   KFQSNM         
NSVVMPHN        : DQTFKBGWFNR    
HASAGILSY       : TALXPH          NDOUBOODAI      TWAJKF         
FAWXUODIOF      : PBELVGXWJLOKWC  MTHPXHGYQRC     MXMMIVC         HCBHULXCNVTM    SIDBXPB        
NSELQS          : VMVEK          
XHBH            : CGQGMXNROX      BOKUOL          ESWHBWHR        KQFPYR          RVWFJKIX       
TJOEUJ          : MYXHCAKVAH      JMLLJ           JETJBE          UODGY           LGPNUVLOJEWB   
IOFHPDV         : RYQBEHASGFXCI   QRVJ            TWAJKF         
LMXWASDMKV      : HLBFPIMCW       ESRLSMK         JLVRVKBKSEMUW   OUUEPRRH       
KFQSNM          : MJJYXIJS        UFASQNDMYEIS    LMQYJAJSSPCMAAB
ESAPY           : GGSXFUMTW       LCNTVGEG        VXCFYUOIURUQS  
FGTWJPPWCPVFK   : RPJIOKEUUOPN    GVPU            KYTT            KQFPYR          PTXVUHJ        
TWAJKF          : CPFDIIHRID      NOHM            HASAGILSY       IOFHPDV        
FURJY           : SLAXCDUWTNO     GWWHOQKNBYYMJAA JETJBE          AKYTXFGY        PTXVUHJ         JVFCOPYJWGNC    NOMFRQCW       
JPKVWQPTBHL     : CGQGMXNROX      MJJYXIJS        ENBAGBNGTUOOCU 
MDYRNANN        : DDGWHOY         OAUVCTYWRTFUUBP LLTSPQDPVRBTD   RDFAWXRNJUI    
WXGCF           : FIFWS           AEYAR           LKVKXTR        
UODGY           : RCNLUN          YGJVO           BDDXOXOABBFIP   NJJCHGNDUG      IAGDPKQCOEHUQJ  TJOEUJ         
QWTHN           : LHHYKWLGSTEARB 
KWBNJGMDVMQJNQJ : EFITUDSOJMEFBA  AJILWVIRN       QXWXPYJFYLWPGSW UOUKCSSEAVSOBP  RVWFJKIX       
SOYNECT         : OGJPDRIF        BCEWATNBILKV    LRWSINSNTQXT    TDQNLMOYDH      QDQALVF         PSQOXDMXDOH    
YMCSWRKHRLW     : LVBQCKV         CYLKLX          SMLELCGYGLVYMS  PKIPKIRXDOS     EHTBMHFMRNB     OBXUDVGDIQVAT   AKYTXFGY       
RJHOWXAM        : JBWXNYRTRO      HOUYRVEWIYVNHHA ODIFSRLOHFEFTJ  DFRGNWCHJSOQW   MANISCBQCBFPCL  WCPQRVHPEOSK    OAMG           
MKMBJAHOWONJT   : NKUPKTM         IPNELJO         RAYTUGYFLVX     HCELHJLBBEWM    MHVNJQX        
GLTQDIN         : EYMQQNXOHG      VRXKTCJOYSICJB 
CAOSYOVN        : KGCAXPI         OAMG            RDFAWXRNJUI    
IXULHWTVTIMGC   : OOUYOOUWVEBCE   OBXUDVGDIQVAT   IISAPTDX        OUUEPRRH       
OQRHVC          : XTGU            CUJQUHWHEN      HMUGFQRMQEVTVHK NJJCHGNDUG      QRPMQM         
FFXVXY          : FIFWS           CJLHTSFBBOBNAC 
VMVEK           : QQWKENCXQON     MXMMIVC         FKOCU           RRJU            KRVBDIKIJKXTEVO NSELQS         
QRPMQM          : RRJU            UTYAMNLIGBAKTX  OQRHVC         
FSADJSURQXRYF   : SQFF            EJCHQHRKFUDTE   JSXOUFKFUEE     JCYJOFG        
UFOICD          : PKMBKP          JEYCLVNREGQ    
GNWY            : SLAXCDUWTNO     WGRUUHHNHCX     RYQBEHASGFXCI   KMJOFBAAQNXKJWP
PLXCJDWLGGGE    : FSHCASRPW       YGJVO           MIPDHFLWODQMF  
WERVLJTQACUDJ   : FIFWS           EGTQ           
SIDBXPB         : IDQWOWDCTCRC    IYXRIIKFFX      WCWPKSJBNJSCDFX HHFKGORYOT      FAWXUODIOF     
BHYMPGUVITAD    : FDNPTTJ         NGNPTT          OLYODBLM        XLWRKI          HNEYFLWYXAHUBY 
NOMFRQCW        : DDGWHOY         LONPASUHTNOSH   FURJY          
GQLK            : PXSTE           OOUYOOUWVEBCE   IWEDA           NLETLH          QXOYLVSQGFRNC  
LCUOFEPRWXMSH   : CYLKLX          SRKOXNF         ATJUJBCXLEHUNST SEBFGQPYS      
VMYJBNQSFT      : LHJDNAE         YLOHEFRVI       QXOYLVSQGFRNC  
HCHSMBHQXXV     : RPPVRCXYDHHQIG  EOGH           
NPCMEUT         : HCAJC           YSFBUQFTST     
SGODJ           : PVMSIKHAURCIDYX WCWPKSJBNJSCDFX OBBWOGIHCNJY    HNEYFLWYXAHUBY 
VDKPTRUDNHGUBGS : FYWII           ESBNLT          QSKIHTTLBBY     SECUTLQNI      
LGPNUVLOJEWB    : MFEVMQM         RJSYNIDN        SEBFGQPYS       LRLOWNL         TJOEUJ         
HEGMO           : ILWPEI          KRIOCICULD      KYTT            BBOYXGWKBAV    
IISNVDTSECL     : FXTL            QSKIHTTLBBY     YLQJBLP        
OUUEPRRH        : MHRRTUBKEUULPBF ADIQ            QXWXPYJFYLWPGSW RVWFJKIX        LMXWASDMKV      IXULHWTVTIMGC  
