UWCYANDHCPKOE   : THGEB           GFDTVTJWDEQ     FPHPAPVKQLCRLON
LUNJHLQR        : GIEPNYYURIGQI   JANPIVMNKGCTPN  NDMNOCHILXBDGQJ
BSDWEWHXS       : IOKVACXQSXDPR   PUXIDJA         RWCPVJM         QNONGBCASL      LNNKMCKVKXVRF   POWL           
ATFQWOSOAHSXU   : SJCITRCCRCAYHY  RKJC            BNTLGXOHCE     
NFXAXREY        : GSIQOJWQC       JOGROCWLOE      FNEISNDFB       LIMOSNLPQQMO    HOFEKQLHFN      HLQPG          
JYTGGRBKUVRLUHG : IJQAI           NWEVPIVEFPFMFJ  POPH            HBAURMAISVYDWNB ROABTDG         XPMKCM         
JPFJLVW         : UHPMN           OACL            GBPYCEWMQYPNIFL
VYQQFRDQQ       : HODPHAJ         SPTUGPBPIRSOP  
XYRBMOWECUN     : VWPA            JQJXHSMKGJNYJTG RITP            VTRTASTUXVVJ    GAVBE           IIBMLRLMAXCJY   RXISCRTTPWD     JBADK          
FWAM            : BMNWSWWTK       GHXV            RXISCRTTPWD     BJBCRPBYWL      GLGYK          
LLGGH           : MKILMWGU        RHVTHUQFA       TQWOLRURSA      GIHF           
WAPRGGKFGKYIWN  : CPTNYAIRHXSO   
DPCRAJQBWAOIIVR : QURBIKPYW       RUWONP          EBSSBTTGEY      RLCXVPPCEHO    
UUHMBQXIWK      : JNTR            LOHUNFSW       
HJXRM           : CFDWGHTEUQ      CTYLE          
VGQGXTFAJNIFHCC : LRSCP           EHAWOYYWYEGOO   IUGIRLXYYUQA    YPFWQROKSTG     NTHJAOHLJJO     PRQVCTYHAX      JCRPSKWJBYB     OLVKLMWXVG     
MRFDPQCCBK      : NTJAJDT         UUQETBKRKHER    AQOXAEFLDKD     BJBCRPBYWL     
BEXRAFLG        : AEVPNNTYM       MNXQFOKIEKSKA   RYOQVJFCKE      WHDDWV          LWRGFX         
FNHOBPVL        : GDCVDMUNLKSFK   OUYVVSPG        MIULQTDFNQA     SPTUGPBPIRSOP  
BPGSVJKMMM      : YIRPD           GACDTCPAAU      JRMNQRUAQICKNQ  FITQA          
YXQDXJDF        : QKRRNO          MWYQSLAM        TBNSJBBKLYNWI  
MKCARTEJRRGUHMN : BJUESX          DGRRXARLLS      EOGNWNHLKQAYAW  MTEA           
WXTLKJMKBPJMUO  : SQKYMMBYTCOIKF  ARJYNNTPP       UMAKIYQVN       TANK           
HCNKV           : FIVCURCCR       DQAEM           XROLKBOEYXNSRON NYJMQPAJ       
QGCI            : PJSGDOLFU       RLWSFCECE       OIMGYED        
WPBNVALPLY      : PUXIDJA         TQFDEGWDLVGP   
AJDPSPNIBWMOH   : VNORGNLJOBIJOIJ PNOBNWDAQO      QOUG           
YXQD            : QSTFG           IJIMBYVD        JOGROCWLOE      RIYKILHA        ATSVA           SIPMBPVLYBIBI   UJWVYHWXQ       HMBHLIHPDEGMXYP
YXQD            : EXJOTSJQQ      
FCYHPU          : UMCAD           AFYK            IPUEGAQG        IOYFHHMREKQERF 
EMVDMXOR        : BIVU            TPVHUOUXXP     
IHESKBFAJ       : UCHTP           HKYA            TJNOF           IMGMJDPXYGLHQ   BPDVBGGCQ       LDGW           
BJHGSMIRV       : LEBLBOY         DUXNXUGXIY     
OGFBE           : GHXV            YMPMTXLE        AUMQVFVKSGQF    ROABTDG         XYFMTUATXIKCX   HQKBYA         
QCWISHSWCDYHFK  : YYEAEEBFT       RYXAPYGBNYMP    GDRRYGXHPX     
GVHOOTXIQ       : FYJHQHWRUMINEH  NNBPKLAJ        SINHXDHXOV      MBUWDMTOKFKITU  PDGTKFXML       RGQSKLKMAAITJ   SPMUXNNKXF     
WWEBBO          : PUXIDJA         GBPYCEWMQYPNIFL
DNCWVUTXBUIGFI  : GYVANM          ARFOBHRGFK      EWBQGAFI       
CPESJEECDDBHECX : DSGUQSFGYNKR    KIHBCUPCOPT     PNSDBENEGUDDWH 
IMBHIXDIYYQIGYX : PNPPBJXHMF      RTHL            SDIJVXTDNYIBPMI AQOXAEFLDKD     VCMG            QVIXPXQQSEF    
OEEBJIDMNHWSJ   : WYSNEICYO       GSYYPPKJKD      AJWFQHEKARATEAU YTRSFPJAAQXNKR 
QTHTDRUHBTIT    : FPUSLEI         CJPY            VGTBPFSOJXBOOK  PFLT            IUMEIEQQBHE    
QTCCKHI         : AIVSYYFTJCDI    AHBTVTNOYWT     DPEU           
QSTFG           : YXQD            RVNE            ABTOPCOIL       QABF            KRUGJIEMXVKHOC 
EBMAUHJOME      : BLCAGNXNFRLU    UVTYTCCPDOJNC   IJRKYVR        
THGEB           : UWCYANDHCPKOE   HYSP            TQFDEGWDLVGP   
VWPA            : XYRBMOWECUN     OGWMFFTFSKR     VJHQHOWJX       MCFKPKLUUFC     LTYOJ          
WKXPDRWLUCNIE   : HXEBNYKNGPBS    XFJRFCF        
RNYE            : IQNNIOTIDGQMH   NKCCUPTJNQHKPBB VCHBML          RANVRM         
LBBTF           : NWPRFTMFOBEEGWM BIVU            XMDJDDOHJ       KEKWNLYQWHEKD   CGFTBBXVBPVRV  
GDCVDMUNLKSFK   : FNHOBPVL        SDGFAHYDJJNNLCN RDIIUQEJGO      OJFCEBEKDQBD    FGOSFQQYP       LUVHFBJPAE     
DMULQFFGE       : RITP            URQWKTNOEKKLJGV LJFB           
BRMCNUHUAKQGYMV : IJQAI           QQVOE           JAEKQHITNOV     EOSI            BIBR           
YPUJWXV         : IXOX            MHNW            SQIOUE          MAOOD           IOYFHHMREKQERF 
LOYQVFC         : NECIOVKVTAJIU   IEBGWPCDRWTX    VGMTTUBSQQGRNK  WXIONYV         DTWRDIVNKBMNYXO WXAQFFPTYQXOT   RJBTOEC        
XRBNOLIOXAU     : JNTR            QFFF           
ORMNJHAGFXCSNBJ : PQHVERPJ        GDDPQNRTL      
INKIHNWVBFLY    : KTXJGYIEVJUKFEA JKIAUHRM        XOSJFPDVEWRXEI 
GYVANM          : DNCWVUTXBUIGFI  CEETJI          OVPNBKYUOIJCI  
UORCMTUCWGP     : VODFKTNRD       MXDAYSFMFNF     IOYFHHMREKQERF  VSKAEOG         MMGU           
VAOEQLARTLTB    : LXTITHJCPX      LTBJICEDTAXCQAS
UAUIMHFDYJPVEU  : PDGTKFXML       RUEEYFXWCSLVGOG FTYFNESASERY    BQAKGWHTEPXA   
MKBINQMEENVXB   : SUUGPQJMGACDX   IWNJAXUMC       HEDRGA          PJVNOKBMFLQSXGV
CVMCTUQDCTE     : VEXS            INCSWUAMRLMAKE  UUNHQSBCIX      HBMGRUYGKK      LEUJMBJYGPHATI 
LARGVETYNHRCLW  : GSIQOJWQC       XQKHLITV        ERVEAYKNCJHPKEX KEKWNLYQWHEKD   KNAGIOSMHNPOBA  AJWFQHEKARATEAU VGOVGBTSAPI    
JWTCYRODN       : CDDMGBJPSYW     VTKWI           EKRL            JFEPQKF         KGFKLRG        
TQON            : GAQL            VLEQSLOARGXR    CNKANKQXIOLUL  
DCXUK           : PJYWHIMQUNHWN   TACGBBTKVMOJWNU GYROTKR         RVFEKIXKMHDWJFA
AEVPNNTYM       : BEXRAFLG        TLGWWN          HJAPAXVWDDS     EWXVOKVLAYFW    JANPIVMNKGCTPN  VUIHAJRS        VOBNQBMEPDVQMRI
LMGNLAEROSLFIC  : VNBC            JNMCNPTHBRGH    BFYGLLOATI      OGWMFFTFSKR     VJHQHOWJX       SIPMBPVLYBIBI  
NECIOVKVTAJIU   : LOYQVFC         FQNKYLNGQBV     DFLV            VCPOQQMDKXXAO  
WJWJPMXRQ       : BWFUXR          IFOV            HGFTOUHONJUD   
GKDO            : IKYUJDVLVD      JDUB            XMDJDDOHJ       NVWSHFTBYE      ENOPANPXT      
FRIJTSB         : EROSGDCVBCLLUH  IEBGWPCDRWTX    XYFMTUATXIKCX   QMRVTF         
EWMGIWDTUMQ     : DHPLIEEJKEEDTQA WPQNVVQ         STYQCNBQKFBUOC  FIDWBWNWYIXIIV  RTLUS          
EFEWWVFJA       : NFKXYYJOOXRDT   RTCRHEJXHXSE    IGKXK           QICB           
GFMQRGJUB       : YEQYAY          AFORVUC         TQWOLRURSA      OXQGOJ          OJFCEBEKDQBD   
TOWCL           : XNDPHNLXGYKK    HPFWGESDUUVLIHY USKPBUEDGGGA    KGFKLRG        
WINPPT          : NNTGGEFCOOAE    YQRL           
TQUQ            : HQLQY           JDUB            QLJOVQTGGUSTJFY RDLF            JBADK          
EQSMXFDPOOMP    : JNFVKGHBWASDQB  KDEUFQVOCMXRE  
GGCJUEIDR       : HFBITUQQUALYH   AFORVUC        
SMVPFS          : TYIYVS          QBFPUTG        
CYBVLYDORTGEMLL : GSIQOJWQC       FLUDRG          KYQVQOHB        IMGMJDPXYGLHQ   VUIHAJRS        IVBGFNJOMPHVR   SIQTDTATTFRGHFQ
NWPRFTMFOBEEGWM : LBBTF           IQDVX           IPUEGAQG        VQCQVQP        
WNJKPOCHJI      : JNHWPCUMCJ      EIVXODYXTIV     NVWSHFTBYE      QGYMOEDLQT      OCUXU           AHHHIAMRFRGNHR 
XTBSJ           : NKEMLASFRG      FRPV            FVFFSOY         NFXHBGLAYTNBTIE
JDFDRNR         : WGQBTPBWSN      VVPLBWKIADNBAL  MXDAYSFMFNF     SQIOUE          QRYHVQOTSFJ    
RYEQLPPCBBRRFBD : PUUQCXXXIAPYPHC XQKHLITV        IHTOC           SEVDHWE         PJKE           
OBJQUUQEXWJ     : ARKWJNGVDHSBFDH SHHJWM          CXJFXOB         HMNYPB         
KBNEARUOJNQMOK  : WSWCDKRULMW     PJNRLWY         UWUPWTWCLUSVPO  JCRPSKWJBYB     OCUXU           TVCU            QNYEDIT        
VLIJCM          : NTHJAOHLJJO     RGJREUVFU       RWBXEMKMA       YMTXDMDXLAN     QNYEDIT        
UHPMN           : JPFJLVW         ANSJJEOUH       NRJGQEQDQNNML   RIYKILHA        JIOJCOGGYCCCME 
JWITAYX         : CPQH            MMEEJAXR        VYQE            JIOJCOGGYCCCME  PJKE           
QURBIKPYW       : DPCRAJQBWAOIIVR VSNJB           CCBSDI          KNAGIOSMHNPOBA  WLWPABRH        UFQHVVN        
UKGGMSBI        : VWJXUVTW        LCBDUKLMM       AKUPG           JFEPQKF         RWBXEMKMA      
QUPJGORAO       : DHKPBKFHVMBWWT  VSMLSFRQWLGXG  
ARKWJNGVDHSBFDH : OBJQUUQEXWJ     QCRYJGIXYBW     ANYEO           RQKNIXPQQMQ     KJHGTIHBS       AVDTQVP        
SCNBGGXVPEKKGBD : YCWTBINTNFALPMQ SLBIUYFMRCGB    EOSI            IFOV            VPEVNQVI        CHIXWNPGXFSADHP
TNFFDNCHVWKBDR  : PERE            QGJSWBX         XIYQOKXVRE     
VVCYCLWADDM     : VCHBML          EHAWOYYWYEGOO   YEWFYHA         OQLFFYJ         BGXP           
JNTR            : UUHMBQXIWK      XRBNOLIOXAU     VPOQSIXQGW      LIMOSNLPQQMO    MUUQGYUBSAA     POPH            ULTUMQJ         NNTGGEFCOOAE   
HYNNNRULQHMTBB  : RXYOBGOHICIUQOL NFKXYYJOOXRDT  
WGQBTPBWSN      : JDFDRNR         VCWTXJL         ANUNV           TTNREWWWBKVIHS  ANSANSUTOJBFHTI RTHL            IPUEGAQG        SDIJVXTDNYIBPMI
WGQBTPBWSN      : CCWY            YMTXDMDXLAN    
EDHXLQXBENUBYLI : IJQAI           FVVAVEKQQJNFBNR
IJQAI           : JYTGGRBKUVRLUHG BRMCNUHUAKQGYMV EDHXLQXBENUBYLI AQJOOGILQCJPJ   SPOYACH         WNDEWBQQC       CEETJI         
TJQJKQFAEJENIR  : FSOIGBVEHDRDUYM LUAVJ           LUOE           
IUJVPMW         : VBBTXCPSAGQPBG  VSHVDGDAXETHOS  IDIRQ           FITQA          
VKLHBMQBGATPNK  : CPTNYAIRHXSO    RUKSPWIJI       QQVOE           CWDHJYNYR       VGTBPFSOJXBOOK  WXAQFFPTYQXOT  
PQHVERPJ        : ORMNJHAGFXCSNBJ VBHLTHTUWHDBFQM PFLT            BCHT           
KUXAHW          : RGQSKLKMAAITJ   RTHL            UAPUMWKERYMGHCD CSNHSEH        
DHPLIEEJKEEDTQA : EWMGIWDTUMQ     ARJYNNTPP       PJVNOKBMFLQSXGV SIQTDTATTFRGHFQ
IJIMBYVD        : YXQD            EOBYEHJPKFPF    VNBC           
QDMBASEJKRUPXE  : GDDOGMJN       
FKFY            : HXEBNYKNGPBS    EKRL            RXISCRTTPWD     MVSQ            HUKTDM          MIULQTDFNQA     LDYDPNBKOFFJ   
ILMRUYV         : PDVC            YJIUWACWABXK    OQLFFYJ         MKWLBW          EQSNYVGFKFKOL   BCHT           
XBHQ            : MBBCA           GYLUHPRCHRGE    WBDSTXGTOKLAO   EXVDFHGJPTUNHH 
VRHQYT          : INCSWUAMRLMAKE  BITLXYHHGVRSQ  
SOTRUVWI        : QIWAWFDYKFSV    WOLEKLHOEPR     GTAYNGFLCY      WFPFLB          DKWIKR         
XMOKYGH         : MGXRFIITGRT     BNAEHNSXOQNUSOM
EFXGMR          : INCSWUAMRLMAKE  HUKTDM         
LJWCKQEGHAXD    : IJKPQ           DKXCITU         NYUBHMVHUGTRU  
WLDWXRJWASWF    : HFBITUQQUALYH   YIRPD           EQMWELS         URTY            MATPBL         
XNNPBYBXBORIUY  : INNQW           BRAEFNFCQYLRTD  RDONG           WSJEGEAKY      
UCHTP           : IHESKBFAJ       DQNCIRHCPCBFFDV YUTRNW         
QNEBMHTM        : PJYWHIMQUNHWN   GYROTKR        
SKAIC           : FIVCURCCR       VOLJHMDYLBLHDS  ERCYPTLK        FPHPAPVKQLCRLON
HFBITUQQUALYH   : GGCJUEIDR       WLDWXRJWASWF    EYRER           URTY            KDEUFQVOCMXRE   TKEGMLBTGQ     
PUWFYASIT       : VWJXUVTW        UPUEWWA         FVFFSOY         UANHNCLGEQ      OSIYQTJPTBFSX  
UORWWVAGB       : VBBTXCPSAGQPBG  AFORVUC        
PXBIOVKBXU      : MHNW            HOFEKQLHFN      BNTLGXOHCE     
PPFUQH          : DGRRXARLLS      ICVIK           TJNOF           MSNSAGACVAUAVL 
ACUWSOWSKWYODQM : RTKPBDXTX      
CDDMGBJPSYW     : JWTCYRODN       MUUQGYUBSAA     URQWKTNOEKKLJGV FLAARCRTT       MXUEBO          LVMFHJXWDWA     COQVP           RIASIC         
SFEU            : CREQOWCOY       EGUEJAALQCNNGLT DICBYIJJGQD     BJBCRPBYWL     
CREQOWCOY       : SFEU            WBDXLEQHNHL     UVOTSLBIXKBMEBA ULTUMQJ         USSAPBTBNHONC  
TRFYTIDJPGSFAUE : QTWQFJDBFKHLO   IKNGRJMLCFDN    RYXAPYGBNYMP   
PJWKUYEASVYU    : REERCA          PWGSDSDE        SKWIPHJYIBDXHTF LPGLUOERGLLEOGW OHBEHOAGDMUXJ  
ANESUG          : VSKAEOG         GNHCTYBW        VGOVGBTSAPI     LUVHFBJPAE     
DJXURTATQH      : GPESKTQUFB      JTGCTAX         LRSCP           OGWMFFTFSKR     PJYWHIMQUNHWN   RUOAMY          BIBR            APDLXEXL       
GSIQOJWQC       : NFXAXREY        LARGVETYNHRCLW  CYBVLYDORTGEMLL HMUYJOP         CASPDWRAW       MATPBL         
PYDQOKJJQAN     : BURV            JUUTIT         
BIVU            : EMVDMXOR        LBBTF           FHAAI           AHBTVTNOYWT     PKAWKLXJDLCHM  
QNSBTNLM        : PKPFGDEGNXPOSF  RGXOBWYDPPRPGVQ XQASXUJFWTGJXI  GTDJXLVLYC      OSOIEPEDMQEFH   BERK           
XJSADL          : RIYKILHA        UPUEWWA         NYUBHMVHUGTRU   VQCQVQP        
ICQUNBNNORQY    : JTGCTAX         VTKWI           BWFUXR          ROLEVKYGEXOQR   WPJDCGRQFIMGQ  
NMFBFI          : PDVC            GAVBE           XSWIBXBJ       
VWJXUVTW        : UKGGMSBI        PUWFYASIT       VOBNQBMEPDVQMRI KRUGJIEMXVKHOC 
FYJHQHWRUMINEH  : GVHOOTXIQ       GBHCFEEQOYMP    GWHEX          
RULTCTQXSDYN    : AKUPG           PXVV            VWTQS           ESCIIDUEOY     
SNAAML          : YYEAEEBFT       QBFPUTG        
DSGUQSFGYNKR    : CPESJEECDDBHECX LRDATCVOR       QSLKQAHIPDY     QGJSWBX         FGQBJNRF       
VNORGNLJOBIJOIJ : AJDPSPNIBWMOH   GMQLFLG         VCHBML          YAQFQF          OUYMDWYV       
USHNB           : NKCCUPTJNQHKPBB FEUQCMORVXGUVE  GKPQHBYGQDSRLQ  FFKGQVNUPLA     NFXHBGLAYTNBTIE
GTKMV           : JCGSSDFC        GKPQHBYGQDSRLQ  LYTVWLBSOCUTYF  NWXRJXPTIF     
WNKUDCNJPBTG    : VGYMURLJALMN    COQVP          
CPTNYAIRHXSO    : WAPRGGKFGKYIWN  VKLHBMQBGATPNK  LRSCP           RDLF            BTFKSUINJVS    
OATMCRCPOFREPJF : LXWDHNJITGVPGTV PKAWKLXJDLCHM   RJBTOEC        
PKPFGDEGNXPOSF  : QNSBTNLM        WIKHTD          QTWQFJDBFKHLO   JIOJCOGGYCCCME  FXOETGXYXJ      UOUEJNNBU      
HHNULHWBWFSDW   : OMFGTKADVN      YTRSFPJAAQXNKR 
JIRVXYEEDMTDCI  : JRMNQRUAQICKNQ  TGAM           
JCGSSDFC        : GTKMV           BQAKGWHTEPXA   
GBHCFEEQOYMP    : FYJHQHWRUMINEH  OUCEXKICMSLVAD  HUKTDM         
SVEFPJJYGV      : URTY            NOFWKDXFP       RXVEKFN         GDRRYGXHPX     
MOXRTBTDE       : NWNFVEDFXK      UPUEWWA         VBBTXCPSAGQPBG  MTPH            MYTNGQXTKGNNWQ 
FJILAAMOPNHLTM  : NBAII           IKNGRJMLCFDN    GQYOSCUWWPAXL  
FYCLUGAJE       : HODYFWNTXXG     BNAEHNSXOQNUSOM FGOSFQQYP      
GHMJMQQXB       : ERJFRG          NVBGMHBAU       AQPMEURRQ       NFEHXCTCEDH    
YBTPSJXG        : ANSJJEOUH       NAVMPKGLLI      MSGDJNDGM       XJSN            EYGLODQU       
MKILMWGU        : LLGGH           MGFQJLWM        FVFFSOY         AHBTVTNOYWT    
QCRYJGIXYBW     : ARKWJNGVDHSBFDH BWKJPPINBIRW    QXUYIHICC       WSJEGEAKY       QGYMOEDLQT     
HXEBNYKNGPBS    : WKXPDRWLUCNIE   FKFY            IBYNUKYY        WXIONYV         ERYKQVG         WIWXAFT         SAXDVMDVL      
MHXTDW          : CUXQPAOHCV      KIODDIANEJ      VANKIBJVLV     
HQLQY           : TQUQ            RHSA            PWSMLFCLLKC     DTWRDIVNKBMNYXO
RXYOBGOHICIUQOL : HYNNNRULQHMTBB  QVJB            MURHRSXMBCJFGY 
JOGROCWLOE      : NFXAXREY        YXQD            OMFCJANWXUMQMH  HBDLFVNFRFXN    HFMHMPPEKNGEBU  HJAPAXVWDDS    
AWEXOFWFGETP    : GAVBE           EIVXODYXTIV     TJNOF           XQAKLVVOLQSPYM  SDIJVXTDNYIBPMI
YXJRPWLYNTS     : NVBIIJYYQGWLMF  KWHDUSWK        ULRCMFWU        RYRPQ          
WPQNVVQ         : EWMGIWDTUMQ     RIER            KNAGIOSMHNPOBA  KJHGTIHBS      
AOKFMQNSMFHNESH : LWRGFX          QABF            CGFTBBXVBPVRV  
SUUGPQJMGACDX   : MKBINQMEENVXB   CYILFWIOOXI     WXSA            LTBJICEDTAXCQAS
YAIJIWCVPPEW    : PNOBNWDAQO      SIPMBPVLYBIBI   XIYQOKXVRE      JSRH           
IRNEKIB         : BKWHWUH         PSDFNHQFS      
ARFOBHRGFK      : DNCWVUTXBUIGFI  PTMOSPFIXJYRCN  JFQYFQVQPK      PSDFNHQFS       QMTLDBJYBFGMV  
FSONPRMHJ       : JRUBSCDTM       VMKUMHWIY       OVRMPTTQRTRQRG 
EOBYEHJPKFPF    : IJIMBYVD        MIPVRXS         AKPYVHTBYFPPNK  VANKIBJVLV     
FGRWOWJTFFIUWCJ : RRSMPPMMIO      BERK            TVCU           
LCLDFKHMWYACP   : WHPTUONSWPFRGW  VEXS            BGJNVN          WODBOMUCFY      MQUDONUSHEN     GVRIOOOHTT      XKLCIC         
NWNFVEDFXK      : MOXRTBTDE       NPRHGTXNYTKQJW  NMOYXNGBYPJB    UCNBBPCVHGCRLBS RYKOWFLEV      
IFKLPPYRBCXMMM  : SDQXENRWBS      OLNNODMSTKFNSHJ ANSJJEOUH       ULTUMQJ         OHEDVTLYV       LXMEDCK         QYPUCGMYX      
NOLDVBCLHXPMG   : OIDOUSYYSC     
WSWCDKRULMW     : KBNEARUOJNQMOK  FRPV            TLOCR           JRMNQRUAQICKNQ  QICB           
MLFB            : WSJEGEAKY      
SQKYMMBYTCOIKF  : WXTLKJMKBPJMUO  MAEDDQ          GIEPNYYURIGQI   PRQVCTYHAX      TKEGMLBTGQ     
DEHJQCGCQ       : NOCHMOMX        ILAOHAO         HTJWOLFDLGLS   
SDQXENRWBS      : IFKLPPYRBCXMMM 
NTLJVCRGHYMNG   : QXUYIHICC       XSWIBXBJ       
EKEHDKCGBD      : CYQUTYS         JNHWPCUMCJ      PNPPBJXHMF     
RUKSPWIJI       : VKLHBMQBGATPNK  DUXNXUGXIY     
INNQW           : XNNPBYBXBORIUY  UHPRRD          XUBYYYMMFWK    
FLUDRG          : CYBVLYDORTGEMLL JTGCTAX         IJRKYVR         RHSA            UKJVLLXAX       SGRLNYFUJT     
BJUESX          : MKCARTEJRRGUHMN KWULY           QWIPG           NLEILI          WREKTNOYOSYHAS  RUEEYFXWCSLVGOG
GPESKTQUFB      : DJXURTATQH      CIEGUQ          OYCJGI          EXQPHM          TUDCCNJNEVMNRSY FQLSTHOCUWS    
NOCHMOMX        : DEHJQCGCQ       GAVBE           SPJYELHJHRTTRI  SVUKJHXEJ       XDKD            PWSMLFCLLKC     USKOAAIYMPUXAL 
QPSDREXXYVHFOLB : EQMWELS         FYEBFLGHUFKERAT ERCYPTLK       
HRYMSPBKSKWJW   : GAQL            BDIUNFXSOJFNEOS JFANPPNY        STYQCNBQKFBUOC  TQXJUSFD        MNXQFOKIEKSKA   UVOTSLBIXKBMEBA RTKPBDXTX      
VPOQSIXQGW      : JNTR            MBUWDMTOKFKITU  EXJOTSJQQ      
NFGBGH          : WBDXLEQHNHL     VBHLTHTUWHDBFQM TKQVXJQRYD      XVEOUJBBF      
AIVSYYFTJCDI    : QTCCKHI         LVITVBDMPLVC    ARJYNNTPP       HRSWQJF         LNHKGYHTDQ      YEFJBQLXGAOXFEK
CYQUTYS         : EKEHDKCGBD      RHSA            DUXNXUGXIY      KJQTEMB         GQYOSCUWWPAXL  
IQDVX           : NWPRFTMFOBEEGWM NKCCUPTJNQHKPBB NJUTKFR         HTFKRRLUH      
AESIECGYD       : LNFVSAWQJC      DDCXEBTYFHGQ   
FWSJACJEDCC     : CQFIWH          MTPH            CXSMBWLISS     
BWKJPPINBIRW    : QCRYJGIXYBW     PDVC           
XBCXEJFBFODHA   : GGMIGQTLRYD     YTJJYBHBHSK     VSHVDGDAXETHOS  RKNKOLQYKUPP    UAPUMWKERYMGHCD BCHT           
KCMJGJUPAK      : GBFVUKOXCIAR    DBWXCP          MXVN            WIIMAXQVVDBBQSO
NMKI            : YAAO            HTFKRRLUH      
GGMIGQTLRYD     : XBCXEJFBFODHA   SOEPHEBSH       VSHVDGDAXETHOS 
IDFUIRF         : ANSJJEOUH       IBYNUKYY        RTHL            XYFMTUATXIKCX  
EAGEMHTBRCMX    : CJFHWAW         UMAKIYQVN       FMAMF           KGFKLRG        
YIRPD           : BPGSVJKMMM      WLDWXRJWASWF    JSWSBQUVGHX     KIQWFU          CCSMPGEDW      
JELFNQMIYHPNL   : ERWJJEI         GHBNPTYVTME     TUEIH          
WPFE            : LRDATCVOR       QJEUBVH        
IXOX            : YPUJWXV         IAMAG          
AWHTPMCBRPIHHVR : DKXCITU         QRQFIDKPYA      LPGLUOERGLLEOGW
DIWQCTGJATS     : TNWB            VSHVDGDAXETHOS  YTRSFPJAAQXNKR  DAQS           
IQWKPHHHVLJNCRW : RUHSXYFLU       VMKUMHWIY       NOQGIXHPW       IVHKFRA         RFLSDX         
NPRSAQJCMRO     : LXAJVATBAIIC    UUNHQSBCIX      CSNHSEH        
MHNW            : YPUJWXV         PXBIOVKBXU      EUUFKAMHSTUQOVG GTDJXLVLYC      UFQHVVN        
MIPVRXS         : EOBYEHJPKFPF    INBA            XNHHDJBXV       OFKIYDBTTCWEDA  QUSK            IOYFHHMREKQERF 
JIFBGQRXLKAC    : UNPKYP          TYIYVS          XOSJFPDVEWRXEI 
EROSGDCVBCLLUH  : FRIJTSB         YPBRFKDGSAEX    XDCRFDKBOWON    JFQYFQVQPK      XFJRFCF        
UAIELQFTJWT     : PNPPBJXHMF      LENEALWYHCPFM   VCPOQQMDKXXAO   UMBAVM          MPWGWKSDB      
KTAHARXVACXWFD  : YXGEA           CKHSTH         
QARVW           : RGXOBWYDPPRPGVQ DQNCIRHCPCBFFDV TLOCR           CJPY            PJLC            KMGGPRRHG       UULMWP          QNVXAIEFHSL    
EBGUI           : NVBGMHBAU       RDONG           RFLSDX          WSJEGEAKY      
FIVCURCCR       : HCNKV           SKAIC           PCDCORBBYHHMFCB NPKPSPMFBARC    JYXO           
ANYEO           : ARKWJNGVDHSBFDH DSUBBTRRGSQYWFJ
JTGCTAX         : DJXURTATQH      ICQUNBNNORQY    FLUDRG          ITBUUIJF        ROABTDG        
UDTDAEFHMBKH    : VSNJB           TEFAHUKTSFFTLJB QVJB            EDDIMBTKJ       YNSGE          
OLNNODMSTKFNSHJ : IFKLPPYRBCXMMM  LMYX            BYFWJXVVGMSSWHJ JFYPELXGXRTWTW  AJWFQHEKARATEAU
GAQL            : TQON            HRYMSPBKSKWJW   BDCBTRKLFII     WQIJSPNQGG      OSOIEPEDMQEFH   NDEAYVROEM      MCFKPKLUUFC    
VNBC            : LMGNLAEROSLFIC  IJIMBYVD        DVLQ            MCWA           
NFKXYYJOOXRDT   : EFEWWVFJA       HYNNNRULQHMTBB  VJUTWMEXCYW     FALI            CRDOIDIIC      
NBAII           : FJILAAMOPNHLTM  WMYXWDWILX      SIPMBPVLYBIBI   TUDITQUN       
EQMWELS         : WLDWXRJWASWF    QPSDREXXYVHFOLB CJPY            ASRYBPTJEIXN    TPTICFO        
MUSCBDACEMQVMK  : ROLEVKYGEXOQR   BGJNVN          THNVBQQFSLBVKQ 
IWNJAXUMC       : MKBINQMEENVXB   FPVNEKLRNCBTEH 
BYUMSP          : RXISCRTTPWD     TPVHUOUXXP      VOEEXCUSNBKSY  
PIGSNIU         : OKQURUYWM       SPMEGFOIYIR     MSNSAGACVAUAVL 
UNPKYP          : JIFBGQRXLKAC    RXISCRTTPWD     RTHL            JCRPSKWJBYB     TEKKUJAUNMQRFM 
VFFXDCMI        : XHTR            SVUKJHXEJ       QVIXPXQQSEF    
OHKDCCHSMNN     : VGOVGBTSAPI    
VJUTWMEXCYW     : NFKXYYJOOXRDT   PJYWHIMQUNHWN   IGPCMR          HNWSSHVUK      
GUNKIVB         : DKXCITU         BAYRJWGORFMWNAM IVHKFRA         FVVAVEKQQJNFBNR MTEA           
FNEISNDFB       : NFXAXREY        VSNJB           JRUWIFF         WCPAMKWXFWETDXN LXMEDCK        
GACDTCPAAU      : BPGSVJKMMM      OACL            RLHDF           DGRRXARLLS      TJNOF           VMKUMHWIY       AUMQVFVKSGQF    XOUELPLTYUGJ   
WEKUTUFRXGX     : JDUB            QQVOE           NYQBMYOJMYCCQY  TTNREWWWBKVIHS  FYAYIJRDRSRUKUJ
KIHBN           : TBEQOKNOMXW    
EGUEJAALQCNNGLT : SFEU            NVBIIJYYQGWLMF  YCWTBINTNFALPMQ WXVIYSO         ILAOHAO        
IQNNIOTIDGQMH   : RNYE            WEVVFNWPLGRGJ   MAOOD           KIODDIANEJ      UMSEJLVJ       
BMNWSWWTK       : FWAM            VKNXCYMKE       HMUYJOP         OUCEXKICMSLVAD  GBLFOGWBBBAC   
XAFENC          : RUHSXYFLU       KIHBCUPCOPT     CSNHSEH         TUEIH           XENMHNWICNDBPRW TGPDMDTTGLGON  
VSNJB           : QURBIKPYW       UDTDAEFHMBKH    FNEISNDFB       KWHDUSWK        SINHXDHXOV      JNBSVDWDETIWNP  PMCKLHGIPANTHCA TBNSJBBKLYNWI  
VSNJB           : MSGTOY         
DMHM            : ANSJJEOUH       QQVOE           GYLUHPRCHRGE    YAAO            IUMEIEQQBHE    
VTKWI           : JWTCYRODN       ICQUNBNNORQY    TXMRG          
VCWTXJL         : WGQBTPBWSN      TJNOF           OWLOWC          PPXQFGKV        RWBXEMKMA      
LRDATCVOR       : DSGUQSFGYNKR    WPFE            RRLPRJYBQBBQ   
RVNE            : QSTFG           QTWQFJDBFKHLO   EYRER           LEBLBOY        
AKBWUBFU        : XIRO            KIVPBQMHD       GJSFFYRK       
JTSHFHGQYL      : UUVSGSJBKCIV   
UPPLIXD         : NYQBMYOJMYCCQY  UMSEJLVJ        FQMRYULOAR     
LIMOSNLPQQMO    : NFXAXREY        JNTR            FJONHJJCTSL     SEVDHWE         TCSX            JUUTIT         
IJKPQ           : LJWCKQEGHAXD    XDCRFDKBOWON    KIQWFU          JISKCYSOR       SKWIPHJYIBDXHTF RDRUV           LUAVJ           RWOTGWRDLJ     
GREAMURAFPELDOX : MMEEJAXR       
HODYFWNTXXG     : FYCLUGAJE       LWIDNBND        TUEIH           ECPRV           OLVKLMWXVG     
NWEVPIVEFPFMFJ  : JYTGGRBKUVRLUHG MBUWDMTOKFKITU  JBSXNCROBMR    
LXWDHNJITGVPGTV : OATMCRCPOFREPJF DBWXCP          NVWSHFTBYE      XVEOUJBBF       CYTAOJYM        OLVKLMWXVG     
JTWFJIENP       : SPOYACH         WBDXLEQHNHL     DPEU           
SDCECNEBQLRCTLI : OWLOWC          OSOIEPEDMQEFH  
BQNXKWTHD       : BITLXYHHGVRSQ   ROLEVKYGEXOQR   MXVN            OSIYQTJPTBFSX  
PJSGDOLFU       : QGCI            BFYGLLOATI      NDOXIU          RUOAMY          RTKPBDXTX      
SAQM            : RDPYVNFU        GHRVJDDW        QTKVPQGCOB      XIRO            BPMXEAXYVROSVH 
IOKVACXQSXDPR   : BSDWEWHXS       AXUHTR          BDHVRDRCCGXRU  
UWDGRLK         : XBWXIQK         RAMRXHIEOBLXO   TQCSDMHKODL     MCBCFH          FTYFNESASERY   
WREMNGGCTQSEN   : AOTXXMNGOPNR   
JNMCNPTHBRGH    : LMGNLAEROSLFIC  BFYGLLOATI      POJUXOOLCPYPVPS UPQJ           
XSMHQFNFUTLW    : HBBILV          WCPAMKWXFWETDXN QNONGBCASL      TWEOWBQVEHPPC  
FPUSLEI         : QTHTDRUHBTIT    FTRNKWQCGC      VGOYPGDCR       OHBEHOAGDMUXJ  
IVNEDR          : WQIJSPNQGG      XDCRFDKBOWON    IKNGRJMLCFDN    PPGJOXUWUIVSB   GYROTKR        
JBYJTNQMSGSP    : NVBIIJYYQGWLMF  MFQUKKNQKVLRY   CASPDWRAW       GNHCTYBW       
GMQLFLG         : VNORGNLJOBIJOIJ SPOYACH         STHG            QHDDOJFQSLOTCW 
ROQCKGGP        : VJHQHOWJX       UBIRK           FNWPYVIPFEIOKC  SEVDHWE         RWBXEMKMA      
HBBILV          : XSMHQFNFUTLW    KIHBCUPCOPT     TRXUDTUGCWJW   
EKRL            : JWTCYRODN       FKFY            MPJBNCSFWT      RIYKILHA        PSVKPEG         NYJMQPAJ        AHHHIAMRFRGNHR 
HNMWE           : STYQCNBQKFBUOC  WMYXWDWILX      RITP            YYEAEEBFT       PWGSDSDE        JFQYFQVQPK      DGGKDXVAFFVWTQ 
CPHUJVL         : UHPRRD          WSJEGEAKY       POWL            HOXRFGWLTNNHN  
JRUBSCDTM       : FSONPRMHJ       DUXNXUGXIY     
RIUDC           : LMYX            LGXBMKORMRKSLAP PDGTKFXML       TOIP            BPDVBGGCQ       MYTNGQXTKGNNWQ 
IKYUJDVLVD      : GKDO            VCKUTAEB        CHIXWNPGXFSADHP
FBTRKLMMGQ      : FHAAI           MTFSBPS         RLCXVPPCEHO     ITSKKTURSOI    
BDIUNFXSOJFNEOS : HRYMSPBKSKWJW   SGLJ            SJLJRRMPWTUOYRP DHKPBKFHVMBWWT 
CQFIWH          : FWSJACJEDCC     FNDTEGJQRMAOLF  CHXE           
QTRFGYXXCDIWQOX : LRSCP           TJNOF           EOSVMIEQJMEXRWU SJHAAK         
FHQULFNQHFVREFV : DCQVKPKLXFA     PUUQCXXXIAPYPHC AUPR            FVFFSOY        
AOCIPAJRDROVIM  : KJGH            TKEGMLBTGQ     
NVBIIJYYQGWLMF  : YXJRPWLYNTS     EGUEJAALQCNNGLT JBYJTNQMSGSP    IPUEGAQG        QWRDDJJY       
JFANPPNY        : HRYMSPBKSKWJW   DBWXCP          HREVOCCJ        VQCQVQP         PNSDBENEGUDDWH  AVDTQVP        
STYQCNBQKFBUOC  : EWMGIWDTUMQ     HRYMSPBKSKWJW   HNMWE           UISPAFTIN       QYURRJPXJHXRLIQ
HISSUX          : VDFNDQDIMP      FUCEXVBOA       YHLQJMRYGKXL    LLNLX          
GFDTVTJWDEQ     : UWCYANDHCPKOE   CPYBVKRB        NOQGIXHPW       QMRVTF          KGFKLRG        
VTSYMDEPXUSVD   : HYSP            XBWXIQK        
OVYPBHWHCSDLQGS : RWCPVJM         FYAYIJRDRSRUKUJ
LQDEPR          : ERWJJEI         YNSGE          
WIJTB           : XBWXIQK         JWUUJQIIOMSXNGL JTGY            HFMHMPPEKNGEBU 
WEVVFNWPLGRGJ   : IQNNIOTIDGQMH   RYXAPYGBNYMP    AQOXAEFLDKD     EXJOTSJQQ      
YQXJEOOKHHTGRF  : TQXHT           OIMGYED         XIYQOKXVRE     
UKABIVJWUYIC    : TLGWWN          KTXJGYIEVJUKFEA MVSQ            WKLVEAUOMVWR    VXQHFFSHX      
QLXQEYAIPQSY    : FYMSCQTD       
OFRVIMGI        : OIMGYED         VKMWBHUKNSG    
RGXOBWYDPPRPGVQ : QNSBTNLM        QARVW           PSVKPEG         NJUTKFR         QTJIUWJAW      
FHAAI           : BIVU            FBTRKLMMGQ      FYEBFLGHUFKERAT UONUOLLL        FRTJTYT         YJIUWACWABXK    VGOYPGDCR      
ROSN            : ANSJJEOUH       GVRIOOOHTT     
HWJVOPVFQUEW    : JSWSBQUVGHX     TGBGOPPSHVYG    ROABTDG         LXNJFBIQ       
VODFKTNRD       : UORCMTUCWGP     FKQEU           RNTFUC          UPQJ            OIDOUSYYSC      EDDIMBTKJ      
UMSODLECUBN     : GHXV            LMMTTFDGEQXXY   VHNMHSLRXLTNLI 
RDPYVNFU        : SAQM            KPABF          
CJFHWAW         : EAGEMHTBRCMX    LWIDNBND        MXVIBX         
FNLRGCWTH       : GMOGYMMBOFIDMVL JNBSVDWDETIWNP  GWHEX           LPGLUOERGLLEOGW
OKOI            : LGXBMKORMRKSLAP VWTQS           LXMEDCK        
TBEQOKNOMXW     : KIHBN           MMEEJAXR        AFYK            ETJJKXAJIHJR    JFQYFQVQPK     
WYSNEICYO       : OEEBJIDMNHWSJ   LQYPCF          MFQUKKNQKVLRY   VOBNQBMEPDVQMRI
VKNXCYMKE       : BMNWSWWTK       XJCBCTRTPDCHXBP GTDJXLVLYC      GGHFEYRNM       QTJIUWJAW      
NKCCUPTJNQHKPBB : RNYE            USHNB           IQDVX          
JDUB            : GKDO            TQUQ            WEKUTUFRXGX     XQASXUJFWTGJXI  AANCNBLVJCVYXFC
RNXRP           : IOFVHELJMUK     KNTS            JKUKYV          IBQRLOMHMFRT    CXJFXOB        
GDDPQNRTL       : ORMNJHAGFXCSNBJ XWSIFIVXYXEMRIJ JSRH           
PUXIDJA         : BSDWEWHXS       WPBNVALPLY      WWEBBO          JKIAUHRM        DMNGGXBKW      
MVRR            : BLCAGNXNFRLU    GYXWYSUXOU      FNWPYVIPFEIOKC  SPTUGPBPIRSOP   TKEGMLBTGQ     
SBLJYD          : YOGBHSTWEJ      JNHWPCUMCJ      EIVXODYXTIV     LEPFQGUFWDJAYEN MWYQSLAM        BDHVRDRCCGXRU   IPMLXUYCSUE    
XJCBCTRTPDCHXBP : VKNXCYMKE       QKRRNO          NOFWKDXFP       WAILYUYUBY     
MPJBNCSFWT      : EKRL            GTRYTHKWLQQ     GKAUKJLXJAFMCR  FSSRJHVASWO     GUFEBESSIXNONPU HPFXFATJJERKH  
GVXIVKKAMGRG    : XENMHNWICNDBPRW
ULDUOUBDMKEBO   : FWDXJBC        
IOSCWQAFNMSN    : VXXKEWNH        BVYJRHLH        UUNHQSBCIX      LLNLX           VTWKOTPXOX      TKCCH          
YHIXCVDY        : GQHJYJFAPXT     TJBPTEDGRIE    
YAPLLV          : HFWNOTVBANB     SBOBPWXEEEAKYK  SGLJ            PSVKPEG         UURACVTFKE      GWOREDSD       
CUXQPAOHCV      : MHXTDW          TTELMT          MCBCFH          CLGIADIYWTTRM   WUSAQLGMYW     
POKQORYOV       : MIHRCSMJAGHLQ   EOSVMIEQJMEXRWU
RUHSXYFLU       : IQWKPHHHVLJNCRW XAFENC          QUSK            FGOSFQQYP       ECPRV          
NPRHGTXNYTKQJW  : NWNFVEDFXK      VDFNDQDIMP      HNIPRWQFWH      ITBUUIJF        EDSOORKPP       KDEUFQVOCMXRE   RDRUV           CLGIADIYWTTRM  
AQJOOGILQCJPJ   : IJQAI           RWCPVJM         PSRHMQXMHTJKQVY
LDJBXSJTQWSK    : KOAJBCTUMGT     OJFCEBEKDQBD   
LVITVBDMPLVC    : AIVSYYFTJCDI    EQSNYVGFKFKOL  
ANSJJEOUH       : UHPMN           YBTPSJXG        IFKLPPYRBCXMMM  IDFUIRF         DMHM            ROSN            HRSWQJF        
NRJGQEQDQNNML   : UHPMN           AKPYVHTBYFPPNK  WREKTNOYOSYHAS  XDJTNCH         MPWGWKSDB      
RBHDWLG         : MXVIBX         
CYILFWIOOXI     : SUUGPQJMGACDX   FTRNKWQCGC      BWIQBLD         UESRUEK         GQYOSCUWWPAXL  
EAEUFUKU        : VBHLTHTUWHDBFQM UMAKIYQVN       HGFTOUHONJUD    ACGXJEMOGDQKGAL
WMYXWDWILX      : NBAII           HNMWE           FNDTEGJQRMAOLF 
MGXRFIITGRT     : XMOKYGH         XJXAX           AHBTVTNOYWT    
TYIYVS          : SMVPFS          JIFBGQRXLKAC    YITUDVXWYA      PDVC            FJONHJJCTSL     MTQSFU          FGOSFQQYP      
ERJFRG          : GHMJMQQXB       OWLIJMOIAS      GBPYCEWMQYPNIFL DVJPIRMF       
QQVOE           : BRMCNUHUAKQGYMV VKLHBMQBGATPNK  WEKUTUFRXGX     DMHM            DKXCITU         GIEPNYYURIGQI   PGLXKWEYFBA    
UECDNLYTD       : PJLC            SGSMSWY        
HYSP            : THGEB           VTSYMDEPXUSVD   NYGGFFAPB       BQAKGWHTEPXA    HTJWOLFDLGLS   
OKVUDFDWNNOHMDN : UWUPWTWCLUSVPO  CFDWGHTEUQ      CKHSTH          FITQA           USKOAAIYMPUXAL 
BRAEFNFCQYLRTD  : XNNPBYBXBORIUY  HFMHMPPEKNGEBU  IGPCMR          EPTNDWEFDNTV    GDDOGMJN       
JNNGS           : UVFXTKNKIC      SOEPHEBSH       MJHWWQSPDCYBPPW
JQJXHSMKGJNYJTG : XYRBMOWECUN     KRUGJIEMXVKHOC  XENMHNWICNDBPRW
AKPYVHTBYFPPNK  : EOBYEHJPKFPF    NRJGQEQDQNNML   MXUEBO         
XBWXIQK         : UWDGRLK         VTSYMDEPXUSVD   WIJTB          
WTJXGGFF        : TWJYFFEKGNI     MIHRCSMJAGHLQ  
RVHQ            : HLQPG          
DRHIHWYUIWVFWH  : SIPMBPVLYBIBI   QQQLCNIPGTUBTII ILAOHAO        
JFVF            : QKRRNO          NNBPKLAJ        OUYMDWYV        CCSMPGEDW       LSRJSEYBUPPNW  
TNWB            : DIWQCTGJATS     JTGY            GTDJXLVLYC      XPMKCM         
FTRNKWQCGC      : FPUSLEI         CYILFWIOOXI     GNOXMEQKNWNAB  
DBHNAFVY        : NRIBNDDBBAJWHSY IOWAXIJIYPXFF  
RITP            : XYRBMOWECUN     DMULQFFGE       HNMWE           FSOIGBVEHDRDUYM DRINUJ         
NKEMLASFRG      : XTBSJ           UPUEWWA         XQKHLITV        MXVN            MJHWWQSPDCYBPPW OXQGOJ         
QYWXBJDESR      : GYXWYSUXOU      WKLVEAUOMVWR    XUBYYYMMFWK    
XNDPHNLXGYKK    : TOWCL           TEKKUJAUNMQRFM  TLPLIWQLFEMYQX 
XKFEENX         : KYQVQOHB        RTCRHEJXHXSE    JBADK           DWNMJYEO        SPMUXNNKXF     
MUUQGYUBSAA     : JNTR            CDDMGBJPSYW     XQKHLITV        GTAYNGFLCY     
FRPV            : XTBSJ           WSWCDKRULMW     WXSA            SHRPFDN         YNSGE          
PCDCORBBYHHMFCB : FIVCURCCR       QTWQFJDBFKHLO   VBBTXCPSAGQPBG  THOEP           SMPFNWNPRGHMV  
ARJYNNTPP       : WXTLKJMKBPJMUO  DHPLIEEJKEEDTQA AIVSYYFTJCDI    DKWIKR         
WHTUKM          : MAEDDQ          CPMAAXKCSRTH    IJXQQJUQHESLQL  JHSDCQODHF      UISPAFTIN      
POPH            : JYTGGRBKUVRLUHG JNTR            WAILYUYUBY      PGLXKWEYFBA    
QIWAWFDYKFSV    : SOTRUVWI        THNVBQQFSLBVKQ  OCUXU          
GJAXYCVGXQR     : WREKTNOYOSYHAS  PJVNOKBMFLQSXGV CEETJI         
SJCITRCCRCAYHY  : ATFQWOSOAHSXU   XJXAX          
MTFSBPS         : FBTRKLMMGQ      XJSN            IKNGRJMLCFDN    CGFTBBXVBPVRV  
OUYVVSPG        : FNHOBPVL        FKQEU           PJVNOKBMFLQSXGV
YITUDVXWYA      : TYIYVS          WJXUTATHQ       TOFXP           TANK           
GBFVUKOXCIAR    : KCMJGJUPAK      OYCJGI          CCHJX           EHSF           
YPBRFKDGSAEX    : EROSGDCVBCLLUH  JRXKHYLPGOOT    DKXCITU         FRJK            TKCCH          
CUWEQGFXCALQBNB : HFWNOTVBANB     YLGNXHXJ       
HHAWKUEUANQAROW : OYCJGI          QRQFIDKPYA      IWBBLHNNF       WLWPABRH        RHRVDRRWYJG    
MVAFCHG         : WJDBSDBK        ARIECIDSHEQJLY 
JRXKHYLPGOOT    : YPBRFKDGSAEX    VSMLSFRQWLGXG   TLPLIWQLFEMYQX 
VOLJHMDYLBLHDS  : SKAIC           JISKCYSOR      
KYQVQOHB        : CYBVLYDORTGEMLL XKFEENX         UVTYTCCPDOJNC   XDCRFDKBOWON   
UQWLHQW         : AKUPG           HBDLFVNFRFXN    PRQVCTYHAX     
ILQPATOLWCUA    : EWXVOKVLAYFW    USSAPBTBNHONC   ULRCMFWU       
HMUYJOP         : GSIQOJWQC       BMNWSWWTK       UVFJDMPD        KPABF           XKLCIC         
PEPIECR         : KJGH            SDIJVXTDNYIBPMI VWFDHI         
BXFMOVOLMAIR    : CPMAAXKCSRTH    EOSI            PHEBVMACPT     
JNFVKGHBWASDQB  : EQSMXFDPOOMP    JISKCYSOR       HODPHAJ        
UVFXTKNKIC      : JNNGS           NNBPKLAJ        CKHSTH         
VDFNDQDIMP      : HISSUX          NPRHGTXNYTKQJW  INCSWUAMRLMAKE 
URQWKTNOEKKLJGV : DMULQFFGE       CDDMGBJPSYW     RDIIUQEJGO     
QHYPDEUSHLXSA   : OVRMPTTQRTRQRG  FPVNEKLRNCBTEH 
KWHDUSWK        : YXJRPWLYNTS     VSNJB           HQKBYA         
DVVOHC          : NAVMPKGLLI      LISKWQYLNINWLHP CMVWYUJ         HNWSSHVUK       FIDWBWNWYIXIIV 
EUUFKAMHSTUQOVG : MHNW            RTCRHEJXHXSE   
SOEPHEBSH       : GGMIGQTLRYD     JNNGS           GNHCTYBW       
OYGSOMNJTBL     : YEWFYHA         MTNBJIUBCRSUJYO QBFPUTG         BNTLGXOHCE     
IEBGWPCDRWTX    : LOYQVFC         FRIJTSB         EHAWOYYWYEGOO   DFHKBU          NYUBHMVHUGTRU  
DCQVKPKLXFA     : FHQULFNQHFVREFV IBQRLOMHMFRT   
TLGWWN          : AEVPNNTYM       UKABIVJWUYIC    TOIP           
DQNCIRHCPCBFFDV : UCHTP           QARVW           HCUHEGKOPIANLXN QGJSWBX         LEBLBOY         MSDIC          
PNOBNWDAQO      : AJDPSPNIBWMOH   YAIJIWCVPPEW    PCUTHLKPIVBUKP  KOAJBCTUMGT     NNTGGEFCOOAE    IPMLXUYCSUE    
PLVWQMLSV       : DJVJCFSCQBE     CWUXR           QPJPPVOMY      
BAUDBAKFXOUNG   : CACQSEHVLKDHE   RXVEKFN         RRLPRJYBQBBQ    OSIYQTJPTBFSX   PFLT           
BDCBTRKLFII     : GAQL            YXGEA           YUTRNW          MTEA           
VTRTASTUXVVJ    : XYRBMOWECUN     JRUWIFF         QTKVPQGCOB      GKPQHBYGQDSRLQ 
VXXKEWNH        : IOSCWQAFNMSN    TUDITQUN        EQSNYVGFKFKOL   EHSF           
PDVC            : ILMRUYV         NMFBFI          BWKJPPINBIRW    TYIYVS          SJHAAK         
DKXCITU         : LJWCKQEGHAXD    AWHTPMCBRPIHHVR GUNKIVB         QQVOE           YPBRFKDGSAEX    XIRO            RFLSDX          DKWIKR         
TNYPM           : XROLKBOEYXNSRON OFKIYDBTTCWEDA  CAFB            BHHDTK         
LXAJVATBAIIC    : NPRSAQJCMRO     MAAUIWNOHUGY    VANKIBJVLV     
MAEDDQ          : SQKYMMBYTCOIKF  WHTUKM          HMHAPWHICEFYV   XYFMTUATXIKCX   TYWSNLPGIV      FIDWBWNWYIXIIV  JGEFGV         
GAVBE           : XYRBMOWECUN     NMFBFI          AWEXOFWFGETP    NOCHMOMX        CQCYQ           YUTRNW         
QFFF            : XRBNOLIOXAU     AANCNBLVJCVYXFC TEKKUJAUNMQRFM 
SDGFAHYDJJNNLCN : GDCVDMUNLKSFK   IGPCMR          QXDUMCLHWTQAV   LPGLUOERGLLEOGW
GQHJYJFAPXT     : YHIXCVDY        FEUQCMORVXGUVE  TKTYJFRTX      
FYEBFLGHUFKERAT : QPSDREXXYVHFOLB FHAAI           GLDBLAEFVMIUY  
DJVJCFSCQBE     : PLVWQMLSV       MWYQSLAM        LDGW            GLGYK          
YXGEA           : KTAHARXVACXWFD  BDCBTRKLFII     TQYES          
HFWNOTVBANB     : YAPLLV          CUWEQGFXCALQBNB SBYSBTK         YJCLBN          TEKKUJAUNMQRFM 
SEDOPHVJJMM     : ABHHWWNODN      RGQSKLKMAAITJ  
TLOCR           : WSWCDKRULMW     QARVW           XTFMTI          VCMG           
NAVMPKGLLI      : YBTPSJXG        DVVOHC          XOIBJAR         LXMEDCK         EHSF           
PCUTHLKPIVBUKP  : PNOBNWDAQO      OSIYQTJPTBFSX  
XHTR            : VFFXDCMI        FELQKDQFVOKYN   RTHL           
JRUWIFF         : FNEISNDFB       VTRTASTUXVVJ    PWSMLFCLLKC    
TQXJUSFD        : HRYMSPBKSKWJW   NLEILI          TANK            LNHKGYHTDQ     
RUMPXIA         : QXDUMCLHWTQAV   QYPUCGMYX      
YXXUQ           : PTWYKEXSK       UJWVYHWXQ       VWGIBQDNXFEE   
FKQEU           : VODFKTNRD       OUYVVSPG        TXSAYQ          KJQTEMB         GKAUKJLXJAFMCR  CEQMJFUQTPE    
LRSCP           : VGQGXTFAJNIFHCC DJXURTATQH      CPTNYAIRHXSO    QTRFGYXXCDIWQOX GXLPJVRRAYNIOY  QMTLDBJYBFGMV  
XKJDOEAETX      : MFQUKKNQKVLRY   CRDOIDIIC       HHVLQVANLAODIB 
UONUOLLL        : FHAAI           TWJYFFEKGNI     MXVN            IBQRLOMHMFRT   
YCWTBINTNFALPMQ : SCNBGGXVPEKKGBD EGUEJAALQCNNGLT MMEEJAXR       
QSLKQAHIPDY     : DSGUQSFGYNKR    ATSVA           PUUQCXXXIAPYPHC OWIQWOD         FCWBKUYO       
QKRRNO          : YXQDXJDF        XJCBCTRTPDCHXBP JFVF            WXIONYV         RWCPVJM         XMDJDDOHJ       QICB            CEQMJFUQTPE    
OACL            : JPFJLVW         GACDTCPAAU      YJIUWACWABXK    COGLLWLE       
INBA            : MIPVRXS        
THQMUEFUN       : JTGY            VSHVDGDAXETHOS 
LSPMMA          : APNJYWGWR       LEBLBOY         WUSAQLGMYW      SGRLNYFUJT     
EPXSFAVSNEGQ    : MJULJUVKKUARW   JFEPQKF         KIHBCUPCOPT    
JMOAYLGHHWWUPO  : TTELMT          WSPS           
CPQH            : JWITAYX         CFWA            UESRUEK         SLBIUYFMRCGB   
RAMRXHIEOBLXO   : UWDGRLK         VJHQHOWJX       HGQJGXM         EOSI            DXUA            GYBEUHOKHGRNF  
APNJYWGWR       : LSPMMA          PTWYKEXSK       RUWONP          NOFWKDXFP      
LCBDUKLMM       : UKGGMSBI        CNKANKQXIOLUL   KRUGJIEMXVKHOC 
HNIPRWQFWH      : NPRHGTXNYTKQJW  WBDSTXGTOKLAO   SSNJTM         
WXVIYSO         : EGUEJAALQCNNGLT WQIJSPNQGG      EXQPHM         
NPKPSPMFBARC    : FIVCURCCR       VUIHAJRS       
HKYA            : IHESKBFAJ       EWVBOURAHBWAX   TOFXP           CGCG           
RFGAPFANQ       : RDIIUQEJGO      KJQTEMB         EKQUPBVKNW      CFDWGHTEUQ      VPEVNQVI        SAXDVMDVL      
GHXV            : FWAM            OGFBE           UMSODLECUBN     FNDTEGJQRMAOLF  VVPLBWKIADNBAL  TRXUDTUGCWJW    ULRCMFWU        XOSJFPDVEWRXEI 
KLPABUEBP       : JWUUJQIIOMSXNGL KJQTEMB         KXDSMSMSS      
KWULY           : BJUESX          BDCC            XYFMTUATXIKCX   CTYLE          
DHMFWTHKKH      : VWGIBQDNXFEE   
UHPRRD          : INNQW           CPHUJVL        
TEFAHUKTSFFTLJB : UDTDAEFHMBKH    MIHRCSMJAGHLQ   RGQSKLKMAAITJ  
QXUYIHICC       : QCRYJGIXYBW     NTLJVCRGHYMNG   QBFPUTG         QYDJOSKCUFABM   VTWKOTPXOX     
TWJYFFEKGNI     : WTJXGGFF        UONUOLLL       
IBYNUKYY        : HXEBNYKNGPBS    IDFUIRF         FQNKYLNGQBV     IJXQQJUQHESLQL  MQUDONUSHEN     XOUELPLTYUGJ   
QWIPG           : BJUESX          HBDLFVNFRFXN   
AKUPG           : UKGGMSBI        RULTCTQXSDYN    UQWLHQW         FJONHJJCTSL     QJTOK          
BFYGLLOATI      : LMGNLAEROSLFIC  PJSGDOLFU       JNMCNPTHBRGH    TJBPTEDGRIE     LXMEDCK        
WJXUTATHQ       : YITUDVXWYA      UMCAD           SINHXDHXOV      NYQBMYOJMYCCQY  UCNBBPCVHGCRLBS
RIYKILHA        : YXQD            UHPMN           XJSADL          EKRL            FNWPYVIPFEIOKC  DPEU           
BDCC            : KWULY           FELQKDQFVOKYN  
NNBPKLAJ        : GVHOOTXIQ       JFVF            UVFXTKNKIC      CPYBVKRB        OHEDVTLYV       CCSMPGEDW       PGLXKWEYFBA     JCRPSKWJBYB    
YEQYAY          : GFMQRGJUB       YPFWQROKSTG     HNWSSHVUK       JOJXOSXTFDORHJU
TQCSDMHKODL     : UWDGRLK         IBQRLOMHMFRT    QGYMOEDLQT      CIODRKR         RYKOWFLEV       TVCU           
FNDTEGJQRMAOLF  : CQFIWH          WMYXWDWILX      GHXV            SPJYELHJHRTTRI  CWUXR           NSMBQWGJRTYUYWO WXVMONSSDJ     
MFHGYAIUEWEOLHD : IOFVHELJMUK     LNNKMCKVKXVRF   NDMNOCHILXBDGQJ
PQILWPWNHJO     : YIANNIEVLJFH    DKWIKR          MPWGWKSDB      
UVFJDMPD        : HMUYJOP         ERWJJEI         LOHUNFSW       
XASUGIIPL       : JKUKYV          ETJJKXAJIHJR    LNHKGYHTDQ      THSEIPRMVP      EXQPHM         
FEUQCMORVXGUVE  : USHNB           GQHJYJFAPXT     RTMEYLBGYC      YGMVSRBUUKD     XWSIFIVXYXEMRIJ PAEXJUOURRHL    XIYQOKXVRE     
FIOVNEVNWRVH    : BHHDTK         
LSORALIEAYVV    : JAEKQHITNOV    
FRTJTYT         : FHAAI           UUQETBKRKHER    AQOXAEFLDKD     UULMWP         
WHPTUONSWPFRGW  : LCLDFKHMWYACP   CGFTBBXVBPVRV   CLGIADIYWTTRM   GGLBRJOG        CXJFXOB         GIHF            NASCVQ         
RHVTHUQFA       : LLGGH           PWRLMN          MSDIC          
BLCAGNXNFRLU    : EBMAUHJOME      MVRR            USSAPBTBNHONC   PJKE            UFQHVVN        
ERWJJEI         : JELFNQMIYHPNL   LQDEPR          UVFJDMPD        DTWRDIVNKBMNYXO
XQASXUJFWTGJXI  : QNSBTNLM        JDUB            VGHUKBECUXKH    YNFPTJFW        DPPCBSAIKAIGB   PAEXJUOURRHL    VGOVGBTSAPI    
MIHRCSMJAGHLQ   : POKQORYOV       WTJXGGFF        TEFAHUKTSFFTLJB OFKIYDBTTCWEDA 
WULNUENSPSPJBB  : FMAMF           JFPNSOBEN      
JSWSBQUVGHX     : YIRPD           HWJVOPVFQUEW    FSOIGBVEHDRDUYM LLNLX           SXMMWSVELLBVLHL BTFKSUINJVS     LVMFHJXWDWA    
OMFCJANWXUMQMH  : JOGROCWLOE      XDCRFDKBOWON    CHXE            DITSDNHS        EJTCSVSKHSKOCTY
WIKHTD          : PKPFGDEGNXPOSF  MBBCA           CAFB            JGEFGV         
OGWMFFTFSKR     : VWPA            LMGNLAEROSLFIC  DJXURTATQH      MCFKPKLUUFC     LTBJICEDTAXCQAS
MBBCA           : XBHQ            WIKHTD          JOJXOSXTFDORHJU
YMPMTXLE        : OGFBE           RPSVQXAT        FLAARCRTT       BDHVRDRCCGXRU  
SBOBPWXEEEAKYK  : YAPLLV         
YYEAEEBFT       : QCWISHSWCDYHFK  SNAAML          HNMWE           PTLMWSXR        HNWSSHVUK       GUFEBESSIXNONPU KVHXOFCNACDJB  
RNTFUC          : VODFKTNRD       TQFDEGWDLVGP   
VSBNSASWGSHH    : RLHDF           BYFWJXVVGMSSWHJ ATMOWOVQLQ     
MGFQJLWM        : MKILMWGU        VFLQOYSVWU      RPQQLIOQ        XDJTNCH        
SGLJ            : BDIUNFXSOJFNEOS YAPLLV          STHG            TQYES          
REERCA          : PJWKUYEASVYU    LMMTTFDGEQXXY   GTNCKXYIVPETDYC LYTVWLBSOCUTYF  RTLUS          
PSVKPEG         : EKRL            RGXOBWYDPPRPGVQ YAPLLV          VFLQOYSVWU      SQIOUE         
LMMTTFDGEQXXY   : UMSODLECUBN     REERCA          CTTELBLX       
HBDLFVNFRFXN    : JOGROCWLOE      UQWLHQW         QWIPG           RDLF            NDMNOCHILXBDGQJ
QTWQFJDBFKHLO   : TRFYTIDJPGSFAUE PKPFGDEGNXPOSF  RVNE            PCDCORBBYHHMFCB
LMYX            : OLNNODMSTKFNSHJ RIUDC           JAEKQHITNOV     CLGIADIYWTTRM  
ABHHWWNODN      : SEDOPHVJJMM     CEQMJFUQTPE    
VEXS            : CVMCTUQDCTE     LCLDFKHMWYACP   ICVIK          
FECJJMQXCQL     : POJUXOOLCPYPVPS SVUKJHXEJ       TGAM           
PJNRLWY         : KBNEARUOJNQMOK  GTNCKXYIVPETDYC RYXAPYGBNYMP   
UMCAD           : FCYHPU          WJXUTATHQ       KSKXVNPXKYGO   
VJHQHOWJX       : VWPA            LMGNLAEROSLFIC  ROQCKGGP        RAMRXHIEOBLXO   WXVMONSSDJ     
YOGBHSTWEJ      : SBLJYD          YTJJYBHBHSK     CMVWYUJ         SHHJWM         
PHQBEFF         : PPXQFGKV       
INCSWUAMRLMAKE  : CVMCTUQDCTE     VRHQYT          EFXGMR          VDFNDQDIMP      FQNKYLNGQBV    
NLEILI          : BJUESX          TQXJUSFD        HSVBICATDIVHV   OWLOWC          MKWLBW         
CBBSEF          : XKYQVJXJ        NYXIQ          
JNHWPCUMCJ      : WNJKPOCHJI      EKEHDKCGBD      SBLJYD          AFORVUC         ASYGBNQFQSXRW   VOEEXCUSNBKSY  
QVJB            : RXYOBGOHICIUQOL UDTDAEFHMBKH    XJSN            KJGH            GWHEX          
SPOYACH         : IJQAI           JTWFJIENP       GMQLFLG         XIYQOKXVRE     
EIVXODYXTIV     : WNJKPOCHJI      AWEXOFWFGETP    SBLJYD          YNFPTJFW        CXSMBWLISS     
LQYPCF          : WYSNEICYO       HGQJGXM        
XOIBJAR         : NAVMPKGLLI      HETHJIAHEETIP   FMAMF           NVOV           
ATSVA           : YXQD            QSLKQAHIPDY    
TXSAYQ          : FKQEU           CSNHSEH         TJSCWTEB       
IOFVHELJMUK     : RNXRP           MFHGYAIUEWEOLHD TQYES           OJFCEBEKDQBD    DGGKDXVAFFVWTQ 
DNNFFXHB        : GKPQHBYGQDSRLQ  EOGNWNHLKQAYAW  EDDIMBTKJ      
DBWXCP          : KCMJGJUPAK      LXWDHNJITGVPGTV JFANPPNY        BYFWJXVVGMSSWHJ
BITLXYHHGVRSQ   : VRHQYT          BQNXKWTHD       IMGMJDPXYGLHQ   PUUQCXXXIAPYPHC ANPXHQR        
VVPLBWKIADNBAL  : JDFDRNR         GHXV            RIER            JBSXNCROBMR     IPDMAQ         
RLHDF           : GACDTCPAAU      VSBNSASWGSHH    BWFUXR          UJWVYHWXQ       KIHBCUPCOPT    
DHFKNBE         : AUYFAFBGSSGIWY 
TIGPASSW        : VFLQOYSVWU      QNONGBCASL      VPEVNQVI        FFENQBLXHOKWPQR
BWIQBLD         : CYILFWIOOXI     AXUHTR          OTUEUIKNOCTJJ   PNSDBENEGUDDWH 
FQNKYLNGQBV     : NECIOVKVTAJIU   IBYNUKYY        INCSWUAMRLMAKE  LEUJMBJYGPHATI 
FELQKDQFVOKYN   : XHTR            BDCC            SPJYELHJHRTTRI  CTTELBLX       
POJUXOOLCPYPVPS : JNMCNPTHBRGH    FECJJMQXCQL     PHEBVMACPT     
HBAURMAISVYDWNB : JYTGGRBKUVRLUHG BTFKSUINJVS     FVVAVEKQQJNFBNR HTJWOLFDLGLS   
EKMCCBQE        : EYGLODQU       
PVOIP           : IMGMJDPXYGLHQ   MKWLBW          QABF           
RQKNIXPQQMQ     : ARKWJNGVDHSBFDH LUVHFBJPAE     
LGXBMKORMRKSLAP : RIUDC           OKOI            YNFPTJFW        EDDIMBTKJ       DAQS           
KFLDXVQ         : BFIMQMTUCXOAEQ  ANPXHQR         QPJPPVOMY      
VGYMURLJALMN    : WNKUDCNJPBTG    VCKUTAEB        UMBAVM          CGFTBBXVBPVRV   COQVP          
DFLV            : NECIOVKVTAJIU   GKXHKOMDWT      LENUAWFFRXPIS   UESRUEK         THSEIPRMVP     
GHRVJDDW        : SAQM            JRMNQRUAQICKNQ  WSJEGEAKY      
BVYJRHLH        : IOSCWQAFNMSN    URTH            CCBSDI         
FSOIGBVEHDRDUYM : TJQJKQFAEJENIR  RITP            JSWSBQUVGHX     CPMAAXKCSRTH    NOFWKDXFP       FYAYIJRDRSRUKUJ
UVTYTCCPDOJNC   : EBMAUHJOME      KYQVQOHB        WKLVEAUOMVWR    UTHKCWWYLAJIK   XENMHNWICNDBPRW
SJLJRRMPWTUOYRP : BDIUNFXSOJFNEOS UANHNCLGEQ      LSRJSEYBUPPNW   SMPFNWNPRGHMV   DMNGGXBKW       DKWIKR         
JLKFMGK         : AEUKURKHUJG     SEVDHWE         WKXOKYVHKMGKLOT OHBEHOAGDMUXJ   QICB           
XNHHDJBXV       : MIPVRXS         RLWSFCECE       KDDAAHI         LTBJICEDTAXCQAS NSHHRFJN       
HPFWGESDUUVLIHY : TOWCL           PXVV            FNFD            CCSMPGEDW       GVVUDMF        
MLBWEYNMJQX     : ETBU            OUAWRKSS        FGQBJNRF       
PTWYKEXSK       : YXXUQ           APNJYWGWR       SQIOUE          MAAUIWNOHUGY   
VGMTTUBSQQGRNK  : LOYQVFC         NNTGGEFCOOAE   
BWFUXR          : WJWJPMXRQ       ICQUNBNNORQY    RLHDF           UUNHQSBCIX      KQTL            RTLUS          
ROLEVKYGEXOQR   : ICQUNBNNORQY    MUSCBDACEMQVMK  BQNXKWTHD       ULTUMQJ         OHEDVTLYV       SKWIPHJYIBDXHTF AVDTQVP        
NVBGMHBAU       : GHMJMQQXB       EBGUI           WBDSTXGTOKLAO  
ERCYPTLK        : SKAIC           QPSDREXXYVHFOLB RHSA            FFNGDFJVFCUN    WHDDWV          EKQUPBVKNW     
WQIJSPNQGG      : GAQL            IVNEDR          WXVIYSO         HJMFUIS         ANUNV           QUSK            SJHAAK         
PWGSDSDE        : PJWKUYEASVYU    HNMWE           MXVIBX         
XDCRFDKBOWON    : EROSGDCVBCLLUH  IJKPQ           IVNEDR          KYQVQOHB        OMFCJANWXUMQMH  BPDVBGGCQ      
WXIONYV         : LOYQVFC         HXEBNYKNGPBS    QKRRNO          IPPHIVQIUVW     EXJOTSJQQ      
KNTS            : RNXRP           ULTUMQJ        
WOLEKLHOEPR     : SOTRUVWI        DQAEM           GXLPJVRRAYNIOY  FPHPAPVKQLCRLON IOYFHHMREKQERF 
SINHXDHXOV      : GVHOOTXIQ       VSNJB           WJXUTATHQ      
NTJAJDT         : MRFDPQCCBK      MKAARAPYUIJKMER WXVMONSSDJ     
CIEGUQ          : GPESKTQUFB      AXUHTR          RPSVQXAT        NMOYXNGBYPJB   
LWIDNBND        : HODYFWNTXXG     CJFHWAW        
LISKWQYLNINWLHP : DVVOHC          DIMKNXWCEQNRDP  MVIMY           CXSMBWLISS      UAPUMWKERYMGHCD GVRIOOOHTT     
RUWONP          : DPCRAJQBWAOIIVR APNJYWGWR       QYDJOSKCUFABM   MMGU           
MXDAYSFMFNF     : UORCMTUCWGP     JDFDRNR         WFLWLFGQKWBPO  
NYQBMYOJMYCCQY  : WEKUTUFRXGX     UPPLIXD         WJXUTATHQ       GMOGYMMBOFIDMVL ERYKQVG         PHEBVMACPT      QYPUCGMYX      
GMOGYMMBOFIDMVL : FNLRGCWTH       NYQBMYOJMYCCQY  JRMNQRUAQICKNQ 
JKUKYV          : RNXRP           XASUGIIPL       GIEPNYYURIGQI   DKRTBP         
IIBMLRLMAXCJY   : XYRBMOWECUN    
VCHBML          : RNYE            VVCYCLWADDM     VNORGNLJOBIJOIJ MXVIBX          RYXAPYGBNYMP   
JWUUJQIIOMSXNGL : WIJTB           KLPABUEBP       NSMBQWGJRTYUYWO YTFLUAPDH       FGOSFQQYP       SPPXSBH        
RXISCRTTPWD     : XYRBMOWECUN     FWAM            FKFY            BYUMSP          UNPKYP          EHQGYCVPO      
LOHUNFSW        : UUHMBQXIWK      UVFJDMPD        RHRVDRRWYJG    
DHKPBKFHVMBWWT  : QUPJGORAO       BDIUNFXSOJFNEOS GTAYNGFLCY     
QOUG            : AJDPSPNIBWMOH   MXVIBX          HHVLQVANLAODIB 
BAYRJWGORFMWNAM : GUNKIVB         NJUTKFR         JQCQVDKJPOXKAHR
KTXJGYIEVJUKFEA : INKIHNWVBFLY    UKABIVJWUYIC    YEWFYHA         RLCXVPPCEHO    
EBANXGFPOR      : MCBCFH          CFDWGHTEUQ      OCRLDMSBDAUJ    LIRMJIFXOVJYOUX
ETBU            : MLBWEYNMJQX     GSYYPPKJKD     
UUQETBKRKHER    : MRFDPQCCBK      FRTJTYT         MMEEJAXR        IVHKFRA        
EAPGBGGJNWXFN   : HJAPAXVWDDS     YEWFYHA         XFJRFCF        
APWHMRASOBDGLL  : NSFGHDFPG       VGTBPFSOJXBOOK  WXAQFFPTYQXOT  
EYRER           : HFBITUQQUALYH   RVNE            LNFVSAWQJC     
HAFRNEPURU      : XKYQVJXJ        BFPGCMRHDQOVN   IPPHIVQIUVW     XOUELPLTYUGJ    VWFDHI          WXVMONSSDJ     
JTGY            : WIJTB           TNWB            THQMUEFUN       UWUPWTWCLUSVPO  AOTXXMNGOPNR   
GTDJXLVLYC      : QNSBTNLM        MHNW            VKNXCYMKE       TNWB           
RIER            : WPQNVVQ         VVPLBWKIADNBAL  AMFFNTFTYBJ    
EYIRFAPAUMLPTKE : HJMFUIS         WIWXAFT         GNHCTYBW       
HJMFUIS         : WQIJSPNQGG      EYIRFAPAUMLPTKE NFXHBGLAYTNBTIE WLWPABRH        KMGGPRRHG       RGJREUVFU      
MFQUKKNQKVLRY   : JBYJTNQMSGSP    WYSNEICYO       XKJDOEAETX      PHEBVMACPT     
RTPELJQPM       : RWCPVJM         LEBLBOY         MMMCWXHGTA      KABBTMHTC       HGFTOUHONJUD   
BYFWJXVVGMSSWHJ : OLNNODMSTKFNSHJ VSBNSASWGSHH    DBWXCP          HBMGRUYGKK      VSMLSFRQWLGXG  
FUCEXVBOA       : HISSUX          IPPHIVQIUVW     WUSAQLGMYW      LVMFHJXWDWA     QVIXPXQQSEF    
XTFMTI          : TLOCR           IJRKYVR         UVOTSLBIXKBMEBA XKLCIC         
CFWA            : CPQH           
SIPMBPVLYBIBI   : YXQD            LMGNLAEROSLFIC  YAIJIWCVPPEW    NBAII           DRHIHWYUIWVFWH  SBYSBTK         EWKOQXKEGOMGQII
XJXAX           : MGXRFIITGRT     SJCITRCCRCAYHY  CTTELBLX        UMAKIYQVN      
VFLQOYSVWU      : MGFQJLWM        PSVKPEG         TIGPASSW        MNXQFOKIEKSKA   OWLOWC          RLWSFCECE      
PERE            : TNFFDNCHVWKBDR  WFLWLFGQKWBPO   MCWA           
HCUHEGKOPIANLXN : DQNCIRHCPCBFFDV NDOXIU          UULMWP         
GYXWYSUXOU      : MVRR            QYWXBJDESR      JDSOCC          ASRYBPTJEIXN    GWHEX          
UPUEWWA         : PUWFYASIT       XJSADL          MOXRTBTDE       NKEMLASFRG      RDONG           QUSK           
DGRRXARLLS      : MKCARTEJRRGUHMN PPFUQH          GACDTCPAAU      VQCQVQP         TYWSNLPGIV     
VBBTXCPSAGQPBG  : IUJVPMW         UORWWVAGB       MOXRTBTDE       PCDCORBBYHHMFCB
HFMHMPPEKNGEBU  : JOGROCWLOE      WIJTB           BRAEFNFCQYLRTD 
DQAEM           : HCNKV           WOLEKLHOEPR     LENEALWYHCPFM   MUTOBHPEJKSBS  
ICVIK           : PPFUQH          VEXS            NASCVQ         
ANUNV           : WGQBTPBWSN      WQIJSPNQGG     
AFORVUC         : GFMQRGJUB       GGCJUEIDR       UORWWVAGB       JNHWPCUMCJ      URTH            UKXFNUSGI       LWRGFX          MXUEBO         
AFORVUC         : QMRVTF         
CJPY            : QTHTDRUHBTIT    QARVW           EQMWELS         KOAXARETMHQXSC  EWVBOURAHBWAX   OIDOUSYYSC     
SPJYELHJHRTTRI  : NOCHMOMX        FNDTEGJQRMAOLF  FELQKDQFVOKYN   XOUELPLTYUGJ   
HETHJIAHEETIP   : XOIBJAR         OIMGYED         VAPXO          
HYEWKDD         : DPPCBSAIKAIGB   FXOETGXYXJ      TKEGMLBTGQ     
MMEEJAXR        : JWITAYX         GREAMURAFPELDOX TBEQOKNOMXW     YCWTBINTNFALPMQ UUQETBKRKHER    AHBTVTNOYWT    
GXLPJVRRAYNIOY  : LRSCP           WOLEKLHOEPR     OWLOWC          HPFXFATJJERKH  
NDOXIU          : PJSGDOLFU       HCUHEGKOPIANLXN GWUOATUR       
WJDBSDBK        : MVAFCHG         OUYMDWYV        KQTL            ASRYBPTJEIXN   
JKIAUHRM        : INKIHNWVBFLY    PUXIDJA         TLPLIWQLFEMYQX  DTWRDIVNKBMNYXO DKRTBP         
QASGBKV         : DTWRDIVNKBMNYXO
AWOWTLGWO       : RPQQLIOQ        KDDAAHI         SJHAAK         
CPMAAXKCSRTH    : WHTUKM          BXFMOVOLMAIR    FSOIGBVEHDRDUYM EHQGYCVPO      
NJUTKFR         : IQDVX           RGXOBWYDPPRPGVQ BAYRJWGORFMWNAM
HOFEKQLHFN      : NFXAXREY        PXBIOVKBXU      OTWPPLHDNVK     VSKAEOG        
WAMYA           : UANHNCLGEQ      RWOTGWRDLJ     
BURV            : PYDQOKJJQAN    
TJNOF           : IHESKBFAJ       PPFUQH          AWEXOFWFGETP    GACDTCPAAU      VCWTXJL         QTRFGYXXCDIWQOX OUYMDWYV        FQMRYULOAR     
VYQE            : JWITAYX         FNWPYVIPFEIOKC  CAFB            DTWRDIVNKBMNYXO
XKYQVJXJ        : CBBSEF          HAFRNEPURU      YGLNEUORAXWD    FGNKYVMLNTOFKKU HUHSGO         
VMKUMHWIY       : FSONPRMHJ       IQWKPHHHVLJNCRW GACDTCPAAU      BAPRSVDHVXESID  KEKWNLYQWHEKD   DTWRDIVNKBMNYXO
MSGDJNDGM       : YBTPSJXG        QUSK           
MBUWDMTOKFKITU  : GVHOOTXIQ       VPOQSIXQGW      NWEVPIVEFPFMFJ  FWQLR           XWSIFIVXYXEMRIJ WXVMONSSDJ     
HEDRGA          : MKBINQMEENVXB   TGBGOPPSHVYG    CWDHJYNYR       CMVWYUJ        
BGJNVN          : LCLDFKHMWYACP   MUSCBDACEMQVMK  QYPUCGMYX      
IMGMJDPXYGLHQ   : IHESKBFAJ       CYBVLYDORTGEMLL BITLXYHHGVRSQ   PVOIP          
DNAMTFECHN      : KOAJBCTUMGT     EYGLODQU        VANKIBJVLV     
PWRLMN          : RHVTHUQFA       LUOE           
YTJJYBHBHSK     : XBCXEJFBFODHA   YOGBHSTWEJ      RKNKOLQYKUPP    VPEVNQVI        TEKKUJAUNMQRFM 
PNPPBJXHMF      : IMBHIXDIYYQIGYX EKEHDKCGBD      UAIELQFTJWT    
SVUKJHXEJ       : NOCHMOMX        VFFXDCMI        FECJJMQXCQL     XUBYYYMMFWK    
PUUQCXXXIAPYPHC : RYEQLPPCBBRRFBD FHQULFNQHFVREFV QSLKQAHIPDY     BITLXYHHGVRSQ  
FJONHJJCTSL     : LIMOSNLPQQMO    TYIYVS          AKUPG           XDKD            GDRRYGXHPX     
AUPR            : FHQULFNQHFVREFV QHDDOJFQSLOTCW  CHIXWNPGXFSADHP
MJULJUVKKUARW   : EPXSFAVSNEGQ    SVTXVQBCQOIIW   ANSANSUTOJBFHTI PUFECEYWUYCEHK  VANKIBJVLV      EDDIMBTKJ      
XJSN            : YBTPSJXG        MTFSBPS         QVJB            OSBNCFBFSSK    
CWUXR           : PLVWQMLSV       FNDTEGJQRMAOLF  FDJES           VGTBPFSOJXBOOK  CEETJI         
TTELMT          : CUXQPAOHCV      JMOAYLGHHWWUPO  TOIP            RUEEYFXWCSLVGOG BHHDTK          GBPYCEWMQYPNIFL BBWXNUMYVKI     DVJPIRMF       
XQKHLITV        : LARGVETYNHRCLW  RYEQLPPCBBRRFBD NKEMLASFRG      MUUQGYUBSAA     TOFXP           GBCNBTKCY      
WODBOMUCFY      : LCLDFKHMWYACP   FWDXJBC        
AXUHTR          : IOKVACXQSXDPR   BWIQBLD         CIEGUQ          RTCRHEJXHXSE    KVHXOFCNACDJB   RJBTOEC        
GGHFEYRNM       : VKNXCYMKE       POWL            FRJK           
KJGH            : AOCIPAJRDROVIM  PEPIECR         QVJB            DGGKDXVAFFVWTQ  MSNSAGACVAUAVL 
KIQWFU          : YIRPD           IJKPQ           KABBTMHTC      
FVFFSOY         : XTBSJ           PUWFYASIT       MKILMWGU        FHQULFNQHFVREFV
CHSK            : YWMGGEKAWQ      MPWGWKSDB      
YLGNXHXJ        : CUWEQGFXCALQBNB GLDBLAEFVMIUY   MORAKFPRUMGMGO  USPRVUPFPENFLOL IUMEIEQQBHE     RWBXEMKMA      
HJAPAXVWDDS     : AEVPNNTYM       JOGROCWLOE      EAPGBGGJNWXFN   LENEALWYHCPFM   JOJXOSXTFDORHJU
KOAJBCTUMGT     : LDJBXSJTQWSK    PNOBNWDAQO      DNAMTFECHN     
PJYWHIMQUNHWN   : DCXUK           QNEBMHTM        DJXURTATQH      VJUTWMEXCYW     DQWKYTSH        FJXIJIETCUPBL   TQWOLRURSA     
USKPBUEDGGGA    : TOWCL           DGGKDXVAFFVWTQ 
UJWVYHWXQ       : YXQD            YXXUQ           RLHDF           HSVBICATDIVHV   PTLMWSXR        YWMGGEKAWQ      ENOPANPXT      
MKAARAPYUIJKMER : NTJAJDT         KIODDIANEJ     
MXVN            : KCMJGJUPAK      BQNXKWTHD       NKEMLASFRG      UONUOLLL        KJHGTIHBS      
RWCPVJM         : BSDWEWHXS       OVYPBHWHCSDLQGS AQJOOGILQCJPJ   QKRRNO          RTPELJQPM       AHHHIAMRFRGNHR  JGEFGV         
DRINUJ          : RITP            IKNGRJMLCFDN    GBLFOGWBBBAC    JUUTIT         
UBIRK           : ROQCKGGP        BNAEHNSXOQNUSOM QVIXPXQQSEF    
EWXVOKVLAYFW    : AEVPNNTYM       ILQPATOLWCUA    HSVBICATDIVHV  
UUNHQSBCIX      : CVMCTUQDCTE     NPRSAQJCMRO     IOSCWQAFNMSN    BWFUXR          JISKCYSOR       KOAXARETMHQXSC  FWDXJBC        
RUOAMY          : DJXURTATQH      PJSGDOLFU       JAEKQHITNOV    
RXTP            : HNWSSHVUK       TWEOWBQVEHPPC  
HMBHLIHPDEGMXYP : YXQD           
IONCJCDYEWSE    : LXTITHJCPX     
ITBUUIJF        : JTGCTAX         NPRHGTXNYTKQJW  UISPAFTIN      
BKWHWUH         : IRNEKIB         PPGJOXUWUIVSB   YUTRNW          XWERWQI        
WREKTNOYOSYHAS  : BJUESX          NRJGQEQDQNNML   GJAXYCVGXQR     IPDMAQ          OCRLDMSBDAUJ    QNYEDIT        
TTNREWWWBKVIHS  : WGQBTPBWSN      WEKUTUFRXGX     YPFXFCFNNFEWIS 
WPJDCGRQFIMGQ   : ICQUNBNNORQY    VJMB            CGHT           
YJIUWACWABXK    : ILMRUYV         FHAAI           OACL            HUTRQQUOXBIY    LYTVWLBSOCUTYF  KEAB           
GTRYTHKWLQQ     : MPJBNCSFWT      FNFD            INSLB          
YAQFQF          : VNORGNLJOBIJOIJ FDJES           GKAUKJLXJAFMCR  TKTYJFRTX      
CQCYQ           : GAVBE           LNHKGYHTDQ      WXSA            ATMOWOVQLQ     
VSHVDGDAXETHOS  : IUJVPMW         XBCXEJFBFODHA   GGMIGQTLRYD     DIWQCTGJATS     THQMUEFUN      
GKXHKOMDWT      : DFLV           
NYGGFFAPB       : HYSP            TOIP            EQSNYVGFKFKOL   DVJPIRMF        TWEOWBQVEHPPC  
VGHUKBECUXKH    : XQASXUJFWTGJXI  NCSAFBLWNYN     EHQGYCVPO       DVJPIRMF       
RTMEYLBGYC      : FEUQCMORVXGUVE  OUYMDWYV        CACQSEHVLKDHE   NRIBNDDBBAJWHSY UDKXFAHUHFKU    COGLLWLE       
IJRKYVR         : EBMAUHJOME      FLUDRG          XTFMTI         
CASPDWRAW       : GSIQOJWQC       JBYJTNQMSGSP    AMFFNTFTYBJ     LWRGFX          RHRVDRRWYJG     TKCCH          
HSVBICATDIVHV   : NLEILI          UJWVYHWXQ       EWXVOKVLAYFW    FHABIOQBTWKY    LNNKMCKVKXVRF   BNAEHNSXOQNUSOM OSIYQTJPTBFSX  
RPQQLIOQ        : MGFQJLWM        AWOWTLGWO       HUKTDM          RKJC           
JIOJCOGGYCCCME  : UHPMN           JWITAYX         PKPFGDEGNXPOSF  CHIXWNPGXFSADHP
IKNGRJMLCFDN    : TRFYTIDJPGSFAUE FJILAAMOPNHLTM  IVNEDR          MTFSBPS         DRINUJ          SPPXSBH        
TGBGOPPSHVYG    : HWJVOPVFQUEW    HEDRGA          UURACVTFKE     
DIMKNXWCEQNRDP  : LISKWQYLNINWLHP AMYLQDXOCXJLE   WLWPABRH        COGLLWLE       
IGPCMR          : VJUTWMEXCYW     BRAEFNFCQYLRTD  SDGFAHYDJJNNLCN
EHAWOYYWYEGOO   : VGQGXTFAJNIFHCC VVCYCLWADDM     IEBGWPCDRWTX    CCHJX          
MNXQFOKIEKSKA   : BEXRAFLG        HRYMSPBKSKWJW   VFLQOYSVWU      RKJC            IAMAG          
ARIECIDSHEQJLY  : MVAFCHG         HMNYPB         
AUMQVFVKSGQF    : OGFBE           GACDTCPAAU      OHEDVTLYV       LNNKMCKVKXVRF  
CHXE            : CQFIWH          OMFCJANWXUMQMH  QXDUMCLHWTQAV   MREEN          
GIEPNYYURIGQI   : LUNJHLQR        SQKYMMBYTCOIKF  QQVOE           JKUKYV          UMAKIYQVN       RXLQIPJCBXOLNU 
OUYMDWYV        : VNORGNLJOBIJOIJ JFVF            WJDBSDBK        TJNOF           RTMEYLBGYC     
PDGTKFXML       : GVHOOTXIQ       UAUIMHFDYJPVEU  RIUDC          
SBYSBTK         : HFWNOTVBANB     SIPMBPVLYBIBI   RWBXEMKMA      
AEUKURKHUJG     : JLKFMGK         KRUGJIEMXVKHOC  FRJK           
PXVV            : RULTCTQXSDYN    HPFWGESDUUVLIHY UISPAFTIN       KRUGJIEMXVKHOC  FNOEMIWXMWWC   
JBSXNCROBMR     : NWEVPIVEFPFMFJ  VVPLBWKIADNBAL  PTLMWSXR        CCHJX           VEVNUTDHUGX    
YEWFYHA         : VVCYCLWADDM     OYGSOMNJTBL     KTXJGYIEVJUKFEA EAPGBGGJNWXFN   JKIWKEEYA       YAAO           
THOEP           : PCDCORBBYHHMFCB CXSMBWLISS      MSGTOY         
TOIP            : RIUDC           TLGWWN          TTELMT          NYGGFFAPB       OWLIJMOIAS      XPMKCM         
RTCRHEJXHXSE    : EFEWWVFJA       XKFEENX         EUUFKAMHSTUQOVG AXUHTR          AJWFQHEKARATEAU
WBDXLEQHNHL     : CREQOWCOY       NFGBGH          JTWFJIENP       HTGH            FNFD            UMBAVM         
RHSA            : HQLQY           FLUDRG          CYQUTYS         ERCYPTLK       
CTTELBLX        : LMMTTFDGEQXXY   FELQKDQFVOKYN   XJXAX           YPFWQROKSTG     TWEOWBQVEHPPC   NFEHXCTCEDH    
SVTXVQBCQOIIW   : MJULJUVKKUARW   PYTNYPGLDBQVT   PMCKLHGIPANTHCA KGFKLRG        
PKCJSUJUYFOGT   : SKWIPHJYIBDXHTF GUFEBESSIXNONPU
RRSMPPMMIO      : FGRWOWJTFFIUWCJ UESRUEK         TANK           
AFYK            : FCYHPU          TBEQOKNOMXW     QPSGUAX         OIDOUSYYSC     
WCPAMKWXFWETDXN : FNEISNDFB       XSMHQFNFUTLW    MTPH            RXLQIPJCBXOLNU 
RGJHX           : VIOCPIKQMGGEDUG USSAPBTBNHONC   IPPHIVQIUVW     GLGYK           FWDXJBC        
VHNMHSLRXLTNLI  : UMSODLECUBN     XDUFJM          AOTXXMNGOPNR    FWQLR           XOUELPLTYUGJ   
IHDHNYMNMJ      : TQXHT           GIHF           
UVOTSLBIXKBMEBA : CREQOWCOY       HRYMSPBKSKWJW   XTFMTI          SQIOUE         
QLJOVQTGGUSTJFY : TQUQ            NYVSMVGTDOPKCW  FYAYIJRDRSRUKUJ IVBGFNJOMPHVR  
BPDVBGGCQ       : IHESKBFAJ       RIUDC           XDCRFDKBOWON    VGOYPGDCR       WIWXAFT         TUEIH           GRDBGM         
OWLOWC          : VCWTXJL         SDCECNEBQLRCTLI NLEILI          VFLQOYSVWU      GXLPJVRRAYNIOY 
GTAYNGFLCY      : SOTRUVWI        MUUQGYUBSAA     DHKPBKFHVMBWWT  PGLXKWEYFBA    
JAEKQHITNOV     : BRMCNUHUAKQGYMV LSORALIEAYVV    LMYX            RUOAMY         
XMDJDDOHJ       : LBBTF           GKDO            QKRRNO          CJLPWBDMD       ACGXJEMOGDQKGAL
IJXQQJUQHESLQL  : WHTUKM          IBYNUKYY        CACQSEHVLKDHE   KIODDIANEJ     
YGLNEUORAXWD    : XKYQVJXJ        XROLKBOEYXNSRON XPMKCM         
FNWPYVIPFEIOKC  : ROQCKGGP        MVRR            RIYKILHA        VYQE            KJQTEMB         XCQXAFVISO     
CPYBVKRB        : GFDTVTJWDEQ     NNBPKLAJ        FNFD            MORAKFPRUMGMGO 
IUGIRLXYYUQA    : VGQGXTFAJNIFHCC DDCXEBTYFHGQ    IOWAXIJIYPXFF   IUMEIEQQBHE    
ASYGBNQFQSXRW   : JNHWPCUMCJ      LNHKGYHTDQ      GWHEX          
DQWKYTSH        : PJYWHIMQUNHWN   OFKIYDBTTCWEDA  XENMHNWICNDBPRW
FFNGDFJVFCUN    : ERCYPTLK        OOUSYMUKMC      XJEYAXAWGU      YQRL           
LENEALWYHCPFM   : UAIELQFTJWT     DQAEM           HJAPAXVWDDS    
YIANNIEVLJFH    : PQILWPWNHJO     OOUSYMUKMC      APDLXEXL       
JFEPQKF         : JWTCYRODN       UKGGMSBI        EPXSFAVSNEGQ    TQYES           PKAWKLXJDLCHM   QWRDDJJY        DPEU           
KQTL            : BWFUXR          WJDBSDBK        JDSOCC          MWYQSLAM        FUFMRMIJJDE     SHRPFDN        
VBHLTHTUWHDBFQM : PQHVERPJ        NFGBGH          EAEUFUKU       
XDUFJM          : VHNMHSLRXLTNLI  FWQLR           VJMB            OOUSYMUKMC      PSRHMQXMHTJKQVY
URTH            : BVYJRHLH        AFORVUC         IOYFHHMREKQERF 
PTLMWSXR        : YYEAEEBFT       UJWVYHWXQ       JBSXNCROBMR     FUFMRMIJJDE     PJKE           
ROABTDG         : JYTGGRBKUVRLUHG OGFBE           JTGCTAX         HWJVOPVFQUEW    TBNSJBBKLYNWI   YSLIQYSSNIT    
QTKVPQGCOB      : SAQM            VTRTASTUXVVJ    LXTITHJCPX      SPMEGFOIYIR     MCFKPKLUUFC    
KIHBCUPCOPT     : CPESJEECDDBHECX XAFENC          HBBILV          EPXSFAVSNEGQ    RLHDF          
JISKCYSOR       : IJKPQ           VOLJHMDYLBLHDS  JNFVKGHBWASDQB  UUNHQSBCIX      USSAPBTBNHONC   CKUKFA         
YNFPTJFW        : XQASXUJFWTGJXI  EIVXODYXTIV     LGXBMKORMRKSLAP YAAO           
RGQSKLKMAAITJ   : GVHOOTXIQ       KUXAHW          SEDOPHVJJMM     TEFAHUKTSFFTLJB OFKIYDBTTCWEDA  VGCHUSKOQVN     IOWAXIJIYPXFF   XCQXAFVISO     
RGQSKLKMAAITJ   : JUUTIT         
OTWPPLHDNVK     : HOFEKQLHFN      LDGW           
RTKPBDXTX       : ACUWSOWSKWYODQM HRYMSPBKSKWJW   PJSGDOLFU       IVBGFNJOMPHVR   ITSKKTURSOI    
FJXIJIETCUPBL   : PJYWHIMQUNHWN   MXVIBX          NNTGGEFCOOAE   
NSMBQWGJRTYUYWO : FNDTEGJQRMAOLF  JWUUJQIIOMSXNGL XROLKBOEYXNSRON PGLXKWEYFBA     FGOSFQQYP      
HTGH            : WBDXLEQHNHL     OYCJGI         
SQIOUE          : YPUJWXV         JDFDRNR         PSVKPEG         PTWYKEXSK       UVOTSLBIXKBMEBA
XROLKBOEYXNSRON : HCNKV           TNYPM           YGLNEUORAXWD    NSMBQWGJRTYUYWO LDYDPNBKOFFJ   
LENUAWFFRXPIS   : DFLV            NYXIQ           RYXAPYGBNYMP   
OQLFFYJ         : VVCYCLWADDM     ILMRUYV         GNOXMEQKNWNAB   FPHPAPVKQLCRLON POWL           
DITSDNHS        : OMFCJANWXUMQMH  LSRJSEYBUPPNW  
UWUPWTWCLUSVPO  : KBNEARUOJNQMOK  OKVUDFDWNNOHMDN JTGY            TYWSNLPGIV      RANVRM         
JDSOCC          : GYXWYSUXOU      KQTL            SDIJVXTDNYIBPMI EPNMECOXIHYT   
HMHAPWHICEFYV   : MAEDDQ          HHVLQVANLAODIB  WKXOKYVHKMGKLOT
STHG            : GMQLFLG         SGLJ            BBWXNUMYVKI     GVVUDMF        
CCFQOOVHFAJRHV  : RYXAPYGBNYMP    GJSFFYRK        PKQNCOJBOKPETI 
JNBSVDWDETIWNP  : VSNJB           FNLRGCWTH       VCKUTAEB        KSKXVNPXKYGO   
ETJJKXAJIHJR    : TBEQOKNOMXW     XASUGIIPL       AQOXAEFLDKD    
TQFDEGWDLVGP    : WPBNVALPLY      THGEB           RNTFUC         
OMFGTKADVN      : HHNULHWBWFSDW   OVRMPTTQRTRQRG  AVDTQVP        
YWMGGEKAWQ      : CHSK            UJWVYHWXQ       CCHJX           HUHSGO         
CWDHJYNYR       : VKLHBMQBGATPNK  HEDRGA          BHHDTK          KXDSMSMSS       CEQMJFUQTPE    
OWLIJMOIAS      : ERJFRG          TOIP            SHRPFDN        
WFPFLB          : SOTRUVWI        YJCLBN          TJSCWTEB        CLGIADIYWTTRM   EPNMECOXIHYT   
JRMNQRUAQICKNQ  : BPGSVJKMMM      JIRVXYEEDMTDCI  WSWCDKRULMW     GHRVJDDW        GMOGYMMBOFIDMVL LXMEDCK        
ABTOPCOIL       : QSTFG           GFIBNRBAMTUXVL  SGSMSWY         FXOETGXYXJ     
NCSAFBLWNYN     : VGHUKBECUXKH    QGYMOEDLQT     
TQYES           : YXGEA           SGLJ            IOFVHELJMUK     JFEPQKF         RYOQVJFCKE      RXLQIPJCBXOLNU  YQRL           
ULTUMQJ         : JNTR            CREQOWCOY       IFKLPPYRBCXMMM  ROLEVKYGEXOQR   KNTS            VGOYPGDCR      
UANHNCLGEQ      : PUWFYASIT       SJLJRRMPWTUOYRP WAMYA           COGLLWLE        FCWBKUYO       
PPXQFGKV        : VCWTXJL         PHQBEFF         FMAMF          
QQQLCNIPGTUBTII : DRHIHWYUIWVFWH  BNOIEQQSOKLQ    CAWJK          
MVSQ            : FKFY            UKABIVJWUYIC    SHRPFDN        
DICBYIJJGQD     : SFEU            IOYFHHMREKQERF  MTEA           
KOAXARETMHQXSC  : CJPY            UUNHQSBCIX      NYXIQ           PSRHMQXMHTJKQVY MURHRSXMBCJFGY 
OUCEXKICMSLVAD  : GBHCFEEQOYMP    BMNWSWWTK       EWBQGAFI        OWIQWOD        
ANSANSUTOJBFHTI : WGQBTPBWSN      MJULJUVKKUARW   AMYLQDXOCXJLE   RRLPRJYBQBBQ    IPDMAQ          UVWELWQUUIGDYU 
JFYPELXGXRTWTW  : OLNNODMSTKFNSHJ TACGBBTKVMOJWNU CHIXWNPGXFSADHP
TKQVXJQRYD      : NFGBGH          NYVSMVGTDOPKCW  VGOVACUSKIVNAT 
GKPQHBYGQDSRLQ  : USHNB           GTKMV           VTRTASTUXVVJ    DNNFFXHB       
FNFD            : HPFWGESDUUVLIHY GTRYTHKWLQQ     WBDXLEQHNHL     CPYBVKRB       
YPFWQROKSTG     : VGQGXTFAJNIFHCC YEQYAY          CTTELBLX        VGCHUSKOQVN     OKQURUYWM       JFPNSOBEN       MMMCWXHGTA     
GWUOATUR        : NDOXIU          RDIIUQEJGO      XKLCIC          FCWBKUYO       
PJKHUPWAULBNTX  : GYLUHPRCHRGE   
NOQGIXHPW       : IQWKPHHHVLJNCRW GFDTVTJWDEQ    
EWVBOURAHBWAX   : HKYA            CJPY            UCNBBPCVHGCRLBS UISPAFTIN       CGHT            RYKOWFLEV      
UMAKIYQVN       : WXTLKJMKBPJMUO  EAGEMHTBRCMX    EAEUFUKU        XJXAX           GIEPNYYURIGQI  
EYGLODQU        : YBTPSJXG        EKMCCBQE        DNAMTFECHN      RDIIUQEJGO     
OVRMPTTQRTRQRG  : FSONPRMHJ       QHYPDEUSHLXSA   OMFGTKADVN      NLVPFUP         BERK           
EOSVMIEQJMEXRWU : QTRFGYXXCDIWQOX POKQORYOV      
MTNBJIUBCRSUJYO : OYGSOMNJTBL     QJEUBVH         XOUELPLTYUGJ    PHEBVMACPT     
PJLC            : QARVW           UECDNLYTD       NWXRJXPTIF     
RUEEYFXWCSLVGOG : UAUIMHFDYJPVEU  BJUESX          TTELMT          SPMEGFOIYIR     VPEVNQVI       
JHSDCQODHF      : WHTUKM          NYXIQ           VJNEJXFRWPFY   
TQWOLRURSA      : LLGGH           GFMQRGJUB       PJYWHIMQUNHWN   TOFXP           FUFMRMIJJDE     QYURRJPXJHXRLIQ
RDLF            : TQUQ            CPTNYAIRHXSO    HBDLFVNFRFXN    QRYHVQOTSFJ    
RTHL            : IMBHIXDIYYQIGYX WGQBTPBWSN      KUXAHW          IDFUIRF         UNPKYP          XHTR            INSLB          
QGJSWBX         : TNFFDNCHVWKBDR  DSGUQSFGYNKR    DQNCIRHCPCBFFDV USPRVUPFPENFLOL BJBCRPBYWL      YAAO           
GSYYPPKJKD      : OEEBJIDMNHWSJ   ETBU            SDIJVXTDNYIBPMI PBORX          
NVWSHFTBYE      : GKDO            WNJKPOCHJI      LXWDHNJITGVPGTV FGNKYVMLNTOFKKU MQUDONUSHEN    
HUTRQQUOXBIY    : YJIUWACWABXK    LXMEDCK        
AQPMEURRQ       : GHMJMQQXB       UTHKCWWYLAJIK   JFPNSOBEN       WIIMAXQVVDBBQSO JUUTIT         
MXVIBX          : CJFHWAW         RBHDWLG         PWGSDSDE        VCHBML          QOUG            FJXIJIETCUPBL   TQXHT           CCWY           
OFKIYDBTTCWEDA  : MIPVRXS         TNYPM           MIHRCSMJAGHLQ   DQWKYTSH        RGQSKLKMAAITJ   DFHKBU         
URTY            : WLDWXRJWASWF    HFBITUQQUALYH   SVEFPJJYGV      HHVLQVANLAODIB 
NSFGHDFPG       : APWHMRASOBDGLL 
HUKTDM          : FKFY            EFXGMR          GBHCFEEQOYMP    RPQQLIOQ       
HGQJGXM         : RAMRXHIEOBLXO   LQYPCF          LNNKMCKVKXVRF   LYTVWLBSOCUTYF  HGFTOUHONJUD   
FHABIOQBTWKY    : HSVBICATDIVHV   PNSDBENEGUDDWH  UMBAVM          GINKFOFFM      
DFHKBU          : IEBGWPCDRWTX    OFKIYDBTTCWEDA  DTWRDIVNKBMNYXO
GHBNPTYVTME     : JELFNQMIYHPNL   XSWIBXBJ       
VGCHUSKOQVN     : RGQSKLKMAAITJ   YPFWQROKSTG    
YTFLUAPDH       : JWUUJQIIOMSXNGL UUVSGSJBKCIV    KXDSMSMSS      
RYOQVJFCKE      : BEXRAFLG        TQYES           LUAVJ           OJFCEBEKDQBD    ENOPANPXT      
NLGIVV          : IGKXK          
RLWSFCECE       : QGCI            XNHHDJBXV       VFLQOYSVWU      VSMLSFRQWLGXG   WIWXAFT         FQLSTHOCUWS    
GNOXMEQKNWNAB   : FTRNKWQCGC      OQLFFYJ         JBADK           TBNSJBBKLYNWI  
NOFWKDXFP       : SVEFPJJYGV      XJCBCTRTPDCHXBP APNJYWGWR       FSOIGBVEHDRDUYM UVWELWQUUIGDYU  MCFKPKLUUFC    
AUYFAFBGSSGIWY  : DHFKNBE         TUEIH          
MVIMY           : LISKWQYLNINWLHP IOWAXIJIYPXFF   FCWBKUYO        ENOPANPXT      
DPPCBSAIKAIGB   : XQASXUJFWTGJXI  HYEWKDD         GKAUKJLXJAFMCR 
IHTOC           : RYEQLPPCBBRRFBD
WKLVEAUOMVWR    : UKABIVJWUYIC    QYWXBJDESR      UVTYTCCPDOJNC   SEVDHWE         NYUBHMVHUGTRU  
MTPH            : MOXRTBTDE       FWSJACJEDCC     WCPAMKWXFWETDXN
XSWIBXBJ        : NMFBFI          NTLJVCRGHYMNG   GHBNPTYVTME     MMGU            BNTLGXOHCE      DGGKDXVAFFVWTQ 
WAILYUYUBY      : XJCBCTRTPDCHXBP POPH            RYKOWFLEV       NSHHRFJN        KFMB           
QNONGBCASL      : BSDWEWHXS       XSMHQFNFUTLW    TIGPASSW        CGCG            WABMPGQN       
SEVDHWE         : RYEQLPPCBBRRFBD LIMOSNLPQQMO    ROQCKGGP        JLKFMGK         WKLVEAUOMVWR   
EDSOORKPP       : NPRHGTXNYTKQJW  YSLIQYSSNIT    
OHEDVTLYV       : IFKLPPYRBCXMMM  NNBPKLAJ        ROLEVKYGEXOQR   AUMQVFVKSGQF    ERYKQVG         NRIBNDDBBAJWHSY DMNGGXBKW      
RKNKOLQYKUPP    : XBCXEJFBFODHA   YTJJYBHBHSK     NJJSIWSJX      
LEPFQGUFWDJAYEN : SBLJYD          FGOSFQQYP       YEFJBQLXGAOXFEK
CCSMPGEDW       : YIRPD           JFVF            NNBPKLAJ        HPFWGESDUUVLIHY
OTUEUIKNOCTJJ   : BWIQBLD         DSUBBTRRGSQYWFJ
MUTOBHPEJKSBS   : DQAEM           MXUEBO          JUUTIT         
HREVOCCJ        : JFANPPNY        XWERWQI         FQMRYULOAR     
MWYQSLAM        : YXQDXJDF        SBLJYD          DJVJCFSCQBE     KQTL           
VGOYPGDCR       : FPUSLEI         FHAAI           BPDVBGGCQ       ULTUMQJ         OXQGOJ          VWGIBQDNXFEE   
FMAMF           : EAGEMHTBRCMX    WULNUENSPSPJBB  XOIBJAR         PPXQFGKV        XENMHNWICNDBPRW
IVHKFRA         : IQWKPHHHVLJNCRW GUNKIVB         UUQETBKRKHER   
TQXHT           : YQXJEOOKHHTGRF  IHDHNYMNMJ      MXVIBX          GDDOGMJN       
HRSWQJF         : AIVSYYFTJCDI    ANSJJEOUH       TJBPTEDGRIE    
NYVSMVGTDOPKCW  : QLJOVQTGGUSTJFY TKQVXJQRYD      LJFB            HODPHAJ        
CCBSDI          : QURBIKPYW       BVYJRHLH       
PPGJOXUWUIVSB   : IVNEDR          BKWHWUH        
QJEUBVH         : WPFE            MTNBJIUBCRSUJYO GVVUDMF        
TOFXP           : YITUDVXWYA      HKYA            XQKHLITV        TQWOLRURSA      NYUBHMVHUGTRU  
BAPRSVDHVXESID  : VMKUMHWIY       CKHSTH         
LNFVSAWQJC      : AESIECGYD       EYRER           XDJTNCH         EBSSBTTGEY      FYAYIJRDRSRUKUJ
YHLQJMRYGKXL    : HISSUX          BTFKSUINJVS    
TJBPTEDGRIE     : YHIXCVDY        BFYGLLOATI      HRSWQJF         TRXUDTUGCWJW    QRQFIDKPYA      JCRPSKWJBYB    
KDEUFQVOCMXRE   : EQSMXFDPOOMP    HFBITUQQUALYH   NPRHGTXNYTKQJW 
XQAKLVVOLQSPYM  : AWEXOFWFGETP    GLGYK          
FALI            : NFKXYYJOOXRDT   KDDAAHI         GLDBLAEFVMIUY   FSSRJHVASWO    
IPUEGAQG        : FCYHPU          NWPRFTMFOBEEGWM WGQBTPBWSN      NVBIIJYYQGWLMF  PYTNYPGLDBQVT   GRDBGM         
XIRO            : AKBWUBFU        SAQM            DKXCITU         KDDAAHI        
CAFB            : TNYPM           WIKHTD          VYQE            GTNCKXYIVPETDYC USPRVUPFPENFLOL
QTJIUWJAW       : RGXOBWYDPPRPGVQ VKNXCYMKE       MPWGWKSDB       NFEHXCTCEDH     XGQNDWY        
KDDAAHI         : XNHHDJBXV       AWOWTLGWO       FALI            XIRO            QUSK            QABF           
AOTXXMNGOPNR    : WREMNGGCTQSEN   JTGY            VHNMHSLRXLTNLI 
HLQPG           : NFXAXREY        RVHQ            LIRMJIFXOVJYOUX
YGMVSRBUUKD     : FEUQCMORVXGUVE  VIOCPIKQMGGEDUG RDONG           QHDDOJFQSLOTCW  TUEIH           KJQTEMB        
LSRJSEYBUPPNW   : JFVF            SJLJRRMPWTUOYRP DITSDNHS       
BNOIEQQSOKLQ    : QQQLCNIPGTUBTII GYBEUHOKHGRNF  
GBLFOGWBBBAC    : BMNWSWWTK       DRINUJ          OKQURUYWM       UULMWP          EXVDFHGJPTUNHH 
PTMOSPFIXJYRCN  : ARFOBHRGFK     
PGLXKWEYFBA     : QQVOE           POPH            NNBPKLAJ        GTAYNGFLCY      NSMBQWGJRTYUYWO HPFXFATJJERKH  
FDJES           : CWUXR           YAQFQF          VIOCPIKQMGGEDUG
SKWIPHJYIBDXHTF : PJWKUYEASVYU    IJKPQ           ROLEVKYGEXOQR   PKCJSUJUYFOGT   TCSX            TPTICFO         YMTXDMDXLAN    
RPSVQXAT        : YMPMTXLE        CIEGUQ          XKLCIC         
FWQLR           : MBUWDMTOKFKITU  VHNMHSLRXLTNLI  XDUFJM          QJTOK           QABF           
ECUO            : FPVNEKLRNCBTEH  EDDIMBTKJ       AVDTQVP        
CXSMBWLISS      : FWSJACJEDCC     EIVXODYXTIV     LISKWQYLNINWLHP THOEP           PFOWYPHQONKO   
MKWLBW          : ILMRUYV         NLEILI          PVOIP           FGQBJNRF       
UESRUEK         : CYILFWIOOXI     CPQH            DFLV            RRSMPPMMIO      FIDWBWNWYIXIIV 
KOOY            : HGFTOUHONJUD    TLPLIWQLFEMYQX  MURHRSXMBCJFGY 
TACGBBTKVMOJWNU : DCXUK           JFYPELXGXRTWTW 
KIVPBQMHD       : AKBWUBFU        XSLPBLKJOXUL   
TRXUDTUGCWJW    : HBBILV          GHXV            TJBPTEDGRIE     MATPBL         
GLARJNOMA       : SRCNHJHMSH     
KPABF           : RDPYVNFU        HMUYJOP         BUGHVFEPXYK     UVWELWQUUIGDYU 
GLDBLAEFVMIUY   : FYEBFLGHUFKERAT YLGNXHXJ        FALI           
EHQGYCVPO       : RXISCRTTPWD     CPMAAXKCSRTH    VGHUKBECUXKH    EXJOTSJQQ       CKUKFA          EOGNWNHLKQAYAW 
MAOOD           : YPUJWXV         IQNNIOTIDGQMH   VEVNUTDHUGX     MSNSAGACVAUAVL 
AMFFNTFTYBJ     : RIER            CASPDWRAW       SLBIUYFMRCGB   
VIOCPIKQMGGEDUG : RGJHX           YGMVSRBUUKD     FDJES           QVIXPXQQSEF    
LLNLX           : HISSUX          IOSCWQAFNMSN    JSWSBQUVGHX     FCRHKSTCTTFMV   LIRMJIFXOVJYOUX
QNOVKOATXXCP    : LTYOJ          
TANK            : WXTLKJMKBPJMUO  YITUDVXWYA      TQXJUSFD        RRSMPPMMIO      JKIWKEEYA       BFIMQMTUCXOAEQ 
USSAPBTBNHONC   : CREQOWCOY       ILQPATOLWCUA    BLCAGNXNFRLU    RGJHX           JISKCYSOR       WUSAQLGMYW      AHHHIAMRFRGNHR 
CRDOIDIIC       : NFKXYYJOOXRDT   XKJDOEAETX      UOUEJNNBU       XGQNDWY        
AHGAUSRRN       : QGYMOEDLQT      TCSX           
RDONG           : XNNPBYBXBORIUY  EBGUI           UPUEWWA         YGMVSRBUUKD    
UURACVTFKE      : YAPLLV          TGBGOPPSHVYG    INSLB          
SMPFNWNPRGHMV   : PCDCORBBYHHMFCB SJLJRRMPWTUOYRP
GYLUHPRCHRGE    : XBHQ            DMHM            PJKHUPWAULBNTX  BBWXNUMYVKI    
MORAKFPRUMGMGO  : YLGNXHXJ        CPYBVKRB        UTHKCWWYLAJIK  
ULRCMFWU        : YXJRPWLYNTS     ILQPATOLWCUA    GHXV           
OYCJGI          : GPESKTQUFB      GBFVUKOXCIAR    HHAWKUEUANQAROW HTGH            YTRSFPJAAQXNKR 
UAPUMWKERYMGHCD : KUXAHW          XBCXEJFBFODHA   LISKWQYLNINWLHP BIBR           
PUFECEYWUYCEHK  : MJULJUVKKUARW  
CMVWYUJ         : DVVOHC          YOGBHSTWEJ      HEDRGA          RPWTA          
OKQURUYWM       : PIGSNIU         YPFWQROKSTG     GBLFOGWBBBAC   
ERYKQVG         : HXEBNYKNGPBS    NYQBMYOJMYCCQY  OHEDVTLYV       LWRGFX         
AMYLQDXOCXJLE   : DIMKNXWCEQNRDP  ANSANSUTOJBFHTI MCBCFH         
VWTQS           : RULTCTQXSDYN    OKOI            VGTBPFSOJXBOOK  BDHVRDRCCGXRU   MREEN          
PFOWYPHQONKO    : CXSMBWLISS      DPEU            GKAUKJLXJAFMCR 
MATPBL          : WLDWXRJWASWF    GSIQOJWQC       TRXUDTUGCWJW    TYWSNLPGIV      NTHJAOHLJJO    
BUGHVFEPXYK     : KPABF           UDKXFAHUHFKU    NPNCV          
HBMGRUYGKK      : CVMCTUQDCTE     BYFWJXVVGMSSWHJ JKIWKEEYA       ENOPANPXT      
NYXIQ           : CBBSEF          LENUAWFFRXPIS   KOAXARETMHQXSC  JHSDCQODHF     
VLEQSLOARGXR    : TQON            LCOANAHVPRUNE  
NYUBHMVHUGTRU   : LJWCKQEGHAXD    XJSADL          IEBGWPCDRWTX    WKLVEAUOMVWR    TOFXP          
RFLSDX          : IQWKPHHHVLJNCRW EBGUI           DKXCITU         RYRPQ          
VSMLSFRQWLGXG   : QUPJGORAO       JRXKHYLPGOOT    BYFWJXVVGMSSWHJ RLWSFCECE      
FUFMRMIJJDE     : KQTL            PTLMWSXR        TQWOLRURSA     
PYTNYPGLDBQVT   : SVTXVQBCQOIIW   IPUEGAQG        WHDDWV          SHRPFDN         DSUBBTRRGSQYWFJ
JANPIVMNKGCTPN  : LUNJHLQR        AEVPNNTYM       BFIMQMTUCXOAEQ  AVDQ           
VGOVACUSKIVNAT  : TKQVXJQRYD      RKJC           
RDIIUQEJGO      : GDCVDMUNLKSFK   URQWKTNOEKKLJGV RFGAPFANQ       GWUOATUR        EYGLODQU        JKIWKEEYA      
JKIWKEEYA       : YEWFYHA         TANK            HBMGRUYGKK      RDIIUQEJGO      BJBCRPBYWL      POWL           
EWBQGAFI        : DNCWVUTXBUIGFI  OUCEXKICMSLVAD  YMHSEAQAPWRV   
MAAUIWNOHUGY    : LXAJVATBAIIC    PTWYKEXSK       TPTICFO        
QHDDOJFQSLOTCW  : GMQLFLG         AUPR            YGMVSRBUUKD     WLWPABRH       
JFQYFQVQPK      : ARFOBHRGFK      EROSGDCVBCLLUH  HNMWE           TBEQOKNOMXW     EXJOTSJQQ      
WFLWLFGQKWBPO   : MXDAYSFMFNF     PERE            RYRPQ           LEUJMBJYGPHATI 
BFPGCMRHDQOVN   : HAFRNEPURU     
LXNJFBIQ        : HWJVOPVFQUEW    FCWBKUYO        WXAQFFPTYQXOT  
QJTOK           : AKUPG           FWQLR           MQUDONUSHEN    
FGNKYVMLNTOFKKU : XKYQVJXJ        NVWSHFTBYE      GWOREDSD       
VUIHAJRS        : AEVPNNTYM       CYBVLYDORTGEMLL NPKPSPMFBARC    MMTOAIV         FPVNEKLRNCBTEH 
LCOANAHVPRUNE   : VLEQSLOARGXR   
CAWJK           : QQQLCNIPGTUBTII NPNCV           TKEGMLBTGQ     
GFIBNRBAMTUXVL  : ABTOPCOIL       LTYOJ          
LNHKGYHTDQ      : AIVSYYFTJCDI    TQXJUSFD        XASUGIIPL       CQCYQ           ASYGBNQFQSXRW  
FPHPAPVKQLCRLON : UWCYANDHCPKOE   SKAIC           WOLEKLHOEPR     OQLFFYJ         FYMSCQTD       
MMTOAIV         : VUIHAJRS        UULMWP         
QUSK            : MIPVRXS         RUHSXYFLU       WQIJSPNQGG      UPUEWWA         MSGDJNDGM       KDDAAHI         KGFKLRG        
LJFB            : DMULQFFGE       NYVSMVGTDOPKCW 
XDJTNCH         : NRJGQEQDQNNML   MGFQJLWM        LNFVSAWQJC      DDCXEBTYFHGQ   
UTHKCWWYLAJIK   : UVTYTCCPDOJNC   AQPMEURRQ       MORAKFPRUMGMGO 
FFKGQVNUPLA     : USHNB           HGFTOUHONJUD   
HODPHAJ         : VYQQFRDQQ       JNFVKGHBWASDQB  NYVSMVGTDOPKCW  LVMFHJXWDWA     NFEHXCTCEDH     OLVKLMWXVG     
LNNKMCKVKXVRF   : BSDWEWHXS       MFHGYAIUEWEOLHD HSVBICATDIVHV   AUMQVFVKSGQF    HGQJGXM        
XYFMTUATXIKCX   : OGFBE           FRIJTSB         IDFUIRF         MAEDDQ          KWULY           OXQGOJ          NFEHXCTCEDH    
CJLPWBDMD       : XMDJDDOHJ       XJEYAXAWGU     
IPPHIVQIUVW     : WXIONYV         HAFRNEPURU      FUCEXVBOA       RGJHX          
TXMRG           : VTKWI           SAXDVMDVL      
VGTBPFSOJXBOOK  : QTHTDRUHBTIT    VKLHBMQBGATPNK  APWHMRASOBDGLL  CWUXR           VWTQS           LEBLBOY        
GTNCKXYIVPETDYC : REERCA          PJNRLWY         CAFB           
WIWXAFT         : HXEBNYKNGPBS    EYIRFAPAUMLPTKE BPDVBGGCQ       RLWSFCECE       GKAUKJLXJAFMCR  CKHSTH         
QRQFIDKPYA      : AWHTPMCBRPIHHVR HHAWKUEUANQAROW TJBPTEDGRIE     MREEN          
LYTVWLBSOCUTYF  : GTKMV           REERCA          YJIUWACWABXK    HGQJGXM         JFPNSOBEN      
AHBTVTNOYWT     : QTCCKHI         BIVU            MKILMWGU        MGXRFIITGRT     MMEEJAXR       
OSOIEPEDMQEFH   : QNSBTNLM        GAQL            SDCECNEBQLRCTLI
CCHJX           : GBFVUKOXCIAR    EHAWOYYWYEGOO   JBSXNCROBMR     YWMGGEKAWQ     
QBFPUTG         : SMVPFS          SNAAML          OYGSOMNJTBL     QXUYIHICC       XKLCIC          XVEOUJBBF      
SDIJVXTDNYIBPMI : IMBHIXDIYYQIGYX WGQBTPBWSN      AWEXOFWFGETP    PEPIECR         JDSOCC          GSYYPPKJKD      IPDMAQ          SPMUXNNKXF     
WNDEWBQQC       : IJQAI          
GYROTKR         : DCXUK           QNEBMHTM        IVNEDR          LEUJMBJYGPHATI  PKQNCOJBOKPETI  GUFEBESSIXNONPU ACGXJEMOGDQKGAL
VQCQVQP         : NWPRFTMFOBEEGWM XJSADL          JFANPPNY        DGRRXARLLS      RANVRM          MSDIC           NWXRJXPTIF      ITSKKTURSOI    
THSEIPRMVP      : XASUGIIPL       DFLV            SPMUXNNKXF     
MIULQTDFNQA     : FNHOBPVL        FKFY            WSPS           
MQUDONUSHEN     : LCLDFKHMWYACP   IBYNUKYY        NVWSHFTBYE      QJTOK           YNSGE          
NDEAYVROEM      : GAQL            CXJFXOB         HPFXFATJJERKH  
WHDDWV          : BEXRAFLG        ERCYPTLK        PYTNYPGLDBQVT  
PJVNOKBMFLQSXGV : MKBINQMEENVXB   DHPLIEEJKEEDTQA GJAXYCVGXQR     OUYVVSPG        UUVSGSJBKCIV    CEQMJFUQTPE    
IWBBLHNNF       : HHAWKUEUANQAROW BHHDTK         
TKUPPMBLCSXEFD  : RANVRM         
XXPHVTPS        : CNKANKQXIOLUL  
SHHJWM          : OBJQUUQEXWJ     YOGBHSTWEJ     
QYDJOSKCUFABM   : QXUYIHICC       RUWONP          NFEHXCTCEDH    
SLBIUYFMRCGB    : SCNBGGXVPEKKGBD CPQH            AMFFNTFTYBJ     WBDSTXGTOKLAO  
RYXAPYGBNYMP    : QCWISHSWCDYHFK  TRFYTIDJPGSFAUE WEVVFNWPLGRGJ   PJNRLWY         VCHBML          LENUAWFFRXPIS   CCFQOOVHFAJRHV  IAPMLM         
RYXAPYGBNYMP    : LDYDPNBKOFFJ   
TPVHUOUXXP      : EMVDMXOR        BYUMSP          VJMB            YUTRNW         
FCRHKSTCTTFMV   : LLNLX          
NJKCCEWTAE      : VWFDHI          VAPXO          
RYRPQ           : YXJRPWLYNTS     RFLSDX          WFLWLFGQKWBPO   MJHWWQSPDCYBPPW
WSJEGEAKY       : XNNPBYBXBORIUY  QCRYJGIXYBW     MLFB            EBGUI           CPHUJVL         GHRVJDDW       
PNSDBENEGUDDWH  : CPESJEECDDBHECX JFANPPNY        BWIQBLD         FHABIOQBTWKY    PWSMLFCLLKC    
OIMGYED         : QGCI            YQXJEOOKHHTGRF  OFRVIMGI        HETHJIAHEETIP  
PKAWKLXJDLCHM   : BIVU            OATMCRCPOFREPJF JFEPQKF         AVDQ            BDHVRDRCCGXRU  
USPRVUPFPENFLOL : YLGNXHXJ        QGJSWBX         CAFB            HTJWOLFDLGLS   
LEBLBOY         : BJHGSMIRV       RVNE            DQNCIRHCPCBFFDV LSPMMA          RTPELJQPM       VGTBPFSOJXBOOK 
XDKD            : NOCHMOMX        FJONHJJCTSL     RIASIC          HMNYPB         
YMHSEAQAPWRV    : EWBQGAFI       
YJCLBN          : HFWNOTVBANB     WFPFLB          KJHGTIHBS      
EBSSBTTGEY      : DPCRAJQBWAOIIVR LNFVSAWQJC      IOWAXIJIYPXFF   POWL           
FLAARCRTT       : CDDMGBJPSYW     YMPMTXLE       
OSBNCFBFSSK     : XJSN            UUVSGSJBKCIV   
NFXHBGLAYTNBTIE : XTBSJ           USHNB           HJMFUIS        
CACQSEHVLKDHE   : BAUDBAKFXOUNG   RTMEYLBGYC      IJXQQJUQHESLQL  DVLQ           
ERVEAYKNCJHPKEX : LARGVETYNHRCLW  DWNMJYEO       
RDRUV           : IJKPQ           NPRHGTXNYTKQJW 
BFIMQMTUCXOAEQ  : KFLDXVQ         TANK            JANPIVMNKGCTPN  GKAUKJLXJAFMCR 
OFCXOTLSU       : DWNMJYEO        OVPNBKYUOIJCI  
LXTITHJCPX      : VAOEQLARTLTB    IONCJCDYEWSE    QTKVPQGCOB      VXQHFFSHX      
CSNHSEH         : KUXAHW          NPRSAQJCMRO     XAFENC          TXSAYQ         
VJMB            : WPJDCGRQFIMGQ   XDUFJM          TPVHUOUXXP     
NRIBNDDBBAJWHSY : DBHNAFVY        RTMEYLBGYC      OHEDVTLYV      
SRCNHJHMSH      : GLARJNOMA       GGLBRJOG       
DVLQ            : VNBC            CACQSEHVLKDHE   MCFKPKLUUFC    
FYMSCQTD        : QLXQEYAIPQSY    FPHPAPVKQLCRLON OWIQWOD         USKOAAIYMPUXAL 
DDCXEBTYFHGQ    : AESIECGYD       IUGIRLXYYUQA    XDJTNCH         KVHXOFCNACDJB  
UKXFNUSGI       : AFORVUC        
GVRIOOOHTT      : LCLDFKHMWYACP   ROSN            LISKWQYLNINWLHP UOUEJNNBU      
SXMMWSVELLBVLHL : JSWSBQUVGHX     HNWSSHVUK       KFMB           
ASRYBPTJEIXN    : EQMWELS         GYXWYSUXOU      WJDBSDBK        UMBAVM          YPFXFCFNNFEWIS  FITQA           LTYOJ          
TYWSNLPGIV      : MAEDDQ          DGRRXARLLS      UWUPWTWCLUSVPO  MATPBL          EXQPHM          XFJRFCF        
VXQHFFSHX       : UKABIVJWUYIC    LXTITHJCPX     
JBADK           : XYRBMOWECUN     TQUQ            XKFEENX         GNOXMEQKNWNAB   WSPS           
NLVPFUP         : OVRMPTTQRTRQRG  DXUA            CLGIADIYWTTRM  
IBQRLOMHMFRT    : RNXRP           DCQVKPKLXFA     UONUOLLL        TQCSDMHKODL    
KEKWNLYQWHEKD   : LBBTF           LARGVETYNHRCLW  VMKUMHWIY       EXJOTSJQQ      
RXLQIPJCBXOLNU  : GIEPNYYURIGQI   WCPAMKWXFWETDXN TQYES           XFJRFCF         IUMEIEQQBHE    
JFPNSOBEN       : WULNUENSPSPJBB  YPFWQROKSTG     AQPMEURRQ       LYTVWLBSOCUTYF  GUFEBESSIXNONPU
DUXNXUGXIY      : BJHGSMIRV       RUKSPWIJI       CYQUTYS         JRUBSCDTM       XOSJFPDVEWRXEI  UFQHVVN        
XKLCIC          : LCLDFKHMWYACP   HMUYJOP         XTFMTI          GWUOATUR        RPSVQXAT        QBFPUTG        
XWSIFIVXYXEMRIJ : GDDPQNRTL       FEUQCMORVXGUVE  MBUWDMTOKFKITU 
VJNEJXFRWPFY    : JHSDCQODHF      QVIXPXQQSEF    
IOYFHHMREKQERF  : FCYHPU          YPUJWXV         UORCMTUCWGP     MIPVRXS         WOLEKLHOEPR     URTH            DICBYIJJGQD     OVPNBKYUOIJCI  
IOYFHHMREKQERF  : TKCCH          
AQOXAEFLDKD     : MRFDPQCCBK      IMBHIXDIYYQIGYX WEVVFNWPLGRGJ   FRTJTYT         ETJJKXAJIHJR    JQCQVDKJPOXKAHR FFENQBLXHOKWPQR
BJBCRPBYWL      : FWAM            MRFDPQCCBK      SFEU            QGJSWBX         JKIWKEEYA      
QRYHVQOTSFJ     : JDFDRNR         RDLF            GRDBGM         
HNWSSHVUK       : VJUTWMEXCYW     DVVOHC          YEQYAY          YYEAEEBFT       RXTP            SXMMWSVELLBVLHL
VOBNQBMEPDVQMRI : AEVPNNTYM       VWJXUVTW        WYSNEICYO      
LDGW            : IHESKBFAJ       DJVJCFSCQBE     OTWPPLHDNVK     WBDSTXGTOKLAO   EQSNYVGFKFKOL  
NNTGGEFCOOAE    : WINPPT          JNTR            PNOBNWDAQO      VGMTTUBSQQGRNK  FJXIJIETCUPBL  
QWRDDJJY        : NVBIIJYYQGWLMF  JFEPQKF         ESCIIDUEOY      PJKE           
VSKAEOG         : UORCMTUCWGP     ANESUG          HOFEKQLHFN      MEDYM          
LWRGFX          : BEXRAFLG        AOKFMQNSMFHNESH AFORVUC         CASPDWRAW       ERYKQVG        
MCBCFH          : UWDGRLK         CUXQPAOHCV      EBANXGFPOR      AMYLQDXOCXJLE  
VGMYJVIIXHBJ    : UPQJ            EJTCSVSKHSKOCTY
IAPMLM          : RYXAPYGBNYMP    OOUSYMUKMC      IOWAXIJIYPXFF   XPMKCM         
TUEIH           : JELFNQMIYHPNL   XAFENC          HODYFWNTXXG     BPDVBGGCQ       AUYFAFBGSSGIWY  YGMVSRBUUKD    
KJQTEMB         : CYQUTYS         FKQEU           RFGAPFANQ       KLPABUEBP       FNWPYVIPFEIOKC  YGMVSRBUUKD    
NMOYXNGBYPJB    : NWNFVEDFXK      CIEGUQ          UDKXFAHUHFKU   
XOUELPLTYUGJ    : GACDTCPAAU      IBYNUKYY        HAFRNEPURU      SPJYELHJHRTTRI  VHNMHSLRXLTNLI  MTNBJIUBCRSUJYO
BNAEHNSXOQNUSOM : XMOKYGH         FYCLUGAJE       UBIRK           HSVBICATDIVHV   TKEGMLBTGQ      MEDYM          
PSDFNHQFS       : IRNEKIB         ARFOBHRGFK      OHBEHOAGDMUXJ  
EPTNDWEFDNTV    : BRAEFNFCQYLRTD  TPTICFO         RIASIC         
KNAGIOSMHNPOBA  : LARGVETYNHRCLW  QURBIKPYW       WPQNVVQ         YAAO           
IUTNNNDQMH      : MCWA            EKQUPBVKNW      YPFXFCFNNFEWIS 
PWSMLFCLLKC     : HQLQY           NOCHMOMX        JRUWIFF         PNSDBENEGUDDWH 
WLWPABRH        : QURBIKPYW       HHAWKUEUANQAROW HJMFUIS         DIMKNXWCEQNRDP  QHDDOJFQSLOTCW 
MCWA            : VNBC            PERE            IUTNNNDQMH      QPJPPVOMY      
BTFKSUINJVS     : CPTNYAIRHXSO    JSWSBQUVGHX     HBAURMAISVYDWNB YHLQJMRYGKXL   
HHVLQVANLAODIB  : XKJDOEAETX      QOUG            HMHAPWHICEFYV   URTY            GGLBRJOG       
MXUEBO          : CDDMGBJPSYW     AKPYVHTBYFPPNK  AFORVUC         MUTOBHPEJKSBS   RWBXEMKMA      
MJHWWQSPDCYBPPW : JNNGS           NKEMLASFRG      RYRPQ          
EKQUPBVKNW      : RFGAPFANQ       ERCYPTLK        IUTNNNDQMH      HPFXFATJJERKH  
RXVEKFN         : SVEFPJJYGV      BAUDBAKFXOUNG   TVBHFH         
CEETJI          : GYVANM          IJQAI           GJAXYCVGXQR     CWUXR          
NYJMQPAJ        : HCNKV           EKRL            NJJSIWSJX      
RKJC            : ATFQWOSOAHSXU   RPQQLIOQ        MNXQFOKIEKSKA   VGOVACUSKIVNAT 
GJSFFYRK        : AKBWUBFU        CCFQOOVHFAJRHV  JGEFGV         
EOSI            : BRMCNUHUAKQGYMV SCNBGGXVPEKKGBD BXFMOVOLMAIR    RAMRXHIEOBLXO   KJHGTIHBS       WXVMONSSDJ     
FRDUSOHJFJT     : SSNJTM         
CGCG            : HKYA            QNONGBCASL     
JQCQVDKJPOXKAHR : BAYRJWGORFMWNAM AQOXAEFLDKD     VOEEXCUSNBKSY   TKTYJFRTX       JUUTIT         
MMMCWXHGTA      : RTPELJQPM       YPFWQROKSTG     WABMPGQN        MMGU           
BERK            : QNSBTNLM        FGRWOWJTFFIUWCJ OVRMPTTQRTRQRG 
KMGGPRRHG       : QARVW           HJMFUIS         XSLPBLKJOXUL   
TGAM            : JIRVXYEEDMTDCI  FECJJMQXCQL     FNOEMIWXMWWC   
PBORX           : GSYYPPKJKD      RWBXEMKMA      
BHHDTK          : TNYPM           FIOVNEVNWRVH    TTELMT          CWDHJYNYR       IWBBLHNNF      
LUAVJ           : TJQJKQFAEJENIR  IJKPQ           RYOQVJFCKE     
FYAYIJRDRSRUKUJ : WEKUTUFRXGX     OVYPBHWHCSDLQGS FSOIGBVEHDRDUYM QLJOVQTGGUSTJFY LNFVSAWQJC      AANCNBLVJCVYXFC
VWFDHI          : PEPIECR         HAFRNEPURU      NJKCCEWTAE      GDDOGMJN       
RRLPRJYBQBBQ    : LRDATCVOR       BAUDBAKFXOUNG   ANSANSUTOJBFHTI
KIODDIANEJ      : MHXTDW          IQNNIOTIDGQMH   MKAARAPYUIJKMER IJXQQJUQHESLQL  SGSMSWY        
AJWFQHEKARATEAU : OEEBJIDMNHWSJ   LARGVETYNHRCLW  OLNNODMSTKFNSHJ RTCRHEJXHXSE   
DWNMJYEO        : XKFEENX         ERVEAYKNCJHPKEX OFCXOTLSU      
OOUSYMUKMC      : FFNGDFJVFCUN    YIANNIEVLJFH    XDUFJM          IAPMLM          GBPYCEWMQYPNIFL HGFTOUHONJUD   
THNVBQQFSLBVKQ  : MUSCBDACEMQVMK  QIWAWFDYKFSV    FXOETGXYXJ     
UPQJ            : JNMCNPTHBRGH    VODFKTNRD       VGMYJVIIXHBJ    VKMWBHUKNSG    
GBPYCEWMQYPNIFL : JPFJLVW         WWEBBO          ERJFRG          TTELMT          OOUSYMUKMC     
VCPOQQMDKXXAO   : NECIOVKVTAJIU   UAIELQFTJWT     VQBVJQFVIHJOQJT RWBXEMKMA      
UULMWP          : QARVW           FRTJTYT         HCUHEGKOPIANLXN GBLFOGWBBBAC    MMTOAIV         KVHXOFCNACDJB  
VCKUTAEB        : IKYUJDVLVD      VGYMURLJALMN    JNBSVDWDETIWNP 
OXQGOJ          : GFMQRGJUB       NKEMLASFRG      VGOYPGDCR       XYFMTUATXIKCX   KSKXVNPXKYGO    TPTICFO        
CNKANKQXIOLUL   : TQON            LCBDUKLMM       XXPHVTPS       
OJFCEBEKDQBD    : GDCVDMUNLKSFK   GFMQRGJUB       LDJBXSJTQWSK    IOFVHELJMUK     RYOQVJFCKE      DTWRDIVNKBMNYXO
IRTITHSV        : VTWKOTPXOX     
FPVNEKLRNCBTEH  : IWNJAXUMC       QHYPDEUSHLXSA   ECUO            VUIHAJRS        GGLBRJOG        AVDQ           
JSACVD          : UCNBBPCVHGCRLBS GKAUKJLXJAFMCR 
EXJOTSJQQ       : YXQD            VPOQSIXQGW      WEVVFNWPLGRGJ   WXIONYV         EHQGYCVPO       JFQYFQVQPK      KEKWNLYQWHEKD  
IPDMAQ          : VVPLBWKIADNBAL  WREKTNOYOSYHAS  ANSANSUTOJBFHTI SDIJVXTDNYIBPMI QMTLDBJYBFGMV   XUBYYYMMFWK    
NTHJAOHLJJO     : VGQGXTFAJNIFHCC VLIJCM          MATPBL         
NDMNOCHILXBDGQJ : LUNJHLQR        MFHGYAIUEWEOLHD HBDLFVNFRFXN    MSGTOY         
QABF            : QSTFG           AOKFMQNSMFHNESH PVOIP           KDDAAHI         FWQLR          
IOWAXIJIYPXFF   : DBHNAFVY        IUGIRLXYYUQA    RGQSKLKMAAITJ   MVIMY           EBSSBTTGEY      IAPMLM         
TJSCWTEB        : TXSAYQ          WFPFLB         
WKXOKYVHKMGKLOT : JLKFMGK         HMHAPWHICEFYV  
QMRVTF          : FRIJTSB         GFDTVTJWDEQ     AFORVUC         XOSJFPDVEWRXEI 
DXUA            : RAMRXHIEOBLXO   NLVPFUP        
BBWXNUMYVKI     : TTELMT          STHG            GYLUHPRCHRGE   
XOSJFPDVEWRXEI  : INKIHNWVBFLY    JIFBGQRXLKAC    GHXV            DUXNXUGXIY      QMRVTF          EHSF           
CFDWGHTEUQ      : HJXRM           OKVUDFDWNNOHMDN RFGAPFANQ       EBANXGFPOR     
VOEEXCUSNBKSY   : BYUMSP          JNHWPCUMCJ      JQCQVDKJPOXKAHR HTFKRRLUH      
PRQVCTYHAX      : VGQGXTFAJNIFHCC SQKYMMBYTCOIKF  UQWLHQW         JCRPSKWJBYB    
HRVCKRYYWFYBBSP : RANVRM         
FIDWBWNWYIXIIV  : EWMGIWDTUMQ     DVVOHC          MAEDDQ          UESRUEK        
RPWTA           : CMVWYUJ         XJEYAXAWGU      NSHHRFJN        ACGXJEMOGDQKGAL
UCNBBPCVHGCRLBS : NWNFVEDFXK      WJXUTATHQ       EWVBOURAHBWAX   JSACVD         
OSIYQTJPTBFSX   : PUWFYASIT       BQNXKWTHD       BAUDBAKFXOUNG   PCUTHLKPIVBUKP  HSVBICATDIVHV   UMBAVM          TKTYJFRTX       QYPUCGMYX      
KSKXVNPXKYGO    : UMCAD           JNBSVDWDETIWNP  OXQGOJ         
SPMEGFOIYIR     : PIGSNIU         QTKVPQGCOB      RUEEYFXWCSLVGOG EJTCSVSKHSKOCTY
FVVAVEKQQJNFBNR : EDHXLQXBENUBYLI GUNKIVB         HBAURMAISVYDWNB GWHEX           FXOETGXYXJ      GVVUDMF         FQMRYULOAR     
UISPAFTIN       : STYQCNBQKFBUOC  WHTUKM          ITBUUIJF        PXVV            EWVBOURAHBWAX  
QMTLDBJYBFGMV   : ARFOBHRGFK      LRSCP           IPDMAQ         
XJEYAXAWGU      : FFNGDFJVFCUN    CJLPWBDMD       RPWTA           GWOREDSD       
IDIRQ           : IUJVPMW        
IFOV            : WJWJPMXRQ       SCNBGGXVPEKKGBD
PFLT            : QTHTDRUHBTIT    PQHVERPJ        BAUDBAKFXOUNG   WXSA           
RGJREUVFU       : VLIJCM          HJMFUIS         LUVHFBJPAE     
GRDBGM          : BPDVBGGCQ       IPUEGAQG        QRYHVQOTSFJ    
QGYMOEDLQT      : WNJKPOCHJI      QCRYJGIXYBW     TQCSDMHKODL     NCSAFBLWNYN     AHGAUSRRN       ESCIIDUEOY     
DPEU            : QTCCKHI         JTWFJIENP       RIYKILHA        JFEPQKF         PFOWYPHQONKO   
PMCKLHGIPANTHCA : VSNJB           SVTXVQBCQOIIW  
IAMAG           : IXOX            MNXQFOKIEKSKA  
LXMEDCK         : IFKLPPYRBCXMMM  FNEISNDFB       OKOI            NAVMPKGLLI      BFYGLLOATI      JRMNQRUAQICKNQ  HUTRQQUOXBIY   
AANCNBLVJCVYXFC : JDUB            QFFF            FYAYIJRDRSRUKUJ TPTICFO        
GKAUKJLXJAFMCR  : MPJBNCSFWT      FKQEU           YAQFQF          DPPCBSAIKAIGB   PFOWYPHQONKO    WIWXAFT         BFIMQMTUCXOAEQ  JSACVD         
GKAUKJLXJAFMCR  : TVCU            NASCVQ         
ESCIIDUEOY      : RULTCTQXSDYN    QWRDDJJY        QGYMOEDLQT     
OWIQWOD         : QSLKQAHIPDY     OUCEXKICMSLVAD  FYMSCQTD       
JOJXOSXTFDORHJU : YEQYAY          MBBCA           HJAPAXVWDDS     FQLSTHOCUWS    
RANVRM          : RNYE            UWUPWTWCLUSVPO  VQCQVQP         TKUPPMBLCSXEFD  HRVCKRYYWFYBBSP FRJK           
GLGYK           : FWAM            DJVJCFSCQBE     RGJHX           XQAKLVVOLQSPYM 
CKHSTH          : KTAHARXVACXWFD  OKVUDFDWNNOHMDN UVFXTKNKIC      BAPRSVDHVXESID  WIWXAFT        
MFER            : VEVNUTDHUGX    
UMSEJLVJ        : IQNNIOTIDGQMH   UPPLIXD        
TBNSJBBKLYNWI   : YXQDXJDF        VSNJB           ROABTDG         GNOXMEQKNWNAB   TCSX           
QPSGUAX         : AFYK            FFENQBLXHOKWPQR
UMBAVM          : UAIELQFTJWT     VGYMURLJALMN    WBDXLEQHNHL     FHABIOQBTWKY    ASRYBPTJEIXN    OSIYQTJPTBFSX  
INSLB           : GTRYTHKWLQQ     RTHL            UURACVTFKE     
VCMG            : IMBHIXDIYYQIGYX TLOCR           KRUGJIEMXVKHOC 
NVOV            : XOIBJAR         FSSRJHVASWO     SBRLE          
ILAOHAO         : DEHJQCGCQ       EGUEJAALQCNNGLT DRHIHWYUIWVFWH 
XCQXAFVISO      : FNWPYVIPFEIOKC  RGQSKLKMAAITJ   FQLSTHOCUWS    
TCSX            : LIMOSNLPQQMO    SKWIPHJYIBDXHTF AHGAUSRRN       TBNSJBBKLYNWI   BQAKGWHTEPXA   
YPFXFCFNNFEWIS  : TTNREWWWBKVIHS  ASRYBPTJEIXN    IUTNNNDQMH     
GWHEX           : FYJHQHWRUMINEH  FNLRGCWTH       QVJB            GYXWYSUXOU      ASYGBNQFQSXRW   FVVAVEKQQJNFBNR
CGFTBBXVBPVRV   : LBBTF           AOKFMQNSMFHNESH MTFSBPS         WHPTUONSWPFRGW  VGYMURLJALMN    EOGNWNHLKQAYAW 
WABMPGQN        : QNONGBCASL      MMMCWXHGTA      TUDITQUN        VTWKOTPXOX     
LEUJMBJYGPHATI  : CVMCTUQDCTE     FQNKYLNGQBV     WFLWLFGQKWBPO   GYROTKR         SBRLE           YAYRGUIFUPIWF  
PKQNCOJBOKPETI  : CCFQOOVHFAJRHV  GYROTKR        
IVBGFNJOMPHVR   : CYBVLYDORTGEMLL QLJOVQTGGUSTJFY RTKPBDXTX      
FSSRJHVASWO     : MPJBNCSFWT      FALI            NVOV           
OUAWRKSS        : MLBWEYNMJQX     COGLLWLE       
BIBR            : BRMCNUHUAKQGYMV DJXURTATQH      UAPUMWKERYMGHCD RDNFB          
SBRLE           : NVOV            LEUJMBJYGPHATI  KABBTMHTC      
EXQPHM          : GPESKTQUFB      WXVIYSO         XASUGIIPL       TYWSNLPGIV      EWKOQXKEGOMGQII
CLGIADIYWTTRM   : CUXQPAOHCV      NPRHGTXNYTKQJW  WHPTUONSWPFRGW  LMYX            WFPFLB          NLVPFUP        
ANPXHQR         : BITLXYHHGVRSQ   KFLDXVQ         EOGNWNHLKQAYAW 
VQBVJQFVIHJOQJT : VCPOQQMDKXXAO  
KRUGJIEMXVKHOC  : QSTFG           VWJXUVTW        JQJXHSMKGJNYJTG LCBDUKLMM       AEUKURKHUJG     PXVV            VCMG           
MSDIC           : DQNCIRHCPCBFFDV RHVTHUQFA       VQCQVQP        
PAEXJUOURRHL    : FEUQCMORVXGUVE  XQASXUJFWTGJXI 
NWXRJXPTIF      : GTKMV           PJLC            VQCQVQP        
MTQSFU          : TYIYVS         
UUVSGSJBKCIV    : JTSHFHGQYL      YTFLUAPDH       PJVNOKBMFLQSXGV OSBNCFBFSSK     YAYRGUIFUPIWF  
YTRSFPJAAQXNKR  : OEEBJIDMNHWSJ   HHNULHWBWFSDW   DIWQCTGJATS     OYCJGI          YUTRNW         
POWL            : BSDWEWHXS       CPHUJVL         GGHFEYRNM       OQLFFYJ         JKIWKEEYA       EBSSBTTGEY     
SGSMSWY         : UECDNLYTD       ABTOPCOIL       KIODDIANEJ      KEAB           
FXOETGXYXJ      : PKPFGDEGNXPOSF  HYEWKDD         ABTOPCOIL       THNVBQQFSLBVKQ  FVVAVEKQQJNFBNR
YAAO            : NMKI            DMHM            YEWFYHA         YNFPTJFW        QGJSWBX         KNAGIOSMHNPOBA  VAPXO          
TUDITQUN        : NBAII           VXXKEWNH        WABMPGQN        WXAQFFPTYQXOT  
OCRLDMSBDAUJ    : EBANXGFPOR      WREKTNOYOSYHAS 
UKJVLLXAX       : FLUDRG          JCRPSKWJBYB    
WBDSTXGTOKLAO   : XBHQ            HNIPRWQFWH      NVBGMHBAU       SLBIUYFMRCGB    LDGW            SAXDVMDVL       RJBTOEC        
VPEVNQVI        : SCNBGGXVPEKKGBD RFGAPFANQ       TIGPASSW        YTJJYBHBHSK     RUEEYFXWCSLVGOG LTBJICEDTAXCQAS
FGOSFQQYP       : GDCVDMUNLKSFK   FYCLUGAJE       RUHSXYFLU       TYIYVS          JWUUJQIIOMSXNGL NSMBQWGJRTYUYWO LEPFQGUFWDJAYEN
CIODRKR         : TQCSDMHKODL     TKCCH          
WUSAQLGMYW      : CUXQPAOHCV      LSPMMA          FUCEXVBOA       USSAPBTBNHONC  
JCRPSKWJBYB     : VGQGXTFAJNIFHCC KBNEARUOJNQMOK  UNPKYP          NNBPKLAJ        TJBPTEDGRIE     PRQVCTYHAX      UKJVLLXAX      
DMNGGXBKW       : PUXIDJA         SJLJRRMPWTUOYRP OHEDVTLYV      
GWOREDSD        : YAPLLV          FGNKYVMLNTOFKKU XJEYAXAWGU     
CGHT            : WPJDCGRQFIMGQ   EWVBOURAHBWAX  
RTLUS           : EWMGIWDTUMQ     REERCA          BWFUXR         
TVBHFH          : RXVEKFN        
GUFEBESSIXNONPU : MPJBNCSFWT      YYEAEEBFT       PKCJSUJUYFOGT   GYROTKR         JFPNSOBEN      
LVMFHJXWDWA     : CDDMGBJPSYW     JSWSBQUVGHX     FUCEXVBOA       HODPHAJ        
CKUKFA          : JISKCYSOR       EHQGYCVPO      
GGLBRJOG        : WHPTUONSWPFRGW  SRCNHJHMSH      HHVLQVANLAODIB  FPVNEKLRNCBTEH  WSPS           
GDRRYGXHPX      : QCWISHSWCDYHFK  SVEFPJJYGV      FJONHJJCTSL     JYXO           
VWGIBQDNXFEE    : YXXUQ           DHMFWTHKKH      VGOYPGDCR      
PHEBVMACPT      : BXFMOVOLMAIR    POJUXOOLCPYPVPS NYQBMYOJMYCCQY  MFQUKKNQKVLRY   MTNBJIUBCRSUJYO
OCUXU           : WNJKPOCHJI      KBNEARUOJNQMOK  QIWAWFDYKFSV    BPMXEAXYVROSVH 
EQSNYVGFKFKOL   : ILMRUYV         LVITVBDMPLVC    VXXKEWNH        NYGGFFAPB       LDGW            TGPDMDTTGLGON  
HTFKRRLUH       : IQDVX           NMKI            VOEEXCUSNBKSY   TUDCCNJNEVMNRSY EHSF           
RYKOWFLEV       : NWNFVEDFXK      TQCSDMHKODL     EWVBOURAHBWAX   WAILYUYUBY      MPWGWKSDB       LDYDPNBKOFFJ   
TUDCCNJNEVMNRSY : GPESKTQUFB      HTFKRRLUH       UVWELWQUUIGDYU  GIHF           
MMGU            : UORCMTUCWGP     RUWONP          XSWIBXBJ        MMMCWXHGTA     
XVEOUJBBF       : NFGBGH          LXWDHNJITGVPGTV QBFPUTG        
UDKXFAHUHFKU    : RTMEYLBGYC      BUGHVFEPXYK     NMOYXNGBYPJB    UVWELWQUUIGDYU  AVDQ           
DVJPIRMF        : ERJFRG          TTELMT          NYGGFFAPB       VGHUKBECUXKH    YNSGE          
KJHGTIHBS       : ARKWJNGVDHSBFDH WPQNVVQ         MXVN            YJCLBN          EOSI           
GDDOGMJN        : QDMBASEJKRUPXE  BRAEFNFCQYLRTD  TQXHT           VWFDHI         
TKTYJFRTX       : GQHJYJFAPXT     YAQFQF          JQCQVDKJPOXKAHR OSIYQTJPTBFSX  
YQRL            : WINPPT          FFNGDFJVFCUN    TQYES          
AHHHIAMRFRGNHR  : WNJKPOCHJI      EKRL            RWCPVJM         USSAPBTBNHONC  
COQVP           : CDDMGBJPSYW     WNKUDCNJPBTG    VGYMURLJALMN    ENOPANPXT      
EJTCSVSKHSKOCTY : OMFCJANWXUMQMH  VGMYJVIIXHBJ    SPMEGFOIYIR    
HQKBYA          : OGFBE           KWHDUSWK       
TEKKUJAUNMQRFM  : UNPKYP          XNDPHNLXGYKK    QFFF            HFWNOTVBANB     YTJJYBHBHSK    
RVFEKIXKMHDWJFA : DCXUK          
YEFJBQLXGAOXFEK : AIVSYYFTJCDI    LEPFQGUFWDJAYEN FWDXJBC         LUVHFBJPAE     
APDLXEXL        : DJXURTATQH      YIANNIEVLJFH   
DKWIKR          : SOTRUVWI        ARJYNNTPP       DKXCITU         PQILWPWNHJO     SJLJRRMPWTUOYRP
QYURRJPXJHXRLIQ : STYQCNBQKFBUOC  TQWOLRURSA     
XUBYYYMMFWK     : INNQW           QYWXBJDESR      SVUKJHXEJ       IPDMAQ          MPWGWKSDB      
KEAB            : YJIUWACWABXK    SGSMSWY        
UVWELWQUUIGDYU  : ANSANSUTOJBFHTI NOFWKDXFP       KPABF           TUDCCNJNEVMNRSY UDKXFAHUHFKU    AVDQ           
TVCU            : KBNEARUOJNQMOK  FGRWOWJTFFIUWCJ TQCSDMHKODL     GKAUKJLXJAFMCR 
OIDOUSYYSC      : NOLDVBCLHXPMG   VODFKTNRD       CJPY            AFYK           
QXDUMCLHWTQAV   : SDGFAHYDJJNNLCN RUMPXIA         CHXE           
FRJK            : YPBRFKDGSAEX    GGHFEYRNM       AEUKURKHUJG     RANVRM          YMTXDMDXLAN    
JYXO            : FIVCURCCR       GDRRYGXHPX     
SIQTDTATTFRGHFQ : CYBVLYDORTGEMLL DHPLIEEJKEEDTQA
CHIXWNPGXFSADHP : SCNBGGXVPEKKGBD IKYUJDVLVD      AUPR            JIOJCOGGYCCCME  JFYPELXGXRTWTW 
RHRVDRRWYJG     : HHAWKUEUANQAROW LOHUNFSW        CASPDWRAW       LIRMJIFXOVJYOUX
RWOTGWRDLJ      : IJKPQ           WAMYA          
LPGLUOERGLLEOGW : PJWKUYEASVYU    AWHTPMCBRPIHHVR FNLRGCWTH       SDGFAHYDJJNNLCN
FITQA           : BPGSVJKMMM      IUJVPMW         OKVUDFDWNNOHMDN ASRYBPTJEIXN    QVIXPXQQSEF    
FTYFNESASERY    : UAUIMHFDYJPVEU  UWDGRLK         YSLIQYSSNIT    
MPWGWKSDB       : UAIELQFTJWT     NRJGQEQDQNNML   PQILWPWNHJO     CHSK            QTJIUWJAW       RYKOWFLEV       XUBYYYMMFWK    
COGLLWLE        : OACL            RTMEYLBGYC      DIMKNXWCEQNRDP  UANHNCLGEQ      OUAWRKSS       
IGKXK           : EFEWWVFJA       NLGIVV          LIRMJIFXOVJYOUX
XFJRFCF         : WKXPDRWLUCNIE   EROSGDCVBCLLUH  EAPGBGGJNWXFN   TYWSNLPGIV      RXLQIPJCBXOLNU 
BNTLGXOHCE      : ATFQWOSOAHSXU   PXBIOVKBXU      OYGSOMNJTBL     XSWIBXBJ       
NPNCV           : BUGHVFEPXYK     CAWJK          
MCFKPKLUUFC     : VWPA            GAQL            OGWMFFTFSKR     QTKVPQGCOB      NOFWKDXFP       DVLQ            LUVHFBJPAE     
KABBTMHTC       : RTPELJQPM       KIQWFU          SBRLE          
WIIMAXQVVDBBQSO : KCMJGJUPAK      AQPMEURRQ      
NJJSIWSJX       : RKNKOLQYKUPP    NYJMQPAJ        XWERWQI        
YHJDBILLUNK     : ACGXJEMOGDQKGAL HTJWOLFDLGLS   
LIRMJIFXOVJYOUX : EBANXGFPOR      HLQPG           LLNLX           RHRVDRRWYJG     IGKXK          
EXVDFHGJPTUNHH  : XBHQ            GBLFOGWBBBAC   
TPTICFO         : EQMWELS         SKWIPHJYIBDXHTF MAAUIWNOHUGY    EPTNDWEFDNTV    OXQGOJ          AANCNBLVJCVYXFC
VKMWBHUKNSG     : OFRVIMGI        UPQJ           
BQAKGWHTEPXA    : UAUIMHFDYJPVEU  JCGSSDFC        HYSP            TCSX           
SJHAAK          : QTRFGYXXCDIWQOX PDVC            WQIJSPNQGG      AWOWTLGWO      
MYTNGQXTKGNNWQ  : MOXRTBTDE       RIUDC          
GNHCTYBW        : ANESUG          JBYJTNQMSGSP    SOEPHEBSH       EYIRFAPAUMLPTKE
VGOVGBTSAPI     : LARGVETYNHRCLW  ANESUG          OHKDCCHSMNN     XQASXUJFWTGJXI 
HGFTOUHONJUD    : WJWJPMXRQ       EAEUFUKU        RTPELJQPM       HGQJGXM         KOOY            FFKGQVNUPLA     OOUSYMUKMC     
WXSA            : SUUGPQJMGACDX   FRPV            CQCYQ           PFLT           
AVDQ            : JANPIVMNKGCTPN  PKAWKLXJDLCHM   FPVNEKLRNCBTEH  UDKXFAHUHFKU    UVWELWQUUIGDYU 
LUOE            : TJQJKQFAEJENIR  PWRLMN         
EOGNWNHLKQAYAW  : MKCARTEJRRGUHMN DNNFFXHB        EHQGYCVPO       CGFTBBXVBPVRV   ANPXHQR        
TWEOWBQVEHPPC   : XSMHQFNFUTLW    RXTP            NYGGFFAPB       CTTELBLX        ITSKKTURSOI    
VANKIBJVLV      : MHXTDW          EOBYEHJPKFPF    LXAJVATBAIIC    DNAMTFECHN      MJULJUVKKUARW  
CXJFXOB         : OBJQUUQEXWJ     RNXRP           WHPTUONSWPFRGW  NDEAYVROEM      HPFXFATJJERKH  
SPTUGPBPIRSOP   : VYQQFRDQQ       FNHOBPVL        MVRR           
EDDIMBTKJ       : UDTDAEFHMBKH    VODFKTNRD       DNNFFXHB        LGXBMKORMRKSLAP MJULJUVKKUARW   ECUO            USKOAAIYMPUXAL 
LTBJICEDTAXCQAS : VAOEQLARTLTB    SUUGPQJMGACDX   OGWMFFTFSKR     XNHHDJBXV       VPEVNQVI       
TLPLIWQLFEMYQX  : XNDPHNLXGYKK    JRXKHYLPGOOT    JKIAUHRM        KOOY           
CTYLE           : HJXRM           KWULY          
RIASIC          : CDDMGBJPSYW     XDKD            EPTNDWEFDNTV    KGFKLRG        
IUMEIEQQBHE     : QTHTDRUHBTIT    DMHM            YLGNXHXJ        IUGIRLXYYUQA    RXLQIPJCBXOLNU 
NSHHRFJN        : XNHHDJBXV       WAILYUYUBY      RPWTA          
XSLPBLKJOXUL    : KIVPBQMHD       KMGGPRRHG       QPJPPVOMY       UOUEJNNBU      
YUTRNW          : UCHTP           BDCBTRKLFII     GAVBE           BKWHWUH         TPVHUOUXXP      YTRSFPJAAQXNKR 
SGRLNYFUJT      : FLUDRG          LSPMMA         
HMNYPB          : OBJQUUQEXWJ     ARIECIDSHEQJLY  XDKD           
BPMXEAXYVROSVH  : SAQM            OCUXU          
OVPNBKYUOIJCI   : GYVANM          OFCXOTLSU       IOYFHHMREKQERF 
FWDXJBC         : ULDUOUBDMKEBO   WODBOMUCFY      UUNHQSBCIX      RGJHX           YEFJBQLXGAOXFEK
BDHVRDRCCGXRU   : IOKVACXQSXDPR   SBLJYD          YMPMTXLE        VWTQS           PKAWKLXJDLCHM  
DTWRDIVNKBMNYXO : LOYQVFC         HQLQY           ERWJJEI         JKIAUHRM        QASGBKV         VYQE            VMKUMHWIY       DFHKBU         
DTWRDIVNKBMNYXO : OJFCEBEKDQBD   
MSGTOY          : VSNJB           THOEP           NDMNOCHILXBDGQJ MREEN          
GBCNBTKCY       : XQKHLITV       
YSLIQYSSNIT     : ROABTDG         EDSOORKPP       FTYFNESASERY    RDNFB          
YAYRGUIFUPIWF   : LEUJMBJYGPHATI  UUVSGSJBKCIV   
SPMUXNNKXF      : GVHOOTXIQ       XKFEENX         SDIJVXTDNYIBPMI THSEIPRMVP     
SAXDVMDVL       : HXEBNYKNGPBS    RFGAPFANQ       TXMRG           WBDSTXGTOKLAO  
DGGKDXVAFFVWTQ  : HNMWE           IOFVHELJMUK     KJGH            USKPBUEDGGGA    XSWIBXBJ       
KGFKLRG         : JWTCYRODN       TOWCL           EAGEMHTBRCMX    GFDTVTJWDEQ     SVTXVQBCQOIIW   QUSK            RIASIC         
PJKE            : RYEQLPPCBBRRFBD JWITAYX         BLCAGNXNFRLU    PTLMWSXR        QWRDDJJY       
IPMLXUYCSUE     : SBLJYD          PNOBNWDAQO     
CCWY            : WGQBTPBWSN      MXVIBX         
RLCXVPPCEHO     : DPCRAJQBWAOIIVR FBTRKLMMGQ      KTXJGYIEVJUKFEA
LDYDPNBKOFFJ    : FKFY            XROLKBOEYXNSRON RYXAPYGBNYMP    RYKOWFLEV      
FNOEMIWXMWWC    : PXVV            TGAM           
BGXP            : VVCYCLWADDM    
LTYOJ           : VWPA            QNOVKOATXXCP    GFIBNRBAMTUXVL  ASRYBPTJEIXN   
RWBXEMKMA       : VLIJCM          UKGGMSBI        VCWTXJL         ROQCKGGP        YLGNXHXJ        SBYSBTK         MXUEBO          PBORX          
RWBXEMKMA       : VCPOQQMDKXXAO  
QPJPPVOMY       : PLVWQMLSV       KFLDXVQ         MCWA            XSLPBLKJOXUL   
OHBEHOAGDMUXJ   : PJWKUYEASVYU    FPUSLEI         JLKFMGK         PSDFNHQFS      
XPMKCM          : JYTGGRBKUVRLUHG TNWB            TOIP            YGLNEUORAXWD    IAPMLM         
VEVNUTDHUGX     : JBSXNCROBMR     MAOOD           MFER           
KFMB            : WAILYUYUBY      SXMMWSVELLBVLHL
SHRPFDN         : FRPV            KQTL            OWLIJMOIAS      MVSQ            PYTNYPGLDBQVT  
VAPXO           : HETHJIAHEETIP   NJKCCEWTAE      YAAO           
VTWKOTPXOX      : IOSCWQAFNMSN    QXUYIHICC       IRTITHSV        WABMPGQN       
TKEGMLBTGQ      : HFBITUQQUALYH   SQKYMMBYTCOIKF  AOCIPAJRDROVIM  MVRR            HYEWKDD         CAWJK           BNAEHNSXOQNUSOM
JGEFGV          : MAEDDQ          WIKHTD          RWCPVJM         GJSFFYRK       
XWERWQI         : BKWHWUH         HREVOCCJ        NJJSIWSJX      
GIHF            : LLGGH           WHPTUONSWPFRGW  IHDHNYMNMJ      TUDCCNJNEVMNRSY
EPNMECOXIHYT    : JDSOCC          WFPFLB         
FCWBKUYO        : QSLKQAHIPDY     UANHNCLGEQ      GWUOATUR        MVIMY           LXNJFBIQ       
XIYQOKXVRE      : TNFFDNCHVWKBDR  YAIJIWCVPPEW    YQXJEOOKHHTGRF  FEUQCMORVXGUVE  SPOYACH        
ITSKKTURSOI     : FBTRKLMMGQ      RTKPBDXTX       VQCQVQP         TWEOWBQVEHPPC  
QICB            : EFEWWVFJA       WSWCDKRULMW     QKRRNO          JLKFMGK        
DSUBBTRRGSQYWFJ : ANYEO           OTUEUIKNOCTJJ   PYTNYPGLDBQVT  
AVDTQVP         : ARKWJNGVDHSBFDH JFANPPNY        ROLEVKYGEXOQR   OMFGTKADVN      ECUO           
GQYOSCUWWPAXL   : FJILAAMOPNHLTM  CYQUTYS         CYILFWIOOXI    
SSNJTM          : HNIPRWQFWH      FRDUSOHJFJT    
FGQBJNRF        : DSGUQSFGYNKR    MLBWEYNMJQX     MKWLBW         
YMTXDMDXLAN     : VLIJCM          WGQBTPBWSN      SKWIPHJYIBDXHTF FRJK           
BCHT            : PQHVERPJ        ILMRUYV         XBCXEJFBFODHA  
UFQHVVN         : QURBIKPYW       MHNW            BLCAGNXNFRLU    DUXNXUGXIY     
WXAQFFPTYQXOT   : LOYQVFC         VKLHBMQBGATPNK  APWHMRASOBDGLL  LXNJFBIQ        TUDITQUN       
ATMOWOVQLQ      : VSBNSASWGSHH    CQCYQ          
CYTAOJYM        : LXWDHNJITGVPGTV
PSRHMQXMHTJKQVY : AQJOOGILQCJPJ   XDUFJM          KOAXARETMHQXSC 
KVHXOFCNACDJB   : YYEAEEBFT       AXUHTR          DDCXEBTYFHGQ    UULMWP         
USKOAAIYMPUXAL  : NOCHMOMX        OKVUDFDWNNOHMDN FYMSCQTD        EDDIMBTKJ      
ACGXJEMOGDQKGAL : EAEUFUKU        XMDJDDOHJ       GYROTKR         RPWTA           YHJDBILLUNK    
XENMHNWICNDBPRW : XAFENC          GVXIVKKAMGRG    JQJXHSMKGJNYJTG UVTYTCCPDOJNC   DQWKYTSH        FMAMF          
TGPDMDTTGLGON   : XAFENC          EQSNYVGFKFKOL  
QNYEDIT         : KBNEARUOJNQMOK  VLIJCM          WREKTNOYOSYHAS 
QYPUCGMYX       : IFKLPPYRBCXMMM  RUMPXIA         NYQBMYOJMYCCQY  BGJNVN          OSIYQTJPTBFSX  
FQLSTHOCUWS     : GPESKTQUFB      RLWSFCECE       JOJXOSXTFDORHJU XCQXAFVISO     
RJBTOEC         : LOYQVFC         OATMCRCPOFREPJF AXUHTR          WBDSTXGTOKLAO  
HTJWOLFDLGLS    : DEHJQCGCQ       HYSP            HBAURMAISVYDWNB USPRVUPFPENFLOL YHJDBILLUNK    
YNSGE           : UDTDAEFHMBKH    LQDEPR          FRPV            MQUDONUSHEN     DVJPIRMF       
ECPRV           : HODYFWNTXXG     RUHSXYFLU      
SPPXSBH         : JWUUJQIIOMSXNGL IKNGRJMLCFDN   
MEDYM           : VSKAEOG         BNAEHNSXOQNUSOM
MURHRSXMBCJFGY  : RXYOBGOHICIUQOL KOAXARETMHQXSC  KOOY            GYBEUHOKHGRNF  
DAQS            : DIWQCTGJATS     LGXBMKORMRKSLAP
QNVXAIEFHSL     : QARVW          
NFEHXCTCEDH     : GHMJMQQXB       CTTELBLX        QTJIUWJAW       HODPHAJ         XYFMTUATXIKCX   QYDJOSKCUFABM  
EHSF            : GBFVUKOXCIAR    VXXKEWNH        NAVMPKGLLI      XOSJFPDVEWRXEI  HTFKRRLUH       GYBEUHOKHGRNF  
NASCVQ          : WHPTUONSWPFRGW  ICVIK           GKAUKJLXJAFMCR 
EWKOQXKEGOMGQII : SIPMBPVLYBIBI   EXQPHM         
MSNSAGACVAUAVL  : PPFUQH          PIGSNIU         KJGH            MAOOD           XPMMJHNLLEXWLUO
DKRTBP          : JKUKYV          JKIAUHRM       
GVVUDMF         : HPFWGESDUUVLIHY STHG            QJEUBVH         FVVAVEKQQJNFBNR
MTEA            : MKCARTEJRRGUHMN GUNKIVB         BDCBTRKLFII     DICBYIJJGQD    
GINKFOFFM       : FHABIOQBTWKY   
MREEN           : CHXE            VWTQS           QRQFIDKPYA      MSGTOY         
WSPS            : JMOAYLGHHWWUPO  MIULQTDFNQA     JBADK           GGLBRJOG       
KXDSMSMSS       : KLPABUEBP       CWDHJYNYR       YTFLUAPDH      
CEQMJFUQTPE     : FKQEU           QKRRNO          ABHHWWNODN      CWDHJYNYR       PJVNOKBMFLQSXGV
TKCCH           : IOSCWQAFNMSN    YPBRFKDGSAEX    CASPDWRAW       IOYFHHMREKQERF  CIODRKR        
RDNFB           : BIBR            YSLIQYSSNIT    
XPMMJHNLLEXWLUO : MSNSAGACVAUAVL 
LUVHFBJPAE      : GDCVDMUNLKSFK   ANESUG          RQKNIXPQQMQ     RGJREUVFU       YEFJBQLXGAOXFEK MCFKPKLUUFC    
OLVKLMWXVG      : VGQGXTFAJNIFHCC HODYFWNTXXG     LXWDHNJITGVPGTV HODPHAJ        
JSRH            : YAIJIWCVPPEW    GDDPQNRTL      
FFENQBLXHOKWPQR : TIGPASSW        AQOXAEFLDKD     QPSGUAX         JUUTIT         
ENOPANPXT       : GKDO            UJWVYHWXQ       RYOQVJFCKE      MVIMY           HBMGRUYGKK      COQVP          
HOXRFGWLTNNHN   : CPHUJVL        
WXVMONSSDJ      : FNDTEGJQRMAOLF  VJHQHOWJX       NTJAJDT         HAFRNEPURU      MBUWDMTOKFKITU  EOSI           
GYBEUHOKHGRNF   : RAMRXHIEOBLXO   BNOIEQQSOKLQ    MURHRSXMBCJFGY  EHSF           
JUUTIT          : PYDQOKJJQAN     LIMOSNLPQQMO    DRINUJ          RGQSKLKMAAITJ   AQPMEURRQ       MUTOBHPEJKSBS   JQCQVDKJPOXKAHR FFENQBLXHOKWPQR
HPFXFATJJERKH   : MPJBNCSFWT      GXLPJVRRAYNIOY  PGLXKWEYFBA     NDEAYVROEM      EKQUPBVKNW      CXJFXOB        
FQMRYULOAR      : UPPLIXD         TJNOF           HREVOCCJ        FVVAVEKQQJNFBNR
UOUEJNNBU       : PKPFGDEGNXPOSF  CRDOIDIIC       GVRIOOOHTT      XSLPBLKJOXUL   
HUHSGO          : XKYQVJXJ        YWMGGEKAWQ     
QVIXPXQQSEF     : IMBHIXDIYYQIGYX VFFXDCMI        FUCEXVBOA       UBIRK           VIOCPIKQMGGEDUG VJNEJXFRWPFY    FITQA          
XGQNDWY         : QTJIUWJAW       CRDOIDIIC      
