PXCTPQNJYXP     : QVMVFHPEMXFYG   EPJVINO         VVYHE          
HAMIIMLV        : MYYSQGDRW       UGJPIH          KHSCPW          COHJLGBPIYS    
SYDGGMQ         : IQAWIU          LFDMOPYDPBUTTXN SMBD            LKFCSBROUN     
JUUJYPYSFIREXY  : FUSRAO          ENCENYAT        SSQNYEUOTOVRLI  CXWBHGD         ORFEBC         
BLWJBKHGDHJLPY  : GERCKEWESD      LIGSEQHKHIVYU   LDUONPVCCP      NRVLNIVR       
SKAQTYGSTNDMR   : FHHJVQDMLQOBF   IYYKKPQAIJ      TTUHNBOXL      
NGECF           : VQMMEOGKQJKXJT  FNVQAS          RLJIGHX         OMGJMCO        
DPXJ            : NWPRSGHDYMAYTN  GDEJGLAGY       MBDKBFIHOS      CFCIMRMRCV      MVNEURHVO       QBQXW          
HUGXTLQGNJAP    : XSWA            PYRHWTWWFNIQ   
UJGXXAC         : VPMLQEJBBGE     SAED            IAKSSUKIUJQSGV  QEBMCDTK       
GIONYRDADAHXHF  : YEGHISGYRBLODHJ ARHTWGFP        JMNLRHXFLF     
UYBJIEYBYKHAJH  : CJAAOKPP        VMADTY          BOSMPMMBCSA     EXXQ            UENOUM          FYCP           
VQMMEOGKQJKXJT  : NGECF           AVSUCVJYVN      SAED            BHUSFAKRSJNR    HUIDVUD         CKXJLY         
GPFKBPOCQPMARXI : PGTLJXR         QCPIXHDTAATJX   RSPGPPUDAOMFKL  ELWW           
VBLIFCORSAF     : BXURLHJWGXMVOCF UIBBGKKWXYVO    TQQV           
MYYSQGDRW       : HAMIIMLV        DLGJ            GHHBMPDDYYYNSY 
VPMLQEJBBGE     : UJGXXAC         LRCMIKFGMMSVNR  DBETP           BSFUXCYIEDVYB  
QLQI            : CVKLPPCTU       GABIBIOAWSGRRDN SBLMOPOVASFG    HEJCIGUQGVLAP   LTIBIHHCHLHMY  
LIJEUKGQ        : CGAD            SOVIOAYUWEN    
OVVNQSEFEWJN    : JBDNSL          VANJYNXE        GTRV            FRRYQRJQFSY    
MVEBPRRXVFIHM   : RWCPOAMRWGSK   
SSUUHQQXJ       : HJIHLUYG        CXKPVVUFPLF     URPQDL         
COPBBGDNEJP     : SFFUCFVAMSO     PUAUPCCT        XEGTS           TEAR            URPQDL         
BJRXPBH         : SSIS            EODWUEJ         PFSS           
HAWEW           : EDRXCIUWONKQE   VTRG           
WQEJCIXUJBD     : IERLDR          PNES           
PHXFEAQXAIYHKIK : CYFCOHTHCMQXIE  RGHNDF          OEAIW           RROJK           PKUUNMDU       
OHSMAWVFIVATXD  : QOLPLEF         QIIXK           CXWBHGD         DYGKPV         
PMHWQHNPHWQ     : BPYGMY          SQEKFNWPX       STNVBTFXR       HGPADOEU        YPBPAUPSH       BOHGUY         
JCATQJMFKLDPTA  : QMVNDMEADCGVR   NEYTUP          SNAPACR         SCNFEJSABPOSTQW
OAUXRJFOBP      : XLIVKMKMQFGL    GJQLUYCSLS      XOEFIQSSKKGB    VLTYLJ          HMSFCSL         FOENRDHK       
SWYJOLLQFFBTKLH : CCFEQIXQ        UWXKITI        
DCQUSSRQKBXYC   : VRSWQJE        
BWNDJEOUVV      : LKJSJAXUSU      AXRNYG         
WRNKYENDUKVP    : TPYCXRBCB       UFWMHMWR        CDSBNBABCAATOWW CGAKUWY        
OADPYIFCF       : HWJXQDR         TAKLV           GKNYDFWLS      
HOAX            : JWRQGUEC        GERCKEWESD      MWKDT           XKAGK           HJPCODRXPJJMV  
VTQUNGHNKW      : XNDUDNCYWV      VHHIJNMKCKAT   
HHPWJE          : YEBLHRMBA       EFYBXWKUJOTG    UCYTQXXKAM      DYFMFGYKVLSI   
OTXYADH         : NAXBPFOSNJ      IHCJONRJSTKNFVK AVHPCTD         RXCFQUKNYFRLEA  UYTQTAMCJNTOJG 
MVWLKSHEPVKWLV  : LAJJAACKOTF     VSWXGVA         FYDFFIBL       
EDDTDOYCEU      : NEWYGAPBTQHQ    GLNFYVVT        BOMN           
DUGKSSJPGVLO    : DPFFMQOFQVBNNT  UBDQSVFNBTUFA   VQLADEUECBC     RFJSYON        
BMNBXJWCOBYRPX  : HGQV            QOVWBXDN        DLJAJJYJILIQB   TXCNOWCL        CXSGJEGAYQNKQS 
VSACQGMJBXB     : QMDBSKEGG       SPNPNYLNMUF     JXHCRJIKUSNA    TKQTFRVGTDAYTVU IERLDR          APWCDECQMKWE    GTPSRUJOEN     
WMYYOLMP        : HJIHLUYG        AUAMMFVXWALCHB  AFVAJIGDB       MWHYCXSXTCLUTL 
XOPNPOH         : CJAFHPNGEANFE   JQTBQEXOH       REIAO          
OEEKGGBMVMOVNY  : EQSXPCWTXEXSGVU MODMVCGXYXMF    UCHVSTMMOUFM   
BXURLHJWGXMVOCF : VBLIFCORSAF     EKIW            GDYFGROSBFXPQ  
QMDBSKEGG       : VSACQGMJBXB     TENQIPSMA       DUTTWAL        
WCHXXKXSC       : QJHRASAYQTOAX   BXNYD           MYATYTIHTIBFGK  PIHCFAXVWLGHX   EYYUDWKOOWCS    CXGGOMQQUIUC   
CNGILSGCUMBOBF  : VWCUM           TMRNKOFVDRGKPQ  HWOOVICHIMQBN   UEQGWHPM        PRHIHPIYVXANMLB JIJUESWCJNWSII 
TPYCXRBCB       : WRNKYENDUKVP    TWFC            YCDIII          XKAGK           NEYTUP         
ALWUPIXD        : EODWUEJ         LDUONPVCCP      ISYVOHQS       
IRIPTFEXV       : JXEIJSE        
DQYUPESJFWLHAY  : GDEJGLAGY       PIGMST          GORJS          
UPPSUEEM        : SCQWIMSWFFSVKF  WOSUPQ          OLDWYEDJ        BIFAPS         
TJUXH           : CQARVDQJRUPNRA  ROLB           
FMJGHYKCLQ      : VXPLVUUI        WPLAIU          KHDHDBFIA       IPIHWTOWXYHSL   FDYTSIGHKUIKDTT
WXYVE           : BUYU            CVXDJEJTNKIE   
NTRJBV          : VHHIJNMKCKAT    VTDEUNU        
PPJMPSGWFREOT   : RUAFU           OQSKD           TGIWTNBFOETOC  
SFFUCFVAMSO     : COPBBGDNEJP     TDMFNDMCQBM     OURXALCJOPVG    YYCS           
LAJJAACKOTF     : MVWLKSHEPVKWLV  WFGAHBS         NOVONA          SCYOA           EOVLIUPMUPFLJ  
RNPVEJKXOSSQAQ  : ALSXVAF         EOEEJGTVEXE     WIUXSFEFN       TKJM           
MMHVA           : VFFCOGMVCSVK    JOVJQMXSLC      NWOFDVN         XFYHNG          HHNHMT          DWYWGY         
HJIHLUYG        : SSUUHQQXJ       WMYYOLMP        VRSWQJE         RAECFMSSN       WNAPLOFVVK     
VXPLVUUI        : FMJGHYKCLQ      RVRLL           CKKQHPFBC      
JBPCEGTQSDOS    : BTEE            WCUSQNTFHHAI    RXJCHBF         BQNQPUM         QRDWSGABTQTL    NPGGDJ          QFJNDI         
WDVG            : RROJK           SSHCHBBAQKJ     WOCSVXKXLQUAHUO RTSNYDRJJHOFOLE
SFWWCWNNSKJ     : ATLYLCNYS       DLJAJJYJILIQB   NEQHMYEIOH     
FUHU            : DLAO            JGHBFCBQ       
LDTDWWTRKQUIXOD : GIQEERRFFGKQVY  TLGHHKJYVGTRB   FESFYJ          SVGDJNPIAHCOC   GKBQRRACLXQO    FTXOWH         
LBHLQXGBJK      : MXGKMMACRCQB    RXIMYFETFSXQHTG
ESFCEIXJFV      : TBBGT           XYWQG           NSLUXEI         KHEGGOHJNG     
XIWURWJUDX      : HMLWV           TRJQLEGVGHM     MYATYTIHTIBFGK  COHJLGBPIYS    
MJOKRRVDA       : UFCLCH          EAHVSACC        QIDXAABNXA      WJHUILXPH       HEDCPPXEFNBFJJ 
VFFCOGMVCSVK    : MMHVA           MOJXPQM         MHMAYN          KNAWIJAB        ORLI            FIOQOVCRMXKA   
RENDA           : DMHRBVB         RAECFMSSN      
DAFMPQFHOKIRGPX : KUWQ            MBWUELN         DWSJOM         
GEWDIP          : OINVRWRXW       CROVRXHW        WSHUXLTKHLAEIPF DMHRBVB         YSQESQ         
UGSAVYCO        : NWJOUGEYKF      VQQD            VGNH           
CTRTMYCCJMTRC   : RJEK            NKEQTGVE        NSLUXEI         YMGY           
CJAAOKPP        : UYBJIEYBYKHAJH  XLIVKMKMQFGL    GHVDTUK        
XLIVKMKMQFGL    : OAUXRJFOBP      CJAAOKPP        KJYBQUTAEUWWNCY PFUEMWHCIBSWGWP USXIEQXBCUPUGTY LWGGNI         
FNVQAS          : NGECF           TBBGT           DRLOVQFVBVWSN   PQVYNALQJIVK    XLLLSJPJY      
EMLPPLGADW      : TRJQLEGVGHM     EOEEJGTVEXE    
EKQAUDNJU       : TBBGT           NJVPXERLKQUGMEV CTRBLVQSCAY     EDVDBMYV        JIJUESWCJNWSII 
SGMXVLPXEACSLU  : XDQMSYVWXOLM    GTPSRUJOEN      CCFEQIXQ        MDLUOVREITVTNHP
YBJDARHMLJHOW   : CDHKVFA         YKVCHPXIEMV     UKDHNPFBLMWWK  
LRMTHM          : NHSHFYY         ADWDVMTMIXSCR   ICDTCJKKBWA     PGWCFTCDAU     
SCNY            : TFCUUY          QWHSBWEYITQSR   IMWRSOJP        XJGIITHAHV      DCUFT          
SRQPDQSMVTGDG   : SDUOSPGX        KVOIJOHEMWH     NAMHUNCVYIGRFTQ GSMATI          HUYSMOP        
OQJOMW          : FQJE            NEYTUP          DUTTWAL        
BRPNHISXJXS     : GFVXMSTWVICULB  QDCJONOPIOKPUD  GORJS           CFKT            HYOSMV         
OIFHBTDWCIGWXY  : RJEK           
MLFUM           : TGJJKP          PPADGKSYTN      OBBEHTJ         MVGO           
LCHVUHGSAKKK    : QGHVRRQV        SFAUPBPREJMVNNW EKMXRLB         QAEFGY         
RNLVLNETMESU    : GNPLGYDRKLJYHSB YFFIMWI         KHDHDBFIA       KNJEOXDHQFIPGJU
GBOUA           : NVXWMNX         CMEM            NATHEU         
WHXUQGNSQADIST  : EFUFGNYU        LTHCXNORJ      
QHKUB           : YLJNLNHMD       PAGSNMR         QMSFOHDEQL     
AVSUCVJYVN      : VQMMEOGKQJKXJT  XGQURSO        
GOQY            : IJHHQWSKK       JQSGEOO         CLQHGGLBGMFSSE  SXWSCWUFEFXQJF  YMGY           
HSMHXUCRR       : RQEREJXQSYHOK   SRJCLUNMMYYJHGW HVFIHQFDY       FYCP            MODMVCGXYXMF   
YCQCBSXTNCRAB   : IDKA           
NAWCSVXA        : KICNAWTQ        FWIUBNHKCPFH    LAKUUBKNG       PKUUNMDU       
MKPJOHBIJDBLHTM : SUKKGKX         GABIBIOAWSGRRDN
JOVJQMXSLC      : MMHVA           PJKJTFQQW       WXFWUJTJRJHPBS  BFOWT          
HCOBQBQBP       : CTIPOQWSD       ARHTWGFP        BHFOEMHGCPGKUDM MCEAGWFF        OURXALCJOPVG   
CAJIBXPWKSHYQQR : YWDJ            KLFKRTFWR       YIXUYASGXAC     ROLB            SXNDYGWQGCFG    TTAKMHNKPN      YJNHFYBXI       OMGJMCO        
QMOV            : VHNQYTAVRCMLUPV TXCNOWCL        JBQQ           
YXPCP           : IJFCELTJR       HEDCPPXEFNBFJJ  MVGO           
SSIS            : BJRXPBH         SUTEKUOBNEW     ENKMGYC         VQQD            MVNNNUXTFHV     JURNKVCGM      
LFFO            : EGANXFFPAGLA    VHMYHSBGKWTLCKB NKEQTGVE        SJFREVYYCBVCFYG AENYG          
WMPQVQJOJNGX    : QFVYJ           YIXUYASGXAC     GNGDW          
CYFCOHTHCMQXIE  : PHXFEAQXAIYHKIK AQEFNRLUYVG     YCDIII          XDQMSYVWXOLM    IFQVLU         
PSINFXGDO       : JWXO            HHSXAFYWQFMUWX  VHYGHB         
SAFYBMDATHPECWG : YLJNLNHMD       CAMYCKKTCNRUSK  NOLGITVPMASBNMV
PEYTJRP         : SBFEUEJRDRP     PLNHCLVFYUOYK   KXCO           
FURNB           : AUDFRBRBLDGNIU  TGCJUD          HIXO            FRRYQRJQFSY    
DTLLUM          : EKWXXDHKYUVH    YJXJXAKNELQJT   XDQMSYVWXOLM   
XNTHFXJEFBWLAS  : XFYHNG         
TIPYGKOHVSBJGVW : BPQGMTWA        EJHSPJPUPYCQFII FJSEU           UFVPBLGUMOAOH  
VMADTY          : UYBJIEYBYKHAJH  TDUPJQYYTJPOMW  FJSEU          
XGQURSO         : AVSUCVJYVN      DMWYUCWA        RTYUSKLH        TKVMEVSJUQPOTQ  EYQVFDITLNOXGS  DOFDWHHSSC     
NWIOFUEMQYNCF   : VAVSWOVOHN      VIDSOFOHSE      HSECUKU         CXXJEHAWVXBQL  
YLJNLNHMD       : QHKUB           SAFYBMDATHPECWG OXBEEMETT      
SVDNOTFCTNRYKV  : SBFEUEJRDRP     TLGHHKJYVGTRB   VHMYHSBGKWTLCKB MCUL           
DUCGCQ          : HWJXQDR         URDRPODCHQSSN   KHSCPW          ISHYCWKSAB     
NAXBPFOSNJ      : OTXYADH         LWBWXW          UDJJEWL         QECONRT        
TWGPFIJ         : VKJVQEMXQSUMDY  ORFIPIQK        SEBSWKBC       
CJGAXJWCRYUAO   : UHBKKEJIWSTVIA  NBGUCKOF       
XQNFHJVQA       : VDTQFNWHQCXYS   SLVE            OJVNSFIMHS     
QGHVRRQV        : LCHVUHGSAKKK    JQDLNOI         NVXO            HMVHUTX         SQHE           
YYDJVHD         : UKOQOQWKRDEH    PUAUPCCT        MBDKBFIHOS      SKAXODKJDCL    
FFKDDDQLM       : GTKLYEMTFBYOOJ  RVOHK           OFVHPWU         SWHXSDYP        PHTUVBVJY       ENAGOPUMQYGYBVF
JEDBWL          : JQDLNOI         JDEKK           ENCENYAT        JNVOUCLMI       SQHE           
UFCLCH          : MJOKRRVDA       WBPLB           BQLPGJY         OPLYWJGNCRJD    XEAB           
DMWYUCWA        : XGQURSO         PPXPKUAJTTOO    WJULRQJF        NRVLNIVR       
KFNNVYBYK       : EAHVSACC        OEAIW           JQKHKUSMBI      EWKNBUPJDNBKLO  HHUKFSLNCDND    SCNFEJSABPOSTQW
ELGRWBXB        : RFGUL           OBBEHTJ         WFJQFL         
CJAFXYESCEUKOA  : CTUPCXYRDEHPVP  VSMALAMHHWA     MHLGJQBV        ISCXMA          TNYT           
EYAHAKO         : NQGE            VDTQFNWHQCXYS   KHMQFFT         WBKQMAB        
YUVXVVBLXM      : RAECHVI        
FLNMERQCCFCCJ   : CAMYCKKTCNRUSK  SNMSLQRML       YOOSEUYC        MAXE            PMSRWUXIADSL   
ETDRIJ          : RFGUL           EFYBXWKUJOTG   
GIQEERRFFGKQVY  : LDTDWWTRKQUIXOD NKEQTGVE        WOITEXY         WUONPFEMQRXUEX 
NPBRWGV         : ENCENYAT       
JBDNSL          : OVVNQSEFEWJN    LQNEDDJ         YJEPGT         
LTHCBMV         : BNURGHWVYOTQC   PTOBUYXP        KKERGWDFESF     VKTGFHYKCE     
TBBGT           : ESFCEIXJFV      FNVQAS          EKQAUDNJU       PRKCUXFFU       ACFIIGQM       
GTMVUGV         : UKWCVULTBL      BPQGMTWA        AENYG           MHLGJQBV       
DFLGIBYVAMSIO   : KIVEWYVIPRBU    BOKCDIOYLEFA    YTVAOCJSKJTDYE 
UKOQOQWKRDEH    : YYDJVHD         KCHQKQYD        KIRWCKMKAF      GRJKRCSOYFFUYFU
CNXFSFQYN       : YAFAHQF         TPPDAKPMOXXPM  
ALUMEDDXAQPQ    : NRVLNIVR       
INRATYHXBXX     : XQRQJFK         QQDHAAWAGQLTJJ  HUNBTWJHIV      WHEGFIUHNV      MSBI           
QDASSTSEOIJTLJ  : NHSHFYY         MARNOWULPIA     LYLOSXJWEVSMKPY HUMMYRLRJSCRJK 
CYKJHBEIUD      : UJNWCIGXEYC     XNDUDNCYWV      DOQPOCUMWGVUF   QOVWBXDN       
SGNS            : GKNYDFWLS       PJKJTFQQW       HPPAN          
HVOAO           : NWPRSGHDYMAYTN  EQJGGSPTYRL     WXNKGDCHEEAMT  
USCDEWROQVPEGX  : AUGFMPN         RULVJN          NOITSBUXKJNP    BOHGUY         
KICNAWTQ        : NAWCSVXA        BOSMPMMBCSA     XGSBXG          WHDWB           QYOHLGCOUO      EEBLNBBPFBXEHF  VKPDAOHVL      
IXNAACLUWN      : MNIAQSJ         NOVONA          IKPHJVVSMINFOY 
EKSUEOKKWKRJSVY : YUXGNXCJA       VAVSWOVOHN      CTRBLVQSCAY     MKYE            CUOCVYNV        WEBV           
SUKKGKX         : MKPJOHBIJDBLHTM BOKCDIOYLEFA    UCYAVECQSL      KHDHDBFIA       KMAJCFSTGSS     IPLOD           DBUDAJ         
KCRHBHIFUDAYU   : BMTCCPKUUTTM    VYPCFLJLISFARJK PIHCFAXVWLGHX  
LTVDERYDLTY     : HSJXNRWKRKSWS   KPGYAQIQR       ONHCMEQELRV    
GFIEN           : JQSGEOO         KRHRLPKEIGW     KEHHTV         
IHCJONRJSTKNFVK : OTXYADH         YJLRHAONI       DNODJP          EQJGGSPTYRL    
BOXATLVUJ       : DWKDSLQJFFRBU   HENAWDDCLNVLJJN JOAUABJAMNDYX  
CTIPOQWSD       : HCOBQBQBP       QFVYJ           MLYQYUGP        CXSGJEGAYQNKQS 
GWXCQJPYHC      : NQGE            XSWA            MFTVM           RBRXHENYPLIWVRN NVUT            YRXICJPCKDBIQ  
JQDLNOI         : QGHVRRQV        JEDBWL         
XMNT            : UDQUWJLAYM      RHQQNNIUGFQBLT  PHXHP           UCHVSTMMOUFM   
DIODDRRMOROIBGH : OMDDLNVMVI      MVNNNUXTFHV     IWTWWQGDLYPK   
JMWCPI          : HXMDCIAQY       WCUSQNTFHHAI    EQHGPVP         FKFMP           AHLNHNQH        TUBOAQOBDHJMF  
ESBEGOXETISW    : PPLWNLYOU       ENKMGYC         HIXO            FMMQCNPP       
NQAEJOMM        : OIHCRKDYAUEML   BIHMOEHKNGR     CSDBHWPGIFSX    COITEPMCCVQ    
TXFIUJXGAEYBKH  : TSOMOYHSEJNEVVT DIJAORHMJXDKE   UKKHVYVAOIHKWSY
INLSHJHWAHBJWQ  : TCNRCAE         CJAFHPNGEANFE   QPWJEYYCTQOP    ETVJGXXP        SWHXSDYP       
UKWCVULTBL      : GTMVUGV         AWKRCSGUJLMFOCT IHVQQQYDDAJB   
COLKGWXSPH      : TSVIUCFY        COSRSYKMTOCRDW  AGVDSFJ         SBYANRHUNBULSI  TAEWVL         
YEGHISGYRBLODHJ : GIONYRDADAHXHF  YVGHJSXQI       PWLUNQ         
EMFFPTSCDPCX    : GRHTPWPWLXTF   
KCHQKQYD        : UKOQOQWKRDEH    MNIAQSJ         PUFNPSSBH       NUARYE          ISFGBQRKFRXJU   URUJWKEWUIYNXI 
AUAMMFVXWALCHB  : WMYYOLMP        OEAIW           YFTIWRA         XPGILEBAONUJCF  IVWUJJOT       
BDBSFYBRDLLOC   : SPNPNYLNMUF     YVHX            TMWPWXMYHN     
TCNRCAE         : INLSHJHWAHBJWQ  FEYWBJONFOAL    NKGH           
VEHYPJGSHJXLFG  : CALKJSYDUXGXPHE OJLQLIEDAUYDSA  EGNUHX          APWCDECQMKWE    AFVAJIGDB       NGPA           
IXQTJHYWB       : COSRSYKMTOCRDW  IHFBBK          FMMQCNPP        SRFNJCD        
KUFMYPKGWJXI    : DPFFMQOFQVBNNT  EYDDHL         
RQEREJXQSYHOK   : HSMHXUCRR       WCRHWQBWDE      RBRXHENYPLIWVRN BBBPTISFWRCHHPN WEBV           
NJUQTPWIRMTXK   : TFCUUY          CSOPVHMIUNIQBSW HHNHMT          HMVHUTX        
VSXPLDIP        : ENKCULJQXE      YCDIII          LVFSKKUJLK      SNLVPWSY       
IJHHQWSKK       : GOQY            PULFFHPPIPKSL   TSVIUCFY        EOVLIUPMUPFLJ   NOITSBUXKJNP   
FEYWBJONFOAL    : TCNRCAE         RNJWLHMEEJB     WBPLB           TNTURWFIPLOGDAH VUHFNWGWSMCL    OVXHV           RXIMYFETFSXQHTG
VLFHQNAGWJ      : AVHPCTD         ACPTKBQXCL      JEYXLDGVJGA     NQRAGSJIAEEIXW 
GCOBOCEVGFTHOKW : DSCDNTFFML      FJSEU           QYOHLGCOUO      GSMATI          FTDBRDPVOLGBFMA TLSAMOHLDVWWUPH
CXKPVVUFPLF     : SSUUHQQXJ       UGYHVLSBVNWB    EODWUEJ         NBGUCKOF       
KQPSVFU         : FYDFFIBL        YGCSNJFYELSJYS  LQAQPBOB       
HBHNGDUWNTT     : ROYBXWPBBX      AIVPGXKVAOP     QKSHI           NVUT           
RGHNDF          : PHXFEAQXAIYHKIK CVXH            OPLYWJGNCRJD    ADFYCQMABNCRC  
USBUDUKVQ       : RLKWLBY         EBWQ            PGDXOVKDWMMCRVJ DMIPC          
SDWTMKAP        : CQARVDQJRUPNRA  ERGVVTA        
AGCVXVDI        : QUVXLLLRKOJUA  
INGDGJ          : WOSUPQ          QPYUNPEFTDOT    LTTQQFAX       
LEKJWBDD        : CVVAVL          FPUOLUEHLVGF    RHQQNNIUGFQBLT  LRCMIKFGMMSVNR  POSWPHKSICBLA   OAFYAILQJYDG    IDCDKPYOUHJ    
WPLAIU          : FMJGHYKCLQ      OTYUATWBXSCN    TMRNKOFVDRGKPQ  EHGYFTSHR       XUJPK          
QYXQVBY         : KHSCPW          RBFBEHA         IGOYVPAYM      
LMQQUCQIJCSGFVL : SVFAC           AWKRCSGUJLMFOCT SXWSCWUFEFXQJF  BBTLYUL        
UESUOQWFPVVL    : GGKCQSHTUSCQJS  VDTQFNWHQCXYS   FJCABIHKJOGE   
VVNKOEIRXQBCJJ  : DWBNCTFFDYCQW   BXJHAAUTEADD    TKTFBU          ISFGBQRKFRXJU   FYDTBB         
HXMDCIAQY       : JMWCPI          OINVRWRXW      
XOVTDWRBKF      : LSRMEMQSU       IEDPBDQNUYWRRF  NWMYNR         
RNKPE           : WCUSQNTFHHAI    TSOMOYHSEJNEVVT
ROYBXWPBBX      : HBHNGDUWNTT     JRNTTSOGISONYB 
RWCPOAMRWGSK    : MVEBPRRXVFIHM   HNOUHVWXLFFIFK  ACPTKBQXCL      BLRDHW          IHDBMXAVLJP    
LCYVTG          : DSCDNTFFML      USXIEQXBCUPUGTY OAFYAILQJYDG   
NWJOUGEYKF      : UGSAVYCO        PDRH            FFVGQIYLDI      MDJINRB        
CCHUQHJKEPG     : UMAGBYK         TEUXOIDMFRJDIJI BRJP           
ERUDO           : OSLRYJEFLQEY    ELWW            ATYJEKS         SSQNYEUOTOVRLI  IHVQQQYDDAJB   
JXEIJSE         : IRIPTFEXV       EXCDHQXHCRTLPS  QDXDFQJOKJI     BODDKUMCJSKFA  
ADDFIHJPCDWNN   : JEYXLDGVJGA     SEVJWMPEOSXHJF  ESROVNAKWJ     
ETUIMRNDH       : BQNQPUM         DGPDHHSBDQQ     RHCPEAVW       
BNINHOGJRJ      : AQEFNRLUYVG     HKSKVNNYYRVKC   MSRLC           CCSMXJF         PGHRTTLFWSB    
CQARVDQJRUPNRA  : TJUXH           SDWTMKAP        AWKRCSGUJLMFOCT TVHYFK          KADYAGFE       
JQFSQJHBWQQDCKO : RCUKXOB         JLBAULIEJJY     YOOSEUYC        KXLUBN          VTRG            WKPEEMYXYKE    
NHSHFYY         : LRMTHM          QDASSTSEOIJTLJ  PCABBHPWMQYBIK  NWMYNR          UJHXMAVRRP      DMIPC          
STJG            : NWPRWCUPHFIGP  
KJYBQUTAEUWWNCY : XLIVKMKMQFGL    TNHFMDSALS     
STODMVINUAGQ    : LXAYHKGXW       TWFAQFP         ODIS           
NEWYGAPBTQHQ    : EDDTDOYCEU      KTDDWXTPP       ROCBCDJOIDH     WTLLFAEQ        WHEGFIUHNV      LTTQQFAX        PMSRWUXIADSL   
EFUFGNYU        : WHXUQGNSQADIST  ILAVFWNVCH      KJQSSIBLTJ      SUPMNDLRYCWMBHG CHQMTTELFOPQHV  TVPECXBFXWQFLDQ
NQCCMEIF        : IQAWIU          ERYSOCTBFI      EWEDXXKXAO      UHBKKEJIWSTVIA 
XMNYSNPVJIDBAJI : YJLRHAONI       JDEKK           URPQDL          LTNG            VCNJUXBNMDDEC   MVGO           
QOLPLEF         : OHSMAWVFIVATXD  NYLJIDNCGNG     GNPLGYDRKLJYHSB GDEJGLAGY      
GJQLUYCSLS      : OAUXRJFOBP      UIIQFRHF        MLMJGXJGBDKCEWS AYCFLC         
GGKCQSHTUSCQJS  : UESUOQWFPVVL    PRKCUXFFU       ELVIFGCVUEYFLF  JEYXLDGVJGA     PNES            HGPADOEU       
BEIGIRSCFNBJIOC : KUWQ            BSNFELWHVSP    
UJNWCIGXEYC     : CYKJHBEIUD      BKJWC           DOEDOCIXMKSKR   YFFIMWI         GKUOFRGWILJF    PKUUNMDU       
KUBLBJTL        : BUAUH           CDTKAJ          KFGWFA          QEQTFWAWNUAT   
MNIAQSJ         : IXNAACLUWN      KCHQKQYD        TQXOJXGBDQFYS   XGGOVHLLWPQ     MVIOMFNWEDSMBHM
UMAGBYK         : CCHUQHJKEPG     GERCKEWESD      MDVAYJXBHHXJOSW VBYYUQNNUEAIF  
HINGKKSHLEIXYU  : CJHDBELSUDVYA  
NKMOEFXJCMMLNN  : LVFSKKUJLK      TTOSOQWKL      
AVHPCTD         : OTXYADH         VLFHQNAGWJ      XQRQJFK         TQRJ           
CQCMODJSRWFIBKI : FUSRAO          PYRHWTWWFNIQ   
OUYA            : GNGDW           FYGSL           PJKJTFQQW       BWWHK          
NYLJIDNCGNG     : QOLPLEF         UDCC            KNAWIJAB        HQQWBLHPFEUC    TYDOFXSSXPUGB   UVVGQRMBUIA    
QVMVFHPEMXFYG   : PXCTPQNJYXP     CXQCWFRUL       ESROVNAKWJ      BXAG           
OETQPJPDUXGLD   : YVIILFMH        SKAXODKJDCL     MXPVPGEHSASUBMR LVFSKKUJLK      GKUOFRGWILJF   
YJLRHAONI       : IHCJONRJSTKNFVK XMNYSNPVJIDBAJI PWTSFDHUHRHWAYL GKNYDFWLS       KHHCXOGNX       LVFSKKUJLK      CKXJLY          FSEJSANSATQK   
TWFC            : TPYCXRBCB       VWHYCB          PUFNPSSBH       BSIQ            EODWUEJ         LHQXDAWX        YJXJXAKNELQJT   INYEJNT        
NWPRSGHDYMAYTN  : DPXJ            HVOAO           VANJYNXE        YUXGNXCJA       MUWFWGXKSRR     NDEHEE         
HNOUHVWXLFFIFK  : RWCPOAMRWGSK    DWBNCTFFDYCQW   TWYKJVF         EODWUEJ         KVOIJOHEMWH     PAGHBLSBNUKY    TYDJDHHTDQCDUM  JHNYYBBCDANR   
EAHVSACC        : MJOKRRVDA       KFNNVYBYK       HHUEBSBFNPQ     LHLANB          YRVIFDLF        IFQVLU          DHKUKYHWQ       GMSK           
DPGDJ           : TEAUQGQX        QKSHI           TXCNOWCL        DHKUKYHWQ       JHULM           CGAKUWY        
HSJXNRWKRKSWS   : LTVDERYDLTY     ERUGMJ          MFNKGKXPCT     
JDEKK           : JEDBWL          XMNYSNPVJIDBAJI TXCNOWCL        OOJIPNVN        MFNKGKXPCT     
FLEH            : IPUAE           GSMATI          UNSPBTKOOUDPC  
KWYPGTYBFXO     : YYESCLMB        NXASU          
WCRHWQBWDE      : RQEREJXQSYHOK   NQUPQFSNGXEQIC  WQCPOKTBH      
NPFSD           : ARETOXVLUEMYHFB KJQSSIBLTJ      KHMQFFT         IGIJXQD        
CVVAVL          : LEKJWBDD        DRLOVQFVBVWSN   IQVRNSHVAO      HMVHUTX        
RLKWLBY         : USBUDUKVQ       UGJPIH          IPAWHPMJMY      UFWMHMWR        EJAYTUWHJH      DCUFT          
DQPAJQWMXAC     : DUBHLPJFW       SVAAFEAIOJSAYAE OBBEHTJ        
FUSRAO          : JUUJYPYSFIREXY  CQCMODJSRWFIBKI MUGHN           BMTCCPKUUTTM   
AKEKERU         : SEGUUMNGHTCFG   REIAO           LLGRHWJT       
DWBNCTFFDYCQW   : VVNKOEIRXQBCJJ  HNOUHVWXLFFIFK  ICGTMLWPVDWXXJ  MCUL            ECRGFFNKMUWWN  
SMMQHGSVYSJD    : GKUOFRGWILJF    JMNLRHXFLF      TNYT           
NUBRA           : LSRMEMQSU       MWYW            YPTVDRKQPBL     EQHGPVP        
UNCQSHURMNQ     : XSVKW           ALSXVAF         TJKQUAJNO      
IDIBMRT         : YYTHHKISGTD     RSDACYCHIKX     GDYFGROSBFXPQ  
QOUTU           : RVRLL           SQGOAVGJDMGGPU  AXRNYG         
QXDQXAECRY      : GXYHHEJS        GXBR            CXDCR           HIQLCGEJPNHVCN  SFYJITAN        GKUOFRGWILJF   
OTYCKUM         : NWPRWCUPHFIGP   FJCABIHKJOGE    TYEAGUX         ORLI            FJKTV           YSQESQ         
FQDWMONEJJYUAW  : SAGTQVTJAFB     MBDKBFIHOS      OVXHV           FCDNL           YXLWYDQKKTMOOL 
SWAYYRYLGUMK    : YIITJD          RTSNYDRJJHOFOLE HXURPYMGY      
JAAPQG          : WRDR            CXWBHGD        
FUDJHOK         : RTHP            JIMBRDN         ESROVNAKWJ      TYDJDHHTDQCDUM  NMDJ           
RJEK            : CTRTMYCCJMTRC   OIFHBTDWCIGWXY  RLEIMTNLGIVQ    UCYAVECQSL      XLLLSJPJY      
EKIW            : BXURLHJWGXMVOCF MWYW            CVAFIMBMLKL     JGNWTB          DKOYKKUDYXJ    
VDGJQPSQQ       : SAED            BGXUTILYGOQOCJG LIGSEQHKHIVYU   GORJS           BBBPTISFWRCHHPN TYPOHEHRMBCGEX 
JWXO            : PSINFXGDO       QRGIACULP       HOFBDKPKF      
DBBRNFLXJ       : GXBR            XSWA            QFVYJ           KATYCOYG       
GOJQ            : CUFVTAIS        SRFNJCD         UWXKITI        
UNSDYJSRAJF     : LHLANB          CJAFHPNGEANFE   YCDIII          BLRDHW         
IDDDIEECTMOT    : VOBDQXXQPVJP    UDQUWJLAYM      CDSBNBABCAATOWW
NBMW            : FSNVU           TYNPGKUSVOW     OOSNPDVPLRLLEYU
ARHTWGFP        : GIONYRDADAHXHF  HCOBQBQBP       BHFOEMHGCPGKUDM FSNVU           DLJAJJYJILIQB   HDTQXUIL        TMYSRFOAYMQI    CXGGOMQQUIUC   
ICGTMLWPVDWXXJ  : DWBNCTFFDYCQW   ATLYLCNYS       MWKDT           NSXRWJFSBAWMMHJ
TFCUUY          : SCNY            NJUQTPWIRMTXK   DUIITVGYFRJ    
USYQPIWIJFMRBY  : VVYTYLNH        LFKEOXFUJV      MODMVCGXYXMF    PWQPFXTA       
BPYGMY          : PMHWQHNPHWQ     KTDDWXTPP       VQQD            KGPAFAO         XDQMSYVWXOLM   
VOBDQXXQPVJP    : IDDDIEECTMOT    VPTSAYMQDAVDK   VQLADEUECBC    
CALKJSYDUXGXPHE : VEHYPJGSHJXLFG  TKTFBU          HSRWWFXBILXFEKK TAEWVL         
GLAWMGOKEFBAQSP : RHQQNNIUGFQBLT  PNES           
SBFEUEJRDRP     : PEYTJRP         SVDNOTFCTNRYKV  PVPHOJHQPCSB    NWOFDVN         AGWR            OXVDCXT        
YTXHHAF         : VRSWQJE         TEGNBSJJMCY     TYEAGUX         WEBV            TWUNH           RNIXELFLGIQWCB  EFYBXWKUJOTG   
GVHNBKPTDFNXJ   : PFUEMWHCIBSWGWP RXKWL           QXTBWXLU        MFNKGKXPCT      LUNNGSDMOFLTTR 
EGANXFFPAGLA    : LFFO            YKVCHPXIEMV     YSQESQ         
TDUPJQYYTJPOMW  : VMADTY          PBINSNVUPKVT    UPMPHXKNIWKQ    EUXST           OISULR          ESSPPTYRTBDNGM  PVPXBMCOBA     
MGYSOBGOGNEJTSJ : FHBQSB         
OOHEBBEAUNPLDP  : VRSA            VMBAFMTJLJPOJ   SLWVNLEMUAK     TYPOHEHRMBCGEX  WPYKXXHLG      
RVRLL           : VXPLVUUI        QOUTU           JQKHKUSMBI      GORJS           EWKNBUPJDNBKLO  VSMALAMHHWA    
TAAIHLCAWOOMWUN : CLQHGGLBGMFSSE  IGIJXQD        
BNURGHWVYOTQC   : LTHCBMV         BUAUH           LPQPIUJORUEURU  LMNJOMPNVILLIMX
MWKMFRA         : XEAB            ONADBEYAHKGS    FKSTYPELEDA    
TWYKJVF         : HNOUHVWXLFFIFK  QQDHAAWAGQLTJJ  CDTKAJ          SOVIOAYUWEN     JOAUABJAMNDYX  
VHNQYTAVRCMLUPV : QMOV            PCJPE           FOAIQYRRCGYSJBQ NEYTUP          HXURPYMGY      
MGVRAV          : EODWUEJ         QQDHAAWAGQLTJJ  YFCU            DBUDAJ         
TTCEDXLDVUQNTMP : DKBIFPOFA       VVYTYLNH        CGAKUWY        
GRHTPWPWLXTF    : EMFFPTSCDPCX    GWCMIR          WHAXKEDKSUR    
PGTLJXR         : GPFKBPOCQPMARXI SMWGXXYY        KYPSYS         
MUGHN           : FUSRAO          VWHYCB          QVVHIJBIGMWSRIN SHNRLIKDBGDSB   TWLDQTMBNK      TEMAUAHKMDVBDSK
ECNVI           : KHSCPW          LNEFH           WOCSVXKXLQUAHUO LTNG           
FCXCSUNQ        : CAMYCKKTCNRUSK  ROLB            ODDYUSI         HIXO           
SRJCLUNMMYYJHGW : HSMHXUCRR       ARKEPGYCILFWUOU
KYTJHCOMC       : CDHKVFA         LIHAQTHEYYQTEEY RVCWMHBDEMCL   
HWJXQDR         : OADPYIFCF       DUCGCQ          DOHV            QPYUNPEFTDOT    YFCU           
HEUWQKVPTEXRJJ  : CKLJBDKLQWGXQJ  EEKUUHDXQLMJ    RCUKXOB         NUXQJDOFXNW     PWQPFXTA       
DUBHLPJFW       : DQPAJQWMXAC     WFGAHBS         HLBOTYBJG       LVOGMK          HHSXAFYWQFMUWX  IYYKKPQAIJ      TENQIPSMA      
PUAUPCCT        : COPBBGDNEJP     YYDJVHD         FKGUV           DLAO            WLJKSND        
BKJWC           : UJNWCIGXEYC     YEBLHRMBA      
DAXNLSSGVDSL    : KYDOND          FJSEU           TMRNKOFVDRGKPQ  RULVJN         
AIVPGXKVAOP     : HBHNGDUWNTT     JLBAULIEJJY     PWTGILMHOTC     NENYQMLRWWLM   
PCJPE           : VHNQYTAVRCMLUPV TSEMIHDLVPDJVI  OJVNSFIMHS     
SGPISJEBHHT     : FFVGQIYLDI      AOYADMWOODPKL   RDDG           
VWCUM           : CNGILSGCUMBOBF  HQQWBLHPFEUC    TWFAQFP        
SAGTQVTJAFB     : FQDWMONEJJYUAW  INYEJNT         WSTFMM         
XVNNFGY         : CGAD            IJFCELTJR      
HHUEBSBFNPQ     : EAHVSACC        LWKIXNBX        PGMTOMVOYBBKW  
RWBLVWU         : CEBQ            TIROJ          
EVDCRQSYYRMIB   : ERALXOJFTRW     KNTLWCXHUYGUNCS QAEFGY          JFCQOWYETJDEKMN OURXALCJOPVG   
MEDP            : CSVSYSNDFQEHSYC PWLUNQ          SBLMOPOVASFG   
QIDXAABNXA      : MJOKRRVDA       LVOGMK          QDCJONOPIOKPUD  MVGO            RXIMYFETFSXQHTG
WFGAHBS         : LAJJAACKOTF     DUBHLPJFW       PCDMQ          
CTUPCXYRDEHPVP  : CJAFXYESCEUKOA  AHFW           
VSWXGVA         : MVWLKSHEPVKWLV  PQVYNALQJIVK    AYCFLC          VTDEUNU         VIGQHJ          KEHHTV         
SFAUPBPREJMVNNW : LCHVUHGSAKKK    UHHNLQHNTYBD    YUOCLEXKD       UIFV           
QCPIXHDTAATJX   : GPFKBPOCQPMARXI DOQPOCUMWGVUF   MBDKBFIHOS      GHVDTUK        
DSCDNTFFML      : GCOBOCEVGFTHOKW LCYVTG          RBINJTFRDPNX    TKVMEVSJUQPOTQ  OTWIJRNSB       ALVVWKPVGNE     XNLQNBPVUOKVSHE SUKCSMPSTBY    
DSCDNTFFML      : TGHJFABMYUNJTFK
BHFOEMHGCPGKUDM : HCOBQBQBP       ARHTWGFP        IWJOQA          UDHJW           CFMOFI         
WXVTBRY         : OROFF           WHEGFIUHNV     
FUMNHX          : HPYNB           ALCURJJXXJ      GABIBIOAWSGRRDN YLFJQGRWKILSNAH HNXWIVFXTE      GECMIG          HARMO          
LHLANB          : EAHVSACC        UNSDYJSRAJF     MDJINRB         GCQIKTSHQTR    
UFADPXGFVGDT    : HMSFCSL         YEBLHRMBA       DWKDSLQJFFRBU   EULOQPMSOWGRP  
HLBOTYBJG       : DUBHLPJFW       EXCDHQXHCRTLPS  TGJJKP          IPVMA           YLFJQGRWKILSNAH VLDWRKWIANVGW   AFVAJIGDB      
PRKCUXFFU       : TBBGT           GGKCQSHTUSCQJS  WHDWB           TAEWVL         
FYDFFIBL        : MVWLKSHEPVKWLV  KQPSVFU         XYWQG           PYGIQ           UKDHNPFBLMWWK   XOMMAXHJRSBCA   RMYJDGOLB       MOESHNR        
FYDFFIBL        : TNYT           
XOUJRLF         : IPVMA           YENVYM          MBISFTHTIHQH    AGQCH          
OOARFTCJODOTXBC : RBINJTFRDPNX   
EHFOLSDJHAU     : PVALH           JGHBFCBQ        BYSOTCAFNG     
MBUBPUVURXEG    : SUTEKUOBNEW     LSRMEMQSU       BVCABIIPHTW    
UDCWHYBOGQCAVLJ : OTYUATWBXSCN    CCSMXJF         HDTQXUIL       
HLKKHOAEKXVK    : YTVWNB          PIGNK           VMBAFMTJLJPOJ   EHGYFTSHR       HUNBTWJHIV      WFMGABYSGESDYDL
FOAIQYRRCGYSJBQ : VHNQYTAVRCMLUPV ITRWTQVQJN      YDBXVXFCWKTR    TAGHATXSTHR     UWXKITI        
KPGYAQIQR       : LTVDERYDLTY     STNVBTFXR       WUWDAIXNMHGYPG  XKAGK          
DRLOVQFVBVWSN   : FNVQAS          CVVAVL          TSVIUCFY        EEBLNBBPFBXEHF  MIPRP          
BOSMPMMBCSA     : UYBJIEYBYKHAJH  KICNAWTQ        YKITC           TMULPEROM       TSVIUCFY        IERLDR         
KIVEWYVIPRBU    : DFLGIBYVAMSIO   XFYHNG          TNHFMDSALS      KSKSCUFYAXX    
ESNYHNBXJ       : SVFAC           BLRDHW         
OVCRAVRE        : AQEFNRLUYVG     GWLLVMYTME      JLBAULIEJJY    
CAMYCKKTCNRUSK  : SAFYBMDATHPECWG FLNMERQCCFCCJ   FCXCSUNQ       
RTYUSKLH        : XGQURSO         MHMAYN          VDNFCHSAYOHH    LUNNGSDMOFLTTR 
PBINSNVUPKVT    : TDUPJQYYTJPOMW  ULHGEMASBP      UVVGQRMBUIA    
IQAWIU          : SYDGGMQ         NQCCMEIF        JQGOP          
UGJPIH          : HAMIIMLV        RLKWLBY         PHTUVBVJY       DOFDWHHSSC     
SUTEKUOBNEW     : SSIS            MBUBPUVURXEG    GTKLYEMTFBYOOJ  KNJEOXDHQFIPGJU RLJIGHX        
UIIQFRHF        : GJQLUYCSLS      SBYANRHUNBULSI  PGMTOMVOYBBKW  
RBINJTFRDPNX    : DSCDNTFFML      OOARFTCJODOTXBC JQKHKUSMBI      RYGFT          
RLEIMTNLGIVQ    : RJEK            XPQHJLPNU       HEJCIGUQGVLAP   QEBMCDTK       
CKLJBDKLQWGXQJ  : HEUWQKVPTEXRJJ  OEVQYT          KADYAGFE       
EKWXXDHKYUVH    : DTLLUM          HQLCBSPQVWX     OOSNPDVPLRLLEYU
UYIWJTGLXT      : LABLMFSNKOI     TAKLV           CJUNIOSU        RKMAWWWOUUXGGA 
QSFPJ           : QDXDFQJOKJI     SNMSLQRML       WEBV           
DOEDOCIXMKSKR   : UJNWCIGXEYC     TSOMOYHSEJNEVVT
FQJE            : OQJOMW          IWJOQA          RSDACYCHIKX    
DNODJP          : IHCJONRJSTKNFVK FDMBRSNEVTNFJMA SVAAFEAIOJSAYAE
CVKLPPCTU       : QLQI            TRHTKJKFTNCEXVB NHGXPCYEUPCSX   KNKPSQWEWWWND   RAECFMSSN      
VGRKQNWIPFCYJF  : KDRAPGRDNVPUMVG OAOH           
YVIILFMH        : OETQPJPDUXGLD   ALCURJJXXJ      HQLCBSPQVWX     BQNQPUM         QEBMCDTK       
BYKFSFYQLT      : ORDW            LRCMIKFGMMSVNR  LXAYHKGXW      
EJYNYEPYPU      : GHVDTUK         HIXO           
RQQCCWPMOQ      : QWLLTQ          RKMAWWWOUUXGGA  ITCWQNBAE      
BXJHAAUTEADD    : VVNKOEIRXQBCJJ  HQQWBLHPFEUC    ISHYCWKSAB      DNBRLIMF       
CJHDBELSUDVYA   : HINGKKSHLEIXYU  VMBAFMTJLJPOJ   PGWCFTCDAU      TEMAUAHKMDVBDSK YSQESQ         
NQGE            : EYAHAKO         GWXCQJPYHC      CJUNIOSU        YENVYM         
ENCENYAT        : JUUJYPYSFIREXY  JEDBWL          NPBRWGV         ALVVWKPVGNE     ONLS            NTMKQ          
DYQI            : CGAD            LWKIXNBX        CFCIMRMRCV      QNTIVSV        
XNMCAHYDFBFS    : ENKMGYC         IWKYRNNDCWMBISC DIMRUYUN        TGIWTNBFOETOC   SNLVPWSY        HQDMEGPOYD     
XYWQG           : ESFCEIXJFV      FYDFFIBL        VABHR           VDNFCHSAYOHH    LTHNVCDFSJKO   
UMBUNUVSU       : TELBTPLF        GTPSRUJOEN      SWNJQPF         MVGO            NPGGDJ         
DFPRRUR         : OSLRYJEFLQEY   
VWHYCB          : TWFC            MUGHN           SCQWIMSWFFSVKF  IWVIM           ISFGBQRKFRXJU   TMWQYTPTFNM     JCMPLPNTQD      TGHJFABMYUNJTFK
VWHYCB          : DUTTWAL        
ACPTKBQXCL      : VLFHQNAGWJ      RWCPOAMRWGSK    NQUPQFSNGXEQIC 
YKITC           : BOSMPMMBCSA     YCAUSWLFMX      GHGRQKDSQN      HQDMEGPOYD      JHNYYBBCDANR   
ARETOXVLUEMYHFB : NPFSD           EYQHXTFCGQPB    LIHAQTHEYYQTEEY KHEGGOHJNG      WSMOGKDUUIDTPE 
VUWWM           : QPWJEYYCTQOP    BXNYD           JVIBA           HOFBDKPKF      
BAKCMSWOFYJ     : FLWV            DWKDSLQJFFRBU   OEWJFVLQIHFOF   ECVMQDIYYFBPFT 
UXLR            : UHBKKEJIWSTVIA  GKUOFRGWILJF    IDQTRKEM        FSEJSANSATQK   
GXYHHEJS        : QXDQXAECRY      NVFORLMUEEXQFI  HPYNB           IGDRYDH         RFJSYON        
ERYSOCTBFI      : NQCCMEIF        VMBAFMTJLJPOJ   OEWJFVLQIHFOF   TTMTAKNT       
EXCDHQXHCRTLPS  : JXEIJSE         HLBOTYBJG       JOTIKQKTP       FMKTOX          WKPEEMYXYKE    
YYESCLMB        : KWYPGTYBFXO     KKERGWDFESF     MFTVM           BQNQPUM         RJSCVDXUYBM     IGDRYDH         HNXWIVFXTE      RNVOTHIB       
CGAD            : LIJEUKGQ        XVNNFGY         DYQI            RQUOWWQDTQKV    MSRLC          
JARJFWQXUA      : DGPDHHSBDQQ     BSNFELWHVSP     UCHVSTMMOUFM   
PVPHOJHQPCSB    : SBFEUEJRDRP     ELWW            TGHJFABMYUNJTFK
VGQCIWRRYJBGGT  : FVETHGWNADK     WOSUPQ          KLYALMWTHCWWGQ  IHFBBK          SWLOISRA       
EUJTQYBIKI      : SJFREVYYCBVCFYG
BMTCCPKUUTTM    : KCRHBHIFUDAYU   FUSRAO          TEGNBSJJMCY     UHHNLQHNTYBD    IHVQQQYDDAJB   
VYPCFLJLISFARJK : KCRHBHIFUDAYU   CRRWJTL         PQYNCRVKSHJ     EYYUDWKOOWCS   
TLGHHKJYVGTRB   : LDTDWWTRKQUIXOD SVDNOTFCTNRYKV  FBOYCDWUE      
FWIUBNHKCPFH    : NAWCSVXA        ARQRAKOJOONR    GHWSGE          OLDWYEDJ        JBQQ            PPJOX           KNKPSQWEWWWND   QDYRANS        
AQEFNRLUYVG     : CYFCOHTHCMQXIE  BNINHOGJRJ      OVCRAVRE        PGMLO           IEDPBDQNUYWRRF  LLWTUOADQCBPMXY
TMULPEROM       : BOSMPMMBCSA     OIHCRKDYAUEML   ICUBUFBTTHG     RBRXHENYPLIWVRN PWTSFDHUHRHWAYL TXCNOWCL       
QDXDFQJOKJI     : JXEIJSE         QSFPJ           KNKPSQWEWWWND   BSPFNWE        
OVJCQLXW        : FPPFJNFGWNFXJHN SGOVYNG         UIVMG           HYOSMV         
ULHGEMASBP      : PBINSNVUPKVT    ALQOXGMMADE     QPYUNPEFTDOT    EGNUHX          YIBIH           WUONPFEMQRXUEX  DNGCFH         
GNPLGYDRKLJYHSB : RNLVLNETMESU    QOLPLEF         PAGSNMR         TRJQLEGVGHM     HQMYJFQSB      
EBWQ            : USBUDUKVQ       WQBHJXSWSHM     PFSS            EMTMYD         
KYDOND          : DAXNLSSGVDSL    WYIBKFVCN       IPIHWTOWXYHSL  
QUVXLLLRKOJUA   : AGCVXVDI        WQBHJXSWSHM     VHYGHB          SXNDYGWQGCFG   
VHMYHSBGKWTLCKB : LFFO            SVDNOTFCTNRYKV  HSUSSJEYEXVVUA 
URDRPODCHQSSN   : DUCGCQ          LWBWXW          MOJXPQM         KHDHDBFIA       EGPEOS          IDCDKPYOUHJ    
OMDDLNVMVI      : DIODDRRMOROIBGH KFYYJLXKAB      LJTHCBAXVLH    
PTOBUYXP        : LTHCBMV         DOQPOCUMWGVUF   ATOCPDTLN       YLFJQGRWKILSNAH MXGX           
PFTVJDMDWCYLO   : NAMHUNCVYIGRFTQ UPEJXMFYRVDSL  
OBPMPOVC        : UDHJW           IYYKKPQAIJ     
RTHP            : FUDJHOK         MOHTXEWEIIO     FCDNL           YPTVDRKQPBL     UPEJXMFYRVDSL  
GFVXMSTWVICULB  : BRPNHISXJXS     XEBUJIPFSX      KKNJUTKDVL      IHFBBK          LHFEQVSDTYS    
ADWDVMTMIXSCR   : LRMTHM          GQNDBNDYNSKMHK  YXMBCL          RJSCVDXUYBM    
RNJWLHMEEJB     : FEYWBJONFOAL    ALCURJJXXJ      AFYSREDFFYH     UVOVOTOGLPIELRM
NVXO            : QGHVRRQV        VUWJOOA         OEVQYT          UGYXKCLCEA     
BTEE            : JBPCEGTQSDOS    BQLPGJY         UWNTQPYTYWELTH  BTYOFGPX        TCVGUOLE       
SAED            : UJGXXAC         VQMMEOGKQJKXJT  VDGJQPSQQ       ATYJEKS         GASTXLM        
XGSBXG          : KICNAWTQ        SKOB            NNFBOIPAKS      WOTEWCKBC      
XSVKW           : UNCQSHURMNQ     DUTTWAL        
VANJYNXE        : OVVNQSEFEWJN    NWPRSGHDYMAYTN  CRRWJTL         JIHCPSQH        TPPDAKPMOXXPM   DLRCOE          HWDPSVON       
TKVMEVSJUQPOTQ  : XGQURSO         DSCDNTFFML      AFVAJIGDB       XJSGHBJWALCAIJ  UOIMVUPKH      
GQNDBNDYNSKMHK  : ADWDVMTMIXSCR   UCHLOWEFWKFVI   TEUXOIDMFRJDIJI DLRCOE          QWMJMPKOGRDUVO 
XEGTS           : COPBBGDNEJP     VRSWQJE         WVOYDXL        
QMVNDMEADCGVR   : JCATQJMFKLDPTA  GERCKEWESD      XLLLSJPJY       KADYAGFE       
YFPXVIII        : EBAEFOMSUU      VIDSOFOHSE      WFJQFL         
SCQWIMSWFFSVKF  : UPPSUEEM        VWHYCB          MSFXJVXQXSCOS   XPQHJLPNU      
KKERGWDFESF     : LTHCBMV         YYESCLMB       
EPJVINO         : PXCTPQNJYXP     PWLUNQ          UIQH            LLWTUOADQCBPMXY
XEBUJIPFSX      : GFVXMSTWVICULB  GXBR            XAWGGWBTAPEG    VDTQFNWHQCXYS   WFGPQQVTJSTND   TUBOAQOBDHJMF  
EKMXRLB         : LCHVUHGSAKKK    ACFIIGQM        JFABKWYYBUIMN   KSKSCUFYAXX    
QWHSBWEYITQSR   : SCNY            CVXH            YLFCNEHXVLGSE  
TOGCFOW         : MUWESABKJG      IGNUEDLDCDCNF   RKXRSHSHC      
WBPLB           : UFCLCH          FEYWBJONFOAL    RUMUIFKAAMN     DEFKEXSODLOU   
XDLQCSJD        : AUDFRBRBLDGNIU  YTGQKTGE        GRJKRCSOYFFUYFU
OEAIW           : PHXFEAQXAIYHKIK KFNNVYBYK       AUAMMFVXWALCHB  NBHY            YLFCNEHXVLGSE   GTKYWAGBLBB    
DROTB           : TDQVMOJLODV     QBQXW          
BPQGMTWA        : TIPYGKOHVSBJGVW GTMVUGV         IFGM            WTSRD           WQCPOKTBH      
GXBR            : QXDQXAECRY      DBBRNFLXJ       XEBUJIPFSX      YYTHHKISGTD    
DKBIFPOFA       : TTCEDXLDVUQNTMP HGAYDGEUTPFDYD  PNSIEP         
BDGPXHJYYC      : PAGSNMR        
NVFORLMUEEXQFI  : GXYHHEJS        YUXGNXCJA       YDYDPRQ         BHUSFAKRSJNR   
WXEWM           : XSWA            CJUNIOSU        ENMHUNJM       
BSWBDI          : ORFIPIQK        QDYRANS         HUIDVUD        
CKKQHPFBC       : VXPLVUUI        GWLLVMYTME      PRHIHPIYVXANMLB
WIXWBFIACIGAUL  : ITRWTQVQJN      PYGIQ           PSBTYWAAOFSK    EWKNBUPJDNBKLO  WSTFMM         
NKEQTGVE        : CTRTMYCCJMTRC   LFFO            GIQEERRFFGKQVY  SVFAC           CBFNKAVVAOFE    KQIONA          NENYQMLRWWLM    ELFRUUS        
MNJTP           : NHGXPCYEUPCSX   DOHV            HQMYJFQSB       OOSNPDVPLRLLEYU
NOVONA          : LAJJAACKOTF     IXNAACLUWN      ERALXOJFTRW    
XAWGGWBTAPEG    : XEBUJIPFSX      PHHVHTIJLEURD   UKYIBWMNTFFKRH  SLVE           
XOEFIQSSKKGB    : OAUXRJFOBP      KLFKRTFWR       EGJWYV          KMBOPLIBLR      KAMN            GORJS          
FPPFJNFGWNFXJHN : OVJCQLXW        IMWRSOJP        SJEVSU          RYGFT           SIWBBCAM        NBGUCKOF       
NWOFDVN         : MMHVA           SBFEUEJRDRP     KFEAPSGOVNRSB   OBQV           
OIHCRKDYAUEML   : NQAEJOMM        TMULPEROM       PTWUMWSPP       GKMEER          WEFDLFDJ       
UIBBGKKWXYVO    : VBLIFCORSAF     CHQMTTELFOPQHV  HEJCIGUQGVLAP   LWVGGLXUVKXW    IGIJXQD         PQYNCRVKSHJ    
YKVVCF          : EEKUUHDXQLMJ    TYNPGKUSVOW     SBYANRHUNBULSI  KEKGOFTHUWDHNR 
EYQHXTFCGQPB    : ARETOXVLUEMYHFB TIROJ           OEWJFVLQIHFOF   LJTHCBAXVLH    
QEFBPCB         : VPEPWHSMYIVD    LFDMOPYDPBUTTXN SQHE            IDCDKPYOUHJ    
XSWA            : HUGXTLQGNJAP    GWXCQJPYHC      DBBRNFLXJ       WXEWM           CRRWJTL         HUYSMOP         WVAYASPJ       
SVFAC           : LMQQUCQIJCSGFVL ESNYHNBXJ       NKEQTGVE        UEQGWHPM        KNAWIJAB        ADFYCQMABNCRC  
YTVWNB          : HLKKHOAEKXVK    ATWBM           EYYUDWKOOWCS   
VRSWQJE         : DCQUSSRQKBXYC   HJIHLUYG        YTXHHAF         XEGTS           GNGDW           KNJEOXDHQFIPGJU LXUDIFH        
MTDQMDJJDMECU   : LIHAQTHEYYQTEEY QYOHLGCOUO      CFKT            PNIX           
EIEAEEPFHLYDLR  : ALCURJJXXJ      RXJCHBF         AEQYW          
RSCNVSA         : FUOOFENIJ       MSTINIICGW      RJBGUMXBKUUQR  
EJHSPJPUPYCQFII : TIPYGKOHVSBJGVW RJSMHTEKBHWF    PQVYNALQJIVK   
RUMUIFKAAMN     : WBPLB           YWYUSPUNNGUMS   QWLLTQ          HKSKVNNYYRVKC  
HPYNB           : FUMNHX          GXYHHEJS        OPLYWJGNCRJD    WAEHNWXNGBO     UFVPBLGUMOAOH  
GQRWMIVQBD      : FDMBRSNEVTNFJMA YFTIWRA         KJQSSIBLTJ      OBQV            MBWUELN         HEJCIGUQGVLAP   SRFNJCD        
JQSGEOO         : GOQY            GFIEN           LAEOHOMNQNVDJN  RJBGUMXBKUUQR  
BQLPGJY         : UFCLCH          BTEE            UDHJW           MKYE            ISFL            ILDQXXHF       
IMWRSOJP        : SCNY            FPPFJNFGWNFXJHN FVFRG           IPLOD          
TNTURWFIPLOGDAH : FEYWBJONFOAL    ERALXOJFTRW     CCXXYATKB      
LWBWXW          : NAXBPFOSNJ      URDRPODCHQSSN   MVLROLXQQKLMBH  YSQESQ         
KUAE            : PAGSNMR         EHGYFTSHR       WOSUPQ          MXGX           
LVOGMK          : DUBHLPJFW       QIDXAABNXA      CVXH            QJRTVABNU       DBNJNDLWLCJ    
EHIOYUEGXEP     : YFTIWRA        
SPUPNUXYP       : BUAUH           LAJYQIIMOTCTQA  SWNJQPF        
FDMBRSNEVTNFJMA : DNODJP          GQRWMIVQBD      SEENXXSQCTFCDI  GJBLLRTDPUYE   
UAVNTQ          : SSQNYEUOTOVRLI  JQTBQEXOH       ILCUBHYILIW     HHUKFSLNCDND    DLRCOE          KADYAGFE       
RJSMHTEKBHWF    : EJHSPJPUPYCQFII WHDWB           GHWSGE          VBYYUQNNUEAIF  
PUFNPSSBH       : KCHQKQYD        TWFC            WOITEXY        
SDUOSPGX        : SRQPDQSMVTGDG   SQEKFNWPX       TAKLV           OURXALCJOPVG   
PQVYNALQJIVK    : FNVQAS          VSWXGVA         EJHSPJPUPYCQFII PHHVHTIJLEURD   PPADGKSYTN     
RROJK           : PHXFEAQXAIYHKIK WDVG            RUAFU           BIOUVDAFBQ      EOEICGO        
KTDDWXTPP       : NEWYGAPBTQHQ    BPYGMY          MWYW            PGWCFTCDAU      SXNDYGWQGCFG    GTRV           
PYRHWTWWFNIQ    : HUGXTLQGNJAP    CQCMODJSRWFIBKI XPKTHIYATITPGG  WAEHNWXNGBO     BYSOTCAFNG     
SQEKFNWPX       : PMHWQHNPHWQ     SDUOSPGX        PVRIEXFQRL      FJFQYDE         PAGHBLSBNUKY    CCSMXJF        
UDQUWJLAYM      : XMNT            IDDDIEECTMOT    LRCMIKFGMMSVNR  FQPPBCSSH       TGHJFABMYUNJTFK
IKPHJVVSMINFOY  : IXNAACLUWN      JRNTTSOGISONYB  KDRAPGRDNVPUMVG
CXDCR           : QXDQXAECRY      VHHIJNMKCKAT    GORJS           BSFUXCYIEDVYB  
FJSEU           : TIPYGKOHVSBJGVW VMADTY          GCOBOCEVGFTHOKW DAXNLSSGVDSL    CDSBNBABCAATOWW
GTVBFIQMTOKO    : URWFRLGR        OBQV            TKQTFRVGTDAYTVU BYSOTCAFNG     
UDJJEWL         : NAXBPFOSNJ      YCGUUTPCPQQEDHL XFYHNG          TLCNAE          RXKWL           KATYCOYG       
CNWCUGWCDGIYCLE : TELBTPLF        JIHCPSQH        MUWESABKJG      YQLXBQRJFCYEUY  LQQBLERPVU      CEUFFKUDCVS     LLGRHWJT       
DTGTEVXCBJLFGAJ : KMAJCFSTGSS     PEDGOFRKMSHCRRS TDQVMOJLODV     RXCFQUKNYFRLEA 
PGMLO           : AQEFNRLUYVG     LERFUKHKMAHHB   DRODGR          EIQWKAF        
PRPXRTMVG       : YIITJD          YKVCHPXIEMV     CFMOFI          YSQESQ         
PPLWNLYOU       : ESBEGOXETISW    GMSK            HKTUWFXRCU      LHFEQVSDTYS    
TDMFNDMCQBM     : SFFUCFVAMSO     LOXITQEIXKDXB   SPBGEIUX        KXLUBN          BBTLYUL         LYLOSXJWEVSMKPY
TEGNBSJJMCY     : YTXHHAF         BMTCCPKUUTTM    KUWQ            OFWANYGKI      
BOKCDIOYLEFA    : DFLGIBYVAMSIO   SUKKGKX        
TEAUQGQX        : DPGDJ           SJFREVYYCBVCFYG KBRXOTFY       
EYKQKWUKXVYLAFT : IITYDJ          XPGILEBAONUJCF 
EHSLJCF         : ROLB            JBBXLIYB        MVIOMFNWEDSMBHM UMPST           FBOYCDWUE      
CDHKVFA         : YBJDARHMLJHOW   KYTJHCOMC       ALVVWKPVGNE     LNEFH           LKJSJAXUSU      ACFIIGQM        HANESFGJMM     
GMTRJOEKMFVMKRD : VMTCUF          VTDEUNU         OFWANYGKI       ENAGOPUMQYGYBVF
YWDJ            : CAJIBXPWKSHYQQR HWOOVICHIMQBN   IGNUEDLDCDCNF   ALQOXGMMADE    
LAEOHOMNQNVDJN  : JQSGEOO         KJQSSIBLTJ      WEBV            FOENRDHK       
XRAK            : FUHKRNJOBEROQIE JIJWNDWAK      
XYKPDCQ         : GUSPNDSNANIYHUX XGGOVHLLWPQ     KFGWFA          PEDGOFRKMSHCRRS IIDQ           
ICDTCJKKBWA     : LRMTHM          QVWPLMLKHXIA   
NVXWMNX         : GBOUA           NKITAM          SMWGXXYY        JQGOP           KYPSYS          PNSIEP          VKPDAOHVL      
PIGNK           : HLKKHOAEKXVK    IGNUEDLDCDCNF   LLKVVQMKJTTM    RVCWMHBDEMCL   
FNVXREBWXFHKRKK : TWLDQTMBNK      EEJTGMUMN      
CXQCWFRUL       : QVMVFHPEMXFYG   GMSK            KADYAGFE        ERRCVGQLJ      
GSWQMEGIDX      : OLPDPMYHUUR    
GWNLGBEQLX      : UFPT           
LOXITQEIXKDXB   : TDMFNDMCQBM     YDBXVXFCWKTR    SVGDJNPIAHCOC   GEQLNEUWPT     
CJAFHPNGEANFE   : XOPNPOH         INLSHJHWAHBJWQ  UNSDYJSRAJF     BXAG           
SCAETYMPPS      : PJFTHXLWQAXC    KBRXOTFY        LVFSKKUJLK      WNAPLOFVVK     
PDDNGUSPVAYNOG  : YIITJD         
OTYUATWBXSCN    : WPLAIU          UDCWHYBOGQCAVLJ KRQYSQGL        WLJKSND         EPHKAMMBHPX    
TGJJKP          : MLFUM           HLBOTYBJG       UBDQSVFNBTUFA   PWQPFXTA       
QKSHI           : HBHNGDUWNTT     DPGDJ           SJFREVYYCBVCFYG QRFOFKQ        
IWJOQA          : BHFOEMHGCPGKUDM FQJE            KLWPGAWG       
SULMUONNQB      : YMCTE          
MJLXTBXNNSWYOFX : PHRRL           TKQTFRVGTDAYTVU NUARYE          MGQBTHQOOSVKUGS HYOSMV         
WQBHJXSWSHM     : EBWQ            QUVXLLLRKOJUA   BGXUTILYGOQOCJG NJVPXERLKQUGMEV VBWBVTWCWV      GKBQRRACLXQO    LQADGOBGG      
ANKM            : GTKYWAGBLBB    
VLTYLJ          : OAUXRJFOBP      SPNPNYLNMUF     BSIQ            BIOUVDAFBQ      SLWVNLEMUAK    
HGQV            : BMNBXJWCOBYRPX  HUCROUPYEKKWDQT
OXKFBSRANQSVDE  : LWVGGLXUVKXW    TEMAUAHKMDVBDSK
SPNPNYLNMUF     : VSACQGMJBXB     BDBSFYBRDLLOC   VLTYLJ          CBFNKAVVAOFE    OJBAFREUEWJ     KRITSAPOD       WKYKJTOMQUKKWT 
DVRRK           : TELBTPLF        OFVHPWU         GLNFYVVT        DOFDWHHSSC     
CRRWJTL         : VYPCFLJLISFARJK VANJYNXE        XSWA            PAGHBLSBNUKY   
PJFTHXLWQAXC    : SCAETYMPPS      NKGH            LDUONPVCCP      OCCQUKV         UYTQTAMCJNTOJG 
LAUFDQAWDSCWMY  : KFYYJLXKAB      GJBLLRTDPUYE   
HMLWV           : XIWURWJUDX      BSMOVKMUGEC    
SGRFDKHCPW      : YWYUSPUNNGUMS   WDTPYOKI        KDRAPGRDNVPUMVG
PTWUMWSPP       : OIHCRKDYAUEML   PIHCFAXVWLGHX   EGNUHX          AWGUASMFJPGOCL 
MFTVM           : GWXCQJPYHC      YYESCLMB        ERGVVTA        
IJFCELTJR       : YXPCP           XVNNFGY         XNDUDNCYWV      WYIBKFVCN      
QVWPLMLKHXIA    : ICDTCJKKBWA     MOHTXEWEIIO     YIPCWSTBP       DLAO            AQMRVX          VOARQDTQDUQ    
AUDFRBRBLDGNIU  : FURNB           XDLQCSJD        UENOUM         
TMRNKOFVDRGKPQ  : CNGILSGCUMBOBF  WPLAIU          DAXNLSSGVDSL    HGPADOEU        QYSLP          
GTKLYEMTFBYOOJ  : FFKDDDQLM       SUTEKUOBNEW     ORFIPIQK        LWKIXNBX       
BGXUTILYGOQOCJG : VDGJQPSQQ       WQBHJXSWSHM     CYOQWFKP        KNJEOXDHQFIPGJU FYAMB          
PCABBHPWMQYBIK  : NHSHFYY         DPFFMQOFQVBNNT  LVYLICNGWHTTIN  ESTUDPXMSURB   
JQKHKUSMBI      : KFNNVYBYK       RVRLL           RBINJTFRDPNX    FQPPBCSSH       SXWSCWUFEFXQJF  GRJKRCSOYFFUYFU ADQGXKVFPW      UOIMVUPKH      
JQKHKUSMBI      : RNVOTHIB        NMDJ           
SKOB            : XGSBXG          VTDEUNU         TTFUG           QSCVQODRUJEY   
GDEJGLAGY       : DPXJ            DQYUPESJFWLHAY  QOLPLEF         CBFNKAVVAOFE    KVWJT           RLMCGXQTTSVOFV  WXHOKRGCILIT    TCVGUOLE       
FCBPRNHCUT      : EULOQPMSOWGRP  
PGDXOVKDWMMCRVJ : USBUDUKVQ       OTWIJRNSB       VABHR           QNTIVSV         KJDSA          
VPEPWHSMYIVD    : QEFBPCB         HVFIHQFDY       ROLB            WJULRQJF       
QFVYJ           : WMPQVQJOJNGX    CTIPOQWSD       DBBRNFLXJ       ABYGJNOASB     
PHHVHTIJLEURD   : XAWGGWBTAPEG    PQVYNALQJIVK    YVASIAMCY       NEOIHRJJWV     
VUHFNWGWSMCL    : FEYWBJONFOAL    MLYQYUGP       
XNDUDNCYWV      : VTQUNGHNKW      CYKJHBEIUD      IJFCELTJR       PVRIEXFQRL      IUVFNG          MBECJXNCPPLPROF
GKMEER          : OIHCRKDYAUEML   UEQGWHPM        VPBNL           EYYUDWKOOWCS   
CMYKAXSYSHEFC   : PSBTYWAAOFSK    BIOUVDAFBQ     
UHYXUBXRAHBM    : KQIONA          EMTMYD         
FSNVU           : NBMW            ARHTWGFP        QOVWBXDN        EDVDBMYV       
WHDWB           : KICNAWTQ        PRKCUXFFU       RJSMHTEKBHWF    LTTQQFAX        BOMN           
QIIXK           : OHSMAWVFIVATXD  YCDIII         
SUMQPQQKSBNFWU  : OAFYAILQJYDG    BBTLYUL        
NQUPQFSNGXEQIC  : WCRHWQBWDE      ACPTKBQXCL      ISFL            JHULM           UIVMG          
VUWJOOA         : NVXO           
BSIQ            : TWFC            VLTYLJ          JIMBRDN         WRDR            OAFYAILQJYDG   
ILAVFWNVCH      : EFUFGNYU        NATHEU         
KHSCPW          : HAMIIMLV        DUCGCQ          QYXQVBY         ECNVI           ONLS           
MSFXJVXQXSCOS   : SCQWIMSWFFSVKF  KDRAPGRDNVPUMVG
DUIITVGYFRJ     : TFCUUY         
KLFKRTFWR       : CAJIBXPWKSHYQQR XOEFIQSSKKGB    QOVWBXDN        WUONPFEMQRXUEX 
TRHTKJKFTNCEXVB : CVKLPPCTU       ESSPPTYRTBDNGM 
UGYHVLSBVNWB    : CXKPVVUFPLF     AXRNYG         
QRGIACULP       : JWXO           
IFGM            : BPQGMTWA        WDTPYOKI        HUCROUPYEKKWDQT HANESFGJMM      WBKQMAB        
ENKCULJQXE      : VSXPLDIP        RUAFU           AEIYFUMXNMGYT   GTRV           
VRSA            : OOHEBBEAUNPLDP  ATYJEKS         IDKA           
JRNTTSOGISONYB  : ROYBXWPBBX      IKPHJVVSMINFOY  EQJGGSPTYRL     WLJKSND        
DPFFMQOFQVBNNT  : DUGKSSJPGVLO    KUFMYPKGWJXI    PCABBHPWMQYBIK  FLBS            SWLOISRA       
UDHJW           : BHFOEMHGCPGKUDM OBPMPOVC        BQLPGJY         PHRRL           DWYWGY         
ENKMGYC         : SSIS            ESBEGOXETISW    XNMCAHYDFBFS    FHHJVQDMLQOBF   PGMTOMVOYBBKW   OABLXOWER      
AWKRCSGUJLMFOCT : UKWCVULTBL      LMQQUCQIJCSGFVL CQARVDQJRUPNRA  EYDDHL          GRJKRCSOYFFUYFU
ROLB            : TJUXH           EHSLJCF         YEBLHRMBA       YXMBCL          UGIBTWGDITIJ   
KFEAPSGOVNRSB   : NWOFDVN         TYEAGUX         EOEEJGTVEXE    
WTSRD           : BPQGMTWA        WTLLFAEQ        GISIFP          HSRWWFXBILXFEKK WVAYASPJ       
ELVIFGCVUEYFLF  : GGKCQSHTUSCQJS  QVVHIJBIGMWSRIN HENAWDDCLNVLJJN RNIXELFLGIQWCB 
CYOQWFKP        : BGXUTILYGOQOCJG WAHY           
YMCTE           : SULMUONNQB      OFVHPWU         NEOIHRJJWV      JFABKWYYBUIMN  
ALSXVAF         : RNPVEJKXOSSQAQ  UNCQSHURMNQ     NJVPXERLKQUGMEV
YAFAHQF         : CNXFSFQYN       WRDR            LWVOB          
SGFM            : WVOYDXL         PEFWUFKACE      SMQRWTVQUU     
MYUU            : YIPCWSTBP       CBGGC           GORJS           RCXCDPXFJ       GTPSRUJOEN     
JWRQGUEC        : HOAX            URWFRLGR        GWCMIR         
ACCBDEGD        : YDBXVXFCWKTR   
ALCURJJXXJ      : FUMNHX          YVIILFMH        RNJWLHMEEJB     EIEAEEPFHLYDLR  NAMHUNCVYIGRFTQ EHGYFTSHR       WAHY           
SJFREVYYCBVCFYG : LFFO            EUJTQYBIKI      TEAUQGQX        QKSHI           HQMYJFQSB      
DOQPOCUMWGVUF   : CYKJHBEIUD      QCPIXHDTAATJX   PTOBUYXP        PIHCFAXVWLGHX   CFMOFI          GECMIG         
PATWSXURYWUUCC  : OPXLMUNRRX      KKNJUTKDVL      VABHR           VVYTYLNH       
IPAWHPMJMY      : RLKWLBY         WSHUXLTKHLAEIPF
VWDDFVDBSV      : NEMPTRQBSJSXPXD PFUEMWHCIBSWGWP LFDMOPYDPBUTTXN AHLNHNQH        UBDQSVFNBTUFA  
OPXLMUNRRX      : PATWSXURYWUUCC  FCDNL           HHSXAFYWQFMUWX  HUNBTWJHIV      YYCS            MVGO           
RVOHK           : FFKDDDQLM       DWNE            MWKDT           BODDKUMCJSKFA  
WJHUILXPH       : MJOKRRVDA       JIHCPSQH        SDNXWO          TYDOFXSSXPUGB   XPGILEBAONUJCF 
QCCRQRPFHN      : MHRQUKAPORBG    DFQYMKWS       
YFTIWRA         : AUAMMFVXWALCHB  GQRWMIVQBD      EHIOYUEGXEP     VSMALAMHHWA    
CBFNKAVVAOFE    : NKEQTGVE        SPNPNYLNMUF     GDEJGLAGY       VQLADEUECBC    
KGXDAPK         : HSUSSJEYEXVVUA  MWKDT           ONHCMEQELRV     BGGOBGKTTGOVQN 
FIIKERHVTQXUVLF : DRUJRLYHN       XWVEGJEQFCSPPB  QOGVEUULPSFQIIW DMSOJGJSXQ      HJPCODRXPJJMV  
JEYXLDGVJGA     : VLFHQNAGWJ      ADDFIHJPCDWNN   GGKCQSHTUSCQJS  RCUKXOB        
VMTCUF          : GMTRJOEKMFVMKRD GWCMIR          GCQIKTSHQTR    
YWYUSPUNNGUMS   : RUMUIFKAAMN     SGRFDKHCPW      GTRV            DNGCFH         
OSLRYJEFLQEY    : ERUDO           DFPRRUR         PWLUNQ         
ITRWTQVQJN      : FOAIQYRRCGYSJBQ WIXWBFIACIGAUL  TWUNH           JOAUABJAMNDYX  
WCUSQNTFHHAI    : JBPCEGTQSDOS    JMWCPI          RNKPE          
EODWUEJ         : BJRXPBH         ALWUPIXD        CXKPVVUFPLF     TWFC            HNOUHVWXLFFIFK  MGVRAV          IGNUEDLDCDCNF   RFATOGWYTLVJR  
EODWUEJ         : VLDWRKWIANVGW   ILDQXXHF       
YCAUSWLFMX      : YKITC           DMSOJGJSXQ      HSECUKU        
OTWIJRNSB       : DSCDNTFFML      PGDXOVKDWMMCRVJ NNFBOIPAKS      RFATOGWYTLVJR   KFYYJLXKAB     
CSVSYSNDFQEHSYC : MEDP            FNOKHIW         UWXKITI        
NHFLMV          : ATOCPDTLN       YKVCHPXIEMV     RKXRSHSHC      
LERFUKHKMAHHB   : PGMLO           RMSCNMMYBCSDXL  YTVAOCJSKJTDYE  FIOQOVCRMXKA   
UHHNLQHNTYBD    : SFAUPBPREJMVNNW BMTCCPKUUTTM    GKNYDFWLS      
ORDW            : BYKFSFYQLT      RXJCHBF         TXDKRG         
HQLCBSPQVWX     : EKWXXDHKYUVH    YVIILFMH        VBNMOQUJV       ECYNT           PHTUVBVJY      
YVGHJSXQI       : YEGHISGYRBLODHJ YQLXBQRJFCYEUY  UCYAVECQSL      SYEBULBWHQ      FRRYQRJQFSY    
SLAYARCYXMPKQTF : JYKT            SMWGXXYY        KHEGGOHJNG     
MBDKBFIHOS      : DPXJ            YYDJVHD         FQDWMONEJJYUAW  QCPIXHDTAATJX  
MLMJGXJGBDKCEWS : GJQLUYCSLS      FHUTPFHEP      
QOVWBXDN        : BMNBXJWCOBYRPX  CYKJHBEIUD      FSNVU           KLFKRTFWR       GHVDTUK        
IWKYRNNDCWMBISC : XNMCAHYDFBFS    VVYHE           KJQSSIBLTJ      NBHY           
FESFYJ          : LDTDWWTRKQUIXOD KBRXOTFY        LIGSEQHKHIVYU   IFQVLU          QXTBWXLU        LLKVVQMKJTTM    UGIBTWGDITIJ   
PFSS            : BJRXPBH         EBWQ            SYEBULBWHQ      OPDUNC         
XJGIITHAHV      : SCNY            TVPECXBFXWQFLDQ YMMH           
LSRMEMQSU       : XOVTDWRBKF      NUBRA           MBUBPUVURXEG    JOTIKQKTP       PULFFHPPIPKSL   HQDMEGPOYD      WSTFMM         
LAWUVPAQIGPROXC : XPQHJLPNU       KHDHDBFIA       KGPAFAO        
GERCKEWESD      : BLWJBKHGDHJLPY  HOAX            UMAGBYK         QMVNDMEADCGVR   VABHR           OGQJSXSKHHOUGR 
KVOIJOHEMWH     : SRQPDQSMVTGDG   HNOUHVWXLFFIFK  KLTYBBYISRNVDOV SWLOISRA        DMIPC          
IPUAE           : FLEH            YCGUUTPCPQQEDHL VBWBVTWCWV      YIBIH           WFJQFL         
FPCJJGVPFBJLUTH : AGVDSFJ         ONHCMEQELRV    
ERALXOJFTRW     : EVDCRQSYYRMIB   NOVONA          TNTURWFIPLOGDAH TTFUG           IPLOD           GCQIKTSHQTR    
TELBTPLF        : UMBUNUVSU       CNWCUGWCDGIYCLE DVRRK           BETDJCPLKN     
HVFIHQFDY       : HSMHXUCRR       VPEPWHSMYIVD    NKITAM          GSMATI         
HSUSSJEYEXVVUA  : VHMYHSBGKWTLCKB KGXDAPK         JOTIKQKTP       HGPADOEU        CKXJLY          HMVHUTX        
VVYHE           : PXCTPQNJYXP     IWKYRNNDCWMBISC FLWV            XWVEGJEQFCSPPB  RNIXELFLGIQWCB 
RAECHVI         : YUVXVVBLXM      BSNFELWHVSP    
WDTPYOKI        : SGRFDKHCPW      IFGM            HSRWWFXBILXFEKK KYHEXJNQCKSPT   YMMH            HANESFGJMM      HUMMYRLRJSCRJK  SNLVPWSY       
JOTIKQKTP       : EXCDHQXHCRTLPS  LSRMEMQSU       HSUSSJEYEXVVUA  MVNNNUXTFHV     SCNFEJSABPOSTQW
UWNTQPYTYWELTH  : BTEE            GWCMIR         
LGTV            : YCDIII          CVXH            KCXVMLJ         WYIBKFVCN      
PIGMST          : DQYUPESJFWLHAY  DYKUVUB         LWVGGLXUVKXW    IJPXYS          KTPUNPCAESDRKU 
FPUOLUEHLVGF    : LEKJWBDD       
DJGYRNKAI       : PAGSNMR         BWWHK           OOSNPDVPLRLLEYU
RARBOK          : ASHHWDEEJJQU   
UPMPHXKNIWKQ    : TDUPJQYYTJPOMW  INYEJNT        
HWOOVICHIMQBN   : CNGILSGCUMBOBF  YWDJ            SEBSWKBC        UWXKITI        
ECUYYMLPVM      : KRQYSQGL       
MWYW            : NUBRA           EKIW            KTDDWXTPP       DWKDSLQJFFRBU   TMYSRFOAYMQI   
EEKUUHDXQLMJ    : HEUWQKVPTEXRJJ  YKVVCF          LLGRHWJT       
ATSFQTEFIVEWY   : PULFFHPPIPKSL   TVBSJIEA        KATYCOYG       
TXNHE           : WVOYDXL         XOMMAXHJRSBCA  
UYPCEPUQCGHFC   : WEBV            UIVMG          
KUWQ            : DAFMPQFHOKIRGPX BEIGIRSCFNBJIOC TEGNBSJJMCY     ISYVOHQS        MVGO            ECVMQDIYYFBPFT 
HNGEMWAMMIT     : FUOOFENIJ       SBLMOPOVASFG    UKDHNPFBLMWWK   UCHVSTMMOUFM   
DSYHXOE         : VABHR           QXTBWXLU        DLGJ           
SKAXODKJDCL     : YYDJVHD         OETQPJPDUXGLD   URWFRLGR        UCHLOWEFWKFVI   BTCLNJKRIWKIA  
RSPGPPUDAOMFKL  : GPFKBPOCQPMARXI CCTLPPPVBVX     LWGGNI          NPGGDJ         
ICUBUFBTTHG     : TMULPEROM       DGWIL           UIQH            PTRCEDDX        CDJAPBERQNN    
KIRWCKMKAF      : UKOQOQWKRDEH    DGPDHHSBDQQ    
FHUTPFHEP       : MLMJGXJGBDKCEWS NWPRWCUPHFIGP   SYEBULBWHQ     
ASHHWDEEJJQU    : RARBOK          CROVRXHW       
NWNDK           : HHNHMT          UBDTRMFBR       HEDCPPXEFNBFJJ  TIROJ          
IQVRNSHVAO      : CVVAVL          LIGSEQHKHIVYU   WOSUPQ          ILDQXXHF        AGGD            SISUNKSXA      
MOHTXEWEIIO     : RTHP            QVWPLMLKHXIA    SSQNYEUOTOVRLI  HLBB            TTUHNBOXL      
DRODGR          : PGMLO           CDSBNBABCAATOWW
YCGUUTPCPQQEDHL : UDJJEWL         IPUAE          
IPVMA           : HLBOTYBJG       XOUJRLF         DWNE            YPTVDRKQPBL     OGKELFRLUDNCALR WNTTOXMVMEFHEK  ONHCMEQELRV     OXBEEMETT      
BBMVPREIH       : LQADGOBGG       GTPSRUJOEN     
KNAHHQMAHDEKNR  : IJPXYS          YMMH            BOHGUY         
VHHIJNMKCKAT    : VTQUNGHNKW      NTRJBV          CXDCR           UPEJXMFYRVDSL  
KBRXOTFY        : TEAUQGQX        SCAETYMPPS      FESFYJ          YIXUYASGXAC     VGNH            IGDRYDH         ADQGXKVFPW     
RBRXHENYPLIWVRN : GWXCQJPYHC      RQEREJXQSYHOK   TMULPEROM       MHMAYN          DIJAORHMJXDKE  
ERUGMJ          : HSJXNRWKRKSWS   RLRWHBOFV       KAMN           
PDRH            : NWJOUGEYKF      EXXQ            ACFIIGQM        HUMMYRLRJSCRJK  KAPNNHWV       
YIITJD          : SWAYYRYLGUMK    PRPXRTMVG       PDDNGUSPVAYNOG  SXILMBVTGPWBVLH MDLUOVREITVTNHP
QJHRASAYQTOAX   : WCHXXKXSC       NGJNGOMDHRR     QRDWSGABTQTL    YTGQKTGE       
UEVHXLKPSKRBTL  : DTPEHCGO        NSXRWJFSBAWMMHJ HNXWIVFXTE      SYEBULBWHQ      QFJNDI         
YFFIMWI         : RNLVLNETMESU    UJNWCIGXEYC    
YIXUYASGXAC     : CAJIBXPWKSHYQQR WMPQVQJOJNGX    KBRXOTFY        OJLQLIEDAUYDSA 
XQRQJFK         : INRATYHXBXX     AVHPCTD         QAEFGY          UVVGQRMBUIA    
BVCABIIPHTW     : MBUBPUVURXEG    AFVAJIGDB       MOESHNR        
EWEDXXKXAO      : NQCCMEIF        PNSIEP         
AFYSREDFFYH     : RNJWLHMEEJB     RMSCNMMYBCSDXL  COSRSYKMTOCRDW  EMTMYD         
ARQRAKOJOONR    : FWIUBNHKCPFH    NGJNGOMDHRR    
NEMPTRQBSJSXPXD : VWDDFVDBSV      TEUXOIDMFRJDIJI IRYEJE          EFKJMVM        
ILRACJCMBNDRCU  : GHWSGE          EXXQ            JHNYYBBCDANR   
RCUKXOB         : JQFSQJHBWQQDCKO HEUWQKVPTEXRJJ  JEYXLDGVJGA     NJVPXERLKQUGMEV ROLB           
HMSFCSL         : OAUXRJFOBP      UFADPXGFVGDT    FCDNL           GLNFYVVT       
DWNE            : RVOHK           IPVMA           EGJWYV         
YIPCWSTBP       : QVWPLMLKHXIA    MYUU            ECYNT          
URWFRLGR        : GTVBFIQMTOKO    JWRQGUEC        SKAXODKJDCL     YOOSEUYC        SXNDYGWQGCFG   
VMBAFMTJLJPOJ   : OOHEBBEAUNPLDP  HLKKHOAEKXVK    CJHDBELSUDVYA   ERYSOCTBFI      FLBS            YILHUDP        
ELWW            : GPFKBPOCQPMARXI ERUDO           PVPHOJHQPCSB   
XPKTHIYATITPGG  : PYRHWTWWFNIQ    TMWPWXMYHN      LUNNGSDMOFLTTR 
GNGDW           : WMPQVQJOJNGX    OUYA            VRSWQJE         WUWDAIXNMHGYPG  AGQCH          
MOJXPQM         : VFFCOGMVCSVK    URDRPODCHQSSN   CFMOFI          XJSGHBJWALCAIJ  WBKQMAB        
PULFFHPPIPKSL   : IJHHQWSKK       LSRMEMQSU       ATSFQTEFIVEWY   TGCJUD         
YRVIFDLF        : EAHVSACC        UENOUM          HUYSMOP        
ATLYLCNYS       : SFWWCWNNSKJ     ICGTMLWPVDWXXJ  UBDQSVFNBTUFA   DBNJNDLWLCJ    
MXPVPGEHSASUBMR : OETQPJPDUXGLD   UBDTRMFBR       ARGFDMVIANYBBGV
SWWAWXVKYIPM    : NWMYNR          RJBN           
IWVIM           : VWHYCB         
YUXGNXCJA       : EKSUEOKKWKRJSVY NWPRSGHDYMAYTN  NVFORLMUEEXQFI  TKTFBU          IWTWWQGDLYPK   
DLJAJJYJILIQB   : BMNBXJWCOBYRPX  SFWWCWNNSKJ     ARHTWGFP        DLRWTDAYY       ESSPPTYRTBDNGM  FJKTV          
ALVVWKPVGNE     : DSCDNTFFML      ENCENYAT        CDHKVFA         OBQV            EQHGPVP        
OIFQXKC         : SXWSCWUFEFXQJF 
KNTLWCXHUYGUNCS : EVDCRQSYYRMIB   NDEHEE          SCVNYOGTUIU    
NKITAM          : NVXWMNX         HVFIHQFDY       YQLXBQRJFCYEUY  FUOOFENIJ       MSRLC           TKJM           
OVXHV           : FEYWBJONFOAL    FQDWMONEJJYUAW  EUXST          
MDVAYJXBHHXJOSW : UMAGBYK         FYGSL           NXASU           SLWVNLEMUAK    
NHGXPCYEUPCSX   : CVKLPPCTU       MNJTP           MXGX            OXBEEMETT      
DKEYMFJK        : IDKA           
SSHCHBBAQKJ     : WDVG            KGRCRGCBDNIPB   RMSCNMMYBCSDXL  MVLROLXQQKLMBH 
CLQHGGLBGMFSSE  : GOQY            TAAIHLCAWOOMWUN OROFF           UEQGWHPM        NBGUCKOF       
XPQHJLPNU       : RLEIMTNLGIVQ    SCQWIMSWFFSVKF  LAWUVPAQIGPROXC OROFF           CROVRXHW        CJUNIOSU        NVUT            EULOQPMSOWGRP  
XPQHJLPNU       : QEBMCDTK       
RXJCHBF         : JBPCEGTQSDOS    EIEAEEPFHLYDLR  ORDW            IDKA            WKYKJTOMQUKKWT  HUYSMOP        
ROCBCDJOIDH     : NEWYGAPBTQHQ    SEENXXSQCTFCDI  WWVSPJKYW      
JIHCPSQH        : VANJYNXE        CNWCUGWCDGIYCLE WJHUILXPH       SPJBGQXQ        RHCPEAVW       
LABLMFSNKOI     : UYIWJTGLXT      SPBGEIUX        UIQH            OURXALCJOPVG    OAOH            LTHCXNORJ       VKTGFHYKCE     
SJEVSU          : FPPFJNFGWNFXJHN XPTUMBCRAUBHRV  DMHRBVB         UCHVSTMMOUFM    NGPA           
XFYHNG          : MMHVA           XNTHFXJEFBWLAS  KIVEWYVIPRBU    UDJJEWL         MGTJSRAHXYB    
FCDNL           : FQDWMONEJJYUAW  RTHP            OPXLMUNRRX      HMSFCSL         WEPIEWKRECG     YOOSEUYC       
PMDCRXSF        : VQQD            MBWUELN         FNOKHIW         DNBRLIMF       
BIHMOEHKNGR     : NQAEJOMM        SCYOA           EBAEFOMSUU     
PFUEMWHCIBSWGWP : XLIVKMKMQFGL    GVHNBKPTDFNXJ   VWDDFVDBSV      YTGQKTGE       
PWTSFDHUHRHWAYL : YJLRHAONI       TMULPEROM       WVAYASPJ        BNXJ           
GHWSGE          : FWIUBNHKCPFH    RJSMHTEKBHWF    ILRACJCMBNDRCU  VDRGMMNGDSLRENW MBNLONU        
RHQQNNIUGFQBLT  : XMNT            LEKJWBDD        GLAWMGOKEFBAQSP MVLROLXQQKLMBH 
IEDPBDQNUYWRRF  : XOVTDWRBKF      AQEFNRLUYVG     EQJGGSPTYRL     PHXHP          
PYGIQ           : FYDFFIBL        WIXWBFIACIGAUL  XGGOVHLLWPQ    
YYTHHKISGTD     : IDIBMRT         GXBR            CMEM           
YUOCLEXKD       : SFAUPBPREJMVNNW PWLUNQ         
EIQWKAF         : PGMLO           KHDHDBFIA       OOSNPDVPLRLLEYU WFMGABYSGESDYDL
YGCSNJFYELSJYS  : KQPSVFU         HQQWBLHPFEUC   
NWPRWCUPHFIGP   : STJG            OTYCKUM         FHUTPFHEP       QOGVEUULPSFQIIW NVUT            ISYVOHQS        WVAYASPJ        LUNNGSDMOFLTTR 
NSLUXEI         : ESFCEIXJFV      CTRTMYCCJMTRC   VABHR           QDYRANS         WIUXSFEFN       LFNKUJ          DYFMFGYKVLSI    AGQCH          
LHQXDAWX        : TWFC            RTSNYDRJJHOFOLE FJKTV           QWMJMPKOGRDUVO  TYDJDHHTDQCDUM 
MUWESABKJG      : TOGCFOW         CNWCUGWCDGIYCLE SNMSLQRML       WUONPFEMQRXUEX  SNLVPWSY        NTMKQ          
RYGFT           : RBINJTFRDPNX    FPPFJNFGWNFXJHN USXIEQXBCUPUGTY SQGOAVGJDMGGPU  PNIX           
ATYJEKS         : ERUDO           SAED            VRSA            OISULR          ISFGBQRKFRXJU   YJNHFYBXI      
KVWJT           : GDEJGLAGY       BYSOTCAFNG     
VRCCMEDWPMR     : TSVIUCFY        CBGGC           SEBSWKBC       
NAMHUNCVYIGRFTQ : SRQPDQSMVTGDG   PFTVJDMDWCYLO   ALCURJJXXJ      URPQDL          LQAQPBOB       
DMJAEL          : WIUXSFEFN       HXURPYMGY      
QRIPHUKOIKDRH   : DWKDSLQJFFRBU   STMYMWGSDDPEQKH SWLOISRA        SRFNJCD        
VDRGMMNGDSLRENW : GHWSGE          YDBXVXFCWKTR    BGCH            EOEEJGTVEXE    
SPJBGQXQ        : JIHCPSQH       
IDKA            : YCQCBSXTNCRAB   VRSA            DKEYMFJK        RXJCHBF         RFATOGWYTLVJR   XRQRD          
EYQVFDITLNOXGS  : XGQURSO         QRYAIHQANPJUL   BYSOTCAFNG     
FKGUV           : PUAUPCCT        SNAPACR        
DOHV            : HWJXQDR         MNJTP           HUNBTWJHIV      DIMRUYUN       
PAGSNMR         : QHKUB           GNPLGYDRKLJYHSB BDGPXHJYYC      KUAE            DJGYRNKAI       KYPSYS         
JYKT            : SLAYARCYXMPKQTF IERLDR          TEUXOIDMFRJDIJI
VKJVQEMXQSUMDY  : TWGPFIJ         EGEYOLEC        ECVMQDIYYFBPFT 
MUWFWGXKSRR     : NWPRSGHDYMAYTN  DUTTWAL        
SCYOA           : LAJJAACKOTF     BIHMOEHKNGR     ATWBM           DNBRLIMF       
AYCFLC          : GJQLUYCSLS      VSWXGVA         QPEQRYLE        SIWBBCAM       
GWLLVMYTME      : OVCRAVRE        CKKQHPFBC       YPTVDRKQPBL     CCXXYATKB       EMMBBCHVHWKMIGJ
SEENXXSQCTFCDI  : FDMBRSNEVTNFJMA ROCBCDJOIDH     HWGNDIGWITJSS  
HNQJLXGWLFKKBYQ : QVVHIJBIGMWSRIN ERGVVTA         WSTFMM         
RUAFU           : PPJMPSGWFREOT   RROJK           ENKCULJQXE      UCYAVECQSL      FNOKHIW         QHAMNUNOC       OYQJDVJOHH     
AMATTFY         : VTDEUNU         KKNJUTKDVL      IDQTRKEM       
KGRCRGCBDNIPB   : SSHCHBBAQKJ     PWTGILMHOTC     WSMOGKDUUIDTPE 
ORFIPIQK        : TWGPFIJ         BSWBDI          GTKLYEMTFBYOOJ  YVHX            PVPXBMCOBA      FKSTYPELEDA     PMSRWUXIADSL   
QWLLTQ          : RQQCCWPMOQ      RUMUIFKAAMN     XGGOVHLLWPQ    
VDTQFNWHQCXYS   : XQNFHJVQA       EYAHAKO         UESUOQWFPVVL    XEBUJIPFSX      ERRCVGQLJ       NGPA           
KJQSSIBLTJ      : EFUFGNYU        NPFSD           GQRWMIVQBD      LAEOHOMNQNVDJN  IWKYRNNDCWMBISC
SUPMNDLRYCWMBHG : EFUFGNYU        RDDG            LEVUEVFIYR     
FFVGQIYLDI      : NWJOUGEYKF      SGPISJEBHHT     WFGPQQVTJSTND   DYGKPV         
OEVQYT          : CKLJBDKLQWGXQJ  NVXO            AUIOIXMKA       EYYUDWKOOWCS   
MHMAYN          : VFFCOGMVCSVK    RTYUSKLH        RBRXHENYPLIWVRN MWKDT           DKOYKKUDYXJ     MBNLONU        
YCDIII          : TPYCXRBCB       CYFCOHTHCMQXIE  VSXPLDIP        UNSDYJSRAJF     QIIXK           LGTV            UCNCU          
OFVHPWU         : FFKDDDQLM       DVRRK           YMCTE           HHSXAFYWQFMUWX  AQNBBDURHOVHD  
FHHLFA          : PPJOX          
YJXJXAKNELQJT   : DTLLUM          TWFC            GKNYDFWLS       DNBRLIMF       
RLRWHBOFV       : ERUGMJ          TENQIPSMA       FYDTBB         
MDOYLRMMDMV     : XDQMSYVWXOLM    ONLS            QFJNDI         
MHRQUKAPORBG    : QCCRQRPFHN      LWKIXNBX        WAEHNWXNGBO     ISFGBQRKFRXJU   EPHKAMMBHPX    
LIGSEQHKHIVYU   : BLWJBKHGDHJLPY  VDGJQPSQQ       FESFYJ          IQVRNSHVAO     
FHHJVQDMLQOBF   : SKAQTYGSTNDMR   ENKMGYC         ITCWQNBAE      
FLBS            : DPFFMQOFQVBNNT  VMBAFMTJLJPOJ   SVAAFEAIOJSAYAE QOGVEUULPSFQIIW
JLBAULIEJJY     : JQFSQJHBWQQDCKO AIVPGXKVAOP     OVCRAVRE        XLLLSJPJY       PPXPKUAJTTOO   
OJBAFREUEWJ     : SPNPNYLNMUF     BTQPFFYMS       APWCDECQMKWE   
CSOPVHMIUNIQBSW : NJUQTPWIRMTXK   LQUBXQ          UVOVOTOGLPIELRM IPIHWTOWXYHSL  
FVETHGWNADK     : VGQCIWRRYJBGGT  KYHEXJNQCKSPT   MHLTX          
ATOCPDTLN       : PTOBUYXP        NHFLMV          OINVRWRXW       VIGQHJ          TPPDAKPMOXXPM   HWGNDIGWITJSS  
TKTFBU          : VVNKOEIRXQBCJJ  CALKJSYDUXGXPHE YUXGNXCJA       EDRXCIUWONKQE  
AHFW            : CTUPCXYRDEHPVP  TVBSJIEA        TEUXOIDMFRJDIJI OXVDCXT        
CGUYVUC         : AQNBBDURHOVHD   STMYMWGSDDPEQKH DWYWGY         
CEBQ            : RWBLVWU        
QVCELJBW        : NEYTUP          UIFV           
GABIBIOAWSGRRDN : QLQI            MKPJOHBIJDBLHTM FUMNHX          LPQPIUJORUEURU  WKPEEMYXYKE    
LRCMIKFGMMSVNR  : VPMLQEJBBGE     LEKJWBDD        BYKFSFYQLT      UDQUWJLAYM      MARNOWULPIA     WRDR           
VTDEUNU         : NTRJBV          VSWXGVA         GMTRJOEKMFVMKRD SKOB            AMATTFY         IAKSSUKIUJQSGV 
LNEFH           : ECNVI           CDHKVFA        
UFWMHMWR        : WRNKYENDUKVP    RLKWLBY         XNLQNBPVUOKVSHE
EHGYFTSHR       : WPLAIU          HLKKHOAEKXVK    KUAE            ALCURJJXXJ      PVALH           HQQWBLHPFEUC    SYEBULBWHQ     
MWKDT           : HOAX            ICGTMLWPVDWXXJ  RVOHK           KGXDAPK         MHMAYN          NUXQJDOFXNW    
OINVRWRXW       : GEWDIP          HXMDCIAQY       ATOCPDTLN      
FJCABIHKJOGE    : UESUOQWFPVVL    OTYCKUM         YKVCHPXIEMV     QBOMMRQWGG      UYTQTAMCJNTOJG 
YQLXBQRJFCYEUY  : CNWCUGWCDGIYCLE YVGHJSXQI       NKITAM          DTPEHCGO        WYIBKFVCN      
SVAAFEAIOJSAYAE : DQPAJQWMXAC     DNODJP          FLBS            ALQOXGMMADE    
YXLWYDQKKTMOOL  : FQDWMONEJJYUAW  ISFGBQRKFRXJU   SGOVYNG        
HHNHMT          : MMHVA           NJUQTPWIRMTXK   NWNDK           QHAMNUNOC       BSMOVKMUGEC    
ULVO            : OJLQLIEDAUYDSA  JIJUESWCJNWSII 
WOSUPQ          : UPPSUEEM        INGDGJ          VGQCIWRRYJBGGT  KUAE            IQVRNSHVAO      BUYU            JQGOP           VSMALAMHHWA    
WOSUPQ          : TUBOAQOBDHJMF  
OROFF           : WXVTBRY         CLQHGGLBGMFSSE  XPQHJLPNU       KRITSAPOD       JBQQ           
BTQPFFYMS       : OJBAFREUEWJ     KHEGGOHJNG      UWXKITI        
YPTVDRKQPBL     : NUBRA           RTHP            IPVMA           GWLLVMYTME      AUIOIXMKA      
SEVJWMPEOSXHJF  : ADDFIHJPCDWNN   VAVSWOVOHN      SXILMBVTGPWBVLH QPVQBJJD        FHBQSB          TENQIPSMA       BSPFNWE        
KRITSAPOD       : SPNPNYLNMUF     OROFF           BSNFELWHVSP    
CVAFIMBMLKL     : EKIW            JIJSXMEGC      
CROVRXHW        : GEWDIP          ASHHWDEEJJQU    XPQHJLPNU       NBHY            ISCXMA         
TQXOJXGBDQFYS   : MNIAQSJ         ROVBUUDY        ERCJQWTLINWPFXK OPDUNC         
JGNWTB          : EKIW            CCTLPPPVBVX    
TDDLBUJIU       : NOCAGTHW        ISFGBQRKFRXJU   RCXCDPXFJ      
FLWV            : BAKCMSWOFYJ     VVYHE           DLAO           
UCYAVECQSL      : SUKKGKX         RJEK            YVGHJSXQI       RUAFU           FUOOFENIJ       LAKUUBKNG       TVHYFK         
HKSKVNNYYRVKC   : BNINHOGJRJ      RUMUIFKAAMN     WAEHNWXNGBO     TDQVMOJLODV     DWSJOM         
KHDHDBFIA       : FMJGHYKCLQ      RNLVLNETMESU    SUKKGKX         URDRPODCHQSSN   LAWUVPAQIGPROXC EIQWKAF         MVIOMFNWEDSMBHM LXAYHKGXW      
KHDHDBFIA       : RBBUX           YJNHFYBXI       PGMTOMVOYBBKW  
EGJWYV          : XOEFIQSSKKGB    DWNE            PJKJTFQQW       IHFBBK         
IGNUEDLDCDCNF   : TOGCFOW         YWDJ            PIGNK           EODWUEJ         XUJPK           TAGHATXSTHR     RCGCLMPMS      
XNVHQYMBBUHHEF  : BTYOFGPX        CUOCVYNV        HLBB           
CCTLPPPVBVX     : RSPGPPUDAOMFKL  JGNWTB          CXWBHGD         UHBKKEJIWSTVIA  GASTXLM         WEFDLFDJ       
XNLQNBPVUOKVSHE : DSCDNTFFML      UFWMHMWR        KRHRLPKEIGW    
OJLQLIEDAUYDSA  : VEHYPJGSHJXLFG  YIXUYASGXAC     ULVO            QMSFOHDEQL      YHWHPLT        
QPWJEYYCTQOP    : INLSHJHWAHBJWQ  VUWWM           COITEPMCCVQ     HWGNDIGWITJSS   RNVOTHIB       
WTLLFAEQ        : NEWYGAPBTQHQ    WTSRD           AGVDSFJ         WFMGABYSGESDYDL
LWKIXNBX        : HHUEBSBFNPQ     DYQI            GTKLYEMTFBYOOJ  MHRQUKAPORBG    RBFBEHA         AMEWMTMXI       KLYALMWTHCWWGQ  QYSLP          
ROVBUUDY        : TQXOJXGBDQFYS   LTNG            MVGO            KAPNNHWV       
TNHFMDSALS      : KJYBQUTAEUWWNCY KIVEWYVIPRBU   
CDSBNBABCAATOWW : WRNKYENDUKVP    IDDDIEECTMOT    FJSEU           DRODGR          RJBGUMXBKUUQR   ADQGXKVFPW      HKBETIDQFX     
TAKLV           : OADPYIFCF       UYIWJTGLXT      SDUOSPGX        FDYTSIGHKUIKDTT
SDNXWO          : WJHUILXPH       JBQQ            SXILMBVTGPWBVLH KEKGOFTHUWDHNR  NDBBOHMMBJJX    PRHIHPIYVXANMLB LJTHCBAXVLH    
PVOT            : QYOHLGCOUO      GSMATI          ANFA           
PHRRL           : MJLXTBXNNSWYOFX UDHJW           UYTQTAMCJNTOJG 
SLPHKOVHRISNJN  : MXGX           
ALQOXGMMADE     : ULHGEMASBP      YWDJ            SVAAFEAIOJSAYAE DLAO            MHLTX          
WWVSPJKYW       : ROCBCDJOIDH     SMQRWTVQUU      SYEBULBWHQ     
UEQGWHPM        : CNGILSGCUMBOBF  SVFAC           GKMEER          CLQHGGLBGMFSSE 
PXRGXAUKDARNWO  : MCEAGWFF        XKAGK           LXUDIFH         CXXJEHAWVXBQL  
PGWCFTCDAU      : LRMTHM          CJHDBELSUDVYA   KTDDWXTPP       BIOUVDAFBQ      LTHCXNORJ      
YEBLHRMBA       : HHPWJE          BKJWC           UFADPXGFVGDT    ROLB            CKLU            GCQIKTSHQTR    
CVXH            : RGHNDF          QWHSBWEYITQSR   LVOGMK          LGTV            CXWBHGD         KYPTFX          CJUNIOSU        PHXHP          
CVXH            : KTPUNPCAESDRKU 
PWTGILMHOTC     : AIVPGXKVAOP     KGRCRGCBDNIPB   SWHXSDYP        NUARYE         
WEPIEWKRECG     : FCDNL           TMDP           
ETMARTWJ        : TGIWTNBFOETOC   IPLOD           IVWUJJOT       
SPBGEIUX        : TDMFNDMCQBM     LABLMFSNKOI     YKVCHPXIEMV     NOLGITVPMASBNMV KJDSA           ORFEBC         
PVRIEXFQRL      : SQEKFNWPX       XNDUDNCYWV      TSVIUCFY        PAGHBLSBNUKY   
YVASIAMCY       : PHHVHTIJLEURD   KCXVMLJ         AGVDSFJ         NDBBOHMMBJJX   
STNVBTFXR       : PMHWQHNPHWQ     KPGYAQIQR       GRJKRCSOYFFUYFU
OPLYWJGNCRJD    : UFCLCH          RGHNDF          HPYNB           ORLI            EPHKAMMBHPX     HKTUWFXRCU     
LVYLICNGWHTTIN  : PCABBHPWMQYBIK  HBMWPQOAAG      TEMAUAHKMDVBDSK MODMVCGXYXMF   
HHSXAFYWQFMUWX  : PSINFXGDO       DUBHLPJFW       OPXLMUNRRX      OFVHPWU         QNTIVSV        
NJVPXERLKQUGMEV : EKQAUDNJU       WQBHJXSWSHM     ALSXVAF         RCUKXOB         NFEJBBOXWQGGP   RXKWL          
NGJNGOMDHRR     : QJHRASAYQTOAX   ARQRAKOJOONR    TWFAQFP        
QQDHAAWAGQLTJJ  : INRATYHXBXX     TWYKJVF         MGVRAV          UBDTRMFBR       DLRWTDAYY       TMYSRFOAYMQI   
WNYMDFVSNMFSUYK : TYEAGUX        
RBFBEHA         : QYXQVBY         LWKIXNBX        SMQRWTVQUU     
OQSKD           : PPJMPSGWFREOT   NQRAGSJIAEEIXW  JTGIQSFEKYN     ERRCVGQLJ      
MARNOWULPIA     : QDASSTSEOIJTLJ  LRCMIKFGMMSVNR  WYLETGSQYSK    
BWXMWPPFTT      : WKYMMAQU       
TBDNTNQXBSR     : UKDHNPFBLMWWK   VPBNL           FYDTBB         
HQMSGUTFWQ      : DKWMUFTJVQPT    WTCMMSJWJJWEG   DTHFUMINTCTBBKU
LQUBXQ          : CSOPVHMIUNIQBSW FNOKHIW        
MLYQYUGP        : CTIPOQWSD       VUHFNWGWSMCL    MJRYPIYXDJTTM   ABYGJNOASB      BOHGUY         
JIMBRDN         : FUDJHOK         BSIQ            AMINK          
LKJSJAXUSU      : BWNDJEOUVV      CDHKVFA        
SMWGXXYY        : PGTLJXR         NVXWMNX         SLAYARCYXMPKQTF DWSJOM         
FQPPBCSSH       : UDQUWJLAYM      JQKHKUSMBI      SEGUUMNGHTCFG   ESSPPTYRTBDNGM  KRQYSQGL       
GUSPNDSNANIYHUX : XYKPDCQ         JQGOP           HPPAN           NTMKQ          
UVOVOTOGLPIELRM : RNJWLHMEEJB     CSOPVHMIUNIQBSW ONLS            TGHJFABMYUNJTFK
OGKELFRLUDNCALR : IPVMA           MHLTX          
IITYDJ          : EYKQKWUKXVYLAFT UCNCU           AXRNYG          GMFNUWINXVW     TNYT           
OBQV            : NWOFDVN         GQRWMIVQBD      GTVBFIQMTOKO    ALVVWKPVGNE     CKLU            WTTMKABNKKECNC  DYKUVUB        
LIHAQTHEYYQTEEY : KYTJHCOMC       ARETOXVLUEMYHFB MTDQMDJJDMECU  
RSDACYCHIKX     : IDIBMRT         FQJE            LTIBIHHCHLHMY  
BTYOFGPX        : BTEE            XNVHQYMBBUHHEF  LFDMOPYDPBUTTXN
YDBXVXFCWKTR    : FOAIQYRRCGYSJBQ LOXITQEIXKDXB   ACCBDEGD        VDRGMMNGDSLRENW UNSPBTKOOUDPC  
WVOYDXL         : XEGTS           SGFM            TXNHE           RBBUX           LTHCXNORJ      
KMAJCFSTGSS     : SUKKGKX         DTGTEVXCBJLFGAJ
WSHUXLTKHLAEIPF : GEWDIP          IPAWHPMJMY      TYPOHEHRMBCGEX 
NQRAGSJIAEEIXW  : VLFHQNAGWJ      OQSKD           UENOUM          TCVGUOLE       
WRDR            : JAAPQG          BSIQ            YAFAHQF         LRCMIKFGMMSVNR  QEXJGCOLC      
OLDWYEDJ        : UPPSUEEM        FWIUBNHKCPFH    EBPELLJKHNH     XUJPK          
JXHCRJIKUSNA    : VSACQGMJBXB     TIROJ           RXIMYFETFSXQHTG
VAVSWOVOHN      : NWIOFUEMQYNCF   EKSUEOKKWKRJSVY SEVJWMPEOSXHJF  LHFEQVSDTYS    
KMBOPLIBLR      : XOEFIQSSKKGB    JMNLRHXFLF     
DBOQYIEYHC      : VPTSAYMQDAVDK   KLYALMWTHCWWGQ  URPQDL         
EUXST           : TDUPJQYYTJPOMW  OVXHV           OOYDJVUQGOBKRN 
CHQMTTELFOPQHV  : EFUFGNYU        UIBBGKKWXYVO    YVHX            ENMHUNJM       
KKNJUTKDVL      : GFVXMSTWVICULB  PATWSXURYWUUCC  AMATTFY         XJSGHBJWALCAIJ 
TLCNAE          : UDJJEWL         BXNYD           SBLMOPOVASFG   
SSQNYEUOTOVRLI  : JUUJYPYSFIREXY  ERUDO           UAVNTQ          MOHTXEWEIIO     CGAKUWY        
BUAUH           : KUBLBJTL        BNURGHWVYOTQC   SPUPNUXYP       LFDMOPYDPBUTTXN VUMRWMEYYU     
QTMKHQXIW       : TQQV            UKKHVYVAOIHKWSY
BQNQPUM         : JBPCEGTQSDOS    ETUIMRNDH       YVIILFMH        YYESCLMB        KLCBVEGOERNPFJJ
QDCJONOPIOKPUD  : BRPNHISXJXS     QIDXAABNXA      QJRTVABNU       OEYPWXSXSVAFI   LTHNVCDFSJKO   
JQTBQEXOH       : XOPNPOH         UAVNTQ          KHHCXOGNX      
CYHYNNQQSAH     : LFNKUJ         
QYOHLGCOUO      : KICNAWTQ        GCOBOCEVGFTHOKW MTDQMDJJDMECU   PVOT            SQHE           
QPYUNPEFTDOT    : INGDGJ          HWJXQDR         ULHGEMASBP      TTUHNBOXL      
CKLU            : YEBLHRMBA       OBQV            JURNKVCGM      
UBDTRMFBR       : NWNDK           MXPVPGEHSASUBMR QQDHAAWAGQLTJJ  ECYNT           DNGCFH         
XGGOVHLLWPQ     : MNIAQSJ         XYKPDCQ         PYGIQ           QWLLTQ          VPBNL          
VFLQKXDHKXL     : GMFNUWINXVW     MODMVCGXYXMF    MOFIK          
UDCC            : NYLJIDNCGNG     DYFMFGYKVLSI   
TYEAGUX         : OTYCKUM         YTXHHAF         KFEAPSGOVNRSB   WNYMDFVSNMFSUYK
GKNYDFWLS       : OADPYIFCF       SGNS            YJLRHAONI       UHHNLQHNTYBD    YJXJXAKNELQJT   WYLETGSQYSK    
VQQD            : UGSAVYCO        SSIS            BPYGMY          PMDCRXSF        JRIFBEYRHIEI    KLCBVEGOERNPFJJ
RQUOWWQDTQKV    : CGAD            VSPCAKFYNSIBY  
FUOOFENIJ       : RSCNVSA         HNGEMWAMMIT     NKITAM          UCYAVECQSL      XKAGK           BFOWT           UYTQTAMCJNTOJG 
TEAR            : COPBBGDNEJP    
TXCNOWCL        : BMNBXJWCOBYRPX  QMOV            DPGDJ           JDEKK           TMULPEROM       YOOSEUYC        EXXQ           
SPQLC           : EIQGCCVAVM      BUYU            QBDFUDHGXGCMNUH
KHHCXOGNX       : YJLRHAONI       JQTBQEXOH       MBECJXNCPPLPROF
ATWBM           : YTVWNB          SCYOA           CKMEJWK         YVNVNII        
UKYIBWMNTFFKRH  : XAWGGWBTAPEG    CTRBLVQSCAY     KXCO           
EQHGPVP         : JMWCPI          NUBRA           ALVVWKPVGNE    
VIGQHJ          : VSWXGVA         ATOCPDTLN       OLPDPMYHUUR    
EGPEOS          : URDRPODCHQSSN   UBDQSVFNBTUFA   EJAYTUWHJH     
DGWIL           : ICUBUFBTTHG     AHLNHNQH        PRHIHPIYVXANMLB HUMMYRLRJSCRJK 
AUGFMPN         : USCDEWROQVPEGX  COHJLGBPIYS    
MDJINRB         : NWJOUGEYKF      LHLANB          RBBUX           JTGIQSFEKYN     FAYTI           GLNFYVVT       
BGCH            : VDRGMMNGDSLRENW JBBXLIYB        LTTQQFAX        PGMTOMVOYBBKW   NGPA           
GXRJBXGKMNM     : NSXRWJFSBAWMMHJ VTRG            KKXBX           HLBB           
WTTMKABNKKECNC  : OBQV            YTGQKTGE        OXBEEMETT      
UENSLOMWPNEC    : JURNKVCGM       HWDPSVON        KADYAGFE       
TRJQLEGVGHM     : XIWURWJUDX      EMLPPLGADW      GNPLGYDRKLJYHSB
TSVIUCFY        : COLKGWXSPH      IJHHQWSKK       DRLOVQFVBVWSN   BOSMPMMBCSA     VRCCMEDWPMR     PVRIEXFQRL      MBISFTHTIHQH   
AMINK           : JIMBRDN         SOVIOAYUWEN     FYCP           
BODDKUMCJSKFA   : JXEIJSE         RVOHK           WYLETGSQYSK    
TSOMOYHSEJNEVVT : TXFIUJXGAEYBKH  RNKPE           DOEDOCIXMKSKR   KYPTFX          UMPST          
WUWDAIXNMHGYPG  : KPGYAQIQR       GNGDW          
LAJYQIIMOTCTQA  : SPUPNUXYP      
BXNYD           : WCHXXKXSC       VUWWM           TLCNAE          RNVOTHIB       
JBBXLIYB        : EHSLJCF         BGCH            RJBN           
RMSCNMMYBCSDXL  : LERFUKHKMAHHB   AFYSREDFFYH     SSHCHBBAQKJ    
NNFBOIPAKS      : XGSBXG          OTWIJRNSB       ELFRUUS        
VBYYUQNNUEAIF   : UMAGBYK         RJSMHTEKBHWF    OAFYAILQJYDG    VIDSOFOHSE     
MXGKMMACRCQB    : LBHLQXGBJK      FJFQYDE         EWKNBUPJDNBKLO  OYQJDVJOHH      PLNHCLVFYUOYK  
SNMSLQRML       : FLNMERQCCFCCJ   QSFPJ           MUWESABKJG      QRFOFKQ        
CBGGC           : MYUU            VRCCMEDWPMR     IUVFNG          WOTEWCKBC      
LFDMOPYDPBUTTXN : SYDGGMQ         QEFBPCB         VWDDFVDBSV      BTYOFGPX        BUAUH           AMEWMTMXI      
NBHY            : OEAIW           IWKYRNNDCWMBISC CROVRXHW       
YLFJQGRWKILSNAH : FUMNHX          HLBOTYBJG       PTOBUYXP       
YKVCHPXIEMV     : YBJDARHMLJHOW   EGANXFFPAGLA    PRPXRTMVG       NHFLMV          FJCABIHKJOGE    SPBGEIUX        NGPA           
TVBSJIEA        : ATSFQTEFIVEWY   AHFW           
WAEHNWXNGBO     : HPYNB           PYRHWTWWFNIQ    MHRQUKAPORBG    HKSKVNNYYRVKC  
WQCPOKTBH       : WCRHWQBWDE      BPQGMTWA        DMHRBVB         AGWR            LJTHCBAXVLH     CDJAPBERQNN    
WFGPQQVTJSTND   : XEBUJIPFSX      FFVGQIYLDI      JDFUBAULFMM     KGPAFAO         KYHEXJNQCKSPT  
MBWUELN         : DAFMPQFHOKIRGPX GQRWMIVQBD      PMDCRXSF        SXGYPEKXBDNWUSK VKPDAOHVL      
ESTUDPXMSURB    : PCABBHPWMQYBIK  MHLTX           UIVMG          
JRIFBEYRHIEI    : VQQD            ETVJGXXP        VGNH            QRFOFKQ        
COSRSYKMTOCRDW  : COLKGWXSPH      IXQTJHYWB       AFYSREDFFYH     DEFKEXSODLOU    TXDKRG         
VABHR           : XYWQG           PGDXOVKDWMMCRVJ PATWSXURYWUUCC  GERCKEWESD      DSYHXOE         NSLUXEI         HARMO           RAMHTODXQ      
MVNNNUXTFHV     : SSIS            DIODDRRMOROIBGH JOTIKQKTP      
AQNBBDURHOVHD   : OFVHPWU         CGUYVUC         EPHKAMMBHPX    
HEDCPPXEFNBFJJ  : MJOKRRVDA       YXPCP           NWNDK           JQGOP          
IGOYVPAYM       : QYXQVBY         ONLS           
JBQQ            : QMOV            FWIUBNHKCPFH    OROFF           SDNXWO          IUVFNG          MSBI           
KAMN            : XOEFIQSSKKGB    ERUGMJ          EDVDBMYV       
CFCIMRMRCV      : DPXJ            DYQI            JFCQOWYETJDEKMN NOCAGTHW       
MCUL            : SVDNOTFCTNRYKV  DWBNCTFFDYCQW   EQSXPCWTXEXSGVU
KNAWIJAB        : VFFCOGMVCSVK    NYLJIDNCGNG     SVFAC           KYPTFX          JURNKVCGM      
ILCUBHYILIW     : UAVNTQ         
UOISUUWPI       : ITCWQNBAE       EBPELLJKHNH     XTUUTJ          FTXOWH         
CXWBHGD         : JUUJYPYSFIREXY  OHSMAWVFIVATXD  JAAPQG          CCTLPPPVBVX     CVXH           
KLWPGAWG        : IWJOQA          PHTHKYL        
KQIONA          : NKEQTGVE        UHYXUBXRAHBM   
IUVFNG          : XNDUDNCYWV      CBGGC           JBQQ            BSPFNWE        
RFATOGWYTLVJR   : EODWUEJ         OTWIJRNSB       IDKA            DBNJNDLWLCJ     LFNKUJ         
IAKSSUKIUJQSGV  : UJGXXAC         VTDEUNU         MXGX            SYEBULBWHQ     
MYATYTIHTIBFGK  : WCHXXKXSC       XIWURWJUDX      PVALH           LDUONPVCCP      QBOMMRQWGG      LYLOSXJWEVSMKPY UGIBTWGDITIJ    KAPNNHWV       
MYATYTIHTIBFGK  : PWQPFXTA       
HUCROUPYEKKWDQT : HGQV            IFGM            SXNDYGWQGCFG    FYAMB           WHAXKEDKSUR    
GSMATI          : SRQPDQSMVTGDG   GCOBOCEVGFTHOKW FLEH            HVFIHQFDY       PVOT            TLSAMOHLDVWWUPH JXOXAMSGEPKA   
BETDJCPLKN      : TELBTPLF        RXCFQUKNYFRLEA  MOFIK          
CCKTD           : LFKEOXFUJV      XWVEGJEQFCSPPB  JTGIQSFEKYN     ORFEBC         
FNOKHIW         : CSVSYSNDFQEHSYC PMDCRXSF        RUAFU           LQUBXQ          LTNG            JGHBFCBQ       
DLRWTDAYY       : DLJAJJYJILIQB   QQDHAAWAGQLTJJ  KLYALMWTHCWWGQ 
KCXVMLJ         : LGTV            YVASIAMCY       YDYDPRQ        
PWLUNQ          : YEGHISGYRBLODHJ MEDP            EPJVINO         OSLRYJEFLQEY    YUOCLEXKD       ESROVNAKWJ      FRRYQRJQFSY    
CDTKAJ          : KUBLBJTL        TWYKJVF         EYDDHL          HYOSMV         
NEOIHRJJWV      : PHHVHTIJLEURD   YMCTE           FIOQOVCRMXKA   
USXIEQXBCUPUGTY : XLIVKMKMQFGL    LCYVTG          RYGFT           ITCWQNBAE       FMEADVF         IERLDR         
HBMWPQOAAG      : LVYLICNGWHTTIN  MKYE            ONHCMEQELRV    
JDFUBAULFMM     : WFGPQQVTJSTND   QRFOFKQ        
QHAMNUNOC       : RUAFU           HHNHMT          CXSGJEGAYQNKQS  DYKUVUB        
DBETP           : VPMLQEJBBGE    
TVPECXBFXWQFLDQ : EFUFGNYU        XJGIITHAHV      VBNMOQUJV      
LQQBLERPVU      : CNWCUGWCDGIYCLE VBNMOQUJV       YMGY           
COHJLGBPIYS     : HAMIIMLV        XIWURWJUDX      AUGFMPN         LLWTUOADQCBPMXY
ARGFDMVIANYBBGV : MXPVPGEHSASUBMR KNKPSQWEWWWND   AFVAJIGDB      
EQJGGSPTYRL     : HVOAO           IHCJONRJSTKNFVK JRNTTSOGISONYB  IEDPBDQNUYWRRF  ECYNT           BOMN           
SEBSWKBC        : TWGPFIJ         HWOOVICHIMQBN   VRCCMEDWPMR    
WKYMMAQU        : BWXMWPPFTT      JIJUESWCJNWSII 
KYPTFX          : CVXH            TSOMOYHSEJNEVVT KNAWIJAB       
XRQRD           : IDKA            SXILMBVTGPWBVLH NRVLNIVR       
KHEGGOHJNG      : ESFCEIXJFV      ARETOXVLUEMYHFB SLAYARCYXMPKQTF BTQPFFYMS       UJHXMAVRRP      FTXOWH          RXIMYFETFSXQHTG
MVIOMFNWEDSMBHM : MNIAQSJ         EHSLJCF         KHDHDBFIA       MBNLONU         OURXALCJOPVG   
AGVDSFJ         : COLKGWXSPH      FPCJJGVPFBJLUTH WTLLFAEQ        YVASIAMCY       VLDWRKWIANVGW   SNAPACR         TMWQYTPTFNM     KSKSCUFYAXX    
MXGX            : PTOBUYXP        KUAE            NHGXPCYEUPCSX   SLPHKOVHRISNJN  IAKSSUKIUJQSGV 
PVALH           : EHFOLSDJHAU     EHGYFTSHR       MYATYTIHTIBFGK  OYQJDVJOHH     
XMCWRFPGIYSBC   : CVXDJEJTNKIE   
YFTFQTTOCTE     : OISULR         
PEFWUFKACE      : SGFM            LOOAUYGXVHUYXY  EULOQPMSOWGRP  
TKQTFRVGTDAYTVU : VSACQGMJBXB     GTVBFIQMTOKO    MJLXTBXNNSWYOFX EIQGCCVAVM     
YOOSEUYC        : FLNMERQCCFCCJ   JQFSQJHBWQQDCKO URWFRLGR        FCDNL           TXCNOWCL        BWWHK           DNBRLIMF        DNGCFH         
GORJS           : DQYUPESJFWLHAY  BRPNHISXJXS     VDGJQPSQQ       RVRLL           XOEFIQSSKKGB    CXDCR           MYUU            UWXKITI        
DFQYMKWS        : QCCRQRPFHN      DKOYKKUDYXJ     NQJRHHCNAQSRBM  UVVGQRMBUIA    
CUFVTAIS        : GOJQ            LYLOSXJWEVSMKPY WNAPLOFVVK     
WNTTOXMVMEFHEK  : IPVMA          
WKYKJTOMQUKKWT  : SPNPNYLNMUF     RXJCHBF         HQQWBLHPFEUC   
MSTINIICGW      : RSCNVSA         OLFCTJPXTNVFVO  IGDRYDH         ERGVVTA         AWGUASMFJPGOCL 
NENYQMLRWWLM    : AIVPGXKVAOP     NKEQTGVE        HUIDVUD         EGNUHX          DCUFT          
CJUNIOSU        : UYIWJTGLXT      NQGE            WXEWM           XPQHJLPNU       CVXH           
OFWANYGKI       : TEGNBSJJMCY     GMTRJOEKMFVMKRD OEWJFVLQIHFOF  
QVVHIJBIGMWSRIN : MUGHN           ELVIFGCVUEYFLF  HNQJLXGWLFKKBYQ
QECONRT         : NAXBPFOSNJ      YENVYM          UFVPBLGUMOAOH  
RKMAWWWOUUXGGA  : UYIWJTGLXT      RQQCCWPMOQ      BFOWT          
NOLGITVPMASBNMV : SAFYBMDATHPECWG SPBGEIUX        EMMBBCHVHWKMIGJ
GISIFP          : WTSRD           QYSLP          
VLDWRKWIANVGW   : HLBOTYBJG       EODWUEJ         AGVDSFJ         RJBN           
EOEEJGTVEXE     : RNPVEJKXOSSQAQ  EMLPPLGADW      KFEAPSGOVNRSB   VDRGMMNGDSLRENW SQGOAVGJDMGGPU 
QNTIVSV         : DYQI            PGDXOVKDWMMCRVJ HHSXAFYWQFMUWX  DTHFUMINTCTBBKU
PPJOX           : FWIUBNHKCPFH    FHHLFA          MVNEURHVO       HXURPYMGY      
CTRBLVQSCAY     : EKQAUDNJU       EKSUEOKKWKRJSVY UKYIBWMNTFFKRH 
YDYDPRQ         : NVFORLMUEEXQFI  KCXVMLJ         JFCQOWYETJDEKMN
AMEWMTMXI       : LWKIXNBX        LFDMOPYDPBUTTXN KLCBVEGOERNPFJJ HWDPSVON        LQNEDDJ         FDYTSIGHKUIKDTT
KNJEOXDHQFIPGJU : RNLVLNETMESU    SUTEKUOBNEW     VRSWQJE         BGXUTILYGOQOCJG
MKYE            : EKSUEOKKWKRJSVY BQLPGJY         HBMWPQOAAG     
CSDBHWPGIFSX    : NQAEJOMM        YLFCNEHXVLGSE   CFKT            WAHY           
WONAW           : ANFA            SIWBBCAM        RMYJDGOLB      
IHVQQQYDDAJB    : UKWCVULTBL      ERUDO           BMTCCPKUUTTM    KEKGOFTHUWDHNR 
DEFKEXSODLOU    : WBPLB           COSRSYKMTOCRDW  TXDKRG          BWWHK          
DIJAORHMJXDKE   : TXFIUJXGAEYBKH  RBRXHENYPLIWVRN CCXXYATKB      
KNKPSQWEWWWND   : CVKLPPCTU       FWIUBNHKCPFH    QDXDFQJOKJI     ARGFDMVIANYBBGV GMFNUWINXVW     FYDTBB         
CXSGJEGAYQNKQS  : BMNBXJWCOBYRPX  CTIPOQWSD       QHAMNUNOC       NQKFRMPMJ       DLAO            LLKVVQMKJTTM    WBTHYEWMAITRCV 
UCHLOWEFWKFVI   : GQNDBNDYNSKMHK  SKAXODKJDCL     QBDFUDHGXGCMNUH GLNFYVVT       
YTVAOCJSKJTDYE  : DFLGIBYVAMSIO   LERFUKHKMAHHB   WEFDLFDJ       
UBRWJFLIMSHWX   : ODIS           
FTDBRDPVOLGBFMA : GCOBOCEVGFTHOKW
HUNBTWJHIV      : INRATYHXBXX     HLKKHOAEKXVK    OPXLMUNRRX      DOHV           
PSBTYWAAOFSK    : WIXWBFIACIGAUL  CMYKAXSYSHEFC   VPBNL           YPPJFWULGNO    
ETVJGXXP        : INLSHJHWAHBJWQ  JRIFBEYRHIEI    SKHFFTUYNU      RAECFMSSN       KADYAGFE       
MSRLC           : BNINHOGJRJ      CGAD            NKITAM          OCCQUKV        
TXDKRG          : ORDW            COSRSYKMTOCRDW  DEFKEXSODLOU   
SEGUUMNGHTCFG   : AKEKERU         FQPPBCSSH       EYYUDWKOOWCS    UFPT           
FEXBQST         : KJDSA           JOAUABJAMNDYX  
VVYTYLNH        : USYQPIWIJFMRBY  TTCEDXLDVUQNTMP PATWSXURYWUUCC  KADYAGFE        DMIPC          
INYEJNT         : TWFC            SAGTQVTJAFB     UPMPHXKNIWKQ   
WOTEWCKBC       : XGSBXG          CBGGC           QDYRANS         WJULRQJF        DCUFT          
SWHXSDYP        : FFKDDDQLM       INLSHJHWAHBJWQ  PWTGILMHOTC    
LFKEOXFUJV      : USYQPIWIJFMRBY  CCKTD           NKGH            FMKTOX          LKFCSBROUN     
BSFUXCYIEDVYB   : VPMLQEJBBGE     CXDCR           LWVOB           NMDJ           
YVHX            : BDBSFYBRDLLOC   ORFIPIQK        CHQMTTELFOPQHV  VGNH            CLAFIANYKHFPRSX ULXQYGGX       
MJRYPIYXDJTTM   : MLYQYUGP        EULOQPMSOWGRP   PMSRWUXIADSL   
CKMEJWK         : ATWBM           QEQTFWAWNUAT   
TLSAMOHLDVWWUPH : GCOBOCEVGFTHOKW GSMATI          PEDGOFRKMSHCRRS
NKGH            : TCNRCAE         PJFTHXLWQAXC    LFKEOXFUJV      SCVNYOGTUIU     LLKVVQMKJTTM   
SVGDJNPIAHCOC   : LDTDWWTRKQUIXOD LOXITQEIXKDXB   TGCJUD          WIUXSFEFN      
BSMOVKMUGEC     : HMLWV           HHNHMT         
ROLB            : CAJIBXPWKSHYQQR FCXCSUNQ        VPEPWHSMYIVD    RCUKXOB         EXXQ            UNSPBTKOOUDPC  
GWCMIR          : GRHTPWPWLXTF    JWRQGUEC        VMTCUF          UWNTQPYTYWELTH  NSXRWJFSBAWMMHJ BSNFELWHVSP     LHFEQVSDTYS    
RULVJN          : USCDEWROQVPEGX  DAXNLSSGVDSL    NXASU          
KGPAFAO         : BPYGMY          LAWUVPAQIGPROXC WFGPQQVTJSTND   WFJQFL         
ISFL            : BQLPGJY         NQUPQFSNGXEQIC 
TYNPGKUSVOW     : NBMW            YKVVCF          KLTYBBYISRNVDOV
JIJSXMEGC       : CVAFIMBMLKL     VTRG            QMSFOHDEQL     
LDUONPVCCP      : BLWJBKHGDHJLPY  ALWUPIXD        PJFTHXLWQAXC    MYATYTIHTIBFGK  ADFYCQMABNCRC   UOIMVUPKH      
PIHCFAXVWLGHX   : WCHXXKXSC       KCRHBHIFUDAYU   PTWUMWSPP       DOQPOCUMWGVUF   ORFEBC         
FKFMP           : JMWCPI          WOITEXY         QEXJGCOLC      
AUIOIXMKA       : OEVQYT          YPTVDRKQPBL     RCXCDPXFJ       LTTQQFAX       
MRNVUUYS        : UCNCU           LTTQQFAX        QFJNDI         
VHYGHB          : PSINFXGDO       QUVXLLLRKOJUA   WPYKXXHLG       EMMBBCHVHWKMIGJ
TGCJUD          : FURNB           PULFFHPPIPKSL   SVGDJNPIAHCOC   EDRXCIUWONKQE   UOIMVUPKH       EFKJMVM        
DTPEHCGO        : UEVHXLKPSKRBTL  YQLXBQRJFCYEUY  EEBLNBBPFBXEHF 
YENVYM          : XOUJRLF         NQGE            QECONRT         SQGOAVGJDMGGPU  CDLYXNO         FHBQSB         
RKXRSHSHC       : TOGCFOW         NHFLMV         
JNVOUCLMI       : JEDBWL          LTTQQFAX       
OOJIPNVN        : JDEKK           MOFIK          
KFGWFA          : KUBLBJTL        XYKPDCQ        
NSXRWJFSBAWMMHJ : ICGTMLWPVDWXXJ  UEVHXLKPSKRBTL  GXRJBXGKMNM     GWCMIR         
WSMOGKDUUIDTPE  : ARETOXVLUEMYHFB KGRCRGCBDNIPB   VPBNL           HKBETIDQFX     
DYKUVUB         : PIGMST          OBQV            QHAMNUNOC       RDDG           
XDQMSYVWXOLM    : SGMXVLPXEACSLU  CYFCOHTHCMQXIE  DTLLUM          BPYGMY          MDOYLRMMDMV    
VPTSAYMQDAVDK   : VOBDQXXQPVJP    DBOQYIEYHC      UIQH            NQJRHHCNAQSRBM 
BHUSFAKRSJNR    : VQMMEOGKQJKXJT  NVFORLMUEEXQFI  PEDGOFRKMSHCRRS HYOSMV         
EDVDBMYV        : EKQAUDNJU       FSNVU           KAMN            TMWQYTPTFNM     YILHUDP        
YLFCNEHXVLGSE   : QWHSBWEYITQSR   OEAIW           CSDBHWPGIFSX    SUKCSMPSTBY     JTGIQSFEKYN     GTPSRUJOEN     
SQGOAVGJDMGGPU  : QOUTU           RYGFT           EOEEJGTVEXE     YENVYM          QJRTVABNU       BFOWT          
OLFCTJPXTNVFVO  : MSTINIICGW      VBWBVTWCWV      PVPXBMCOBA     
KJDSA           : PGDXOVKDWMMCRVJ SPBGEIUX        FEXBQST         LTHNVCDFSJKO   
QJRTVABNU       : LVOGMK          QDCJONOPIOKPUD  SQGOAVGJDMGGPU  HIQLCGEJPNHVCN  NATHEU         
EIQGCCVAVM      : SPQLC           TKQTFRVGTDAYTVU KRHRLPKEIGW     HUIDVUD         JDYEGBDFYJLJNF 
DIMRUYUN        : XNMCAHYDFBFS    DOHV            AENYG          
CFKT            : BRPNHISXJXS     MTDQMDJJDMECU   CSDBHWPGIFSX    SVTGDXXHLTWKWH  LWVOB          
ITCWQNBAE       : RQQCCWPMOQ      FHHJVQDMLQOBF   UOISUUWPI       USXIEQXBCUPUGTY DWSJOM         
EJGFFSDL        : IHGOOUEVHELH    EGNUHX         
QDYRANS         : FWIUBNHKCPFH    BSWBDI          NSLUXEI         WOTEWCKBC       YIBIH           AOYADMWOODPKL  
UEYV            : WEBV            PRHIHPIYVXANMLB
SBLMOPOVASFG    : QLQI            MEDP            HNGEMWAMMIT     TLCNAE          TWUNH          
MCEAGWFF        : HCOBQBQBP       PXRGXAUKDARNWO  BFOWT          
FUHKRNJOBEROQIE : XRAK            BLRDHW         
EEBLNBBPFBXEHF  : KICNAWTQ        DRLOVQFVBVWSN   DTPEHCGO        IJPXYS          DGPDHHSBDQQ     GMFNUWINXVW     AGGD           
ODDYUSI         : FCXCSUNQ        LWVGGLXUVKXW    QWMJMPKOGRDUVO 
VNDLG           : KADYAGFE       
POSWPHKSICBLA   : LEKJWBDD       
UHBKKEJIWSTVIA  : CJGAXJWCRYUAO   NQCCMEIF        UXLR            CCTLPPPVBVX     WYLETGSQYSK     FSEJSANSATQK   
OOYDJVUQGOBKRN  : EUXST           SCNFEJSABPOSTQW ISYVOHQS       
WIUXSFEFN       : RNPVEJKXOSSQAQ  NSLUXEI         DMJAEL          SVGDJNPIAHCOC   HXURPYMGY      
XKAGK           : HOAX            TPYCXRBCB       KPGYAQIQR       PXRGXAUKDARNWO  FUOOFENIJ       KEHHTV         
WYIBKFVCN       : KYDOND          IJFCELTJR       LGTV            YQLXBQRJFCYEUY  TDQVMOJLODV    
FYGSL           : OUYA            MDVAYJXBHHXJOSW GJBLLRTDPUYE   
EGEYOLEC        : VKJVQEMXQSUMDY  GKUOFRGWILJF   
EMTMYD          : EBWQ            UHYXUBXRAHBM    AFYSREDFFYH    
XLLLSJPJY       : FNVQAS          RJEK            QMVNDMEADCGVR   JLBAULIEJJY     YXMBCL          TUBOAQOBDHJMF  
IFQVLU          : CYFCOHTHCMQXIE  EAHVSACC        FESFYJ          RCXCDPXFJ       ORFEBC         
SVTGDXXHLTWKWH  : CFKT            QJTDTMQAJYT     TMWQYTPTFNM    
KUYGGOPFJXN     : GTRV           
VBWBVTWCWV      : WQBHJXSWSHM     IPUAE           OLFCTJPXTNVFVO  NEQHMYEIOH     
GHVDTUK         : CJAAOKPP        QCPIXHDTAATJX   EJYNYEPYPU      QOVWBXDN        RHCPEAVW        RNVOTHIB       
IHGOOUEVHELH    : EJGFFSDL        NXASU           XOMMAXHJRSBCA   OAFYAILQJYDG   
NFEJBBOXWQGGP   : NJVPXERLKQUGMEV IANE            IDQTRKEM        NTMKQ          
DKWMUFTJVQPT    : HQMSGUTFWQ      DWKDSLQJFFRBU   QPEQRYLE        MWHGUXD         ERRCVGQLJ      
TGIWTNBFOETOC   : PPJMPSGWFREOT   XNMCAHYDFBFS    ETMARTWJ        YIBIH           PVPXBMCOBA     
UKDHNPFBLMWWK   : YBJDARHMLJHOW   FYDFFIBL        HNGEMWAMMIT     TBDNTNQXBSR    
NEQHMYEIOH      : SFWWCWNNSKJ     VBWBVTWCWV      NWMYNR          RAMHTODXQ      
FMKTOX          : EXCDHQXHCRTLPS  LFKEOXFUJV      UKKHVYVAOIHKWSY
BBBPTISFWRCHHPN : RQEREJXQSYHOK   VDGJQPSQQ      
ABYGJNOASB      : QFVYJ           MLYQYUGP        UIQH            MVLROLXQQKLMBH  FYCP            UWXKITI        
ORLI            : VFFCOGMVCSVK    OTYCKUM         OPLYWJGNCRJD    DLRCOE          VDNFCHSAYOHH   
PJKJTFQQW       : JOVJQMXSLC      SGNS            OUYA            EGJWYV          UIVMG          
AHLNHNQH        : JMWCPI          VWDDFVDBSV      DGWIL           MGTJSRAHXYB    
DWKDSLQJFFRBU   : BOXATLVUJ       UFADPXGFVGDT    BAKCMSWOFYJ     MWYW            QRIPHUKOIKDRH   DKWMUFTJVQPT   
NEYTUP          : JCATQJMFKLDPTA  TPYCXRBCB       OQJOMW          VHNQYTAVRCMLUPV QVCELJBW        FDYTSIGHKUIKDTT
PPADGKSYTN      : MLFUM           PQVYNALQJIVK   
SXILMBVTGPWBVLH : YIITJD          SEVJWMPEOSXHJF  SDNXWO          XRQRD           KLYALMWTHCWWGQ  YPPJFWULGNO     BOHGUY          HQDMEGPOYD     
SXILMBVTGPWBVLH : MCDCWL         
HENAWDDCLNVLJJN : BOXATLVUJ       ELVIFGCVUEYFLF 
JXOXAMSGEPKA    : GSMATI          FYAMB          
RXKWL           : GVHNBKPTDFNXJ   UDJJEWL         NJVPXERLKQUGMEV
TQQV            : VBLIFCORSAF     QTMKHQXIW       UIQH            LTHNVCDFSJKO   
GROPDERPDIPD    : FSEJSANSATQK    YILHUDP        
KLCBVEGOERNPFJJ : BQNQPUM         VQQD            AMEWMTMXI       DBNJNDLWLCJ     UPEJXMFYRVDSL  
FMEADVF         : USXIEQXBCUPUGTY
NWMYNR          : XOVTDWRBKF      NHSHFYY         SWWAWXVKYIPM    NEQHMYEIOH      BXAG           
XEAB            : UFCLCH          MWKMFRA         SUKCSMPSTBY    
HIQLCGEJPNHVCN  : QXDQXAECRY      QJRTVABNU       KLTYBBYISRNVDOV
FJFQYDE         : SQEKFNWPX       MXGKMMACRCQB   
SXWSCWUFEFXQJF  : GOQY            LMQQUCQIJCSGFVL JQKHKUSMBI      OIFQXKC         TMDP           
SUKCSMPSTBY     : DSCDNTFFML      YLFCNEHXVLGSE   XEAB            KXCO            BNXJ           
AEQYW           : EIEAEEPFHLYDLR  ERCJQWTLINWPFXK
XPTUMBCRAUBHRV  : SJEVSU          JTGIQSFEKYN    
EXXQ            : UYBJIEYBYKHAJH  PDRH            ILRACJCMBNDRCU  TXCNOWCL        ROLB           
SMQRWTVQUU      : SGFM            WWVSPJKYW       RBFBEHA         QMSFOHDEQL      CBLPYI          JIJUESWCJNWSII 
SNAPACR         : JCATQJMFKLDPTA  FKGUV           AGVDSFJ         LLKVVQMKJTTM   
EOVLIUPMUPFLJ   : LAJJAACKOTF     IJHHQWSKK      
EDRXCIUWONKQE   : HAWEW           TKTFBU          TGCJUD          GJBLLRTDPUYE    CCXXYATKB       GTKYWAGBLBB    
SXGYPEKXBDNWUSK : MBWUELN         TTMTAKNT       
NQKFRMPMJ       : CXSGJEGAYQNKQS  RBBUX           JURNKVCGM       RHCPEAVW        JVIBA           WHAXKEDKSUR    
BWWHK           : OUYA            DJGYRNKAI       YOOSEUYC        DEFKEXSODLOU    DWSJOM         
HSRWWFXBILXFEKK : CALKJSYDUXGXPHE WTSRD           WDTPYOKI       
BUYU            : WXYVE           WOSUPQ          SPQLC          
OISULR          : TDUPJQYYTJPOMW  ATYJEKS         YFTFQTTOCTE     CCSMXJF        
UCNCU           : YCDIII          IITYDJ          MRNVUUYS       
CUOCVYNV        : EKSUEOKKWKRJSVY XNVHQYMBBUHHEF 
TIROJ           : RWBLVWU         EYQHXTFCGQPB    NWNDK           JXHCRJIKUSNA    OEWJFVLQIHFOF   YJNHFYBXI      
PHXHP           : XMNT            IEDPBDQNUYWRRF  CVXH            FAYTI          
CDLYXNO         : YENVYM         
LWGGNI          : XLIVKMKMQFGL    RSPGPPUDAOMFKL  UKKHVYVAOIHKWSY VPBNL          
NXASU           : KWYPGTYBFXO     MDVAYJXBHHXJOSW RULVJN          IHGOOUEVHELH   
KLTYBBYISRNVDOV : KVOIJOHEMWH     TYNPGKUSVOW     HIQLCGEJPNHVCN  FBOYCDWUE      
EYDDHL          : KUFMYPKGWJXI    AWKRCSGUJLMFOCT CDTKAJ          TTAKMHNKPN      HWGNDIGWITJSS   TTOSOQWKL       KXCO           
QPEQRYLE        : AYCFLC          DKWMUFTJVQPT    FSEJSANSATQK   
YXMBCL          : ADWDVMTMIXSCR   ROLB            XLLLSJPJY      
WEBV            : EKSUEOKKWKRJSVY RQEREJXQSYHOK   YTXHHAF         QSFPJ           LAEOHOMNQNVDJN  UYPCEPUQCGHFC   UEYV            EPHKAMMBHPX    
QRDWSGABTQTL    : JBPCEGTQSDOS    QJHRASAYQTOAX  
KFYYJLXKAB      : OMDDLNVMVI      LAUFDQAWDSCWMY  OTWIJRNSB       ULXQYGGX       
ONLS            : ENCENYAT        KHSCPW          MDOYLRMMDMV     UVOVOTOGLPIELRM IGOYVPAYM       RFGUL          
HEJCIGUQGVLAP   : QLQI            RLEIMTNLGIVQ    UIBBGKKWXYVO    GQRWMIVQBD     
ADFYCQMABNCRC   : RGHNDF          SVFAC           LDUONPVCCP     
EWKNBUPJDNBKLO  : KFNNVYBYK       RVRLL           WIXWBFIACIGAUL  MXGKMMACRCQB   
ENMHUNJM        : WXEWM           CHQMTTELFOPQHV  FRRYQRJQFSY    
LPQPIUJORUEURU  : BNURGHWVYOTQC   GABIBIOAWSGRRDN
UKKHVYVAOIHKWSY : TXFIUJXGAEYBKH  QTMKHQXIW       FMKTOX          LWGGNI          JDYEGBDFYJLJNF  DHKUKYHWQ       KADYAGFE       
HQQWBLHPFEUC    : NYLJIDNCGNG     VWCUM           BXJHAAUTEADD    YGCSNJFYELSJYS  EHGYFTSHR       WKYKJTOMQUKKWT 
RJSCVDXUYBM     : YYESCLMB        ADWDVMTMIXSCR   HGPADOEU        NRVLNIVR       
KYHEXJNQCKSPT   : WDTPYOKI        FVETHGWNADK     WFGPQQVTJSTND  
WAHY            : CYOQWFKP        ALCURJJXXJ      CSDBHWPGIFSX   
BLRDHW          : RWCPOAMRWGSK    UNSDYJSRAJF     ESNYHNBXJ       FUHKRNJOBEROQIE EGNUHX          KXCO           
FVFRG           : IMWRSOJP       
QPVQBJJD        : SEVJWMPEOSXHJF  DMHRBVB         LQAQPBOB       
ESSPPTYRTBDNGM  : TDUPJQYYTJPOMW  TRHTKJKFTNCEXVB DLJAJJYJILIQB   FQPPBCSSH      
KRHRLPKEIGW     : GFIEN           XNLQNBPVUOKVSHE EIQGCCVAVM      YILHUDP        
SHNRLIKDBGDSB   : MUGHN           MGTJSRAHXYB     AWGUASMFJPGOCL 
XOMMAXHJRSBCA   : FYDFFIBL        TXNHE           IHGOOUEVHELH    IERLDR          YFJDKAXGFLIBGP 
LWVGGLXUVKXW    : UIBBGKKWXYVO    OXKFBSRANQSVDE  PIGMST          ODDYUSI         VOARQDTQDUQ     GEQLNEUWPT     
DRUJRLYHN       : FIIKERHVTQXUVLF EJAYTUWHJH      HLBB           
OYQJDVJOHH      : RUAFU           MXGKMMACRCQB    PVALH           YMMH            JVIBA          
PPXPKUAJTTOO    : DMWYUCWA        JLBAULIEJJY     JHULM          
BIFAPS          : UPPSUEEM        HYOSMV         
ESROVNAKWJ      : ADDFIHJPCDWNN   QVMVFHPEMXFYG   FUDJHOK         PWLUNQ          WNAPLOFVVK     
MAXE            : FLNMERQCCFCCJ   JVIBA          
UFVPBLGUMOAOH   : TIPYGKOHVSBJGVW HPYNB           QECONRT        
PLNHCLVFYUOYK   : PEYTJRP         MXGKMMACRCQB    DMHRBVB         NGPA           
WOCSVXKXLQUAHUO : WDVG            ECNVI          
PEDGOFRKMSHCRRS : DTGTEVXCBJLFGAJ XYKPDCQ         TLSAMOHLDVWWUPH BHUSFAKRSJNR    HDTQXUIL       
HUIDVUD         : VQMMEOGKQJKXJT  BSWBDI          NENYQMLRWWLM    EIQGCCVAVM      UGYXKCLCEA     
LAKUUBKNG       : NAWCSVXA        UCYAVECQSL      MGTJSRAHXYB    
TWUNH           : YTXHHAF         ITRWTQVQJN      SBLMOPOVASFG    DLGJ           
HQMYJFQSB       : GNPLGYDRKLJYHSB MNJTP           SJFREVYYCBVCFYG GMFNUWINXVW    
XWVEGJEQFCSPPB  : FIIKERHVTQXUVLF VVYHE           CCKTD           CVXDJEJTNKIE    TSEMIHDLVPDJVI 
LXAYHKGXW       : STODMVINUAGQ    BYKFSFYQLT      KHDHDBFIA       SGOVYNG        
JDYEGBDFYJLJNF  : EIQGCCVAVM      UKKHVYVAOIHKWSY
PAGHBLSBNUKY    : HNOUHVWXLFFIFK  SQEKFNWPX       CRRWJTL         PVRIEXFQRL      WXNKGDCHEEAMT   DMIPC          
KXLUBN          : JQFSQJHBWQQDCKO TDMFNDMCQBM     IGIJXQD        
JQGOP           : IQAWIU          NVXWMNX         WOSUPQ          GUSPNDSNANIYHUX HEDCPPXEFNBFJJ 
DYGKPV          : OHSMAWVFIVATXD  FFVGQIYLDI     
VGNH            : UGSAVYCO        KBRXOTFY        JRIFBEYRHIEI    YVHX           
QXTBWXLU        : GVHNBKPTDFNXJ   FESFYJ          DSYHXOE         OURXALCJOPVG    ISHYCWKSAB     
IYYKKPQAIJ      : SKAQTYGSTNDMR   DUBHLPJFW       OBPMPOVC       
HPPAN           : SGNS            GUSPNDSNANIYHUX FDYTSIGHKUIKDTT
VTRG            : HAWEW           JQFSQJHBWQQDCKO GXRJBXGKMNM     JIJSXMEGC       AEIYFUMXNMGYT  
IERLDR          : WQEJCIXUJBD     VSACQGMJBXB     BOSMPMMBCSA     JYKT            USXIEQXBCUPUGTY XOMMAXHJRSBCA  
AEIYFUMXNMGYT   : ENKCULJQXE      VTRG           
OLPDPMYHUUR     : GSWQMEGIDX      VIGQHJ          GKUOFRGWILJF    HGAYDGEUTPFDYD  HUYSMOP        
NDEHEE          : NWPRSGHDYMAYTN  KNTLWCXHUYGUNCS KLYALMWTHCWWGQ 
MGTJSRAHXYB     : XFYHNG          AHLNHNQH        SHNRLIKDBGDSB   LAKUUBKNG       EJAYTUWHJH     
QOGVEUULPSFQIIW : FIIKERHVTQXUVLF NWPRWCUPHFIGP   FLBS            SCNFEJSABPOSTQW PRHIHPIYVXANMLB
MBECJXNCPPLPROF : XNDUDNCYWV      KHHCXOGNX       XJSGHBJWALCAIJ  OMGJMCO        
DLGJ            : MYYSQGDRW       DSYHXOE         TWUNH           RJBGUMXBKUUQR   YJEPGT         
BUXTCQE         : NOITSBUXKJNP   
NUARYE          : KCHQKQYD        MJLXTBXNNSWYOFX PWTGILMHOTC    
YTGQKTGE        : XDLQCSJD        QJHRASAYQTOAX   PFUEMWHCIBSWGWP WTTMKABNKKECNC 
LOOAUYGXVHUYXY  : PEFWUFKACE      YHWHPLT        
MVNEURHVO       : DPXJ            PPJOX           JFCQOWYETJDEKMN RCGCLMPMS       JIJUESWCJNWSII 
MBISFTHTIHQH    : XOUJRLF         TSVIUCFY        XPGILEBAONUJCF 
OEWJFVLQIHFOF   : BAKCMSWOFYJ     ERYSOCTBFI      EYQHXTFCGQPB    OFWANYGKI       TIROJ           HIXO            MVLROLXQQKLMBH 
VBNMOQUJV       : HQLCBSPQVWX     TVPECXBFXWQFLDQ LQQBLERPVU      DMIPC          
QRYAIHQANPJUL   : EYQVFDITLNOXGS  DMHRBVB         SFYJITAN       
LVFSKKUJLK      : VSXPLDIP        NKMOEFXJCMMLNN  OETQPJPDUXGLD   YJLRHAONI       SCAETYMPPS     
CCSMXJF         : BNINHOGJRJ      UDCWHYBOGQCAVLJ SQEKFNWPX       OISULR         
IGDRYDH         : GXYHHEJS        YYESCLMB        KBRXOTFY        MSTINIICGW      NOITSBUXKJNP    RCXCDPXFJ       WFMGABYSGESDYDL
PCDMQ           : WFGAHBS         YVNVNII        
RLMCGXQTTSVOFV  : GDEJGLAGY       ARKEPGYCILFWUOU
NOITSBUXKJNP    : USCDEWROQVPEGX  IJHHQWSKK       BUXTCQE         IGDRYDH         ISHYCWKSAB      FYDTBB         
BIOUVDAFBQ      : RROJK           VLTYLJ          CMYKAXSYSHEFC   PGWCFTCDAU      NATHEU         
WJULRQJF        : DMWYUCWA        VPEPWHSMYIVD    WOTEWCKBC       BBTLYUL        
RBBUX           : KHDHDBFIA       WVOYDXL         MDJINRB         NQKFRMPMJ      
IJPXYS          : PIGMST          KNAHHQMAHDEKNR  EEBLNBBPFBXEHF  FAYTI           PTRCEDDX       
PNES            : WQEJCIXUJBD     GGKCQSHTUSCQJS  GLAWMGOKEFBAQSP
JTGIQSFEKYN     : OQSKD           MDJINRB         CCKTD           YLFCNEHXVLGSE   XPTUMBCRAUBHRV 
HHUKFSLNCDND    : KFNNVYBYK       UAVNTQ         
VSMALAMHHWA     : CJAFXYESCEUKOA  RVRLL           YFTIWRA         WOSUPQ         
FEMETGNCDAJVN   : FJKTV          
ARKEPGYCILFWUOU : SRJCLUNMMYYJHGW RLMCGXQTTSVOFV  GTPSRUJOEN     
QAEFGY          : LCHVUHGSAKKK    EVDCRQSYYRMIB   XQRQJFK         ECRGFFNKMUWWN  
TDQVMOJLODV     : DROTB           DTGTEVXCBJLFGAJ HKSKVNNYYRVKC   WYIBKFVCN       ONHCMEQELRV     ORFEBC          PTRCEDDX       
TEUXOIDMFRJDIJI : CCHUQHJKEPG     GQNDBNDYNSKMHK  NEMPTRQBSJSXPXD JYKT            AHFW            RJBGUMXBKUUQR   FKSTYPELEDA    
RJBN            : SWWAWXVKYIPM    JBBXLIYB        VLDWRKWIANVGW  
RJBGUMXBKUUQR   : RSCNVSA         JQSGEOO         CDSBNBABCAATOWW DLGJ            TEUXOIDMFRJDIJI DGPDHHSBDQQ    
FAYTI           : MDJINRB         PHXHP           IJPXYS          TMWQYTPTFNM    
DLAO            : FUHU            PUAUPCCT        QVWPLMLKHXIA    FLWV            ALQOXGMMADE     CXSGJEGAYQNKQS 
PGHRTTLFWSB     : BNINHOGJRJ      CFMOFI          TTAKMHNKPN     
SCVNYOGTUIU     : KNTLWCXHUYGUNCS NKGH           
QMSFOHDEQL      : QHKUB           OJLQLIEDAUYDSA  JIJSXMEGC       SMQRWTVQUU      CVXDJEJTNKIE   
KHMQFFT         : EYAHAKO         NPFSD          
AXRNYG          : BWNDJEOUVV      QOUTU           UGYHVLSBVNWB    IITYDJ          XTUUTJ         
UBDQSVFNBTUFA   : DUGKSSJPGVLO    TGJJKP          VWDDFVDBSV      ATLYLCNYS       EGPEOS          YVNVNII        
SBYANRHUNBULSI  : COLKGWXSPH      UIIQFRHF        YKVVCF         
YFJDKAXGFLIBGP  : XOMMAXHJRSBCA   JHRMS          
UIFV            : SFAUPBPREJMVNNW QVCELJBW        LXUDIFH        
UNSPBTKOOUDPC   : FLEH            YDBXVXFCWKTR    ROLB           
UMPST           : EHSLJCF         TSOMOYHSEJNEVVT SKHFFTUYNU      CCFEQIXQ       
ECYNT           : HQLCBSPQVWX     YIPCWSTBP       UBDTRMFBR       EQJGGSPTYRL     ADQGXKVFPW     
KEKGOFTHUWDHNR  : YKVVCF          SDNXWO          IHVQQQYDDAJB    DMIPC          
SKHFFTUYNU      : ETVJGXXP        UMPST           HARMO          
RTSNYDRJJHOFOLE : WDVG            SWAYYRYLGUMK    LHQXDAWX        IRYEJE          BNXJ           
STMYMWGSDDPEQKH : QRIPHUKOIKDRH   CGUYVUC         YVNVNII        
GDYFGROSBFXPQ   : BXURLHJWGXMVOCF IDIBMRT        
KLYALMWTHCWWGQ  : VGQCIWRRYJBGGT  LWKIXNBX        DBOQYIEYHC      DLRWTDAYY       SXILMBVTGPWBVLH NDEHEE         
QEQTFWAWNUAT    : KUBLBJTL        CKMEJWK         YMMH           
SMBD            : SYDGGMQ         IIDQ            FDYTSIGHKUIKDTT
CFMOFI          : BHFOEMHGCPGKUDM PRPXRTMVG       DOQPOCUMWGVUF   MOJXPQM         PGHRTTLFWSB     ULXQYGGX       
HIXO            : FURNB           ESBEGOXETISW    FCXCSUNQ        EJYNYEPYPU      OEWJFVLQIHFOF  
IHFBBK          : IXQTJHYWB       VGQCIWRRYJBGGT  GFVXMSTWVICULB  EGJWYV         
DKOYKKUDYXJ     : EKIW            MHMAYN          DFQYMKWS        OXVDCXT         FSEJSANSATQK   
AQMRVX          : QVWPLMLKHXIA    MFNKGKXPCT     
EGNUHX          : VEHYPJGSHJXLFG  ULHGEMASBP      PTWUMWSPP       NENYQMLRWWLM    EJGFFSDL        BLRDHW          EBAEFOMSUU     
OAFYAILQJYDG    : LEKJWBDD        LCYVTG          SUMQPQQKSBNFWU  BSIQ            VBYYUQNNUEAIF   IHGOOUEVHELH   
DGPDHHSBDQQ     : ETUIMRNDH       JARJFWQXUA      KIRWCKMKAF      EEBLNBBPFBXEHF  RJBGUMXBKUUQR   MFNKGKXPCT     
WHEGFIUHNV      : INRATYHXBXX     NEWYGAPBTQHQ    WXVTBRY         OBBEHTJ         HOFBDKPKF       YSQESQ         
YIBIH           : ULHGEMASBP      IPUAE           QDYRANS         TGIWTNBFOETOC   EEJTGMUMN      
RNIXELFLGIQWCB  : YTXHHAF         ELVIFGCVUEYFLF  VVYHE          
JFCQOWYETJDEKMN : EVDCRQSYYRMIB   CFCIMRMRCV      YDYDPRQ         MVNEURHVO       WOITEXY         ISCXMA          OPDUNC         
EBAEFOMSUU      : YFPXVIII        BIHMOEHKNGR     EGNUHX          HMVHUTX         NATHEU         
SWLOISRA        : VGQCIWRRYJBGGT  DPFFMQOFQVBNNT  KVOIJOHEMWH     QRIPHUKOIKDRH   HUYSMOP        
QBOMMRQWGG      : FJCABIHKJOGE    MYATYTIHTIBFGK  TKJM           
MIPRP           : DRLOVQFVBVWSN   YJEPGT         
EJAYTUWHJH      : RLKWLBY         EGPEOS          DRUJRLYHN       MGTJSRAHXYB     MBNLONU         TTUHNBOXL      
DHKUKYHWQ       : EAHVSACC        DPGDJ           UKKHVYVAOIHKWSY OURXALCJOPVG   
WXHOKRGCILIT    : GDEJGLAGY       KEHHTV          LEVUEVFIYR     
IPIHWTOWXYHSL   : FMJGHYKCLQ      KYDOND          CSOPVHMIUNIQBSW YFCU            JVIBA          
CLAFIANYKHFPRSX : YVHX            GCQIKTSHQTR    
IIDQ            : XYKPDCQ         SMBD           
ANFA            : PVOT            WONAW           YPPJFWULGNO    
GHGRQKDSQN      : YKITC          
GMFNUWINXVW     : IITYDJ          VFLQKXDHKXL     KNKPSQWEWWWND   EEBLNBBPFBXEHF  HQMYJFQSB      
APWCDECQMKWE    : VSACQGMJBXB     VEHYPJGSHJXLFG  OJBAFREUEWJ     SYEBULBWHQ      YFCU            OGQJSXSKHHOUGR 
KKXBX           : GXRJBXGKMNM     EMMBBCHVHWKMIGJ
HNXWIVFXTE      : FUMNHX          YYESCLMB        UEVHXLKPSKRBTL  TMWPWXMYHN     
AENYG           : LFFO            GTMVUGV         DIMRUYUN        GHHBMPDDYYYNSY  UCYTQXXKAM     
FJKTV           : OTYCKUM         DLJAJJYJILIQB   LHQXDAWX        FEMETGNCDAJVN   JFABKWYYBUIMN  
BBTLYUL         : LMQQUCQIJCSGFVL TDMFNDMCQBM     SUMQPQQKSBNFWU  WJULRQJF       
EBPELLJKHNH     : OLDWYEDJ        UOISUUWPI       WLJKSND        
TWLDQTMBNK      : MUGHN           FNVXREBWXFHKRKK JHRMS          
ONHCMEQELRV     : LTVDERYDLTY     KGXDAPK         FPCJJGVPFBJLUTH IPVMA           HBMWPQOAAG      TDQVMOJLODV    
GKBQRRACLXQO    : LDTDWWTRKQUIXOD WQBHJXSWSHM    
KDRAPGRDNVPUMVG : VGRKQNWIPFCYJF  IKPHJVVSMINFOY  SGRFDKHCPW      MSFXJVXQXSCOS   GJBLLRTDPUYE    RVCWMHBDEMCL   
SXNDYGWQGCFG    : CAJIBXPWKSHYQQR QUVXLLLRKOJUA   KTDDWXTPP       URWFRLGR        HUCROUPYEKKWDQT
TWFAQFP         : STODMVINUAGQ    VWCUM           NGJNGOMDHRR     BXAG            YHWHPLT        
YVNVNII         : ATWBM           PCDMQ           UBDQSVFNBTUFA   STMYMWGSDDPEQKH TYDJDHHTDQCDUM 
QRFOFKQ         : QKSHI           SNMSLQRML       JRIFBEYRHIEI    JDFUBAULFMM    
JHULM           : DPGDJ           NQUPQFSNGXEQIC  PPXPKUAJTTOO    BOHGUY         
GJBLLRTDPUYE    : FDMBRSNEVTNFJMA LAUFDQAWDSCWMY  FYGSL           EDRXCIUWONKQE   KDRAPGRDNVPUMVG UPEJXMFYRVDSL  
NOCAGTHW        : TDDLBUJIU       CFCIMRMRCV     
TPPDAKPMOXXPM   : CNXFSFQYN       VANJYNXE        ATOCPDTLN       DLRCOE         
HGPADOEU        : PMHWQHNPHWQ     GGKCQSHTUSCQJS  TMRNKOFVDRGKPQ  HSUSSJEYEXVVUA  RJSCVDXUYBM     BRJP           
SYEBULBWHQ      : YVGHJSXQI       PFSS            FHUTPFHEP       UEVHXLKPSKRBTL  EHGYFTSHR       WWVSPJKYW       IAKSSUKIUJQSGV  APWCDECQMKWE   
LQADGOBGG       : WQBHJXSWSHM     BBMVPREIH       ODIS           
SOVIOAYUWEN     : LIJEUKGQ        TWYKJVF         AMINK          
KRQYSQGL        : OTYUATWBXSCN    ECUYYMLPVM      FQPPBCSSH      
RFGUL           : ELGRWBXB        ETDRIJ          ONLS           
WTCMMSJWJJWEG   : HQMSGUTFWQ      VKPDAOHVL      
UENOUM          : UYBJIEYBYKHAJH  AUDFRBRBLDGNIU  YRVIFDLF        NQRAGSJIAEEIXW  CKXJLY         
NVUT            : GWXCQJPYHC      HBHNGDUWNTT     XPQHJLPNU       NWPRWCUPHFIGP  
CBLPYI          : SMQRWTVQUU      TSEMIHDLVPDJVI 
DWYWGY          : MMHVA           UDHJW           CGUYVUC        
PVPXBMCOBA      : TDUPJQYYTJPOMW  ORFIPIQK        OLFCTJPXTNVFVO  TGIWTNBFOETOC   TMYSRFOAYMQI   
KNAHIPMJBC      : XTUUTJ          EQSXPCWTXEXSGVU
LMNJOMPNVILLIMX : BNURGHWVYOTQC   PNIX            CXGGOMQQUIUC    LUNNGSDMOFLTTR 
DBNJNDLWLCJ     : LVOGMK          ATLYLCNYS       RFATOGWYTLVJR   KLCBVEGOERNPFJJ
DMHRBVB         : RENDA           GEWDIP          SJEVSU          WQCPOKTBH       QPVQBJJD        PLNHCLVFYUOYK   QRYAIHQANPJUL  
ISFGBQRKFRXJU   : KCHQKQYD        VVNKOEIRXQBCJJ  VWHYCB          ATYJEKS         MHRQUKAPORBG    YXLWYDQKKTMOOL  TDDLBUJIU       NRVLNIVR       
UIQH            : EPJVINO         ICUBUFBTTHG     LABLMFSNKOI     VPTSAYMQDAVDK   ABYGJNOASB      TQQV           
DLRCOE          : VANJYNXE        GQNDBNDYNSKMHK  UAVNTQ          ORLI            TPPDAKPMOXXPM  
IGIJXQD         : NPFSD           TAAIHLCAWOOMWUN UIBBGKKWXYVO    KXLUBN         
AGWR            : SBFEUEJRDRP     WQCPOKTBH      
DMSOJGJSXQ      : FIIKERHVTQXUVLF YCAUSWLFMX     
DCUFT           : SCNY            RLKWLBY         NENYQMLRWWLM    WOTEWCKBC      
REIAO           : XOPNPOH         AKEKERU        
TTMTAKNT        : ERYSOCTBFI      SXGYPEKXBDNWUSK
CMEM            : GBOUA           YYTHHKISGTD     QBQXW           DTHFUMINTCTBBKU
PHTHKYL         : KLWPGAWG       
GHHBMPDDYYYNSY  : MYYSQGDRW       AENYG           GTRV           
JURNKVCGM       : SSIS            CKLU            UENSLOMWPNEC    KNAWIJAB        NQKFRMPMJ      
CVXDJEJTNKIE    : WXYVE           XMCWRFPGIYSBC   XWVEGJEQFCSPPB  QMSFOHDEQL     
LFNKUJ          : NSLUXEI         CYHYNNQQSAH     RFATOGWYTLVJR   VIDSOFOHSE     
XUJPK           : WPLAIU          IGNUEDLDCDCNF   OLDWYEDJ       
ONADBEYAHKGS    : MWKMFRA         CXGGOMQQUIUC   
TEMAUAHKMDVBDSK : MUGHN           CJHDBELSUDVYA   OXKFBSRANQSVDE  LVYLICNGWHTTIN  ERCJQWTLINWPFXK FTXOWH         
EEJTGMUMN       : FNVXREBWXFHKRKK YIBIH          
TYDOFXSSXPUGB   : NYLJIDNCGNG     WJHUILXPH      
LYLOSXJWEVSMKPY : QDASSTSEOIJTLJ  TDMFNDMCQBM     MYATYTIHTIBFGK  CUFVTAIS        ORFEBC         
NUXQJDOFXNW     : HEUWQKVPTEXRJJ  MWKDT          
TAGHATXSTHR     : FOAIQYRRCGYSJBQ IGNUEDLDCDCNF  
FMMQCNPP        : ESBEGOXETISW    IXQTJHYWB       JHNYYBBCDANR   
PHTUVBVJY       : FFKDDDQLM       UGJPIH          HQLCBSPQVWX     LTNG           
FYAMB           : BGXUTILYGOQOCJG HUCROUPYEKKWDQT JXOXAMSGEPKA    DYFMFGYKVLSI   
KTPUNPCAESDRKU  : PIGMST          CVXH           
CCXXYATKB       : TNTURWFIPLOGDAH GWLLVMYTME      DIJAORHMJXDKE   EDRXCIUWONKQE  
SCNFEJSABPOSTQW : JCATQJMFKLDPTA  KFNNVYBYK       JOTIKQKTP       OOYDJVUQGOBKRN  QOGVEUULPSFQIIW QSCVQODRUJEY   
VOARQDTQDUQ     : QVWPLMLKHXIA    LWVGGLXUVKXW   
GTKYWAGBLBB     : OEAIW           ANKM            EDRXCIUWONKQE   MWHYCXSXTCLUTL 
SRFNJCD         : IXQTJHYWB       GOJQ            GQRWMIVQBD      QRIPHUKOIKDRH   JMNLRHXFLF     
SFYJITAN        : QXDQXAECRY      QRYAIHQANPJUL  
TMWPWXMYHN      : BDBSFYBRDLLOC   XPKTHIYATITPGG  HNXWIVFXTE     
IRYEJE          : NEMPTRQBSJSXPXD RTSNYDRJJHOFOLE HWDPSVON       
SIWBBCAM        : FPPFJNFGWNFXJHN AYCFLC          WONAW          
VPBNL           : GKMEER          TBDNTNQXBSR     XGGOVHLLWPQ     PSBTYWAAOFSK    WSMOGKDUUIDTPE  LWGGNI          ISHYCWKSAB     
MBNLONU         : GHWSGE          MHMAYN          MVIOMFNWEDSMBHM EJAYTUWHJH     
AFVAJIGDB       : WMYYOLMP        VEHYPJGSHJXLFG  HLBOTYBJG       TKVMEVSJUQPOTQ  BVCABIIPHTW     ARGFDMVIANYBBGV
CEUFFKUDCVS     : CNWCUGWCDGIYCLE NTMKQ          
MGQBTHQOOSVKUGS : MJLXTBXNNSWYOFX DBUDAJ         
LWVOB           : YAFAHQF         BSFUXCYIEDVYB   CFKT           
VIDSOFOHSE      : NWIOFUEMQYNCF   YFPXVIII        VBYYUQNNUEAIF   LFNKUJ         
MHLTX           : FVETHGWNADK     ALQOXGMMADE     OGKELFRLUDNCALR ESTUDPXMSURB    WFMGABYSGESDYDL
ISYVOHQS        : ALWUPIXD        KUWQ            NWPRWCUPHFIGP   OOYDJVUQGOBKRN 
NQJRHHCNAQSRBM  : DFQYMKWS        VPTSAYMQDAVDK   EOEICGO        
QBDFUDHGXGCMNUH : SPQLC           UCHLOWEFWKFVI  
LXUDIFH         : VRSWQJE         PXRGXAUKDARNWO  UIFV            LLGRHWJT       
FBOYCDWUE       : TLGHHKJYVGTRB   EHSLJCF         KLTYBBYISRNVDOV ERGVVTA        
ACFIIGQM        : TBBGT           EKMXRLB         CDHKVFA         PDRH            TKJM           
FHBQSB          : MGYSOBGOGNEJTSJ SEVJWMPEOSXHJF  YENVYM         
XJSGHBJWALCAIJ  : TKVMEVSJUQPOTQ  MOJXPQM         KKNJUTKDVL      MBECJXNCPPLPROF
LLKVVQMKJTTM    : PIGNK           FESFYJ          CXSGJEGAYQNKQS  NKGH            SNAPACR        
PQYNCRVKSHJ     : VYPCFLJLISFARJK UIBBGKKWXYVO    ENAGOPUMQYGYBVF
SLVE            : XQNFHJVQA       XAWGGWBTAPEG   
XPGILEBAONUJCF  : AUAMMFVXWALCHB  EYKQKWUKXVYLAFT WJHUILXPH       MBISFTHTIHQH   
SGOVYNG         : OVJCQLXW        YXLWYDQKKTMOOL  LXAYHKGXW      
URPQDL          : SSUUHQQXJ       COPBBGDNEJP     XMNYSNPVJIDBAJI NAMHUNCVYIGRFTQ DBOQYIEYHC     
YMMH            : XJGIITHAHV      WDTPYOKI        KNAHHQMAHDEKNR  OYQJDVJOHH      QEQTFWAWNUAT    QSCVQODRUJEY   
AOYADMWOODPKL   : SGPISJEBHHT     QDYRANS        
GKUOFRGWILJF    : UJNWCIGXEYC     OETQPJPDUXGLD   SMMQHGSVYSJD    QXDQXAECRY      UXLR            EGEYOLEC        OLPDPMYHUUR     FRRYQRJQFSY    
XTUUTJ          : UOISUUWPI       AXRNYG          KNAHIPMJBC      VDNFCHSAYOHH   
WOITEXY         : GIQEERRFFGKQVY  PUFNPSSBH       FKFMP           JFCQOWYETJDEKMN
ILDQXXHF        : BQLPGJY         EODWUEJ         IQVRNSHVAO      VUMRWMEYYU     
NDBBOHMMBJJX    : SDNXWO          YVASIAMCY       CEIYXYYKFA     
EULOQPMSOWGRP   : UFADPXGFVGDT    FCBPRNHCUT      XPQHJLPNU       PEFWUFKACE      MJRYPIYXDJTTM  
QWMJMPKOGRDUVO  : GQNDBNDYNSKMHK  LHQXDAWX        ODDYUSI        
TJKQUAJNO       : UNCQSHURMNQ    
COITEPMCCVQ     : NQAEJOMM        QPWJEYYCTQOP    EQSXPCWTXEXSGVU GTRV           
JFABKWYYBUIMN   : EKMXRLB         YMCTE           FJKTV          
OXVDCXT         : SBFEUEJRDRP     AHFW            DKOYKKUDYXJ    
TYDJDHHTDQCDUM  : HNOUHVWXLFFIFK  FUDJHOK         LHQXDAWX        YVNVNII        
TMDP            : WEPIEWKRECG     SXWSCWUFEFXQJF 
RDDG            : SGPISJEBHHT     SUPMNDLRYCWMBHG DYKUVUB         NBGUCKOF       
YMGY            : CTRTMYCCJMTRC   GOQY            LQQBLERPVU     
TVHYFK          : CQARVDQJRUPNRA  UCYAVECQSL     
MHLGJQBV        : CJAFXYESCEUKOA  GTMVUGV        
UIVMG           : OVJCQLXW        NQUPQFSNGXEQIC  UYPCEPUQCGHFC   ESTUDPXMSURB    PJKJTFQQW      
SLWVNLEMUAK     : OOHEBBEAUNPLDP  VLTYLJ          MDVAYJXBHHXJOSW
YPPJFWULGNO     : PSBTYWAAOFSK    SXILMBVTGPWBVLH ANFA            OABLXOWER      
GLNFYVVT        : EDDTDOYCEU      DVRRK           HMSFCSL         MDJINRB         UCHLOWEFWKFVI  
URUJWKEWUIYNXI  : KCHQKQYD       
UGIBTWGDITIJ    : ROLB            FESFYJ          MYATYTIHTIBFGK  HWGNDIGWITJSS  
EFYBXWKUJOTG    : HHPWJE          ETDRIJ          YTXHHAF         RVCWMHBDEMCL   
UVVGQRMBUIA     : NYLJIDNCGNG     PBINSNVUPKVT    XQRQJFK         DFQYMKWS        LHFEQVSDTYS    
LLWTUOADQCBPMXY : AQEFNRLUYVG     EPJVINO         COHJLGBPIYS     OPDUNC         
RHCPEAVW        : ETUIMRNDH       JIHCPSQH        GHVDTUK         NQKFRMPMJ       ORFEBC         
KYPSYS          : PGTLJXR         NVXWMNX         PAGSNMR         WXNKGDCHEEAMT  
MSBI            : INRATYHXBXX     JBQQ            GMSK           
ENAGOPUMQYGYBVF : FFKDDDQLM       GMTRJOEKMFVMKRD PQYNCRVKSHJ    
RCXCDPXFJ       : MYUU            TDDLBUJIU       AUIOIXMKA       IFQVLU          IGDRYDH         GTPSRUJOEN     
RCGCLMPMS       : IGNUEDLDCDCNF   MVNEURHVO       TNYT           
EQSXPCWTXEXSGVU : OEEKGGBMVMOVNY  MCUL            KNAHIPMJBC      COITEPMCCVQ    
OURXALCJOPVG    : SFFUCFVAMSO     HCOBQBQBP       EVDCRQSYYRMIB   SDUOSPGX        LABLMFSNKOI     MVIOMFNWEDSMBHM QXTBWXLU        DHKUKYHWQ      
RLJIGHX         : NGECF           SUTEKUOBNEW     EYYUDWKOOWCS   
GRJKRCSOYFFUYFU : UKOQOQWKRDEH    XDLQCSJD        JQKHKUSMBI      AWKRCSGUJLMFOCT STNVBTFXR      
HGAYDGEUTPFDYD  : DKBIFPOFA       OLPDPMYHUUR    
HXURPYMGY       : SWAYYRYLGUMK    VHNQYTAVRCMLUPV DMJAEL          PPJOX           WIUXSFEFN      
LTTQQFAX        : INGDGJ          NEWYGAPBTQHQ    WHDWB           BGCH            AUIOIXMKA       MRNVUUYS        JNVOUCLMI      
ADQGXKVFPW      : JQKHKUSMBI      KBRXOTFY        CDSBNBABCAATOWW ECYNT          
CEIYXYYKFA      : NDBBOHMMBJJX    OOSNPDVPLRLLEYU
TTAKMHNKPN      : CAJIBXPWKSHYQQR EYDDHL          PGHRTTLFWSB    
GTPSRUJOEN      : VSACQGMJBXB     SGMXVLPXEACSLU  UMBUNUVSU       MYUU            BBMVPREIH       YLFCNEHXVLGSE   ARKEPGYCILFWUOU RCXCDPXFJ      
OOSNPDVPLRLLEYU : NBMW            EKWXXDHKYUVH    MNJTP           DJGYRNKAI       EIQWKAF         CEIYXYYKFA      QBQXW           SNLVPWSY       
OOSNPDVPLRLLEYU : NGPA           
LKFCSBROUN      : SYDGGMQ         LFKEOXFUJV     
LTNG            : XMNYSNPVJIDBAJI ECNVI           ROVBUUDY        FNOKHIW         PHTUVBVJY       JGHBFCBQ        PNSIEP         
EYYUDWKOOWCS    : WCHXXKXSC       VYPCFLJLISFARJK YTVWNB          GKMEER          OEVQYT          SEGUUMNGHTCFG   RLJIGHX        
WLJKSND         : PUAUPCCT        OTYUATWBXSCN    JRNTTSOGISONYB  EBPELLJKHNH     QSEWCS         
GTRV            : OVVNQSEFEWJN    KTDDWXTPP       ENKCULJQXE      YWYUSPUNNGUMS   KUYGGOPFJXN     GHHBMPDDYYYNSY  COITEPMCCVQ    
EPHKAMMBHPX     : OTYUATWBXSCN    MHRQUKAPORBG    OPLYWJGNCRJD    AQNBBDURHOVHD   WEBV           
GMSK            : EAHVSACC        PPLWNLYOU       CXQCWFRUL       MSBI           
QJTDTMQAJYT     : SVTGDXXHLTWKWH  JHRMS          
UOIMVUPKH       : TKVMEVSJUQPOTQ  JQKHKUSMBI      LDUONPVCCP      TGCJUD         
TYPOHEHRMBCGEX  : VDGJQPSQQ       OOHEBBEAUNPLDP  WSHUXLTKHLAEIPF HWGNDIGWITJSS   QBQXW          
WXFWUJTJRJHPBS  : JOVJQMXSLC     
RMYJDGOLB       : FYDFFIBL        WONAW           SQMFMEUH        CXGGOMQQUIUC   
ODIS            : STODMVINUAGQ    UBRWJFLIMSHWX   LQADGOBGG       AGQCH          
ERCJQWTLINWPFXK : TQXOJXGBDQFYS   AEQYW           TEMAUAHKMDVBDSK MOESHNR         FOENRDHK       
RAECFMSSN       : HJIHLUYG        RENDA           CVKLPPCTU       ETVJGXXP       
HSECUKU         : NWIOFUEMQYNCF   YCAUSWLFMX      DWSJOM         
ULXQYGGX        : YVHX            KFYYJLXKAB      CFMOFI         
MVLROLXQQKLMBH  : LWBWXW          SSHCHBBAQKJ     RHQQNNIUGFQBLT  ABYGJNOASB      OEWJFVLQIHFOF   EMMBBCHVHWKMIGJ
TMWQYTPTFNM     : VWHYCB          AGVDSFJ         EDVDBMYV        SVTGDXXHLTWKWH  FAYTI          
TTFUG           : SKOB            ERALXOJFTRW    
GASTXLM         : SAED            CCTLPPPVBVX    
WYLETGSQYSK     : MARNOWULPIA     GKNYDFWLS       BODDKUMCJSKFA   UHBKKEJIWSTVIA  HARMO           QBQXW          
ORFEBC          : JUUJYPYSFIREXY  SPBGEIUX        CCKTD           PIHCFAXVWLGHX   IFQVLU          TDQVMOJLODV     LYLOSXJWEVSMKPY RHCPEAVW       
HWGNDIGWITJSS   : SEENXXSQCTFCDI  ATOCPDTLN       QPWJEYYCTQOP    EYDDHL          UGIBTWGDITIJ    TYPOHEHRMBCGEX  DUTTWAL        
HWDPSVON        : VANJYNXE        UENSLOMWPNEC    AMEWMTMXI       IRYEJE         
GECMIG          : FUMNHX          DOQPOCUMWGVUF  
IPLOD           : SUKKGKX         IMWRSOJP        ERALXOJFTRW     ETMARTWJ       
YJNHFYBXI       : CAJIBXPWKSHYQQR ATYJEKS         KHDHDBFIA       TIROJ          
WNAPLOFVVK      : HJIHLUYG        SCAETYMPPS      CUFVTAIS        ESROVNAKWJ     
ISHYCWKSAB      : DUCGCQ          BXJHAAUTEADD    QXTBWXLU        NOITSBUXKJNP    VPBNL          
LQAQPBOB        : KQPSVFU         NAMHUNCVYIGRFTQ QPVQBJJD       
LQNEDDJ         : JBDNSL          AMEWMTMXI       LTHCXNORJ      
BTCLNJKRIWKIA   : SKAXODKJDCL     ELFRUUS        
TSEMIHDLVPDJVI  : PCJPE           XWVEGJEQFCSPPB  CBLPYI          UFPT           
HJPCODRXPJJMV   : HOAX            FIIKERHVTQXUVLF
OAOH            : VGRKQNWIPFCYJF  LABLMFSNKOI    
BSNFELWHVSP     : BEIGIRSCFNBJIOC JARJFWQXUA      RAECHVI         KRITSAPOD       GWCMIR          UCHVSTMMOUFM   
CCFEQIXQ        : SWYJOLLQFFBTKLH SGMXVLPXEACSLU  UMPST          
HANESFGJMM      : CDHKVFA         IFGM            WDTPYOKI       
HARMO           : FUMNHX          VABHR           SKHFFTUYNU      WYLETGSQYSK     WHAXKEDKSUR    
TKJM            : RNPVEJKXOSSQAQ  NKITAM          QBOMMRQWGG      ACFIIGQM       
MOESHNR         : FYDFFIBL        BVCABIIPHTW     ERCJQWTLINWPFXK
OBBEHTJ         : MLFUM           ELGRWBXB        DQPAJQWMXAC     WHEGFIUHNV     
FYCP            : UYBJIEYBYKHAJH  HSMHXUCRR       AMINK           ABYGJNOASB     
FKSTYPELEDA     : MWKMFRA         ORFIPIQK        TEUXOIDMFRJDIJI ECRGFFNKMUWWN  
ISCXMA          : CJAFXYESCEUKOA  CROVRXHW        JFCQOWYETJDEKMN
QBQXW           : DPXJ            DROTB           CMEM            OOSNPDVPLRLLEYU TYPOHEHRMBCGEX  WYLETGSQYSK    
OCCQUKV         : PJFTHXLWQAXC    MSRLC           RXIMYFETFSXQHTG
ERGVVTA         : SDWTMKAP        MFTVM           HNQJLXGWLFKKBYQ MSTINIICGW      FBOYCDWUE      
VUMRWMEYYU      : BUAUH           ILDQXXHF        EFKJMVM         JIJWNDWAK      
RVCWMHBDEMCL    : KYTJHCOMC       PIGNK           KDRAPGRDNVPUMVG EFYBXWKUJOTG   
TTOSOQWKL       : NKMOEFXJCMMLNN  EYDDHL          PMSRWUXIADSL   
CKXJLY          : VQMMEOGKQJKXJT  YJLRHAONI       HSUSSJEYEXVVUA  UENOUM         
QSCVQODRUJEY    : SKOB            SCNFEJSABPOSTQW YMMH           
WUONPFEMQRXUEX  : GIQEERRFFGKQVY  ULHGEMASBP      KLFKRTFWR       MUWESABKJG     
SWNJQPF         : UMBUNUVSU       SPUPNUXYP      
HKBETIDQFX      : CDSBNBABCAATOWW WSMOGKDUUIDTPE 
VQLADEUECBC     : DUGKSSJPGVLO    VOBDQXXQPVJP    CBFNKAVVAOFE   
TCVGUOLE        : BTEE            GDEJGLAGY       NQRAGSJIAEEIXW 
YFCU            : MGVRAV          HWJXQDR         IPIHWTOWXYHSL   APWCDECQMKWE   
HMVHUTX         : QGHVRRQV        NJUQTPWIRMTXK   CVVAVL          HSUSSJEYEXVVUA  EBAEFOMSUU     
TENQIPSMA       : QMDBSKEGG       DUBHLPJFW       RLRWHBOFV       SEVJWMPEOSXHJF 
QYSLP           : TMRNKOFVDRGKPQ  LWKIXNBX        GISIFP         
PNIX            : MTDQMDJJDMECU   RYGFT           LMNJOMPNVILLIMX DUTTWAL        
DNBRLIMF        : BXJHAAUTEADD    PMDCRXSF        SCYOA           YJXJXAKNELQJT   YOOSEUYC        WBKQMAB        
VCNJUXBNMDDEC   : XMNYSNPVJIDBAJI EMMBBCHVHWKMIGJ
PRHIHPIYVXANMLB : CNGILSGCUMBOBF  CKKQHPFBC       SDNXWO          DGWIL           UEYV            QOGVEUULPSFQIIW
UWXKITI         : SWYJOLLQFFBTKLH GOJQ            FOAIQYRRCGYSJBQ CSVSYSNDFQEHSYC HWOOVICHIMQBN   BTQPFFYMS       GORJS           ABYGJNOASB     
HUMMYRLRJSCRJK  : QDASSTSEOIJTLJ  WDTPYOKI        PDRH            DGWIL          
HKTUWFXRCU      : PPLWNLYOU       OPLYWJGNCRJD    NRVLNIVR       
MDLUOVREITVTNHP : SGMXVLPXEACSLU  YIITJD         
YYCS            : SFFUCFVAMSO     OPXLMUNRRX     
MODMVCGXYXMF    : OEEKGGBMVMOVNY  HSMHXUCRR       USYQPIWIJFMRBY  LVYLICNGWHTTIN  VFLQKXDHKXL    
JVIBA           : VUWWM           NQKFRMPMJ       OYQJDVJOHH      MAXE            IPIHWTOWXYHSL  
WXNKGDCHEEAMT   : HVOAO           PAGHBLSBNUKY    KYPSYS         
PGMTOMVOYBBKW   : HHUEBSBFNPQ     UIIQFRHF        ENKMGYC         KHDHDBFIA       BGCH           
OABLXOWER       : ENKMGYC         YPPJFWULGNO    
MVGO            : MLFUM           YXPCP           XMNYSNPVJIDBAJI QIDXAABNXA      UMBUNUVSU       OPXLMUNRRX      KUWQ            ROVBUUDY       
CGAKUWY         : WRNKYENDUKVP    DPGDJ           TTCEDXLDVUQNTMP SSQNYEUOTOVRLI 
SNLVPWSY        : VSXPLDIP        XNMCAHYDFBFS    WDTPYOKI        MUWESABKJG      OOSNPDVPLRLLEYU
UCYTQXXKAM      : HHPWJE          AENYG          
GCQIKTSHQTR     : LHLANB          VMTCUF          ERALXOJFTRW     YEBLHRMBA       CLAFIANYKHFPRSX
JGHBFCBQ        : FUHU            EHFOLSDJHAU     FNOKHIW         LTNG           
FRRYQRJQFSY     : OVVNQSEFEWJN    FURNB           YVGHJSXQI       PWLUNQ          ENMHUNJM        GKUOFRGWILJF   
LJTHCBAXVLH     : OMDDLNVMVI      EYQHXTFCGQPB    SDNXWO          WQCPOKTBH      
UJHXMAVRRP      : NHSHFYY         KHEGGOHJNG     
IHDBMXAVLJP     : RWCPOAMRWGSK   
NRVLNIVR        : BLWJBKHGDHJLPY  DMWYUCWA        ALUMEDDXAQPQ    XRQRD           RJSCVDXUYBM     ISFGBQRKFRXJU   HKTUWFXRCU     
FYDTBB          : VVNKOEIRXQBCJJ  RLRWHBOFV       TBDNTNQXBSR     KNKPSQWEWWWND   NOITSBUXKJNP    NMDJ           
SQHE            : QGHVRRQV        JEDBWL          QEFBPCB         QYOHLGCOUO     
MFNKGKXPCT      : HSJXNRWKRKSWS   JDEKK           GVHNBKPTDFNXJ   AQMRVX          DGPDHHSBDQQ     OXBEEMETT      
TQRJ            : AVHPCTD        
NBGUCKOF        : CJGAXJWCRYUAO   CXKPVVUFPLF     FPPFJNFGWNFXJHN CLQHGGLBGMFSSE  RDDG           
DYFMFGYKVLSI    : HHPWJE          NSLUXEI         UDCC            FYAMB           DUTTWAL        
LLGRHWJT        : AKEKERU         CNWCUGWCDGIYCLE EEKUUHDXQLMJ    LXUDIFH         TMYSRFOAYMQI   
AWGUASMFJPGOCL  : PTWUMWSPP       MSTINIICGW      SHNRLIKDBGDSB  
BYSOTCAFNG      : EHFOLSDJHAU     PYRHWTWWFNIQ    GTVBFIQMTOKO    KVWJT           EYQVFDITLNOXGS  JHRMS          
WFJQFL          : ELGRWBXB        YFPXVIII        IPUAE           KGPAFAO        
OGQJSXSKHHOUGR  : GERCKEWESD      APWCDECQMKWE    YPBPAUPSH      
AGQCH           : XOUJRLF         GNGDW           NSLUXEI         ODIS           
RNVOTHIB        : YYESCLMB        JQKHKUSMBI      QPWJEYYCTQOP    BXNYD           GHVDTUK        
YPBPAUPSH       : PMHWQHNPHWQ     OGQJSXSKHHOUGR 
DWSJOM          : DAFMPQFHOKIRGPX HKSKVNNYYRVKC   SMWGXXYY        ITCWQNBAE       BWWHK           HSECUKU        
VDNFCHSAYOHH    : RTYUSKLH        XYWQG           ORLI            XTUUTJ         
AGGD            : IQVRNSHVAO      EEBLNBBPFBXEHF 
IANE            : NFEJBBOXWQGGP  
LHFEQVSDTYS     : GFVXMSTWVICULB  PPLWNLYOU       VAVSWOVOHN      GWCMIR          UVVGQRMBUIA    
DBUDAJ          : SUKKGKX         MGVRAV          MGQBTHQOOSVKUGS
JCMPLPNTQD      : VWHYCB         
BOHGUY          : PMHWQHNPHWQ     USCDEWROQVPEGX  KNAHHQMAHDEKNR  MLYQYUGP        SXILMBVTGPWBVLH JHULM          
OEYPWXSXSVAFI   : QDCJONOPIOKPUD 
HUYSMOP         : SRQPDQSMVTGDG   XSWA            YRVIFDLF        RXJCHBF         OLPDPMYHUUR     SWLOISRA       
UPEJXMFYRVDSL   : PFTVJDMDWCYLO   RTHP            VHHIJNMKCKAT    KLCBVEGOERNPFJJ GJBLLRTDPUYE   
QEBMCDTK        : UJGXXAC         RLEIMTNLGIVQ    YVIILFMH        XPQHJLPNU       DMIPC          
BFOWT           : JOVJQMXSLC      FUOOFENIJ       RKMAWWWOUUXGGA  SQGOAVGJDMGGPU  MCEAGWFF       
OXBEEMETT       : YLJNLNHMD       IPVMA           NHGXPCYEUPCSX   WTTMKABNKKECNC  MFNKGKXPCT     
NPGGDJ          : JBPCEGTQSDOS    UMBUNUVSU       RSPGPPUDAOMFKL 
JMNLRHXFLF      : GIONYRDADAHXHF  SMMQHGSVYSJD    KMBOPLIBLR      SRFNJCD         IDCDKPYOUHJ    
KADYAGFE        : CQARVDQJRUPNRA  CKLJBDKLQWGXQJ  QMVNDMEADCGVR   UAVNTQ          CXQCWFRUL       UENSLOMWPNEC    ETVJGXXP        VVYTYLNH       
KADYAGFE        : VNDLG           UKKHVYVAOIHKWSY
KAPNNHWV        : PDRH            ROVBUUDY        MYATYTIHTIBFGK 
IVWUJJOT        : AUAMMFVXWALCHB  ETMARTWJ        CXXJEHAWVXBQL  
UFPT            : GWNLGBEQLX      SEGUUMNGHTCFG   TSEMIHDLVPDJVI 
PWQPFXTA        : USYQPIWIJFMRBY  HEUWQKVPTEXRJJ  TGJJKP          MYATYTIHTIBFGK  ERRCVGQLJ      
WPYKXXHLG       : OOHEBBEAUNPLDP  VHYGHB         
IDQTRKEM        : UXLR            AMATTFY         NFEJBBOXWQGGP  
TGHJFABMYUNJTFK : DSCDNTFFML      VWHYCB          PVPHOJHQPCSB    UDQUWJLAYM      UVOVOTOGLPIELRM
FIOQOVCRMXKA    : VFFCOGMVCSVK    LERFUKHKMAHHB   NEOIHRJJWV      OMGJMCO        
YRXICJPCKDBIQ   : GWXCQJPYHC     
CXXJEHAWVXBQL   : NWIOFUEMQYNCF   PXRGXAUKDARNWO  IVWUJJOT       
DNGCFH          : ULHGEMASBP      YWYUSPUNNGUMS   UBDTRMFBR       YOOSEUYC       
HQDMEGPOYD      : XNMCAHYDFBFS    YKITC           LSRMEMQSU       SXILMBVTGPWBVLH
WEFDLFDJ        : OIHCRKDYAUEML   CCTLPPPVBVX     YTVAOCJSKJTDYE 
ECRGFFNKMUWWN   : DWBNCTFFDYCQW   QAEFGY          FKSTYPELEDA    
LTIBIHHCHLHMY   : QLQI            RSDACYCHIKX    
PKUUNMDU        : PHXFEAQXAIYHKIK NAWCSVXA        UJNWCIGXEYC     TUBOAQOBDHJMF  
QFJNDI          : JBPCEGTQSDOS    UEVHXLKPSKRBTL  MDOYLRMMDMV     MRNVUUYS       
FTXOWH          : LDTDWWTRKQUIXOD UOISUUWPI       KHEGGOHJNG      TEMAUAHKMDVBDSK SISUNKSXA       FOENRDHK       
ELFRUUS         : NKEQTGVE        NNFBOIPAKS      BTCLNJKRIWKIA  
KEHHTV          : GFIEN           VSWXGVA         XKAGK           WXHOKRGCILIT    WFMGABYSGESDYDL
QSEWCS          : WLJKSND         DUTTWAL        
MWHGUXD         : DKWMUFTJVQPT   
WKPEEMYXYKE     : JQFSQJHBWQQDCKO EXCDHQXHCRTLPS  GABIBIOAWSGRRDN
RXCFQUKNYFRLEA  : OTXYADH         DTGTEVXCBJLFGAJ BETDJCPLKN      KATYCOYG       
BXAG            : QVMVFHPEMXFYG   CJAFHPNGEANFE   NWMYNR          TWFAQFP        
KXCO            : PEYTJRP         UKYIBWMNTFFKRH  SUKCSMPSTBY     EYDDHL          BLRDHW         
BOMN            : EDDTDOYCEU      WHDWB           EQJGGSPTYRL    
SISUNKSXA       : IQVRNSHVAO      FTXOWH         
FSEJSANSATQK    : YJLRHAONI       UXLR            UHBKKEJIWSTVIA  GROPDERPDIPD    QPEQRYLE        DKOYKKUDYXJ    
UCHVSTMMOUFM    : OEEKGGBMVMOVNY  XMNT            JARJFWQXUA      HNGEMWAMMIT     SJEVSU          BSNFELWHVSP    
RFJSYON         : DUGKSSJPGVLO    GXYHHEJS       
BGGOBGKTTGOVQN  : KGXDAPK         JIJUESWCJNWSII  BRJP           
MCDCWL          : SXILMBVTGPWBVLH ECVMQDIYYFBPFT 
HDTQXUIL        : ARHTWGFP        UDCWHYBOGQCAVLJ PEDGOFRKMSHCRRS
LTHCXNORJ       : WHXUQGNSQADIST  LABLMFSNKOI     PGWCFTCDAU      WVOYDXL         LQNEDDJ        
JHNYYBBCDANR    : HNOUHVWXLFFIFK  YKITC           ILRACJCMBNDRCU  FMMQCNPP       
TNYT            : CJAFXYESCEUKOA  SMMQHGSVYSJD    FYDFFIBL        IITYDJ          RCGCLMPMS      
JIJUESWCJNWSII  : CNGILSGCUMBOBF  EKQAUDNJU       ULVO            WKYMMAQU        SMQRWTVQUU      MVNEURHVO       BGGOBGKTTGOVQN  KATYCOYG       
JIJUESWCJNWSII  : VKPDAOHVL      
WHAXKEDKSUR     : GRHTPWPWLXTF    HUCROUPYEKKWDQT NQKFRMPMJ       HARMO           TUBOAQOBDHJMF  
KSKSCUFYAXX     : KIVEWYVIPRBU    EKMXRLB         AGVDSFJ        
HLBB            : MOHTXEWEIIO     XNVHQYMBBUHHEF  GXRJBXGKMNM     DRUJRLYHN      
LEVUEVFIYR      : SUPMNDLRYCWMBHG WXHOKRGCILIT    EFKJMVM        
VKTGFHYKCE      : LTHCBMV         LABLMFSNKOI     NTMKQ          
EFKJMVM         : NEMPTRQBSJSXPXD TGCJUD          VUMRWMEYYU      LEVUEVFIYR     
UYTQTAMCJNTOJG  : OTXYADH         PJFTHXLWQAXC    FJCABIHKJOGE    PHRRL           FUOOFENIJ      
PMSRWUXIADSL    : FLNMERQCCFCCJ   NEWYGAPBTQHQ    ORFIPIQK        MJRYPIYXDJTTM   TTOSOQWKL      
RXIMYFETFSXQHTG : LBHLQXGBJK      FEYWBJONFOAL    QIDXAABNXA      JXHCRJIKUSNA    KHEGGOHJNG      OCCQUKV        
BRJP            : CCHUQHJKEPG     HGPADOEU        BGGOBGKTTGOVQN 
DOFDWHHSSC      : XGQURSO         UGJPIH          DVRRK           JOAUABJAMNDYX  
TMYSRFOAYMQI    : ARHTWGFP        MWYW            QQDHAAWAGQLTJJ  PVPXBMCOBA      LLGRHWJT       
WBKQMAB         : EYAHAKO         IFGM            MOJXPQM         DNBRLIMF       
OJVNSFIMHS      : XQNFHJVQA       PCJPE          
TUBOAQOBDHJMF   : JMWCPI          XEBUJIPFSX      WOSUPQ          XLLLSJPJY       PKUUNMDU        WHAXKEDKSUR     JIJWNDWAK      
WVAYASPJ        : XSWA            WTSRD           PWTSFDHUHRHWAYL NWPRWCUPHFIGP  
ECVMQDIYYFBPFT  : BAKCMSWOFYJ     KUWQ            VKJVQEMXQSUMDY  MCDCWL         
HYOSMV          : BRPNHISXJXS     OVJCQLXW        MJLXTBXNNSWYOFX CDTKAJ          BHUSFAKRSJNR    BIFAPS         
LTHNVCDFSJKO    : XYWQG           QDCJONOPIOKPUD  KJDSA           TQQV           
DTHFUMINTCTBBKU : HQMSGUTFWQ      QNTIVSV         CMEM           
IDCDKPYOUHJ     : LEKJWBDD        URDRPODCHQSSN   QEFBPCB         JMNLRHXFLF     
TAEWVL          : COLKGWXSPH      CALKJSYDUXGXPHE PRKCUXFFU       YJEPGT         
RAMHTODXQ       : VABHR           NEQHMYEIOH     
UGYXKCLCEA      : NVXO            HUIDVUD        
NMDJ            : FUDJHOK         JQKHKUSMBI      BSFUXCYIEDVYB   FYDTBB         
JIJWNDWAK       : XRAK            VUMRWMEYYU      TUBOAQOBDHJMF  
PNSIEP          : DKBIFPOFA       NVXWMNX         EWEDXXKXAO      LTNG            IWTWWQGDLYPK   
EOEICGO         : RROJK           NQJRHHCNAQSRBM 
GEQLNEUWPT      : LOXITQEIXKDXB   LWVGGLXUVKXW   
SQMFMEUH        : RMYJDGOLB      
CXGGOMQQUIUC    : WCHXXKXSC       ARHTWGFP        LMNJOMPNVILLIMX ONADBEYAHKGS    RMYJDGOLB      
OPDUNC          : PFSS            TQXOJXGBDQFYS   JFCQOWYETJDEKMN LLWTUOADQCBPMXY
HOFBDKPKF       : JWXO            VUWWM           WHEGFIUHNV     
YHWHPLT         : OJLQLIEDAUYDSA  LOOAUYGXVHUYXY  TWFAQFP         WBTHYEWMAITRCV 
ERRCVGQLJ       : CXQCWFRUL       VDTQFNWHQCXYS   OQSKD           DKWMUFTJVQPT    PWQPFXTA       
BNXJ            : PWTSFDHUHRHWAYL SUKCSMPSTBY     RTSNYDRJJHOFOLE VSPCAKFYNSIBY  
DMIPC           : USBUDUKVQ       NHSHFYY         KVOIJOHEMWH     VVYTYLNH        PAGHBLSBNUKY    VBNMOQUJV       KEKGOFTHUWDHNR  QEBMCDTK       
WBTHYEWMAITRCV  : CXSGJEGAYQNKQS  YHWHPLT        
JOAUABJAMNDYX   : BOXATLVUJ       TWYKJVF         ITRWTQVQJN      FEXBQST         DOFDWHHSSC     
BSPFNWE         : QDXDFQJOKJI     SEVJWMPEOSXHJF  IUVFNG         
WSTFMM          : SAGTQVTJAFB     WIXWBFIACIGAUL  LSRMEMQSU       HNQJLXGWLFKKBYQ
KATYCOYG        : DBBRNFLXJ       UDJJEWL         ATSFQTEFIVEWY   RXCFQUKNYFRLEA  JIJUESWCJNWSII 
YSQESQ          : GEWDIP          OTYCKUM         EGANXFFPAGLA    CJHDBELSUDVYA   LWBWXW          PRPXRTMVG       WHEGFIUHNV     
VKPDAOHVL       : KICNAWTQ        NVXWMNX         MBWUELN         WTCMMSJWJJWEG   JIJUESWCJNWSII 
PTRCEDDX        : ICUBUFBTTHG     IJPXYS          TDQVMOJLODV    
FOENRDHK        : OAUXRJFOBP      LAEOHOMNQNVDJN  ERCJQWTLINWPFXK FTXOWH         
CDJAPBERQNN     : ICUBUFBTTHG     WQCPOKTBH      
QEXJGCOLC       : WRDR            FKFMP          
TTUHNBOXL       : SKAQTYGSTNDMR   MOHTXEWEIIO     QPYUNPEFTDOT    EJAYTUWHJH     
DUTTWAL         : QMDBSKEGG       OQJOMW          VWHYCB          XSVKW           MUWFWGXKSRR     HWGNDIGWITJSS   PNIX            DYFMFGYKVLSI   
DUTTWAL         : QSEWCS         
NATHEU          : GBOUA           ILAVFWNVCH      QJRTVABNU       BIOUVDAFBQ      EBAEFOMSUU     
MWHYCXSXTCLUTL  : WMYYOLMP        GTKYWAGBLBB    
MOFIK           : VFLQKXDHKXL     BETDJCPLKN      OOJIPNVN       
IWTWWQGDLYPK    : DIODDRRMOROIBGH YUXGNXCJA       PNSIEP         
OMGJMCO         : NGECF           CAJIBXPWKSHYQQR MBECJXNCPPLPROF FIOQOVCRMXKA   
YILHUDP         : VMBAFMTJLJPOJ   EDVDBMYV        GROPDERPDIPD    KRHRLPKEIGW    
NTMKQ           : ENCENYAT        MUWESABKJG      GUSPNDSNANIYHUX NFEJBBOXWQGGP   CEUFFKUDCVS     VKTGFHYKCE     
JHRMS           : YFJDKAXGFLIBGP  TWLDQTMBNK      QJTDTMQAJYT     BYSOTCAFNG     
FDYTSIGHKUIKDTT : FMJGHYKCLQ      TAKLV           AMEWMTMXI       NEYTUP          HPPAN           SMBD           
YJEPGT          : JBDNSL          DLGJ            MIPRP           TAEWVL         
WFMGABYSGESDYDL : HLKKHOAEKXVK    EIQWKAF         WTLLFAEQ        IGDRYDH         MHLTX           KEHHTV         
NGPA            : VEHYPJGSHJXLFG  SJEVSU          VDTQFNWHQCXYS   BGCH            YKVCHPXIEMV     PLNHCLVFYUOYK   OOSNPDVPLRLLEYU
LUNNGSDMOFLTTR  : GVHNBKPTDFNXJ   RTYUSKLH        XPKTHIYATITPGG  NWPRWCUPHFIGP   LMNJOMPNVILLIMX
VSPCAKFYNSIBY   : RQUOWWQDTQKV    BNXJ           
EMMBBCHVHWKMIGJ : GWLLVMYTME      NOLGITVPMASBNMV VHYGHB          KKXBX           MVLROLXQQKLMBH  VCNJUXBNMDDEC  
