XMXCKYUJQ       : EMMXELWMT       SLYMGWSLRND     CPQYLCUXCCSIU   EECGJQCAJUYX    AOCM           
HWHCADGDFIRXC   : GMDQBXFKCT      GGIGYNSFBVP    
VLJIOFJNTH      : GUBRSWCSE       AXWLKPHGB       RDAEWEJ         SFNJKEYWJCSEQ  
FIMQY           : LCSPNW          EBJG            XLLSF           SDJOYBB        
XWXCYEKCJSTJV   : AYPV            LBFQFUQGHJXKVG  TSPVPKI         UWELXPCQL       CIBPEXUNGVVLB   OPEP            PQBUNSDDVPVMNT 
FJVPXD          : UEIK            KGLREQ          CTCCUWSBDBF     SUEFOO          PQNVM           AMGSAWPCXLL    
NYKFGURWUKX     : TPNAI           RTQIAOUVBVMA    PYWELY          KQBXQEO         FOMUUCFQ       
LCSPNW          : FIMQY           EBLJEXXGUR     
GSKEFRNBKMGL    : PXTBLJ          YQSKJUWUIELTYL  CAVNO           BRRVAJXWRPYUTNE PDAVSDOWRP     
FYIMTCLQNJ      : TAEHG           XTMRNGLO        TCDBBSOHKSIXYDY YUHRNFSNSGNQFN  VWOUSOFLJHC     OJJSFMD         QJALHU         
YMFQCERIWCNE    : WDJRLR          NRGMY          
DHGRNU          : WAMIYQOEAGAP    EYQGNYGSTR      EECGJQCAJUYX    QXTTGGPBXJ      EJDSYBEVJM     
TTDIPF          : TXWCJCABHRGQOY  XGONCXWXSLFVY   NYVSTJULTVJ     RTQIAOUVBVMA    CRCECVCS        DBPRRJMOIM     
HSGTTUCKWGEFGI  : TKLNCIGPEBXCSMQ HIUY           
KFBSNSIINCESM   : CPBHXCS         DQVBFQYN       
YHCTPVQKXB      : REMHSQQDGUU     NCMHGECN        GLJXMJHKA      
HIONQMAVNUKG    : GMFESPWSI       NXCTLFRYSJBFTPW JJVJGJMSBAQH    EWWHNVRJMRKIHF  IEUXRVO         CPIVPPUP        WMDR            IEMT           
UWGCPVWQFB      : RUYJCSOWYBLM    MVRBFIV         DTITITE        
UYEHXHO         : XNLY            XRCLUIGCVLSULSR TRJJCDKHPQGPAJ  QPAXM           NVIWSRUBFPE    
PFUHRWF         : JQAQIM          JCPLE           TKTU            BTIMINB         KWPLV          
SROW            : QSWTUIQPNENG    YNXWPRUNDKLIB   FVXRWBQMORFTJCO BKVRF           QPBRST         
NFPFBO          : DVYLRIQXX       FDDD            FWCOLTKUXGWPY  
GPKDOOKOVBX     : VRUEK           YLKJHAFHAHENUWM ABBRYJOSBLHQWQ  EECGJQCAJUYX   
HUVBSBJ         : LRAHJD          OYYH            VRBUOD          WRCJAKNEDJ      YMDQBQWWDLDOACU JQMFSIW        
TAIJNPBSRPRAH   : YQSKJUWUIELTYL  SIVTCLRLCFRAT   SLIFGGLYVKIL   
EXSOP           : OCUPHXMGXOBKJLI HEHNXNW         MGAOYNA         JCFNOHAMXPIUU  
QNGAJEBCHKNDMXM : UXRFRMD        
PNVHFPKMSOLNF   : UPKJY           UINWARNMBXHG    JOAIKHVS        GSYMTLD         OYUVVVOMTYOWAR  UKLFMVJSTS     
HXOP            : EIWMJTRNNKCR    FMRG            SNKRFVYF       
ATCCEMRHC       : TQUCJJTMY       RXVRYNQAST      TIUOLTWPFSKE   
UEIK            : FJVPXD          MSAY            JESO           
RQSCDNSQBB      : TAYDPKIMMXUIVP  TDAQPNKEHDY     LIYSN           RWFRDH         
LYLBA           : KVLTRIDJQJWYJE  NFUNMXUVKGTSFO  TQJEXHEDBXAVP  
XCOCQIJSBE      : QQFWULPHTWNVGH  PGHMFNGUJQXPBVF
JRCDI           : HWPJ            VLOSCYLIEYN     VTJDWDW         EPQAYMQV        TAALQFOCMWQXP  
INIDFME         : DTJQPSP         EGXSA          
XGMBIYY         : JGWHQGPMRAS     TPPMPDUIYSUR   
PDBXNWYTW       : JHAQYDDE        FMPISLDUNLEFU   IEMT           
LYQVUYK         : REMHSQQDGUU     WIXH            XFKEPCUOOY      PMWNSYSDGX      RGPYF          
CPTJQRREV       : PKSA            YPJCTTJHN       IOQXEXEWWYBBWIU FKGV           
FWKU            : SWYVPDCBXV      IMIUWLB         UJHHGEBBDL      RDISLUAOS       RKTTFXJYHWXT   
NSOMUK          : CQOUTAAOX       XQTIPFM        
HYLXUIWFPCWKNO  : XNYEOEMLDVUWJ   SUEFOO          LBNJOIYWMDNGG   YADISR         
FUAFAXR         : XYSNDSHRXUL     CRWUNFST        CQMPDNEV       
YHPPUM          : TLEKYNELWSKY   
GUBRSWCSE       : VLJIOFJNTH      ILIY            FODBHSSISGWCFXM GOUFYVBRKVVTB  
WCDKS           : HLJLHXRLVGSFELQ UNISE           XDNQ            DTITITE        
PNKWPKO         : LEMI            FIPRLUSIFO      FNUQBFUM        YDGDTLELR      
LVEDSRFCMJVHIY  : UORSIU          LJWJA          
MTYQW           : EJNXKGB         FTQQDEYN       
JIYYSVOFM       : JXVEVDXARFVHE  
QLIT            : QCWGOADCMJOR    GNXFNAYCMKIUNW  WMGFPTLBXXXXK   UCRLCLKUTKSHUDG
ACIOLFXTE       : VYQEODIRK      
IXAAWKL         : THGKE           WHYRCRRPVGNFPV  XDNQ           
JLBICGWGAIOTPQV : NSIWB           YRMGCFPJM      
HJDFFJGOHHQGRC  : FETTSOJIAENTDPS CSKVPQKLDEY     AEWJJGJBGIDVJXW
DPPNSXL         : PEELKGWAEHLEMOO USGVQSDG       
XVPSL           : YPUK           
QMPBPWI         : WBYXSCBLYXM     HXQDEYI         PBSGBFXT        WUXXX          
EWJNPSFSH       : KSIHSJBX        MINRO           WIGTASWGWHDPMU  NRTIDOYQKXGP    HJMORQSNWVCDR   OVNCLFCJTE     
IYYDWMCV        : EMYVMBTBLMF     LCDFVSCCIJR    
TQUCJJTMY       : ATCCEMRHC       UGDLLRBRXLOY    QXKFCVI         CVGYKOSL       
VDXU            : KIIXWMQLSA      PDSYKJOLGRRC   
LLISGP          : JMRYEDQOBDMFLV  GMDLKIPWQEO     EAFN           
QQEUNQYL        : HLJLHXRLVGSFELQ EYPDAIHWHUI    
TEWXQGUDHMB     : VAGBJYFSACL     WPBO           
MWBAKJSQBXH     : KJXXO           UIHKEER         JFJFHQPRLFXQOAS VRNGOYT         TIJHHPE        
DEHVEVVXCUXSDSY : UEBDI           SXGU            FUAXEPVSHCQGXK  TFMEIUPQJ      
HAYTYCTJNOCQNM  : RMMWEORLDCERKM  UNSDRVIHGOFWCR  MPQXETYS        KYWEEWTMO       FKXE            JALNYUIUI       FXVCDE          CWUBAPJSFYIO   
SQTOUPNU        : BHSFGP          FJDV            USLVOBKLISRQ    ICXJVLC         TIKUVBSUTIYMB   SFKGKMXXVRMJ    TSQOW           VQWIESRAY      
IVPOOOAWR       : BGDSUVQRIAY     QSBNCGDBOF      PRUQB           HQRBV          
SQFPDSEFJR      : XSOIYRQGXW      SMIVSIOQPIN    
TKLNCIGPEBXCSMQ : HSGTTUCKWGEFGI  LBFQFUQGHJXKVG  OWGONIICY       CTCN            YRATCFVRYNH    
OPAR            : GOMWQYM         AKIRUUTFUXTM    HYUSE           MNTKPSNSQD      RUUSXRNMQDTMSQ  XYJQWMFNCKMAE   UIOQRUUYATSK    DQVBFQYN       
SWYVPDCBXV      : FWKU            MSNADTNFHID     LMQEUNUUKJVGL   WDUOQJGOQHECSTE
KJLMSTCY        : OBIGRJIWAM     
DBPRTX          : FIGXFKSNVLNFW   SAUFYL          CBBXWUALY       RAYRTRH        
KABVT           : BHSFGP          BFARYJHB        TIGBAGSCXXVV    NEVCUJMPDWMMLN  BFFWRWWAVPSNR  
UPSATUXSRJCF    : MKJCB           BJNFBXJMJCG     MVVWXECMEOVR    NUPJIKJTXMG     QXTAEUYP        PQBUNSDDVPVMNT 
WYBX            : KWRAJS          NPYTNPLUKDXS    DVNKPXUR        JJOOUOIBUJ     
EYMVVKFGL       : WBYXSCBLYXM     KRLGXKCXM       CHYIXMD         OVCFU           DYCSBAEG        OFHEOGMLCWFMQYC
CHKYWFYR        : VARLLG          MQSYHMSXUVXEQY  UHWQGSLKHIFQNUC YRKOX           BKQJDAXLJTO    
AMULOAJOA       : CCAAD           ODFMBBWMNYQ     VJGMXSWKAJAULDY MEWHBJLTRSQ    
MXQOKNKXU       : NRCL            EWWHNVRJMRKIHF 
LGUSSTPY        : DISH            EKAYDCC        
JBUVXGNB        : OOUPUXFMSSVB    GGDHDHNCDBQWVED OBLQNJRTASYWVO  EWFJPH          AMRXXAIK       
EDDQBUFM        : AWMRGRNIRIUWDG  FIPRLUSIFO      VAKSIBIJI       ITUTBEMPKJ     
PMFIXMD         : FEYUY          
FYKGUUIPSIYI    : JMIDOAFGDLSQPQF OANIRFFHOS     
RMMWEORLDCERKM  : HAYTYCTJNOCQNM  GKRTTQTP        VABNG           GGONYWDGTHYDINY
YSKGRUNORXHNGI  : KDNYR           DVNKPXUR        JYKMYHVMTS      OWJJSVQHFT      EECGJQCAJUYX    LWKVT          
SALFWRV         : XUQMRWOUFW      GIXHVH          PQQLLPKJJP     
DYTHQGWIHR      : XNGDEDD         GECAEXKCVAMDYN 
OLQEBICKXKSUDS  : FXXGTU          JCPLE           OROMUBIHO       CHLXWBTY       
LRAHJD          : HUVBSBJ         EAPXDYWHLMUXSEU HJMORQSNWVCDR   FEYMADUDHQ     
GNCOMLWEIL      : QJLXHRKVAVS     LGREXKEUY       WFCNHTF         JNTRT          
YPUK            : XVPSL           KVLTRIDJQJWYJE  YMIMSVULAYUEV   BDWYIMOMCULKD   FCFGS           UXRFRMD         IIJTL           PAPFQXSWDCEJV  
YPUK            : PFVOWBOJE      
FIGXFKSNVLNFW   : DBPRTX          DMOGVFSSGE      RQHB            RTDIKCEXTPUGU   GSYMTLD        
OFJRUVFTC       : DVJALEYTSRMOS   MSEWCC          YQXXHSFKUHYTOI  XVVQKJOWMVJTQEO MAGVLBQJESL     VKTHWINA        MLHAGVIOWQF     OAHTSLAIDBCMC  
FVNWRASWKY      : DGRRVJXXTOPKPS  FDDD            HLBG            FTVDUF          YDNWMAALA      
QLQEHEUPCO      : WUAUMGGH        JMRYEDQOBDMFLV  IIYJI           QJALHU         
JXVEVDXARFVHE   : JIYYSVOFM       MSKWRPUAKPNQPKM ITTNCQFUBN      EWJOWFIONVYNW   UQHE            KKQTGFKYQEWYOW 
HWLTWJKICRSHM   : EBJG            GTPXO           KHTMSGIGCPFIUV 
JBMSBLAWOAWI    : QHJTOB          GUVDDNLJL       QWKJSO         
UPKJY           : PNVHFPKMSOLNF   BKRNXENHWWCAU  
WTHIGRKXKRKS    : CCKIICW         GEKXLNHBVRKAIB 
NIYOVYLKYKVH    : TEFARVGHBJVXKIA GTAKFDEENYHR    TSPTQVK        
LURNFOHOYNGJO   : ATMKJ           YLRO            RAHWEMP         WDABT          
EYOHNYGCUHQIJDE : RFNVRLN         HLJLHXRLVGSFELQ YMDQBQWWDLDOACU DFKARWLBU      
JPNDFUROLSFUFTO : SSVBCYG         CWSOECDHP       RDKRD          
SFSIFANAJEKS    : ROXKARSGK       PHBVLDJKK       FXOXBXXFNEJRNX 
OMTHCWMAR       : VHDEMWTRJEQ     QSUCQM          QKNCDB          UBGBRWCOAS      TLQMQMD        
NMJIRDYBXH      : AVWCXKWKYFX     QICEGO          USGVQSDG        MKMGUTJ        
HMYWOID         : KVYJXSKTPOHPEJ  WAAKVXEQBETBN   DBPRRJMOIM      VTRYGUTLOGEDXRN DRAWKTVEMFLLOPQ
EMQSI           : YCBTNMUFIDFWNWF UCGRTH         
UINWARNMBXHG    : PNVHFPKMSOLNF   SAJNHX          JYQWUCSNIHOBAL  BGQKMEG         KIDAGMXCJUWDX  
KEHHNVGK        : KADCFJTVQCS     XFUNFYFC        PHBVLDJKK      
PNMTDEMLEJTTJV  : SEHWFULFODKDXRD NWXHDHGJDRQ     PBXNFWIFJDL     PJUCPEVLTXDYUE  LHLU           
WLOUSUUDCC      : ILIY            KNTQLIAUCNLCAU  TGCUUMUPQPRSFC  KKYEXGUUNGYTS   FAKBSD         
PXTBLJ          : GSKEFRNBKMGL   
AFTGTGLGCHRYVO  : PMPRGMOYWI      WJVNIBQ         WPWRMY         
MLDKJIMNVCOQ    : XWDDFO          WKBTNBGWYQWSM   CIEQTOJHIFM     SNLWBRULQINMYE 
ACYAKS          : QYSCI           OQFQARXT        UBGBRWCOAS      PTTYWKQY        YKAHWEKVVLHMO   TKRKRSPH       
EBUMGEEFAUP     : TAYDPKIMMXUIVP  OQFQARXT        HVVFGGEL        VDGECCAOT      
JUASDMGAQU      : GJUJQYHEEOXE    JYKMYHVMTS      DFVHDVNG        ROQUNJ          UCWTXOK        
WWUVXFQH        : AXWLKPHGB       JQRLWKUHOUR     YAQHSB          FAVISKP        
UEBDI           : DEHVEVVXCUXSDSY RAYRHHRFKYI     GBVBYUBQGVLPGHH NAPJEKYKMVPKB   FHDHM          
ILDAB           : VMKOHTDRAFTW    TSPVPKI         RVCFEPNYNBAAU  
UBHAPOCGLUFJSD  : DFLGBYBYKVQXSV  RAYRTRH         IPHGTOWAQQN     HQSCRLXISRM    
XUQMRWOUFW      : SALFWRV         IXWOBLHDDN      KSDYS           PXUIGIULIGW     NRMOUFGOQNFLG  
SAFTPCWWEMN     : NKSCGBG         TBPOKFHABG      SWVYFVXWAKG     BEYGKJRADN     
VAGBJYFSACL     : TEWXQGUDHMB     ARQFHLYSFQBL    JTHGAC         
VIBQPXXJ        : MGHNNBPA        VTKFTRTVOUI    
DDSHDP          : BYLNHVYIP       KNJWJBTSMTCJFM  FCBVX           HKGLLBS        
PGWNGE          : NUPWS           KWPLV           HNIJJCQO       
PDUIFYVSUE      : LJCGUJKBV       AUECE           CCOTM           CNTLI           UGVYCDUPBARQQ  
NTWLDAQJ        : MXVVNQVXM       ROGJCVQEEVKIYX  RTQIAOUVBVMA    KLYJTRFOX       LISIBMJEA       RNGHOKG         OAYAIMGXAWMOIN 
AMKNEQLSWPKOU   : IHCCSMTXK       BDXGJX          CCOTM           JCBIMGTQAMOQJ   LYCGHJCP        FEYMADUDHQ     
WBGUVBYROTQ     : KEWHIW          AACXJ           GIIHQJRBJRNP   
YQSKJUWUIELTYL  : GSKEFRNBKMGL    TAIJNPBSRPRAH   MKMGUTJ        
JAJQAKWUIAUCQQT : MWRQNQSKMOIOOO  BDNETY          FKOCUMRPTMQWPS  YYPUYNCP       
RKNDU           : QBGUBKDKSMDDEOD
CRQGF           : UKFWLFJJDLQOO   UUATBEIKEAWQGHO AGDLCHIHTEOQN   BTYLLGR         GTSBGWDPG      
FQBQTK          : YOMJHMREYN      QQFWULPHTWNVGH  BCDDKFOCGEFTO  
TWGQFGNIYECRY   : LMCDTBL         NXCTLFRYSJBFTPW JNKDEKVIKTOP   
HCJPEDJNJYSC    : ARLBCONTMAA     BWJFRQVF        EIMVMCGMRO      NUBEO           DASBHIU         DXPUTPQNUYJLW   FEFEWDYJJNIGVA  EKKIMBTCYX     
HCJPEDJNJYSC    : FRTO           
KVLTRIDJQJWYJE  : LYLBA           YPUK            BGDSUVQRIAY     GUIH            UPASHY         
DDRLFE          : BVBLMPB         JYHFBPALUAFNO  
LHOYSPUVQHT     : XREGX           IAXCNSWMJBNJKQG XOFJH           EUSK            PQLWV           WHYRCRRPVGNFPV 
DMOGVFSSGE      : FIGXFKSNVLNFW   KSDYS           IXBUEBJNJ       YBQDUYNJDXSBJPH SDJOYBB        
LJCGUJKBV       : PDUIFYVSUE      RVAGLBOUGIA     GPCJHYLYCHTE    EWFDIBLCNEAWKAA TSCXDAIVPL      YBQDUYNJDXSBJPH CWUBAPJSFYIO   
RWNITLYDFFH     : YBAVYYSVJTMX    TIUOLTWPFSKE    QJVNVYQORW     
TPNAI           : NYKFGURWUKX     MLPLL           KNTQLIAUCNLCAU  DLAD           
IMIUWLB         : FWKU            EPLL            HEJPS           VKYYOTFPLR      FQAIFNEQLTEM    PCXGKOBU        XVUHGEFFWTIJIJ 
UNWSHP          : SKKFPBVASWC     TESPECUEVEFAN  
WAMIYQOEAGAP    : DHGRNU          GMDQBXFKCT      YOMJHMREYN      OVEPJUWNQROMHX  VTKFTRTVOUI    
CYILNQI         : MGRLWOPQRF      KBBSR           DLRUJODNPU     
ELJC            : QDYJGRYPLP      XCHIKRGKCGNM    PTHQQQHAOG     
IUIANGABO       : JPLNV           NOTDM           UFOIXUL        
TFFTMIJLKKVX    : SSKO            EPLL            NRIRNIUHP      
OIPTTBVU        : TAYDPKIMMXUIVP  EIBOPUE         YWINSGM         LNIXAEUSBFX    
QGKHOLIFMCL     : AXNGIWUNDY      VSOKSTWV        XVEADCKXJ       HGQAQNUPEWC    
XADHNNUJO       : WHIMXELKXYXSDG  EQQFFENXB       IROY            EAPXDYWHLMUXSEU WEBW           
XWNTTPRQCL      : XWNQI           VFMETWKCIPDEQ   EWWHNVRJMRKIHF  FIPRLUSIFO      FPUMMF         
MSNADTNFHID     : SWYVPDCBXV      JQNTUWOCYAICWS  BYLANHKN        BRVDBKR         PXWAOBTBXQY    
NMWDJIRH        : DBDA            DFTQVAVTOPDO    QNKESCACXLLUKF 
PVDJNUCPG       : UHIBR           IRMQTFMOF       PNWBOTLCPRRA    IPHGTOWAQQN    
CBPDELSLSDQCQE  : RUYJCSOWYBLM    XTMRNGLO        JQYCHD          HTSTYDKHOVNV    UOWVMWPVRANLYF  RKTTFXJYHWXT   
TNJOXS          : PTVFCJFMCAFHDL  IRMQTFMOF       ATQDBVETNXF    
TXPHURYETD      : MIPMBSX         SPUR            SNLWBRULQINMYE  IECYEKP        
MIMXBXTEPX      : CAOLMFTTVLVXLHC FHSNNWYWYXCG    DFTQVAVTOPDO    DNJIIORT        AJTK           
VARLLG          : CHKYWFYR        RFNVRLN         AXGAKYKJSCHSMY  THWHU           PXWAOBTBXQY    
GMDGEM          : ORGWDRWKCIH     CVFQPSESDP      OWVAF          
XNGURNHAAF      : NBWFCBNARULJQF  EHUDBJNCWTFSXYR OXAS           
YYIQAGM         : LJMBR           YAINAINUNCOVHXA ELFCY           LMQEUNUUKJVGL  
AXNGIWUNDY      : QGKHOLIFMCL     XHTBJ           VABCJAKLHURVX   OVNCLFCJTE      ITNEIIWYRA     
HYQPT           : NNEUOXH         FRXPYHCLFYLUQYE ISIWRSXIOYFVAQ 
EBJG            : FIMQY           HWLTWJKICRSHM   FRXPYHCLFYLUQYE JVVPCKGTG       YCGSXTMVQ       BYMOEAE        
NHIVXKCKMELBKTA : HQOBOPLPK       SEHXNRJ         LNTW            LFYKC           QQOIFVR         XVUHGEFFWTIJIJ 
HDIKLIEDCMH     : DHDSLX          QFBGW           PQSEYDTQGPUJ   
VQNLXXIYJM      : WEYAOR          KBLJAECRUPV     FRYTTMGXIXJLYB  YRATCFVRYNH     YFVNURSVP      
XRWYEQYMB       : HXFNGBHTLMSS    JUUHJTRLK      
UNSDRVIHGOFWCR  : HAYTYCTJNOCQNM  BDBWWAYULSK     YLRO            YVEOELWXGPNFEQV MDQGMTYTITMLCH  WAULQSUVPBVE   
CAVNO           : GSKEFRNBKMGL    EELX            NFUNMXUVKGTSFO  GTAKFDEENYHR    VBPPLJPFN       SJHTWIA        
MGHNNBPA        : VIBQPXXJ        UUNHXABYBVGCIP  XPIFVY          OBKGONEPTCLRBP  FNUQBFUM        OBHUGNGRLV      UGVYCDUPBARQQ  
UWTPDOLLVTABQ   : EVMYKDEDUU      LNNXVFCIYQCH    UOMNXRWMKNPRJ  
UQIWOYMYLUJBI   : DVNKPXUR        BXNVB           YUTEUJBQVOE     MTBOXTHCCNVU    UKLFMVJSTS      YBWRAB         
QKON            : OGBQYVPU        RDAEWEJ         XLGPSQ          NKNGNK         
KDNYR           : YSKGRUNORXHNGI  DIAODJGLEQTQUEO QDTNOQ         
ULDYFJ          : DGPW            HBWEMKXIFR      NRGBTLCVATXN    CNMB            PTWOPFCR       
VRTMSGMEBVIMIY  : SFAPAETCKAFT    RQHB            HWKVUWXDLSS     LNIXAEUSBFX    
YPJJUYJMCGBFHG  : DNSPJWRPCVB     UKUJPDWHF       USPVPMGDXACDJS  BUDDIMV         PPSSWYUDXA      PBGAIIKFIX      NYRQMJNO       
EELX            : CAVNO           BVBLMPB         XRLOJCAWPHPAM   TFXLQVKNPLGS   
EEFLHB          : PUKVPSGTYBDCEPO OQFQARXT        DSUAOBJPKQTAQFW TEKYCBVVTRLXLL  GTLEFUNKBN     
VJUVKKHUGHEUJ   : UKFWLFJJDLQOO   PBURKK          IRMQTFMOF       STXDCBA         IBJKVLVEWDFQBH  SXAL           
VRUEK           : GPKDOOKOVBX     OCUPHXMGXOBKJLI EMNQNDYNMWQQDO  CVJPABRU        FCDJMFGEJG     
KVYEBFJOMNILY   : FCBVX           VGFCEVLIBTLK   
HKQQFWXLTKASE   : EQQFFENXB       KSDYS           RVWNXEPVMLHEYXF
WOXKNW          : MXGWTWD         IOQXEXEWWYBBWIU LNEEVSYUMJRB    YWINSGM         XKILH          
OCAFRNNFNSMA    : QHMPL           QTHCNVNJWQ      LUAYK           NPKVOLKAFHW    
FFIE            : UTTCBLJLLUCXHM  YLFMLIXIFBHT    HIHXA          
DQSVUQU         : JQNTUWOCYAICWS  QSHYCYDCM       QPIFAPYDWQENGPF DQVBFQYN       
OFYMVPQWUKMKPAE : DUXOWESCNMXFPSH IPVKMEGWJRAMLO  VJCEMY          XLFFCSQLLX      ESYSKKOYXCYEJ  
ANKH            : UDXOJFIUCNRXYJB TVCYUAUJ        QMHSG          
QACHVXE         : MCYGUFQTRT      MGKNRDJAF       NVCOMFWTYICV    RVWNXEPVMLHEYXF
UPBBPPYHJXDTLNM : NEKTHEWWB       FKOCUMRPTMQWPS 
TQQI            : YHCIR           BQUBPJEOQQBYK   UXQMCI          CMAHXPMURJGEYJ  WUGBYJKYVXA    
XHTBJ           : AXNGIWUNDY      FAMBAS          DNJIIORT        WDAAJOPVITIIYJE JLMCLFPJUENMQ  
WHFLCXOFPFHWQF  : HQSFN           WGVSLI          QXRPMH          TTMQYUHPTID    
MQSYHMSXUVXEQY  : CHKYWFYR        YACQQWSXDKFLIJQ MPVFWADVUMC     HUPBGHK         OCDKTRVJJX      FLONMIHE       
TXWCJCABHRGQOY  : TTDIPF          PQSEYDTQGPUJ   
TLPMLWYEUWCTB   : BGDSUVQRIAY     HDSGAJAASH      TLMAQJFALHRWB  
UPNVOPHQRIBJ    : TVPHLGLJQY      MXJSE           JVWOJUFFQVYES   LNBJM           ELSGAMR         IOPUCYVLUGARY  
RAPOTCHGPGGV    : UGXDOLOHCI      BTHVQBQFRN      SYTWISUAQLCCQG 
FXXGTU          : OLQEBICKXKSUDS  BDXGJX          TGELQJUUNRW     HBFKVCEFB       WICQ           
HQNYYEQHF       : XTCUSFJYAHCFUQ  EWFJGMCGC       LLATAXNFR       KGBLRSCKCBHLXRS PPIYQGE        
YACQQWSXDKFLIJQ : MQSYHMSXUVXEQY  YDIMLG          VHKPPDAOUOIIFFP
HADEXMVNLUS     : AHVRFTN         MKLKG           BLLKM           UXRFRMD        
EAGDA           : JVWOJUFFQVYES   SXUWVFWIE       JVVPCKGTG       UWELXPCQL       WKBTNBGWYQWSM   KTIRMSXJEXBGEBB BUESUQXKSKW    
WRFRRLDW        : XWLGUTEGGFHP    GNOGRQSTT       KQOPNKL        
NIQW            : YFIETDNWYKVSYOU LNNXVFCIYQCH    MUPYGEUO        CTCN            UWFOCDOSAKLN   
QAWQ            : JLTBFWJAXV      QCDKPWDGTHY     NMWHHLR         QLTRVPY         WOTSGWPNW      
SFAPAETCKAFT    : VRTMSGMEBVIMIY  OPPITEDETI      KNTQLIAUCNLCAU  CPBHXCS         EJWYJVONUDCROEK
WBOOMTOMIW      : KMKGDTG         GMFESPWSI       GARA            TEKFTRSD        EWJOWFIONVYNW   BDITYQCEWAPFCL 
FPVIMO          : SFNNOCXJMWC     JDPAAXMK        EMYVMBTBLMF     UOMNXRWMKNPRJ  
HVXWXESBRU      : AARCPLWJ        VABCJAKLHURVX   YARHWHPN        CNMB            AOCM            NOOWUNODOL     
LTFOJVCF        : FKCSF           VERUBYTVIKURM  
OPKTVA          : UUNHXABYBVGCIP  JTWTGDXBKPAHLAK DYCSBAEG       
GOGD            : QHMPL           IKGLEVVQUYAPEGL HHRVVVHHGN      CCUPQD          IGRLOBCIDAOSFW 
DDWBIPEC        : JQBNMDIKSWYH    AGLQHA          YHYNORKRGDK    
MPHREQOIYB      : LMCDTBL         YEXNBJIIBHDMK  
OLSMNKSERY      : JQAQIM          LNSQSTDOOAWYT   BRVDBKR         ICFBJR          DLAD           
WEYAOR          : VQNLXXIYJM      WTPW            WDWGXTVRONGV    EKAYDCC        
QDTGMMLED       : GYKAPWHL        YPJCTTJHN       FQYXWWAB        SEHXNRJ         BRTNIOIT       
FETTSOJIAENTDPS : HJDFFJGOHHQGRC  QSTVREGQEMUH    LCIBOPMRLVPC    SUDNDW          UVFSFJUOYRYKE   WDUCOWTLIXIYF  
RUYJCSOWYBLM    : UWGCPVWQFB      CBPDELSLSDQCQE  NFLRLNG        
OJMUDJNTSWVWM   : EXJTGKQGWHEFGK  VKTJXH          TJXMC           PQSEYDTQGPUJ    MTBOXTHCCNVU    TQJEXHEDBXAVP  
DCKN            : ODLEFXQ        
GODKHTHJVSVDHF  : XNYEOEMLDVUWJ   KYJMVDAEDCLUE   OXULXDXWRSPMMM  HUSPFUCGIA      HMEOXYFATGMAD  
FKCSF           : LTFOJVCF        YIMPLXWQSQQLC   EUJCIIACCJYPDUY BRVDBKR         EJDSYBEVJM      FXOXBXXFNEJRNX  YYMKEOJRBDHPR  
RDTEVWJI        : PVAV            LJWJA          
FQELCNFJ        : RXVRYNQAST      TPQKU          
BDVFMDXROA      : MLPLL           LRPKJEV         PVGDFMQWNL      CBQEPKCNLMXLQ  
VWHBQMWQXGFDWJO : CNGJR           VCFJCYE         EWFJGMCGC       ELXXJJQBREVCVOQ YBWRAB         
AWLYXQUFDYFXP   : CRJH            XSVXVVTC        XAQJBQ         
NNEUOXH         : HYQPT           WHIMXELKXYXSDG  WMUBOYMLNGH     PCMKFW         
OHUT            : EGEIHPSWISVNX   KNJDTXOQM       YLKJHAFHAHENUWM IFRPFLHMRQARE   QLIE            JSPFJJHHDDNRDEI FIEBYKDCU       OMTUQSGSDFP    
OHUT            : OEAO           
TGCTGYHFX       : KFDQMBXNCIVGDGL GKMVHGSHRHVAD   JDWAAYEGGSKG    YXHWLEPXS       BBFU            VVYNUJCNDNPA    IGHTCGBEVBTXG  
DFDELBTSOJAK    : SJVBARABVT      BABLDRBW        UFOIXUL        
XTMMCHIPE       : BGDSUVQRIAY     XYSNDSHRXUL     RMRVSWKK        RWFRDH         
RAYRHHRFKYI     : UEBDI           PCXWUBERRDMMM   XFAOVSPQD      
KMKGDTG         : WBOOMTOMIW      GJUJQYHEEOXE    NDSLFGKIBLXXKN  BTCGHR          WDUCOWTLIXIYF  
REMHSQQDGUU     : YHCTPVQKXB      LYQVUYK         RVPVAL          VXSQ            STSODYHEOE      FAMUTMLLTPF     THWHU          
UTTCBLJLLUCXHM  : FFIE            BJFTTRFNDOGBMSC HRGVWXDGDFV     OBIGRJIWAM      AULXRPKWMCQRFKU WGOSKTLH        PJUCPEVLTXDYUE  AGDLCHIHTEOQN  
UTTCBLJLLUCXHM  : STDNUSP        
MGMDBS          : NRLIP           EPQAYMQV        TQAQGGIXMG      KJKBPHOAAGXQUKQ
ILIY            : GUBRSWCSE       WLOUSUUDCC      KYWEEWTMO       UGECUMP         UOWVMWPVRANLYF  PYXNTNDGGJEQKW 
OWMORGJUIWGV    : FJDV            LIXWF           TGBFQK          QWUJW          
BBJKNRXWF       : DKUGYYIB        ELSGAMR         UWHDFPF        
AXUKMDLETIQI    : MKKOROUY        EBJYKKY        
WTXH            : KYJMVDAEDCLUE   SKJK            EXBYTU          SGFOLL         
EGEIHPSWISVNX   : OHUT            NFLRLNG         VMRDBTD         OJJSFMD        
NSICXUGR        : GEGGUF          XVVQKJOWMVJTQEO YHCSJOYRW       IIMJ            LMCLWFELKCRRAW 
YDGWYGGS        : JPLDUAPHSXSPJJQ NJNFASICCTOUSYA FEYUY           KJXXO           YDIMLG         
MXVVNQVXM       : NTWLDAQJ        MYMP            HEHNXNW         OBHUGNGRLV     
NKSCGBG         : SAFTPCWWEMN    
XNYEOEMLDVUWJ   : HYLXUIWFPCWKNO  GODKHTHJVSVDHF  SNBCSRFEVYUJEEB YDMNVDOASCEMD   HFQOFUPIADGY   
WHIMXELKXYXSDG  : XADHNNUJO       NNEUOXH         FGGKGDKGBHAM    UWHDFPF        
KMUANBORODVK    : CVFQPSESDP      GGIGYNSFBVP     DIKTPYW        
UVJRDREBVROWRO  : LLATAXNFR       VISPXBVUS      
UUMH            : RVAGLBOUGIA     SPUR            KXACRTYS        VGBQRCRMISXVDH 
KHVLYNCELMEIK   : QSWTUIQPNENG    XGMCIH         
CNGJR           : VWHBQMWQXGFDWJO WVJYKGKYOQSG    RFGWEQNOKORXHY 
BGDSUVQRIAY     : IVPOOOAWR       KVLTRIDJQJWYJE  TLPMLWYEUWCTB   XTMMCHIPE       IRTJTUSIXLCMI   RVWNXEPVMLHEYXF MWPMADUBTFX    
KWHJNJNBYR      : QCMVCBJWILE     VOLQSGET       
JHMXNX          : MVASLPUNVRS     RRIH           
UAXXUUVN        : VTORNVMNDHUAQ   CQHYLTVHEFLQDVL WWYQQO         
FONCYLJIY       : HFQOFUPIADGY    UDMUDHWEUBC    
XAURMGYCGPAXK   : GBWECS          TYKOMIVXVPVERA  IJCHWFFPUNGUKFA BTIMINB        
VKXSHLHOAVQYJD  : ITTNCQFUBN     
KYJMVDAEDCLUE   : GODKHTHJVSVDHF  WTXH            JIFBJXYR        OBKGONEPTCLRBP  VHVSRCUNB      
FHIRFDYQLP      : MCYGUFQTRT      ILRMJSYBTIMVVD 
JJUSM           : AHVRFTN         GNOGRQSTT      
DNSPJWRPCVB     : YPJJUYJMCGBFHG  WBYXSCBLYXM    
BNEIXVN         : JXVNYMVKANPNRUM MAGVJKXW        WDABT           LWKVT          
XGONCXWXSLFVY   : TTDIPF          QHMPL           VCFJCYE         FCTNXXYUKBGWK   SOHGCYPV        RQXQTSTGTF      FALHNMHPHAXFN  
OIUIBYFCVIRA    : YFVNURSVP       FGGKGDKGBHAM   
RWGVWOKKRLKPEV  : JRCNFMNPR       CEEORJEBA       BEKQCOWIDDH     WUIWJFAQHXJ     VHKPPDAOUOIIFFP
DVWRGU          : GNOWJLRUSQ      ANEFLGISMA     
HTHMQRGSKYRSU   : YCGSXTMVQ       WEBW            FJJRNAIHJLYWLX 
IHCCSMTXK       : AMKNEQLSWPKOU   TEFARVGHBJVXKIA MGKNRDJAF       FKGV            RDPNEEA         XGFEYA         
DGPW            : ULDYFJ          AJPAYPELNBJJGH  YAUFEYTROXMAE  
KYWFJLXBSQMRJFO : FTKJBJUPUMKNX   UDMUDHWEUBC     GPCJHYLYCHTE    MCHCVRAP       
PVCTRONRCG      : CQDLRJ         
KWRAJS          : WYBX            IVQYUVAYR       WHYRCRRPVGNFPV  KAODNFT         CCKIICW        
QCLOGGIUATCOTS  : QYMMONCNXEBPR  
WOFNDYPLTBIN    : TFRBU           MCDAK          
UGDLLRBRXLOY    : TQUCJJTMY       CSKVPQKLDEY     AJPAYPELNBJJGH  LMJTPML        
QPYLDXBKMGJE    : XLLSF           MHMDVNDLSLH     KDSCONYEGXGFF   XSOIYRQGXW      DIKTPYW         OOIJUOAQLUFNURL
DHDSLX          : HDIKLIEDCMH     BFCEFRE         FXBIG           FDDD            AVQUXUS        
QJNIMHJXXID     : STGFTTI         XRNXICBBD      
XFDEDEOR        : ODFGKEQNCPY     QTGMIRRRPKUHA   DBCUAXKIK       GIXHVH          VGFCEVLIBTLK   
YYCEIFXVFCNPR   : VUYILBPCWNJT    VWOUSOFLJHC    
CBHDYRIPSNSWTWN : BYLNHVYIP       EIUUKFMI        FITHVCNXDRYNWW  OYTGPK         
JMOOTAVTVCV     : MKJCB           QMHSG           XAQJBQ          EPHPSWBJFB     
RNKV            : NRYLJKIQS       MKDHIGTELT      FDJSR          
TBPOKFHABG      : SAFTPCWWEMN     DQBJGEU         VGBQRCRMISXVDH  TYOXUU         
ATMKJ           : LURNFOHOYNGJO   RBQSSFFA        RHEEUTECOUMUEL 
BDBWWAYULSK     : UNSDRVIHGOFWCR  VMRDBTD         MYUIRFP         QJALHU          BUQVB          
RBQSSFFA        : ATMKJ           ENCPBGNOB       DBPRRJMOIM      VTCNUHLRBK     
GBWECS          : XAURMGYCGPAXK   HPTHDHDYLCUMA   XQWIKYEMM       FHDHM          
OCUPHXMGXOBKJLI : EXSOP           VRUEK           FPUMMF          FEBHQEKYRIS     YHLLIFKPBUGBMYP HXTTUSRDOBQ    
OYYH            : HUVBSBJ         TCDBBSOHKSIXYDY AUECE           XQWIKYEMM       JASVLRVUHMXYXDE FAKBSD         
EIWMJTRNNKCR    : HXOP            KQBXQEO        
TAEHG           : FYIMTCLQNJ      FMRG            BBGQTI         
XKOJ            : MMVLJBQRRWB     LWVX           
XNLY            : UYEHXHO         DBCUAXKIK       DXPUTPQNUYJLW   XPRFERG        
UISDFIPCCFRMI   : OQFQARXT        TCQDGJD        
SCJYLSDLDUVBS   : BCVKXMBULXVJAC  CQDLRJ          OVCFU          
OTAKCUPKFFMH    : YHYXRX          KCUGE           RKRSMKJNSLVBVD  FGLUASSQ       
EWVPP           : HDSGAJAASH     
CQOUTAAOX       : NSOMUK          LHMJHFM         OLGPRYL        
JLQGNDI         : RSATLIVP        VFMETWKCIPDEQ   BKOHRXYQUUXCDNW ISKULKMPGRGNH   UQTVDEFEOK     
SUQBJBMPXKGPMI  : KJIMEFCLD       JSPFJJHHDDNRDEI QWUJW          
BFCEFRE         : DHDSLX          YNXWPRUNDKLIB  
DQBJGEU         : TBPOKFHABG      MVDSLBQIYX      AAOUYAJTEWBUTRR CNMGSPWVRYYT    FGYUBHADWHV     KEBPGJDPAUGMS  
ARLBCONTMAA     : HCJPEDJNJYSC    YLRO            NXCTLFRYSJBFTPW ELFTCFJKTNE     ATVWSIRKHOS    
MKKOROUY        : AXUKMDLETIQI    YDBQ            XLHKA           KGNBITFX        QQOIFVR         DXRXHNRFVP     
YIMPLXWQSQQLC   : FKCSF           FJDV            YQXXHSFKUHYTOI  VWDSBKYLFKGRP   QUQENPCBEWFDINJ STXDCBA        
PSHJHJKL        : DROKU          
WXMPNJOVJ       : MSFDHCURI      
KBLJAECRUPV     : VQNLXXIYJM      CNRPBXUVM       GPQB            OFLFGPELQ      
FRXPYHCLFYLUQYE : HYQPT           EBJG            PQQLLPKJJP      QQOIFVR        
XNHIR           : GUIH            KRRFP           CWSOECDHP       FEBHQEKYRIS    
RRWWLTMKKU      : CKUPSFDQPLJYF   SUEFOO          YSNLOHWHRRM    
KKBRMO          : LNEEVSYUMJRB    SNKRFVYF       
NBWFCBNARULJQF  : XNGURNHAAF      DGLG            DRAWKTVEMFLLOPQ
NEPKTCUOE       : QYAUNXOWTG      KGQLTQQKKXFRD   DIKTPYW        
YHCNWCBAY       : OPNQKIBPHCM     VEWGP           NFUNMXUVKGTSFO  KCVQWWNUFBACO   UOIGJYQOJPGHC  
CDVFUTQGKX      : DRNFLIV         KLMRVEJIAFGURJN TSPTQVK         GXAGLHRUQAYIAXM MBTT           
ADBKWFINLQOTS   : XJLOVV          QGIRXMQVCWRAKU  UXQMCI          KEUBIYHJAAK     FXVCDE         
SXFSYOU         : LHMJHFM         WRCJAKNEDJ      KYWEEWTMO       CHYIXMD         ATNMVCCEUDLGY  
MCYGUFQTRT      : QACHVXE         FHIRFDYQLP     
UGXDOLOHCI      : RAPOTCHGPGGV    YWTTXC          VTORNVMNDHUAQ   VYEILLMIXTYRM   PCMKFW         
GBBLVCCTFPV     : SAUFYL          CRTCXV          QJVNVYQORW     
XTMRNGLO        : FYIMTCLQNJ      CBPDELSLSDQCQE  JFJFHQPRLFXQOAS
ROGJCVQEEVKIYX  : NTWLDAQJ        FMXR            CXFOOYWDQEBTMO  FMPISLDUNLEFU   CCVDMMDGOCK     VDFP            EKAYDCC         FQFJVKYBBWL    
CDAJUYPSS       : TRAXIXNPVOHB   
KIIXWMQLSA      : VDXU            JYKMYHVMTS      RCBGPB         
QSTVREGQEMUH    : FETTSOJIAENTDPS DGRRVJXXTOPKPS  DCDARITLGCJXR   NFKSIRDYT      
ECMUVHWIPIHM    : JDWAAYEGGSKG    JJOOUOIBUJ      ATGBFSQ         NOTDM          
AARCPLWJ        : HVXWXESBRU      FRYTTMGXIXJLYB  FTKJBJUPUMKNX   OXULXDXWRSPMMM  EJMPSJE        
OPPITEDETI      : SFAPAETCKAFT    MQBOQXVJVDVAW   HWKFC           CMEOORJDQLAYSTC WJVNIBQ         HSBFSIFKGO     
IDEPCP          : VHDEMWTRJEQ     WDNOUHCAGUOIPNX
MYRLYTGDJRAS    : PKGPFEUWXFLVCBH PBURKK          LOIXBUQG        QMRIMPU         TAALQFOCMWQXP   OHCDHDIHTSE    
PKSA            : CPTJQRREV       ODFGKEQNCPY     GPCJHYLYCHTE    CSKVPQKLDEY     SUESPY          CCAAD          
WDJRLR          : YMFQCERIWCNE    LHSVWJADLIVKYNI FAMBAS         
QWQVMXK         : RKWXCXCAKA      QMYFEGRAOBOVN   HCVBTIRLRGCSDKF
SWMMFPYWPRXH    : WAQPTBMUI       WWKWWOMTJQB     TABCGJBIEKPIED  KVJEVFCHHLLEV   CEEORJEBA      
QHMPL           : OCAFRNNFNSMA    GOGD            XGONCXWXSLFVY   JGLGBMONIOHU    EKAYDCC         SOHYOQKUCXW    
HYPKSMDOBBYOTX  : UXJXDB          CSKVPQKLDEY     TNNYWYF        
HDSGAJAASH      : TLPMLWYEUWCTB   EWVPP           YHYXRX          LMCLWFELKCRRAW  YVRNPLRCVQFY   
DTJQPSP         : INIDFME        
DKUGYYIB        : BBJKNRXWF       XREGX           EMYVMBTBLMF     BQUBPJEOQQBYK  
CYRLDKTDVW      : KWHEAFJKIDJL    NUPJIKJTXMG     THWHU           PDSYKJOLGRRC   
REYWYKNQEFYHQWO : FCBVX           BQPLSIPPKHMSB   UPLQHMYDI       AKLHNIHGUVWE   
XYSNDSHRXUL     : FUAFAXR         XTMMCHIPE       OGJT            DGRRVJXXTOPKPS  TLINWGJ         BEGJSFCCUVUPM   FYWQIQJBNVQ    
SKJK            : WTXH            QKNCDB         
LHSVWJADLIVKYNI : WDJRLR          DROKU           UXQMCI          XHTXBWUO       
JVDEGU          : MVRINVIL        MWRQNQSKMOIOOO  QVOLRRHXNXP     ANXWEXHYKHWB   
BJFTTRFNDOGBMSC : UTTCBLJLLUCXHM  KGQGSIKVE      
EMNQNDYNMWQQDO  : VRUEK           DJLPGRRNWSQWYU  MYPQDMQUSSJKHAJ
EXBYTU          : WTXH            UPQWY           XEXDLIQOB       EBJYKKY         RYQIBXDUKFFPIHC
IXWOBLHDDN      : XUQMRWOUFW      XAQJBQ          VSISOKDYGTFP    XNNERMYV       
SEHWFULFODKDXRD : PNMTDEMLEJTTJV  RDKRD           ITUTBEMPKJ      JPWEYEYXNBXKDS 
SWVYFVXWAKG     : SAFTPCWWEMN     OOIJUOAQLUFNURL
NWXHDHGJDRQ     : PNMTDEMLEJTTJV  YCBTNMUFIDFWNWF
WBYXSCBLYXM     : QMPBPWI         EYMVVKFGL       DNSPJWRPCVB     FFQRGYK         CCMMTKVOLYSANL  OFLFGPELQ      
VLGVVOCLLC      : GEGGUF          KIEYDW          MQDIOVYBOKDSQR  JMMT            BUGRNMNGJL      YADISR         
PJBBOVRKSSJSOLU : IIYOFQKKYMSEP   OMTUQSGSDFP    
NUPWS           : PGWNGE          NXCTLFRYSJBFTPW TYKOMIVXVPVERA  JCPLE           SYTWISUAQLCCQG  HUSPFUCGIA      FJJRNAIHJLYWLX 
FRYTTMGXIXJLYB  : VQNLXXIYJM      AARCPLWJ        EQEXX           DOYFK           WQJDLIRF        OESYUCE         OFHEOGMLCWFMQYC
QLDLXXALSDY     : NCMHGECN        VXJCUTEYSJMH    LWPEISPR       
UXJXDB          : HYPKSMDOBBYOTX  EUJCIIACCJYPDUY NVCOMFWTYICV   
XWLGUTEGGFHP    : WRFRRLDW        QYMMONCNXEBPR   OEAO           
VUJTTMFORHDOF   : AUECE           VGFIKALY        WCYGD           DYCSBAEG        PPUJKFDOKYIDEO 
MLPLL           : TPNAI           BDVFMDXROA     
WRHTXPCFARDVPM  : LSKDHHXRPN     
JBWXUEDJMR      : JYKMYHVMTS      FTGAXAT        
XHJJTHDDDDVFI   : VROQFYO         AWNYSAJAXTDXFBK ROQUNJ         
YLRO            : LURNFOHOYNGJO   UNSDRVIHGOFWCR  ARLBCONTMAA     DJLPGRRNWSQWYU  HHRVVVHHGN      QXTTGGPBXJ      YXLGHBQIXEU     TATMBYVSREHLS  
JAEIBYPEJ       : GKMVHGSHRHVAD   EYQGNYGSTR      PQFUIDSTKGWWVIA ATPPLLJYM       TKRKRSPH        JCFNOHAMXPIUU  
YHCIR           : TQQI            FEDPF           HMQHTL          NRLIP           LNBJM           OQFQARXT       
FBSIE           : NRGMY           VOFGVPLGCFO     VGKYGC         
EJEAIRTARDAV    : JESO            DKHWYMCQMVBJ   
BXEIJGHQKR      : LGREXKEUY       BHSFGP          EEMJGDSD        DVNKPXUR        GQBXJOSCTOGJ   
XWNQI           : XWNTTPRQCL      YFIETDNWYKVSYOU MQBOQXVJVDVAW   LHMJHFM         VHTUUWGFJEI     RFGWEQNOKORXHY 
OOFSRQKLQE      : YMFF            IRMQTFMOF       VAKSIBIJI       IGRLOBCIDAOSFW 
QBGUBKDKSMDDEOD : RKNDU           WLHFQ           AOCM            ETORJIMECVFBQB  AKLHNIHGUVWE    RJUWXJYJIGN    
EVMYKDEDUU      : UWTPDOLLVTABQ   UGMIEY          VGFIKALY       
JLTBFWJAXV      : QAWQ            ELGW            CLYPARHQDPXDA   FCKWSDRMQ       KFBUSOHLTCAQY   FBXTIWEK        LQSMRS          XNEJQOW        
JLTBFWJAXV      : HXTTUSRDOBQ    
IORMTVDWCHUOGFS : MMVLJBQRRWB     SSKO            GTAKFDEENYHR    JNKDEKVIKTOP    EKKIMBTCYX     
IPIAYUTCCR      : YGQSW           DASBHIU         HKRAXMPAOTQBT   WAULQSUVPBVE   
CRJH            : AWLYXQUFDYFXP   MXJSE           NRGBTLCVATXN    MBOSTU          UCRLCLKUTKSHUDG DKKSWMSNGEDOQD 
AYPV            : XWXCYEKCJSTJV   PASAQOTEYVAC    NFKSIRDYT       MFXKSL         
SUAAPOJU        : GRPCFSCWLBQV    CCHPWKKJU      
WFCFFBCAEETTGL  : INLRENBWNKP     MKDHIGTELT     
NOGOEDMWXMA     : PNMXDJECH       SPSDWNPA        PFFMDPFSHBYKS   CAFJIIFUGEFX   
DJLPGRRNWSQWYU  : EMNQNDYNMWQQDO  YLRO            YXHWLEPXS      
TEFARVGHBJVXKIA : NIYOVYLKYKVH    IHCCSMTXK       FEYUY           KLYJTRFOX       QJSQJX          FVXRWBQMORFTJCO DQYSRBQPGGVRAJ 
LJMBR           : YYIQAGM         LEMI            GPQB           
SGCOWBNT        : WVJYKGKYOQSG    CAANTT          AMIPHEUBCYQMV  
JXEJQASABEVCOG  : MSAY            FQPPIKNFQI      YMNKSYWOBW      PBSGBFXT        QVJRC          
PROFVGJQONFLP   : GSWIJSSG        ATQDBVETNXF     BWIMDI         
GMFESPWSI       : HIONQMAVNUKG    WBOOMTOMIW      UYFLOIKQHAKQEB  QPFWPW          PJUCPEVLTXDYUE  FWCOLTKUXGWPY  
UOWYEDDVX       : CAHODSRM        GFJKTRCLTKGX    PQLWV           DKQRXGSGKRVIUQ  HISGHBASHYOSFYK MWPMADUBTFX     FXOXBXXFNEJRNX 
BVBLMPB         : DDRLFE          EELX            QFANWEVRP       BXQQWRKAYHOWBSG SHHIYOCDIGIFD   TJXMC          
EQOMFVSX        : XRSPUULNBCMSSJ  XGFEYA         
QTVROLPPRUSN    : PNYVHKIQMJAQD   ORGGIEKE        GOAIFJBJHWHC    EQVRYWYTMIH     RUUSXRNMQDTMSQ 
LRQOFE          : BUXDVPXNE       KODEPV         
GYKAPWHL        : QDTGMMLED       IROY            VABCJAKLHURVX   BTCGHR         
GAJAXBQLSIDQBT  : DLRUJODNPU      BRTNIOIT       
OLFDSL          : CCFVR           TAWICKTSYORCD   IXBUEBJNJ       KVJKCVAXRWH    
YMUYCUHNLPP     : RVAGLBOUGIA     LHMJHFM         TSCXDAIVPL     
ROXKARSGK       : SFSIFANAJEKS   
CXLPDOIOB       : QTCYT           IGRLOBCIDAOSFW  BDPJCBMLVJV     WAULQSUVPBVE   
BWJFRQVF        : HCJPEDJNJYSC   
LAAAXMDRFJ      : QKNCDB         
BNBMDGELXFUBEE  : BPEB            KNJDTXOQM       NEVCUJMPDWMMLN  XATYC          
XWDDFO          : MLDKJIMNVCOQ    CNMGSPWVRYYT    WDAAJOPVITIIYJE DAJCEJJNYMRJQVM GTSBGWDPG      
HRGVWXDGDFV     : UTTCBLJLLUCXHM  KOKHADGVIOCTADT CVWIEAGTFM      RRIH            KJKBPHOAAGXQUKQ
TYMAKMGF        : IFRPFLHMRQARE   IGQRAXG         PLVEQKSONJ     
MMVLJBQRRWB     : XKOJ            IORMTVDWCHUOGFS BKRNXENHWWCAU   AVQUXUS         LLATAXNFR       KVFJBSNPTRM    
DXIDBQII        : EVSMNRFYJE      UWSNPTSCHPI     UTDTWYPLAY      KYVOGGKIMPLGBB  FHAFGFMR        HXTTUSRDOBQ    
ODLEFXQ         : DCKN            QBEGYTOYIOO    
GFBSDOCGFVYEX   : MVRBFIV         MYUIRFP         OLJRKHOYCURQGQV CHYIXMD         ARQFHLYSFQBL   
JXVNYMVKANPNRUM : BNEIXVN         SJGJDVMK       
JSQMNVDRDKOEP   : CLYPARHQDPXDA   EUSK           
QYMMONCNXEBPR   : QCLOGGIUATCOTS  XWLGUTEGGFHP    NMWOOVMYEMBT    UDCKUWQTCKRON   BKRNXENHWWCAU   QXTTGGPBXJ      STDNUSP        
LGFWBXJOWMHAW   : VPKLLRILUEJJH   WDNOUHCAGUOIPNX WWNFPUGUJHUWTAX EHWBOJM         JEORSBFF        PQDQGTMOSL     
GOMWQYM         : OPAR            NRLIP           MSFDHCURI      
OOUPUXFMSSVB    : JBUVXGNB        YQGGYBDNIQO     CCMMTKVOLYSANL  ALWPLAJHRSDDWKY QTCYT           WFVMENWBA      
WYBMVPVXP       : YWTTXC          MVDSLBQIYX      OLGPRYL         DKQRXGSGKRVIUQ 
GEGGUF          : NSICXUGR        VLGVVOCLLC      JCFNOHAMXPIUU  
DVJALEYTSRMOS   : OFJRUVFTC       IIYJI           FBXTIWEK        CXFI            PFFMDPFSHBYKS  
OUGBSWWTMQASY   : ARRBVOTWRELTOYQ YGQSW           MOCE            NUQQSYPYOFYY   
QGDTCMT         : VGFIKALY       
SSKO            : TFFTMIJLKKVX    IORMTVDWCHUOGFS OQFQARXT        OWJJSVQHFT      KDCVCGSIF      
YFIETDNWYKVSYOU : NIQW            XWNQI           RVPVAL          DBCUAXKIK       TATMBYVSREHLS  
NEKTHEWWB       : UPBBPPYHJXDTLNM VXSQ            OVNCLFCJTE     
RVAGLBOUGIA     : LJCGUJKBV       UUMH            YMUYCUHNLPP     KFDQMBXNCIVGDGL CXGINMECHBGMP  
GYGCTHTRBHXMCH  : CHTITDQCXWE     MPHHHFYGDNYJT   OXUHGNHHBAYFFL 
BETQYSSHETVBCFC : MKLKG           TDAQPNKEHDY     MQPE            EJDSYBEVJM      BWIMDI         
NDERANLRP       : RSQX            PBDSPDVJKVKAE   YCGSXTMVQ      
PCXWUBERRDMMM   : RAYRHHRFKYI     DVYLRIQXX      
GJUJQYHEEOXE    : JUASDMGAQU      KMKGDTG         NPYTNPLUKDXS    TIKUVBSUTIYMB   CPIVPPUP       
MVRINVIL        : JVDEGU          THVCJ           YEXNBJIIBHDMK   RGPYF          
JPLDUAPHSXSPJJQ : YDGWYGGS       
PVIOCMBYHLM     : GGDHDHNCDBQWVED BWFCV           SSSRJXY         NKNGNK         
TAYDPKIMMXUIVP  : RQSCDNSQBB      EBUMGEEFAUP     OIPTTBVU        TEIRSITXA       PNKRYFMGWX      PJNGLORHNPPFIFD UCWTXOK        
GARA            : WBOOMTOMIW      FEYUY           PASAQOTEYVAC    FJDV            TEKFTRSD        SUEFOO          SKULHBFJQTNRW  
NKGPWJQEUG      : SETWNAPX        VGFIKALY        VTJDWDW        
OGJT            : XYSNDSHRXUL     TCDBBSOHKSIXYDY RXVRYNQAST      OXUPITWMTF      ROLEVXP         THGKE          
WCNLAKT         : XREGX           YOMJHMREYN      HVVFGGEL        XPYKLOKKRRKUJLY CIISRILGHB     
BSHBMHSATA      : SETWNAPX        AYVXDYXDEVBBK  
QJLXHRKVAVS     : GNCOMLWEIL      YDBQ            LICX           
UUNHXABYBVGCIP  : MGHNNBPA        OPKTVA          EPQAYMQV       
KJXD            : PQFUIDSTKGWWVIA AXTPDEVJEMPM    SSSRJXY         EPQAYMQV        CXFI            MGAOYNA        
JQAQIM          : PFUHRWF         OLSMNKSERY      DGNFFBOCUSM     IVARVOVD        ESFNXM         
KJIMEFCLD       : SUQBJBMPXKGPMI  TGDAQHL        
PEELKGWAEHLEMOO : DPPNSXL         JAXHUMVAVAQ     XXMK           
OFNCW           : MDUB            GMDULXC         OVGGBTDLABUR    TLEKYNELWSKY    CIISRILGHB      EKIVBBMHDU     
NFLRLNG         : RUYJCSOWYBLM    EGEIHPSWISVNX   XNEJQOW         PFFMDPFSHBYKS  
PVVTJIBGLHO     : LHRNRIKYPFIKJF  VTORNVMNDHUAQ   JPNRL           QWITTNV        
MBLBHDIUFGTUNF  : UEEFELPSNMGGECS FUAXEPVSHCQGXK 
YSUSJQQFBYIJ    : WTPW            WOTSGWPNW      
QXKFCVI         : TQUCJJTMY       YNGOB           TWQXC           TEKYCBVVTRLXLL  PLBHJYW        
YQGGYBDNIQO     : OOUPUXFMSSVB    YXHWLEPXS       JASVLRVUHMXYXDE KHTMSGIGCPFIUV  GEKXLNHBVRKAIB 
NJNFASICCTOUSYA : YDGWYGGS        VROQFYO         PCNTOXDLOABAGM  UKGSKOATNUUWW   AEIHTBKAEQHD   
XIIYBOGD        : GSJUEWCBKRYF    TLBQDYCHDOGE    IGHTCGBEVBTXG   VCDFGRG        
JQYCHD          : CBPDELSLSDQCQE  TLEKYNELWSKY    WDUCOWTLIXIYF  
RSATLIVP        : JLQGNDI         TGBFQK          FFGPMHVG       
NMWOOVMYEMBT    : QYMMONCNXEBPR   GHOBWHJAAYMKX   PPWPF           VGBQRCRMISXVDH 
ELGW            : JLTBFWJAXV      GFWBU           YOMJHMREYN      FAMBAS          KYVOGGKIMPLGBB  PXVMVCPUNBVKBX  SLLVJUFQWTJC   
LGREXKEUY       : GNCOMLWEIL      BXEIJGHQKR      AHLGLYYRQY      YVNMDXGPY      
SQSGE           : ORGGIEKE        QNEMALITP       ANEFLGISMA     
VSOKSTWV        : QGKHOLIFMCL     OAQLPJEJI       FMEADPCUMXVLM   QNEMALITP      
TCDBBSOHKSIXYDY : FYIMTCLQNJ      OYYH            OGJT            NLEENDIN        GKRTTQTP       
XPIFVY          : MGHNNBPA        SNKRFVYF       
RQNMKNKAHMFKPXY : NCMHGECN        USPVPMGDXACDJS  AFEFOGCIQECKKH  DTITITE        
JTHJUMIILARS    : SYHD            JCBIMGTQAMOQJ   LJWJA           KFCILHOQ        KERHEUUGAP     
SVQJJDVYNXHC    : NYVSTJULTVJ     WQSBOCHCT       YJVJ            YBWRAB         
TRCVQN          : KICDVSPFW       PDAVSDOWRP      QEWQKDKVLHHTBH 
BYLNHVYIP       : DDSHDP          CBHDYRIPSNSWTWN GNOWJLRUSQ      AWNYSAJAXTDXFBK
HLPXWCDTBSRKU   : XUREO           VDQGMBIW        KOWYPGBMPUY     EAFN            TQUXXJCRMDX    
FODBHSSISGWCFXM : GUBRSWCSE       WHXQYOMGJPA     GGVTPI          GNXFNAYCMKIUNW  QTCYT          
STIKTG          : FJYN            WLHFQ           EMYVMBTBLMF     CDCDTW          BTCGHR         
WAQPTBMUI       : SWMMFPYWPRXH    GTAKFDEENYHR    RRKVJO         
XLLSF           : FIMQY           QPYLDXBKMGJE    EEIOAP          EMYVMBTBLMF     FAMBAS          TQJEXHEDBXAVP  
LNSQSTDOOAWYT   : OLSMNKSERY      KOWYPGBMPUY     RBDKIFJJBR      BKQJDAXLJTO    
MRFFHCIWWRAWDL  : CFRVURMJK       PXUIGIULIGW     OANIRFFHOS     
KIEYDW          : VLGVVOCLLC      YIMPJLIOAGCNVRV
YAINAINUNCOVHXA : YYIQAGM         DGNFFBOCUSM     XLFFCSQLLX     
UWJVVNH         : CIWWJDW         SFKGKMXXVRMJ    WLHMAVUILYNBAA  HQRBV          
ARRBVOTWRELTOYQ : OUGBSWWTMQASY   PQHYAM          LWKVT          
BFBKEBCYAM      : EVSMNRFYJE      LTPSAGJF        KRVJUAACMOSE    KJKBPHOAAGXQUKQ
VCFJCYE         : VWHBQMWQXGFDWJO XGONCXWXSLFVY   OWGONIICY       UKGSKOATNUUWW   VSQKXD         
WUAUMGGH        : QLQEHEUPCO      KOKHADGVIOCTADT
FXBIG           : DHDSLX          PEPGX           FCTNXXYUKBGWK   TFRBU           DJLLMFTCNJF    
UKFWLFJJDLQOO   : CRQGF           VJUVKKHUGHEUJ   CYKLP           FMPISLDUNLEFU   CNMB           
UUNQ            : ICLJFGCJKD      TCDJOD         
KFDQMBXNCIVGDGL : TGCTGYHFX       RVAGLBOUGIA    
TSKDXXVN        : HSJQQYPJ        FPFPXHQDWO     
MKJCB           : UPSATUXSRJCF    JMOOTAVTVCV     HCVBTIRLRGCSDKF IEMT           
MHMDVNDLSLH     : QPYLDXBKMGJE    IIMJ            GKWKRDPVUG     
OPNQKIBPHCM     : YHCNWCBAY       EHWBOJM         MQGG            PCMKFW         
QBHDDLLRSXW     : TRAXIXNPVOHB    KGQGSIKVE       BUGRNMNGJL      PPUJKFDOKYIDEO 
OADH            : KLMRVEJIAFGURJN QOCMIH          SSVBCYG         NPNDOCMTT       OJJSFMD        
KICDVSPFW       : TRCVQN          EXJTGKQGWHEFGK  RAHWEMP         YJPRTEB        
OYTLPWUUCGH     : VWECIIGBIGKC    KBBSR           EJNXKGB         BDPJCBMLVJV     EWEGNDEKCC     
BHQSVQVFEIO     : BJNFBXJMJCG     IWOMU           VXJCUTEYSJMH   
LMCDTBL         : TWGQFGNIYECRY   MPHREQOIYB      FORWDNIWOYKY   
AHVRFTN         : HADEXMVNLUS     JJUSM           AHVNVXXAWN      MYMP            TUFAEJXIGLUVLPP OTKMB           FRTO           
AUECE           : PDUIFYVSUE      OYYH            VUJTTMFORHDOF   QSWTUIQPNENG    EPLL            LBFQFUQGHJXKVG  LEKWRU          EQVRYWYTMIH    
AUECE           : EBBKYDMBMOO     VJCEMY         
UBOSISBYCP      : RTDIKCEXTPUGU   HDBOQYNK        YDIJJKCRVFKW   
GUIH            : KVLTRIDJQJWYJE  XNHIR           OWGONIICY       CNTLI           KIDEJ          
TJOR            : CHTITDQCXWE     XJLOVV          THVCJ           LYCGHJCP        DISH           
TLQDO           : AUIOMYEA        YACOK           SUBXDMAJP       UGECUMP         RVCFEPNYNBAAU  
HQSFN           : WHFLCXOFPFHWQF 
TGEOJEQBSWWDG   : QDYJGRYPLP      LDOO            ATPPLLJYM       ODFMBBWMNYQ    
WPTPTP          : CRGJLDGYYGLJI   CTCCUWSBDBF    
MVRBFIV         : UWGCPVWQFB      GFBSDOCGFVYEX   XNVLQGGWMV      AHVNVXXAWN      KYHJYAXJCRCIQ   XHTXBWUO       
XREGX           : LHOYSPUVQHT     DKUGYYIB        WCNLAKT         DAMNSGCGMXF     QSBNCGDBOF      LLNMGTBBAQCPA   KVJKCVAXRWH    
SEMVYMUDSBAJ    : NDSLFGKIBLXXKN  TIGBAGSCXXVV    EKAYDCC         ECXFWYETNV      WFJCAPJ        
RFNVRLN         : EYOHNYGCUHQIJDE VARLLG          EBLJEXXGUR      XPYKLOKKRRKUJLY
QYQCYKGGLCYPPUP : FFVKHUOKOL      ICXJVLC         OXULXDXWRSPMMM 
QSWTUIQPNENG    : SROW            KHVLYNCELMEIK   AUECE           DMEOOQWYPNSK    FUAXEPVSHCQGXK  JAXHUMVAVAQ    
DDJCULCHTKSWL   : MWRQNQSKMOIOOO  XLBOYCSHABNFXI  KYHJYAXJCRCIQ   RDWMVKQEKHJ     NRTIDOYQKXGP    CMEOORJDQLAYSTC
OGBQYVPU        : QKON            UNSEXGMXSXDPR   WGVSLI          NFTBSHQJM      
YMIMSVULAYUEV   : YPUK            TFRBU           JYQWUCSNIHOBAL  MRIFANFROIRIPFO
IDASYYEINNLGOHW : ORGWDRWKCIH     JLIQLFHSO       XHUYDWTC        GQHQ            PIGUOMHUXTAHXXY
AXWLKPHGB       : VLJIOFJNTH      WWUVXFQH        VRBUOD         
HXQDEYI         : QMPBPWI        
UHIBR           : PVDJNUCPG       SOHGCYPV        KHPEJDPAEAKEK   CNMGSPWVRYYT    SUDNDW          FEFEWDYJJNIGVA 
ODFGKEQNCPY     : XFDEDEOR        PKSA            QYNEMXIJF      
HIXLSFJJKOK     : LNEEVSYUMJRB    WDWGXTVRONGV    ITHUW          
XFDGHWFXB       : MXNKYPJLHGTL    LKSNXSIMK       VYQEODIRK       EKAYDCC        
ENRWBWM         : THGKE           FUFO           
OUJMGE          : EQDWGYGOMXIWBYX KJKBPHOAAGXQUKQ
PPGGCB          : KNTQLIAUCNLCAU  TABCGJBIEKPIED  PSURMXQNBV     
KGLREQ          : FJVPXD          BRRVAJXWRPYUTNE XVJXXNHEYY     
FEYUY           : PMFIXMD         YDGWYGGS        TEFARVGHBJVXKIA GARA            OJJSFMD        
WVJYKGKYOQSG    : CNGJR           SGCOWBNT        JESO            EYVUDFAU        RJNEH           CUXQKOQIGWYFFU 
YPJCTTJHN       : CPTJQRREV       QDTGMMLED       EYQGNYGSTR      BQPLSIPPKHMSB   AEWJJGJBGIDVJXW
BHSFGP          : SQTOUPNU        KABVT           BXEIJGHQKR      KADCFJTVQCS     VRSJCFDDVVDRFBW PAMKXNDU        RBDKIFJJBR     
DMEOOQWYPNSK    : QSWTUIQPNENG    CIYDJBRHQBU     OLJRKHOYCURQGQV
BLJMOG          : JVWOJUFFQVYES   MOCE            RKTTFXJYHWXT   
XNVLQGGWMV      : MVRBFIV         YNXWPRUNDKLIB   JYKMYHVMTS      EWQJTFJAK       NFJAXWIYB       QVJRC          
RLKICBHBTUV     : KMITBKC         XVVQKJOWMVJTQEO JFJFHQPRLFXQOAS DINVSUJAF      
RXQDKFJTF       : YCWOODTM        PNWBOTLCPRRA    BQNGO           XRNXICBBD      
RSQX            : NDERANLRP       DASBHIU         PXUIGIULIGW     DDKYWQWMEVDI   
PNYVHKIQMJAQD   : QTVROLPPRUSN    AISC            LIXWF           DGNFFBOCUSM     IIJTL           YAUFEYTROXMAE  
MIPMBSX         : TXPHURYETD      MTDUGY          QUDNB           LNBJM           QKFUOO          NABNFHWQYSEOS   MCDAK          
DRNFLIV         : CDVFUTQGKX      NFVXRFVMGHQJKB  EIMVMCGMRO      TKUA            LCVDHJGMUVGTAH  EUXSMDMXFD     
JOAIKHVS        : PNVHFPKMSOLNF   JFHMPODFUUCY   
KEBDIYSSO       : BGQKMEG        
VHDEMWTRJEQ     : OMTHCWMAR       IDEPCP          AWNYSAJAXTDXFBK MYPQDMQUSSJKHAJ
NFVXRFVMGHQJKB  : DRNFLIV         FTDFSRGTGDNYGCB DTCBJFCHQ       NHBOOL          EPHPSWBJFB     
DVYLRIQXX       : NFPFBO          PCXWUBERRDMMM   TJJSQTA         MOCE            LLATAXNFR       EKAYDCC        
TRAXIXNPVOHB    : CDAJUYPSS       QBHDDLLRSXW     RRLPABHTGPVEJLK USGVQSDG        YVWIRLDYTJD    
TJRLS           : WFJCAPJ        
OFKLEXD         : ICLJFGCJKD      XHIFJSPMSJA     IRMQTFMOF      
PEPGX           : FXBIG           MIOQCQILCUOI    GGIGYNSFBVP    
GYSGMICBSDM     : NUPJIKJTXMG     VCDFGRG        
PGAKNP          : GMDQBXFKCT      LWCQ           
BDWYIMOMCULKD   : YPUK            VEEGKNTM       
FJYN            : STIKTG          THGKE           DFKARWLBU      
DGRRVJXXTOPKPS  : FVNWRASWKY      QSTVREGQEMUH    XYSNDSHRXUL     VFMETWKCIPDEQ   EWJOWFIONVYNW  
QCWGOADCMJOR    : QLIT            KYHJYAXJCRCIQ  
QHJTOB          : JBMSBLAWOAWI    TVCYUAUJ        PXRAWDD        
MKLKG           : HADEXMVNLUS     BETQYSSHETVBCFC RJNEH           BKVRF           JLMCLFPJUENMQ   XXMK           
BRRVAJXWRPYUTNE : GSKEFRNBKMGL    KGLREQ          IHKKEBVBSMISOX  TUITYQNOEJQQP   WQJDLIRF        UFOIXUL        
HACPLVGM        : RDKRD           IBJKVLVEWDFQBH  DKKSWMSNGEDOQD 
SYUFFVGYPD      : NYVSTJULTVJ     MUPYGEUO        OLJRKHOYCURQGQV
YDBQ            : MKKOROUY        QJLXHRKVAVS     OCDKTRVJJX      RNGHOKG         WFJJWOFKGRJ    
COPQUBXWDP      : DGNFFBOCUSM     MUPYGEUO        FPUMMF         
BVWKQXFWG       : PUKVPSGTYBDCEPO
FFVKHUOKOL      : QYQCYKGGLCYPPUP SVVV            SMHIXGOKHA     
DBDA            : NMWDJIRH        BLLKM           YOAUON         
EXJTGKQGWHEFGK  : OJMUDJNTSWVWM   KICDVSPFW       DFLGBYBYKVQXSV  PVGDFMQWNL     
MSEWCC          : OFJRUVFTC       PTTYWKQY        TKATI          
MSAY            : UEIK            JXEJQASABEVCOG  PWUTYDCCOQQNX  
BDXGJX          : AMKNEQLSWPKOU   FXXGTU          HWKVUWXDLSS     SKKFPBVASWC    
DFDVNAERF       : SXUWVFWIE       KKYEXGUUNGYTS   UCGRTH          PYXNTNDGGJEQKW 
FQYXWWAB        : QDTGMMLED       PBSGBFXT        DKQRXGSGKRVIUQ  IFAQTCUA       
MTKNR           : UYFLOIKQHAKQEB  KQBXQEO         FOMUUCFQ        HNIJJCQO       
QSUCQM          : OMTHCWMAR       NOJUOWU         GFJKTRCLTKGX    RDAEWEJ        
XRCLUIGCVLSULSR : UYEHXHO         AKIRUUTFUXTM    ATVWSIRKHOS     BKAUREYFA      
TDAQPNKEHDY     : RQSCDNSQBB      BETQYSSHETVBCFC FFQRGYK         TUVA            DTITITE         CAFJIIFUGEFX   
UORSIU          : LVEDSRFCMJVHIY  NPYTNPLUKDXS    JDPAAXMK        GSKEVKAPAGASNNJ
DFLGBYBYKVQXSV  : UBHAPOCGLUFJSD  EXJTGKQGWHEFGK  NFUNMXUVKGTSFO  KKCKJTQVHTHT    HISGHBASHYOSFYK DAJCEJJNYMRJQVM EAFN            TQUXXJCRMDX    
JMPTQY          : RTDIKCEXTPUGU   KRLGXKCXM      
SLUJ            : AYBHRPLTYK      CRCECVCS        XDNQ            RYQIBXDUKFFPIHC LWCQ            OANIRFFHOS     
NRAUXGIEJHHITEC : QGJLXGILUJNJD   CPBHXCS         CPQYLCUXCCSIU  
WXTIMKEGJEBUY   : PQHYAM          QCMVCBJWILE     BBFU            BEKYPRCUE       WICQ           
BPEB            : BNBMDGELXFUBEE  HHRVVVHHGN      QKNCDB          YWINSGM         RPKSWWVIJJCDO  
CHTITDQCXWE     : GYGCTHTRBHXMCH  TJOR           
VFMETWKCIPDEQ   : XWNTTPRQCL      JLQGNDI         DGRRVJXXTOPKPS  TGCUUMUPQPRSFC  IJCHWFFPUNGUKFA
FGUITYSN        : AMRXXAIK       
MQBOQXVJVDVAW   : OPPITEDETI      XWNQI           WIXH            YODEK           ANEFLGISMA     
KADCFJTVQCS     : KEHHNVGK        BHSFGP          RBMGCDEPTVUYI  
VRSJCFDDVVDRFBW : BHSFGP          LXBKTMMWMU      MRIFANFROIRIPFO MTBOXTHCCNVU   
DUXOWESCNMXFPSH : OFYMVPQWUKMKPAE FVGFTGPXYDJGJPS KKOEBMRDLAS     TIKUVBSUTIYMB   AYVXDYXDEVBBK   IIMJ            SNKRFVYF       
LAAPHDVDBBXHD   : LJWJA           XVUHGEFFWTIJIJ 
MGRLWOPQRF      : CYILNQI         CJUSFRLA        ICXJVLC         LHLU           
RMWNTLBTLQDQM   : BDNETY          KOKHADGVIOCTADT TLEKYNELWSKY    RDKRD           XRIQIV         
RQHB            : FIGXFKSNVLNFW   VRTMSGMEBVIMIY  JMRAWIKA        TGELQJUUNRW     XPWXWD          QGIRXMQVCWRAKU  IBJKVLVEWDFQBH  QLTRVPY        
EOCWCAN         : NRGBTLCVATXN    LRII            OOIJUOAQLUFNURL OBLQNJRTASYWVO 
SHYACMXPG       : ABBRYJOSBLHQWQ  GHLHCOASJTI     XQTIPFM        
QDYJGRYPLP      : ELJC            TGEOJEQBSWWDG   CSKVPQKLDEY    
NLEENDIN        : TCDBBSOHKSIXYDY WYVHJNP         GRPCFSCWLBQV    CVJPABRU       
CIYDJBRHQBU     : DMEOOQWYPNSK    DXPUTPQNUYJLW   MBTT            IWKUHBVFDWLOU  
EVSMNRFYJE      : DXIDBQII        BFBKEBCYAM      SJSKTAOFRPSK   
UKUJPDWHF       : YPJJUYJMCGBFHG  LSKDHHXRPN      SUDNDW         
ILPLDYEEVNKRI   : KRFVIMGPNABDQ  
HBFGKLXGYSROW   : RVPVAL          KCBTIADMUM     
VEWGP           : YHCNWCBAY       LCOY            XVEADCKXJ      
RVPVAL          : REMHSQQDGUU     YFIETDNWYKVSYOU HBFGKLXGYSROW   CRWUNFST        QTTTKSYWBXVS    EQPBIGRQ        YKAHWEKVVLHMO  
NFUNMXUVKGTSFO  : LYLBA           CAVNO           YHCNWCBAY       DFLGBYBYKVQXSV  VYEILLMIXTYRM   LBNJOIYWMDNGG  
ULASSYCKOT      : EGXSA           EEIOAP          HQLRGO         
GSJUEWCBKRYF    : XIIYBOGD        QWKJSO          AYVXDYXDEVBBK  
KNJDTXOQM       : OHUT            BNBMDGELXFUBEE  FITHVCNXDRYNWW  STGFTTI         RKTTFXJYHWXT   
LHRNRIKYPFIKJF  : PVVTJIBGLHO     GECAEXKCVAMDYN  JEORSBFF        TRBGYYQYEWEYKJ 
NRGMY           : YMFQCERIWCNE    FBSIE           JQRLWKUHOUR     EIUUKFMI        SUESPY          AMRXXAIK       
YMFF            : OOFSRQKLQE      JDPAAXMK        RKTDGSQVK       PUKVPSGTYBDCEPO TPQKU           HCKWIUM        
GVBUONC         : CNMB            NMCGIDOY        QPBRST         
DTPPSHUD        : TKATI           NKNGNK          PPIYQGE         MEWHBJLTRSQ    
HKIUCPJDLJQROB  : KYHJYAXJCRCIQ   UHWQGSLKHIFQNUC NEVCUJMPDWMMLN  HWWQITXETH     
MDUB            : OFNCW          
WHXQYOMGJPA     : FODBHSSISGWCFXM UOIGJYQOJPGHC   ELFTCFJKTNE     EAIOREWIXNR    
BJNFBXJMJCG     : UPSATUXSRJCF    BHQSVQVFEIO     EUSK            CCKIICW         RSEWRPPO       
FGMIBNDXWEPWSCF : DNJIIORT        IFAQTCUA        TNNYWYF         LAELP           QVOLRRHXNXP    
TGXURNBULMH     : VPKLLRILUEJJH   RQXQTSTGTF      YJVJ           
OOUTUJ          : CAOLMFTTVLVXLHC HUPBGHK         YCGSXTMVQ      
WWKWWOMTJQB     : SWMMFPYWPRXH    CKUPSFDQPLJYF   WIGTASWGWHDPMU  GIXHVH          RQNYOBQLNG      UBMGSVVYX      
LHOIBCLVQ       : XHQTU           KXAQQASDROE    
GNOWJLRUSQ      : DVWRGU          BYLNHVYIP       NAPJEKYKMVPKB   LIYSN          
FORWDNIWOYKY    : LMCDTBL         TGGFKRPKTTVUM   QIQWYNQRBDM    
SAUFYL          : DBPRTX          GBBLVCCTFPV     GTAKFDEENYHR    OHGWYG          KDCVCGSIF       VGKYGC         
HBWEMKXIFR      : ULDYFJ          KMITBKC         UIHKEER         XQTIPFM        
KIUJ            : LICX            EDXXU           TKRKRSPH       
ISIWRSXIOYFVAQ  : HYQPT           WVIRLQIK        VAKSIBIJI       RKTTFXJYHWXT   
JRCNFMNPR       : RWGVWOKKRLKPEV  IROY            QUDNB           LNNXVFCIYQCH    TTMQYUHPTID     ESFNXM          OAHTSLAIDBCMC  
SFNNOCXJMWC     : FPVIMO          XTCUSFJYAHCFUQ  ORGGIEKE        FELQVMTGMHX    
VMWWR           : QPAXM           LCOY            SDJOYBB        
YKXIEBXLPLB     : SXUWVFWIE       YCBTNMUFIDFWNWF
TVPHLGLJQY      : UPNVOPHQRIBJ    QXRPMH          KEBVDTWXBP      BKOHRXYQUUXCDNW
UJHHGEBBDL      : FWKU            EUJCIIACCJYPDUY LSOQQADNNETYM   DTXQLGYVMLAKJS  HLUHYMJCBEXHFB  LVNVIEGOCJ     
NRCL            : MXQOKNKXU       YCBTNMUFIDFWNWF KJXXO           WDSHP           OVNCLFCJTE     
SYHD            : JTHJUMIILARS    HDBOQYNK        ATPPLLJYM      
EUDPB           : XFAOVSPQD       FAPXHCCGLGSYAKR
CTPLOYSX        : SGFOLL          NRTIDOYQKXGP    GPKAXWIKK       SNIWPPDGLU     
YYKEMMRFQF      : JESO            INLRENBWNKP     ANXWEXHYKHWB   
JESO            : UEIK            EJEAIRTARDAV    WVJYKGKYOQSG    YYKEMMRFQF      GFJKTRCLTKGX    EQEXX           KKOEBMRDLAS     OXUHGNHHBAYFFL 
YJBPNR          : MKDHIGTELT      RPAMFOGIOM      PIGUOMHUXTAHXXY
JIFBJXYR        : KYJMVDAEDCLUE   WQJDLIRF        LUUHQNRUGCRX   
BCDNQWUICGTGC   : CIEQTOJHIFM     DAJCEJJNYMRJQVM FAPXHCCGLGSYAKR
GBUHSKCMW       : LEHWQTYIQHS     MEJOYFDU        FQFJVKYBBWL    
RXVRYNQAST      : ATCCEMRHC       FQELCNFJ        OGJT            XHUYDWTC        QMRIMPU         UXRFRMD        
JQNTUWOCYAICWS  : MSNADTNFHID     DQSVUQU        
IUIHHDFDUGTMH   : STXDCBA        
IAXCNSWMJBNJKQG : LHOYSPUVQHT     FKOCUMRPTMQWPS  YRKOX           NRGBTLCVATXN    XAVTTLIS        WFVMENWBA      
OQCYXJCFO       : YUPPVGJOR       OBHOPWSOMBC     KQBXQEO         HLBG           
MKOVWWVXYLSY    : BGITEY          OWGONIICY       PVAV            PACCA           RRLOSANIQSUJQP 
CAOLMFTTVLVXLHC : MIMXBXTEPX      OOUTUJ          QYSCI           YVEOELWXGPNFEQV QBEGYTOYIOO     OESYUCE        
YCEJQCJQXH      : HQOBOPLPK       UEEFELPSNMGGECS AJTK            LVNVIEGOCJ      KLHM           
LAQME           : PNMXDJECH       XHAMCYQFS       PYWELY         
CRGJLDGYYGLJI   : WPTPTP          NFJAXWIYB      
INLRENBWNKP     : WFCFFBCAEETTGL  YYKEMMRFQF      MPHHHFYGDNYJT   ECXFWYETNV     
MIOQCQILCUOI    : PEPGX           WGJXJBSHFIG     BQNGO          
PQHYAM          : ARRBVOTWRELTOYQ WXTIMKEGJEBUY   BYLANHKN        VBPPLJPFN       VSQKXD         
NXCTLFRYSJBFTPW : HIONQMAVNUKG    TWGQFGNIYECRY   ARLBCONTMAA     NUPWS           IIENSO          LTPSAGJF        LUFHYICEIEMDEJ 
IHKKEBVBSMISOX  : BRRVAJXWRPYUTNE GPCJHYLYCHTE   
CVGYKOSL        : TQUCJJTMY       TETHW          
EMMXELWMT       : XMXCKYUJQ       TELBQYK         FJJRNAIHJLYWLX  EDXXU          
AXMVYGIKYAID    : WGVSLI          PVMAADPOUDMKHOR NFKSIRDYT       VJNGEIMJR       GNOMIJUSMUV    
GMDQBXFKCT      : HWHCADGDFIRXC   WAMIYQOEAGAP    PGAKNP          KDIWQXMPVR      GGDHDHNCDBQWVED CXGINMECHBGMP   JDUOPS          FVXRWBQMORFTJCO
GMDQBXFKCT      : QLTRVPY         EKKIMBTCYX     
BYLANHKN        : MSNADTNFHID     PQHYAM          IIYOFQKKYMSEP   NEVCUJMPDWMMLN 
WJJDUTEWEK      : DHYTXIPORDGAWR  VLOSCYLIEYN     AGDLCHIHTEOQN   RYQIBXDUKFFPIHC
KWHEAFJKIDJL    : CYRLDKTDVW      DHOPRQVQBC      QPIFAPYDWQENGPF EKBSOLQKRQ     
UNSEXGMXSXDPR   : OGBQYVPU        JGJUFJDQ        NEVCUJMPDWMMLN  HLBG            UTLBKRS        
OXUPITWMTF      : OGJT            DHOPRQVQBC     
ENCPBGNOB       : RBQSSFFA        IJCHWFFPUNGUKFA FPFPXHQDWO     
PKGPFEUWXFLVCBH : MYRLYTGDJRAS    AACXJ           PXWAOBTBXQY    
BTPGUVVW        : EPLL            KGTB            VJNGEIMJR       OMTUQSGSDFP     NKNGNK          QBEGYTOYIOO    
WFCNHTF         : GNCOMLWEIL      XSBRWX          VUYILBPCWNJT    SYTWISUAQLCCQG  GWEDJXKQPAYW   
DWYJSVI         : SKGUSCGU        TXHWRIUHNMVS    FYWQIQJBNVQ     IPGJOQTWL       ISTGDUPGPDLQ   
HGDKNY          : PNKRYFMGWX      STXDCBA         EBJYKKY         BCDDKFOCGEFTO   MUHR           
KRRFP           : XNHIR           JJOOUOIBUJ      HAUCGF          YTEISJHHQUERV  
EEMJGDSD        : BXEIJGHQKR      MVVWXECMEOVR    EHUDBJNCWTFSXYR AMIPHEUBCYQMV   FNXAII          IAJGGPQOOFKVIG 
MGKNRDJAF       : QACHVXE         IHCCSMTXK       NOJUOWU         SSSRJXY        
JIEWKPJCIQRX    : KGQGSIKVE       LLXQV           JASVLRVUHMXYXDE PPIYQGE         XXMK           
WLHFQ           : QBGUBKDKSMDDEOD STIKTG          ORTFQSUIPI      RFGWEQNOKORXHY 
IBRQL           : JXAVMKYDMHM     ONRAETCEBQBC    TEMOYEPVVFUD    CVFQPSESDP      VYEILLMIXTYRM   TATMBYVSREHLS  
JQRLWKUHOUR     : WWUVXFQH        NRGMY           OHGSRTB         LXWAXIIYOSKR    UBMGSVVYX      
GTPXO           : HWLTWJKICRSHM   AJTK            WSKFM          
SNBCSRFEVYUJEEB : XNYEOEMLDVUWJ   YIDFEXOTSAKS    VJUUKTADVKIJP   VJNGEIMJR      
SAJNHX          : UINWARNMBXHG    WSONBOKOWJO     TPOVJGKMX      
CFRVURMJK       : MRFFHCIWWRAWDL  YRMGCFPJM      
MPVFWADVUMC     : MQSYHMSXUVXEQY  JALNYUIUI      
PBURKK          : VJUVKKHUGHEUJ   MYRLYTGDJRAS    WFBGDIVMJDIWRB  XHIFJSPMSJA    
IXCORALJN       : SXGU            QTDEUEY         DASBHIU         HSBFSIFKGO     
VPKLLRILUEJJH   : LGFWBXJOWMHAW   TGXURNBULMH     YMYXUATXBQY     LCVDHJGMUVGTAH  PHUOJ          
AKIRUUTFUXTM    : OPAR            XRCLUIGCVLSULSR EHWBOJM         CTCN            PQNVM          
IVQFSGP         : UDFGBDWDPDA     GGDHDHNCDBQWVED UGETE           WUIWJFAQHXJ     JAKRY          
UHPIEVRO        : XCHIKRGKCGNM    GLGIH           QJGFD           AGDLCHIHTEOQN   TCDJOD         
FQPPIKNFQI      : JXEJQASABEVCOG  HPTHDHDYLCUMA  
MXGWTWD         : WOXKNW          OCDKTRVJJX      STXDCBA        
GUVDDNLJL       : JBMSBLAWOAWI    KGBLRSCKCBHLXRS MSFDHCURI       MUHR           
XRLOJCAWPHPAM   : EELX            WQSBOCHCT       QROS            CAFJIIFUGEFX   
XTCUSFJYAHCFUQ  : HQNYYEQHF       SFNNOCXJMWC     WWNFPUGUJHUWTAX CMSMWCWI        LWPEISPR       
HUPBGHK         : MQSYHMSXUVXEQY  OOUTUJ          CVFQPSESDP      HJMORQSNWVCDR   IECYEKP        
JHAQYDDE        : PDBXNWYTW       AXTPDEVJEMPM   
WGVSLI          : WHFLCXOFPFHWQF  OGBQYVPU        AXMVYGIKYAID    ORTFQSUIPI      VOFGVPLGCFO     BTYLLGR        
NPYTNPLUKDXS    : WYBX            GJUJQYHEEOXE    UORSIU          MPPGBPXK        ICXJVLC         JWDSQKCVFEYJ   
IEVSGMTJQXNPEJ  : WQJDLIRF        DNGOUGCSFISNKF 
RTDIKCEXTPUGU   : FIGXFKSNVLNFW   UBOSISBYCP      JMPTQY          EJNXKGB         FEYMADUDHQ     
YIDFEXOTSAKS    : SNBCSRFEVYUJEEB ICLJFGCJKD      XJLOVV          SYTWISUAQLCCQG 
CAANTT          : SGCOWBNT        AVQUXUS         GGDHDHNCDBQWVED RSEWRPPO        CHYIXMD         QBRHY          
CEWGEQ          : RTMXYSMALSJQ    TIKUVBSUTIYMB   MEJOYFDU       
YWTTXC          : UGXDOLOHCI      WYBMVPVXP      
EGXSA           : INIDFME         ULASSYCKOT      RKRSMKJNSLVBVD 
SMMJROJFIFX     : UDFGBDWDPDA     SJVBARABVT      TGBFQK          SOHYOQKUCXW    
MWRQNQSKMOIOOO  : JAJQAKWUIAUCQQT JVDEGU          DDJCULCHTKSWL   IAJGGPQOOFKVIG 
NJAIDOWMGLXNUDN : GQBXJOSCTOGJ    CVWIEAGTFM      QFBGW          
PKCHAUCKHQVX    : QRNFLTUVTT     
MVVWXECMEOVR    : UPSATUXSRJCF    EEMJGDSD        ITIDL          
JMRAWIKA        : RQHB            TYKOMIVXVPVERA  UWHDFPF         DRAWKTVEMFLLOPQ
LWVX            : XKOJ            DFEFEONFGJRAJMN VVYNUJCNDNPA    ARQFHLYSFQBL   
MVDSLBQIYX      : DQBJGEU         WYBMVPVXP       EJAFLEU        
OCDKTRVJJX      : MQSYHMSXUVXEQY  YDBQ            MXGWTWD         OTKMB           KELNICIINV     
TLINWGJ         : XYSNDSHRXUL     FEDPF           NOJUOWU         XYRMDMOYP       VTRYGUTLOGEDXRN
NYVSTJULTVJ     : TTDIPF          SVQJJDVYNXHC    SYUFFVGYPD      DROKU           LFLPTCBE       
KNJWJBTSMTCJFM  : DDSHDP          SXGU            WRCJAKNEDJ      JSPFJJHHDDNRDEI CNRPBXUVM       VERUBYTVIKURM  
EUJCIIACCJYPDUY : FKCSF           UXJXDB          UJHHGEBBDL     
GOUFYVBRKVVTB   : GUBRSWCSE       XPRFERG         TSCXDAIVPL     
TGGFKRPKTTVUM   : FORWDNIWOYKY    VABCJAKLHURVX   UPLQHMYDI      
PNMXDJECH       : NOGOEDMWXMA     LAQME           JSDD            PLVEQKSONJ     
VRBUOD          : HUVBSBJ         AXWLKPHGB       UAKWWOHHHASUIAX
KLMRVEJIAFGURJN : CDVFUTQGKX      OADH            BKBVRBKBFMFD    YJPRTEB        
XLJHRNOXJ       : KDSCONYEGXGFF   YSNLOHWHRRM    
BEYGKJRADN      : SAFTPCWWEMN     SKGUSCGU        KJKBPHOAAGXQUKQ
MXJSE           : UPNVOPHQRIBJ    CRJH            MRIFANFROIRIPFO DFKARWLBU      
KNTQLIAUCNLCAU  : WLOUSUUDCC      TPNAI           SFAPAETCKAFT    PPGGCB          OBIGRJIWAM      DNGOUGCSFISNKF 
GTMTGFTJUCWV    : TRAVBGM         FCFGS           OLGPRYL         OVKMNFGEYJO    
PASAQOTEYVAC    : AYPV            GARA            KSRUU           NEXL           
LEMI            : PNKWPKO         LJMBR           RAYRTRH        
UDXOJFIUCNRXYJB : ANKH            KVMOSOKWSUTRO   XJDWFXMVBJJ    
KRLGXKCXM       : EYMVVKFGL       JMPTQY          HAYNU           JUUHJTRLK       UVFSFJUOYRYKE  
MTDUGY          : MIPMBSX         GNOGRQSTT       RCBGPB         
EPLL            : IMIUWLB         TFFTMIJLKKVX    AUECE           BTPGUVVW        VMRDBTD         CKGRGKCEUICA    AWMRGRNIRIUWDG  CAFJIIFUGEFX   
HQOBOPLPK       : NHIVXKCKMELBKTA YCEJQCJQXH      UDFGBDWDPDA     LSXHANXNAF      AMGSAWPCXLL     PXBVGYGOSMHWP  
JVEIIIIXAUR     : QJGFD           DLRUJODNPU      FUFO           
SXGU            : DEHVEVVXCUXSDSY IXCORALJN       KNJWJBTSMTCJFM  FIEBYKDCU      
WHSX            : GPCJHYLYCHTE   
JMRYEDQOBDMFLV  : LLISGP          QLQEHEUPCO      KSRUU           LAELP          
VTORNVMNDHUAQ   : UAXXUUVN        UGXDOLOHCI      PVVTJIBGLHO     RTQIAOUVBVMA    MINRO          
XHAMCYQFS       : LAQME           EIUUKFMI        YGXSQRASFK     
JVWOJUFFQVYES   : UPNVOPHQRIBJ    EAGDA           BLJMOG          AYAXBSXXYKUCU   UGVYCDUPBARQQ  
UVXPXOGXYHKBIDI : FNXAII          AGNCDEBYPYEPXV 
NRYLJKIQS       : RNKV            RDISLUAOS       OHCDHDIHTSE     WFVMENWBA      
NTGI            : YENJWLQADMUSG   BYMOEAE         WPWRMY          DTITITE        
BGITEY          : MKOVWWVXYLSY    TOEOEUUTJGSFU   WFJJWOFKGRJ    
CAHODSRM        : UOWYEDDVX       EBBKYDMBMOO     AJNFMBKUWUSN   
GGVTPI          : FODBHSSISGWCFXM MLHAGVIOWQF    
HDEWALFKML      : MPPGBPXK        RDWMVKQEKHJ     VABCJAKLHURVX  
IRTJTUSIXLCMI   : BGDSUVQRIAY     SPUR           
TGELQJUUNRW     : FXXGTU          RQHB            VMRDBTD         PPWPF           PWUTYDCCOQQNX  
YHQKCYEXKXUEIV  : JCBIMGTQAMOQJ   FEYMADUDHQ     
LICX            : QJLXHRKVAVS     KIUJ            SABKEVAF        PAPFQXSWDCEJV   QWITTNV         UCRLCLKUTKSHUDG
KDSCONYEGXGFF   : QPYLDXBKMGJE    XLJHRNOXJ       KPDR            NABNFHWQYSEOS   MLHAGVIOWQF    
SJVW            : MGAOYNA        
HXFNGBHTLMSS    : XRWYEQYMB       AHVNVXXAWN     
XLBOYCSHABNFXI  : DDJCULCHTKSWL   KEBVDTWXBP      TNNYWYF         IGHQM          
WFBGDIVMJDIWRB  : PBURKK          UYFLOIKQHAKQEB  RDKRD           ANXWEXHYKHWB    RVCFEPNYNBAAU  
PBDSPDVJKVKAE   : NDERANLRP       UYFLOIKQHAKQEB  DTITITE         GIXIHRGS       
IUIO            : FNXAII          OBKGONEPTCLRBP  SGDQTWROCXMXVU 
QTGMIRRRPKUHA   : XFDEDEOR        UBMGSVVYX      
LSOQQADNNETYM   : UJHHGEBBDL      VKYYOTFPLR      MJKJXSA         LYEJXJJ         XXMK           
JDPAAXMK        : FPVIMO          UORSIU          YMFF            EWFJGMCGC       FCKWSDRMQ       CHYIXMD         FUFO           
EEIOAP          : XLLSF           ULASSYCKOT     
YDMNVDOASCEMD   : XNYEOEMLDVUWJ   LWCQ            FPFPXHQDWO     
EMYVMBTBLMF     : IYYDWMCV        FPVIMO          DKUGYYIB        STIKTG          XLLSF           SIVTCLRLCFRAT   AGNCDEBYPYEPXV  LDOO           
EMYVMBTBLMF     : PQPEDJFGMIQTAUA
UWSNPTSCHPI     : DXIDBQII        HTVVYKEJ        THVCJ           DKQRXGSGKRVIUQ 
PDAVSDOWRP      : GSKEFRNBKMGL    TRCVQN          YVAYNBSCPPSRPFF AACXJ           QYLIQOKQWWYUYWJ
EQQFFENXB       : XADHNNUJO       HKQQFWXLTKASE   BBFU            PRUQB           RVCFEPNYNBAAU  
QOCMIH          : OADH            CQDLRJ          XHTXBWUO        DWFWFILOOLH    
XRSPUULNBCMSSJ  : EQOMFVSX        KEIW            IKEOQQXYAKKY    CXNULO          LIYSN          
LBFQFUQGHJXKVG  : XWXCYEKCJSTJV   TKLNCIGPEBXCSMQ AUECE           MSLPLE         
QGJLXGILUJNJD   : NRAUXGIEJHHITEC BUDDIMV         QNEMALITP       RJUWXJYJIGN    
TDWUKPCGHINQIA  : QNKESCACXLLUKF  FIPS            NEVCUJMPDWMMLN 
ORGWDRWKCIH     : GMDGEM          IDASYYEINNLGOHW XCHIKRGKCGNM    EMDDYUKTKUNS    QROS           
WQRHMUEHFUJNEU  : WLSSUTU         LAELP          
UDCKUWQTCKRON   : QYMMONCNXEBPR   RDFV            VXJCUTEYSJMH    KELNICIINV      QWITTNV         OEPGOGAR       
VAYPTHCONM      : OBKGONEPTCLRBP  UQHE           
KVMOSOKWSUTRO   : UDXOJFIUCNRXYJB JNKDEKVIKTOP   
UYFLOIKQHAKQEB  : GMFESPWSI       MTKNR           WFBGDIVMJDIWRB  PBDSPDVJKVKAE   UPRJVWVTBQBLW   JGNJWPG        
QXRPMH          : WHFLCXOFPFHWQF  TVPHLGLJQY      QQFWULPHTWNVGH  JGNJWPG         XKILH          
BTHVQBQFRN      : RAPOTCHGPGGV    GMWDTSFFDENSEPX QTTTKSYWBXVS    LFYKC           MCHCVRAP       
WYVHJNP         : NLEENDIN        HPTHDHDYLCUMA   YXMHOFCUAFNVXSR
AISC            : PNYVHKIQMJAQD   GGDHDHNCDBQWVED DBVONGSASNQQWK  VAKSIBIJI       BRVDBKR        
LCIBOPMRLVPC    : FETTSOJIAENTDPS JALNYUIUI       CRCECVCS        QWUJW          
GKRTTQTP        : RMMWEORLDCERKM  TCDBBSOHKSIXYDY SABKEVAF       
FFQRGYK         : WBYXSCBLYXM     TDAQPNKEHDY     RDAEWEJ        
PVMAADPOUDMKHOR : AXMVYGIKYAID    OROMUBIHO       HJMORQSNWVCDR   IIBUUCWAIEOOHXH DJLLMFTCNJF    
GNLAHEYPLRHT    : FVGFTGPXYDJGJPS FHAFGFMR       
TEIRSITXA       : TAYDPKIMMXUIVP  WCIBFQJNXMR     EUJMNW          HVVFGGEL        STXDCBA         CPIVPPUP       
SFAGN           : KGNBITFX        GGIGYNSFBVP     CIISRILGHB      OESYUCE        
AHVNVXXAWN      : AHVRFTN         MVRBFIV         HXFNGBHTLMSS    SNBGWNMXKV      CXGINMECHBGMP   UTDTWYPLAY     
QWKJSO          : JBMSBLAWOAWI    GSJUEWCBKRYF    DFEFEONFGJRAJMN
MKDHIGTELT      : RNKV            WFCFFBCAEETTGL  YJBPNR          TWYDVUBDLTOS    GSYMTLD        
YLKJHAFHAHENUWM : GPKDOOKOVBX     OHUT            ITTNCQFUBN      MBTT            YBQGMCBWR       BUQVB          
GFWBU           : ELGW            PJUCPEVLTXDYUE 
FCTNXXYUKBGWK   : XGONCXWXSLFVY   FXBIG           QGTCYGP        
XPWXWD          : RQHB            FJJRNAIHJLYWLX  VQWIESRAY      
TABCGJBIEKPIED  : SWMMFPYWPRXH    PPGGCB          EUCBNKTBU       ONRAETCEBQBC    UVBCRDEVBPH    
FEDPF           : YHCIR           TLINWGJ         YRATCFVRYNH    
PRBN            : CXFI           
XNGDEDD         : DYTHQGWIHR      LKSNXSIMK       XNEJQOW         CUXQKOQIGWYFFU 
FMRG            : HXOP            TAEHG           EQPBIGRQ       
XSOIYRQGXW      : SQFPDSEFJR      QPYLDXBKMGJE    XMQPMAPOHD      UKBFLGTSSKNB    TAWICKTSYORCD  
EIMVMCGMRO      : HCJPEDJNJYSC    DRNFLIV         YCGSXTMVQ      
WRVF            : CCCARLQVCEYMQSL PLTHENVJYPHKF   YHYNORKRGDK    
KYHJYAXJCRCIQ   : MVRBFIV         DDJCULCHTKSWL   QCWGOADCMJOR    HKIUCPJDLJQROB 
HWKVUWXDLSS     : VRTMSGMEBVIMIY  BDXGJX          KMRXQUCI        MBTT            CQMPDNEV       
RMBYMLATVYWV    : KMLPURJUFOALU   LLNMGTBBAQCPA  
YOMJHMREYN      : FQBQTK          WAMIYQOEAGAP    WCNLAKT         ELGW            TNJPKCIRVOWN    KKQTGFKYQEWYOW 
XOFJH           : LHOYSPUVQHT     DBCUAXKIK       TVCPXFMLPVDT    EAFN           
MYMP            : MXVVNQVXM       AHVRFTN         HEJPS           SGDQTWROCXMXVU 
YBAVYYSVJTMX    : RWNITLYDFFH     ICLJFGCJKD      KSRUU           OXUHGNHHBAYFFL 
TKUA            : DRNFLIV         AHKPOSTRTYWIWD 
LDJAITJIIIXX    : MPPGBPXK       
WBKUDLPYW       : QGTCYGP         VWPQHPBB        IPGJOQTWL      
NUPJIKJTXMG     : UPSATUXSRJCF    CYRLDKTDVW      GYSGMICBSDM     PAPFQXSWDCEJV   MSLPLE         
XCHIKRGKCGNM    : ELJC            UHPIEVRO        ORGWDRWKCIH     MUHEQ           SLIFGGLYVKIL    NMWHHLR         TSCXDAIVPL     
QATRWDFSSOB     : GTLEFUNKBN     
AWEPDF          : XQHACGYNMVADEIL UCGRTH          LCSGWEXNY      
FMXR            : ROGJCVQEEVKIYX  RDFV            QVOLRRHXNXP    
HEJPS           : IMIUWLB         MYMP            UTDTWYPLAY      PRUQB           DVKD           
SLYMGWSLRND     : XMXCKYUJQ       FITHVCNXDRYNWW  IIFJP          
TFRBU           : WOFNDYPLTBIN    FXBIG           YMIMSVULAYUEV   BUXDVPXNE       BQNGO           TPQKU          
GMDULXC         : OFNCW           DFVHDVNG        IWOMU           OOXGQLI         LUFHYICEIEMDEJ  NVIWSRUBFPE    
EOKWNDLOSRNLFH  : MAGVJKXW        XYJQWMFNCKMAE   NVIWSRUBFPE    
KCVQWWNUFBACO   : YHCNWCBAY       PTVFCJFMCAFHDL  NOGNEFHGGTPFY   SVVV            KIDAGMXCJUWDX   HIHXA          
FJDV            : SQTOUPNU        OWMORGJUIWGV    YIMPLXWQSQQLC   GARA            CSKVPQKLDEY     DQYSRBQPGGVRAJ  PLVEQKSONJ     
CLYPARHQDPXDA   : JLTBFWJAXV      JSQMNVDRDKOEP   GFJKTRCLTKGX   
YQXXHSFKUHYTOI  : OFJRUVFTC       YIMPLXWQSQQLC   WUKDT           ATGBFSQ         DDGJOJ          WSKFM          
KEBVDTWXBP      : TVPHLGLJQY      XLBOYCSHABNFXI  JNKDEKVIKTOP    UPRJVWVTBQBLW   ODFMBBWMNYQ     YNYGAMYUO      
QNGT            : YTYNEYHETVHQQW  ELXXJJQBREVCVOQ HHJVN          
HMQHTL          : YHCIR           LHMJHFM         SLIFGGLYVKIL    NPCSLGJUL      
EHUDBJNCWTFSXYR : XNGURNHAAF      EEMJGDSD        UGETE          
DHYTXIPORDGAWR  : WJJDUTEWEK      NVGXW           WCYGD           VTRYGUTLOGEDXRN
EBLJEXXGUR      : LCSPNW          RFNVRLN         DOYFK           CQWRQYHUANGOR  
NRLIP           : MGMDBS          YHCIR           GOMWQYM        
RRLPABHTGPVEJLK : TRAXIXNPVOHB    RDFV            VOFGVPLGCFO     FXVCDE          SJHTWIA        
WTPW            : WEYAOR          YSUSJQQFBYIJ    AJPAYPELNBJJGH  DGLG            GTLEFUNKBN     
WRMJI           : LKSNXSIMK       AYBHRPLTYK      ATPPLLJYM       XAVTTLIS       
WSUOKOCBQF      : WCIBFQJNXMR     WDJFYI          DKQRXGSGKRVIUQ 
KMAHSJUDUT      : TQAQGGIXMG      CHLXWBTY       
LRPKJEV         : BDVFMDXROA      GPQB            XHTXBWUO       
IUMFJXT         : YMYXUATXBQY     IQNFTDCF       
BKRNXENHWWCAU   : UPKJY           MMVLJBQRRWB     QYMMONCNXEBPR   UOIGJYQOJPGHC   PBGAIIKFIX     
YINQSAUQVE      : RDWMVKQEKHJ    
JJVJGJMSBAQH    : HIONQMAVNUKG    DTXQLGYVMLAKJS  GNOGRQSTT       WUXXX           ATPPLLJYM       MLWRNOIUBHWR   
XGMCIH          : KHVLYNCELMEIK   CXGINMECHBGMP   WMGFPTLBXXXXK   FEBHQEKYRIS     PFVOWBOJE       DBPRRJMOIM     
IROY            : XADHNNUJO       GYKAPWHL        JRCNFMNPR       TWYDVUBDLTOS    JWOBGFAS       
QUDNB           : MIPMBSX         JRCNFMNPR      
YMNKSYWOBW      : JXEJQASABEVCOG  CKUWXVFW        TQJEXHEDBXAVP  
KMITBKC         : RLKICBHBTUV     HBWEMKXIFR      RHAAAIVI        YDIMLG         
JMDBOQRJVHMNG   : DAMNSGCGMXF     YXLGHBQIXEU     TQUXXJCRMDX    
BQUBPJEOQQBYK   : TQQI            DKUGYYIB        STSODYHEOE     
MPQXETYS        : HAYTYCTJNOCQNM  AYBHRPLTYK      AYVXDYXDEVBBK   LJHRH           GIXIHRGS       
TELBQYK         : EMMXELWMT       VCDFGRG         YDNWMAALA      
BDNETY          : JAJQAKWUIAUCQQT RMWNTLBTLQDQM   ETORJIMECVFBQB 
IRBM            : XMQPMAPOHD      OTKMB           SNBGWNMXKV     
ORGGIEKE        : QTVROLPPRUSN    SQSGE           SFNNOCXJMWC     VROQFYO         GLIGFNNGVLS     FOMVIPBEEEC    
GTAKFDEENYHR    : NIYOVYLKYKVH    CAVNO           IORMTVDWCHUOGFS WAQPTBMUI       SAUFYL         
LNNXVFCIYQCH    : UWTPDOLLVTABQ   NIQW            JRCNFMNPR       GPKAXWIKK      
KMLPURJUFOALU   : RMBYMLATVYWV    WLACDMODDU      IIYJI           YACOK           XQWIKYEMM       YMDQBQWWDLDOACU WFJCAPJ        
KDIWQXMPVR      : GMDQBXFKCT      PBSGBFXT        UOMNXRWMKNPRJ   PMPRGMOYWI     
FTKJBJUPUMKNX   : KYWFJLXBSQMRJFO AARCPLWJ        PVFAWLEK        FCDJMFGEJG     
UOIGJYQOJPGHC   : YHCNWCBAY       WHXQYOMGJPA     BKRNXENHWWCAU   SHHIYOCDIGIFD   IODQPNDVBEWTXWE CTYJAHCN       
DVNKPXUR        : WYBX            YSKGRUNORXHNGI  UQIWOYMYLUJBI   BXEIJGHQKR      HLUHYMJCBEXHFB  WCYGD           IIFJP          
RHEEUTECOUMUEL  : ATMKJ           VVFOQI          AYVXDYXDEVBBK   EJNXKGB         RWFRDH          EKIVBBMHDU     
TUFAEJXIGLUVLPP : AHVRFTN         UQHE            HHJVN          
HAYNU           : KRLGXKCXM       WDUOQJGOQHECSTE
TYKOMIVXVPVERA  : XAURMGYCGPAXK   NUPWS           JMRAWIKA        RVCFEPNYNBAAU   UPLQHMYDI      
RKTDGSQVK       : YMFF            CCMMTKVOLYSANL  AEODCJ          VTCNUHLRBK     
GKMVHGSHRHVAD   : TGCTGYHFX       JAEIBYPEJ       CMAHXPMURJGEYJ  GGONYWDGTHYDINY
XUREO           : HLPXWCDTBSRKU   UKGSKOATNUUWW   FEFEWDYJJNIGVA 
SGFOLL          : WTXH            CTPLOYSX        SKKFPBVASWC     SNBGWNMXKV      XRNXICBBD      
CKUPSFDQPLJYF   : RRWWLTMKKU      WWKWWOMTJQB    
UHWQGSLKHIFQNUC : CHKYWFYR        HKIUCPJDLJQROB  RAYRTRH         MLHAGVIOWQF    
GHOBWHJAAYMKX   : NMWOOVMYEMBT    IEMT           
EUCBNKTBU       : TABCGJBIEKPIED  GNOGRQSTT       AWNYSAJAXTDXFBK AGNCDEBYPYEPXV  MLHAGVIOWQF     MPHHHFYGDNYJT  
JDWAAYEGGSKG    : TGCTGYHFX       ECMUVHWIPIHM    DBVONGSASNQQWK  CQHYLTVHEFLQDVL
TGCUUMUPQPRSFC  : WLOUSUUDCC      VFMETWKCIPDEQ   LSKDHHXRPN      FIEBYKDCU      
HYUSE           : OPAR            SMHIXGOKHA     
SETWNAPX        : NKGPWJQEUG      BSHBMHSATA      RTQIAOUVBVMA    GSKEVKAPAGASNNJ SMIVSIOQPIN    
TRPWMMLJEDYXXEA : KJXXO           BKOHRXYQUUXCDNW BIQPRHNLBOS     GQHQ            RPKSWWVIJJCDO  
NCMHGECN        : YHCTPVQKXB      QLDLXXALSDY     RQNMKNKAHMFKPXY
ABBRYJOSBLHQWQ  : GPKDOOKOVBX     SHYACMXPG       RHAAAIVI        UTLBKRS         NVIWSRUBFPE    
CRTCXV          : GBBLVCCTFPV     DAMNSGCGMXF     SKGUSCGU        EYPIXWROEWVOTX 
MAGVJKXW        : BNEIXVN         EOKWNDLOSRNLFH  DAMNSGCGMXF     EYVUDFAU        RSNLSLURGJFJ   
AAOUYAJTEWBUTRR : DQBJGEU         AXGAKYKJSCHSMY  KBBSR          
LNBJM           : UPNVOPHQRIBJ    YHCIR           MIPMBSX         AWMRGRNIRIUWDG  RMRVSWKK        PXWAOBTBXQY    
VMBTXOUUCUWQ    : RTFEBOYS       
XSBRWX          : WFCNHTF         CKGRGKCEUICA    SUESPY          TGBFQK          RUUSXRNMQDTMSQ  USOFTSIQ       
TUMOVACYKOWIEAD : QCMVCBJWILE     XFAOVSPQD       KVXNMJTEDVPRLHG FIEELUPB        SLMBRWHV       
OXAS            : XNGURNHAAF      HXTTUSRDOBQ    
WJNVFQPCRL      : QKFUOO          TRYIDWWYQTVNAQ  IODQPNDVBEWTXWE NQVCFYB        
MXNKYPJLHGTL    : XFDGHWFXB       JGJUFJDQ        VIJHDEX         WSKFM          
YNXWPRUNDKLIB   : SROW            BFCEFRE         XNVLQGGWMV      YKQVUFJWMLWN    VJTPVRTATUDRL   STDNUSP        
NSMMHNCROTCABK  : XHIFJSPMSJA     AUIOMYEA        THWHU           JYHFBPALUAFNO  
ORTFQSUIPI      : WLHFQ           WGVSLI          YHLLIFKPBUGBMYP BQPLSIPPKHMSB  
AVWCXKWKYFX     : NMJIRDYBXH      MAGVLBQJESL     CKUWXVFW        LYCGHJCP        PCXGKOBU        DLAD           
WMUBOYMLNGH     : NNEUOXH         RYXN            WGJXJBSHFIG    
YAQHSB          : WWUVXFQH        CTCN            LUAYK           RDKRD          
SXUWVFWIE       : EAGDA           DFDVNAERF       YKXIEBXLPLB    
JHBXEFNDTYT     : BLLKM           GMDLKIPWQEO    
GOAIFJBJHWHC    : QTVROLPPRUSN    KTIRMSXJEXBGEBB YPMQVYWNJSFMNE  ONOW           
FHSNNWYWYXCG    : MIMXBXTEPX      IIENSO          IGQRAXG         EWTJ           
FAMBAS          : XHTBJ           WDJRLR          ELGW            XLLSF           KYATSP          MNTKPSNSQD      SMHIXGOKHA      EJDSYBEVJM     
CDXOHHVG        : PAMKXNDU        FIPS            MXNAKWWDN       NYRQMJNO        WFVMENWBA      
BCVKXMBULXVJAC  : SCJYLSDLDUVBS   UUKNLRVEJQIVCCC CTYJAHCN        DEIVMMKIX      
ICLJFGCJKD      : UUNQ            OFKLEXD         YIDFEXOTSAKS    YBAVYYSVJTMX    SEHXNRJ         PPIYQGE         OXUHGNHHBAYFFL 
RKWXCXCAKA      : QWQVMXK         YJPRTEB         YIMPJLIOAGCNVRV LRII            DXRXHNRFVP     
LXBKTMMWMU      : VRSJCFDDVVDRFBW IRMQTFMOF       NFTBSHQJM       UNISE          
XHIFJSPMSJA     : OFKLEXD         PBURKK          NSMMHNCROTCABK  THGKE           GMDLKIPWQEO     QHGF            ITTNCQFUBN      PPFLT          
XHIFJSPMSJA     : LAELP          
JCPLE           : PFUHRWF         OLQEBICKXKSUDS  NUPWS           RWFRDH         
OROMUBIHO       : OLQEBICKXKSUDS  PVMAADPOUDMKHOR APGRWF          XLGPSQ          OAHTSLAIDBCMC  
TJJSQTA         : DVYLRIQXX       AEQKMXQGLL      VROQFYO         PTVFCJFMCAFHDL  YNYGAMYUO       MAYDYNKU       
MPPGBPXK        : NPYTNPLUKDXS    HDEWALFKML      LDJAITJIIIXX    PFVOWBOJE       NMWHHLR        
QXYTOSIDNK      : WDJFYI          BTYLLGR         NRMOUFGOQNFLG  
WYTTKFMCAOF     : PCNTOXDLOABAGM  WCYGD          
EWWHNVRJMRKIHF  : HIONQMAVNUKG    MXQOKNKXU       XWNTTPRQCL      LLXQV          
KSDYS           : XUQMRWOUFW      DMOGVFSSGE      HKQQFWXLTKASE   KCBTIADMUM     
VMRDBTD         : EGEIHPSWISVNX   BDBWWAYULSK     EPLL            TGELQJUUNRW     CTYJAHCN       
BUVARDPP        : RPKSWWVIJJCDO   DDKYWQWMEVDI   
AEQKMXQGLL      : TJJSQTA         GECAEXKCVAMDYN 
KGQGSIKVE       : BJFTTRFNDOGBMSC QBHDDLLRSXW     JIEWKPJCIQRX    UEEFELPSNMGGECS YDIMLG          KYWEEWTMO       EWEGNDEKCC     
LHMJHFM         : CQOUTAAOX       SXFSYOU         XWNQI           YMUYCUHNLPP     HMQHTL         
WLACDMODDU      : KMLPURJUFOALU   DDKYWQWMEVDI   
RHAAAIVI        : KMITBKC         ABBRYJOSBLHQWQ  TVORAURSENXPO   BQPLSIPPKHMSB  
ROLEVXP         : OGJT            FKOCUMRPTMQWPS  LLNMGTBBAQCPA   FIPS            OKVXEJF         WQJDLIRF        QBRHY          
FDDD            : NFPFBO          FVNWRASWKY      DHDSLX          KYATSP          UIOQRUUYATSK    SMWYUFTH        FTQQDEYN        RSNLSLURGJFJ   
DFTQVAVTOPDO    : NMWDJIRH        MIMXBXTEPX      NAPJEKYKMVPKB   DYXUKRH         YHYNORKRGDK    
DAMNSGCGMXF     : XREGX           JMDBOQRJVHMNG   CRTCXV          MAGVJKXW       
DKIJNYMUVFTVENK : JNTRT           VJUUKTADVKIJP   LMJTPML        
QCMVCBJWILE     : KWHJNJNBYR      WXTIMKEGJEBUY   TUMOVACYKOWIEAD QKNCDB          BBGQTI         
LLXQV           : JIEWKPJCIQRX    EWWHNVRJMRKIHF  HVVFGGEL        OOXGQLI        
AMIPHEUBCYQMV   : SGCOWBNT        EEMJGDSD        STDNUSP        
QKFUOO          : MIPMBSX         WJNVFQPCRL      RYXN            OUNYWMNK        AYBHRPLTYK     
YCBTNMUFIDFWNWF : EMQSI           NWXHDHGJDRQ     YKXIEBXLPLB     NRCL            IIENSO         
SIVTCLRLCFRAT   : TAIJNPBSRPRAH   EMYVMBTBLMF     NOJUOWU         KNBSYICOORQFGH  SKULHBFJQTNRW  
USLVOBKLISRQ    : SQTOUPNU        SLMBRWHV        JPWEYEYXNBXKDS 
FNXAII          : EEMJGDSD        UVXPXOGXYHKBIDI IUIO            BDITYQCEWAPFCL 
DKHWYMCQMVBJ    : EJEAIRTARDAV    JGJUFJDQ        NVGXW           FOMUUCFQ       
OHGSRTB         : JQRLWKUHOUR     RNTHSKMFOHNS    WHYRCRRPVGNFPV  KGNBITFX        OVCFU          
LTDRIDT         : FHAFGFMR       
OPVYATXMVQ      : YUTEUJBQVOE     LGIBATRVHCPXQER
UUKNLRVEJQIVCCC : BCVKXMBULXVJAC  WIXH           
KFPEVIAVIT      : UMPFWV          STDNUSP         KXAQQASDROE    
USPVPMGDXACDJS  : YPJJUYJMCGBFHG  RQNMKNKAHMFKPXY BNMK            QMYFEGRAOBOVN   TCQDGJD        
HWPJ            : JRCDI           LCSGWEXNY      
BRLHNTHLEEK     : QTHCNVNJWQ      TRJJCDKHPQGPAJ  FEYMADUDHQ     
YCWOODTM        : RXQDKFJTF       QPIFAPYDWQENGPF UFOIXUL        
VROQFYO         : XHJJTHDDDDVFI   NJNFASICCTOUSYA ORGGIEKE        TJJSQTA         FQFJVKYBBWL     OFLFGPELQ      
KKYEXGUUNGYTS   : WLOUSUUDCC      DFDVNAERF       JEORSBFF       
SUVJJCGWHEQYVW  : PPWPF           WMGFPTLBXXXXK   UVFSFJUOYRYKE   ETTEHBTWIKGLK  
MSKWRPUAKPNQPKM : JXVEVDXARFVHE   MJKJXSA         KEUBIYHJAAK     JVXA           
DHOPRQVQBC      : KWHEAFJKIDJL    OXUPITWMTF      AWYDFLCGIBKEQK  FXVCDE          USOFTSIQ       
AXGAKYKJSCHSMY  : VARLLG          AAOUYAJTEWBUTRR YXVLPRHMFRVVI   CCHPWKKJU       VABNG           GWEDJXKQPAYW    JRTWYDMDOEUN   
GQTSHYAYQTP     : UCGRTH          FAMUTMLLTPF    
KSRUU           : PASAQOTEYVAC    JMRYEDQOBDMFLV  YBAVYYSVJTMX    TYOXUU         
BUDDIMV         : YPJJUYJMCGBFHG  QGJLXGILUJNJD  
TRAVBGM         : GTMTGFTJUCWV    DKGJEMVXKESBG   QJALHU          JAKRY          
BUXDVPXNE       : LRQOFE          TFRBU           HLUHYMJCBEXHFB  CTCN            MUHR           
HVFCMHAR        : CXNULO          NCRSMVHUCMIQO   EKAYDCC        
KEIW            : XRSPUULNBCMSSJ  KELNICIINV     
AWYDFLCGIBKEQK  : DHOPRQVQBC      KAODNFT         OJJSFMD         STGFTTI         FTQQDEYN       
UUATBEIKEAWQGHO : CRQGF           VOFGVPLGCFO     CQHYLTVHEFLQDVL DFKARWLBU      
KLIPTUSADTMIMW  : TETHW          
JSDD            : PNMXDJECH       LJJGBRXYEK      UNMLGGJBLIBH    EVMBUX         
JLIQLFHSO       : IDASYYEINNLGOHW IFBEIBESAXI     CNMB            OKVXEJF        
CYKLP           : UKFWLFJJDLQOO   IVQYUVAYR       WCIBFQJNXMR     EJWYJVONUDCROEK EWTJ           
IKGLEVVQUYAPEGL : GOGD            IPVKMEGWJRAMLO  QDTNOQ         
RTFEBOYS        : VMBTXOUUCUWQ    FTVDUF          NRMOUFGOQNFLG   YDNWMAALA      
DTXQLGYVMLAKJS  : UJHHGEBBDL      JJVJGJMSBAQH    AIVRPTCOSSLYI  
JVVPCKGTG       : EBJG            EAGDA           AJNFMBKUWUSN   
AKDBDQFWQX      : EMDDYUKTKUNS    HQSCRLXISRM    
WXHLLK          : HLUHYMJCBEXHFB  MRIFANFROIRIPFO
UDFGBDWDPDA     : IVQFSGP         SMMJROJFIFX     HQOBOPLPK       PAMKXNDU        WQSBOCHCT       SXAL           
RAHWEMP         : LURNFOHOYNGJO   KICDVSPFW      
JGJUFJDQ        : UNSEXGMXSXDPR   MXNKYPJLHGTL    DKHWYMCQMVBJ    AULXRPKWMCQRFKU KHPEJDPAEAKEK  
PPSSWYUDXA      : YPJJUYJMCGBFHG  VQURQSCIFVSRWK  AGDLCHIHTEOQN  
EAPXDYWHLMUXSEU : LRAHJD          XADHNNUJO       FIEELUPB        KWPLV          
OAQLPJEJI       : VSOKSTWV        RSNLSLURGJFJ   
GLGIH           : UHPIEVRO        WHYRCRRPVGNFPV  FCDJMFGEJG     
JYKMYHVMTS      : YSKGRUNORXHNGI  JUASDMGAQU      KIIXWMQLSA      JBWXUEDJMR      XNVLQGGWMV     
OWGONIICY       : TKLNCIGPEBXCSMQ VCFJCYE         GUIH            MKOVWWVXYLSY    OGLIAW         
IKEOQQXYAKKY    : XRSPUULNBCMSSJ  UGETE          
YXHWLEPXS       : TGCTGYHFX       DJLPGRRNWSQWYU  YQGGYBDNIQO     TKPFLD          FAKBSD          UPLQHMYDI      
GKFPUHOO        : FXOMGYKNUTPMYNF PYWELY          LWPEISPR       
YUHRNFSNSGNQFN  : FYIMTCLQNJ      DDGJOJ          AEODCJ         
DBCUAXKIK       : XFDEDEOR        XNLY            YFIETDNWYKVSYOU XOFJH           GFJKTRCLTKGX    LSKDHHXRPN      VOLQSGET        TKATI          
XFAOVSPQD       : RAYRHHRFKYI     EUDPB           TUMOVACYKOWIEAD OXULXDXWRSPMMM  BBGQTI          FBXTIWEK       
FKDUD           : LSRWWGNTA       BQNGO           BQPLSIPPKHMSB  
IVQYUVAYR       : KWRAJS          CYKLP           QWUJW          
YENJWLQADMUSG   : NTGI           
DNJIIORT        : MIMXBXTEPX      XHTBJ           FGMIBNDXWEPWSCF VWECIIGBIGKC   
KSIHSJBX        : EWJNPSFSH       CVFQPSESDP      LWCQ           
HLUHYMJCBEXHFB  : UJHHGEBBDL      DVNKPXUR        BUXDVPXNE       WXHLLK          DDKYWQWMEVDI   
QJGFD           : UHPIEVRO        JVEIIIIXAUR     CTYJAHCN        GMIGFYWYRSF    
SPSDWNPA        : NOGOEDMWXMA     MQPE            BMQOEFOSSVRDYX  QBRHY           VGKYGC         
BKBVRBKBFMFD    : KLMRVEJIAFGURJN HEHNXNW         FBXTIWEK        NOOWUNODOL     
KGTB            : BTPGUVVW        CTCCUWSBDBF     EBBKYDMBMOO     AYBHRPLTYK      WFJJWOFKGRJ    
AJWAE           : OTKMB           CCKIICW         HCKWIUM        
UIMKXNYYXA      : XLHKA           KODEPV         
RDISLUAOS       : FWKU            NRYLJKIQS       KKQTGFKYQEWYOW 
XMQPMAPOHD      : XSOIYRQGXW      IRBM            XEXDLIQOB       DLAD           
PPWPF           : NMWOOVMYEMBT    TGELQJUUNRW     SUVJJCGWHEQYVW  TUITYQNOEJQQP  
QFANWEVRP       : BVBLMPB         ONOW            MSLPLE         
UGMIEY          : EVMYKDEDUU     
WOCMFJPRBHQ     : VDQGMBIW        CBBXWUALY       KNBSYICOORQFGH  RPXO           
NOJUOWU         : QSUCQM          MGKNRDJAF       TLINWGJ         SIVTCLRLCFRAT   TXBNIXPIWLUMU  
VMKOHTDRAFTW    : ILDAB           SUEFOO          JDUOPS          ESFNXM          CQHYLTVHEFLQDVL
XLBHDUKLLDBCMXT : AYAXBSXXYKUCU   EKAYDCC         RKRSMKJNSLVBVD  KHTMSGIGCPFIUV  TPIEATL        
SOHGCYPV        : XGONCXWXSLFVY   UHIBR           SNIWPPDGLU     
KVJEVFCHHLLEV   : SWMMFPYWPRXH   
QYAUNXOWTG      : NEPKTCUOE       IPVKMEGWJRAMLO  HCHBBIVTNAVNRK  WDJFYI          UXQMCI          UCGRTH          HXTTUSRDOBQ     RJUWXJYJIGN    
CKGRGKCEUICA    : EPLL            XSBRWX          ELFTCFJKTNE    
KJXXO           : MWBAKJSQBXH     YDGWYGGS        NRCL            TRPWMMLJEDYXXEA TLJKG          
WHUYCIYTIS      : ETORJIMECVFBQB  UFOIXUL        
PUKVPSGTYBDCEPO : EEFLHB          BVWKQXFWG       YMFF            PCNTOXDLOABAGM  SNIWPPDGLU     
OMCILJGKOOJI    : SFNJKEYWJCSEQ   DBVONGSASNQQWK  EBBKYDMBMOO    
FKOCUMRPTMQWPS  : JAJQAKWUIAUCQQT UPBBPPYHJXDTLNM IAXCNSWMJBNJKQG ROLEVXP         VQURQSCIFVSRWK 
HHRVVVHHGN      : GOGD            YLRO            BPEB            ETNN           
UEEFELPSNMGGECS : MBLBHDIUFGTUNF  YCEJQCJQXH      KGQGSIKVE       XQWIKYEMM      
BKOHRXYQUUXCDNW : JLQGNDI         TVPHLGLJQY      TRPWMMLJEDYXXEA HJLTRKBJSSX    
RDFV            : UDCKUWQTCKRON   FMXR            RRLPABHTGPVEJLK PJNGLORHNPPFIFD DDGJOJ         
WRCJAKNEDJ      : HUVBSBJ         SXFSYOU         KNJWJBTSMTCJFM  WDWGXTVRONGV   
PAMKXNDU        : BHSFGP          CDXOHHVG        UDFGBDWDPDA     YSNLOHWHRRM     EWEGNDEKCC     
BXQQWRKAYHOWBSG : BVBLMPB         HTVVYKEJ        PBSGBFXT        WEBW            RRWSOFRTHL     
EWFJGMCGC       : HQNYYEQHF       VWHBQMWQXGFDWJO JDPAAXMK        BAOJEPLIEPANFG 
GRPCFSCWLBQV    : SUAAPOJU        NLEENDIN       
PFROGMXJQUQD    : VSQKXD          DDKYWQWMEVDI    HSBFSIFKGO     
GFJKTRCLTKGX    : UOWYEDDVX       QSUCQM          JESO            CLYPARHQDPXDA   DBCUAXKIK       FGLUASSQ        CQMPDNEV       
RYXN            : WMUBOYMLNGH     QKFUOO          MAGVLBQJESL    
PTVFCJFMCAFHDL  : TNJOXS          KCVQWWNUFBACO   TJJSQTA         XRIQIV         
OVGGBTDLABUR    : OFNCW           CCUPQD          UGETE           IXBUEBJNJ      
UIHKEER         : MWBAKJSQBXH     HBWEMKXIFR      SUBXDMAJP       BABLDRBW        TPIEATL        
PWUTYDCCOQQNX   : MSAY            TGELQJUUNRW     IOQXEXEWWYBBWIU CVFQPSESDP     
QTDEUEY         : IXCORALJN      
JTWTGDXBKPAHLAK : OPKTVA          WAULQSUVPBVE   
CCFVR           : OLFDSL          XJLOVV          IQNFTDCF        DINVSUJAF      
VKYYOTFPLR      : IMIUWLB         LSOQQADNNETYM   KMSQJCU         KJKBPHOAAGXQUKQ
ILRMJSYBTIMVVD  : FHIRFDYQLP      QSHYCYDCM       XHUYDWTC        ECXFWYETNV     
AIVRPTCOSSLYI   : DTXQLGYVMLAKJS  EHWBOJM         XTRQGNIW        YAUFEYTROXMAE   QWITTNV         SKULHBFJQTNRW  
QTHCNVNJWQ      : OCAFRNNFNSMA    BRLHNTHLEEK     PQQLLPKJJP      KVUFBF          MKMGUTJ         NFCXVDFBNFGTK   EUXSMDMXFD      DQYSRBQPGGVRAJ 
IFBEIBESAXI     : JLIQLFHSO      
CXNULO          : XRSPUULNBCMSSJ  HVFCMHAR        FMAQG           KERHEUUGAP     
KHBRLOOBXNR     : IFRPFLHMRQARE   VDDGBXNEFBDQCW 
VWECIIGBIGKC    : OYTLPWUUCGH     DNJIIORT        BWFCV          
KRFVIMGPNABDQ   : ILPLDYEEVNKRI   TPOVJGKMX      
DFVHDVNG        : JUASDMGAQU      GMDULXC         LCDFVSCCIJR     VTKFTRTVOUI     PIGUOMHUXTAHXXY
VOFGVPLGCFO     : FBSIE           WGVSLI          RRLPABHTGPVEJLK UUATBEIKEAWQGHO YUPPVGJOR      
OBIGRJIWAM      : KJLMSTCY        UTTCBLJLLUCXHM  KNTQLIAUCNLCAU  MGAOYNA         FLONMIHE       
HLJLHXRLVGSFELQ : WCDKS           QQEUNQYL        EYOHNYGCUHQIJDE QUQENPCBEWFDINJ YVRNPLRCVQFY   
NVCOMFWTYICV    : QACHVXE         UXJXDB         
QYSCI           : ACYAKS          CAOLMFTTVLVXLHC IFWYOBY         VTJDWDW         OAYAIMGXAWMOIN  HNIJJCQO       
LIXWF           : OWMORGJUIWGV    PNYVHKIQMJAQD   RMRVSWKK        STDNUSP        
QKNCDB          : OMTHCWMAR       SKJK            LAAAXMDRFJ      BPEB            QCMVCBJWILE     BTIMINB         ICFBJR         
YDIMLG          : YACQQWSXDKFLIJQ YDGWYGGS        KMITBKC         KGQGSIKVE       EPQAYMQV        VISPXBVUS      
KOKHADGVIOCTADT : HRGVWXDGDFV     WUAUMGGH        RMWNTLBTLQDQM   NWTCBKGVFCFLUM  AGLQHA          OBLQNJRTASYWVO 
KMRXQUCI        : HWKVUWXDLSS     PACCA           LNEEVSYUMJRB    NRMOUFGOQNFLG   OSPGAGPSJSV    
FRIQA           : FTGAXAT         EDXXU           MGAOYNA        
CQDLRJ          : PVCTRONRCG      SCJYLSDLDUVBS   QOCMIH          TKATI           TNJPKCIRVOWN   
NRIRNIUHP       : TFFTMIJLKKVX    WUXXX           QWUJW           BQPLSIPPKHMSB  
THGKE           : IXAAWKL         OGJT            ENRWBWM         FJYN            XHIFJSPMSJA     MDKPLDOWOHYL    HQSCRLXISRM    
VBPPLJPFN       : CAVNO           PQHYAM         
KYATSP          : FAMBAS          FDDD           
DIAODJGLEQTQUEO : KDNYR           LJWJA           EDXXU          
TEKFTRSD        : WBOOMTOMIW      GARA            FOMUUCFQ        OAYAIMGXAWMOIN 
RDWMVKQEKHJ     : DDJCULCHTKSWL   HDEWALFKML      YINQSAUQVE     
NUBEO           : HCJPEDJNJYSC    LYPEOVNLLFI    
AULXRPKWMCQRFKU : UTTCBLJLLUCXHM  JGJUFJDQ        BGQKMEG         OMTUQSGSDFP     XJDWFXMVBJJ    
XSOQWCXHYLEC    : KHPEJDPAEAKEK   VWOUSOFLJHC     BKAUREYFA       TQAQGGIXMG     
VXSQ            : REMHSQQDGUU     NEKTHEWWB      
QICEGO          : NMJIRDYBXH      GNXFNAYCMKIUNW  SKGUSCGU        SDJOYBB        
YGNJDTJWJAVNXFM : RUVVDSFMEMPUO   LWLHOXS        
MQDIOVYBOKDSQR  : VLGVVOCLLC      OGLIAW         
RAPBFMLCVN      : RPAMFOGIOM      GBVBYUBQGVLPGHH FEBHQEKYRIS     VSQKXD          CQWRQYHUANGOR   ACMCOMGSY      
LOIXBUQG        : MYRLYTGDJRAS    JFJFHQPRLFXQOAS UPASHY          AFMKSTAPDSLVV  
FCFGS           : YPUK            GTMTGFTJUCWV    FIVO            PACCA          
JMIDOAFGDLSQPQF : FYKGUUIPSIYI    BRVDBKR         MQGG            WDUOQJGOQHECSTE
CTCCUWSBDBF     : FJVPXD          WPTPTP          KGTB            VWDSBKYLFKGRP   SSVBCYG         KQOPNKL        
JXAVMKYDMHM     : IBRQL           WCYGD          
SHHIYOCDIGIFD   : BVBLMPB         UOIGJYQOJPGHC   NAPJEKYKMVPKB  
IIENSO          : NXCTLFRYSJBFTPW FHSNNWYWYXCG    YCBTNMUFIDFWNWF QVDIIAVPOYLJHY 
UKBFLGTSSKNB    : XSOIYRQGXW      MDKPLDOWOHYL    VVYNUJCNDNPA    QJALHU         
WCIBFQJNXMR     : TEIRSITXA       WSUOKOCBQF      CYKLP           PMPRGMOYWI      RNGHOKG         AFMKSTAPDSLVV   KJKBPHOAAGXQUKQ
XVVQKJOWMVJTQEO : OFJRUVFTC       NSICXUGR        RLKICBHBTUV     MINRO           UCUVVMIO        KQOPNKL        
SPUR            : TXPHURYETD      UUMH            IRTJTUSIXLCMI   BFARYJHB        OPLNAJDSHIT     YHLLIFKPBUGBMYP RPXO           
FUAXEPVSHCQGXK  : DEHVEVVXCUXSDSY MBLBHDIUFGTUNF  QSWTUIQPNENG    RMRVSWKK        KTIRMSXJEXBGEBB
JYQWUCSNIHOBAL  : UINWARNMBXHG    YMIMSVULAYUEV   SSGIAAAVKG     
TSPTQVK         : NIYOVYLKYKVH    CDVFUTQGKX      VEEGKNTM       
RTQIAOUVBVMA    : NYKFGURWUKX     TTDIPF          NTWLDAQJ        VTORNVMNDHUAQ   SETWNAPX        UFOIXUL        
QSHYCYDCM       : DQSVUQU         ILRMJSYBTIMVVD 
YGQSW           : IPIAYUTCCR      OUGBSWWTMQASY   TPIEATL        
FMEADPCUMXVLM   : VSOKSTWV        UKLFMVJSTS     
HFQOFUPIADGY    : XNYEOEMLDVUWJ   FONCYLJIY       KGNBITFX       
YRKOX           : CHKYWFYR        IAXCNSWMJBNJKQG TVLYFBA         TFMEIUPQJ      
SABKEVAF        : LICX            GKRTTQTP        YRATCFVRYNH     TIJHHPE        
LTPSAGJF        : BFBKEBCYAM      NXCTLFRYSJBFTPW CIWWJDW         HTSTYDKHOVNV   
CPBHXCS         : KFBSNSIINCESM   SFAPAETCKAFT    NRAUXGIEJHHITEC MAGVLBQJESL     KCBTIADMUM     
UDMUDHWEUBC     : FONCYLJIY       KYWFJLXBSQMRJFO HKGLLBS        
ITIDL           : MVVWXECMEOVR    KBBSR          
DROKU           : PSHJHJKL        LHSVWJADLIVKYNI NYVSTJULTVJ     FMPISLDUNLEFU  
AYAXBSXXYKUCU   : JVWOJUFFQVYES   XLBHDUKLLDBCMXT
IPVKMEGWJRAMLO  : OFYMVPQWUKMKPAE IKGLEVVQUYAPEGL QYAUNXOWTG      KEBPGJDPAUGMS  
IIYJI           : QLQEHEUPCO      DVJALEYTSRMOS   KMLPURJUFOALU   VXJCUTEYSJMH    QVJRC           YYMKEOJRBDHPR  
NEXL            : PASAQOTEYVAC    WIGTASWGWHDPMU  XVMANRSAFRMAX   PVDJUR          DEIVMMKIX      
LJJGBRXYEK      : JSDD            FMAQG          
KHPEJDPAEAKEK   : UHIBR           JGJUFJDQ        XSOQWCXHYLEC    SKGUSCGU        IPFTYSTQYMAFX  
GXAGLHRUQAYIAXM : CDVFUTQGKX      YBWRAB         
EYVUDFAU        : WVJYKGKYOQSG    MAGVJKXW       
EUSK            : LHOYSPUVQHT     JSQMNVDRDKOEP   BJNFBXJMJCG    
OQFQARXT        : ACYAKS          EBUMGEEFAUP     EEFLHB          UISDFIPCCFRMI   YHCIR           SSKO            MCJJULWGCLQU   
OUNYWMNK        : QKFUOO          IUNKD           TPIEATL        
MINRO           : EWJNPSFSH       VTORNVMNDHUAQ   XVVQKJOWMVJTQEO FAKBSD          HNIJJCQO        YTEISJHHQUERV  
MYUIRFP         : BDBWWAYULSK     GFBSDOCGFVYEX   RNTHSKMFOHNS    JCFNOHAMXPIUU  
YVAYNBSCPPSRPFF : PDAVSDOWRP      TJXMC           FAPXHCCGLGSYAKR
AUIOMYEA        : TLQDO           NSMMHNCROTCABK  NABNFHWQYSEOS   OPEP           
YISHAEG         : QIFY           
GHLHCOASJTI     : SHYACMXPG       LEHWQTYIQHS    
YKQVUFJWMLWN    : YNXWPRUNDKLIB   FKGV           
RUVVDSFMEMPUO   : YGNJDTJWJAVNXFM UWELXPCQL      
EIUUKFMI        : CBHDYRIPSNSWTWN NRGMY           XHAMCYQFS       LDOO            DKKSWMSNGEDOQD 
TRYIDWWYQTVNAQ  : WJNVFQPCRL      QYNEMXIJF       TNNYWYF         NPKVOLKAFHW    
MUHEQ           : XCHIKRGKCGNM    CDCDTW          UMME           
OWJJSVQHFT      : YSKGRUNORXHNGI  SSKO            XLGPSQ         
WUKDT           : YQXXHSFKUHYTOI  KYWEEWTMO       WKBTNBGWYQWSM   XLGPSQ          HTSTYDKHOVNV    SDJOYBB        
ELFCY           : YYIQAGM        
STSODYHEOE      : REMHSQQDGUU     BQUBPJEOQQBYK   BNMK            TESPECUEVEFAN  
AWMRGRNIRIUWDG  : EDDQBUFM        EPLL            LNBJM           HEHNXNW         YVNMDXGPY      
OLGPRYL         : CQOUTAAOX       WYBMVPVXP       GTMTGFTJUCWV    NFKSIRDYT      
PQLWV           : LHOYSPUVQHT     UOWYEDDVX       HWKFC           MTBOXTHCCNVU    CSCNSJMWK      
EMDDYUKTKUNS    : ORGWDRWKCIH     AKDBDQFWQX      KRVJUAACMOSE    CWUBAPJSFYIO   
KVXNMJTEDVPRLHG : TUMOVACYKOWIEAD XFUNFYFC        GLSSBMMXXSM     XYRMDMOYP       HSBFSIFKGO     
FIPRLUSIFO      : PNKWPKO         EDDQBUFM        XWNTTPRQCL      TATMBYVSREHLS  
CCOTM           : PDUIFYVSUE      AMKNEQLSWPKOU   QVDIIAVPOYLJHY 
RDAEWEJ         : VLJIOFJNTH      QKON            QSUCQM          FFQRGYK        
WCHEK           : QLTRVPY         FXMOG          
LSKDHHXRPN      : WRHTXPCFARDVPM  UKUJPDWHF       TGCUUMUPQPRSFC  DBCUAXKIK       ATGBFSQ         FJJRNAIHJLYWLX  SJGJDVMK        FUFO           
RPAMFOGIOM      : YJBPNR          RAPBFMLCVN      EWJOWFIONVYNW   GNOMIJUSMUV    
VWDSBKYLFKGRP   : YIMPLXWQSQQLC   CTCCUWSBDBF     KWPLV           BTCGHR         
YNGOB           : QXKFCVI        
HTVVYKEJ        : UWSNPTSCHPI     BXQQWRKAYHOWBSG VSRYPBFAYPJFAH  HQLRGO         
RQXQTSTGTF      : XGONCXWXSLFVY   TGXURNBULMH     CIISRILGHB      AHKPOSTRTYWIWD 
ELFTCFJKTNE     : ARLBCONTMAA     WHXQYOMGJPA     CKGRGKCEUICA    XNEJQOW        
JCBIMGTQAMOQJ   : AMKNEQLSWPKOU   JTHJUMIILARS    YHQKCYEXKXUEIV  LKSNXSIMK       HBFKVCEFB      
KPDR            : KDSCONYEGXGFF   OVNCLFCJTE      WFJJWOFKGRJ    
JFJFHQPRLFXQOAS : MWBAKJSQBXH     XTMRNGLO        RLKICBHBTUV     LOIXBUQG        CNRPBXUVM       VPASAIILH      
PBSGBFXT        : QMPBPWI         JXEJQASABEVCOG  FQYXWWAB        KDIWQXMPVR      BXQQWRKAYHOWBSG SSJHCVDHCJKFJB  NPCSLGJUL      
HEHNXNW         : EXSOP           MXVVNQVXM       BKBVRBKBFMFD    AWMRGRNIRIUWDG  HCVBTIRLRGCSDKF
WDNOUHCAGUOIPNX : IDEPCP          LGFWBXJOWMHAW   WGOSKTLH       
IFRPFLHMRQARE   : OHUT            TYMAKMGF        KHBRLOOBXNR     KAODNFT         FTGAXAT        
VDDLRXSVXYTOK   : XHQTU           UQHE            FXMOG          
EIBOPUE         : OIPTTBVU        JDUOPS          RRLOSANIQSUJQP  MROAHHNYUROC   
JNKDEKVIKTOP    : TWGQFGNIYECRY   IORMTVDWCHUOGFS KVMOSOKWSUTRO   KEBVDTWXBP     
GNXFNAYCMKIUNW  : QLIT            FODBHSSISGWCFXM QICEGO          PQSEYDTQGPUJ    EJWYJVONUDCROEK ROQUNJ         
LEKWRU          : AUECE           NVGXW           RTMXYSMALSJQ   
WIXH            : LYQVUYK         MQBOQXVJVDVAW   UUKNLRVEJQIVCCC
TVLYFBA         : YRKOX           VKGATYRJWE      WICQ           
PCNTOXDLOABAGM  : NJNFASICCTOUSYA WYTTKFMCAOF     PUKVPSGTYBDCEPO TCDJOD          SGUYOTL        
YHYXRX          : OTAKCUPKFFMH    HDSGAJAASH      PLTHENVJYPHKF   YDNWMAALA      
NRGBTLCVATXN    : ULDYFJ          CRJH            EOCWCAN         IAXCNSWMJBNJKQG IGHTCGBEVBTXG  
ONRAETCEBQBC    : IBRQL           TABCGJBIEKPIED  XSVXVVTC        UAKWWOHHHASUIAX SJGJDVMK       
DASBHIU         : HCJPEDJNJYSC    IPIAYUTCCR      RSQX            IXCORALJN       AJNFMBKUWUSN   
JQBNMDIKSWYH    : DDWBIPEC        AGDLCHIHTEOQN   CQHYLTVHEFLQDVL
CNMGSPWVRYYT    : DQBJGEU         XWDDFO          UHIBR           BXNVB           WFJJWOFKGRJ     OYUVVVOMTYOWAR  LGIBATRVHCPXQER
CCCARLQVCEYMQSL : WRVF            TVCYUAUJ        RVCFEPNYNBAAU  
CCUPQD          : GOGD            OVGGBTDLABUR    XDNQ            ANXWEXHYKHWB   
HCHBBIVTNAVNRK  : QYAUNXOWTG      VPASAIILH       MPHHHFYGDNYJT  
POIPBCKM        : PIDYXOVAE      
MQPE            : BETQYSSHETVBCFC SPSDWNPA        VDGECCAOT       NOOWUNODOL     
UPQWY           : EXBYTU          XUXNBGFNS       FVXRWBQMORFTJCO
XHQTU           : LHOIBCLVQ       VDDLRXSVXYTOK  
SKKFPBVASWC     : UNWSHP          BDXGJX          SGFOLL          IEUXRVO         UNMLGGJBLIBH   
LYPEOVNLLFI     : NUBEO           YACOK           USDUMX         
CJUSFRLA        : MGRLWOPQRF      JWKEGXSCSQASDD 
XHUYDWTC        : IDASYYEINNLGOHW RXVRYNQAST      ILRMJSYBTIMVVD  GNOGRQSTT       OYTGPK         
WPBO            : TEWXQGUDHMB     IFWYOBY         PYXNTNDGGJEQKW  RRWSOFRTHL     
QLIE            : OHUT            OLJRKHOYCURQGQV LFYKC           VTCNUHLRBK     
PNKRYFMGWX      : TAYDPKIMMXUIVP  HGDKNY          JMYHCU         
AVQUXUS         : DHDSLX          MMVLJBQRRWB     CAANTT         
YUPPVGJOR       : OQCYXJCFO       VOFGVPLGCFO     LCSGWEXNY       DINVSUJAF      
TRJJCDKHPQGPAJ  : UYEHXHO         BRLHNTHLEEK     CMEOORJDQLAYSTC CRCECVCS        IECYEKP        
TEMOYEPVVFUD    : IBRQL           FGLUASSQ        DEIVMMKIX      
LWLHOXS         : YGNJDTJWJAVNXFM ATNMVCCEUDLGY  
BFARYJHB        : KABVT           SPUR            RUUSXRNMQDTMSQ 
VUYILBPCWNJT    : YYCEIFXVFCNPR   WFCNHTF         CBQEPKCNLMXLQ  
BIQPRHNLBOS     : TRPWMMLJEDYXXEA BLLOMSVCNESJM   PJUCPEVLTXDYUE 
IRMQTFMOF       : PVDJNUCPG       TNJOXS          VJUVKKHUGHEUJ   OOFSRQKLQE      OFKLEXD         LXBKTMMWMU     
DGNFFBOCUSM     : JQAQIM          YAINAINUNCOVHXA PNYVHKIQMJAQD   COPQUBXWDP      YARHWHPN        LJHRH          
IEUXRVO         : HIONQMAVNUKG    SKKFPBVASWC     COHSPCNIADULI   ARLJRML        
CXFOOYWDQEBTMO  : ROGJCVQEEVKIYX 
TSPVPKI         : XWXCYEKCJSTJV   ILDAB           GUKRHKDHONPB    SSGIAAAVKG      XQTIPFM        
UPASHY          : KVLTRIDJQJWYJE  LOIXBUQG        VJNGEIMJR      
UBGBRWCOAS      : OMTHCWMAR       ACYAKS          MFXKSL         
COHSPCNIADULI   : IEUXRVO         FQAIFNEQLTEM    EUXSMDMXFD      YYMKEOJRBDHPR  
BLLKM           : HADEXMVNLUS     DBDA            JHBXEFNDTYT    
GPCJHYLYCHTE    : LJCGUJKBV       KYWFJLXBSQMRJFO PKSA            IHKKEBVBSMISOX  WHSX            TUITYQNOEJQQP   OYTGPK          GQHQ           
EYQGNYGSTR      : DHGRNU          JAEIBYPEJ       YPJCTTJHN       GMIGFYWYRSF    
MUPYGEUO        : NIQW            SYUFFVGYPD      COPQUBXWDP     
XXBYLCDSYJRD    : ARQFHLYSFQBL    UCBXGJFCMSDSJ  
KLYJTRFOX       : NTWLDAQJ        TEFARVGHBJVXKIA JLAPT           IFAQTCUA       
JNTRT           : GNCOMLWEIL      DKIJNYMUVFTVENK VXJCUTEYSJMH    DKKSWMSNGEDOQD 
GNOGRQSTT       : WRFRRLDW        JJUSM           MTDUGY          JJVJGJMSBAQH    EUCBNKTBU       XHUYDWTC       
SEHXNRJ         : NHIVXKCKMELBKTA QDTGMMLED       ICLJFGCJKD      AJTK            VSQKXD         
BEGJSFCCUVUPM   : XYSNDSHRXUL     NOGNEFHGGTPFY   PCXGKOBU        RGPYF          
FCKWSDRMQ       : JLTBFWJAXV      JDPAAXMK       
SYLGQUUUYEERL   : OPLU            JJOOUOIBUJ      PIGUOMHUXTAHXXY ROQUNJ         
WIGTASWGWHDPMU  : EWJNPSFSH       WWKWWOMTJQB     NEXL            JMYHCU          DDGJOJ          DLAD           
GIXHVH          : SALFWRV         XFDEDEOR        WWKWWOMTJQB     QDTNOQ          DYCSBAEG       
QEWQKDKVLHHTBH  : TRCVQN          CIISRILGHB      QPBRST         
BNMK            : USPVPMGDXACDJS  STSODYHEOE      WHYRCRRPVGNFPV  LCDFVSCCIJR     WVIRLQIK        XPRFERG         CWUBAPJSFYIO   
FXOMGYKNUTPMYNF : GKFPUHOO        LJWJA           FWCOLTKUXGWPY  
QPIFAPYDWQENGPF : DQSVUQU         KWHEAFJKIDJL    YCWOODTM        QHGF            NXSBTLASQWYP    QIQWYNQRBDM    
PVAV            : RDTEVWJI        MKOVWWVXYLSY   
MLSHBFG         : VDDGBXNEFBDQCW  FEFEWDYJJNIGVA  FOMUUCFQ       
MRIFANFROIRIPFO : YMIMSVULAYUEV   VRSJCFDDVVDRFBW MXJSE           WXHLLK          TUITYQNOEJQQP   NPNDOCMTT      
KCUGE           : OTAKCUPKFFMH    FHDHM          
EQEXX           : FRYTTMGXIXJLYB  JESO            GGONYWDGTHYDINY YDGDTLELR      
FGYUBHADWHV     : DQBJGEU        
RNTHSKMFOHNS    : OHGSRTB         MYUIRFP         YTYNEYHETVHQQW 
UKGSKOATNUUWW   : NJNFASICCTOUSYA VCFJCYE         XUREO           XFKEPCUOOY      WSKFM           XYRMDMOYP       JPWEYEYXNBXKDS 
TETHW           : CVGYKOSL        KLIPTUSADTMIMW  NVGXW           NKNGNK          BUQVB          
CEEORJEBA       : RWGVWOKKRLKPEV  SWMMFPYWPRXH    DKMNRTFMXY     
EUJMNW          : TEIRSITXA      
PQQLLPKJJP      : SALFWRV         FRXPYHCLFYLUQYE QTHCNVNJWQ      NFKSIRDYT       IPHGTOWAQQN     EWEGNDEKCC      HHJVN          
RMRVSWKK        : XTMMCHIPE       LNBJM           LIXWF           FUAXEPVSHCQGXK  DHALRJ          SKULHBFJQTNRW  
QOIQSDAHSYJJP   : IMLPWNIRVLQRG  
WDSHP           : NRCL            FAMUTMLLTPF     HWWQITXETH     
YXVLPRHMFRVVI   : AXGAKYKJSCHSMY  TAWICKTSYORCD   OFLFGPELQ      
MDKPLDOWOHYL    : THGKE           UKBFLGTSSKNB    GQBXJOSCTOGJ    VDQGMBIW        KFCILHOQ        EWJOWFIONVYNW   XKILH          
TVCYUAUJ        : ANKH            QHJTOB          CCCARLQVCEYMQSL TLEKYNELWSKY    SFKGKMXXVRMJ    LHLU           
PQFUIDSTKGWWVIA : JAEIBYPEJ       KJXD            ECXFWYETNV     
HPTHDHDYLCUMA   : GBWECS          FQPPIKNFQI      WYVHJNP         QPAXM           FIVO           
FPUMMF          : XWNTTPRQCL      OCUPHXMGXOBKJLI COPQUBXWDP      CUXQKOQIGWYFFU 
FBDNYALJCBRTUBX : KNPAVNAOXDFHP   DBPRRJMOIM      NHBOOL         
EWQJTFJAK       : XNVLQGGWMV      VHKPPDAOUOIIFFP
WWNFPUGUJHUWTAX : LGFWBXJOWMHAW   XTCUSFJYAHCFUQ  YIMPJLIOAGCNVRV FBXTIWEK        EYPIXWROEWVOTX  YGXSQRASFK     
TVORAURSENXPO   : RHAAAIVI        CVWIEAGTFM      YODEK          
QNKESCACXLLUKF  : NMWDJIRH        TDWUKPCGHINQIA  TVCPXFMLPVDT    TXHWRIUHNMVS    EDXXU          
JSPFJJHHDDNRDEI : OHUT            SUQBJBMPXKGPMI  KNJWJBTSMTCJFM  TLQMQMD         GLIGFNNGVLS    
UVBCRDEVBPH     : TABCGJBIEKPIED  CSCNSJMWK       XAVTTLIS        WAULQSUVPBVE   
CNTLI           : PDUIFYVSUE      GUIH            TJXMC          
SSVBCYG         : JPNDFUROLSFUFTO OADH            CTCCUWSBDBF     DQVBFQYN        YGXSQRASFK     
SJVBARABVT      : DFDELBTSOJAK    SMMJROJFIFX     XLHKA           MDQGMTYTITMLCH  ITUTBEMPKJ     
APGRWF          : OROMUBIHO       KFCILHOQ       
MAGVLBQJESL     : OFJRUVFTC       AVWCXKWKYFX     RYXN            CPBHXCS         LCDFVSCCIJR     KNBSYICOORQFGH 
KEWHIW          : WBGUVBYROTQ     FKXE           
KYWEEWTMO       : HAYTYCTJNOCQNM  ILIY            SXFSYOU         KGQGSIKVE       WUKDT           QJVNVYQORW      XWJJJJXADOAGY  
SKGUSCGU        : DWYJSVI         BEYGKJRADN      CRTCXV          QICEGO          KHPEJDPAEAKEK   CERJQI          RRWSOFRTHL     
QYNEMXIJF       : ODFGKEQNCPY     TRYIDWWYQTVNAQ  RKWCXMYIBOO     BQNGO           MYPQDMQUSSJKHAJ
GGDHDHNCDBQWVED : JBUVXGNB        PVIOCMBYHLM     GMDQBXFKCT      IVQFSGP         CAANTT          AISC           
WHYRCRRPVGNFPV  : IXAAWKL         LHOYSPUVQHT     KWRAJS          OHGSRTB         GLGIH           BNMK            FXVCDE         
VEEGKNTM        : BDWYIMOMCULKD   TSPTQVK         EQDWGYGOMXIWBYX
WGOSKTLH        : UTTCBLJLLUCXHM  WDNOUHCAGUOIPNX TSQOW           AKLHNIHGUVWE   
LCDFVSCCIJR     : IYYDWMCV        DFVHDVNG        BNMK            MAGVLBQJESL     DKMNRTFMXY     
JPLNV           : IUIANGABO       MNTKPSNSQD     
CSKVPQKLDEY     : HJDFFJGOHHQGRC  UGDLLRBRXLOY    PKSA            HYPKSMDOBBYOTX  QDYJGRYPLP      FJDV           
FMPISLDUNLEFU   : PDBXNWYTW       ROGJCVQEEVKIYX  UKFWLFJJDLQOO   DROKU           IFWYOBY        
UGETE           : IVQFSGP         EHUDBJNCWTFSXYR IKEOQQXYAKKY    OVGGBTDLABUR    UVFSFJUOYRYKE   EWEGNDEKCC     
MOCE            : OUGBSWWTMQASY   BLJMOG          DVYLRIQXX       KMSQJCU        
OPLU            : SYLGQUUUYEERL   QSBNCGDBOF      UOONGFNEFPBM    YFVNURSVP      
YACOK           : TLQDO           KMLPURJUFOALU   LYPEOVNLLFI    
CNRPBXUVM       : KBLJAECRUPV     KNJWJBTSMTCJFM  JFJFHQPRLFXQOAS ARLJRML         WCYGD           CQMPDNEV       
EQOIYDA         : YVEOELWXGPNFEQV LUUHQNRUGCRX    UCRLCLKUTKSHUDG
HKRAXMPAOTQBT   : IPIAYUTCCR      FVGFTGPXYDJGJPS TTMQYUHPTID     MDQGMTYTITMLCH  MCHCVRAP        QHEIDNMSMEAG    YGXSQRASFK     
OLJRKHOYCURQGQV : GFBSDOCGFVYEX   DMEOOQWYPNSK    SYUFFVGYPD      QLIE            ELSGAMR        
VDSPDQEUQSR     : EJAFLEU         MCJJULWGCLQU   
TLEKYNELWSKY    : YHPPUM          OFNCW           JQYCHD          RMWNTLBTLQDQM   TVCYUAUJ        PXUIGIULIGW     PQSEYDTQGPUJ   
CRWUNFST        : FUAFAXR         RVPVAL          TIJHHPE        
IWOMU           : BHQSVQVFEIO     GMDULXC        
HMSDAWPYKUNIPXJ : BMQOEFOSSVRDYX  AWNYSAJAXTDXFBK STGFTTI        
DCDARITLGCJXR   : QSTVREGQEMUH    LDOO           
GBUYFU          : TKPFLD          UKLFMVJSTS     
WVIRLQIK        : ISIWRSXIOYFVAQ  BNMK            HJMORQSNWVCDR   FRTO           
QPFWPW          : GMFESPWSI       AJPAYPELNBJJGH  RUUSXRNMQDTMSQ 
JJOOUOIBUJ      : WYBX            ECMUVHWIPIHM    KRRFP           SYLGQUUUYEERL   AYJWTY         
VQURQSCIFVSRWK  : PPSSWYUDXA      FKOCUMRPTMQWPS  IOQXEXEWWYBBWIU
EHWBOJM         : LGFWBXJOWMHAW   OPNQKIBPHCM     AKIRUUTFUXTM    AIVRPTCOSSLYI   RQNYOBQLNG      QMHSG           WUIWJFAQHXJ     STDNUSP        
AJTK            : MIMXBXTEPX      YCEJQCJQXH      GTPXO           SEHXNRJ         YTYNEYHETVHQQW  FCDJMFGEJG     
OVKMNFGEYJO     : GTMTGFTJUCWV    QQOIFVR        
FKXE            : HAYTYCTJNOCQNM  KEWHIW          NVIWSRUBFPE     GTSBGWDPG      
FIEELUPB        : TUMOVACYKOWIEAD EAPXDYWHLMUXSEU NMWHHLR        
RKWCXMYIBOO     : QYNEMXIJF       UPLQHMYDI       MFXKSL         
UPRJVWVTBQBLW   : UYFLOIKQHAKQEB  KEBVDTWXBP      EQDWGYGOMXIWBYX NYRQMJNO       
WUXXX           : QMPBPWI         JJVJGJMSBAQH    NRIRNIUHP       TEKYCBVVTRLXLL  TPPMPDUIYSUR    RSNLSLURGJFJ   
JUUHJTRLK       : XRWYEQYMB       KRLGXKCXM      
TFXLQVKNPLGS    : EELX            EWFDIBLCNEAWKAA YFVNURSVP       SJSKTAOFRPSK   
GBVBYUBQGVLPGHH : UEBDI           RAPBFMLCVN      DSUAOBJPKQTAQFW AVPMPW         
RQNYOBQLNG      : WWKWWOMTJQB     EHWBOJM         JDUOPS         
YMYXUATXBQY     : VPKLLRILUEJJH   IUMFJXT         TOEOEUUTJGSFU   IJCHWFFPUNGUKFA QVJRC           HWWQITXETH     
YVEOELWXGPNFEQV : UNSDRVIHGOFWCR  CAOLMFTTVLVXLHC EQOIYDA         QHEIDNMSMEAG   
EEXFRWDOWYNXS   : WMGFPTLBXXXXK  
RRKVJO          : WAQPTBMUI       IIJTL           UOWVMWPVRANLYF 
IOQXEXEWWYBBWIU : CPTJQRREV       WOXKNW          PWUTYDCCOQQNX   VQURQSCIFVSRWK  FNUQBFUM       
LKSNXSIMK       : XFDGHWFXB       XNGDEDD         WRMJI           JCBIMGTQAMOQJ  
XJLOVV          : ADBKWFINLQOTS   TJOR            YIDFEXOTSAKS    CCFVR          
OTKMB           : AHVRFTN         OCDKTRVJJX      IRBM            AJWAE          
JALNYUIUI       : HAYTYCTJNOCQNM  MPVFWADVUMC     LCIBOPMRLVPC    LMJTPML         DLAD           
PXUIGIULIGW     : XUQMRWOUFW      MRFFHCIWWRAWDL  RSQX            TLEKYNELWSKY   
CVFQPSESDP      : GMDGEM          KMUANBORODVK    IBRQL           HUPBGHK         KSIHSJBX        PWUTYDCCOQQNX   UWHDFPF         JRTWYDMDOEUN   
QDTNOQ          : KDNYR           IKGLEVVQUYAPEGL GIXHVH          VDQGMBIW       
JGWHQGPMRAS     : XGMBIYY         RJUWXJYJIGN    
YXMHOFCUAFNVXSR : WYVHJNP         LMQEUNUUKJVGL   EJAFLEU         TQAQGGIXMG     
HJLTRKBJSSX     : BKOHRXYQUUXCDNW CILCDAOSBJSNVG  YWINSGM        
USGVQSDG        : DPPNSXL         NMJIRDYBXH      TRAXIXNPVOHB   
HDBOQYNK        : UBOSISBYCP      SYHD            JGNJWPG        
CTCN            : TKLNCIGPEBXCSMQ NIQW            AKIRUUTFUXTM    YAQHSB          BUXDVPXNE       NAPJEKYKMVPKB  
WASGVL          : VGFIKALY        TSQOW           PHUOJ          
IIYOFQKKYMSEP   : PJBBOVRKSSJSOLU BYLANHKN        CIWWJDW         VJNGEIMJR       IIFJP           YPMQVYWNJSFMNE  UPLQHMYDI      
XQWIKYEMM       : GBWECS          OYYH            KMLPURJUFOALU   UEEFELPSNMGGECS DBUELUVIMIIO    RWFRDH         
JPNRL           : PVVTJIBGLHO     FRTO           
XVMANRSAFRMAX   : NEXL            GQBXJOSCTOGJ    QQFWULPHTWNVGH  GLIGFNNGVLS     YTEISJHHQUERV  
HVVFGGEL        : EBUMGEEFAUP     WCNLAKT         TEIRSITXA       LLXQV           SUEFOO         
TIHLXAYAAUPAKHS : JFHMPODFUUCY    PXRAWDD        
OMAONFY         : LDOO            GKWKRDPVUG      VVYNUJCNDNPA    LFLPTCBE       
BGQKMEG         : UINWARNMBXHG    KEBDIYSSO       AULXRPKWMCQRFKU DDKYWQWMEVDI    VERUBYTVIKURM  
MNTKPSNSQD      : OPAR            FAMBAS          JPLNV           QSBNCGDBOF      WDABT           LIYSN          
BMQOEFOSSVRDYX  : SPSDWNPA        HMSDAWPYKUNIPXJ GTSBGWDPG      
JLAPT           : KLYJTRFOX       OKVXEJF        
GQBXJOSCTOGJ    : BXEIJGHQKR      NJAIDOWMGLXNUDN MDKPLDOWOHYL    XVMANRSAFRMAX   BXNVB           UCUVVMIO       
UNMLGGJBLIBH    : JSDD            SKKFPBVASWC     KFBUSOHLTCAQY   UQTVDEFEOK     
MJKJXSA         : LSOQQADNNETYM   MSKWRPUAKPNQPKM CXGINMECHBGMP   EJAFLEU         SFKGKMXXVRMJ    BKAUREYFA       NFIWI          
TLQMQMD         : OMTHCWMAR       JSPFJJHHDDNRDEI
VKTJXH          : OJMUDJNTSWVWM   LRII            WSONBOKOWJO    
EQVRYWYTMIH     : QTVROLPPRUSN    AUECE          
ICXJVLC         : SQTOUPNU        QYQCYKGGLCYPPUP MGRLWOPQRF      NPYTNPLUKDXS    QHGF            XUODYNOA       
CPQYLCUXCCSIU   : XMXCKYUJQ       NRAUXGIEJHHITEC TUITYQNOEJQQP   GKWKRDPVUG      ACMCOMGSY      
AWNYSAJAXTDXFBK : XHJJTHDDDDVFI   BYLNHVYIP       VHDEMWTRJEQ     EUCBNKTBU       HMSDAWPYKUNIPXJ
OOXGQLI         : GMDULXC         LLXQV           EJAFLEU         VKGATYRJWE      XUODYNOA       
LMQEUNUUKJVGL   : SWYVPDCBXV      YYIQAGM         YXMHOFCUAFNVXSR NABNFHWQYSEOS   PVGDFMQWNL      JRTWYDMDOEUN   
GMDLKIPWQEO     : LLISGP          JHBXEFNDTYT     XHIFJSPMSJA     OKVXEJF        
KFBUSOHLTCAQY   : JLTBFWJAXV      UNMLGGJBLIBH    TWQXC          
CWSOECDHP       : JPNDFUROLSFUFTO XNHIR           VTJDWDW         SJSKTAOFRPSK   
SFNJKEYWJCSEQ   : VLJIOFJNTH      OMCILJGKOOJI   
QMHSG           : ANKH            JMOOTAVTVCV     EHWBOJM        
FIEBYKDCU       : OHUT            SXGU            TGCUUMUPQPRSFC  VKTHWINA        BWIMDI         
SNBGWNMXKV      : AHVNVXXAWN      IRBM            SGFOLL          AGNCDEBYPYEPXV 
FAVISKP         : WWUVXFQH        KKCKJTQVHTHT    FMAQG           LUAYK          
QXTAEUYP        : UPSATUXSRJCF    UWHDFPF        
CKUWXVFW        : YMNKSYWOBW      AVWCXKWKYFX     OVNCLFCJTE     
RVWNXEPVMLHEYXF : HKQQFWXLTKASE   QACHVXE         BGDSUVQRIAY     WMGFPTLBXXXXK   PPFLT           QXGLWO         
AJPAYPELNBJJGH  : DGPW            UGDLLRBRXLOY    WTPW            QPFWPW          UPLQHMYDI       OANIRFFHOS     
XFUNFYFC        : KEHHNVGK        KVXNMJTEDVPRLHG WTJSTA         
QJSQJX          : TEFARVGHBJVXKIA CAFJIIFUGEFX   
KKCKJTQVHTHT    : DFLGBYBYKVQXSV  FAVISKP         CILCDAOSBJSNVG  NHBOOL          OKWDJYGIUXKNG   STEVUJFDRMABSFB PLBHJYW        
QPAXM           : UYEHXHO         VMWWR           HPTHDHDYLCUMA   CYTQXL          CDCDTW          ODFMBBWMNYQ    
ELSGAMR         : UPNVOPHQRIBJ    BBJKNRXWF       OLJRKHOYCURQGQV OJJSFMD         CHLXWBTY       
DBVONGSASNQQWK  : AISC            JDWAAYEGGSKG    OMCILJGKOOJI    JEORSBFF       
QMRIMPU         : MYRLYTGDJRAS    RXVRYNQAST      QXTTGGPBXJ      TCQDGJD        
THVCJ           : MVRINVIL        TJOR            UWSNPTSCHPI     CHYIXMD        
VFNXCE          : OBKGONEPTCLRBP  RNGHOKG        
KAODNFT         : KWRAJS          AWYDFLCGIBKEQK  IFRPFLHMRQARE  
SUEFOO          : FJVPXD          HYLXUIWFPCWKNO  RRWWLTMKKU      GARA            VMKOHTDRAFTW    HVVFGGEL        XDNQ           
GMWDTSFFDENSEPX : BTHVQBQFRN      CBBXWUALY       VGBQRCRMISXVDH  PUODYHBKAG     
CXGINMECHBGMP   : RVAGLBOUGIA     GMDQBXFKCT      AHVNVXXAWN      XGMCIH          MJKJXSA         CGLBKVAIJ      
HWKFC           : OPPITEDETI      PQLWV           XQTIPFM        
AHLGLYYRQY      : LGREXKEUY      
VYQEODIRK       : ACIOLFXTE       XFDGHWFXB       FEYMADUDHQ      TKWUHVC        
AACXJ           : WBGUVBYROTQ     PKGPFEUWXFLVCBH PDAVSDOWRP      UGVYCDUPBARQQ  
IODQPNDVBEWTXWE : UOIGJYQOJPGHC   WJNVFQPCRL      FTDFSRGTGDNYGCB
XUXNBGFNS       : UPQWY           EWFDIBLCNEAWKAA HUSPFUCGIA      XDNQ           
NVGXW           : DHYTXIPORDGAWR  DKHWYMCQMVBJ    LEKWRU          TETHW           LVNVIEGOCJ      KELNICIINV      EBJYKKY         TRBGYYQYEWEYKJ 
OBKGONEPTCLRBP  : MGHNNBPA        KYJMVDAEDCLUE   IUIO            VAYPTHCONM      VFNXCE         
BLLOMSVCNESJM   : BIQPRHNLBOS     FAKBSD         
JFHMPODFUUCY    : JOAIKHVS        TIHLXAYAAUPAKHS XAQJBQ          OVCFU          
TAWICKTSYORCD   : OLFDSL          XSOIYRQGXW      YXVLPRHMFRVVI   ATNMVCCEUDLGY  
UOMNXRWMKNPRJ   : UWTPDOLLVTABQ   FPVIMO          KDIWQXMPVR      KBBSR           YAUFEYTROXMAE  
TIUOLTWPFSKE    : ATCCEMRHC       RWNITLYDFFH     OAYAIMGXAWMOIN 
CILCDAOSBJSNVG  : HJLTRKBJSSX     KKCKJTQVHTHT    XRIQIV          WWGCFJEDQPJW    EJMPSJE        
NRTIDOYQKXGP    : EWJNPSFSH       DDJCULCHTKSWL   CTPLOYSX        ITNEIIWYRA      GTSBGWDPG      
SUBXDMAJP       : TLQDO           UIHKEER         BAOJEPLIEPANFG 
EQDWGYGOMXIWBYX : OUJMGE          VEEGKNTM        UPRJVWVTBQBLW  
KXACRTYS        : UUMH            JWOBGFAS       
FIVO            : FCFGS           HPTHDHDYLCUMA  
NUQQSYPYOFYY    : OUGBSWWTMQASY   CQWRQYHUANGOR   EQPBIGRQ       
BBFU            : TGCTGYHFX       WXTIMKEGJEBUY   EQQFFENXB       HQLRGO         
DXPUTPQNUYJLW   : HCJPEDJNJYSC    XNLY            CIYDJBRHQBU     YJPRTEB         OESYUCE        
GPQB            : KBLJAECRUPV     LJMBR           LRPKJEV         IXBUEBJNJ       XNEJQOW        
JCFQEFUHGC      : PTWOPFCR       
VGALDVD         : VNGQXCIOJ       KCPS           
JASVLRVUHMXYXDE : OYYH            YQGGYBDNIQO     JIEWKPJCIQRX   
HJMORQSNWVCDR   : EWJNPSFSH       LRAHJD          HUPBGHK         PVMAADPOUDMKHOR WVIRLQIK        JQMFSIW        
YCGSXTMVQ       : EBJG            HTHMQRGSKYRSU   NDERANLRP       OOUTUJ          EIMVMCGMRO     
KRVJUAACMOSE    : BFBKEBCYAM      EMDDYUKTKUNS    CIEQTOJHIFM    
LUFHYICEIEMDEJ  : NXCTLFRYSJBFTPW GMDULXC         JQMFSIW         XYRMDMOYP      
CCMMTKVOLYSANL  : WBYXSCBLYXM     OOUPUXFMSSVB    RKTDGSQVK       FDJSR          
VABCJAKLHURVX   : AXNGIWUNDY      HVXWXESBRU      GYKAPWHL        TGGFKRPKTTVUM   HDEWALFKML     
FQAIFNEQLTEM    : IMIUWLB         COHSPCNIADULI   LCOY            XWJJJJXADOAGY  
EBBKYDMBMOO     : AUECE           CAHODSRM        KGTB            OMCILJGKOOJI    ACMCOMGSY      
VJUUKTADVKIJP   : SNBCSRFEVYUJEEB DKIJNYMUVFTVENK HAUCGF         
XLHKA           : MKKOROUY        UIMKXNYYXA      SJVBARABVT      PUODYHBKAG     
NDYN            : WAAKVXEQBETBN  
NQVCFYB         : WJNVFQPCRL      GGONYWDGTHYDINY
TVCPXFMLPVDT    : XOFJH           QNKESCACXLLUKF  NPNDOCMTT       LRII            VWPQHPBB       
OBHOPWSOMBC     : OQCYXJCFO       DIKTPYW         DAJCEJJNYMRJQVM
WGJXJBSHFIG     : MIOQCQILCUOI    WMUBOYMLNGH     DQVBFQYN       
UTDTWYPLAY      : DXIDBQII        AHVNVXXAWN      HEJPS           EYPIXWROEWVOTX 
PYWELY          : NYKFGURWUKX     LAQME           GKFPUHOO       
PXRAWDD         : QHJTOB          TIHLXAYAAUPAKHS QRNFLTUVTT      USOFTSIQ       
LLATAXNFR       : HQNYYEQHF       UVJRDREBVROWRO  MMVLJBQRRWB     DVYLRIQXX       PACCA          
EJAFLEU         : MVDSLBQIYX      VDSPDQEUQSR     YXMHOFCUAFNVXSR MJKJXSA         OOXGQLI        
CCVDMMDGOCK     : ROGJCVQEEVKIYX  IPHGTOWAQQN     ELGLIUWKBKR     GMIGFYWYRSF    
TXHWRIUHNMVS    : DWYJSVI         QNKESCACXLLUKF 
VXJCUTEYSJMH    : QLDLXXALSDY     BHQSVQVFEIO     UDCKUWQTCKRON   IIYJI           JNTRT           MCHCVRAP        ITHUW          
UXRFRMD         : QNGAJEBCHKNDMXM YPUK            HADEXMVNLUS     RXVRYNQAST      JDFPU           MAYDYNKU       
JWKEGXSCSQASDD  : CJUSFRLA        SMIVSIOQPIN     ONOW           
YJPRTEB         : KICDVSPFW       KLMRVEJIAFGURJN RKWXCXCAKA      DXPUTPQNUYJLW   KVFJBSNPTRM    
AYBHRPLTYK      : SLUJ            WRMJI           MPQXETYS        QKFUOO          KGTB           
FTGAXAT         : JBWXUEDJMR      FRIQA           IFRPFLHMRQARE   NFKSIRDYT       QIKQBRRYL      
UWELXPCQL       : XWXCYEKCJSTJV   EAGDA           RUVVDSFMEMPUO  
TUITYQNOEJQQP   : BRRVAJXWRPYUTNE PPWPF           GPCJHYLYCHTE    MRIFANFROIRIPFO CPQYLCUXCCSIU   VKGATYRJWE     
KVYJXSKTPOHPEJ  : HMYWOID         BUGRNMNGJL     
SUDNDW          : FETTSOJIAENTDPS UHIBR           UKUJPDWHF       RSEWRPPO       
VKGATYRJWE      : TVLYFBA         OOXGQLI         TUITYQNOEJQQP   CPIVPPUP       
VNGQXCIOJ       : VGALDVD         CIBPEXUNGVVLB   RUUSXRNMQDTMSQ  XXDEX          
VVFOQI          : RHEEUTECOUMUEL  PXBVGYGOSMHWP  
VHVSRCUNB       : KYJMVDAEDCLUE   OPEP           
YARHWHPN        : HVXWXESBRU      DGNFFBOCUSM     YDIJJKCRVFKW    QLTRVPY        
TWYDVUBDLTOS    : MKDHIGTELT      IROY            CYTQXL          VWPQHPBB        KVWGROG        
VOLQSGET        : KWHJNJNBYR      DBCUAXKIK       ROQUNJ         
ETNN            : HHRVVVHHGN      KJOIBTP         JFQCF           LMJTPML        
WDJFYI          : WSUOKOCBQF      QXYTOSIDNK      QYAUNXOWTG      KQBXQEO         IVARVOVD        MXBJDUWS       
EECGJQCAJUYX    : XMXCKYUJQ       DHGRNU          GPKDOOKOVBX     YSKGRUNORXHNGI  DEIVMMKIX      
PQNVM           : FJVPXD          AKIRUUTFUXTM    YHCSJOYRW      
CIBPEXUNGVVLB   : XWXCYEKCJSTJV   VNGQXCIOJ       TESPECUEVEFAN   FJJRNAIHJLYWLX  PHBVLDJKK       ARQFHLYSFQBL   
PJNGLORHNPPFIFD : TAYDPKIMMXUIVP  RDFV           
QGIRXMQVCWRAKU  : ADBKWFINLQOTS   RQHB           
CERJQI          : SKGUSCGU        XSVXVVTC        KBBSR          
AXTPDEVJEMPM    : KJXD            JHAQYDDE       
PBXNFWIFJDL     : PNMTDEMLEJTTJV 
IFWYOBY         : QYSCI           WPBO            FMPISLDUNLEFU   PVPM            RPKSWWVIJJCDO   UMPFWV          IQDBAPH         UIOQRUUYATSK   
WQSBOCHCT       : SVQJJDVYNXHC    XRLOJCAWPHPAM   UDFGBDWDPDA    
LJWJA           : LVEDSRFCMJVHIY  RDTEVWJI        JTHJUMIILARS    LAAPHDVDBBXHD   DIAODJGLEQTQUEO FXOMGYKNUTPMYNF TKPFLD         
IIJTL           : YPUK            PNYVHKIQMJAQD   RRKVJO          GQHQ           
FTDFSRGTGDNYGCB : NFVXRFVMGHQJKB  IODQPNDVBEWTXWE IQDBAPH        
GUKRHKDHONPB    : TSPVPKI         MBOSTU          VJGMXSWKAJAULDY
BXNVB           : UQIWOYMYLUJBI   CNMGSPWVRYYT    GQBXJOSCTOGJ   
QSBNCGDBOF      : IVPOOOAWR       XREGX           OPLU            MNTKPSNSQD     
FMAQG           : CXNULO          LJJGBRXYEK      FAVISKP         YGXSQRASFK     
DKQRXGSGKRVIUQ  : UOWYEDDVX       WYBMVPVXP       FQYXWWAB        UWSNPTSCHPI     WSUOKOCBQF      UTLBKRS        
QROS            : XRLOJCAWPHPAM   ORGWDRWKCIH     GIIHQJRBJRNP    DDCYDWPHXEXXF  
RTMXYSMALSJQ    : CEWGEQ          LEKWRU          EPQAYMQV       
DKGJEMVXKESBG   : TRAVBGM         FALHNMHPHAXFN   ARQFHLYSFQBL   
SUESPY          : PKSA            NRGMY           XSBRWX          IQDBAPH         BWIMDI         
PACCA           : MKOVWWVXYLSY    KMRXQUCI        FCFGS           LLATAXNFR       JTHGAC         
WMGFPTLBXXXXK   : QLIT            XGMCIH          SUVJJCGWHEQYVW  EEXFRWDOWYNXS   RVWNXEPVMLHEYXF
SLIFGGLYVKIL    : TAIJNPBSRPRAH   XCHIKRGKCGNM    HMQHTL          BRVDBKR         RSNLSLURGJFJ   
NPNDOCMTT       : OADH            MRIFANFROIRIPFO TVCPXFMLPVDT    AFMKSTAPDSLVV  
FVGFTGPXYDJGJPS : DUXOWESCNMXFPSH GNLAHEYPLRHT    HKRAXMPAOTQBT   KMSQJCU         NFIWI           UGVYCDUPBARQQ   CBQEPKCNLMXLQ  
NFTBSHQJM       : OGBQYVPU        LXBKTMMWMU      VIJHDEX         YBQDUYNJDXSBJPH
LYCGHJCP        : AMKNEQLSWPKOU   TJOR            AVWCXKWKYFX    
XVJXXNHEYY      : KGLREQ          WKBTNBGWYQWSM   OANIRFFHOS     
KODEPV          : LRQOFE          UIMKXNYYXA      TCQDGJD         RJNEH           AEODCJ         
IFAQTCUA        : FQYXWWAB        FGMIBNDXWEPWSCF KLYJTRFOX       VAKSIBIJI       BKQJDAXLJTO    
GECAEXKCVAMDYN  : DYTHQGWIHR      LHRNRIKYPFIKJF  AEQKMXQGLL      VDQGMBIW        PYXNTNDGGJEQKW  DRAWKTVEMFLLOPQ
JDFPU           : UXRFRMD         QQOIFVR         QIQWYNQRBDM    
DGLG            : NBWFCBNARULJQF  WTPW            YHCSJOYRW       PCXGKOBU       
FITHVCNXDRYNWW  : CBHDYRIPSNSWTWN KNJDTXOQM       SLYMGWSLRND     TQJEXHEDBXAVP  
LCOY            : VEWGP           VMWWR           FQAIFNEQLTEM   
BEKQCOWIDDH     : RWGVWOKKRLKPEV  EUXSMDMXFD      TLMAQJFALHRWB  
NDSLFGKIBLXXKN  : KMKGDTG         SEMVYMUDSBAJ    AJNFMBKUWUSN   
NFKSIRDYT       : QSTVREGQEMUH    AYPV            AXMVYGIKYAID    OLGPRYL         PQQLLPKJJP      FTGAXAT         VCDFGRG        
XEXDLIQOB       : EXBYTU          XMQPMAPOHD     
TKPFLD          : YXHWLEPXS       GBUYFU          LJWJA          
LNTW            : NHIVXKCKMELBKTA KFCILHOQ       
YJVJ            : SVQJJDVYNXHC    TGXURNBULMH     PLTHENVJYPHKF   NOOWUNODOL      QWBKPKQJMHW    
CIWWJDW         : UWJVVNH         LTPSAGJF        IIYOFQKKYMSEP   UMPFWV         
QHGF            : XHIFJSPMSJA     QPIFAPYDWQENGPF ICXJVLC        
LCVDHJGMUVGTAH  : DRNFLIV         VPKLLRILUEJJH   VDGECCAOT       SNIWPPDGLU     
XQHACGYNMVADEIL : AWEPDF          KHTMSGIGCPFIUV  RYQIBXDUKFFPIHC
TNNYWYF         : HYPKSMDOBBYOTX  FGMIBNDXWEPWSCF XLBOYCSHABNFXI  TRYIDWWYQTVNAQ  GIIHQJRBJRNP   
TESPECUEVEFAN   : UNWSHP          STSODYHEOE      CIBPEXUNGVVLB  
NABNFHWQYSEOS   : MIPMBSX         KDSCONYEGXGFF   AUIOMYEA        LMQEUNUUKJVGL   GLSSBMMXXSM     TPOVJGKMX      
NAPJEKYKMVPKB   : UEBDI           GNOWJLRUSQ      DFTQVAVTOPDO    SHHIYOCDIGIFD   CTCN            HQRBV          
KQBXQEO         : NYKFGURWUKX     EIWMJTRNNKCR    MTKNR           OQCYXJCFO       WDJFYI         
LLNMGTBBAQCPA   : XREGX           RMBYMLATVYWV    ROLEVXP         XATYC          
CYTQXL          : QPAXM           TWYDVUBDLTOS    CBBXWUALY       TYOXUU         
YIMPJLIOAGCNVRV : KIEYDW          RKWXCXCAKA      WWNFPUGUJHUWTAX
UXQMCI          : TQQI            ADBKWFINLQOTS   LHSVWJADLIVKYNI QYAUNXOWTG      VHTUUWGFJEI     UIOQRUUYATSK   
KKOEBMRDLAS     : DUXOWESCNMXFPSH JESO            TNJPKCIRVOWN   
KGNBITFX        : MKKOROUY        SFAGN           OHGSRTB         HFQOFUPIADGY   
WTJSTA          : XFUNFYFC        IJCHWFFPUNGUKFA NRMOUFGOQNFLG  
VKTHWINA        : OFJRUVFTC       FIEBYKDCU       CHYIXMD         XAVTTLIS        ROQUNJ         
GGIGYNSFBVP     : HWHCADGDFIRXC   KMUANBORODVK    PEPGX           SFAGN           VQWIESRAY       DLAD           
CNMB            : ULDYFJ          HVXWXESBRU      UKFWLFJJDLQOO   GVBUONC         JLIQLFHSO       UQTVDEFEOK      PJQBADKLA      
XVEADCKXJ       : QGKHOLIFMCL     VEWGP          
IAJGGPQOOFKVIG  : EEMJGDSD        MWRQNQSKMOIOOO  BRTNIOIT        UGVYCDUPBARQQ  
EKBSOLQKRQ      : KWHEAFJKIDJL    DOYFK           SVVV            AEODCJ         
VDQGMBIW        : HLPXWCDTBSRKU   WOCMFJPRBHQ     MDKPLDOWOHYL    QDTNOQ          GECAEXKCVAMDYN  VTKFTRTVOUI     WAULQSUVPBVE   
QMYFEGRAOBOVN   : QWQVMXK         USPVPMGDXACDJS  QGTCYGP         YXLGHBQIXEU     MQWP           
QCDKPWDGTHY     : QAWQ            AYJWTY         
VAKSIBIJI       : EDDQBUFM        OOFSRQKLQE      ISIWRSXIOYFVAQ  AISC            IFAQTCUA        IIFJP          
RBMGCDEPTVUYI   : KADCFJTVQCS     REQJGKRHRKAVG   UWFOCDOSAKLN    TIJHHPE        
WLSSUTU         : WQRHMUEHFUJNEU  FIPS           
TFMEIUPQJ       : DEHVEVVXCUXSDSY YRKOX           VDGECCAOT       YAUFEYTROXMAE  
TWQXC           : QXKFCVI         KFBUSOHLTCAQY  
OXULXDXWRSPMMM  : GODKHTHJVSVDHF  AARCPLWJ        QYQCYKGGLCYPPUP XFAOVSPQD       APATYQIXWNJKVIM
ITTNCQFUBN      : JXVEVDXARFVHE   VKXSHLHOAVQYJD  YLKJHAFHAHENUWM XHIFJSPMSJA     EDXXU          
AGNCDEBYPYEPXV  : UVXPXOGXYHKBIDI EMYVMBTBLMF     EUCBNKTBU       SNBGWNMXKV     
PJUCPEVLTXDYUE  : PNMTDEMLEJTTJV  UTTCBLJLLUCXHM  GMFESPWSI       GFWBU           BIQPRHNLBOS    
KEUBIYHJAAK     : ADBKWFINLQOTS   MSKWRPUAKPNQPKM HGQAQNUPEWC    
PIDYXOVAE       : POIPBCKM        VWOUSOFLJHC     VABNG          
XSVXVVTC        : AWLYXQUFDYFXP   ONRAETCEBQBC    CERJQI          DVKD           
GIIHQJRBJRNP    : WBGUVBYROTQ     QROS            TNNYWYF         KXAQQASDROE    
WUIWJFAQHXJ     : RWGVWOKKRLKPEV  IVQFSGP         EHWBOJM        
YHCSJOYRW       : NSICXUGR        PQNVM           DGLG            HIUY            VTCNUHLRBK     
KGBLRSCKCBHLXRS : HQNYYEQHF       GUVDDNLJL       RJNEH          
KCBTIADMUM      : HBFGKLXGYSROW   KSDYS           CPBHXCS         YUTEUJBQVOE    
TGBFQK          : OWMORGJUIWGV    RSATLIVP        SMMJROJFIFX     XSBRWX          FFGPMHVG        OEPGOGAR       
FEBHQEKYRIS     : OCUPHXMGXOBKJLI XNHIR           XGMCIH          RAPBFMLCVN      HCKWIUM        
LDOO            : TGEOJEQBSWWDG   EMYVMBTBLMF     EIUUKFMI        DCDARITLGCJXR   OMAONFY         NFJAXWIYB       HCKWIUM        
AOCM            : XMXCKYUJQ       HVXWXESBRU      QBGUBKDKSMDDEOD LEHWQTYIQHS     CWUBAPJSFYIO   
QQFWULPHTWNVGH  : XCOCQIJSBE      FQBQTK          QXRPMH          XVMANRSAFRMAX   QUDRCNO        
QGTCYGP         : FCTNXXYUKBGWK   WBKUDLPYW       QMYFEGRAOBOVN   OVEPJUWNQROMHX  HKUHTWHDSUY    
WEBW            : XADHNNUJO       HTHMQRGSKYRSU   BXQQWRKAYHOWBSG
FKGV            : CPTJQRREV       IHCCSMTXK       YKQVUFJWMLWN   
LUAYK           : OCAFRNNFNSMA    YAQHSB          FAVISKP         DDCYDWPHXEXXF   BFFWRWWAVPSNR   XNNERMYV       
VKATSHVMNROOXGS : RKRSMKJNSLVBVD  RYQIBXDUKFFPIHC
KVUFBF          : QTHCNVNJWQ     
WKBTNBGWYQWSM   : MLDKJIMNVCOQ    EAGDA           WUKDT           XVJXXNHEYY     
OYTGPK          : CBHDYRIPSNSWTWN XHUYDWTC        GPCJHYLYCHTE    IECYEKP        
VDDGBXNEFBDQCW  : KHBRLOOBXNR     MLSHBFG        
FEFEWDYJJNIGVA  : HCJPEDJNJYSC    UHIBR           XUREO           MLSHBFG         PTHQQQHAOG     
CVWIEAGTFM      : HRGVWXDGDFV     NJAIDOWMGLXNUDN TVORAURSENXPO   LSXHANXNAF     
KFCILHOQ        : JTHJUMIILARS    MDKPLDOWOHYL    APGRWF          LNTW            CMAHXPMURJGEYJ 
LVNVIEGOCJ      : UJHHGEBBDL      YCEJQCJQXH      NVGXW           PNWBOTLCPRRA    NKNGNK         
FFGPMHVG        : RSATLIVP        TGBFQK          JXYKXDQTGREFQG 
KEBPGJDPAUGMS   : DQBJGEU         IPVKMEGWJRAMLO  PTWOPFCR        CQMPDNEV       
KBBSR           : CYILNQI         OYTLPWUUCGH     AAOUYAJTEWBUTRR ITIDL           UOMNXRWMKNPRJ   CERJQI          KYVOGGKIMPLGBB  EYPIXWROEWVOTX 
CCKIICW         : WTHIGRKXKRKS    KWRAJS          BJNFBXJMJCG     AJWAE           PLVEQKSONJ     
YDIJJKCRVFKW    : UBOSISBYCP      YARHWHPN        HQLRGO          HNIJJCQO       
QJVNVYQORW      : RWNITLYDFFH     GBBLVCCTFPV     KYWEEWTMO       SNKRFVYF        WPWRMY         
VJCEMY          : OFYMVPQWUKMKPAE AUECE           TXBNIXPIWLUMU  
LEHWQTYIQHS     : GBUHSKCMW       GHLHCOASJTI     AOCM           
JMYHCU          : PNKRYFMGWX      WIGTASWGWHDPMU  REQJGKRHRKAVG   IECYEKP        
TLBQDYCHDOGE    : XIIYBOGD        VYEILLMIXTYRM   CBBXWUALY       MWPMADUBTFX    
NMCGIDOY        : GVBUONC         FGGKGDKGBHAM    LFLPTCBE       
KOWYPGBMPUY     : HLPXWCDTBSRKU   LNSQSTDOOAWYT  
NCRSMVHUCMIQO   : HVFCMHAR        IIBUUCWAIEOOHXH ATNMVCCEUDLGY  
ATGBFSQ         : ECMUVHWIPIHM    YQXXHSFKUHYTOI  LSKDHHXRPN     
TIKUVBSUTIYMB   : SQTOUPNU        GJUJQYHEEOXE    DUXOWESCNMXFPSH CEWGEQ          VJNGEIMJR       SJGJDVMK       
KLHM            : YCEJQCJQXH      CSCNSJMWK       SLLVJUFQWTJC   
REQJGKRHRKAVG   : RBMGCDEPTVUYI   JMYHCU          OEAO           
HBFKVCEFB       : FXXGTU          JCBIMGTQAMOQJ  
IPFTYSTQYMAFX   : KHPEJDPAEAKEK   SDJOYBB        
OPEP            : XWXCYEKCJSTJV   AUIOMYEA        VHVSRCUNB      
KYVOGGKIMPLGBB  : DXIDBQII        ELGW            KBBSR           FBXTIWEK       
UCGRTH          : EMQSI           DFDVNAERF       AWEPDF          GQTSHYAYQTP     QYAUNXOWTG      MFXKSL         
TOEOEUUTJGSFU   : BGITEY          YMYXUATXBQY     YVNMDXGPY       IEMT            TATMBYVSREHLS  
NFJAXWIYB       : XNVLQGGWMV      CRGJLDGYYGLJI   LDOO           
VDFP            : ROGJCVQEEVKIYX 
NWTCBKGVFCFLUM  : KOKHADGVIOCTADT TQJEXHEDBXAVP  
XAQJBQ          : AWLYXQUFDYFXP   JMOOTAVTVCV     IXWOBLHDDN      JFHMPODFUUCY   
LRII            : EOCWCAN         RKWXCXCAKA      VKTJXH          TVCPXFMLPVDT   
NOGNEFHGGTPFY   : KCVQWWNUFBACO   BEGJSFCCUVUPM   DVKD           
KNPAVNAOXDFHP   : FBDNYALJCBRTUBX SFKGKMXXVRMJ   
PAPFQXSWDCEJV   : YPUK            LICX            NUPJIKJTXMG    
OVNCLFCJTE      : EWJNPSFSH       AXNGIWUNDY      NEKTHEWWB       NRCL            KPDR            CKUWXVFW        JYHFBPALUAFNO   EYPDAIHWHUI    
TIGBAGSCXXVV    : KABVT           SEMVYMUDSBAJ    RBDKIFJJBR     
SYTWISUAQLCCQG  : RAPOTCHGPGGV    NUPWS           WFCNHTF         YIDFEXOTSAKS    QYLIQOKQWWYUYWJ
MKMGUTJ         : NMJIRDYBXH      YQSKJUWUIELTYL  QTHCNVNJWQ      PXWAOBTBXQY     IWKUHBVFDWLOU  
CCAAD           : AMULOAJOA       PKSA           
VWOUSOFLJHC     : FYIMTCLQNJ      YYCEIFXVFCNPR   XSOQWCXHYLEC    PIDYXOVAE       MROAHHNYUROC   
JEORSBFF        : LGFWBXJOWMHAW   LHRNRIKYPFIKJF  KKYEXGUUNGYTS   DBVONGSASNQQWK  FGGKGDKGBHAM   
AYVXDYXDEVBBK   : BSHBMHSATA      DUXOWESCNMXFPSH GSJUEWCBKRYF    MPQXETYS        RHEEUTECOUMUEL  THWHU          
VYEILLMIXTYRM   : UGXDOLOHCI      NFUNMXUVKGTSFO  IBRQL           TLBQDYCHDOGE    QVOLRRHXNXP    
WRNA            : TNJPKCIRVOWN   
JXYKXDQTGREFQG  : FFGPMHVG        AGLQHA          IIFJP          
YTYNEYHETVHQQW  : QNGT            RNTHSKMFOHNS    AJTK            ESYSKKOYXCYEJ  
KGQLTQQKKXFRD   : NEPKTCUOE       FVSXA           YHLLIFKPBUGBMYP
AQWTRKXRUELQLEH : YAUFEYTROXMAE   QWBKPKQJMHW    
XTRQGNIW        : AIVRPTCOSSLYI   DWJDIUKHGI      HIUY            UFOIXUL        
UWFOCDOSAKLN    : NIQW            RBMGCDEPTVUYI   WDAAJOPVITIIYJE LNIXAEUSBFX    
FIPS            : TDWUKPCGHINQIA  CDXOHHVG        ROLEVXP         WLSSUTU         CSCNSJMWK      
EWJOWFIONVYNW   : JXVEVDXARFVHE   WBOOMTOMIW      DGRRVJXXTOPKPS  RPAMFOGIOM      MDKPLDOWOHYL    SMHIXGOKHA     
KELNICIINV      : OCDKTRVJJX      UDCKUWQTCKRON   KEIW            NVGXW           YYPUYNCP        WSONBOKOWJO    
BBGQTI          : TAEHG           QCMVCBJWILE     XFAOVSPQD      
TTMQYUHPTID     : WHFLCXOFPFHWQF  JRCNFMNPR       HKRAXMPAOTQBT  
FNUQBFUM        : PNKWPKO         MGHNNBPA        IOQXEXEWWYBBWIU
IIMJ            : NSICXUGR        MHMDVNDLSLH     DUXOWESCNMXFPSH LSXHANXNAF     
VDGECCAOT       : EBUMGEEFAUP     MQPE            LCVDHJGMUVGTAH  TFMEIUPQJ       WTVXSDWYT      
MDQGMTYTITMLCH  : UNSDRVIHGOFWCR  SJVBARABVT      HKRAXMPAOTQBT  
SSJHCVDHCJKFJB  : PBSGBFXT       
LNEEVSYUMJRB    : WOXKNW          KKBRMO          HIXLSFJJKOK     KMRXQUCI        RRIH            MUHR           
TJXMC           : OJMUDJNTSWVWM   BVBLMPB         YVAYNBSCPPSRPFF CNTLI           ATVWSIRKHOS     FELQVMTGMHX    
TGDAQHL         : KJIMEFCLD       LWCQ            AEIHTBKAEQHD   
OVEPJUWNQROMHX  : WAMIYQOEAGAP    QGTCYGP         FCBVX           HQRBV          
IVARVOVD        : JQAQIM          WDJFYI          RKRSMKJNSLVBVD  WSKFM           OYUVVVOMTYOWAR 
DIKTPYW         : KMUANBORODVK    QPYLDXBKMGJE    NEPKTCUOE       OBHOPWSOMBC     SNIWPPDGLU      TPIEATL        
WDWGXTVRONGV    : WEYAOR          HIXLSFJJKOK     WRCJAKNEDJ      GELBKICYCPXCDF 
MEJOYFDU        : GBUHSKCMW       CEWGEQ          AGLQHA          QBRHY          
NXSBTLASQWYP    : QPIFAPYDWQENGPF DFEFEONFGJRAJMN ATNMVCCEUDLGY  
YMDQBQWWDLDOACU : HUVBSBJ         EYOHNYGCUHQIJDE KMLPURJUFOALU   CBBXWUALY      
XHTXBWUO        : LHSVWJADLIVKYNI MVRBFIV         QOCMIH          LRPKJEV         CHLXWBTY       
PFVOWBOJE       : YPUK            XGMCIH          MPPGBPXK        EWTJ           
KVFJBSNPTRM     : MMVLJBQRRWB     YJPRTEB        
RUUSXRNMQDTMSQ  : OPAR            QTVROLPPRUSN    XSBRWX          BFARYJHB        QPFWPW          VNGQXCIOJ      
JDUOPS          : GMDQBXFKCT      VMKOHTDRAFTW    EIBOPUE         RQNYOBQLNG     
ATPPLLJYM       : JAEIBYPEJ       TGEOJEQBSWWDG   SYHD            WRMJI           JJVJGJMSBAQH    KTIRMSXJEXBGEBB
VIUVC           : LWPEISPR       
ITNEIIWYRA      : AXNGIWUNDY      NRTIDOYQKXGP   
JQMFSIW         : HUVBSBJ         HJMORQSNWVCDR   LUFHYICEIEMDEJ  FALHNMHPHAXFN   EJMPSJE        
TKTU            : PFUHRWF         MBTT            LCSGWEXNY      
VSISOKDYGTFP    : IXWOBLHDDN     
DOYFK           : FRYTTMGXIXJLYB  EBLJEXXGUR      EKBSOLQKRQ     
VWPQHPBB        : WBKUDLPYW       TVCPXFMLPVDT    TWYDVUBDLTOS    PCXGKOBU       
VYATRINJVSKE    : ODFMBBWMNYQ    
QTTTKSYWBXVS    : RVPVAL          BTHVQBQFRN      KIDEJ           PGHMFNGUJQXPBVF
DISH            : LGUSSTPY        TJOR            FJJRNAIHJLYWLX 
OGLIAW          : OWGONIICY       MQDIOVYBOKDSQR 
LSRWWGNTA       : FKDUD           USOFTSIQ       
GSKEVKAPAGASNNJ : UORSIU          SETWNAPX       
ATVWSIRKHOS     : ARLBCONTMAA     XRCLUIGCVLSULSR TJXMC          
KTIRMSXJEXBGEBB : EAGDA           GOAIFJBJHWHC    FUAXEPVSHCQGXK  ATPPLLJYM       HQSCRLXISRM     ARQFHLYSFQBL   
PMPRGMOYWI      : AFTGTGLGCHRYVO  KDIWQXMPVR      WCIBFQJNXMR     RAYRTRH        
EWFDIBLCNEAWKAA : LJCGUJKBV       TFXLQVKNPLGS    XUXNBGFNS      
HCVBTIRLRGCSDKF : QWQVMXK         MKJCB           HEHNXNW         PVFAWLEK        TSCXDAIVPL      GSWIJSSG       
JMMT            : VLGVVOCLLC      LMJTPML         EWEGNDEKCC     
XXDEX           : VNGQXCIOJ       UIOQRUUYATSK   
RBDKIFJJBR      : LNSQSTDOOAWYT   BHSFGP          TIGBAGSCXXVV   
OJJSFMD         : FYIMTCLQNJ      EGEIHPSWISVNX   OADH            FEYUY           AWYDFLCGIBKEQK  ELSGAMR         YSNLOHWHRRM    
XPYKLOKKRRKUJLY : WCNLAKT         RFNVRLN         FEYMADUDHQ      DTITITE        
VGFIKALY        : VUJTTMFORHDOF   EVMYKDEDUU      QGDTCMT         NKGPWJQEUG      WASGVL          ACMCOMGSY      
VSQKXD          : VCFJCYE         PQHYAM          PFROGMXJQUQD    RAPBFMLCVN      SEHXNRJ        
NEVCUJMPDWMMLN  : KABVT           BNBMDGELXFUBEE  HKIUCPJDLJQROB  BYLANHKN        UNSEXGMXSXDPR   TDWUKPCGHINQIA  XPRFERG        
HUSPFUCGIA      : GODKHTHJVSVDHF  NUPWS           XUXNBGFNS       BCDDKFOCGEFTO  
CMAHXPMURJGEYJ  : TQQI            GKMVHGSHRHVAD   KFCILHOQ       
MXNAKWWDN       : CDXOHHVG       
ARLJRML         : IEUXRVO         CNRPBXUVM       WAAKVXEQBETBN  
MSFDHCURI       : WXMPNJOVJ       GOMWQYM         GUVDDNLJL       DHALRJ          UMWRM           HCKWIUM        
STGFTTI         : QJNIMHJXXID     KNJDTXOQM       AWYDFLCGIBKEQK  HMSDAWPYKUNIPXJ
SFKGKMXXVRMJ    : SQTOUPNU        UWJVVNH         TVCYUAUJ        MJKJXSA         KNPAVNAOXDFHP  
AFEFOGCIQECKKH  : RQNMKNKAHMFKPXY UCUVVMIO       
GPKAXWIKK       : CTPLOYSX        LNNXVFCIYQCH    UMWRM          
IIBUUCWAIEOOHXH : PVMAADPOUDMKHOR NCRSMVHUCMIQO   YLAUQQQJGDMM   
CTYJAHCN        : UOIGJYQOJPGHC   BCVKXMBULXVJAC  VMRDBTD         QJGFD           MQGG            QIQWYNQRBDM    
CMSMWCWI        : XTCUSFJYAHCFUQ 
RDKRD           : JPNDFUROLSFUFTO SEHWFULFODKDXRD HACPLVGM        RMWNTLBTLQDQM   WFBGDIVMJDIWRB  YAQHSB         
VTKFTRTVOUI     : VIBQPXXJ        WAMIYQOEAGAP    DFVHDVNG        VDQGMBIW        TRBGYYQYEWEYKJ  KERHEUUGAP     
CMEOORJDQLAYSTC : OPPITEDETI      DDJCULCHTKSWL   TRJJCDKHPQGPAJ  IGHQM          
LFYKC           : NHIVXKCKMELBKTA BTHVQBQFRN      QLIE            IOPUCYVLUGARY   YNYGAMYUO      
PVDJUR          : NEXL            PRUQB           JYHFBPALUAFNO  
FJJRNAIHJLYWLX  : HTHMQRGSKYRSU   NUPWS           EMMXELWMT       XPWXWD          LSKDHHXRPN      CIBPEXUNGVVLB   DISH            JYHFBPALUAFNO  
FBXTIWEK        : JLTBFWJAXV      DVJALEYTSRMOS   XFAOVSPQD       BKBVRBKBFMFD    WWNFPUGUJHUWTAX KYVOGGKIMPLGBB 
VJNGEIMJR       : AXMVYGIKYAID    BTPGUVVW        SNBCSRFEVYUJEEB UPASHY          IIYOFQKKYMSEP   TIKUVBSUTIYMB   BRTNIOIT       
DHALRJ          : RMRVSWKK        MSFDHCURI      
QIKQBRRYL       : FTGAXAT         RRWSOFRTHL     
VRNGOYT         : MWBAKJSQBXH     GLJXMJHKA      
FELQVMTGMHX     : SFNNOCXJMWC     TJXMC           PVFAWLEK       
GQHQ            : IDASYYEINNLGOHW TRPWMMLJEDYXXEA GPCJHYLYCHTE    IIJTL          
IJCHWFFPUNGUKFA : XAURMGYCGPAXK   VFMETWKCIPDEQ   ENCPBGNOB       YMYXUATXBQY     WTJSTA         
QRNFLTUVTT      : PKCHAUCKHQVX    PXRAWDD         CCHPWKKJU       WDUOQJGOQHECSTE
MBTT            : CDVFUTQGKX      CIYDJBRHQBU     YLKJHAFHAHENUWM HWKVUWXDLSS     TKTU            RGPYF          
FXVCDE          : HAYTYCTJNOCQNM  ADBKWFINLQOTS   RRLPABHTGPVEJLK DHOPRQVQBC      WHYRCRRPVGNFPV 
YRATCFVRYNH     : TKLNCIGPEBXCSMQ VQNLXXIYJM      FEDPF           SABKEVAF        YDGDTLELR      
CBBXWUALY       : DBPRTX          WOCMFJPRBHQ     GMWDTSFFDENSEPX CYTQXL          TLBQDYCHDOGE    YMDQBQWWDLDOACU
HLBG            : FVNWRASWKY      OQCYXJCFO       UNSEXGMXSXDPR   KQOPNKL        
EJNXKGB         : MTYQW           OYTLPWUUCGH     RTDIKCEXTPUGU   RHEEUTECOUMUEL 
KIDEJ           : GUIH            QTTTKSYWBXVS    IUNKD           JPWEYEYXNBXKDS 
LQSMRS          : JLTBFWJAXV     
PTWOPFCR        : ULDYFJ          JCFQEFUHGC      KEBPGJDPAUGMS  
LXWAXIIYOSKR    : JQRLWKUHOUR     HMEOXYFATGMAD  
TLJKG           : KJXXO           TXBNIXPIWLUMU   PFFMDPFSHBYKS   BKQJDAXLJTO    
FAMUTMLLTPF     : REMHSQQDGUU     GQTSHYAYQTP     WDSHP          
DFEFEONFGJRAJMN : LWVX            QWKJSO          NXSBTLASQWYP   
YUTEUJBQVOE     : UQIWOYMYLUJBI   OPVYATXMVQ      KCBTIADMUM      XKILH           YRMGCFPJM      
GKWKRDPVUG      : MHMDVNDLSLH     OMAONFY         CPQYLCUXCCSIU   BWFCV          
BRVDBKR         : MSNADTNFHID     OLSMNKSERY      FKCSF           AISC            JMIDOAFGDLSQPQF SLIFGGLYVKIL   
KMSQJCU         : VKYYOTFPLR      MOCE            FVGFTGPXYDJGJPS QHEIDNMSMEAG   
XLGPSQ          : QKON            OROMUBIHO       OWJJSVQHFT      WUKDT          
DLRUJODNPU      : CYILNQI         GAJAXBQLSIDQBT  JVEIIIIXAUR     XDNQ           
VVYNUJCNDNPA    : TGCTGYHFX       LWVX            UKBFLGTSSKNB    OMAONFY        
PLTHENVJYPHKF   : WRVF            YHYXRX          YJVJ           
YWINSGM         : OIPTTBVU        WOXKNW          BPEB            HJLTRKBJSSX     PHBVLDJKK      
BYMOEAE         : EBJG            NTGI           
PVPM            : IFWYOBY         KXAQQASDROE    
WCYGD           : VUJTTMFORHDOF   DHYTXIPORDGAWR  DVNKPXUR        WYTTKFMCAOF     JXAVMKYDMHM     CNRPBXUVM      
PNWBOTLCPRRA    : PVDJNUCPG       RXQDKFJTF       LVNVIEGOCJ     
SNIWPPDGLU      : CTPLOYSX        SOHGCYPV        PUKVPSGTYBDCEPO LCVDHJGMUVGTAH  DIKTPYW         ISTGDUPGPDLQ   
PRUQB           : IVPOOOAWR       EQQFFENXB       HEJPS           PVDJUR         
IQNFTDCF        : IUMFJXT         CCFVR           UAKWWOHHHASUIAX CPIVPPUP        NYRQMJNO       
RAYRTRH         : DBPRTX          UBHAPOCGLUFJSD  LEMI            UHWQGSLKHIFQNUC PMPRGMOYWI      PNQMLKBSWWN    
QXTTGGPBXJ      : DHGRNU          YLRO            QYMMONCNXEBPR   QMRIMPU        
OKVXEJF         : ROLEVXP         JLIQLFHSO       JLAPT           GMDLKIPWQEO     DTITITE        
OHGWYG          : SAUFYL          ETORJIMECVFBQB 
TCQDGJD         : UISDFIPCCFRMI   USPVPMGDXACDJS  QMRIMPU         KODEPV         
GLJXMJHKA       : YHCTPVQKXB      VRNGOYT         KCPS           
IXBUEBJNJ       : DMOGVFSSGE      OLFDSL          OVGGBTDLABUR    GPQB           
PPFLT           : XHIFJSPMSJA     RVWNXEPVMLHEYXF YGXSQRASFK     
OBHUGNGRLV      : MGHNNBPA        MXVVNQVXM       ANEFLGISMA     
VGBQRCRMISXVDH  : UUMH            TBPOKFHABG      NMWOOVMYEMBT    GMWDTSFFDENSEPX TPQKU          
UMWRM           : MSFDHCURI       GPKAXWIKK       UVFSFJUOYRYKE   PUODYHBKAG      YLFMLIXIFBHT   
UTLBKRS         : UNSEXGMXSXDPR   ABBRYJOSBLHQWQ  DKQRXGSGKRVIUQ  PSURMXQNBV     
PTTYWKQY        : ACYAKS          MSEWCC          CPIVPPUP        IECYEKP        
FHAFGFMR        : DXIDBQII        GNLAHEYPLRHT    LTDRIDT         HAUCGF          OBOEWELEKCMWO  
BRTNIOIT        : QDTGMMLED       GAJAXBQLSIDQBT  IAJGGPQOOFKVIG  VJNGEIMJR       XRIQIV         
UNISE           : WCDKS           LXBKTMMWMU      XXMK           
NFCXVDFBNFGTK   : QTHCNVNJWQ      WQLUEA         
NMWHHLR         : QAWQ            XCHIKRGKCGNM    MPPGBPXK        FIEELUPB       
VLOSCYLIEYN     : JRCDI           WJJDUTEWEK      YVWIRLDYTJD    
AJNFMBKUWUSN    : CAHODSRM        JVVPCKGTG       DASBHIU         NDSLFGKIBLXXKN  MLWRNOIUBHWR    YBWRAB          TQJEXHEDBXAVP  
QUQENPCBEWFDINJ : YIMPLXWQSQQLC   HLJLHXRLVGSFELQ
BTIMINB         : PFUHRWF         XAURMGYCGPAXK   QKNCDB          VHKPPDAOUOIIFFP QQOIFVR        
AYJWTY          : JJOOUOIBUJ      QCDKPWDGTHY     VSRYPBFAYPJFAH  CKCRGTTVFV      NYRQMJNO       
MVASLPUNVRS     : JHMXNX         
DJLLMFTCNJF     : FXBIG           PVMAADPOUDMKHOR EPHPSWBJFB     
JGLGBMONIOHU    : QHMPL          
EKAYDCC         : LGUSSTPY        WEYAOR          ROGJCVQEEVKIYX  QHMPL           SEMVYMUDSBAJ    XFDGHWFXB       DVYLRIQXX       HVFCMHAR       
EKAYDCC         : XLBHDUKLLDBCMXT
NPCSLGJUL       : HMQHTL          PBSGBFXT        NSIWB          
GSYMTLD         : PNVHFPKMSOLNF   FIGXFKSNVLNFW   MKDHIGTELT      GEKXLNHBVRKAIB 
TSQOW           : SQTOUPNU        WGOSKTLH        WASGVL          RKRSMKJNSLVBVD  AEWJJGJBGIDVJXW
YAUFEYTROXMAE   : DGPW            PNYVHKIQMJAQD   AIVRPTCOSSLYI   UOMNXRWMKNPRJ   TFMEIUPQJ       AQWTRKXRUELQLEH
WQJDLIRF        : FRYTTMGXIXJLYB  BRRVAJXWRPYUTNE JIFBJXYR        IEVSGMTJQXNPEJ  ROLEVXP         CHLXWBTY       
UOONGFNEFPBM    : OPLU            SMIVSIOQPIN     SSSRJXY        
AGLQHA          : DDWBIPEC        KOKHADGVIOCTADT JXYKXDQTGREFQG  MEJOYFDU        CPIVPPUP       
LWPEISPR        : QLDLXXALSDY     XTCUSFJYAHCFUQ  GKFPUHOO        VIUVC           XATYC          
WLHMAVUILYNBAA  : UWJVVNH         ACMCOMGSY       USOFTSIQ       
CIISRILGHB      : WCNLAKT         OFNCW           SFAGN           RQXQTSTGTF      QEWQKDKVLHHTBH 
QVDIIAVPOYLJHY  : IIENSO          CCOTM           XNEJQOW        
UAKWWOHHHASUIAX : VRBUOD          ONRAETCEBQBC    IQNFTDCF        RVCFEPNYNBAAU  
STXDCBA         : VJUVKKHUGHEUJ   YIMPLXWQSQQLC   IUIHHDFDUGTMH   HGDKNY          MXGWTWD         TEIRSITXA      
PBGAIIKFIX      : YPJJUYJMCGBFHG  BKRNXENHWWCAU   BWFCV           OOIJUOAQLUFNURL IQDBAPH        
IMLPWNIRVLQRG   : QOIQSDAHSYJJP   RFGWEQNOKORXHY  OBOEWELEKCMWO  
RKRSMKJNSLVBVD  : OTAKCUPKFFMH    EGXSA           XLBHDUKLLDBCMXT VKATSHVMNROOXGS IVARVOVD        TSQOW           YBQDUYNJDXSBJPH
THWHU           : VARLLG          REMHSQQDGUU     CYRLDKTDVW      NSMMHNCROTCABK  AYVXDYXDEVBBK   LUUHQNRUGCRX    QBEGYTOYIOO    
ELXXJJQBREVCVOQ : VWHBQMWQXGFDWJO QNGT            CGLBKVAIJ      
AGDLCHIHTEOQN   : CRQGF           UTTCBLJLLUCXHM  WJJDUTEWEK      UHPIEVRO        PPSSWYUDXA      JQBNMDIKSWYH   
FTVDUF          : FVNWRASWKY      RTFEBOYS        TUVA           
LJHRH           : MPQXETYS        DGNFFBOCUSM    
PVFAWLEK        : FTKJBJUPUMKNX   HCVBTIRLRGCSDKF FELQVMTGMHX    
LSXHANXNAF      : HQOBOPLPK       CVWIEAGTFM      IIMJ           
XLFFCSQLLX      : OFYMVPQWUKMKPAE YAINAINUNCOVHXA TYOXUU         
BWFCV           : PVIOCMBYHLM     VWECIIGBIGKC    GKWKRDPVUG      PBGAIIKFIX     
IGHTCGBEVBTXG   : TGCTGYHFX       XIIYBOGD        NRGBTLCVATXN   
VTJDWDW         : JRCDI           NKGPWJQEUG      QYSCI           CWSOECDHP      
QWITTNV         : PVVTJIBGLHO     LICX            UDCKUWQTCKRON   AIVRPTCOSSLYI  
FEYMADUDHQ      : LRAHJD          AMKNEQLSWPKOU   RTDIKCEXTPUGU   YHQKCYEXKXUEIV  BRLHNTHLEEK     VYQEODIRK       XPYKLOKKRRKUJLY
BQNGO           : RXQDKFJTF       MIOQCQILCUOI    TFRBU           FKDUD           QYNEMXIJF       WDUOQJGOQHECSTE
RSEWRPPO        : BJNFBXJMJCG     CAANTT          SUDNDW         
KJOIBTP         : ETNN           
IPHGTOWAQQN     : UBHAPOCGLUFJSD  PVDJNUCPG       PQQLLPKJJP      CCVDMMDGOCK     UKLFMVJSTS     
FVSXA           : KGQLTQQKKXFRD   YLAUQQQJGDMM    ISTGDUPGPDLQ   
RRIH            : JHMXNX          HRGVWXDGDFV     LNEEVSYUMJRB   
UQHE            : JXVEVDXARFVHE   VAYPTHCONM      TUFAEJXIGLUVLPP VDDLRXSVXYTOK   WDUOQJGOQHECSTE WSONBOKOWJO     WFVMENWBA      
BTYLLGR         : CRQGF           WGVSLI          QXYTOSIDNK      GELBKICYCPXCDF 
XRIQIV          : RMWNTLBTLQDQM   PTVFCJFMCAFHDL  CILCDAOSBJSNVG  BRTNIOIT        IGQRAXG        
NRMOUFGOQNFLG   : XUQMRWOUFW      QXYTOSIDNK      RTFEBOYS        KMRXQUCI        WTJSTA          KCPS           
RDPNEEA         : IHCCSMTXK       WHSGAIQRN      
VHKPPDAOUOIIFFP : YACQQWSXDKFLIJQ RWGVWOKKRLKPEV  EWQJTFJAK       BTIMINB        
UGECUMP         : ILIY            TLQDO           DDGJOJ          WOTSGWPNW      
PHBVLDJKK       : SFSIFANAJEKS    KEHHNVGK        CIBPEXUNGVVLB   YWINSGM         KVJKCVAXRWH    
CDCDTW          : STIKTG          MUHEQ           QPAXM          
CHYIXMD         : EYMVVKFGL       SXFSYOU         GFBSDOCGFVYEX   CAANTT          JDPAAXMK        THVCJ           VKTHWINA       
QFBGW           : HDIKLIEDCMH     NJAIDOWMGLXNUDN
VHTUUWGFJEI     : XWNQI           UXQMCI          PXVMVCPUNBVKBX  VGKYGC         
GLIGFNNGVLS     : ORGGIEKE        JSPFJJHHDDNRDEI XVMANRSAFRMAX   SSSRJXY         FCDJMFGEJG      EAIOREWIXNR    
SMIVSIOQPIN     : SQFPDSEFJR      SETWNAPX        JWKEGXSCSQASDD  UOONGFNEFPBM    VTRYGUTLOGEDXRN
HTSTYDKHOVNV    : CBPDELSLSDQCQE  LTPSAGJF        WUKDT           IOPUCYVLUGARY  
CCHPWKKJU       : SUAAPOJU        AXGAKYKJSCHSMY  QRNFLTUVTT      BABLDRBW       
EDXXU           : KIUJ            EMMXELWMT       FRIQA           DIAODJGLEQTQUEO QNKESCACXLLUKF  ITTNCQFUBN      FXMOG          
LISIBMJEA       : NTWLDAQJ        SGUYOTL        
UVFSFJUOYRYKE   : FETTSOJIAENTDPS KRLGXKCXM       SUVJJCGWHEQYVW  UGETE           UMWRM           JTHGAC         
TKATI           : MSEWCC          DTPPSHUD        DBCUAXKIK       CQDLRJ          XGFEYA          TQUXXJCRMDX    
DWFWFILOOLH     : QOCMIH         
HMEOXYFATGMAD   : GODKHTHJVSVDHF  LXWAXIIYOSKR   
KDCVCGSIF       : SSKO            SAUFYL          VPASAIILH      
QQOIFVR         : NHIVXKCKMELBKTA MKKOROUY        FRXPYHCLFYLUQYE OVKMNFGEYJO     JDFPU           BTIMINB         ACMCOMGSY      
LYEJXJJ         : LSOQQADNNETYM   ODFMBBWMNYQ     RRWSOFRTHL     
SVVV            : FFVKHUOKOL      KCVQWWNUFBACO   EKBSOLQKRQ     
JYHFBPALUAFNO   : DDRLFE          NSMMHNCROTCABK  OVNCLFCJTE      PVDJUR          FJJRNAIHJLYWLX  DAJCEJJNYMRJQVM VJGMXSWKAJAULDY
SMHIXGOKHA      : FFVKHUOKOL      HYUSE           FAMBAS          EWJOWFIONVYNW   QBEGYTOYIOO    
DSUAOBJPKQTAQFW : EEFLHB          GBVBYUBQGVLPGHH YTEISJHHQUERV  
MLHAGVIOWQF     : OFJRUVFTC       GGVTPI          KDSCONYEGXGFF   UHWQGSLKHIFQNUC EUCBNKTBU      
XGFEYA          : IHCCSMTXK       EQOMFVSX        TKATI          
OEPGOGAR        : UDCKUWQTCKRON   TGBFQK          QPBRST         
IOPUCYVLUGARY   : UPNVOPHQRIBJ    LFYKC           HTSTYDKHOVNV    BABLDRBW       
BAOJEPLIEPANFG  : EWFJGMCGC       SUBXDMAJP       PGHMFNGUJQXPBVF
YFVNURSVP       : VQNLXXIYJM      OIUIBYFCVIRA    OPLU            TFXLQVKNPLGS    XPRFERG         IGRLOBCIDAOSFW 
QXGLWO          : RVWNXEPVMLHEYXF SXAL           
WDABT           : LURNFOHOYNGJO   BNEIXVN         MNTKPSNSQD     
LAELP           : FGMIBNDXWEPWSCF JMRYEDQOBDMFLV  WQRHMUEHFUJNEU  XHIFJSPMSJA     EWFJPH         
TEKYCBVVTRLXLL  : EEFLHB          QXKFCVI         WUXXX           CQHYLTVHEFLQDVL
WJVNIBQ         : AFTGTGLGCHRYVO  OPPITEDETI     
WDAAJOPVITIIYJE : XHTBJ           XWDDFO          UWFOCDOSAKLN   
DWJDIUKHGI      : XTRQGNIW        YRMGCFPJM      
RJNEH           : WVJYKGKYOQSG    MKLKG           KODEPV          KGBLRSCKCBHLXRS
EJDSYBEVJM      : DHGRNU          FKCSF           BETQYSSHETVBCFC FAMBAS         
VSRYPBFAYPJFAH  : HTVVYKEJ        AYJWTY         
JWDSQKCVFEYJ    : NPYTNPLUKDXS    TUVA            AMGSAWPCXLL    
KVWGROG         : TWYDVUBDLTOS    MPHHHFYGDNYJT  
SNKRFVYF        : HXOP            KKBRMO          XPIFVY          DUXOWESCNMXFPSH QJVNVYQORW     
YODEK           : MQBOQXVJVDVAW   TVORAURSENXPO   BKROLPJYF      
OMTUQSGSDFP     : OHUT            PJBBOVRKSSJSOLU BTPGUVVW        AULXRPKWMCQRFKU
WHSGAIQRN       : RDPNEEA         WWGCFJEDQPJW   
SSSRJXY         : PVIOCMBYHLM     KJXD            MGKNRDJAF       UOONGFNEFPBM    GLIGFNNGVLS    
TNJPKCIRVOWN    : YOMJHMREYN      CQDLRJ          KKOEBMRDLAS     WRNA            YKAHWEKVVLHMO  
TUVA            : TDAQPNKEHDY     FTVDUF          JWDSQKCVFEYJ    OKWDJYGIUXKNG   NSIWB          
ETORJIMECVFBQB  : QBGUBKDKSMDDEOD BDNETY          WHUYCIYTIS      OHGWYG          KERHEUUGAP     
CRCECVCS        : TTDIPF          SLUJ            LCIBOPMRLVPC    TRJJCDKHPQGPAJ 
QVOLRRHXNXP     : JVDEGU          FGMIBNDXWEPWSCF FMXR            VYEILLMIXTYRM   WOTSGWPNW      
GEFJBKMTMEVGJAI : EJMPSJE         CQMPDNEV       
FCBVX           : DDSHDP          KVYEBFJOMNILY   REYWYKNQEFYHQWO OVEPJUWNQROMHX 
HSJQQYPJ        : TSKDXXVN       
XNEJQOW         : JLTBFWJAXV      NFLRLNG         XNGDEDD         ELFTCFJKTNE     GPQB            QVDIIAVPOYLJHY 
DDGJOJ          : YQXXHSFKUHYTOI  YUHRNFSNSGNQFN  RDFV            WIGTASWGWHDPMU  UGECUMP         QJALHU         
UOWVMWPVRANLYF  : CBPDELSLSDQCQE  ILIY            RRKVJO          MTBOXTHCCNVU   
XFKEPCUOOY      : LYQVUYK         UKGSKOATNUUWW   ACMCOMGSY       PCMKFW         
VIJHDEX         : MXNKYPJLHGTL    NFTBSHQJM      
CKCRGTTVFV      : AYJWTY          OANIRFFHOS     
CVJPABRU        : VRUEK           NLEENDIN       
GTLEFUNKBN      : EEFLHB          QATRWDFSSOB     WTPW            VISPXBVUS       ATQDBVETNXF     EPHPSWBJFB     
DXRXHNRFVP      : MKKOROUY        RKWXCXCAKA      YVNMDXGPY      
ALWPLAJHRSDDWKY : OOUPUXFMSSVB    SSGIAAAVKG     
VABNG           : RMMWEORLDCERKM  AXGAKYKJSCHSMY  PIDYXOVAE      
FGLUASSQ        : OTAKCUPKFFMH    GFJKTRCLTKGX    TEMOYEPVVFUD    PQDQGTMOSL     
TCDJOD          : UUNQ            UHPIEVRO        PCNTOXDLOABAGM  HISGHBASHYOSFYK
XUODYNOA        : ICXJVLC         OOXGQLI         PJQBADKLA      
MCDAK           : WOFNDYPLTBIN    MIPMBSX        
HQSCRLXISRM     : UBHAPOCGLUFJSD  AKDBDQFWQX      THGKE           KTIRMSXJEXBGEBB
DDCYDWPHXEXXF   : QROS            LUAYK           VQWIESRAY      
DKMNRTFMXY      : CEEORJEBA       LCDFVSCCIJR    
VJTPVRTATUDRL   : YNXWPRUNDKLIB  
RPKSWWVIJJCDO   : BPEB            TRPWMMLJEDYXXEA BUVARDPP        IFWYOBY         KNBSYICOORQFGH  YHYNORKRGDK     QWBKPKQJMHW    
EPQAYMQV        : JRCDI           MGMDBS          UUNHXABYBVGCIP  KJXD            YDIMLG          RTMXYSMALSJQ   
MXBJDUWS        : WDJFYI          GGONYWDGTHYDINY
ODFMBBWMNYQ     : AMULOAJOA       TGEOJEQBSWWDG   KEBVDTWXBP      QPAXM           VYATRINJVSKE    LYEJXJJ         YDGDTLELR      
QWUJW           : OWMORGJUIWGV    SUQBJBMPXKGPMI  LCIBOPMRLVPC    IVQYUVAYR       NRIRNIUHP       EAIOREWIXNR     GTSBGWDPG       MAYDYNKU       
XPRFERG         : XNLY            GOUFYVBRKVVTB   BNMK            NEVCUJMPDWMMLN  YFVNURSVP       PCMKFW         
XDNQ            : WCDKS           IXAAWKL         SLUJ            CCUPQD          SUEFOO          XUXNBGFNS       DLRUJODNPU      FUFO           
FVXRWBQMORFTJCO : SROW            TEFARVGHBJVXKIA GMDQBXFKCT      UPQWY          
BKVRF           : SROW            MKLKG           RFGWEQNOKORXHY  SDJOYBB        
XYJQWMFNCKMAE   : OPAR            EOKWNDLOSRNLFH 
EUXSMDMXFD      : DRNFLIV         QTHCNVNJWQ      COHSPCNIADULI   BEKQCOWIDDH     CAFJIIFUGEFX   
HQRBV           : IVPOOOAWR       UWJVVNH         NAPJEKYKMVPKB   OVEPJUWNQROMHX 
BUESUQXKSKW     : EAGDA          
QJALHU          : FYIMTCLQNJ      QLQEHEUPCO      BDBWWAYULSK     TRAVBGM         UKBFLGTSSKNB    DDGJOJ         
LIYSN           : RQSCDNSQBB      GNOWJLRUSQ      XRSPUULNBCMSSJ  MNTKPSNSQD     
AEODCJ          : RKTDGSQVK       YUHRNFSNSGNQFN  KODEPV          EKBSOLQKRQ     
ANXWEXHYKHWB    : JVDEGU          YYKEMMRFQF      WFBGDIVMJDIWRB  CCUPQD          RJUWXJYJIGN    
YOAUON          : DBDA            ANEFLGISMA     
PHUOJ           : VPKLLRILUEJJH   WASGVL          ISTGDUPGPDLQ   
DNGOUGCSFISNKF  : IEVSGMTJQXNPEJ  KNTQLIAUCNLCAU 
JGNJWPG         : UYFLOIKQHAKQEB  QXRPMH          HDBOQYNK        FDJSR          
ELGLIUWKBKR     : CCVDMMDGOCK     IBJKVLVEWDFQBH 
HAUCGF          : KRRFP           VJUUKTADVKIJP   FHAFGFMR        JWOBGFAS        HWWQITXETH      DLAD           
VPASAIILH       : JFJFHQPRLFXQOAS HCHBBIVTNAVNRK  KDCVCGSIF       AEIHTBKAEQHD   
RVCFEPNYNBAAU   : ILDAB           TLQDO           WFBGDIVMJDIWRB  EQQFFENXB       TYKOMIVXVPVERA  CCCARLQVCEYMQSL UAKWWOHHHASUIAX MROAHHNYUROC   
IUNKD           : OUNYWMNK        KIDEJ           VTCNUHLRBK     
IBJKVLVEWDFQBH  : VJUVKKHUGHEUJ   HACPLVGM        RQHB            ELGLIUWKBKR     BDPJCBMLVJV    
FALHNMHPHAXFN   : XGONCXWXSLFVY   DKGJEMVXKESBG   JQMFSIW         UQTVDEFEOK     
KHTMSGIGCPFIUV  : HWLTWJKICRSHM   YQGGYBDNIQO     XLBHDUKLLDBCMXT XQHACGYNMVADEIL
ETTEHBTWIKGLK   : SUVJJCGWHEQYVW  WFJJWOFKGRJ    
YVWIRLDYTJD     : TRAXIXNPVOHB    VLOSCYLIEYN     DQVBFQYN       
QNEMALITP       : SQSGE           VSOKSTWV        QGJLXGILUJNJD   JWOBGFAS        JAXHUMVAVAQ     MCJJULWGCLQU   
UMPFWV          : KFPEVIAVIT      IFWYOBY         CIWWJDW        
HISGHBASHYOSFYK : UOWYEDDVX       DFLGBYBYKVQXSV  TCDJOD         
FYWQIQJBNVQ     : XYSNDSHRXUL     DWYJSVI         EJWYJVONUDCROEK
UMME            : MUHEQ          
HKGLLBS         : DDSHDP          UDMUDHWEUBC    
QLTRVPY         : QAWQ            RQHB            GMDQBXFKCT      WCHEK           YARHWHPN       
MQGG            : OPNQKIBPHCM     JMIDOAFGDLSQPQF CTYJAHCN        NFIWI           ONOW           
JVXA            : MSKWRPUAKPNQPKM DYXUKRH        
SOHYOQKUCXW     : QHMPL           SMMJROJFIFX    
MPHHHFYGDNYJT   : GYGCTHTRBHXMCH  INLRENBWNKP     EUCBNKTBU       HCHBBIVTNAVNRK  KVWGROG        
USDUMX          : LYPEOVNLLFI    
TXBNIXPIWLUMU   : NOJUOWU         VJCEMY          TLJKG           HKUHTWHDSUY     LWCQ           
VCDFGRG         : XIIYBOGD        GYSGMICBSDM     TELBQYK         NFKSIRDYT      
NKNGNK          : QKON            PVIOCMBYHLM     DTPPSHUD        BTPGUVVW        TETHW           LVNVIEGOCJ     
MWPMADUBTFX     : BGDSUVQRIAY     UOWYEDDVX       TLBQDYCHDOGE    NVIWSRUBFPE     LHLU           
ANEFLGISMA      : DVWRGU          SQSGE           MQBOQXVJVDVAW   OBHUGNGRLV      YOAUON          YBQGMCBWR      
FOMUUCFQ        : NYKFGURWUKX     MTKNR           DKHWYMCQMVBJ    TEKFTRSD        MLSHBFG        
FHDHM           : UEBDI           GBWECS          KCUGE           PQSEYDTQGPUJ    WUGBYJKYVXA    
IIFJP           : SLYMGWSLRND     DVNKPXUR        IIYOFQKKYMSEP   VAKSIBIJI       JXYKXDQTGREFQG 
YVNMDXGPY       : LGREXKEUY       AWMRGRNIRIUWDG  TOEOEUUTJGSFU   DXRXHNRFVP      USOFTSIQ       
WPWRMY          : AFTGTGLGCHRYVO  NTGI            QJVNVYQORW     
ESFNXM          : JQAQIM          JRCNFMNPR       VMKOHTDRAFTW    YADISR         
YXLGHBQIXEU     : YLRO            JMDBOQRJVHMNG   QMYFEGRAOBOVN   EYPDAIHWHUI     BTCGHR         
DBUELUVIMIIO    : XQWIKYEMM       STEVUJFDRMABSFB
DTCBJFCHQ       : NFVXRFVMGHQJKB  PFFMDPFSHBYKS  
QTCYT           : CXLPDOIOB       OOUPUXFMSSVB    FODBHSSISGWCFXM
TYOXUU          : TBPOKFHABG      KSRUU           CYTQXL          XLFFCSQLLX     
PQSEYDTQGPUJ    : HDIKLIEDCMH     TXWCJCABHRGQOY  OJMUDJNTSWVWM   GNXFNAYCMKIUNW  TLEKYNELWSKY    FHDHM           EKIVBBMHDU     
AMGSAWPCXLL     : FJVPXD          HQOBOPLPK       JWDSQKCVFEYJ    LHLU           
LCSGWEXNY       : AWEPDF          HWPJ            YUPPVGJOR       TKTU           
PCXGKOBU        : IMIUWLB         AVWCXKWKYFX     BEGJSFCCUVUPM   DGLG            VWPQHPBB       
EJWYJVONUDCROEK : SFAPAETCKAFT    CYKLP           GNXFNAYCMKIUNW  FYWQIQJBNVQ    
CQWRQYHUANGOR   : EBLJEXXGUR      RAPBFMLCVN      NUQQSYPYOFYY   
EVMBUX          : JSDD            YKAHWEKVVLHMO  
MLWRNOIUBHWR    : JJVJGJMSBAQH    AJNFMBKUWUSN   
QIFY            : YISHAEG         GELBKICYCPXCDF 
FOMVIPBEEEC     : ORGGIEKE        HQLRGO         
EQPBIGRQ        : RVPVAL          FMRG            NUQQSYPYOFYY    FQFJVKYBBWL    
SXAL            : VJUVKKHUGHEUJ   UDFGBDWDPDA     QXGLWO         
QVJRC           : JXEJQASABEVCOG  XNVLQGGWMV      IIYJI           YMYXUATXBQY     RKTTFXJYHWXT   
HQLRGO          : ULASSYCKOT      HTVVYKEJ        BBFU            YDIJJKCRVFKW    FOMVIPBEEEC     KVJKCVAXRWH     QPBRST         
MTBOXTHCCNVU    : UQIWOYMYLUJBI   OJMUDJNTSWVWM   VRSJCFDDVVDRFBW PQLWV           UOWVMWPVRANLYF 
PUODYHBKAG      : GMWDTSFFDENSEPX XLHKA           UMWRM           XXOVXPK        
JWOBGFAS        : IROY            KXACRTYS        HAUCGF          QNEMALITP      
BKAUREYFA       : XRCLUIGCVLSULSR XSOQWCXHYLEC    MJKJXSA         SLLVJUFQWTJC   
TPQKU           : FQELCNFJ        YMFF            TFRBU           VGBQRCRMISXVDH  PSURMXQNBV     
RWFRDH          : RQSCDNSQBB      XTMMCHIPE       RHEEUTECOUMUEL  JCPLE           XQWIKYEMM       YBQGMCBWR      
CXFI            : DVJALEYTSRMOS   KJXD            PRBN           
FCDJMFGEJG      : VRUEK           FTKJBJUPUMKNX   GLGIH           AJTK            GLIGFNNGVLS     QWBKPKQJMHW    
MCHCVRAP        : KYWFJLXBSQMRJFO BTHVQBQFRN      HKRAXMPAOTQBT   VXJCUTEYSJMH   
WWGCFJEDQPJW    : CILCDAOSBJSNVG  WHSGAIQRN       MBOSTU          YADISR         
PIGUOMHUXTAHXXY : IDASYYEINNLGOHW YJBPNR          DFVHDVNG        SYLGQUUUYEERL  
PMWNSYSDGX      : LYQVUYK        
VISPXBVUS       : UVJRDREBVROWRO  YDIMLG          GTLEFUNKBN     
CPIVPPUP        : HIONQMAVNUKG    GJUJQYHEEOXE    TEIRSITXA       VKGATYRJWE      IQNFTDCF        PTTYWKQY        AGLQHA          OBLQNJRTASYWVO 
SGDQTWROCXMXVU  : IUIO            MYMP           
LUUHQNRUGCRX    : JIFBJXYR        EQOIYDA         THWHU           QYLIQOKQWWYUYWJ YRMGCFPJM      
OOIJUOAQLUFNURL : QPYLDXBKMGJE    SWVYFVXWAKG     EOCWCAN         PBGAIIKFIX      ECXFWYETNV     
PFFMDPFSHBYKS   : NOGOEDMWXMA     DVJALEYTSRMOS   NFLRLNG         TLJKG           DTCBJFCHQ      
EJMPSJE         : AARCPLWJ        CILCDAOSBJSNVG  JQMFSIW         GEFJBKMTMEVGJAI
ARQFHLYSFQBL    : VAGBJYFSACL     GFBSDOCGFVYEX   LWVX            XXBYLCDSYJRD    CIBPEXUNGVVLB   DKGJEMVXKESBG   KTIRMSXJEXBGEBB UCWTXOK        
EBJYKKY         : AXUKMDLETIQI    EXBYTU          HGDKNY          NVGXW          
FWCOLTKUXGWPY   : NFPFBO          GMFESPWSI       FXOMGYKNUTPMYNF
WMDR            : HIONQMAVNUKG   
WUGBYJKYVXA     : TQQI            FHDHM          
DYXUKRH         : DFTQVAVTOPDO    JVXA            RNGHOKG        
RNGHOKG         : NTWLDAQJ        YDBQ            WCIBFQJNXMR     VFNXCE          DYXUKRH        
PXVMVCPUNBVKBX  : ELGW            VHTUUWGFJEI     AFMKSTAPDSLVV  
GWEDJXKQPAYW    : WFCNHTF         AXGAKYKJSCHSMY 
JFQCF           : ETNN            CSCNSJMWK      
QBRHY           : CAANTT          ROLEVXP         SPSDWNPA        MEJOYFDU       
KWPLV           : PFUHRWF         PGWNGE          EAPXDYWHLMUXSEU VWDSBKYLFKGRP   WWYQQO         
TSCXDAIVPL      : LJCGUJKBV       YMUYCUHNLPP     GOUFYVBRKVVTB   XCHIKRGKCGNM    HCVBTIRLRGCSDKF
OAHTSLAIDBCMC   : OFJRUVFTC       JRCNFMNPR       OROMUBIHO       SJGJDVMK       
WAAKVXEQBETBN   : HMYWOID         NDYN            ARLJRML        
RYQIBXDUKFFPIHC : EXBYTU          SLUJ            WJJDUTEWEK      XQHACGYNMVADEIL VKATSHVMNROOXGS YADISR         
OBLQNJRTASYWVO  : JBUVXGNB        EOCWCAN         KOKHADGVIOCTADT CPIVPPUP       
PPIYQGE         : HQNYYEQHF       DTPPSHUD        JIEWKPJCIQRX    ICLJFGCJKD      MAYDYNKU       
SJSKTAOFRPSK    : EVSMNRFYJE      TFXLQVKNPLGS    CWSOECDHP      
ECXFWYETNV      : SEMVYMUDSBAJ    INLRENBWNKP     ILRMJSYBTIMVVD  PQFUIDSTKGWWVIA OOIJUOAQLUFNURL
DEIVMMKIX       : BCVKXMBULXVJAC  NEXL            TEMOYEPVVFUD    EECGJQCAJUYX    NHBOOL         
SSGIAAAVKG      : JYQWUCSNIHOBAL  TSPVPKI         ALWPLAJHRSDDWKY IPGJOQTWL      
PGHMFNGUJQXPBVF : XCOCQIJSBE      QTTTKSYWBXVS    BAOJEPLIEPANFG  EPHPSWBJFB     
GNOMIJUSMUV     : AXMVYGIKYAID    RPAMFOGIOM      VTCNUHLRBK     
HCKWIUM         : YMFF            AJWAE           FEBHQEKYRIS     LDOO            MSFDHCURI      
ISKULKMPGRGNH   : JLQGNDI         LNIXAEUSBFX    
CQHYLTVHEFLQDVL : UAXXUUVN        JDWAAYEGGSKG    UUATBEIKEAWQGHO VMKOHTDRAFTW    JQBNMDIKSWYH    TEKYCBVVTRLXLL 
LWKVT           : YSKGRUNORXHNGI  BNEIXVN         ARRBVOTWRELTOYQ
GGONYWDGTHYDINY : RMMWEORLDCERKM  GKMVHGSHRHVAD   EQEXX           NQVCFYB         MXBJDUWS       
WFJJWOFKGRJ     : YDBQ            BGITEY          KGTB            KPDR            CNMGSPWVRYYT    ETTEHBTWIKGLK   HIHXA          
PDSYKJOLGRRC    : VDXU            CYRLDKTDVW      XJDWFXMVBJJ    
TIJHHPE         : MWBAKJSQBXH     SABKEVAF        CRWUNFST        RBMGCDEPTVUYI  
YPMQVYWNJSFMNE  : GOAIFJBJHWHC    IIYOFQKKYMSEP  
WSKFM           : GTPXO           YQXXHSFKUHYTOI  MXNKYPJLHGTL    UKGSKOATNUUWW   IVARVOVD       
KNBSYICOORQFGH  : SIVTCLRLCFRAT   WOCMFJPRBHQ     MAGVLBQJESL     RPKSWWVIJJCDO   PXBVGYGOSMHWP  
IGQRAXG         : TYMAKMGF        FHSNNWYWYXCG    XRIQIV         
DINVSUJAF       : RLKICBHBTUV     CCFVR           YUPPVGJOR      
BABLDRBW        : DFDELBTSOJAK    UIHKEER         CCHPWKKJU       IOPUCYVLUGARY  
IGRLOBCIDAOSFW  : GOGD            OOFSRQKLQE      CXLPDOIOB       YFVNURSVP      
CSCNSJMWK       : PQLWV           UVBCRDEVBPH     KLHM            FIPS            JFQCF           VGKYGC         
IPGJOQTWL       : DWYJSVI         WBKUDLPYW       SSGIAAAVKG     
LMJTPML         : UGDLLRBRXLOY    DKIJNYMUVFTVENK JALNYUIUI       ETNN            JMMT           
RKTTFXJYHWXT    : FWKU            CBPDELSLSDQCQE  BLJMOG          KNJDTXOQM       ISIWRSXIOYFVAQ  QVJRC          
GLSSBMMXXSM     : KVXNMJTEDVPRLHG NABNFHWQYSEOS  
CIEQTOJHIFM     : MLDKJIMNVCOQ    BCDNQWUICGTGC   KRVJUAACMOSE   
PNQMLKBSWWN     : RAYRTRH        
JAXHUMVAVAQ     : PEELKGWAEHLEMOO QSWTUIQPNENG    QNEMALITP      
OAYAIMGXAWMOIN  : NTWLDAQJ        QYSCI           TEKFTRSD        TIUOLTWPFSKE   
HKUHTWHDSUY     : QGTCYGP         TXBNIXPIWLUMU   IECYEKP        
QYLIQOKQWWYUYWJ : PDAVSDOWRP      SYTWISUAQLCCQG  LUUHQNRUGCRX    YSNLOHWHRRM    
HWWQITXETH      : HKIUCPJDLJQROB  WDSHP           YMYXUATXBQY     HAUCGF          QUDRCNO        
MCJJULWGCLQU    : OQFQARXT        VDSPDQEUQSR     QNEMALITP       BKQJDAXLJTO    
PTHQQQHAOG      : ELJC            FEFEWDYJJNIGVA 
YBQDUYNJDXSBJPH : DMOGVFSSGE      LJCGUJKBV       NFTBSHQJM       RKRSMKJNSLVBVD 
EAIOREWIXNR     : WHXQYOMGJPA     GLIGFNNGVLS     QWUJW          
EYPDAIHWHUI     : QQEUNQYL        OVNCLFCJTE      YXLGHBQIXEU    
UBMGSVVYX       : WWKWWOMTJQB     JQRLWKUHOUR     QTGMIRRRPKUHA  
OPLNAJDSHIT     : SPUR           
NVIWSRUBFPE     : UYEHXHO         GMDULXC         EOKWNDLOSRNLFH  ABBRYJOSBLHQWQ  FKXE            MWPMADUBTFX     UGVYCDUPBARQQ  
YYPUYNCP        : JAJQAKWUIAUCQQT KELNICIINV      ROMOTLRHLHJLSJN YVRNPLRCVQFY    OWVAF          
NFIWI           : MJKJXSA         FVGFTGPXYDJGJPS MQGG           
GSWIJSSG        : PROFVGJQONFLP   HCVBTIRLRGCSDKF OSPGAGPSJSV    
MBOSTU          : CRJH            GUKRHKDHONPB    WWGCFJEDQPJW    NSIWB          
STDNUSP         : UTTCBLJLLUCXHM  QYMMONCNXEBPR   YNXWPRUNDKLIB   AMIPHEUBCYQMV   KFPEVIAVIT      LIXWF           EHWBOJM        
BDPJCBMLVJV     : CXLPDOIOB       OYTLPWUUCGH     IBJKVLVEWDFQBH 
CQMPDNEV        : FUAFAXR         HWKVUWXDLSS     GFJKTRCLTKGX    CNRPBXUVM       KEBPGJDPAUGMS   GEFJBKMTMEVGJAI
YLAUQQQJGDMM    : IIBUUCWAIEOOHXH FVSXA          
VQWIESRAY       : SQTOUPNU        XPWXWD          GGIGYNSFBVP     DDCYDWPHXEXXF  
SNLWBRULQINMYE  : MLDKJIMNVCOQ    TXPHURYETD     
LNIXAEUSBFX     : OIPTTBVU        VRTMSGMEBVIMIY  UWFOCDOSAKLN    ISKULKMPGRGNH  
XAVTTLIS        : IAXCNSWMJBNJKQG WRMJI           UVBCRDEVBPH     VKTHWINA       
APATYQIXWNJKVIM : OXULXDXWRSPMMM 
FGGKGDKGBHAM    : WHIMXELKXYXSDG  OIUIBYFCVIRA    NMCGIDOY        JEORSBFF       
UCRLCLKUTKSHUDG : QLIT            CRJH            LICX            EQOIYDA         IGHQM          
SLMBRWHV        : TUMOVACYKOWIEAD USLVOBKLISRQ   
NYRQMJNO        : YPJJUYJMCGBFHG  CDXOHHVG        UPRJVWVTBQBLW   IQNFTDCF        AYJWTY         
YSNLOHWHRRM     : RRWWLTMKKU      XLJHRNOXJ       PAMKXNDU        OJJSFMD         QYLIQOKQWWYUYWJ
YHLLIFKPBUGBMYP : OCUPHXMGXOBKJLI ORTFQSUIPI      SPUR            KGQLTQQKKXFRD  
MGAOYNA         : EXSOP           KJXD            SJVW            OBIGRJIWAM      FRIQA           WFJCAPJ        
WWYQQO          : UAXXUUVN        KWPLV          
PVGDFMQWNL      : BDVFMDXROA      EXJTGKQGWHEFGK  LMQEUNUUKJVGL  
QBEGYTOYIOO     : ODLEFXQ         CAOLMFTTVLVXLHC BTPGUVVW        THWHU           SMHIXGOKHA     
GMIGFYWYRSF     : QJGFD           EYQGNYGSTR      CCVDMMDGOCK     EAFN           
XRNXICBBD       : QJNIMHJXXID     RXQDKFJTF       SGFOLL         
IECYEKP         : TXPHURYETD      HUPBGHK         TRJJCDKHPQGPAJ  OYTGPK          JMYHCU          PTTYWKQY        HKUHTWHDSUY    
UWHDFPF         : BBJKNRXWF       WHIMXELKXYXSDG  JMRAWIKA        CVFQPSESDP      QXTAEUYP        QIQWYNQRBDM    
OYUVVVOMTYOWAR  : PNVHFPKMSOLNF   CNMGSPWVRYYT    IVARVOVD       
KVJKCVAXRWH     : OLFDSL          XREGX           PHBVLDJKK       HQLRGO         
EWEGNDEKCC      : OYTLPWUUCGH     KGQGSIKVE       PAMKXNDU        PQQLLPKJJP      UGETE           JMMT           
OVCFU           : EYMVVKFGL       SCJYLSDLDUVBS   OHGSRTB         JFHMPODFUUCY   
YDNWMAALA       : FVNWRASWKY      TELBQYK         RTFEBOYS        YHYXRX         
DAJCEJJNYMRJQVM : XWDDFO          DFLGBYBYKVQXSV  BCDNQWUICGTGC   OBHOPWSOMBC     JYHFBPALUAFNO  
ROMOTLRHLHJLSJN : YYPUYNCP        IGHQM          
LWCQ            : PGAKNP          SLUJ            YDMNVDOASCEMD   KSIHSJBX        TGDAQHL         TXBNIXPIWLUMU  
LGIBATRVHCPXQER : OPVYATXMVQ      CNMGSPWVRYYT    YHYNORKRGDK    
YBQGMCBWR       : YLKJHAFHAHENUWM ANEFLGISMA      RWFRDH         
IQDBAPH         : IFWYOBY         FTDFSRGTGDNYGCB SUESPY          PBGAIIKFIX     
QHEIDNMSMEAG    : HKRAXMPAOTQBT   YVEOELWXGPNFEQV KMSQJCU         TKRKRSPH        QWBKPKQJMHW     IWKUHBVFDWLOU  
YKAHWEKVVLHMO   : ACYAKS          RVPVAL          TNJPKCIRVOWN    EVMBUX         
OESYUCE         : FRYTTMGXIXJLYB  CAOLMFTTVLVXLHC SFAGN           DXPUTPQNUYJLW   VGFCEVLIBTLK   
GTSBGWDPG       : CRQGF           XWDDFO          FKXE            BMQOEFOSSVRDYX  NRTIDOYQKXGP    QWUJW          
CGLBKVAIJ       : CXGINMECHBGMP   ELXXJJQBREVCVOQ CBQEPKCNLMXLQ  
XYRMDMOYP       : TLINWGJ         KVXNMJTEDVPRLHG UKGSKOATNUUWW   LUFHYICEIEMDEJ  AKLHNIHGUVWE   
FXOXBXXFNEJRNX  : SFSIFANAJEKS    FKCSF           UOWYEDDVX      
XVUHGEFFWTIJIJ  : IMIUWLB         NHIVXKCKMELBKTA LAAPHDVDBBXHD  
DQYSRBQPGGVRAJ  : TEFARVGHBJVXKIA FJDV            QTHCNVNJWQ     
UIOQRUUYATSK    : OPAR            FDDD            IFWYOBY         UXQMCI          XXDEX          
EWFJPH          : JBUVXGNB        LAELP           YYMKEOJRBDHPR  
HIUY            : HSGTTUCKWGEFGI  YHCSJOYRW       XTRQGNIW        DTITITE        
DVKD            : HEJPS           XSVXVVTC        NOGNEFHGGTPFY   VTCNUHLRBK     
DBPRRJMOIM      : TTDIPF          HMYWOID         RBQSSFFA        XGMCIH          FBDNYALJCBRTUBX
EYPIXWROEWVOTX  : CRTCXV          WWNFPUGUJHUWTAX UTDTWYPLAY      KBBSR           TKWUHVC         OBOEWELEKCMWO  
ATQDBVETNXF     : TNJOXS          PROFVGJQONFLP   GTLEFUNKBN      RGPYF          
NOOWUNODOL      : HVXWXESBRU      BKBVRBKBFMFD    MQPE            YJVJ           
DQVBFQYN        : KFBSNSIINCESM   OPAR            DQSVUQU         SSVBCYG         WGJXJBSHFIG     YVWIRLDYTJD    
UGVYCDUPBARQQ   : PDUIFYVSUE      MGHNNBPA        JVWOJUFFQVYES   AACXJ           FVGFTGPXYDJGJPS IAJGGPQOOFKVIG  NVIWSRUBFPE    
PLVEQKSONJ      : TYMAKMGF        PNMXDJECH       FJDV            CCKIICW        
PQDQGTMOSL      : LGFWBXJOWMHAW   FGLUASSQ       
VGKYGC          : FBSIE           SAUFYL          SPSDWNPA        VHTUUWGFJEI     CSCNSJMWK      
XKILH           : WOXKNW          QXRPMH          MDKPLDOWOHYL    YUTEUJBQVOE     BUGRNMNGJL     
DTITITE         : UWGCPVWQFB      WCDKS           RQNMKNKAHMFKPXY TDAQPNKEHDY     NTGI            PBDSPDVJKVKAE   XPYKLOKKRRKUJLY OKVXEJF        
DTITITE         : HIUY           
KKQTGFKYQEWYOW  : JXVEVDXARFVHE   YOMJHMREYN      RDISLUAOS      
TPIEATL         : XLBHDUKLLDBCMXT UIHKEER         YGQSW           OUNYWMNK        DIKTPYW         LFLPTCBE       
YGXSQRASFK      : XHAMCYQFS       WWNFPUGUJHUWTAX SSVBCYG         HKRAXMPAOTQBT   FMAQG           PPFLT          
BQPLSIPPKHMSB   : REYWYKNQEFYHQWO YPJCTTJHN       ORTFQSUIPI      RHAAAIVI        FKDUD           NRIRNIUHP      
BFFWRWWAVPSNR   : KABVT           LUAYK           RSNLSLURGJFJ   
UCUVVMIO        : XVVQKJOWMVJTQEO GQBXJOSCTOGJ    AFEFOGCIQECKKH 
AEIHTBKAEQHD    : NJNFASICCTOUSYA TGDAQHL         VPASAIILH      
FAKBSD          : WLOUSUUDCC      OYYH            YXHWLEPXS       MINRO           BLLOMSVCNESJM   GEKXLNHBVRKAIB 
KQOPNKL         : WRFRRLDW        CTCCUWSBDBF     XVVQKJOWMVJTQEO HLBG           
UCBXGJFCMSDSJ   : XXBYLCDSYJRD   
VTRYGUTLOGEDXRN : HMYWOID         TLINWGJ         DHYTXIPORDGAWR  SMIVSIOQPIN    
SLLVJUFQWTJC    : ELGW            KLHM            BKAUREYFA       OHCDHDIHTSE     BEKYPRCUE      
UPLQHMYDI       : REYWYKNQEFYHQWO TGGFKRPKTTVUM   TYKOMIVXVPVERA  YXHWLEPXS       RKWCXMYIBOO     IIYOFQKKYMSEP   AJPAYPELNBJJGH 
ROQUNJ          : JUASDMGAQU      XHJJTHDDDDVFI   GNXFNAYCMKIUNW  SYLGQUUUYEERL   VOLQSGET        VKTHWINA       
YEXNBJIIBHDMK   : MPHREQOIYB      MVRINVIL       
ICFBJR          : OLSMNKSERY      QKNCDB         
OANIRFFHOS      : FYKGUUIPSIYI    MRFFHCIWWRAWDL  SLUJ            AJPAYPELNBJJGH  XVJXXNHEYY      CKCRGTTVFV      HSBFSIFKGO     
UQTVDEFEOK      : JLQGNDI         UNMLGGJBLIBH    CNMB            FALHNMHPHAXFN  
BCDDKFOCGEFTO   : FQBQTK          HGDKNY          HUSPFUCGIA      JAKRY          
BUGRNMNGJL      : VLGVVOCLLC      QBHDDLLRSXW     KVYJXSKTPOHPEJ  XKILH          
PQPEDJFGMIQTAUA : EMYVMBTBLMF    
CWUBAPJSFYIO    : HAYTYCTJNOCQNM  LJCGUJKBV       EMDDYUKTKUNS    BNMK            AOCM           
TAALQFOCMWQXP   : JRCDI           MYRLYTGDJRAS    MFXKSL         
XNNERMYV        : IXWOBLHDDN      LUAYK          
RFGWEQNOKORXHY  : CNGJR           XWNQI           WLHFQ           IMLPWNIRVLQRG   BKVRF          
JLMCLFPJUENMQ   : XHTBJ           MKLKG          
IGHQM           : XLBOYCSHABNFXI  CMEOORJDQLAYSTC UCRLCLKUTKSHUDG ROMOTLRHLHJLSJN
WDUOQJGOQHECSTE : SWYVPDCBXV      HAYNU           JMIDOAFGDLSQPQF QRNFLTUVTT      BQNGO           UQHE           
BUQVB           : BDBWWAYULSK     YLKJHAFHAHENUWM TETHW          
ITUTBEMPKJ      : EDDQBUFM        SEHWFULFODKDXRD SJVBARABVT      MUHR           
FXMOG           : WCHEK           VDDLRXSVXYTOK   EDXXU          
HNIJJCQO        : PGWNGE          MTKNR           QYSCI           MINRO           YDIJJKCRVFKW   
NHBOOL          : NFVXRFVMGHQJKB  FBDNYALJCBRTUBX KKCKJTQVHTHT    DEIVMMKIX       BDITYQCEWAPFCL 
LFLPTCBE        : NYVSTJULTVJ     OMAONFY         NMCGIDOY        TPIEATL         NOTDM          
GEKXLNHBVRKAIB  : WTHIGRKXKRKS    YQGGYBDNIQO     GSYMTLD         FAKBSD         
VJGMXSWKAJAULDY : AMULOAJOA       GUKRHKDHONPB    JYHFBPALUAFNO   PSURMXQNBV     
MFXKSL          : AYPV            UBGBRWCOAS      RKWCXMYIBOO     UCGRTH          TAALQFOCMWQXP  
UKLFMVJSTS      : PNVHFPKMSOLNF   UQIWOYMYLUJBI   FMEADPCUMXVLM   GBUYFU          IPHGTOWAQQN    
ISTGDUPGPDLQ    : DWYJSVI         SNIWPPDGLU      FVSXA           PHUOJ           WSONBOKOWJO    
XXMK            : PEELKGWAEHLEMOO MKLKG           JIEWKPJCIQRX    LSOQQADNNETYM   UNISE           MYPQDMQUSSJKHAJ VERUBYTVIKURM  
AFMKSTAPDSLVV   : LOIXBUQG        WCIBFQJNXMR     NPNDOCMTT       PXVMVCPUNBVKBX 
PQBUNSDDVPVMNT  : XWXCYEKCJSTJV   UPSATUXSRJCF    EWTJ           
YNYGAMYUO       : KEBVDTWXBP      TJJSQTA         LFYKC          
XJDWFXMVBJJ     : UDXOJFIUCNRXYJB AULXRPKWMCQRFKU PDSYKJOLGRRC   
NOTDM           : IUIANGABO       ECMUVHWIPIHM    LFLPTCBE        OEAO           
SJHTWIA         : CAVNO           RRLPABHTGPVEJLK
WAULQSUVPBVE    : UNSDRVIHGOFWCR  IPIAYUTCCR      CXLPDOIOB       JTWTGDXBKPAHLAK UVBCRDEVBPH     VDQGMBIW       
WQLUEA          : NFCXVDFBNFGTK  
JPWEYEYXNBXKDS  : SEHWFULFODKDXRD USLVOBKLISRQ    UKGSKOATNUUWW   KIDEJ          
WOTSGWPNW       : QAWQ            YSUSJQQFBYIJ    UGECUMP         QVOLRRHXNXP    
EKKIMBTCYX      : HCJPEDJNJYSC    IORMTVDWCHUOGFS GMDQBXFKCT     
DYCSBAEG        : EYMVVKFGL       OPKTVA          VUJTTMFORHDOF   GIXHVH          LBNJOIYWMDNGG  
DDKYWQWMEVDI    : RSQX            BUVARDPP        WLACDMODDU      HLUHYMJCBEXHFB  PFROGMXJQUQD    BGQKMEG         AEWJJGJBGIDVJXW BKROLPJYF      
PSURMXQNBV      : PPGGCB          UTLBKRS         TPQKU           VJGMXSWKAJAULDY
DPPGVYCB        : EKIVBBMHDU     
MAYDYNKU        : TJJSQTA         UXRFRMD         QWUJW           PPIYQGE        
SDJOYBB         : FIMQY           DMOGVFSSGE      VMWWR           QICEGO          WUKDT           IPFTYSTQYMAFX   BKVRF          
TQAQGGIXMG      : MGMDBS          KMAHSJUDUT      XSOQWCXHYLEC    YXMHOFCUAFNVXSR WSONBOKOWJO    
OHCDHDIHTSE     : MYRLYTGDJRAS    NRYLJKIQS       SLLVJUFQWTJC    AEWJJGJBGIDVJXW JCFNOHAMXPIUU  
OKWDJYGIUXKNG   : KKCKJTQVHTHT    TUVA           
VGFCEVLIBTLK    : KVYEBFJOMNILY   XFDEDEOR        OESYUCE        
FDJSR           : RNKV            CCMMTKVOLYSANL  JGNJWPG        
QUDRCNO         : QQFWULPHTWNVGH  HWWQITXETH     
BDITYQCEWAPFCL  : WBOOMTOMIW      FNXAII          NHBOOL         
MQWP            : QMYFEGRAOBOVN  
SKULHBFJQTNRW   : GARA            SIVTCLRLCFRAT   AIVRPTCOSSLYI   RMRVSWKK        AKLHNIHGUVWE   
MYPQDMQUSSJKHAJ : EMNQNDYNMWQQDO  VHDEMWTRJEQ     QYNEMXIJF       XXMK           
BEKYPRCUE       : WXTIMKEGJEBUY   SLLVJUFQWTJC   
RRLOSANIQSUJQP  : MKOVWWVXYLSY    EIBOPUE        
ACMCOMGSY       : RAPBFMLCVN      CPQYLCUXCCSIU   EBBKYDMBMOO     VGFIKALY        WLHMAVUILYNBAA  QQOIFVR         XFKEPCUOOY     
JTHGAC          : VAGBJYFSACL     PACCA           UVFSFJUOYRYKE  
TPPMPDUIYSUR    : XGMBIYY         WUXXX           TKWUHVC        
ATNMVCCEUDLGY   : SXFSYOU         LWLHOXS         TAWICKTSYORCD   NCRSMVHUCMIQO   NXSBTLASQWYP   
PYXNTNDGGJEQKW  : ILIY            DFDVNAERF       WPBO            GECAEXKCVAMDYN 
CHLXWBTY        : OLQEBICKXKSUDS  KMAHSJUDUT      ELSGAMR         XHTXBWUO        WQJDLIRF       
BWIMDI          : PROFVGJQONFLP   BETQYSSHETVBCFC FIEBYKDCU       SUESPY          MSLPLE         
SJGJDVMK        : JXVNYMVKANPNRUM LSKDHHXRPN      ONRAETCEBQBC    TIKUVBSUTIYMB   OAHTSLAIDBCMC  
XQTIPFM         : NSOMUK          SHYACMXPG       HBWEMKXIFR      TSPVPKI         HWKFC          
TKWUHVC         : VYQEODIRK       EYPIXWROEWVOTX  TPPMPDUIYSUR   
SMWYUFTH        : FDDD           
DKKSWMSNGEDOQD  : CRJH            HACPLVGM        EIUUKFMI        JNTRT          
EAFN            : LLISGP          HLPXWCDTBSRKU   DFLGBYBYKVQXSV  XOFJH           GMIGFYWYRSF     CUXQKOQIGWYFFU 
HXTTUSRDOBQ     : OCUPHXMGXOBKJLI JLTBFWJAXV      DXIDBQII        OXAS            QYAUNXOWTG      QPBRST         
LBNJOIYWMDNGG   : HYLXUIWFPCWKNO  NFUNMXUVKGTSFO  DYCSBAEG       
KIDAGMXCJUWDX   : UINWARNMBXHG    KCVQWWNUFBACO  
EPHPSWBJFB      : JMOOTAVTVCV     NFVXRFVMGHQJKB  DJLLMFTCNJF     GTLEFUNKBN      PGHMFNGUJQXPBVF
SGUYOTL         : PCNTOXDLOABAGM  LISIBMJEA      
YLFMLIXIFBHT    : FFIE            UMWRM          
YBWRAB          : UQIWOYMYLUJBI   VWHBQMWQXGFDWJO SVQJJDVYNXHC    GXAGLHRUQAYIAXM AJNFMBKUWUSN   
GELBKICYCPXCDF  : WDWGXTVRONGV    BTYLLGR         QIFY            NPKVOLKAFHW    
ONOW            : GOAIFJBJHWHC    QFANWEVRP       JWKEGXSCSQASDD  MQGG           
RGPYF           : LYQVUYK         MVRINVIL        BEGJSFCCUVUPM   MBTT            ATQDBVETNXF    
XATYC           : BNBMDGELXFUBEE  LLNMGTBBAQCPA   LWPEISPR        HGQAQNUPEWC     YDGDTLELR      
FPFPXHQDWO      : TSKDXXVN        ENCPBGNOB       YDMNVDOASCEMD   PXWAOBTBXQY    
CUXQKOQIGWYFFU  : WVJYKGKYOQSG    XNGDEDD         FPUMMF          EAFN           
FQFJVKYBBWL     : ROGJCVQEEVKIYX  GBUHSKCMW       VROQFYO         EQPBIGRQ       
AKLHNIHGUVWE    : REYWYKNQEFYHQWO QBGUBKDKSMDDEOD WGOSKTLH        XYRMDMOYP       SKULHBFJQTNRW  
WFJCAPJ         : SEMVYMUDSBAJ    TJRLS           KMLPURJUFOALU   MGAOYNA        
USOFTSIQ        : XSBRWX          DHOPRQVQBC      PXRAWDD         LSRWWGNTA       WLHMAVUILYNBAA  YVNMDXGPY      
FTQQDEYN        : MTYQW           FDDD            AWYDFLCGIBKEQK 
TLMAQJFALHRWB   : TLPMLWYEUWCTB   BEKQCOWIDDH    
PPUJKFDOKYIDEO  : VUJTTMFORHDOF   QBHDDLLRSXW    
RCBGPB          : KIIXWMQLSA      MTDUGY         
YHYNORKRGDK     : DDWBIPEC        WRVF            DFTQVAVTOPDO    RPKSWWVIJJCDO   LGIBATRVHCPXQER
MUHR            : HGDKNY          GUVDDNLJL       BUXDVPXNE       LNEEVSYUMJRB    ITUTBEMPKJ     
TQUXXJCRMDX     : HLPXWCDTBSRKU   DFLGBYBYKVQXSV  JMDBOQRJVHMNG   TKATI           XWJJJJXADOAGY  
FUFO            : ENRWBWM         JVEIIIIXAUR     JDPAAXMK        LSKDHHXRPN      XDNQ           
UFOIXUL         : IUIANGABO       DFDELBTSOJAK    BRRVAJXWRPYUTNE YCWOODTM        WHUYCIYTIS      RTQIAOUVBVMA    XTRQGNIW        ESYSKKOYXCYEJ  
YADISR          : HYLXUIWFPCWKNO  VLGVVOCLLC      ESFNXM          WWGCFJEDQPJW    RYQIBXDUKFFPIHC
LMCLWFELKCRRAW  : NSICXUGR        HDSGAJAASH     
WSONBOKOWJO     : SAJNHX          VKTJXH          KELNICIINV      UQHE            ISTGDUPGPDLQ    TQAQGGIXMG     
RJUWXJYJIGN     : QBGUBKDKSMDDEOD QGJLXGILUJNJD   QYAUNXOWTG      JGWHQGPMRAS     ANXWEXHYKHWB   
RSNLSLURGJFJ    : MAGVJKXW        FDDD            OAQLPJEJI       WUXXX           SLIFGGLYVKIL    BFFWRWWAVPSNR  
PXWAOBTBXQY     : MSNADTNFHID     VARLLG          PKGPFEUWXFLVCBH LNBJM           MKMGUTJ         FPFPXHQDWO     
QIQWYNQRBDM     : FORWDNIWOYKY    QPIFAPYDWQENGPF JDFPU           CTYJAHCN        UWHDFPF        
AEWJJGJBGIDVJXW : HJDFFJGOHHQGRC  YPJCTTJHN       TSQOW           DDKYWQWMEVDI    OHCDHDIHTSE    
OXUHGNHHBAYFFL  : GYGCTHTRBHXMCH  JESO            YBAVYYSVJTMX    ICLJFGCJKD     
FRTO            : HCJPEDJNJYSC    AHVRFTN         WVIRLQIK        JPNRL          
CAFJIIFUGEFX    : NOGOEDMWXMA     TDAQPNKEHDY     XRLOJCAWPHPAM   EPLL            QJSQJX          EUXSMDMXFD     
AHKPOSTRTYWIWD  : TKUA            RQXQTSTGTF     
STEVUJFDRMABSFB : KKCKJTQVHTHT    DBUELUVIMIIO   
HIHXA           : FFIE            KCVQWWNUFBACO   WFJJWOFKGRJ    
RRWSOFRTHL      : BXQQWRKAYHOWBSG WPBO            SKGUSCGU        QIKQBRRYL       LYEJXJJ        
LHLU            : PNMTDEMLEJTTJV  MGRLWOPQRF      TVCYUAUJ        MWPMADUBTFX     AMGSAWPCXLL     OSPGAGPSJSV    
QPBRST          : SROW            GVBUONC         QEWQKDKVLHHTBH  OEPGOGAR        HQLRGO          HXTTUSRDOBQ    
TQJEXHEDBXAVP   : LYLBA           OJMUDJNTSWVWM   XLLSF           YMNKSYWOBW      FITHVCNXDRYNWW  NWTCBKGVFCFLUM  AJNFMBKUWUSN   
PJQBADKLA       : CNMB            XUODYNOA       
DRAWKTVEMFLLOPQ : HMYWOID         NBWFCBNARULJQF  JMRAWIKA        GECAEXKCVAMDYN 
OSPGAGPSJSV     : KMRXQUCI        GSWIJSSG        LHLU           
EWTJ            : FHSNNWYWYXCG    CYKLP           PFVOWBOJE       PQBUNSDDVPVMNT 
WICQ            : FXXGTU          WXTIMKEGJEBUY   TVLYFBA        
IEMT            : HIONQMAVNUKG    PDBXNWYTW       MKJCB           GHOBWHJAAYMKX   TOEOEUUTJGSFU  
EKIVBBMHDU      : OFNCW           RHEEUTECOUMUEL  PQSEYDTQGPUJ    DPPGVYCB       
VERUBYTVIKURM   : LTFOJVCF        KNJWJBTSMTCJFM  BGQKMEG         XXMK           
YVRNPLRCVQFY    : HDSGAJAASH      HLJLHXRLVGSFELQ YYPUYNCP       
OEAO            : OHUT            XWLGUTEGGFHP    REQJGKRHRKAVG   NOTDM          
GIXIHRGS        : PBDSPDVJKVKAE   MPQXETYS       
BKROLPJYF       : YODEK           DDKYWQWMEVDI   
TKRKRSPH        : ACYAKS          JAEIBYPEJ       KIUJ            QHEIDNMSMEAG   
PXBVGYGOSMHWP   : HQOBOPLPK       VVFOQI          KNBSYICOORQFGH 
OFHEOGMLCWFMQYC : EYMVVKFGL       FRYTTMGXIXJLYB 
WTVXSDWYT       : VDGECCAOT      
OBOEWELEKCMWO   : FHAFGFMR        IMLPWNIRVLQRG   EYPIXWROEWVOTX 
VTCNUHLRBK      : RBQSSFFA        RKTDGSQVK       QLIE            YHCSJOYRW       IUNKD           GNOMIJUSMUV     DVKD           
TPOVJGKMX       : SAJNHX          KRFVIMGPNABDQ   NABNFHWQYSEOS  
JCFNOHAMXPIUU   : EXSOP           JAEIBYPEJ       GEGGUF          MYUIRFP         OHCDHDIHTSE    
PCMKFW          : NNEUOXH         UGXDOLOHCI      OPNQKIBPHCM     XFKEPCUOOY      XPRFERG        
AMRXXAIK        : JBUVXGNB        FGUITYSN        NRGMY          
BTCGHR          : KMKGDTG         GYKAPWHL        STIKTG          VWDSBKYLFKGRP   YXLGHBQIXEU    
HGQAQNUPEWC     : QGKHOLIFMCL     KEUBIYHJAAK     XATYC          
CBQEPKCNLMXLQ   : BDVFMDXROA      VUYILBPCWNJT    FVGFTGPXYDJGJPS CGLBKVAIJ       KXAQQASDROE    
QWBKPKQJMHW     : YJVJ            AQWTRKXRUELQLEH RPKSWWVIJJCDO   FCDJMFGEJG      QHEIDNMSMEAG   
YDGDTLELR       : PNKWPKO         EQEXX           YRATCFVRYNH     ODFMBBWMNYQ     XATYC          
XWJJJJXADOAGY   : KYWEEWTMO       FQAIFNEQLTEM    TQUXXJCRMDX    
TRBGYYQYEWEYKJ  : LHRNRIKYPFIKJF  NVGXW           VTKFTRTVOUI    
DFKARWLBU       : EYOHNYGCUHQIJDE FJYN            MXJSE           UUATBEIKEAWQGHO
FLONMIHE        : MQSYHMSXUVXEQY  OBIGRJIWAM     
OFLFGPELQ       : KBLJAECRUPV     WBYXSCBLYXM     VROQFYO         YXVLPRHMFRVVI  
WDUCOWTLIXIYF   : FETTSOJIAENTDPS KMKGDTG         JQYCHD         
NSIWB           : JLBICGWGAIOTPQV NPCSLGJUL       TUVA            MBOSTU         
JRTWYDMDOEUN    : AXGAKYKJSCHSMY  CVFQPSESDP      LMQEUNUUKJVGL  
RPXO            : WOCMFJPRBHQ     SPUR           
JAKRY           : IVQFSGP         TRAVBGM         BCDDKFOCGEFTO  
NPKVOLKAFHW     : OCAFRNNFNSMA    TRYIDWWYQTVNAQ  GELBKICYCPXCDF 
KJKBPHOAAGXQUKQ : MGMDBS          HRGVWXDGDFV     BFBKEBCYAM      OUJMGE          BEYGKJRADN      VKYYOTFPLR      WCIBFQJNXMR    
ESYSKKOYXCYEJ   : OFYMVPQWUKMKPAE YTYNEYHETVHQQW  UFOIXUL        
ITHUW           : HIXLSFJJKOK     VXJCUTEYSJMH   
DLAD            : TPNAI           OLSMNKSERY      AVWCXKWKYFX     XMQPMAPOHD      WIGTASWGWHDPMU  JALNYUIUI       GGIGYNSFBVP     HAUCGF         
AVPMPW          : GBVBYUBQGVLPGHH
IWKUHBVFDWLOU   : CIYDJBRHQBU     MKMGUTJ         QHEIDNMSMEAG   
KERHEUUGAP      : JTHJUMIILARS    CXNULO          VTKFTRTVOUI     ETORJIMECVFBQB 
WFVMENWBA       : OOUPUXFMSSVB    IAXCNSWMJBNJKQG NRYLJKIQS       CDXOHHVG        UQHE           
KCPS            : VGALDVD         GLJXMJHKA       NRMOUFGOQNFLG  
MEWHBJLTRSQ     : AMULOAJOA       DTPPSHUD       
YTEISJHHQUERV   : KRRFP           MINRO           XVMANRSAFRMAX   DSUAOBJPKQTAQFW
FAPXHCCGLGSYAKR : EUDPB           BCDNQWUICGTGC   YVAYNBSCPPSRPFF
YRMGCFPJM       : JLBICGWGAIOTPQV CFRVURMJK       YUTEUJBQVOE     DWJDIUKHGI      LUUHQNRUGCRX   
HSBFSIFKGO      : OPPITEDETI      IXCORALJN       PFROGMXJQUQD    KVXNMJTEDVPRLHG OANIRFFHOS     
KXAQQASDROE     : LHOIBCLVQ       KFPEVIAVIT      GIIHQJRBJRNP    PVPM            CBQEPKCNLMXLQ  
BKQJDAXLJTO     : CHKYWFYR        LNSQSTDOOAWYT   IFAQTCUA        TLJKG           MCJJULWGCLQU   
OWVAF           : GMDGEM          YYPUYNCP       
MSLPLE          : LBFQFUQGHJXKVG  NUPJIKJTXMG     QFANWEVRP       BWIMDI         
HHJVN           : QNGT            TUFAEJXIGLUVLPP PQQLLPKJJP     
YYMKEOJRBDHPR   : FKCSF           IIYJI           COHSPCNIADULI   EWFJPH         
MROAHHNYUROC    : EIBOPUE         VWOUSOFLJHC     RVCFEPNYNBAAU  
XXOVXPK         : PUODYHBKAG     
TATMBYVSREHLS   : YLRO            YFIETDNWYKVSYOU IBRQL           FIPRLUSIFO      TOEOEUUTJGSFU  
UCWTXOK         : JUASDMGAQU      TAYDPKIMMXUIVP  ARQFHLYSFQBL   
PLBHJYW         : QXKFCVI         KKCKJTQVHTHT   
