DLVXBDRMMR      : NOFV            MIJOEOCKJFFHR  
JKYHYFKCTTSUN   : BCGNTRVBQT      RNXLHC          DHPBTAN         HKMHFI         
QEBKXXPLTNOYHCM : MGMABDBYXYURC   DBSJXEGIUVMKNN  ALUEJGLIMORYGT  CCGFCNFIYUPLTHI FQYQVSMDSTTAVH  SVDDMPAD        HPWRDJHXMMQLVME VOPDESTXEU     
YVMXG           : CGHLJUJOTOVCU   SISIUBT         TSWFONPQUJGHQE 
FQPAKJUAGLHJ    : DMKMF          
HJNTDEKEN       : QAGBWW          JVXDNOHH       
QPNPCMXOROERBPM : EGWXVS          VNRIVKGFT       NDGU            IOWLVOIPTRARGOK
XALHASQQO       : HSMNWWDVIOV     GHDTLQO         CTSWSQOYS       WWYAHF         
UCBIOTBDLDR     : JVTGCTYK        UXRHWIMKDT      RGWVFGVPNRL     HPWRDJHXMMQLVME
TJAB            : PHNCMKHVFDNW   
CQSGRVTYVO      : CGHLJUJOTOVCU   AXEA            VXEMGFBM       
MEQJGTUWOVCCY   : STQYIEB         MSNOPI          YNYWSKEHWQGYKIS VOFVEGAHTT      IXXPGFUDRQ     
MTIMUM          : RJSLUTOSBVQSGLL DMQXHI          PXGBRWM         CHQFALGBNONJC  
NHWFDQHAGAMMSW  : LMDCL           UYPPAIMTOUSRFY  UJMUYMKIJHJU   
NTTCPYGOUSK     : SWICUODPG       ATWHIPBTTMI     QNTCYYFOJNXUJNH HTOTWORA        OWHRTHHUIEVL   
IHRYXAYFDRMF    : KLIJ            KXYFDLVGATTO    XHFV            HKHMWB          OPVCA          
OSOIR           : GKUSBPLCLHB     RWDTBUDROIAJOIX VDQYAGCR        YAMF           
VLGADHGRCCFIKO  : VPSVA           MPAWEGHPSYXM    VTKM            JSDFQQJUCD     
LMCKSIFHNFWIUHC : PMIQV           TGYJHJG         EJORGKLOBOJGCB  MUVLKLDTDEE    
DNOFSVL         : SWTIDNXDWC      GEEJSUTGGTLIM   LPQLXNF         JPRDBXTNPY      WULDL          
YNSJAJL         : JIGRRBMLCVXS    AEEGTL          XPDGUD          POXCAIBKWGJEOK 
WQYRBEBQK       : DCFYGGXNUJBU    FIXO            FJGYKWMTHYBFNEH OEAIUMFBMGPO    PGJGTCLXGRE    
AHHCPMSFRL      : ROPGAEDJABGC   
GYCVTLWEALDSKW  : SILS            IKYW            VFPYGVXG        VQKL            VPIHNFTCJF     
RXKEYMLIRBVM    : XJYOBSVEWXDKX   UQWOLAMIYJH     AALWYTT        
NAKVCO          : AHUEVLLBCVXVEB  LXSXA           QNJYUEF         THGV           
XBPEDDJVNGRHHEL : SGGYSYQIKYGEAPJ HVFVUVKDNMILIK  JYGAY           OTGPIDST        QAGBWW          FQOQVYQYATR     UUYJGCMMWUR    
RYQL            : ADRWHNTXMEIMFC  FJLTDLNSEOEE    VDQIXPSAVSVPOEH OTGPIDST        OVBKKWQHAG     
OXLFXXBCNTBQL   : YXSWVQBW        SSMALTDMSVNGT   IWSPCSBF        YIGXDXMDFYWYI  
TOPRFXLOFPBPJ   : EWVBN           KYTFCTPM        GOPWU          
JUDXUR          : QJDEVPXCJXY     SGIFNVLPSDQPR   XRSUPVJXQWPGL   RJSLUTOSBVQSGLL FHKYH           UUEHY          
TPHXDDYTR       : FHSVQRGAVLDMGY  KJWTDTMS        PETMHUBKAM      PPIVKITHSIDS   
PIWJPUUFDN      : YKEBF           XUCAERI         FUFRAGGYNCHQ    PWMYFKQNF      
SWICUODPG       : NTTCPYGOUSK     RAQNQYJA        DDBGXQ          MSMRNYMVGV     
LVRK            : HLWNHXPWEDR     FDOCAOD         FQYQVSMDSTTAVH  BAQMNDONJMSWYL  WFCNIB         
XJVPQMA         : FYSPHPKDCOEIH   OEAIUMFBMGPO   
VQLTXOHEJ       : PKHTAJOMP       IFPFC           WXGITNK         KLMJNDWJKANVS   MIPRGLCVAS     
OOBDTRJ         : CHPMICRJIDT     HVABPP         
DGYPIWA         : SWMYITQSREC     OWNLNUXMJGPXNQS YULCUIEUQTKBEHE
OSSQJRHU        : TDTRTPYRWU      FIVWQOLEKHVGD  
FLULWDDLH       : YXOJYEKWYUDG    LHNSACK         FUTTXHPOCL      OEHBRPWTKO     
FYSM            : EESGCHSR        FTLWXDJQHFUNMA  WDOIFAYI        HMVVBYKN       
BLUJKWPYPLPBDAV : HKLOFGG         GWVVMBVFPHH     YULCUIEUQTKBEHE
HJNVHSYUAFDBAPI : AWLCGWDM        FXQJUSLUJSCOSHD XSHQRLTNXKSKFLC TXULA          
BFMLCFMTQEVVG   : DRPHTPFCCYTDCF  AWLCGWDM        XJMN           
OOGEKNWLIAQNB   : XCAJTULB        SSQTPBHRTWODOU  WTCK            NYHMRFNSMDE    
DJUG            : IQHDAK          FIVWQOLEKHVGD   LCGQHURW        FUTTXHPOCL      KUFVGB         
ITSNIPGPNC      : WXGITNK         AEODOB          DICFB           TEWALEVHKLMW   
HSMNWWDVIOV     : XALHASQQO       NLCGVGKR        MEYQXYL         VYTLQWXFGXE    
CAVIJSOBDLV     : PVYSKIUOAIVGU   JFNR            QCBBVDRSH       LRQTOAYXQCETU  
TLYJ            : NTDENUB         BEBM            VBCGYWJNYTW     LFCBDCHFWK      BGVMWDM         TSXSJVJ        
DGJVSYUSD       : MIOFD           ROIEVCEIJLRWX   YLAKSAXMBPSA    PKGYRM         
DRPHTPFCCYTDCF  : BFMLCFMTQEVVG   UIFMEJQGCM      FEFVLWRY        YXAANUWRXQMIS  
XYPWLQD         : AFPPK           VDQIXPSAVSVPOEH PHGNKUCFV       FLCWWVL        
ABMA            : NKHKWBTTOWI     CCGFCNFIYUPLTHI CCHHHUQPMFSE    IXXPGFUDRQ     
HDQLWGUSWBXB    : ECXDJIAO       
RGEYHEAWC       : VCIXENWGMYB     BNQY            TXULA           KGOXV           LUML            CIUUEDMUYG     
OHFQIUSHCXXPUH  : VIDBLE          XOSBVKKAS       HMVVBYKN        MIPRGLCVAS      DDQCMGBMA      
OEMOHOINUH      : XCAJTULB        YNCL            PFQSHW          FEYFSFWQ       
AHUEVLLBCVXVEB  : NAKVCO          KBSEJNSY        MVERLLCBRMOAP  
EQRLEIRSWYH     : LXSXA           VQKL            VAWD            QQCMHQLWKLQPM   WFEHWICMPYNDB   EGEKB          
MFMIHVDLT       : QCKQEVQ         MEYQXYL         LWUPDIURNEUQSA  CEFO           
YXSWVQBW        : OXLFXXBCNTBQL   CKMKBISUEP     
GQHRUPKOM       : VTTGPEMUXYXAIMV PEHSRKGFDXWCY   XARF            DICFB           PTXYPBIUEWTHG  
XTYFI           : HKLOFGG         DLNVMWEFHJRJVSB EVFJCSKJJATY    BAOEWKPNRTONX  
MGMABDBYXYURC   : QEBKXXPLTNOYHCM AETED           FBQD            CRBCODRSM       PEIMLSA         EMNWEAKADIFBVRX
HKLOFGG         : BLUJKWPYPLPBDAV XTYFI           LBBMPDWFLBG    
WUDXOCDW        : LMDCL           NPGG            TMWU            SPGIDFD         MAYBKLVWHKBTIRO
SDAU            : MSNOPI          HHEUFVMRIG      HHCU            JUBYKKIUFQAJGKM
FWFEXBXAV       : HFBKQQWHDPXW    QFVENXV         FTLWXDJQHFUNMA  QRWFMDDLUWKAHG  RWDTBUDROIAJOIX PDMHGII         AQDKM           ADVJNY         
NHVSPCKPWNN     : RSGFXIIYDLLJSLC RLWIPSUTSWXYC   CJWVUVFBT       UHOGYHMBHIQAJ   JNTDCSW         GSGTISJLRPRBGNA PBQRL           IWMOKXVWFHDYH  
SSMELRFJYKGEQGH : GHDTLQO        
GFXVMVOFXYUWPKM : NOFV            WXQCEPYDCC      YIPJ           
DYORRVBQJJWAPFT : PIFOQFJED       IWBDVSGYH      
KRUAOJHOLEODO   : ITPXDKNUFAAGXQM WNXLMWOTXLQTIA  WYNTJMTUFEA     WJOLOYFNKCAPA   CKMKBISUEP      BHBTFHUXHJXFS   VDVPMRAWIHN     XIWKOUEM       
NTDENUB         : TLYJ            YXOJYEKWYUDG    HDLTU           RIVXLTHALQG    
NMAKMRRIQFBN    : OKMRGDRPKDF     WSDXSGX         ENTYTDO        
RWOGKSWPJBFFE   : QJTHRWRDKII     PTAR            OHYCPHJDET      YIPJ            UWRQFWLHIKTYUWY
TBNKO           : SXCYTS          MDNVNTT         PXGBRWM         VLQJFPRIOUUFRIA SRWMDWIBVOFFUR 
LBODVXV         : VIDBLE          OQUWIJDF        CCYLQLM        
YJKQJYYVTWMF    : LGXQAHFU        CTASTFK         WCHRL           JRGGXVFCJLA    
RKEEGFRRVRFYJK  : YIHJVDV         DHPBTAN         MAYBKLVWHKBTIRO
HHXGSI          : TPLHWTDBIQARW   BGVMWDM         JKGIWWDBKBBTTY 
EJABFYPKYJXDOE  : MSQCFGIDPJGD    GTNXKOMW        NQCD            GTSJXPI        
IVGDBGMODTXC    : YNCL            OPPCPMSDTBGHFRP CFBCOPVFKP      DOEDDMCXWPFUAPR TFOOM          
QKDXUDBADQ      : EDMBNNWJSGSWSA  NVMPFMKMHHYUCSE
ECLISPUCOCHRKT  : JEOVDJG         QJHGYXOEVWCWQ   ICRYWO          ASGPYCNYDVSSAEI AHRJKGJJKQN    
NPERRXDUVAA     : FWRKYI          LHDLDUIGWNMI    LUTQHQBUENPXY  
AFPPK           : XYPWLQD         WFCNIB          EMHWMVINGK      DNMLBDGUGCXFI  
BUNTPRITYAGU    : TDTRTPYRWU      NTQHYQB         OQUWIJDF        SWCIQYXFYUWBYM 
UKPMENRBLRB     : OHBQELXTSKKYMA  LJFYQEGKVVRU   
UJAKTUOOIIGC    : WXQCEPYDCC      VFLTQP          OEAIUMFBMGPO   
DBSJXEGIUVMKNN  : QEBKXXPLTNOYHCM GKUSBPLCLHB     VOFVEGAHTT      FIVWQOLEKHVGD   YBWHWWGDOEF    
IQHDAK          : DJUG            YIFYVDDPI       RAHFLTAYFPS    
VFEMPOTTHWUDG   : KJOKBB          SPGIDFD         EFRQFJEKSXOP    MUWDCCNAGUKN    RNSQVBNSUEATSKC CVAIWDSVRLGNQ  
HPDE            : NTVWPM          QDPVOPQJMGGWEW  KTCNSTQXGL     
RPYHO           : CCAPVUMTLXBXHGK YIEYHLWTMF      FXJM            QQCMHQLWKLQPM   LBBMPDWFLBG    
XXMBIFW         : POINBHKXGD      MXNOYNCP        EVSEG           KSIG           
LMHBGBIFXLNSVD  : LGXQAHFU        SUCMQCKX        NSNQCSD        
COPTQYIAAJPB    : MRRJCLNOJJQPFTJ JTAE           
UAMIMTJUXUAX    : LPQLXNF         AEEGTL          WUFIMWWPRQ     
QTGTT           : SGWHBJO         YXFU            CJXCHVSDOCIHC   KYTFCTPM       
LMDCL           : NHWFDQHAGAMMSW  WUDXOCDW        UIFMEJQGCM      BOGHTW          UUEHY           GQIHQ           OGWIA          
CLXR            : AYTJFSCGLLRNR   EQKHKFUSPTNR    HRJRXANTFMQPJMM XYEGSU          EMQGQXPXUGPHNI  JUBYKKIUFQAJGKM
ROPGAEDJABGC    : AHHCPMSFRL      CNXHSFBAYQ      GQDLQKDCNKUOEQ  FCAG           
RSWXPRJBGNDREHE : IXPGIFIOV       CFBCOPVFKP      SXXDEMBFO       JPGJ           
CSVSKDSPGFRJLTM : UVGPO           EKVUCWSA        VXWMQHX        
PMEFGNGMDLEH    : XKMAG           FGBDROFXANVQ    QXWOMSLSMDRKKBR WJQDGXGQO       BALDYAXTYHTUX  
KLWEKQQ         : LMNTOSM         SRWMDWIBVOFFUR 
LGXQAHFU        : YJKQJYYVTWMF    LMHBGBIFXLNSVD  EYEJHUB         BAOEWKPNRTONX   PTND            KGOXV           ODVYFHWQY      
KKIQROHABKNIU   : FHSVQRGAVLDMGY  KBSEJNSY        HIFEONGWJB      UHJYLPKCJ       AEOK           
SGGYSYQIKYGEAPJ : XBPEDDJVNGRHHEL XYOIOPE         CYWVWNNFK       FYQRNP         
MTJWLBMSBPFO    : OKMRGDRPKDF     AOUD            HPLMDUYTKCWEY  
AYTJFSCGLLRNR   : CLXR           
NKHKWBTTOWI     : ABMA            SISIUBT         IMSLFBL         RAHFLTAYFPS     DLJS           
ABRQBTPW        : CQEY            KUQFPJUU        NJNRVHNPDKTNSWP NQTD            GPISJQDCAJCEPD  MSDX           
XQIEEVXRPV      : KBSEJNSY        OWNLNUXMJGPXNQS QJTHRWRDKII     SXXDEMBFO       EFLLMNYYENKK    OGWIA          
ADRWHNTXMEIMFC  : RYQL            JSXXEPTXAO      KFBFKXNPY       KSSG            LBBMPDWFLBG    
JVTGCTYK        : UCBIOTBDLDR     PYWIW          
EGWXVS          : QPNPCMXOROERBPM MIJOEOCKJFFHR   SXIPPWMFJCCH    MKDD           
WYAVGQ          : IOFANFRO        ULGBDXBIC       XEFSILGIRGEAY   HGTPDIFWAAKAKXA
EDWOQEQV        : MLKDAP          BTETAOXDQI      GCOTNOFWT       GQIHQ           ROSSGYU        
PRWRLVCMC       : JKONNJOICTM     XGTAYNGLSP      XYFQW           GGFW           
JBGEJFDLELC     : HTOTWORA        XYEGSU          TYSH            WIKETFRMXGJU    ECXDJIAO       
QISHBABWNQRMI   : LCAJAUFS        WGGAHKHISWNKVIL RAHFLTAYFPS     SOVMBWUEKDUEDR 
JMPNWBQFGANL    : TRXNIC          RLWIPSUTSWXYC  
RAQNQYJA        : SWICUODPG       CUYDUTQHHH      WDFYWW          EDDOUTMHLENYLIS FUFRAGGYNCHQ    GOPWU          
JBAYRRMAUXON    : IIONFMWWGPBHVS  GTPEWAV         PVLJKIHXPOKO   
NOFV            : DLVXBDRMMR      GFXVMVOFXYUWPKM HDCYDTKHJRASQ   IFPFC           HBPKCILMU       LJFYQEGKVVRU   
FJLTDLNSEOEE    : RYQL            XAVEVOOUTDBKDL  BGPFQWUYV       IKRTUSHQNX      FCAG           
NGRPXJCBGCR     : MRDVJHWGAIKPAV  WNQL            DRBCVUEQBVHLXRA PTND            VTKM           
PGNUCMDNXYSLMNP : IWBDVSGYH       PEHSRKGFDXWCY   MRUNBBAPEPO     WCHRL          
SWTIDNXDWC      : DNOFSVL         MTDXW           DADJVXP         TOFG            THGV            UGMWQMVQCIPJ   
FEYCUHPP        : LBSOIELONXFLXG  EDMBNNWJSGSWSA  GFLVJFFFWNNN    SCTSDAFBHSCRHTY
CUYDUTQHHH      : RAQNQYJA        XIDX           
CGHLJUJOTOVCU   : YVMXG           CQSGRVTYVO      DMWADYIG        VCSRBRDGUFQCBNR EVSEG           BLCUQEQJSVVMSL  XJMN            FMRGHVLVPP     
GREXKPCFQFAKW   : NTQHYQB         LBBMPDWFLBG     HPLMDUYTKCWEY  
TGVWMEIXBT      : QJDEVPXCJXY     ELHPIVMIRUTK    KXYFDLVGATTO    AURADPBUVGRYA  
XKMAG           : PMEFGNGMDLEH    VBCGYWJNYTW     TFOOM           CHRVYVHEUJGGJ  
IXPGIFIOV       : RSWXPRJBGNDREHE HJPWW           BFVRTTNGJGUUK   CBMLLWRWDHW     CHRVYVHEUJGGJ  
OIPYDVVAKCK     : YCPM            TFIGTU          KPRX            AUBU           
FGBDROFXANVQ    : PMEFGNGMDLEH    JURPGMK         QYIEEBDJWOQ    
HVFVUVKDNMILIK  : XBPEDDJVNGRHHEL YOMPRQWQWD      ANCOEOING       SSFBSWNXQBQ    
MUIRCLXVA       : DNMLBDGUGCXFI  
TDTRTPYRWU      : OSSQJRHU        BUNTPRITYAGU    YUUXR           LWIEW           CKMKBISUEP      KYTFCTPM        YKBNOSMWF      
SISIUBT         : YVMXG           NKHKWBTTOWI     PSIQU           YQADFGNDUNWVV   DOEDDMCXWPFUAPR NWLGEOEYOF     
MRRJCLNOJJQPFTJ : COPTQYIAAJPB    EHLN            MLQFJWULRXEDY  
PYWIW           : JVTGCTYK        JLAOLOJ         UYPPAIMTOUSRFY  DFDXFAGVSIV     FCPOUMP         NGUCTPEUHRDA   
WRDP            : SILS            VBCGYWJNYTW     OPVCA           UCDMSBPDOOVV   
ATWHIPBTTMI     : NTTCPYGOUSK     SGWHBJO         ROIEVCEIJLRWX   KSSG            MPAWEGHPSYXM    EJMPCXXUPIJNE  
YTAOAVXX        : KXGSA           AKEIKJDLVYFQLJA APDUBXAVGKNCH   NAKSYNPJKOP    
YUUXR           : TDTRTPYRWU      EQKHKFUSPTNR    TOJX            PHNCMKHVFDNW    MVERLLCBRMOAP   WCHRL          
SUKVWG          : OHMPJA          IUNHWJFR        GNEYGOV         NAMS            VPDFOXJDBB      YMEMAVEINEGVECG LHDLDUIGWNMI   
EQKHKFUSPTNR    : CLXR            YUUXR           EDMBNNWJSGSWSA  CJOCDMNQFBCFGJ  CCKLSJLAJGWKH   KLINXV         
POINBHKXGD      : XXMBIFW         SFIAPEBGHSMMQE  KPHPQVXFYTGHCE  MKDD           
BAEWAMPG        : VTQFUGDXHROIELJ HKYNKYA         FPWVPMVNSLU     XEGBNKOMJFFCW  
DOOILJXFYSPOHA  : STTGCJLBF       GGLIIRFMWNFS    XIDX           
KHPK            : TSRTFFBHQR     
UEQWLNW         : QJPFPEBUEKBKDA  ANDVXAXFQPEL    EMNWEAKADIFBVRX AALWYTT         HKLMUTJT       
GEEJSUTGGTLIM   : DNOFSVL         FPXHHPLLQB      FUFRAGGYNCHQ    IUAHQRV        
WTDEGMVQFQXXPJM : LHNSACK         QJPFPEBUEKBKDA  VAIHLKIF        FWRKYI         
JURPGMK         : FGBDROFXANVQ    MLKDAP          RIVXLTHALQG     CHGWWHXLQGUO   
STTGCJLBF       : DOOILJXFYSPOHA  OHBQELXTSKKYMA  ELHPIVMIRUTK    YOBLGGKBROWD   
FMDBFKT         : AJVELG          ENIDCHY         NFCDYPXI        SAETFMRJAIBLG  
JKOVA           : VSFXGT          YIEYHLWTMF      FIXO            KPRX            OLBWNDPJFK     
STQYIEB         : MEQJGTUWOVCCY   BLCUQEQJSVVMSL  HKMHFI          WIKETFRMXGJU    JXHNPEVWWMSXJJH
AWLCGWDM        : HJNVHSYUAFDBAPI BFMLCFMTQEVVG   MIDGDN          KPEUDAQGADTLIC 
LBSOIELONXFLXG  : FEYCUHPP        XKFHJLKF        FYQRNP         
RAFAGIFGFQKON   : EGDKCFGWIMXK    XHGFRWFCBVX     DUVFPGMEMOJY    UVJQFEYVCF      SHDDNJDUDKRV   
DDBGXQ          : SWICUODPG       YERNRYXC        VPIHNFTCJF      BGVMWDM        
CCFRALFAT       : IASF            DUXKNRWTDGLCO   YNQSYQB         HDCYDTKHJRASQ  
TTSTCBBKJRUAHLF : YOMPRQWQWD      JVHD           
MLKDAP          : EDWOQEQV        JURPGMK         WJQDGXGQO       LJSEJXPLDJRE   
GHJTPLNBFKUB    : RFSQDV          ITPXDKNUFAAGXQM XUCAERI         EJORGKLOBOJGCB  OWHRTHHUIEVL   
XCAJTULB        : OOGEKNWLIAQNB   OEMOHOINUH      WGGAHKHISWNKVIL MIPRGLCVAS     
QNTCYYFOJNXUJNH : NTTCPYGOUSK     PIUY            FPIYO          
PMHMOYMQYYNTK   : FKQGSOOP        JAGEQCRONA      MSMRNYMVGV      POXCAIBKWGJEOK 
DCFYGGXNUJBU    : WQYRBEBQK      
KJOKBB          : VFEMPOTTHWUDG   PSIQU           FYUMO          
PRSCLR          : CGMXQIGADMVUF   RJSLUTOSBVQSGLL IJBLALSB       
YOMPRQWQWD      : HVFVUVKDNMILIK  TTSTCBBKJRUAHLF EDDOUTMHLENYLIS IRLPPOTGWDBTOXJ EJORGKLOBOJGCB  CFGLCPWI        OCOAX          
LXBOVICFW       : MXBERFUIGRR    
IXGXS           : HLWNHXPWEDR     BOGHTW          MCYERLKAP       NQCD            BYXCVM          SBWVISJUF       LWUPDIURNEUQSA  EMHWMVINGK     
AETED           : MGMABDBYXYURC   JBWVSVHYLSWC    FEFVLWRY        RAHFLTAYFPS    
QUAJSSGV        : GOPWU          
TWNJSVLASXI     : FPXHHPLLQB     
GGLIIRFMWNFS    : DOOILJXFYSPOHA  BVCP           
ONJXLV          : MIOFD           LDEKIX          HDXDPFGQRIAMMDK RGWVFGVPNRL    
IJBDHOFCOPX     : MIDGDN          NTVWPM          NQTD            LJFYQEGKVVRU   
VLGHELVBCCVS    : OEAIUMFBMGPO    PMIQV           GTSJXPI        
JEOVDJG         : ECLISPUCOCHRKT  GBDUHGIO        ELHPIVMIRUTK    IJRSR           LJSEJXPLDJRE    BBBC           
KMWCRBQIYO      : SGIFNVLPSDQPR   HIFEONGWJB      RMRWOIEP       
LXPR            : WXQCEPYDCC      YIHJVDV         YSFQHDVDWRD     PFQSHW         
MSNOPI          : MEQJGTUWOVCCY   SDAU            CRBCODRSM       DDFKOQY         LHHEHHEQ        PDKOGXXFPLUF    KLINXV         
YNYWSKEHWQGYKIS : MEQJGTUWOVCCY   RYWMRHNVYLVE    TTPGV           IUAHQRV        
HHEUFVMRIG      : SDAU            LDEKIX          NEWXYMI         FRNJSWSNMSOXRB 
YXOJYEKWYUDG    : FLULWDDLH       NTDENUB         XNXDSGORBR      PIQXWGFTF       QGNO           
VNRIVKGFT       : QPNPCMXOROERBPM WNQL            POGRGVM        
BCGNTRVBQT      : JKYHYFKCTTSUN   HPHCGPDASRWX    AQFUSRNEFCTJMO 
CVXMUWHAE       : ITFIUGTPSBX     HPLMDUYTKCWEY   EQCDAJSLXVGXST 
VTTGPEMUXYXAIMV : GQHRUPKOM       LPQLXNF         FQOQVYQYATR     SEDWXWOBLX     
IASF            : CCFRALFAT       NTVWPM          HKGALRCDDN      FPIYO           QCBBVDRSH      
VDQIXPSAVSVPOEH : RYQL            XYPWLQD         AFXR            VNQTHDEAYKYCDB  VYPECCOSO      
RFSQDV          : GHJTPLNBFKUB    SYXXJUPXAKOU    FYUMO          
PRBBT           : BWDDNW          RHAUBNEJAUJOR   CCHHHUQPMFSE    SXWVSROLVIVKKNC
IMSLFBL         : NKHKWBTTOWI     VOJHKICMAGL     EVSEG           EFLLMNYYENKK    VTHAIHWX       
VLRQ            : LHNSACK         RXFKTEBU        FNLPULOD       
JFPRX           : QNJYUEF         PEIMLSA         AOUD            QQADNWFPHMUJVO 
WTBC            : RQATVWLTT       HDXDPFGQRIAMMDK KTCNSTQXGL      HBPKCILMU       NUDLJTXHP       KNPODOKIEDR    
CUJEVEBGSTTXWHU : BNQY            DEJRXWIFUCEX    TPUNWKKA       
UOKEYQVSQ       : SXMTGIQ        
PKHTAJOMP       : VQLTXOHEJ       VRVVXSM         LHDLDUIGWNMI   
QQSJKMJ         : FITVLUM         IKRTUSHQNX     
TGCOVOUWFRPWX   : CCKLSJLAJGWKH   AHRJKGJJKQN    
HFBKQQWHDPXW    : FWFEXBXAV       CTXWGPP         VFPYGVXG        BACEH           DDFKOQY        
LLKT            : WJQDGXGQO       KEGOTDUGEYVJ    KSSG           
QXWOMSLSMDRKKBR : PMEFGNGMDLEH    XRSUPVJXQWPGL   GOPWU          
LIFKRK          : CHWXVUWAPPR     ROIEVCEIJLRWX   NGYYBBGYXSFNKYE CVSTHG          TGCX            PSJNOEFFRDNQNX  QUGPXCLGVNPQCW 
QJDEVPXCJXY     : JUDXUR          TGVWMEIXBT      EESGCHSR        EXCEBTVC        QQETKMCORQKPN  
KTMFGPYQDB      : HIFEONGWJB      HBPKCILMU       EBXDBBKBP      
TMVY            : BOGHTW          BRDQMXTJPQOLEW  KFBFKXNPY       IXXPGFUDRQ      RMJWPV         
NLCGVGKR        : HSMNWWDVIOV     VRVVXSM         VOPDESTXEU     
ITFIUGTPSBX     : CVXMUWHAE       RCPOXUIWLLLVWAB XHGFRWFCBVX     FNNGEFTTD      
BRPCCJQXKQMWTU  : CQEY            AQFUSRNEFCTJMO  QCBMHQIPANO     YPVY            SAETFMRJAIBLG  
CGMXQIGADMVUF   : PRSCLR          VNEWIYCKHNEY    GBDUHGIO        WSDXSGX         VDVPMRAWIHN    
TRXNIC          : JMPNWBQFGANL    LLVVJAOIST      OEDQGGWM        LJFYQEGKVVRU   
RTQDMFCIA       : ELGJDSTGMH      KGPQQOFWJGFEF   NSENHJMCQ       KRNLKARJT      
KIJLARRCWGXUN   : CTRXUKLTUDOP    IIONFMWWGPBHVS  QTEIWI          VEEK            MYSDF          
QFVENXV         : FWFEXBXAV       WYNTJMTUFEA     PBBOGUMQURL     OPVCA          
TMNHRPRSMDBVQ   : MCYERLKAP       XUCAERI         GHPAOXPEGKDYL   JVXDNOHH       
PIFOQFJED       : DYORRVBQJJWAPFT VOJHKICMAGL     CTXWGPP         DLNVMWEFHJRJVSB OTIJCWBEQVB     HBPKCILMU       TFOOM           KIOMXDFKB      
JYGAY           : XBPEDDJVNGRHHEL MIPRGLCVAS      KLMPFRRCAM     
ITPXDKNUFAAGXQM : KRUAOJHOLEODO   GHJTPLNBFKUB    VIDBLE          AQDKM          
BTETAOXDQI      : EDWOQEQV        MYLAWGVLJKWKM   BHBTFHUXHJXFS   DDQCMGBMA      
XKDBUYSSEDG     : AILOEF          DDFKOQY         HPLMDUYTKCWEY   GGQNTAWQH      
IICRIVGXY       : WNQL            QNJYUEF         YPVY            ECXDJIAO       
CTASTFK         : YJKQJYYVTWMF    XGTAYNGLSP      VCVIREYT        WQFDDCNUTNOX    XKXVDSS         KFBFKXNPY      
JKONNJOICTM     : PRWRLVCMC       UIFMEJQGCM      TFOOM          
VWSAQBXWB       : HQTKFJJP        OXSRIAPRMQXS    FPXHHPLLQB      DBVTBAH        
XGTAYNGLSP      : PRWRLVCMC       CTASTFK         DEJRXWIFUCEX    RNHYUKQRHAQXU   MIPRGLCVAS      PXGBRWM         KENX           
HDLTU           : NTDENUB         TXULA           OWHRTHHUIEVL   
VOJHKICMAGL     : IMSLFBL         PIFOQFJED       PIUY            DAODDIFMOQIQRNH AUBU           
HLWNHXPWEDR     : LVRK            IXGXS           KXGSA          
CCAPVUMTLXBXHGK : RPYHO           LPPEMGSRVMPTDD  OVHCSC          NEWXYMI         CTSWSQOYS       QCBBVDRSH      
MXGVLGKUE       : HQTKFJJP        VNEWIYCKHNEY    AJVELG          AEEGTL          JECMWBHJHWC    
UIFMEJQGCM      : DRPHTPFCCYTDCF  LMDCL           JKONNJOICTM     QHEXCDSDWFEV    QRWFMDDLUWKAHG  OSVAGGBFP       MLQFJWULRXEDY  
OJOPKM          : GBDUHGIO        IBDYTKWRWWSDGDT FQHVWI          VYTLQWXFGXE    
QAIFXQCM        : FAFPFB          XAVEVOOUTDBKDL  BFVRTTNGJGUUK   XEUQLOSUUG      EJMPCXXUPIJNE  
OHBQELXTSKKYMA  : UKPMENRBLRB     STTGCJLBF       PHLITTFXHQ      RSRUAJX         GPISJQDCAJCEPD 
BJTSV           : VSFXGT          DNCKGYNSPPGPLM 
RNJCUJTWXSLIW   : BKCIUB          YIPJ            WGSDQOQMLGNQJ   SYXXJUPXAKOU    SYEPSHSII      
MIDGDN          : AWLCGWDM        IJBDHOFCOPX     QJUDPHRAHGLOV   JPGJ            XRNXSH         
FARKDDGWYPQOBTK : XXPBNL          SUCMQCKX       
PHLITTFXHQ      : OHBQELXTSKKYMA  RNXLHC          SPGIDFD         AJEXOTWNKGWQ   
NTQHYQB         : BUNTPRITYAGU    GREXKPCFQFAKW  
WESVGKMUMGHAXPN : MHLFTIMAJ       IUNHWJFR        PWUNMFQ        
LIOL            : HSLTRYVFSWDHX   AOPB           
HPHCGPDASRWX    : BCGNTRVBQT      CTRXUKLTUDOP    QAGBWW          OCOAX          
SGWHBJO         : QTGTT           ATWHIPBTTMI     JPGJ            DUKYJOPRVERQT  
LOBAVOKNAEUPL   : YNCL            QJVPMBQOQOME    PDKOGXXFPLUF   
WDFYWW          : RAQNQYJA        NPGG            FPIYO          
WJQDGXGQO       : PMEFGNGMDLEH    MLKDAP          LLKT            QMQDWC          GFLVJFFFWNNN    XASTVVTF       
EESGCHSR        : FYSM            QJDEVPXCJXY     DUVFPGMEMOJY   
WNXLMWOTXLQTIA  : KRUAOJHOLEODO   SSMALTDMSVNGT   EMNWEAKADIFBVRX
LHNSACK         : FLULWDDLH       WTDEGMVQFQXXPJM VLRQ            YKIKNQNLQOOXNF  TMWU            WTCK           
IGPNNIFXGUY     : MXBERFUIGRR     AGXQLFHXBTICWI  OMBTOCOGGMXSME  FEFVLWRY        YGACMPGYWGO     WGBXDKOTMUJKCB 
KXIEW           : MKINHAYBJHL     QTEIWI          WTCK            PETMHUBKAM      LUTQHQBUENPXY   WULDL          
VSFXGT          : JKOVA           BJTSV           SWMYITQSREC     PAENYKPYWUS     AUCVXPFICEVNFV 
TOJX            : YUUXR           FUTTXHPOCL      VXEMGFBM       
QJHGYXOEVWCWQ   : ECLISPUCOCHRKT  LGROEUT         MTHDY           YIPJ           
VAQSWOL         : JSXXEPTXAO      IKOAOJDCCDE     UVJQFEYVCF     
NTVWPM          : HPDE            IJBDHOFCOPX     IASF            VFLTQP          BLCUQEQJSVVMSL  PJYRNLXXPLX     TDNQHSKHOL     
QOXAVGBTWFSWJPN : EDDOUTMHLENYLIS RABHJSNP       
LPPEMGSRVMPTDD  : CCAPVUMTLXBXHGK ALUEJGLIMORYGT  MXBERFUIGRR     IEKBMX          BYXCVM          MVKHFWSTAHFG   
TRBVNJWK        : OQUWIJDF        UAYDF           AANVSTOCOKYBEM 
EDDOUTMHLENYLIS : RAQNQYJA        YOMPRQWQWD      QOXAVGBTWFSWJPN TALNHEHVXUTJQ  
VIDBLE          : OHFQIUSHCXXPUH  LBODVXV         ITPXDKNUFAAGXQM JVHD            HQUUSCY         VAWD           
FHSVQRGAVLDMGY  : TPHXDDYTR       KKIQROHABKNIU   LJNNQREU        KGPQQOFWJGFEF   IIFDLHIOODRIKNI XVUKOVXEFKVXC  
PLGGMTOFC       : WGGAHKHISWNKVIL ODVYFHWQY      
PHNCMKHVFDNW    : TJAB            YUUXR           YPVQEVJC        JVXDNOHH       
PVYSKIUOAIVGU   : CAVIJSOBDLV     YXAANUWRXQMIS  
VCVIREYT        : CTASTFK         DLNVMWEFHJRJVSB NRBIUTHD        XEFSILGIRGEAY  
LEORJEQXTOWP    : VBCGYWJNYTW     TDTQIXQMCT      VXEMGFBM       
FKQGSOOP        : PMHMOYMQYYNTK   ENQCQJWLBDNWCV  PIUY           
MRDVJHWGAIKPAV  : NGRPXJCBGCR     MRYTFKSGKWMDTAG CCKLSJLAJGWKH   FUFRAGGYNCHQ   
TTQIT           : XASTVVTF        BBCKNITA       
KBSEJNSY        : AHUEVLLBCVXVEB  KKIQROHABKNIU   XQIEEVXRPV      DVWS           
ALUEJGLIMORYGT  : QEBKXXPLTNOYHCM LPPEMGSRVMPTDD  JBXINR          OGWIA          
CNRSYNBLPVR     : GXQDVW          OPGOEXH         FMRGHVLVPP     
JLAOLOJ         : PYWIW           KLIJ            LXVTYBY         PBQRL           KUFVGB          FMRGHVLVPP     
AQEJFUB         : AEARCLENVLN     DGXCFRBITJUGNXG VNQTHDEAYKYCDB  QGNO           
BWDDNW          : PRBBT           AFXR            IIFDLHIOODRIKNI XRNXSH         
MLCABB          : ICRPI           LDQVDTJH        XWDCJELKOEQDR  
CKGFARTLKTEQD   : OXSRIAPRMQXS    OLFXLQYQGXTE    AEOK            JSDFQQJUCD     
LGROEUT         : QJHGYXOEVWCWQ   RSRUAJX         VHMOJEMG        EKLICT          FQDSRKKVDXDXLM  NAKSYNPJKOP     RXPVEPYBN       SRURQRB        
LGROEUT         : XCKGQTGPQTTCM  
RSGFXIIYDLLJSLC : NHVSPCKPWNN     OFYVAGNDMWEC    YGACMPGYWGO    
AOIE            : DUVFPGMEMOJY    LNSKJXFGDMFYP   JRIUOQCESRFI    FNNGEFTTD      
OQUWIJDF        : LBODVXV         BUNTPRITYAGU    TRBVNJWK        QTEIWI          CROKVEABNCW    
UAYDF           : TRBVNJWK        GWVVMBVFPHH     LJNNQREU        DLAJDIOVFTQC    NDBJQUYSAYXJWXB FMRGHVLVPP     
OOXRC           : RUWORVMB        ECXDJIAO       
CWXGLAWVGEM     : OMFLWS          XNXDSGORBR     
YKIKNQNLQOOXNF  : LHNSACK        
LXSXA           : NAKVCO          EQRLEIRSWYH     LCGQHURW        UYFSA           QTEIWI         
XIDX            : CUYDUTQHHH      DOOILJXFYSPOHA  BUQHYCPXYCFGROR IJRSR           AEODOB          VTHAIHWX       
AGLMGKWPUNIKYBA : WDNNIQPNEXSML   OKMRGDRPKDF     IIONFMWWGPBHVS  QQCMHQLWKLQPM   CBMLLWRWDHW    
YPVQEVJC        : PHNCMKHVFDNW    DMWADYIG        AXDXFNKSGBLEE   YSFQHDVDWRD     EMNWEAKADIFBVRX
CCGFCNFIYUPLTHI : QEBKXXPLTNOYHCM ABMA            ELHPIVMIRUTK    XYEGSU          LXVTYBY         HKLMUTJT       
PSIQU           : SISIUBT         KJOKBB          YIEYHLWTMF      QGVLJPAACL      KIOMXDFKB      
RLWIPSUTSWXYC   : NHVSPCKPWNN     JMPNWBQFGANL    YAMF            BACEH           KLMPFRRCAM     
MKINHAYBJHL     : KXIEW           LWIEW           JNTDCSW        
CTRXUKLTUDOP    : KIJLARRCWGXUN   HPHCGPDASRWX    YOBLGGKBROWD    LFCBDCHFWK      MRYTFKSGKWMDTAG LUTQHQBUENPXY  
HMUIRWWE        : MPAWEGHPSYXM   
KLIJ            : IHRYXAYFDRMF    JLAOLOJ         XHGFRWFCBVX     DICFB          
RQATVWLTT       : WTBC            CCYLQLM         AKEIKJDLVYFQLJA YGACMPGYWGO     HKLMUTJT        KIOMXDFKB      
HQTKFJJP        : VWSAQBXWB       MXGVLGKUE       WDNNIQPNEXSML   XTSOVYNIMSLTD   GTNXKOMW       
GXQDVW          : CNRSYNBLPVR     VEEK            MKDD           
GKUSBPLCLHB     : OSOIR           DBSJXEGIUVMKNN 
DUXKNRWTDGLCO   : CCFRALFAT       MSMRNYMVGV      NQTD            VOPDESTXEU      CFGLCPWI       
UTHTHQEE        : KTREEVVUTAUEB   OCGSOXRFBSHWKL  NGUCTPEUHRDA   
IVWKHFNH        : NAMS            JKWGHE         
KHVYYSUECGJQRGN : DWVHVKB         XMEXAYEPINC     UQWOLAMIYJH     XJMN            CHRVYVHEUJGGJ  
BUQHYCPXYCFGROR : XIDX            YIFYVDDPI       KGPQQOFWJGFEF   SDECEDKSYBWCCS  KUFVGB         
VNEWIYCKHNEY    : CGMXQIGADMVUF   MXGVLGKUE       FYSPHPKDCOEIH   IKYW            CLAOUPVVPBEL    KEGOTDUGEYVJ    OMBTOCOGGMXSME  YGACMPGYWGO    
RYWMRHNVYLVE    : YNYWSKEHWQGYKIS OLBWNDPJFK      KTREEVVUTAUEB  
CVIVBFJF        : JBIYQVWALDRTWB  TXULA           CEFO           
SGIFNVLPSDQPR   : JUDXUR          KMWCRBQIYO      ELHDHLIAVIBC    AGXQLFHXBTICWI  IWSPCSBF        FXMNYRML        WFLTEOVH        WHSVDYJ        
YIFYVDDPI       : IQHDAK          BUQHYCPXYCFGROR NTCSFEVOVME     SPGIDFD         QCBMHQIPANO     PGJGTCLXGRE    
BEDIQIMLRVQHTF  : XJPRQEYDRNCNY   BACEH           EXCEBTVC        PKTVV          
MIOFD           : DGJVSYUSD       ONJXLV          RGVIKU          RMRWOIEP        GGBYDTTYXHICBAN YLAKSAXMBPSA   
ELHDHLIAVIBC    : SGIFNVLPSDQPR   LDEKIX          KOWHW           XHFV            TYSH            CIUUEDMUYG     
JSXXEPTXAO      : ADRWHNTXMEIMFC  VAQSWOL         QJPFPEBUEKBKDA  BAOEWKPNRTONX  
WDNNIQPNEXSML   : AGLMGKWPUNIKYBA HQTKFJJP        RFMPLVSGIEPI    RABHJSNP       
OHMPJA          : SUKVWG          EVFJCSKJJATY   
FXYLQTJQKOPN    : KRYTQVWJCEILOU  FJGYKWMTHYBFNEH CCHHHUQPMFSE   
GWVVMBVFPHH     : BLUJKWPYPLPBDAV UAYDF           CHPMICRJIDT     ANDVXAXFQPEL   
QVVDVWIWV       : IWBDVSGYH       AGXQLFHXBTICWI  SSQTPBHRTWODOU  MDQSXAAGK      
NPGG            : WUDXOCDW        WDFYWW          GGBYDTTYXHICBAN EMRSRVUEHIBCHG  SXMTGIQ         BHBTFHUXHJXFS  
WXQCEPYDCC      : GFXVMVOFXYUWPKM UJAKTUOOIIGC    LXPR            YOBLGGKBROWD   
HRJRXANTFMQPJMM : CLXR            HPLMDUYTKCWEY  
FSFJPD          : LJQPNC          QTEIWI          SNJI            NUDLJTXHP      
SKRTNTVOE       : WHSVDYJ        
XXPBNL          : FARKDDGWYPQOBTK XKFHJLKF        AEODOB          QQADNWFPHMUJVO 
CCYLQLM         : LBODVXV         RQATVWLTT       IOFANFRO        ACDJO          
ETIVAKQKDMA     : DRBCVUEQBVHLXRA SGOCBCFWAW      YTYSSMFOX      
IOFANFRO        : WYAVGQ          CCYLQLM         NJEEYLSYIYQLJM 
DWVHVKB         : KHVYYSUECGJQRGN AJSKBVX         MSMRNYMVGV      FXMNYRML       
WYNTJMTUFEA     : KRUAOJHOLEODO   QFVENXV         QJYUOFES        BAOEWKPNRTONX   XIWKOUEM        MKDD           
GBDUHGIO        : JEOVDJG         CGMXQIGADMVUF   OJOPKM          GTSJXPI        
YIEYHLWTMF      : RPYHO           JKOVA           PSIQU           GFLVJFFFWNNN    NUYFK          
OUMXJISPOUK     : XNXDSGORBR      LNSKJXFGDMFYP   MRUNBBAPEPO     STBI           
WNQGTBUUB       : WHSVDYJ        
YCPM            : OIPYDVVAKCK    
JAGEQCRONA      : PMHMOYMQYYNTK   JBWVSVHYLSWC    DAODDIFMOQIQRNH VOPDESTXEU     
FRFP            : VAIHLKIF        KRNLKARJT       QYGDRJAYXCFRQ   FMRGHVLVPP     
EGDKCFGWIMXK    : RAFAGIFGFQKON   LCAJAUFS        VPHIGX          PDKOGXXFPLUF   
LJNNQREU        : FHSVQRGAVLDMGY  UAYDF           IEKBMX          MVKHFWSTAHFG   
UKOFQGNISROWDR  : KPRX            UGHFQYUCLUW     GOPWU           DCBATYPVNWKNUOX AHRJKGJJKQN    
LOOA            : RUWORVMB        PDMHGII         TFMJJUEEYKQTJA 
BEBM            : TLYJ            QJYUOFES        YIHJVDV         CEFO           
QFJUAXPNMXGSL   : FQOQVYQYATR     CIMNYXDYF       BACEH          
LDEKIX          : ONJXLV          HHEUFVMRIG      ELHDHLIAVIBC    KTREEVVUTAUEB  
VOFVEGAHTT      : MEQJGTUWOVCCY   DBSJXEGIUVMKNN  UXDJ            XDQUSPGBVWIVLNK SQSVNE         
BGSEELRQJXJUMU  : RGWVFGVPNRL     MVKHFWSTAHFG   
SILS            : GYCVTLWEALDSKW  WRDP            RVBS            TMTARSTAMI      WAWSVBDHEQHPKK  KTCNSTQXGL     
HIFEONGWJB      : KKIQROHABKNIU   KMWCRBQIYO      KTMFGPYQDB      YXWTERVO        LLVVJAOIST      XRMKOPCHJ      
LJQPNC          : FSFJPD          MTHDY           JRKAEXJI        SYERVHTK       
ELHPIVMIRUTK    : TGVWMEIXBT      STTGCJLBF       JEOVDJG         CCGFCNFIYUPLTHI CJWVUVFBT       GFVVFKQY       
EUAKKPQHATCLFS  : CFBCOPVFKP      XYFQW           QAMTBSM         ENQCQJWLBDNWCV  HIVD            NAMS            KUFVGB         
SWMYITQSREC     : DGYPIWA         VSFXGT          XRMKOPCHJ       WAWSVBDHEQHPKK 
YXWTERVO        : HIFEONGWJB      ANCOEOING       JFNR            BGVMWDM         CIGGXMXB        GOPWU          
MIJOEOCKJFFHR   : DLVXBDRMMR      EGWXVS          QJVPMBQOQOME    JRKAEXJI        KUQFPJUU        CYWVWNNFK       CBMLLWRWDHW    
RNXLHC          : JKYHYFKCTTSUN   PHLITTFXHQ      VBQNV           TPUNWKKA        MVKHFWSTAHFG   
RCPOXUIWLLLVWAB : ITFIUGTPSBX     WQFDDCNUTNOX    GTBFYV          BACGKHUSLF      UJMUYMKIJHJU    PJYRNLXXPLX    
CNXHSFBAYQ      : ROPGAEDJABGC    PTXQSDMO        BAOEWKPNRTONX   DHPBTAN         DMKMF          
MXBERFUIGRR     : LXBOVICFW       IGPNNIFXGUY     LPPEMGSRVMPTDD  PBBOGUMQURL     TYSH            EGEKB           GGQNTAWQH      
FDOCAOD         : LVRK            BACEH          
SSMALTDMSVNGT   : OXLFXXBCNTBQL   WNXLMWOTXLQTIA  YERNRYXC       
KOWHW           : ELHDHLIAVIBC    YIGXDXMDFYWYI   JKGIWWDBKBBTTY 
BOGHTW          : LMDCL           IXGXS           TMVY            QRWFMDDLUWKAHG  UVGPO           DRBCVUEQBVHLXRA CTSWSQOYS      
WNQL            : NGRPXJCBGCR     VNRIVKGFT       IICRIVGXY       ICRYWO          SXXDEMBFO       RVPE           
JXGUTLJMHWUD    : UYFSA           CYWVWNNFK      
IRLPPOTGWDBTOXJ : YOMPRQWQWD      QCKQEVQ         GGBYDTTYXHICBAN JECMWBHJHWC     JSDFQQJUCD     
LPQLXNF         : DNOFSVL         UAMIMTJUXUAX    VTTGPEMUXYXAIMV NIDKACBBQHHDLC  AEARCLENVLN     DYUFJMRAQXCXHL 
XRSUPVJXQWPGL   : JUDXUR          QXWOMSLSMDRKKBR MLQFJWULRXEDY   PMXGMQRIL       BEAHHHJDOSYO   
OKMRGDRPKDF     : NMAKMRRIQFBN    MTJWLBMSBPFO    AGLMGKWPUNIKYBA
QDPVOPQJMGGWEW  : HPDE            SUCMQCKX        EHLN            IGXF            YXEWWVEFX      
TFIGTU          : OIPYDVVAKCK     YULCUIEUQTKBEHE IFNE            MUURXVO        
MCYERLKAP       : IXGXS           TMNHRPRSMDBVQ   CJWVUVFBT       QJYUOFES        TJGPLRDVVKRWING
FHXWWQG         : PSQKTCFXFUYKTST TRJYQCFPMS      IUAHQRV        
WOID            : DKDMTQGTQGLWC  
FYSPHPKDCOEIH   : XJVPQMA         VNEWIYCKHNEY    TIYVTFHJDMFTOAD FPIYO           BYXCVM          TBERUXOOPHRYKD 
UJFW            : YULCUIEUQTKBEHE RMJWPV         
OWNLNUXMJGPXNQS : DGYPIWA         XQIEEVXRPV      PKTVV          
YIQE            : ELGJDSTGMH      PWJEPLXPKMX     RWDTBUDROIAJOIX
FIXO            : WQYRBEBQK       JKOVA          
SXIPPWMFJCCH    : EGWXVS          PWDY           
OPGOEXH         : CNRSYNBLPVR     NDGU            KFBFKXNPY       CJOCDMNQFBCFGJ  FRNJSWSNMSOXRB  SEDWXWOBLX     
YQADFGNDUNWVV   : SISIUBT         EPWDQXRYMSJL    CCHHHUQPMFSE    RNHYUKQRHAQXU   TBERUXOOPHRYKD 
NTCSFEVOVME     : YIFYVDDPI       VPSVA           CHIPVSSTC       TSXSJVJ         VPDFOXJDBB      HVABPP         
BKCIUB          : RNJCUJTWXSLIW   QIPKRLYJDV      LCGQHURW        AGXQLFHXBTICWI  JRIUOQCESRFI   
WGHDVKBKJW      : IUNHWJFR        ICRPI           HKHMWB          IUAHQRV        
YKEBF           : PIWJPUUFDN      RJSLUTOSBVQSGLL BBBC            JECMWBHJHWC    
HDXDPFGQRIAMMDK : ONJXLV          WTBC            VPSVA          
KPRX            : OIPYDVVAKCK     JKOVA           UKOFQGNISROWDR  RVBS            MIPRGLCVAS      STBI           
CHPMICRJIDT     : OOBDTRJ         GWVVMBVFPHH     WKSFFOQY        MVKHFWSTAHFG   
EYEJHUB         : LGXQAHFU        TJGPLRDVVKRWING FQOQVYQYATR     PTAR           
WQFDDCNUTNOX    : CTASTFK         RCPOXUIWLLLVWAB GEHB            GRSNLST         KRYTQVWJCEILOU  FNLPULOD        BALDYAXTYHTUX   WGBXDKOTMUJKCB 
ELGJDSTGMH      : RTQDMFCIA       YIQE           
LLVVJAOIST      : TRXNIC          HIFEONGWJB      HRTPKNEXI       CQEY            YIHJVDV        
XXCSSRHQPOE     : NWLGEOEYOF      EVSEG           SRWMDWIBVOFFUR 
XJPRQEYDRNCNY   : BEDIQIMLRVQHTF  AXDXFNKSGBLEE   IUAHQRV        
CHWXVUWAPPR     : LIFKRK          DFDXFAGVSIV     HWFTEGSODQ      LIOMEWF        
IIONFMWWGPBHVS  : JBAYRRMAUXON    KIJLARRCWGXUN   AGLMGKWPUNIKYBA VCIXENWGMYB     XTSOVYNIMSLTD   IJBLALSB        OWNTXREBJDETQ  
AJVELG          : FMDBFKT         MXGVLGKUE       JBWVSVHYLSWC    HGTPDIFWAAKAKXA
KCXJCNB         : JBFRGYMQD       FCPOUMP         DCBATYPVNWKNUOX
NJEEYLSYIYQLJM  : IOFANFRO        AQFUSRNEFCTJMO  HMVVBYKN        LMNTOSM        
GOQDSCLVONVXR   : XYMXFFPNE      
YNCL            : OEMOHOINUH      IVGDBGMODTXC    LOBAVOKNAEUPL   OYANMJCXJS      MACOJNTFISDGN   NGYYBBGYXSFNKYE DNMLBDGUGCXFI  
HKGALRCDDN      : IASF            PTAR            MONXMMAQLX     
MTHDY           : QJHGYXOEVWCWQ   LJQPNC          QXVUXKEM        EDMBNNWJSGSWSA  TFMJJUEEYKQTJA 
IKYW            : GYCVTLWEALDSKW  VNEWIYCKHNEY    KSIG           
UXRHWIMKDT      : UCBIOTBDLDR     HHCU            PTXYPBIUEWTHG  
JVHD            : TTSTCBBKJRUAHLF VIDBLE          TRJYQCFPMS      TSRTFFBHQR      DBVTBAH        
MHLFTIMAJ       : WESVGKMUMGHAXPN MUIVYXXJMRJYDW  ALHPFBYFGTJP    VJLJTRODQUJXS   MDQSXAAGK      
IUNHWJFR        : SUKVWG          WESVGKMUMGHAXPN WGHDVKBKJW      LXVTYBY         WUNDAHPAG      
FAFPFB          : QAIFXQCM        BNQY           
QXVUXKEM        : MTHDY           AXEA            WDOIFAYI        IMIEYDKND       SOVMBWUEKDUEDR  ROSSGYU        
XUCAERI         : PIWJPUUFDN      GHJTPLNBFKUB    TMNHRPRSMDBVQ   FCPOUMP         WGBXDKOTMUJKCB 
FQYQVSMDSTTAVH  : QEBKXXPLTNOYHCM LVRK            GQDLQKDCNKUOEQ  DVUXYNC        
VFLTQP          : UJAKTUOOIIGC    NTVWPM          MONXMMAQLX     
GQDLQKDCNKUOEQ  : ROPGAEDJABGC    FQYQVSMDSTTAVH  NWLCRXQCMYSK    EQCDAJSLXVGXST 
SUCMQCKX        : LMHBGBIFXLNSVD  FARKDDGWYPQOBTK QDPVOPQJMGGWEW  VDQYAGCR        BVCP            ECXDJIAO       
GEHB            : WQFDDCNUTNOX   
AJDSNOLXTNNH    : MUIVYXXJMRJYDW  IBDYTKWRWWSDGDT BJFJJXUOFUPCESY POXCAIBKWGJEOK  XEGBNKOMJFFCW   HPVLBQIGEC     
DNCKGYNSPPGPLM  : BJTSV           KTREEVVUTAUEB   KPEUDAQGADTLIC 
VPSVA           : VLGADHGRCCFIKO  NTCSFEVOVME     HDXDPFGQRIAMMDK HQUUSCY         IXXPGFUDRQ      SQSVNE          TYYGPWCA       
OPPCPMSDTBGHFRP : IVGDBGMODTXC    IKOAOJDCCDE     WUFIMWWPRQ      MKDD            NVRLUPAPPKA    
FIVWQOLEKHVGD   : OSSQJRHU        DJUG            DBSJXEGIUVMKNN  YYGYMLNTA       LALNSRPYBILOC   AXDXFNKSGBLEE   UUEHY           PWMYFKQNF      
FIVWQOLEKHVGD   : RABHJSNP       
FTLWXDJQHFUNMA  : FYSM            FWFEXBXAV      
CHMNFMG         : VDVPMRAWIHN     LUTQHQBUENPXY  
XKFHJLKF        : LBSOIELONXFLXG  XXPBNL          QJVPMBQOQOME    TALNHEHVXUTJQ   DEJRXWIFUCEX   
GTPEWAV         : JBAYRRMAUXON    MUBJBYAQTWVV    XTOVMHMJWP      DADJVXP        
HQUUSCY         : VIDBLE          VPSVA           EKLICT          PWUNMFQ         QGNO           
ROIEVCEIJLRWX   : DGJVSYUSD       ATWHIPBTTMI     LIFKRK          IUAHQRV        
RGVIKU          : MIOFD           AQFUSRNEFCTJMO  CFGLCPWI       
ICRYWO          : ECLISPUCOCHRKT  WNQL            FPXHHPLLQB      YIPJ           
YQWSFF          : OSVAGGBFP       GTSJXPI        
DKDMTQGTQGLWC   : WOID            AEEGTL          GGQNTAWQH      
KXGSA           : YTAOAVXX        HLWNHXPWEDR     KKCDWPYRSVV     XIWKOUEM       
UYPPAIMTOUSRFY  : NHWFDQHAGAMMSW  PYWIW           WAWSVBDHEQHPKK 
YPNUJVHG        : QIPKRLYJDV      QCKQEVQ         ODVYFHWQY      
DSYMOBN         : IKSJTLELVO      VXWMQHX        
CFBCOPVFKP      : IVGDBGMODTXC    RSWXPRJBGNDREHE EUAKKPQHATCLFS  PKGYRM          XJMN           
POGRGVM         : VNRIVKGFT       SXCYTS          LFCBDCHFWK      BLCUQEQJSVVMSL  TYYGPWCA        TAWNI           ECXDJIAO        KIOMXDFKB      
RVBS            : SILS            KPRX            EVFJCSKJJATY    GFLVJFFFWNNN    SWPWVBMLAYMGKEV
TTOIWE          : IWBDVSGYH      
YJUEA           : KTREEVVUTAUEB   FYQRNP          TPUNWKKA       
AFXR            : VDQIXPSAVSVPOEH BWDDNW          FEFVLWRY       
QIPKRLYJDV      : BKCIUB          YPNUJVHG        TYDFPJDGFUO     ENQCQJWLBDNWCV  GFLVJFFFWNNN    EWVBN          
YXFU            : QTGTT           DFDXFAGVSIV     IXNNMIU        
PSQKTCFXFUYKTST : FHXWWQG         MVERLLCBRMOAP   CCHHHUQPMFSE    AANVSTOCOKYBEM 
CJWVUVFBT       : NHVSPCKPWNN     ELHPIVMIRUTK    MCYERLKAP       OVHCSC          CEFO           
CTXWGPP         : HFBKQQWHDPXW    PIFOQFJED       BBHJTMABLYJQR   XEFSILGIRGEAY  
AKEIKJDLVYFQLJA : YTAOAVXX        RQATVWLTT       AGXQLFHXBTICWI  YULCUIEUQTKBEHE IJBLALSB        MJATVK         
FXJM            : RPYHO           DRVJADSR        PWUNMFQ         QGVLJPAACL      EMNWEAKADIFBVRX QQETKMCORQKPN  
DFDXFAGVSIV     : PYWIW           CHWXVUWAPPR     YXFU            KKCDWPYRSVV     KLMPFRRCAM     
OEPXKCVJ        : XNXDSGORBR      RABHJSNP       
OXSRIAPRMQXS    : VWSAQBXWB       CKGFARTLKTEQD   JOCGW          
XAVEVOOUTDBKDL  : FJLTDLNSEOEE    QAIFXQCM        XDQUSPGBVWIVLNK ENQCQJWLBDNWCV  BACEH          
AVXOVQIE        : QJRKLOU        
XYFQW           : PRWRLVCMC       EUAKKPQHATCLFS  UEDTATXJJOOHOJ 
MUBJBYAQTWVV    : GTPEWAV         NWLGEOEYOF      EMQGQXPXUGPHNI 
CJXCHVSDOCIHC   : QTGTT           XNXDSGORBR      HVABPP         
OTGPIDST        : XBPEDDJVNGRHHEL RYQL            IFJFMVY        
RUWORVMB        : OOXRC           LOOA            MRUNBBAPEPO     FYQRNP          QQETKMCORQKPN   OWHRTHHUIEVL   
VBCGYWJNYTW     : TLYJ            XKMAG           WRDP            LEORJEQXTOWP    JIGRRBMLCVXS    UXDJ            KYTFCTPM       
DLAJDIOVFTQC    : UAYDF           VDQYAGCR       
HTOTWORA        : NTTCPYGOUSK     JBGEJFDLELC     SXXDEMBFO       PGJGTCLXGRE    
XYOIOPE         : SGGYSYQIKYGEAPJ ANCOEOING       XJYOBSVEWXDKX   KTREEVVUTAUEB   GCOTNOFWT       XVUKOVXEFKVXC  
TIYVTFHJDMFTOAD : FYSPHPKDCOEIH   DVUXYNC        
PWJEPLXPKMX     : YIQE            NJGT            MAYBKLVWHKBTIRO
EDMBNNWJSGSWSA  : QKDXUDBADQ      FEYCUHPP        EQKHKFUSPTNR    MTHDY           JPGJ            BAQMNDONJMSWYL 
JBWVSVHYLSWC    : AETED           JAGEQCRONA      AJVELG          XNXDSGORBR      SSFBSWNXQBQ     JKGIWWDBKBBTTY 
LCGQHURW        : DJUG            LXSXA           BKCIUB          TSXSJVJ         IKSJTLELVO      WHSVDYJ        
QHEXCDSDWFEV    : UIFMEJQGCM      USSAQUSIYL      VXWMQHX         OGWIA          
YRJXGCVKIJ      : NQCD            MKDD           
OAYKTVVNDA      : BACEH           IKRTUSHQNX      PBQRL          
GEGLDL          : NSENHJMCQ       WULDL          
YNQSYQB         : CCFRALFAT       AILOEF         
OLLYDDBCPVXLJEN : LJFYQEGKVVRU    WPMJQNLBDWWD   
MTDXW           : SWTIDNXDWC      QJYUOFES        KUQFPJUU        TXULA           APDUBXAVGKNCH   WLMKEQLELEAGA  
RXFKTEBU        : VLRQ            UAPG            RNSQVBNSUEATSKC FUFRAGGYNCHQ    GQIHQ          
QJVPMBQOQOME    : LOBAVOKNAEUPL   MIJOEOCKJFFHR   XKFHJLKF        DRVJADSR        SDECEDKSYBWCCS  YMEMAVEINEGVECG
QRWFMDDLUWKAHG  : FWFEXBXAV       UIFMEJQGCM      BOGHTW          HAKPLN         
JBPAKLRWMKL     : HKLMUTJT        VTITCJSOEP     
CBJCTCCAQFFCADO : VCSRBRDGUFQCBNR NGYYBBGYXSFNKYE SHDDNJDUDKRV   
MUIVYXXJMRJYDW  : MHLFTIMAJ       AJDSNOLXTNNH    HBPKCILMU       TJBGIBS        
FXQJUSLUJSCOSHD : HJNVHSYUAFDBAPI XSHQRLTNXKSKFLC FUOJUOKA        SYEPSHSII       TPUNWKKA       
UYFSA           : LXSXA           JXGUTLJMHWUD    MIPRGLCVAS      XEFSILGIRGEAY  
RJSLUTOSBVQSGLL : MTIMUM          JUDXUR          PRSCLR          YKEBF           DOEDDMCXWPFUAPR OVHCSC          UEDTATXJJOOHOJ 
IXNNMIU         : YXFU            RFMPLVSGIEPI    RHAUBNEJAUJOR  
GRSNLST         : WQFDDCNUTNOX    HBPKCILMU       BBBC            FWRKYI          JDJQDGAP        SWPWVBMLAYMGKEV
DMQXHI          : MTIMUM          XYMXFFPNE      
IEKBMX          : LPPEMGSRVMPTDD  LJNNQREU        GGBYDTTYXHICBAN RFMPLVSGIEPI   
HJPWW           : IXPGIFIOV       CVAIWDSVRLGNQ   DKFOIEICGBNANYP
HRTPKNEXI       : LLVVJAOIST      NPIIUA          RNSQVBNSUEATSKC XEGBNKOMJFFCW  
DLNVMWEFHJRJVSB : XTYFI           PIFOQFJED       VCVIREYT        CTSWSQOYS      
CQEY            : ABRQBTPW        BRPCCJQXKQMWTU  LLVVJAOIST      OTISTSU        
MSQCFGIDPJGD    : EJABFYPKYJXDOE  NJIMOXLWVMEMU   DGXCFRBITJUGNXG JBXINR          NAKSYNPJKOP     RXPVEPYBN      
DRVJADSR        : FXJM            QJVPMBQOQOME   
RMRWOIEP        : KMWCRBQIYO      MIOFD           YAMF            RGWVFGVPNRL    
QJYUOFES        : WYNTJMTUFEA     BEBM            MCYERLKAP       MTDXW           MONXMMAQLX      KSIG           
PBBOGUMQURL     : QFVENXV         MXBERFUIGRR     WGGAHKHISWNKVIL
HDCYDTKHJRASQ   : NOFV            CCFRALFAT       SGOCBCFWAW      MSDX           
IWBDVSGYH       : DYORRVBQJJWAPFT PGNUCMDNXYSLMNP QVVDVWIWV       TTOIWE          IKRTUSHQNX      ASMPCHBULD      PKGYRM         
UVGPO           : CSVSKDSPGFRJLTM BOGHTW          BYJHTUOXX       DDFKOQY         THGV           
HXVKWBEJIPCKJU  : ENQCQJWLBDNWCV  YPVY            NQTD            FMRGHVLVPP     
TRJYQCFPMS      : FHXWWQG         JVHD            PJYRNLXXPLX    
IBDYTKWRWWSDGDT : OJOPKM          AJDSNOLXTNNH    AJEXOTWNKGWQ    JKGIWWDBKBBTTY 
NDGU            : QPNPCMXOROERBPM OPGOEXH         QGRMX           IVYNDPGDXQ      TTPGV           LCAJAUFS        SSFBSWNXQBQ    
AGXQLFHXBTICWI  : IGPNNIFXGUY     SGIFNVLPSDQPR   QVVDVWIWV       BKCIUB          AKEIKJDLVYFQLJA JBIYQVWALDRTWB  KSIG           
IFPFC           : VQLTXOHEJ       NOFV            RIJNXIXODOMOKVX MDQSXAAGK      
JLNFVDI         : AXEA            BHXW            VNQTHDEAYKYCDB  MYSDF          
BJFJJXUOFUPCESY : AJDSNOLXTNNH    WWYAHF         
QJTHRWRDKII     : RWOGKSWPJBFFE   XQIEEVXRPV      UHOGYHMBHIQAJ  
NSNQCSD         : LMHBGBIFXLNSVD  BRDQMXTJPQOLEW 
SXCYTS          : TBNKO           POGRGVM         REVYILQG        GFVVFKQY       
ANCOEOING       : HVFVUVKDNMILIK  YXWTERVO        XYOIOPE         LNSKJXFGDMFYP   BWXMLISCUXNBAVB
IJRSR           : JEOVDJG         XIDX            EHLN           
IKOAOJDCCDE     : VAQSWOL         OPPCPMSDTBGHFRP UVJQFEYVCF      QJRKLOU         UJMUYMKIJHJU   
YYGYMLNTA       : FIVWQOLEKHVGD   KXYFDLVGATTO    LJSEJXPLDJRE   
JIGRRBMLCVXS    : YNSJAJL         VBCGYWJNYTW     JYHVSTV         MACOJNTFISDGN   BNQY            UQWOLAMIYJH     MPAWEGHPSYXM   
OEDQGGWM        : TRXNIC          LLEJODMGNHFIX   MRUNBBAPEPO     BEAHHHJDOSYO   
YUHLGXHIWRQDLK  : IJBLALSB        DPACK          
YXIUVDUMH       : KYTFCTPM        LUML           
DOEDDMCXWPFUAPR : IVGDBGMODTXC    SISIUBT         RJSLUTOSBVQSGLL TOFG            PXGBRWM         GTSJXPI        
HWFTEGSODQ      : CHWXVUWAPPR     CIGGXMXB        OEHBRPWTKO     
XEAVJQDMTRQSO   : EMNWEAKADIFBVRX
ALHPFBYFGTJP    : MHLFTIMAJ      
XSHQRLTNXKSKFLC : HJNVHSYUAFDBAPI FXQJUSLUJSCOSHD NSENHJMCQ       ASMPCHBULD      EMNWEAKADIFBVRX RFBBEN         
CLAOUPVVPBEL    : VNEWIYCKHNEY    QGVLJPAACL      WCIUH           PTXYPBIUEWTHG   KPHPQVXFYTGHCE 
TALNHEHVXUTJQ   : EDDOUTMHLENYLIS XKFHJLKF        DADJVXP        
QCKQEVQ         : MFMIHVDLT       IRLPPOTGWDBTOXJ YPNUJVHG        JYHVSTV         HPWRDJHXMMQLVME
QGRMX           : NDGU            BACEH           ODVYFHWQY      
TJGPLRDVVKRWING : MCYERLKAP       EYEJHUB        
TYDFPJDGFUO     : QIPKRLYJDV     
JPRDBXTNPY      : DNOFSVL         APDUBXAVGKNCH   FFBIDL          MSDX           
OMFLWS          : CWXGLAWVGEM    
XOSBVKKAS       : OHFQIUSHCXXPUH  JBIYQVWALDRTWB  JRIUOQCESRFI    OPVCA          
UHOGYHMBHIQAJ   : NHVSPCKPWNN     QJTHRWRDKII    
OVHCSC          : CCAPVUMTLXBXHGK CJWVUVFBT       RJSLUTOSBVQSGLL USSAQUSIYL      WUFIMWWPRQ      LHDLDUIGWNMI    SOVMBWUEKDUEDR 
SSQTPBHRTWODOU  : OOGEKNWLIAQNB   QVVDVWIWV       WFCNIB          PKTVV          
XHGFRWFCBVX     : RAFAGIFGFQKON   ITFIUGTPSBX     KLIJ            EVFJCSKJJATY    DNMLBDGUGCXFI  
XTOVMHMJWP      : GTPEWAV        
QJPFPEBUEKBKDA  : UEQWLNW         WTDEGMVQFQXXPJM JSXXEPTXAO      KUQFPJUU        SIGGORAWVBVY    FYUMO          
FBQD            : MGMABDBYXYURC   PTXQSDMO        YAMF            PPHQXXGWS       DKFOIEICGBNANYP
OYANMJCXJS      : YNCL            RFMPLVSGIEPI    JUBYKKIUFQAJGKM VYPECCOSO      
AEEGTL          : YNSJAJL         UAMIMTJUXUAX    MXGVLGKUE       DKDMTQGTQGLWC   RFMPLVSGIEPI    NUJEKXHBIS     
OPRRCWRUCSLI    : DVUXYNC         EJQKXDXAWW      PBQRL           PWMYFKQNF       WULDL          
CHIPVSSTC       : NTCSFEVOVME     IXXPGFUDRQ     
ICRPI           : MLCABB          WGHDVKBKJW      MEYQXYL        
BRDQMXTJPQOLEW  : TMVY            NSNQCSD         SXWVSROLVIVKKNC XVUKOVXEFKVXC   AUBU           
GGBYDTTYXHICBAN : MIOFD           NPGG            IRLPPOTGWDBTOXJ IEKBMX          PWDY            VPIHNFTCJF      FRNJSWSNMSOXRB 
BFVRTTNGJGUUK   : IXPGIFIOV       QAIFXQCM        WAWSVBDHEQHPKK  EBXDBBKBP       KNMOGPOMG      
PTXQSDMO        : CNXHSFBAYQ      FBQD            MKXKAEREBBYYNRE
MXNOYNCP        : XXMBIFW         PAENYKPYWUS     JXHNPEVWWMSXJJH
KNIE            : EFRQFJEKSXOP    EFLLMNYYENKK   
WKSFFOQY        : CHPMICRJIDT     USSAQUSIYL     
KXYFDLVGATTO    : IHRYXAYFDRMF    TGVWMEIXBT      YYGYMLNTA       JFNR            DRBCVUEQBVHLXRA NIBYITSM        DBVTBAH         EGEKB          
JRKAEXJI        : LJQPNC          MIJOEOCKJFFHR   FEYFSFWQ        MIPRGLCVAS     
IVYNDPGDXQ      : NDGU            GNEYGOV         CAHAXXNKYHIJRG 
WXGITNK         : VQLTXOHEJ       ITSNIPGPNC      EMRSRVUEHIBCHG 
JYHVSTV         : JIGRRBMLCVXS    QCKQEVQ         UDQLY          
SFIAPEBGHSMMQE  : POINBHKXGD      YSQCXRMXG       AANVSTOCOKYBEM 
NEWXYMI         : HHEUFVMRIG      CCAPVUMTLXBXHGK LFCBDCHFWK      MLQFJWULRXEDY   KRNLKARJT      
XKXVDSS         : CTASTFK         VPHIGX          HMVVBYKN        ROSSGYU         UEDTATXJJOOHOJ 
LALNSRPYBILOC   : FIVWQOLEKHVGD  
EPWDQXRYMSJL    : YQADFGNDUNWVV   BLQGOSQDKTNHNUK CEFO            VYPECCOSO      
PEHSRKGFDXWCY   : GQHRUPKOM       PGNUCMDNXYSLMNP
NPIIUA          : HRTPKNEXI       BYJHTUOXX       UUEHY          
AQFUSRNEFCTJMO  : BCGNTRVBQT      BRPCCJQXKQMWTU  NJEEYLSYIYQLJM  RGVIKU         
YULCUIEUQTKBEHE : DGYPIWA         BLUJKWPYPLPBDAV TFIGTU          UJFW            AKEIKJDLVYFQLJA SRURQRB        
KUQFPJUU        : ABRQBTPW        MIJOEOCKJFFHR   MTDXW           QJPFPEBUEKBKDA  BAQMNDONJMSWYL  ELKNODOJJQSSASF ADVJNY         
YOBLGGKBROWD    : STTGCJLBF       CTRXUKLTUDOP    WXQCEPYDCC      DIOASOU         KJWTDTMS        XVUKOVXEFKVXC  
TTPGV           : YNYWSKEHWQGYKIS NDGU            TSXSJVJ        
QAGBWW          : HJNTDEKEN       XBPEDDJVNGRHHEL HPHCGPDASRWX    WTCK            FFBIDL          GQIHQ           DDQCMGBMA      
NIDKACBBQHHDLC  : LPQLXNF         BYJHTUOXX       XPDGUD          XMEXAYEPINC     FTYOWTAXF       IMIEYDKND      
IFNE            : TFIGTU          KHEIH           XEGBNKOMJFFCW   BLQGOSQDKTNHNUK
DMWADYIG        : CGHLJUJOTOVCU   YPVQEVJC        LJKLEVMDCA     
FQOQVYQYATR     : XBPEDDJVNGRHHEL VTTGPEMUXYXAIMV QFJUAXPNMXGSL   EYEJHUB         QJRKLOU        
DUVFPGMEMOJY    : RAFAGIFGFQKON   EESGCHSR        AOIE            XYEGSU         
JFNR            : CAVIJSOBDLV     YXWTERVO        KXYFDLVGATTO    MEYQXYL         IGXF           
OAHDSDEJEGDVQIT : YSFQHDVDWRD     NSENHJMCQ       FLCWWVL        
QJUDPHRAHGLOV   : MIDGDN          CKKM           
EKILPB          : HSLTRYVFSWDHX   AEOK           
TMTARSTAMI      : SILS            GHDTLQO        
XEUQLOSUUG      : QAIFXQCM        MSMRNYMVGV     
QMQDWC          : WJQDGXGQO       BACEH           LIOMEWF        
XRMKOPCHJ       : HIFEONGWJB      SWMYITQSREC     SVDDMPAD        MPAWEGHPSYXM   
VRVVXSM         : PKHTAJOMP       NLCGVGKR        YTYSSMFOX       WLMKEQLELEAGA  
IFJFMVY         : OTGPIDST        CKKM            VDVPMRAWIHN    
MEYQXYL         : HSMNWWDVIOV     MFMIHVDLT       ICRPI           JFNR            VHMOJEMG        HHCU           
MACOJNTFISDGN   : YNCL            JIGRRBMLCVXS    TFOOM          
SXXDEMBFO       : RSWXPRJBGNDREHE XQIEEVXRPV      WNQL            HTOTWORA        IOWLVOIPTRARGOK IWMOKXVWFHDYH  
JPGJ            : RSWXPRJBGNDREHE MIDGDN          SGWHBJO         EDMBNNWJSGSWSA  WHHCNNEHCTLJW  
RWDTBUDROIAJOIX : OSOIR           FWFEXBXAV       YIQE            NYHMRFNSMDE     KLMPFRRCAM     
EVFJCSKJJATY    : XTYFI           OHMPJA          RVBS            XHGFRWFCBVX     FFBIDL          QYGDRJAYXCFRQ   SYEPSHSII      
DRBCVUEQBVHLXRA : NGRPXJCBGCR     ETIVAKQKDMA     BOGHTW          KXYFDLVGATTO    VTQFUGDXHROIELJ KSIG            KLINXV          FMRGHVLVPP     
RFMPLVSGIEPI    : WDNNIQPNEXSML   IXNNMIU         IEKBMX          OYANMJCXJS      AEEGTL          EMQGQXPXUGPHNI 
QTEIWI          : KIJLARRCWGXUN   KXIEW           OQUWIJDF        LXSXA           FSFJPD          LWIEW          
TMWU            : WUDXOCDW        LHNSACK         YIHJVDV         XSHX           
FHKYH           : JUDXUR          OBJYTCMBRF     
SPGIDFD         : WUDXOCDW        VFEMPOTTHWUDG   PHLITTFXHQ      YIFYVDDPI      
NIBYITSM        : KXYFDLVGATTO    HMVVBYKN        BEAHHHJDOSYO    UCDMSBPDOOVV   
PVLJKIHXPOKO    : JBAYRRMAUXON    EJQKXDXAWW      VYTLQWXFGXE    
EHLN            : MRRJCLNOJJQPFTJ QDPVOPQJMGGWEW  IJRSR          
OSVAGGBFP       : UIFMEJQGCM      YQWSFF          ELKNODOJJQSSASF
AEARCLENVLN     : AQEJFUB         LPQLXNF         IWSPCSBF        OMBTOCOGGMXSME 
AXDXFNKSGBLEE   : YPVQEVJC        XJPRQEYDRNCNY   FIVWQOLEKHVGD   IWSPCSBF       
LFCBDCHFWK      : TLYJ            CTRXUKLTUDOP    POGRGVM         NEWXYMI         ECXDJIAO       
BAQMNDONJMSWYL  : LVRK            EDMBNNWJSGSWSA  KUQFPJUU       
BYJHTUOXX       : UVGPO           NPIIUA          NIDKACBBQHHDLC  OWNTXREBJDETQ  
CIBYSTASNOIS    : XASTVVTF       
VCSRBRDGUFQCBNR : CGHLJUJOTOVCU   CBJCTCCAQFFCADO
OLBWNDPJFK      : JKOVA           RYWMRHNVYLVE    JRGGXVFCJLA    
USSAQUSIYL      : QHEXCDSDWFEV    OVHCSC          WKSFFOQY        VPDFOXJDBB      EQCDAJSLXVGXST 
FITVLUM         : QQSJKMJ         CCHHHUQPMFSE    CBMLLWRWDHW     KPEUDAQGADTLIC  FYUMO          
VDQYAGCR        : OSOIR           SUCMQCKX        DLAJDIOVFTQC    RIVXLTHALQG     SSFBSWNXQBQ    
KCRFWMHNK       : OCGSOXRFBSHWKL 
WJOLOYFNKCAPA   : KRUAOJHOLEODO  
JBFRGYMQD       : KCXJCNB         CHRVYVHEUJGGJ   HQKYJGXP       
XARF            : GQHRUPKOM       OFYVAGNDMWEC    GPOUA           HQKYJGXP       
CIMNYXDYF       : QFJUAXPNMXGSL  
LJSEJXPLDJRE    : MLKDAP          JEOVDJG         YYGYMLNTA       VPHIGX          DEJRXWIFUCEX    JKGIWWDBKBBTTY 
KHEIH           : IFNE            YGACMPGYWGO    
PWDY            : SXIPPWMFJCCH    GGBYDTTYXHICBAN TYSH            FQDSRKKVDXDXLM  CHGWWHXLQGUO   
QAMTBSM         : EUAKKPQHATCLFS  PEIMLSA        
EFRQFJEKSXOP    : VFEMPOTTHWUDG   KNIE            SGOCBCFWAW     
VTQFUGDXHROIELJ : BAEWAMPG        DRBCVUEQBVHLXRA FPXHHPLLQB      WUFIMWWPRQ     
XYEGSU          : CLXR            JBGEJFDLELC     CCGFCNFIYUPLTHI DUVFPGMEMOJY    AALWYTT         WIKETFRMXGJU   
CYWVWNNFK       : SGGYSYQIKYGEAPJ MIJOEOCKJFFHR   JXGUTLJMHWUD    IUAHQRV        
XPDGUD          : YNSJAJL         NIDKACBBQHHDLC  IGXF            DNMLBDGUGCXFI   KPHPQVXFYTGHCE  JRGGXVFCJLA    
MRYTFKSGKWMDTAG : MRDVJHWGAIKPAV  CTRXUKLTUDOP    WCIUH          
YERNRYXC        : DDBGXQ          SSMALTDMSVNGT  
PHGNKUCFV       : XYPWLQD         DUKYJOPRVERQT   NJNRVHNPDKTNSWP UEDTATXJJOOHOJ 
KGPQQOFWJGFEF   : RTQDMFCIA       FHSVQRGAVLDMGY  BUQHYCPXYCFGROR PAENYKPYWUS    
WSDXSGX         : NMAKMRRIQFBN    CGMXQIGADMVUF   XWDCJELKOEQDR  
NGYYBBGYXSFNKYE : LIFKRK          YNCL            CBJCTCCAQFFCADO UDQLY           YSQCXRMXG       QQCMHQLWKLQPM  
XNXDSGORBR      : YXOJYEKWYUDG    CWXGLAWVGEM     OUMXJISPOUK     OEPXKCVJ        CJXCHVSDOCIHC   JBWVSVHYLSWC    HKYNKYA         DEJRXWIFUCEX   
XNXDSGORBR      : FFBIDL         
UAPG            : RXFKTEBU        WAWSVBDHEQHPKK 
VFPYGVXG        : GYCVTLWEALDSKW  HFBKQQWHDPXW    XASTVVTF       
GTBFYV          : RCPOXUIWLLLVWAB LHHEHHEQ       
OTIJCWBEQVB     : PIFOQFJED       HSLTRYVFSWDHX  
NJIMOXLWVMEMU   : MSQCFGIDPJGD    LJKLEVMDCA     
QCBMHQIPANO     : BRPCCJQXKQMWTU  YIFYVDDPI      
RHAUBNEJAUJOR   : PRBBT           IXNNMIU         XNWLHDXR       
DVUXYNC         : FQYQVSMDSTTAVH  TIYVTFHJDMFTOAD OPRRCWRUCSLI   
AJSKBVX         : DWVHVKB         MSDX            WWYAHF         
CRBCODRSM       : MGMABDBYXYURC   MSNOPI          BBBC            JXHNPEVWWMSXJJH
NWLGEOEYOF      : SISIUBT         XXCSSRHQPOE     MUBJBYAQTWVV    DGXCFRBITJUGNXG DAODDIFMOQIQRNH
SGOCBCFWAW      : ETIVAKQKDMA     HDCYDTKHJRASQ   EFRQFJEKSXOP    CEFO           
UXDJ            : VOFVEGAHTT      VBCGYWJNYTW     HIVD            KPEUDAQGADTLIC  WIKETFRMXGJU   
XDQUSPGBVWIVLNK : VOFVEGAHTT      XAVEVOOUTDBKDL  CCKLSJLAJGWKH   NJNRVHNPDKTNSWP QCBBVDRSH      
VCIXENWGMYB     : RGEYHEAWC       IIONFMWWGPBHVS  WHHCNNEHCTLJW   PDKOGXXFPLUF   
ENQCQJWLBDNWCV  : FKQGSOOP        EUAKKPQHATCLFS  QIPKRLYJDV      XAVEVOOUTDBKDL  HXVKWBEJIPCKJU  LFKJHKFI       
NJGT            : PWJEPLXPKMX     HQBIVXAGXKJTQ  
KEGOTDUGEYVJ    : LLKT            VNEWIYCKHNEY    VYTLQWXFGXE    
OLFXLQYQGXTE    : CKGFARTLKTEQD   WDOIFAYI       
JOCGW           : OXSRIAPRMQXS    HQBIVXAGXKJTQ   VDVPMRAWIHN     PPIVKITHSIDS   
KFBFKXNPY       : ADRWHNTXMEIMFC  TMVY            CTASTFK         OPGOEXH        
YLAKSAXMBPSA    : DGJVSYUSD       MIOFD           TOFG           
XTSOVYNIMSLTD   : HQTKFJJP        IIONFMWWGPBHVS  OTISTSU         JKGIWWDBKBBTTY 
HSLTRYVFSWDHX   : LIOL            EKILPB          OTIJCWBEQVB     EKLICT          WCIUH          
AXEA            : CQSGRVTYVO      QXVUXKEM        JLNFVDI         FCAG           
AOPB            : LIOL            JMSRJD          ASGPYCNYDVSSAEI NYXOIIJXGVBFTFP
XNWLHDXR        : RHAUBNEJAUJOR   CKMKBISUEP      CKKM            AALWYTT         PJYRNLXXPLX    
LNSKJXFGDMFYP   : AOIE            OUMXJISPOUK     ANCOEOING       IKRTUSHQNX      CYMRC          
FPXHHPLLQB      : GEEJSUTGGTLIM   TWNJSVLASXI     VWSAQBXWB       ICRYWO          VTQFUGDXHROIELJ XHFV           
CJOCDMNQFBCFGJ  : EQKHKFUSPTNR    OPGOEXH         NUJEKXHBIS     
VQKL            : GYCVTLWEALDSKW  EQRLEIRSWYH     IUAHQRV         XSHX            PXGBRWM         GGFW           
RBVCKM          : KPEUDAQGADTLIC 
WDOIFAYI        : FYSM            QXVUXKEM        OLFXLQYQGXTE   
LXVTYBY         : JLAOLOJ         CCGFCNFIYUPLTHI IUNHWJFR       
KKCDWPYRSVV     : KXGSA           DFDXFAGVSIV     EJQKXDXAWW      TAWNI           FLCWWVL        
IJBLALSB        : PRSCLR          IIONFMWWGPBHVS  AKEIKJDLVYFQLJA YUHLGXHIWRQDLK  KYTFCTPM        GGQNTAWQH      
DGXCFRBITJUGNXG : AQEJFUB         MSQCFGIDPJGD    NWLGEOEYOF     
WAWSVBDHEQHPKK  : SILS            SWMYITQSREC     UYPPAIMTOUSRFY  BFVRTTNGJGUUK   UAPG            TDNQHSKHOL     
PTAR            : RWOGKSWPJBFFE   EYEJHUB         HKGALRCDDN      KSIG            PEIMLSA         YMEMAVEINEGVECG
UVJQFEYVCF      : RAFAGIFGFQKON   VAQSWOL         IKOAOJDCCDE     RCYARPV        
BHXW            : JLNFVDI         XRNXSH          TBERUXOOPHRYKD 
YAMF            : OSOIR           RLWIPSUTSWXYC   RMRWOIEP        FBQD           
UUEHY           : JUDXUR          LMDCL           FIVWQOLEKHVGD   NPIIUA          LLEJODMGNHFIX   TPLHWTDBIQARW   TMKRSGWDPCXV    QDXFOXAWFHP    
UUEHY           : YBWHWWGDOEF     QDFKGKQPCCQUQD  WWYAHF         
BAOEWKPNRTONX   : XTYFI           LGXQAHFU        JSXXEPTXAO      WYNTJMTUFEA     CNXHSFBAYQ      JKWGHE          GLEECPWWJYQSNC  NYXOIIJXGVBFTFP
PAENYKPYWUS     : VSFXGT          MXNOYNCP        KGPQQOFWJGFEF  
SYERVHTK        : LJQPNC          PFQSHW          FUOJUOKA        BVCP           
SWCIQYXFYUWBYM  : BUNTPRITYAGU   
LCAJAUFS        : QISHBABWNQRMI   EGDKCFGWIMXK    NDGU            YXAANUWRXQMIS  
JMSRJD          : AOPB            DADJVXP        
CCKLSJLAJGWKH   : EQKHKFUSPTNR    TGCOVOUWFRPWX   MRDVJHWGAIKPAV  XDQUSPGBVWIVLNK
NVMPFMKMHHYUCSE : QKDXUDBADQ      KSSG            TXULA           XJYOBSVEWXDKX   CYMRC          
YIHJVDV         : RKEEGFRRVRFYJK  LXPR            BEBM            LLVVJAOIST      TMWU            MRUNBBAPEPO     PJYRNLXXPLX    
DHPBTAN         : JKYHYFKCTTSUN   RKEEGFRRVRFYJK  CNXHSFBAYQ      BACGKHUSLF      ODVYFHWQY      
VAWD            : EQRLEIRSWYH     VIDBLE          EKVUCWSA        AEOK           
KRYTQVWJCEILOU  : FXYLQTJQKOPN    WQFDDCNUTNOX    DVWS           
RSRUAJX         : OHBQELXTSKKYMA  LGROEUT         PTND            PPIVKITHSIDS    KPHPQVXFYTGHCE 
LLEJODMGNHFIX   : OEDQGGWM        UUEHY           PIQXWGFTF      
HIELSRAPCT      : AANVSTOCOKYBEM  OCGSOXRFBSHWKL  LUML           
VPIHNFTCJF      : GYCVTLWEALDSKW  DDBGXQ          GGBYDTTYXHICBAN RXPVEPYBN       MYSDF          
MUWDCCNAGUKN    : VFEMPOTTHWUDG   HBPKCILMU      
GFLVJFFFWNNN    : FEYCUHPP        WJQDGXGQO       YIEYHLWTMF      RVBS            QIPKRLYJDV      AUBU           
JPEOGTJDWLHM    : IGXF            REVYILQG        KGOXV           QUGPXCLGVNPQCW  AHRJKGJJKQN     SRWMDWIBVOFFUR 
OHYCPHJDET      : RWOGKSWPJBFFE   AUCVXPFICEVNFV  FLCWWVL        
JBIYQVWALDRTWB  : CVIVBFJF        AGXQLFHXBTICWI  XOSBVKKAS      
VPHIGX          : EGDKCFGWIMXK    XKXVDSS         LJSEJXPLDJRE   
HAKPLN          : QRWFMDDLUWKAHG  ENTYTDO        
FYFHIGXEDBSHSMG : MDQSXAAGK       XWDCJELKOEQDR  
MDNVNTT         : TBNKO           XHFV            GGQNTAWQH      
CVSTHG          : LIFKRK          PETMHUBKAM     
PIUY            : QNTCYYFOJNXUJNH VOJHKICMAGL     FKQGSOOP        OFYVAGNDMWEC   
BYWFARM         : UQWOLAMIYJH     PPHQXXGWS      
FUTTXHPOCL      : FLULWDDLH       DJUG            TOJX           
GHPAOXPEGKDYL   : TMNHRPRSMDBVQ   GSGTISJLRPRBGNA YBWHWWGDOEF    
YSFQHDVDWRD     : LXPR            YPVQEVJC        OAHDSDEJEGDVQIT IKRTUSHQNX      KRNLKARJT       UGMWQMVQCIPJ    XIWKOUEM       
JRIUOQCESRFI    : AOIE            BKCIUB          XOSBVKKAS       GGFW           
NSENHJMCQ       : RTQDMFCIA       GEGLDL          XSHQRLTNXKSKFLC OAHDSDEJEGDVQIT SBWVISJUF       KPHPQVXFYTGHCE 
KTCNSTQXGL      : HPDE            WTBC            SILS            JKWGHE         
BACEH           : HFBKQQWHDPXW    RLWIPSUTSWXYC   BEDIQIMLRVQHTF  QFJUAXPNMXGSL   FDOCAOD         XAVEVOOUTDBKDL  OAYKTVVNDA      QGRMX          
BACEH           : QMQDWC         
XMEXAYEPINC     : KHVYYSUECGJQRGN NIDKACBBQHHDLC  HKYNKYA         JNTDCSW        
HIVD            : EUAKKPQHATCLFS  UXDJ            AUCVXPFICEVNFV  SOVMBWUEKDUEDR 
LWIEW           : TDTRTPYRWU      MKINHAYBJHL     QTEIWI         
PFQSHW          : OEMOHOINUH      LXPR            SYERVHTK        MLQFJWULRXEDY   GHDTLQO         CVAIWDSVRLGNQ  
FUOJUOKA        : FXQJUSLUJSCOSHD SYERVHTK        SYEPSHSII      
TPLHWTDBIQARW   : HHXGSI          UUEHY           LJFYQEGKVVRU    HPVLBQIGEC     
GNEYGOV         : SUKVWG          IVYNDPGDXQ      XJMN           
TSWFONPQUJGHQE  : YVMXG           XEFSILGIRGEAY   TJBGIBS        
VHMOJEMG        : LGROEUT         MEYQXYL         RNSQVBNSUEATSKC LSSYJYTOAMWCRRP SYXXJUPXAKOU    HKLMUTJT        LUTQHQBUENPXY  
CKMKBISUEP      : YXSWVQBW        KRUAOJHOLEODO   TDTRTPYRWU      XNWLHDXR        HQKYJGXP       
UDQLY           : JYHVSTV         NGYYBBGYXSFNKYE YQJHDW          IWSPCSBF       
RIVXLTHALQG     : NTDENUB         JURPGMK         VDQYAGCR        JXHNPEVWWMSXJJH
WTCK            : OOGEKNWLIAQNB   LHNSACK         KXIEW           QAGBWW          YQJHDW          JSDFQQJUCD      LUTQHQBUENPXY  
MLQFJWULRXEDY   : MRRJCLNOJJQPFTJ UIFMEJQGCM      XRSUPVJXQWPGL   NEWXYMI         PFQSHW          AALWYTT        
XHFV            : IHRYXAYFDRMF    ELHDHLIAVIBC    FPXHHPLLQB      MDNVNTT         HGTPDIFWAAKAKXA
BGVMWDM         : TLYJ            HHXGSI          DDBGXQ          YXWTERVO       
YQJHDW          : UDQLY           WTCK           
IGXF            : QDPVOPQJMGGWEW  JFNR            XPDGUD          JPEOGTJDWLHM    HPVLBQIGEC     
RGWVFGVPNRL     : UCBIOTBDLDR     ONJXLV          BGSEELRQJXJUMU  RMRWOIEP        ANDVXAXFQPEL   
AJEXOTWNKGWQ    : PHLITTFXHQ      IBDYTKWRWWSDGDT BGPFQWUYV       UIOKICN        
XYMXFFPNE       : GOQDSCLVONVXR   DMQXHI          VXWMQHX         VJQSEKT        
SNJI            : FSFJPD          ENTYTDO        
EVSEG           : XXMBIFW         CGHLJUJOTOVCU   IMSLFBL         XXCSSRHQPOE    
EWVBN           : TOPRFXLOFPBPJ   QIPKRLYJDV      FQHVWI          VTKM            MUVLKLDTDEE    
HKYNKYA         : BAEWAMPG        XNXDSGORBR      XMEXAYEPINC     UIOKICN        
GHDTLQO         : XALHASQQO       SSMELRFJYKGEQGH TMTARSTAMI      PFQSHW          DUKYJOPRVERQT   SBWVISJUF      
DADJVXP         : SWTIDNXDWC      GTPEWAV         TALNHEHVXUTJQ   JMSRJD          DDFKOQY        
AUCVXPFICEVNFV  : VSFXGT          OHYCPHJDET      HIVD           
NDBJQUYSAYXJWXB : UAYDF           DIOASOU         FRNJSWSNMSOXRB  PIQXWGFTF      
YXEWWVEFX       : QDPVOPQJMGGWEW  MSMRNYMVGV      MHTHDUCJXJNIDAI CBMLLWRWDHW     QQKTXBMHYPMMNH 
BNQY            : RGEYHEAWC       CUJEVEBGSTTXWHU FAFPFB          JIGRRBMLCVXS    LJFYQEGKVVRU   
FCPOUMP         : PYWIW           KCXJCNB         XUCAERI         CGHSNM         
MONXMMAQLX      : HKGALRCDDN      VFLTQP          QJYUOFES       
IWSPCSBF        : OXLFXXBCNTBQL   SGIFNVLPSDQPR   AEARCLENVLN     AXDXFNKSGBLEE   UDQLY           EBXDBBKBP      
REVYILQG        : SXCYTS          JPEOGTJDWLHM    GCOTNOFWT       HKMHFI         
GTNXKOMW        : EJABFYPKYJXDOE  HQTKFJJP       
DIOASOU         : YOBLGGKBROWD    NDBJQUYSAYXJWXB ACDJO          
QNJYUEF         : NAKVCO          JFPRX           IICRIVGXY       MYLAWGVLJKWKM   TEWALEVHKLMW   
FQHVWI          : OJOPKM          EWVBN           SSFBSWNXQBQ     TOFG            MUWVJWVNPXSPJL 
SVDDMPAD        : QEBKXXPLTNOYHCM XRMKOPCHJ       AANVSTOCOKYBEM  LUML            MKDD           
KSSG            : ADRWHNTXMEIMFC  ATWHIPBTTMI     LLKT            NVMPFMKMHHYUCSE OFYVAGNDMWEC    GPISJQDCAJCEPD  XLDNCJSHCXUSNUY YBWHWWGDOEF    
NQCD            : EJABFYPKYJXDOE  IXGXS           YRJXGCVKIJ     
BBHJTMABLYJQR   : CTXWGPP        
TXULA           : HJNVHSYUAFDBAPI RGEYHEAWC       HDLTU           CVIVBFJF        MTDXW           NVMPFMKMHHYUCSE OWHRTHHUIEVL   
ENTYTDO         : NMAKMRRIQFBN    HAKPLN          SNJI            GPOUA           RABHJSNP       
FRNJSWSNMSOXRB  : HHEUFVMRIG      OPGOEXH         GGBYDTTYXHICBAN NDBJQUYSAYXJWXB OFTWWBBQVYMOPL 
LJKLEVMDCA      : DMWADYIG        NJIMOXLWVMEMU   CHQFALGBNONJC   BWXMLISCUXNBAVB
BVCP            : GGLIIRFMWNFS    SUCMQCKX        SYERVHTK        RAHFLTAYFPS     VTHAIHWX       
KJWTDTMS        : TPHXDDYTR       YOBLGGKBROWD    GSGTISJLRPRBGNA
FJGYKWMTHYBFNEH : WQYRBEBQK       FXYLQTJQKOPN    OCOAX          
EKLICT          : LGROEUT         HQUUSCY         HSLTRYVFSWDHX   BWXMLISCUXNBAVB
MSMRNYMVGV      : SWICUODPG       PMHMOYMQYYNTK   DUXKNRWTDGLCO   DWVHVKB         XEUQLOSUUG      YXEWWVEFX       IIFDLHIOODRIKNI
HHCU            : SDAU            UXRHWIMKDT      MEYQXYL         ULGBDXBIC      
MVERLLCBRMOAP   : AHUEVLLBCVXVEB  YUUXR           PSQKTCFXFUYKTST
VEEK            : KIJLARRCWGXUN   GXQDVW          OCGSOXRFBSHWKL 
TMKRSGWDPCXV    : UUEHY           DPACK          
VAIHLKIF        : WTDEGMVQFQXXPJM FRFP            TBERUXOOPHRYKD 
YIPJ            : GFXVMVOFXYUWPKM RWOGKSWPJBFFE   RNJCUJTWXSLIW   QJHGYXOEVWCWQ   ICRYWO         
VNQTHDEAYKYCDB  : VDQIXPSAVSVPOEH AQEJFUB         JLNFVDI         GLEECPWWJYQSNC 
YPVY            : BRPCCJQXKQMWTU  IICRIVGXY       HXVKWBEJIPCKJU  SRURQRB         KENX            WPMJQNLBDWWD   
FNLPULOD        : VLRQ            WQFDDCNUTNOX    RAHFLTAYFPS     IUAHQRV        
XJYOBSVEWXDKX   : RXKEYMLIRBVM    XYOIOPE         NVMPFMKMHHYUCSE
NYHMRFNSMDE     : OOGEKNWLIAQNB   RWDTBUDROIAJOIX DYUFJMRAQXCXHL 
YSQCXRMXG       : SFIAPEBGHSMMQE  NGYYBBGYXSFNKYE BGPFQWUYV       BHBTFHUXHJXFS  
SCTSDAFBHSCRHTY : FEYCUHPP        RNHYUKQRHAQXU  
OMBTOCOGGMXSME  : IGPNNIFXGUY     VNEWIYCKHNEY    AEARCLENVLN    
IIFDLHIOODRIKNI : FHSVQRGAVLDMGY  BWDDNW          MSMRNYMVGV     
DUKYJOPRVERQT   : SGWHBJO         PHGNKUCFV       GHDTLQO         EXCEBTVC        PGJGTCLXGRE    
CCHHHUQPMFSE    : ABMA            PRBBT           FXYLQTJQKOPN    YQADFGNDUNWVV   PSQKTCFXFUYKTST FITVLUM         ENIDCHY        
FTYOWTAXF       : NIDKACBBQHHDLC  TDTQIXQMCT      MUURXVO         KNPODOKIEDR    
NAMS            : SUKVWG          IVWKHFNH        EUAKKPQHATCLFS 
EMQGQXPXUGPHNI  : CLXR            MUBJBYAQTWVV    RFMPLVSGIEPI    SHDDNJDUDKRV   
ENIDCHY         : FMDBFKT         CCHHHUQPMFSE   
GFVVFKQY        : ELHPIVMIRUTK    SXCYTS         
FPWVPMVNSLU     : BAEWAMPG        PETMHUBKAM      SXMTGIQ        
VJLJTRODQUJXS   : MHLFTIMAJ       CTSWSQOYS       OWHRTHHUIEVL   
FEYFSFWQ        : OEMOHOINUH      JRKAEXJI       
NFCDYPXI        : FMDBFKT         FWRKYI         
JVXDNOHH        : HJNTDEKEN       TMNHRPRSMDBVQ   PHNCMKHVFDNW    TVLFBMVFUIBRDY  KRNLKARJT       DDQCMGBMA      
SHDDNJDUDKRV    : RAFAGIFGFQKON   CBJCTCCAQFFCADO EMQGQXPXUGPHNI  LSSYJYTOAMWCRRP PPHQXXGWS      
HBPKCILMU       : NOFV            WTBC            KTMFGPYQDB      PIFOQFJED       MUIVYXXJMRJYDW  GRSNLST         MUWDCCNAGUKN   
JUBYKKIUFQAJGKM : SDAU            CLXR            OYANMJCXJS      NJNRVHNPDKTNSWP
PWUNMFQ         : WESVGKMUMGHAXPN HQUUSCY         FXJM            OTISTSU        
PTND            : LGXQAHFU        NGRPXJCBGCR     RSRUAJX        
KYTFCTPM        : TOPRFXLOFPBPJ   QTGTT           TDTRTPYRWU      VBCGYWJNYTW     YXIUVDUMH       IJBLALSB       
MRUNBBAPEPO     : PGNUCMDNXYSLMNP OUMXJISPOUK     RUWORVMB        OEDQGGWM        YIHJVDV        
FEFVLWRY        : DRPHTPFCCYTDCF  AETED           IGPNNIFXGUY     AFXR            SBWVISJUF       TJBGIBS         SOVMBWUEKDUEDR 
BLCUQEQJSVVMSL  : CGHLJUJOTOVCU   STQYIEB         NTVWPM          POGRGVM         NFRKJVGPRUHWBCT XVUKOVXEFKVXC  
ULGBDXBIC       : WYAVGQ          HHCU           
FPIYO           : QNTCYYFOJNXUJNH IASF            WDFYWW          FYSPHPKDCOEIH   HPVLBQIGEC     
AANVSTOCOKYBEM  : TRBVNJWK        PSQKTCFXFUYKTST SFIAPEBGHSMMQE  HIELSRAPCT      SVDDMPAD        NVRLUPAPPKA    
BBBC            : JEOVDJG         YKEBF           GRSNLST         CRBCODRSM       DAODDIFMOQIQRNH
BGPFQWUYV       : FJLTDLNSEOEE    AJEXOTWNKGWQ    YSQCXRMXG       EKVUCWSA       
MYLAWGVLJKWKM   : BTETAOXDQI      QNJYUEF        
WGGAHKHISWNKVIL : QISHBABWNQRMI   XCAJTULB        PLGGMTOFC       PBBOGUMQURL     OCGSOXRFBSHWKL  DDQCMGBMA       TFMJJUEEYKQTJA 
TYSH            : JBGEJFDLELC     ELHDHLIAVIBC    MXBERFUIGRR     PWDY            CROKVEABNCW     FQDSRKKVDXDXLM 
POXCAIBKWGJEOK  : YNSJAJL         PMHMOYMQYYNTK   AJDSNOLXTNNH    NAKSYNPJKOP    
YTYSSMFOX       : ETIVAKQKDMA     VRVVXSM        
KTREEVVUTAUEB   : UTHTHQEE        RYWMRHNVYLVE    LDEKIX          DNCKGYNSPPGPLM  YJUEA           XYOIOPE         PTXYPBIUEWTHG   VTHAIHWX       
EJQKXDXAWW      : OPRRCWRUCSLI    PVLJKIHXPOKO    KKCDWPYRSVV     MDQSXAAGK       VLQJFPRIOUUFRIA
PMXGMQRIL       : XRSUPVJXQWPGL   MSDX           
MHTHDUCJXJNIDAI : YXEWWVEFX       DLJS           
YIGXDXMDFYWYI   : OXLFXXBCNTBQL   KOWHW           CHGWWHXLQGUO   
UWRQFWLHIKTYUWY : RWOGKSWPJBFFE  
FXMNYRML        : SGIFNVLPSDQPR   DWVHVKB        
RNSQVBNSUEATSKC : VFEMPOTTHWUDG   RXFKTEBU        HRTPKNEXI       VHMOJEMG        SXMTGIQ        
EBXDBBKBP       : KTMFGPYQDB      BFVRTTNGJGUUK   IWSPCSBF        AILOEF          NWLCRXQCMYSK    GGQNTAWQH      
AILOEF          : XKDBUYSSEDG     YNQSYQB         EBXDBBKBP       JTAE            MJATVK          KUFVGB          RVPE           
YXAANUWRXQMIS   : DRPHTPFCCYTDCF  PVYSKIUOAIVGU   LCAJAUFS        UIOKICN        
OWNTXREBJDETQ   : IIONFMWWGPBHVS  BYJHTUOXX       GSGTISJLRPRBGNA
AVWYVY          : GCOTNOFWT      
JTAE            : COPTQYIAAJPB    AILOEF          SAETFMRJAIBLG  
QQCMHQLWKLQPM   : EQRLEIRSWYH     RPYHO           AGLMGKWPUNIKYBA NGYYBBGYXSFNKYE OPVCA          
UQWOLAMIYJH     : RXKEYMLIRBVM    KHVYYSUECGJQRGN JIGRRBMLCVXS    BYWFARM         TDTQIXQMCT      IKRTUSHQNX      HVABPP          QQADNWFPHMUJVO 
SEDWXWOBLX      : VTTGPEMUXYXAIMV OPGOEXH        
WUFIMWWPRQ      : UAMIMTJUXUAX    OPPCPMSDTBGHFRP OVHCSC          VTQFUGDXHROIELJ
GCOTNOFWT       : EDWOQEQV        XYOIOPE         REVYILQG        AVWYVY          HKHMWB         
BYXCVM          : IXGXS           LPPEMGSRVMPTDD  FYSPHPKDCOEIH   MKXKAEREBBYYNRE KLINXV         
JKWGHE          : IVWKHFNH        BAOEWKPNRTONX   KTCNSTQXGL      RCYARPV         WPMJQNLBDWWD   
VBQNV           : RNXLHC          HYJCBL         
DEJRXWIFUCEX    : CUJEVEBGSTTXWHU XGTAYNGLSP      XKFHJLKF        LJSEJXPLDJRE    XNXDSGORBR     
CAAQFKDF        : MAYBKLVWHKBTIRO HVABPP          BBCKNITA       
KLMJNDWJKANVS   : VQLTXOHEJ       HKHMWB          RIJNXIXODOMOKVX NUDLJTXHP      
TDTQIXQMCT      : LEORJEQXTOWP    FTYOWTAXF       UQWOLAMIYJH     GLEECPWWJYQSNC  WHHCNNEHCTLJW  
SBWVISJUF       : IXGXS           NSENHJMCQ       GHDTLQO         FEFVLWRY        TOFG           
IKRTUSHQNX      : FJLTDLNSEOEE    QQSJKMJ         OAYKTVVNDA      IWBDVSGYH       LNSKJXFGDMFYP   YSFQHDVDWRD     UQWOLAMIYJH    
SSFBSWNXQBQ     : HVFVUVKDNMILIK  JBWVSVHYLSWC    NDGU            VDQYAGCR        FQHVWI          BACGKHUSLF     
APDUBXAVGKNCH   : YTAOAVXX        MTDXW           JPRDBXTNPY      EMRSRVUEHIBCHG 
JBXINR          : ALUEJGLIMORYGT  MSQCFGIDPJGD    ASGPYCNYDVSSAEI RXPVEPYBN       WGBXDKOTMUJKCB 
TSXSJVJ         : TLYJ            NTCSFEVOVME     LCGQHURW        TTPGV           ASGPYCNYDVSSAEI QYGDRJAYXCFRQ   JRGGXVFCJLA    
PDMHGII         : FWFEXBXAV       LOOA           
KGOXV           : RGEYHEAWC       LGXQAHFU        JPEOGTJDWLHM    TGCX            FCAG           
FFBIDL          : JPRDBXTNPY      QAGBWW          EVFJCSKJJATY    XNXDSGORBR      NRBIUTHD       
WQSSOLCNWM      : HKHMWB         
CBMLLWRWDHW     : IXPGIFIOV       AGLMGKWPUNIKYBA MIJOEOCKJFFHR   FITVLUM         YXEWWVEFX       JECMWBHJHWC    
XEGBNKOMJFFCW   : BAEWAMPG        AJDSNOLXTNNH    HRTPKNEXI       IFNE           
EMRSRVUEHIBCHG  : NPGG            WXGITNK         APDUBXAVGKNCH  
EFLLMNYYENKK    : XQIEEVXRPV      IMSLFBL         KNIE            SYXXJUPXAKOU   
NJNRVHNPDKTNSWP : ABRQBTPW        PHGNKUCFV       XDQUSPGBVWIVLNK JUBYKKIUFQAJGKM
DDFKOQY         : MSNOPI          HFBKQQWHDPXW    XKDBUYSSEDG     UVGPO           DADJVXP         PIQXWGFTF      
RAHFLTAYFPS     : IQHDAK          NKHKWBTTOWI     QISHBABWNQRMI   AETED           BVCP            FNLPULOD       
WGSDQOQMLGNQJ   : RNJCUJTWXSLIW   IKSJTLELVO      OEHBRPWTKO     
DAODDIFMOQIQRNH : VOJHKICMAGL     JAGEQCRONA      NWLGEOEYOF      BBBC            SRURQRB        
QGVLJPAACL      : PSIQU           FXJM            CLAOUPVVPBEL    XRNXSH         
PETMHUBKAM      : TPHXDDYTR       KXIEW           CVSTHG          FPWVPMVNSLU    
OBJYTCMBRF      : FHKYH          
NQTD            : ABRQBTPW        IJBDHOFCOPX     DUXKNRWTDGLCO   HXVKWBEJIPCKJU  ASGPYCNYDVSSAEI KUFVGB         
WFEHWICMPYNDB   : EQRLEIRSWYH     ASMPCHBULD      CROKVEABNCW     GUDPFTDCN      
VPDFOXJDBB      : SUKVWG          NTCSFEVOVME     USSAQUSIYL     
NRBIUTHD        : VCVIREYT        FFBIDL          NUYFK          
OCGSOXRFBSHWKL  : UTHTHQEE        KCRFWMHNK       HIELSRAPCT      VEEK            WGGAHKHISWNKVIL
BLQGOSQDKTNHNUK : EPWDQXRYMSJL    IFNE            QQETKMCORQKPN   DPACK          
JNTDCSW         : NHVSPCKPWNN     MKINHAYBJHL     XMEXAYEPINC     QDXFOXAWFHP    
TSRTFFBHQR      : KHPK            JVHD            BEAHHHJDOSYO    DYUFJMRAQXCXHL 
HKHMWB          : IHRYXAYFDRMF    WGHDVKBKJW      GCOTNOFWT       KLMJNDWJKANVS   WQSSOLCNWM      ASGPYCNYDVSSAEI CHQFALGBNONJC  
HPWRDJHXMMQLVME : QEBKXXPLTNOYHCM UCBIOTBDLDR     QCKQEVQ         UJMUYMKIJHJU   
IKSJTLELVO      : DSYMOBN         LCGQHURW        WGSDQOQMLGNQJ   UGSQHHFWTOMEF  
IOWLVOIPTRARGOK : QPNPCMXOROERBPM SXXDEMBFO      
MAYBKLVWHKBTIRO : WUDXOCDW        RKEEGFRRVRFYJK  PWJEPLXPKMX     CAAQFKDF       
GLEECPWWJYQSNC  : BAOEWKPNRTONX   VNQTHDEAYKYCDB  TDTQIXQMCT      ASMPCHBULD     
AEODOB          : ITSNIPGPNC      XIDX            XXPBNL         
LIOMEWF         : CHWXVUWAPPR     QMQDWC          HYJCBL          GUDPFTDCN      
RNHYUKQRHAQXU   : XGTAYNGLSP      YQADFGNDUNWVV   SCTSDAFBHSCRHTY
CIGGXMXB        : YXWTERVO        HWFTEGSODQ     
LJFYQEGKVVRU    : UKPMENRBLRB     NOFV            IJBDHOFCOPX     TRXNIC          OLLYDDBCPVXLJEN TPLHWTDBIQARW   BNQY            PPHQXXGWS      
LJFYQEGKVVRU    : XWDCJELKOEQDR  
ELKNODOJJQSSASF : KUQFPJUU        OSVAGGBFP       MPAWEGHPSYXM   
TVLFBMVFUIBRDY  : JVXDNOHH        CKKM            TFMJJUEEYKQTJA  SRWMDWIBVOFFUR 
HMVVBYKN        : FYSM            OHFQIUSHCXXPUH  NJEEYLSYIYQLJM  XKXVDSS         NIBYITSM       
DICFB           : ITSNIPGPNC      GQHRUPKOM       KLIJ           
FUFRAGGYNCHQ    : PIWJPUUFDN      RAQNQYJA        GEEJSUTGGTLIM   MRDVJHWGAIKPAV  RXFKTEBU        RJJQP           KPHPQVXFYTGHCE 
KPEUDAQGADTLIC  : AWLCGWDM        DNCKGYNSPPGPLM  FITVLUM         UXDJ            RBVCKM         
OFYVAGNDMWEC    : RSGFXIIYDLLJSLC XARF            PIUY            KSSG            UGHFQYUCLUW     CKKM            GUDPFTDCN      
LSSYJYTOAMWCRRP : VHMOJEMG        SHDDNJDUDKRV   
VFQCGNEMD       : NUDLJTXHP      
BALDYAXTYHTUX   : PMEFGNGMDLEH    WQFDDCNUTNOX   
HVABPP          : OOBDTRJ         NTCSFEVOVME     CJXCHVSDOCIHC   UQWOLAMIYJH     CAAQFKDF        HYJCBL         
LWUPDIURNEUQSA  : MFMIHVDLT       IXGXS           EQCDAJSLXVGXST  RFBBEN         
SXMTGIQ         : UOKEYQVSQ       NPGG            FPWVPMVNSLU     RNSQVBNSUEATSKC NFRKJVGPRUHWBCT LRQTOAYXQCETU   DPACK          
EXCEBTVC        : QJDEVPXCJXY     BEDIQIMLRVQHTF  DUKYJOPRVERQT   DMKMF          
SYXXJUPXAKOU    : RFSQDV          RNJCUJTWXSLIW   VHMOJEMG        EFLLMNYYENKK    RJJQP           FLCWWVL        
GPISJQDCAJCEPD  : ABRQBTPW        OHBQELXTSKKYMA  KSSG            HYJCBL         
LHHEHHEQ        : MSNOPI          GTBFYV         
TOFG            : SWTIDNXDWC      DOEDDMCXWPFUAPR YLAKSAXMBPSA    FQHVWI          SBWVISJUF       LBBMPDWFLBG     UIOKICN        
ASMPCHBULD      : IWBDVSGYH       XSHQRLTNXKSKFLC WFEHWICMPYNDB   GLEECPWWJYQSNC  HQBIVXAGXKJTQ  
WFCNIB          : LVRK            AFPPK           SSQTPBHRTWODOU  YGACMPGYWGO    
PKGYRM          : DGJVSYUSD       CFBCOPVFKP      IWBDVSGYH       BACGKHUSLF     
WHHCNNEHCTLJW   : JPGJ            VCIXENWGMYB     TDTQIXQMCT     
WCIUH           : CLAOUPVVPBEL    MRYTFKSGKWMDTAG HSLTRYVFSWDHX  
KRNLKARJT       : RTQDMFCIA       FRFP            NEWXYMI         YSFQHDVDWRD     JVXDNOHH       
CROKVEABNCW     : OQUWIJDF        TYSH            WFEHWICMPYNDB  
LUML            : RGEYHEAWC       YXIUVDUMH       HIELSRAPCT      SVDDMPAD        LBBMPDWFLBG    
UGHFQYUCLUW     : UKOFQGNISROWDR  OFYVAGNDMWEC    CIUUEDMUYG     
OEAIUMFBMGPO    : WQYRBEBQK       XJVPQMA         UJAKTUOOIIGC    VLGHELVBCCVS   
QDXFOXAWFHP     : UUEHY           JNTDCSW         TYYGPWCA        EGEKB          
CTSWSQOYS       : XALHASQQO       CCAPVUMTLXBXHGK BOGHTW          DLNVMWEFHJRJVSB VJLJTRODQUJXS  
TGCX            : LIFKRK          KGOXV          
KNMOGPOMG       : BFVRTTNGJGUUK   ANDVXAXFQPEL   
OFTWWBBQVYMOPL  : FRNJSWSNMSOXRB  PDKOGXXFPLUF    OCOAX          
MIPRGLCVAS      : VQLTXOHEJ       OHFQIUSHCXXPUH  XCAJTULB        JYGAY           XGTAYNGLSP      KPRX            UYFSA           JRKAEXJI       
MIPRGLCVAS      : DCBATYPVNWKNUOX
PIQXWGFTF       : YXOJYEKWYUDG    LLEJODMGNHFIX   NDBJQUYSAYXJWXB DDFKOQY         VDVPMRAWIHN    
UGSQHHFWTOMEF   : IKSJTLELVO     
KSIG            : XXMBIFW         IKYW            QJYUOFES        AGXQLFHXBTICWI  DRBCVUEQBVHLXRA PTAR           
CKKM            : QJUDPHRAHGLOV   IFJFMVY         XNWLHDXR        TVLFBMVFUIBRDY  OFYVAGNDMWEC    CAHAXXNKYHIJRG 
KLMPFRRCAM      : JYGAY           RLWIPSUTSWXYC   DFDXFAGVSIV     RWDTBUDROIAJOIX RJJQP          
IUAHQRV         : GEEJSUTGGTLIM   YNYWSKEHWQGYKIS FHXWWQG         WGHDVKBKJW      XJPRQEYDRNCNY   ROIEVCEIJLRWX   CYWVWNNFK       VQKL           
IUAHQRV         : FNLPULOD        SXWVSROLVIVKKNC VDVPMRAWIHN    
WCHRL           : YJKQJYYVTWMF    PGNUCMDNXYSLMNP YUUXR           FCAG           
MPAWEGHPSYXM    : VLGADHGRCCFIKO  ATWHIPBTTMI     HMUIRWWE        JIGRRBMLCVXS    XRMKOPCHJ       ELKNODOJJQSSASF
ANDVXAXFQPEL    : UEQWLNW         GWVVMBVFPHH     RGWVFGVPNRL     KNMOGPOMG       TJBGIBS        
GSGTISJLRPRBGNA : NHVSPCKPWNN     GHPAOXPEGKDYL   KJWTDTMS        OWNTXREBJDETQ  
ASGPYCNYDVSSAEI : ECLISPUCOCHRKT  AOPB            JBXINR          TSXSJVJ         NQTD            HKHMWB          NFRKJVGPRUHWBCT PJYRNLXXPLX    
AQDKM           : FWFEXBXAV       ITPXDKNUFAAGXQM HCWHS           NUYFK          
XEFSILGIRGEAY   : WYAVGQ          VCVIREYT        CTXWGPP         UYFSA           TSWFONPQUJGHQE  RFBBEN         
FMEIKWDKELV     : CAHAXXNKYHIJRG 
FYQRNP          : SGGYSYQIKYGEAPJ LBSOIELONXFLXG  YJUEA           RUWORVMB        YBWHWWGDOEF     MDQSXAAGK      
SIGGORAWVBVY    : QJPFPEBUEKBKDA  RVPE           
LDQVDTJH        : MLCABB          CGHSNM         
FNNGEFTTD       : ITFIUGTPSBX     AOIE            WLMKEQLELEAGA  
EKVUCWSA        : CSVSKDSPGFRJLTM VAWD            BGPFQWUYV       CYMRC          
QYIEEBDJWOQ     : FGBDROFXANVQ   
TEWALEVHKLMW    : ITSNIPGPNC      QNJYUEF         HBUNGJRONLE    
HYJCBL          : VBQNV           LIOMEWF         HVABPP          GPISJQDCAJCEPD  SAETFMRJAIBLG  
CVAIWDSVRLGNQ   : VFEMPOTTHWUDG   HJPWW           PFQSHW          BACGKHUSLF      JRGGXVFCJLA    
PEIMLSA         : MGMABDBYXYURC   JFPRX           QAMTBSM         PTAR           
PMIQV           : LMCKSIFHNFWIUHC VLGHELVBCCVS   
THGV            : NAKVCO          SWTIDNXDWC      UVGPO          
JECMWBHJHWC     : MXGVLGKUE       IRLPPOTGWDBTOXJ YKEBF           CBMLLWRWDHW     AUBU           
NGUCTPEUHRDA    : PYWIW           UTHTHQEE        OEHBRPWTKO     
PTXYPBIUEWTHG   : GQHRUPKOM       UXRHWIMKDT      CLAOUPVVPBEL    KTREEVVUTAUEB  
OEHBRPWTKO      : FLULWDDLH       HWFTEGSODQ      WGSDQOQMLGNQJ   NGUCTPEUHRDA    NUJEKXHBIS     
FWRKYI          : NPERRXDUVAA     WTDEGMVQFQXXPJM GRSNLST         NFCDYPXI       
TGYJHJG         : LMCKSIFHNFWIUHC PWMYFKQNF      
HBUNGJRONLE     : TEWALEVHKLMW   
HQBIVXAGXKJTQ   : NJGT            JOCGW           ASMPCHBULD      DKFOIEICGBNANYP
FYUMO           : KJOKBB          RFSQDV          QJPFPEBUEKBKDA  FITVLUM         HKLMUTJT        NWLCRXQCMYSK    RMJWPV         
PKTVV           : BEDIQIMLRVQHTF  OWNLNUXMJGPXNQS SSQTPBHRTWODOU  OWHRTHHUIEVL   
MJATVK          : AKEIKJDLVYFQLJA AILOEF         
XSHX            : TMWU            VQKL            NWLCRXQCMYSK   
PXGBRWM         : MTIMUM          TBNKO           XGTAYNGLSP      DOEDDMCXWPFUAPR VQKL           
XJMN            : BFMLCFMTQEVVG   CGHLJUJOTOVCU   KHVYYSUECGJQRGN CFBCOPVFKP      GNEYGOV         OCOAX          
CAHAXXNKYHIJRG  : IVYNDPGDXQ      CKKM            FMEIKWDKELV     KNPODOKIEDR    
BHBTFHUXHJXFS   : KRUAOJHOLEODO   BTETAOXDQI      NPGG            YSQCXRMXG      
UGMWQMVQCIPJ    : SWTIDNXDWC      YSFQHDVDWRD    
BEAHHHJDOSYO    : XRSUPVJXQWPGL   OEDQGGWM        NIBYITSM        TSRTFFBHQR     
IMIEYDKND       : QXVUXKEM        NIDKACBBQHHDLC  XIWKOUEM        FLCWWVL        
DYUFJMRAQXCXHL  : LPQLXNF         NYHMRFNSMDE     TSRTFFBHQR     
LBBMPDWFLBG     : HKLOFGG         RPYHO           ADRWHNTXMEIMFC  GREXKPCFQFAKW   TOFG            LUML            WULDL          
MUURXVO         : TFIGTU          FTYOWTAXF       TPUNWKKA       
HCWHS           : AQDKM           TDNQHSKHOL     
MSDX            : ABRQBTPW        HDCYDTKHJRASQ   JPRDBXTNPY      AJSKBVX         PMXGMQRIL       OGWIA           JKGIWWDBKBBTTY 
QYGDRJAYXCFRQ   : FRFP            EVFJCSKJJATY    TSXSJVJ        
MKXKAEREBBYYNRE : PTXQSDMO        BYXCVM          WUNDAHPAG       XVUKOVXEFKVXC  
WUNDAHPAG       : IUNHWJFR        MKXKAEREBBYYNRE
EMHWMVINGK      : AFPPK           IXGXS           LFKJHKFI       
AOUD            : MTJWLBMSBPFO    JFPRX           GPOUA          
VTHAIHWX        : IMSLFBL         XIDX            BVCP            KTREEVVUTAUEB  
YGACMPGYWGO     : IGPNNIFXGUY     RSGFXIIYDLLJSLC RQATVWLTT       VNEWIYCKHNEY    KHEIH           WFCNIB         
QCBBVDRSH       : CAVIJSOBDLV     IASF            CCAPVUMTLXBXHGK XDQUSPGBVWIVLNK
PBQRL           : NHVSPCKPWNN     JLAOLOJ         OAYKTVVNDA      OPRRCWRUCSLI    OCOAX          
RJJQP           : FUFRAGGYNCHQ    SYXXJUPXAKOU    KLMPFRRCAM      QQKTXBMHYPMMNH 
SDECEDKSYBWCCS  : BUQHYCPXYCFGROR QJVPMBQOQOME   
VOPDESTXEU      : QEBKXXPLTNOYHCM NLCGVGKR        DUXKNRWTDGLCO   JAGEQCRONA      RFBBEN         
PGJGTCLXGRE     : WQYRBEBQK       YIFYVDDPI       HTOTWORA        DUKYJOPRVERQT   VDVPMRAWIHN     GUDPFTDCN      
NFRKJVGPRUHWBCT : BLCUQEQJSVVMSL  SXMTGIQ         ASGPYCNYDVSSAEI
GOPWU           : TOPRFXLOFPBPJ   RAQNQYJA        QUAJSSGV        QXWOMSLSMDRKKBR UKOFQGNISROWDR  YXWTERVO        CFGLCPWI       
FQDSRKKVDXDXLM  : LGROEUT         PWDY            TYSH            NUJEKXHBIS     
TFOOM           : IVGDBGMODTXC    XKMAG           PIFOQFJED       JKONNJOICTM     MACOJNTFISDGN  
PPHQXXGWS       : FBQD            BYWFARM         SHDDNJDUDKRV    LJFYQEGKVVRU   
EMNWEAKADIFBVRX : MGMABDBYXYURC   UEQWLNW         WNXLMWOTXLQTIA  YPVQEVJC        FXJM            XEAVJQDMTRQSO   XSHQRLTNXKSKFLC
YMEMAVEINEGVECG : SUKVWG          QJVPMBQOQOME    PTAR           
OTISTSU         : CQEY            XTSOVYNIMSLTD   PWUNMFQ        
DCBATYPVNWKNUOX : UKOFQGNISROWDR  KCXJCNB         MIPRGLCVAS     
UHJYLPKCJ       : KKIQROHABKNIU   BBCKNITA       
WFLTEOVH        : SGIFNVLPSDQPR  
RIJNXIXODOMOKVX : IFPFC           KLMJNDWJKANVS  
HPVLBQIGEC      : AJDSNOLXTNNH    TPLHWTDBIQARW   IGXF            FPIYO          
VXWMQHX         : CSVSKDSPGFRJLTM DSYMOBN         QHEXCDSDWFEV    XYMXFFPNE       DVWS           
GGFW            : PRWRLVCMC       VQKL            JRIUOQCESRFI    MVKHFWSTAHFG   
TJBGIBS         : MUIVYXXJMRJYDW  TSWFONPQUJGHQE  FEFVLWRY        ANDVXAXFQPEL   
QQETKMCORQKPN   : QJDEVPXCJXY     FXJM            RUWORVMB        BLQGOSQDKTNHNUK
IXXPGFUDRQ      : MEQJGTUWOVCCY   ABMA            TMVY            VPSVA           CHIPVSSTC      
SXWVSROLVIVKKNC : PRBBT           BRDQMXTJPQOLEW  IUAHQRV        
AURADPBUVGRYA   : TGVWMEIXBT     
PSJNOEFFRDNQNX  : LIFKRK          QCVDWDF        
SYEPSHSII       : RNJCUJTWXSLIW   FXQJUSLUJSCOSHD EVFJCSKJJATY    FUOJUOKA       
GQIHQ           : LMDCL           EDWOQEQV        RXFKTEBU        QAGBWW         
XLDNCJSHCXUSNUY : KSSG           
VDVPMRAWIHN     : KRUAOJHOLEODO   CGMXQIGADMVUF   CHMNFMG         IFJFMVY         JOCGW           PIQXWGFTF       IUAHQRV         PGJGTCLXGRE    
QGNO            : YXOJYEKWYUDG    AQEJFUB         HQUUSCY        
QCVDWDF         : PSJNOEFFRDNQNX 
AALWYTT         : RXKEYMLIRBVM    UEQWLNW         XYEGSU          XNWLHDXR        MLQFJWULRXEDY  
QJRKLOU         : AVXOVQIE        IKOAOJDCCDE     FQOQVYQYATR    
DNMLBDGUGCXFI   : AFPPK           MUIRCLXVA       YNCL            XHGFRWFCBVX     XPDGUD          SWPWVBMLAYMGKEV
DKFOIEICGBNANYP : HJPWW           FBQD            HQBIVXAGXKJTQ  
UUYJGCMMWUR     : XBPEDDJVNGRHHEL WWYAHF         
BACGKHUSLF      : RCPOXUIWLLLVWAB DHPBTAN         SSFBSWNXQBQ     PKGYRM          CVAIWDSVRLGNQ  
UJMUYMKIJHJU    : NHWFDQHAGAMMSW  RCPOXUIWLLLVWAB IKOAOJDCCDE     HPWRDJHXMMQLVME
LHDLDUIGWNMI    : NPERRXDUVAA     SUKVWG          PKHTAJOMP       OVHCSC         
JDJQDGAP        : GRSNLST        
AEOK            : KKIQROHABKNIU   CKGFARTLKTEQD   EKILPB          VAWD           
VTKM            : VLGADHGRCCFIKO  NGRPXJCBGCR     EWVBN           STBI           
SQSVNE          : VOFVEGAHTT      VPSVA           HQKYJGXP       
LRQTOAYXQCETU   : CAVIJSOBDLV     SXMTGIQ        
TYYGPWCA        : VPSVA           POGRGVM         QDXFOXAWFHP     RVPE            CYMRC          
JSDFQQJUCD      : VLGADHGRCCFIKO  CKGFARTLKTEQD   IRLPPOTGWDBTOXJ WTCK           
XRNXSH          : MIDGDN          BWDDNW          BHXW            QGVLJPAACL     
YBWHWWGDOEF     : DBSJXEGIUVMKNN  UUEHY           GHPAOXPEGKDYL   KSSG            FYQRNP          QDFKGKQPCCQUQD 
QQKTXBMHYPMMNH  : YXEWWVEFX       RJJQP          
NAKSYNPJKOP     : YTAOAVXX        LGROEUT         MSQCFGIDPJGD    POXCAIBKWGJEOK 
DVWS            : KBSEJNSY        KRYTQVWJCEILOU  VXWMQHX         OGWIA          
PDKOGXXFPLUF    : MSNOPI          LOBAVOKNAEUPL   EGDKCFGWIMXK    VCIXENWGMYB     OFTWWBBQVYMOPL  RMJWPV         
XVUKOVXEFKVXC   : FHSVQRGAVLDMGY  XYOIOPE         BRDQMXTJPQOLEW  YOBLGGKBROWD    BLCUQEQJSVVMSL  MKXKAEREBBYYNRE
VYTLQWXFGXE     : HSMNWWDVIOV     OJOPKM          PVLJKIHXPOKO    KEGOTDUGEYVJ   
PPIVKITHSIDS    : TPHXDDYTR       JOCGW           RSRUAJX        
LFKJHKFI        : ENQCQJWLBDNWCV  EMHWMVINGK      SAETFMRJAIBLG  
SAETFMRJAIBLG   : FMDBFKT         BRPCCJQXKQMWTU  JTAE            HYJCBL          LFKJHKFI        MDQSXAAGK      
TAWNI           : POGRGVM         KKCDWPYRSVV    
IWMOKXVWFHDYH   : NHVSPCKPWNN     SXXDEMBFO      
SOVMBWUEKDUEDR  : QISHBABWNQRMI   QXVUXKEM        OVHCSC          HIVD            FEFVLWRY       
NUDLJTXHP       : WTBC            FSFJPD          KLMJNDWJKANVS   VFQCGNEMD       MUWVJWVNPXSPJL  YKBNOSMWF       NUJEKXHBIS     
NYXOIIJXGVBFTFP : AOPB            BAOEWKPNRTONX  
AUBU            : OIPYDVVAKCK     VOJHKICMAGL     BRDQMXTJPQOLEW  GFLVJFFFWNNN    JECMWBHJHWC    
OPVCA           : IHRYXAYFDRMF    WRDP            QFVENXV         XOSBVKKAS       QQCMHQLWKLQPM  
CHGWWHXLQGUO    : JURPGMK         PWDY            YIGXDXMDFYWYI  
TPUNWKKA        : CUJEVEBGSTTXWHU RNXLHC          YJUEA           FXQJUSLUJSCOSHD MUURXVO        
NUYFK           : YIEYHLWTMF      NRBIUTHD        AQDKM          
HKLMUTJT        : UEQWLNW         CCGFCNFIYUPLTHI RQATVWLTT       JBPAKLRWMKL     VHMOJEMG        FYUMO          
HGTPDIFWAAKAKXA : WYAVGQ          AJVELG          XHFV           
LUTQHQBUENPXY   : NPERRXDUVAA     KXIEW           CTRXUKLTUDOP    CHMNFMG         VHMOJEMG        WTCK           
CHRVYVHEUJGGJ   : XKMAG           IXPGIFIOV       KHVYYSUECGJQRGN JBFRGYMQD       GGQNTAWQH      
EJORGKLOBOJGCB  : LMCKSIFHNFWIUHC GHJTPLNBFKUB    YOMPRQWQWD     
DMKMF           : FQPAKJUAGLHJ    CNXHSFBAYQ      EXCEBTVC       
MDQSXAAGK       : QVVDVWIWV       MHLFTIMAJ       IFPFC           FYFHIGXEDBSHSMG EJQKXDXAWW      FYQRNP          SAETFMRJAIBLG  
MVKHFWSTAHFG    : LPPEMGSRVMPTDD  LJNNQREU        BGSEELRQJXJUMU  RNXLHC          CHPMICRJIDT     GGFW            XWDCJELKOEQDR  
GPOUA           : XARF            ENTYTDO         AOUD           
CHQFALGBNONJC   : MTIMUM          LJKLEVMDCA      HKHMWB         
VJQSEKT         : XYMXFFPNE      
RCYARPV         : UVJQFEYVCF      JKWGHE         
VXEMGFBM        : CQSGRVTYVO      TOJX            LEORJEQXTOWP    OVBKKWQHAG     
ODVYFHWQY       : LGXQAHFU        PLGGMTOFC       YPNUJVHG        QGRMX           DHPBTAN        
WLMKEQLELEAGA   : MTDXW           VRVVXSM         FNNGEFTTD      
KPHPQVXFYTGHCE  : POINBHKXGD      CLAOUPVVPBEL    XPDGUD          RSRUAJX         NSENHJMCQ       FUFRAGGYNCHQ   
BWXMLISCUXNBAVB : ANCOEOING       LJKLEVMDCA      EKLICT          LMNTOSM        
HQKYJGXP        : JBFRGYMQD       XARF            CKMKBISUEP      SQSVNE         
RXPVEPYBN       : LGROEUT         MSQCFGIDPJGD    VPIHNFTCJF      JBXINR         
OWHRTHHUIEVL    : NTTCPYGOUSK     GHJTPLNBFKUB    HDLTU           RUWORVMB        TXULA           VJLJTRODQUJXS   PKTVV          
PWMYFKQNF       : PIWJPUUFDN      FIVWQOLEKHVGD   OPRRCWRUCSLI    TGYJHJG        
DBVTBAH         : VWSAQBXWB       JVHD            KXYFDLVGATTO   
OGWIA           : LMDCL           XQIEEVXRPV      ALUEJGLIMORYGT  QHEXCDSDWFEV    MSDX            DVWS            WULDL          
SWPWVBMLAYMGKEV : RVBS            GRSNLST         DNMLBDGUGCXFI  
XASTVVTF        : WJQDGXGQO       TTQIT           CIBYSTASNOIS    VFPYGVXG       
LMNTOSM         : KLWEKQQ         NJEEYLSYIYQLJM  BWXMLISCUXNBAVB WPMJQNLBDWWD    GUDPFTDCN      
KLINXV          : EQKHKFUSPTNR    MSNOPI          DRBCVUEQBVHLXRA BYXCVM         
XIWKOUEM        : KRUAOJHOLEODO   WYNTJMTUFEA     KXGSA           YSFQHDVDWRD     IMIEYDKND      
WHSVDYJ         : SGIFNVLPSDQPR   SKRTNTVOE       WNQGTBUUB       LCGQHURW       
NWLCRXQCMYSK    : GQDLQKDCNKUOEQ  EBXDBBKBP       FYUMO           XSHX           
JKGIWWDBKBBTTY  : HHXGSI          KOWHW           JBWVSVHYLSWC    IBDYTKWRWWSDGDT LJSEJXPLDJRE    XTSOVYNIMSLTD   MSDX            RFBBEN         
UIOKICN         : AJEXOTWNKGWQ    HKYNKYA         YXAANUWRXQMIS   TOFG            EJMPCXXUPIJNE  
CEFO            : MFMIHVDLT       CVIVBFJF        BEBM            CJWVUVFBT       EPWDQXRYMSJL    SGOCBCFWAW     
ACDJO           : CCYLQLM         DIOASOU        
RMJWPV          : TMVY            UJFW            FYUMO           PDKOGXXFPLUF   
SRURQRB         : LGROEUT         YULCUIEUQTKBEHE YPVY            DAODDIFMOQIQRNH
DLJS            : NKHKWBTTOWI     MHTHDUCJXJNIDAI
MYSDF           : KIJLARRCWGXUN   JLNFVDI         VPIHNFTCJF     
FLCWWVL         : XYPWLQD         OAHDSDEJEGDVQIT KKCDWPYRSVV     OHYCPHJDET      SYXXJUPXAKOU    IMIEYDKND      
TBERUXOOPHRYKD  : FYSPHPKDCOEIH   YQADFGNDUNWVV   BHXW            VAIHLKIF       
DPACK           : YUHLGXHIWRQDLK  TMKRSGWDPCXV    BLQGOSQDKTNHNUK SXMTGIQ        
KENX            : XGTAYNGLSP      YPVY           
KUFVGB          : DJUG            JLAOLOJ         BUQHYCPXYCFGROR EUAKKPQHATCLFS  AILOEF          NQTD           
MUVLKLDTDEE     : LMCKSIFHNFWIUHC EWVBN          
PJYRNLXXPLX     : NTVWPM          RCPOXUIWLLLVWAB TRJYQCFPMS      XNWLHDXR        YIHJVDV         ASGPYCNYDVSSAEI
VTITCJSOEP      : JBPAKLRWMKL    
QDFKGKQPCCQUQD  : UUEHY           YBWHWWGDOEF    
QUGPXCLGVNPQCW  : LIFKRK          JPEOGTJDWLHM   
HPLMDUYTKCWEY   : MTJWLBMSBPFO    GREXKPCFQFAKW   CVXMUWHAE       XKDBUYSSEDG     HRJRXANTFMQPJMM TDNQHSKHOL     
JRGGXVFCJLA     : YJKQJYYVTWMF    OLBWNDPJFK      XPDGUD          TSXSJVJ         CVAIWDSVRLGNQ  
EQCDAJSLXVGXST  : CVXMUWHAE       GQDLQKDCNKUOEQ  USSAQUSIYL      LWUPDIURNEUQSA 
RABHJSNP        : QOXAVGBTWFSWJPN WDNNIQPNEXSML   FIVWQOLEKHVGD   OEPXKCVJ        ENTYTDO        
MUWVJWVNPXSPJL  : FQHVWI          NUDLJTXHP      
HKMHFI          : JKYHYFKCTTSUN   STQYIEB         REVYILQG       
WIKETFRMXGJU    : JBGEJFDLELC     STQYIEB         XYEGSU          UXDJ           
STBI            : OUMXJISPOUK     KPRX            VTKM           
BBCKNITA        : TTQIT           CAAQFKDF        UHJYLPKCJ      
CFGLCPWI        : YOMPRQWQWD      DUXKNRWTDGLCO   RGVIKU          GOPWU          
ECXDJIAO        : HDQLWGUSWBXB    JBGEJFDLELC     IICRIVGXY       OOXRC           SUCMQCKX        POGRGVM         LFCBDCHFWK     
WPMJQNLBDWWD    : OLLYDDBCPVXLJEN YPVY            JKWGHE          LMNTOSM        
YKBNOSMWF       : TDTRTPYRWU      NUDLJTXHP      
ADVJNY          : FWFEXBXAV       KUQFPJUU       
RVPE            : WNQL            AILOEF          SIGGORAWVBVY    TYYGPWCA       
GTSJXPI         : EJABFYPKYJXDOE  VLGHELVBCCVS    GBDUHGIO        YQWSFF          DOEDDMCXWPFUAPR
KIOMXDFKB       : PIFOQFJED       PSIQU           RQATVWLTT       POGRGVM        
DDQCMGBMA       : OHFQIUSHCXXPUH  BTETAOXDQI      QAGBWW          JVXDNOHH        WGGAHKHISWNKVIL
EGEKB           : EQRLEIRSWYH     MXBERFUIGRR     KXYFDLVGATTO    QDXFOXAWFHP    
VYPECCOSO       : VDQIXPSAVSVPOEH OYANMJCXJS      EPWDQXRYMSJL   
WWYAHF          : XALHASQQO       BJFJJXUOFUPCESY AJSKBVX         UUEHY           UUYJGCMMWUR    
AHRJKGJJKQN     : ECLISPUCOCHRKT  TGCOVOUWFRPWX   UKOFQGNISROWDR  JPEOGTJDWLHM   
ROSSGYU         : EDWOQEQV        QXVUXKEM        XKXVDSS        
QQADNWFPHMUJVO  : JFPRX           XXPBNL          UQWOLAMIYJH    
GUDPFTDCN       : WFEHWICMPYNDB   LIOMEWF         OFYVAGNDMWEC    PGJGTCLXGRE     LMNTOSM         MKDD           
WGBXDKOTMUJKCB  : IGPNNIFXGUY     WQFDDCNUTNOX    XUCAERI         JBXINR         
OVBKKWQHAG      : RYQL            VXEMGFBM       
VLQJFPRIOUUFRIA : TBNKO           EJQKXDXAWW     
UCDMSBPDOOVV    : WRDP            NIBYITSM       
EJMPCXXUPIJNE   : ATWHIPBTTMI     QAIFXQCM        UIOKICN        
FMRGHVLVPP      : CGHLJUJOTOVCU   CNRSYNBLPVR     JLAOLOJ         UAYDF           FRFP            HXVKWBEJIPCKJU  DRBCVUEQBVHLXRA
UEDTATXJJOOHOJ  : XYFQW           RJSLUTOSBVQSGLL XKXVDSS         PHGNKUCFV      
WULDL           : DNOFSVL         KXIEW           GEGLDL          OPRRCWRUCSLI    LBBMPDWFLBG     OGWIA          
RFBBEN          : XSHQRLTNXKSKFLC LWUPDIURNEUQSA  XEFSILGIRGEAY   VOPDESTXEU      JKGIWWDBKBBTTY 
TDNQHSKHOL      : NTVWPM          WAWSVBDHEQHPKK  HCWHS           HPLMDUYTKCWEY  
XCKGQTGPQTTCM   : LGROEUT        
KNPODOKIEDR     : WTBC            FTYOWTAXF       CAHAXXNKYHIJRG 
OCOAX           : YOMPRQWQWD      HPHCGPDASRWX    FJGYKWMTHYBFNEH OFTWWBBQVYMOPL  XJMN            PBQRL          
CIUUEDMUYG      : RGEYHEAWC       ELHDHLIAVIBC    UGHFQYUCLUW    
NUJEKXHBIS      : AEEGTL          CJOCDMNQFBCFGJ  OEHBRPWTKO      FQDSRKKVDXDXLM  NUDLJTXHP      
MKDD            : EGWXVS          POINBHKXGD      GXQDVW          WYNTJMTUFEA     OPPCPMSDTBGHFRP YRJXGCVKIJ      SVDDMPAD        GUDPFTDCN      
TFMJJUEEYKQTJA  : LOOA            MTHDY           WGGAHKHISWNKVIL TVLFBMVFUIBRDY 
XWDCJELKOEQDR   : MLCABB          WSDXSGX         FYFHIGXEDBSHSMG LJFYQEGKVVRU    MVKHFWSTAHFG   
GGQNTAWQH       : XKDBUYSSEDG     MXBERFUIGRR     DKDMTQGTQGLWC   IJBLALSB        MDNVNTT         EBXDBBKBP       CHRVYVHEUJGGJ  
SRWMDWIBVOFFUR  : TBNKO           KLWEKQQ         XXCSSRHQPOE     JPEOGTJDWLHM    TVLFBMVFUIBRDY 
JXHNPEVWWMSXJJH : STQYIEB         MXNOYNCP        CRBCODRSM       RIVXLTHALQG    
CYMRC           : LNSKJXFGDMFYP   NVMPFMKMHHYUCSE EKVUCWSA        TYYGPWCA       
CGHSNM          : FCPOUMP         LDQVDTJH       
FCAG            : ROPGAEDJABGC    FJLTDLNSEOEE    AXEA            KGOXV           WCHRL          
NVRLUPAPPKA     : OPPCPMSDTBGHFRP AANVSTOCOKYBEM 
