CBWXNHATGDO     : HQXFIV          CWRWSXJOMSJ     TQYKFT          CFUYCHTCKE     
AVKV            : IYPIHLOTDNKUW   GFPY           
FQFTJX          : BGLGSFQFPE      LCIERIK         BQXIFVWMGHWBV   CFPFLUKEYFGNK   GNFUDPPTU      
MAONXCXD        : EMCTSKMPKILUGL  ROPFEQN         YPCGTVYLFNQD    YSOMMDBN        GWAYWVCKKGB    
WBSEBPL         : MUPORIN         AJCRRAAUWJRW    PMQORR          QXKUS          
EDFCNDKSTRPDPAR : NPYHBR          MGSOIQJLEMI     VSTFNQERERA     YDVTBTF         WOTJ            RNCVGAUKAFIOQ  
OIQSIVXGWRKXHXF : PRNO            GKJPWP          VEDQQKQXOSUA    CAVRUIS         QPNYL          
BMQQRDM         : SCEGHAVFWS      PFDRSFYQ        VFERSY         
VEQLELEUTWQC    : GGUY            QPGDA           PLQWDJICGRXBH   KCXBKR          UXWHKBWGALBIG  
OIRIVRPTWGX     : MEVRFOYCAF      FVKSJGNHO       TKHHYLNW       
YODCDQXH        : QCDET           JNJOLNRAX       GJGYGCESU      
MNVSLRRCVMSH    : SUSHNCBMNGS     KFRQNTIULOWBV   SDOS            FOISBNAMEC      HEXG            YQSTTJ         
CDVRWVXWHWMNCPE : GXJLQGSPP       DYIQVINGMJSB    PUTUNJEXRIRIB   LXEYGMYYXIKMC   TDNVXMHSMWLA    WQVYDUGSKU      AXETABETB      
AOONMH          : HAMP            ORKHXIAATWSTU   GEPDYGM         OIESTRGGFTVANI 
EBBBNU          : FOGE            OTUSLFNQ        ELEWSY          LNNLNLNU        YVWR           
TWLQQKORI       : HALVXRUGEVHCEUO IDWGPRJWWG      FHXEEHG         OPLDUQWLXU      NRCKDQSYJWHTE  
QWJSOQVOF       : BCIJABYXTTXIV   OPLDUQWLXU     
DSUC            : ISVAV           EAAVYIGWSYT     AVANVXDSMYJ     OECJHLCJVG      WGCYP          
VGAMBK          : PIUUHIJQH       TQYKFT          SACTAJVOUH     
AXYS            : VOLB            FAUPUM          KOKQQIIMNE      UTQJROBNYSRBOB  FPNHLKDTKQCOLP 
NKTMCSXWHOS     : LGIKLUGKX       QPGDA           IYPIHLOTDNKUW   QYINRNEBUGE     DIJTKOEYOF     
WECRYEQWM       : JNEQPDR         GUQSXTRASTKB    XLOWJYPFPGFNETK IAGMAGTV        VBERNPNA        OXMU           
JNEQPDR         : WECRYEQWM       SGLFBSHSSBEQQW  CQEQEHRYU       ODADHBAUGBFH   
OGVKSXD         : OPUCOEYI        KUBGNBBTJQEAMVE JXKMDBP         ADKHJDAI       
VMIQLFUNWVUNVH  : IOIGYSJOPXLMDUU CWRWSXJOMSJ     EFUCFSJBVGH    
FXOXPTQY        : WPVXUWXHKF      HQYQCP         
YXUTVAMTMULYCIO : IXXSLTUK        UKBKAVYKL       QYQATMYCON      OXXBFB         
HLPDVYK         : EMCTSKMPKILUGL  HGIRNAPCMESLYXO MFXRFMN         WUAWLSRCQOF     CSEG           
PJLJCNTBLQWJQJ  : JVROBKBQFBUBQBL BUQDSSWUNS     
EHRFLCVNJ       : GLQIUV          YWCHI           QNFIYBYTKOPBJUT GDUGURB        
FOGE            : EBBBNU          KMOWTEDJ        XSOVBWDDMHJJFK  HYHAPFR         PTMEXECBWLYALYJ
CWLNINBDQMTNYLY : DXBJAHRWMOKK    MMCADAJWESDEYV  TIRAEVVCOBP    
RIWYUYWILHNANT  : BVQHJYW         VSTFNQERERA     KDLWYNNRQWTCKQL
PSNECBHFTWB     : VOVMCIGV        KXKOS           YWBUPAQR        FYYUSXDULR     
VOLB            : AXYS            KMOWTEDJ       
TXHOWHYKOOLDL   : SGEWBK          ORPOSNESY       PITOERBQQCVBKXJ LNNLNLNU       
UECYGFHLAG      : RISQSFRDWKD     UYLLLKPJ       
JCEUDNRBWIAE    : POPLJYJ         MGPQYCRY        UUUUWEIDYQVE    EKTMLVRRLNKAFJN FOISBNAMEC      YAYRIBWFX      
LTYYYKMTPQ      : KFRQNTIULOWBV   YSOMMDBN        IIBSKIBYKEKRPP 
XWFMYLCKN       : KLQGRWLD        VCDU            QYQATMYCON      CWNFWSDLPYNXA   UFNEINYORGX    
ISVAV           : DSUC            SWLTUWOLOWOO    CPHHUYMJTAP     UMSXCKUWTRKTTU 
IXXSLTUK        : YXUTVAMTMULYCIO JBXTUQSAIAJYVX  FFIUDJEXCRQU    CWARAUSFWEY     JSFG            FFVBIQXJD      
FAPW            : SGLFBSHSSBEQQW  KDLDJTJ         MCRNAMYHJ       PATVHOMVIME     GFWPBPMXAVEOFEB TIRAEVVCOBP     BUHJWRIWTEQGR  
LVPQI           : GBCYUXQTDEDWPAS WIJHCGXIM       XAKH           
EMCTSKMPKILUGL  : MAONXCXD        HLPDVYK         GIOKOVP         VMLNABRNOCTOFO 
SGLFBSHSSBEQQW  : JNEQPDR         FAPW            QSSKWAXLYO      SOBKFNE         XYIQBFH        
IBLMUGWJXJRLEBX : AFLT            DQPIHIETOSS     LNDAESN        
VEKD            : UNPTSSIMCFFQQIA HSSCER          AEGMMGHDHUBYL  
GLBYMHPFFQPIE   : MGSOIQJLEMI     UKBKAVYKL       RUCJ            KBWUUFYIEIFJVNT OYUMAXHRWSF     LOLGKTJNUR     
EMBNNKIYRLWOHD  : JVROBKBQFBUBQBL TQOICQTJDGA     BMQNCBA         KOKQQIIMNE      ARNFOUAGXK      LMOJYBWYVHG    
KLIXOJKVYSD     : HTVGACFGNTSN    KDVKOWO         LBAT           
IMXNQKOGXC      : IXNMS           JNXIDVUEWOMCHLN DNWEPF          SRNSWBVTEOXAHUB
XTAWKJB         : GBCYUXQTDEDWPAS HLWRHJISD       LTYMINSONFAOS   GYYHPDWO        MUBJQBIEUAG     KJTRSHVRAUYXPTP ADKHJDAI       
WOWUDGIBHBF     : HGIRNAPCMESLYXO PNYBMHQAYO      NYINVL          VUTDKUOISKKFIN 
LRWBKKSQIU      : WJXCNWEQ        OXHEP           ARNFOUAGXK     
IOIGYSJOPXLMDUU : VMIQLFUNWVUNVH  EKTMLVRRLNKAFJN BRJLLIBYCNVSJP 
CXLEMDBPNNIFWD  : WIJHCGXIM       FFIUDJEXCRQU    NKAANGOSV       QYQATMYCON      WTRQDPIYTS      BOPFAIGPIHHVEQF
HTXNVSWKKW      : VMSD            KOKQQIIMNE      HNABXAWESDWGH  
XASUHXVSCK      : HLCYAPHH        BKWLL           SNOI            MUBJQBIEUAG     MQLH            SFRDMPEALFHMKS  YVWR           
FAOTJ           : PITGIKCCHNNMJ   WGCYP          
SOJAJKQ         : GMQAAXPRAAYFAJF KUBGNBBTJQEAMVE DEAQUWRRFTABAVU IYNSVC          IUWMBD          VNALMX         
DNRO            : VSTFNQERERA     MJIM           
POPLJYJ         : JCEUDNRBWIAE    ENFQNIBFS       ADKHJDAI       
UNPTSSIMCFFQQIA : VEKD            CXUSBHUROXPPR   EAAVYIGWSYT     JNBSAQDU        AAATJHJL        GYFW           
YHFOYTC         : QBIDW           PVJSSEM         ACLJPCQTIFTWG  
IUDTTOCOCT      : UQXGENMHXH      XUMTNWXWQA      XFHNELEU       
WMTKOBRIRAKTYS  : MCRNAMYHJ       CVCP            EHOUMLMHC      
OTUSLFNQ        : EBBBNU          OVQQKMXL        QTHT            UUALNVGSGB     
IFDYJXKH        : WHPRRNF         GYYHPDWO        FPNHLKDTKQCOLP 
GTEHLMYOWSPR    : CFDDSM          WTSUN          
GMQAAXPRAAYFAJF : SOJAJKQ         WPDUBDCJRTTSS   WYTFDDHNVOUKY   DRNAGCO        
QSSKWAXLYO      : SGLFBSHSSBEQQW  HVJSV          
UFFQLRINTIGL    : DVBIYFIRAFL     QRNAVWFRQIRRX   LYBCW          
GLQIUV          : EHRFLCVNJ       BGLGSFQFPE      XFHNELEU       
NQPAPPABRPOM    : EDDCFRKMSAE     EAAVYIGWSYT     BHSURUMN        YKIIUXLIPW      JKEWWVGLAKHCI   VFERSY         
TDILNYF         : IIIIT           NTMDAUVGYH      VPDOJGCAVGDYNX 
FTJLFAWCYT      : QMRABSMU        HLCYAPHH        QRNAVWFRQIRRX   YULEBIY        
PKRICRJTJXI     : RUWXDRUXYICAXP  BNBO            RMBBXODYHI      AXETABETB      
ROPFEQN         : MAONXCXD        WVPMHAHLG       PTMEXECBWLYALYJ OPLDUQWLXU     
VJNJON          : WVPMHAHLG       CFXXGD          YWBUPAQR        CTTKN          
SOBKFNE         : SGLFBSHSSBEQQW  BGECDOTKPO      WYOQVWP         BNRHAYCKTUDA    ICFBDXS        
PXBMIAUQ        : EFOQMOYOOSMK    UHUC            MMCADAJWESDEYV  IEAYLVQ        
LGCQ            : UCJYWLSCHEFKWYE OMWTXXQJSSRAAE  KXBFKDMPIA     
RTUBHFRX        : YIEVD           NRSSNHMOUODYVH  HVJSV           SARBQC         
KMOWTEDJ        : FOGE            VOLB            IFEYYE          XUOXNUDDBF      GFPY           
BLJLNGDJSLNLL   : RAYGOVIGM       NRCKDQSYJWHTE   XAKH           
HGIRNAPCMESLYXO : HLPDVYK         WOWUDGIBHBF     MPVWXYAAVD      WDNGPRVXLLGMQY  WTSUN           RBCGTQUHHYPFH   MGQOD           VIILHA         
UQXGENMHXH      : IUDTTOCOCT      LPTKRSH         GJGYGCESU       SQCTQBFHXFTFWJM
LUHTDPCUE       : UFRHYIHCKRK     RUCJ            RFQWLX         
MGPQYCRY        : JCEUDNRBWIAE    QACIQNVRYMNLE   TRTUKJEMHXJA   
FVLDCQRRAPBVDWF : DUNWH           PATVHOMVIME     MUBJQBIEUAG     BNRHAYCKTUDA    HWWMBMV         EIDTBYQNO      
AVAWCDL         : BNBO            CDVSJCITCAESX   AEGMMGHDHUBYL   QXKUS           YVWR           
UCJYWLSCHEFKWYE : LGCQ            UERVBJVLYNYDQVM
QFVWCET         : GBKJUYTRABBWFR  SARBQC          WQEVWJLCKRODO   UUALNVGSGB     
AVDC            : PDNUWWB         XSOYTPOMHXDBQGX XFHNELEU        BXBD           
OMWTXXQJSSRAAE  : LGCQ            DUNWH           IWSMR           YAYRIBWFX      
CIWSPVPSAMYC    : RCHJP           CHTJCWSETAYCB   SMRPNHHH        LMSMSNDIBD      UFNEINYORGX     RJVGXQSEDUOVKMN
FGKVSJPSHGDDBUD : KUBGNBBTJQEAMVE LOLATDU         WRMS           
BCIJABYXTTXIV   : QWJSOQVOF      
QBIDW           : YHFOYTC         WHPRRNF         KPXBFPDOFR      TEUPGXXCAVWAO   KKHOGG          KJTRSHVRAUYXPTP
MPVWXYAAVD      : HGIRNAPCMESLYXO BHNNNP         
WHOIHRIFNE      : EPIHCIDBURJW    SARBQC         
VAHP            : VSTFNQERERA     HQXFIV          UQTNA          
PSDUGSRDSS      : VLDTPVTTGNJDF   QTHT            GFLYX           OIESTRGGFTVANI  TACFWAPFFN      UFNEINYORGX    
UPIBOPRXAM      : NAVNSYBRBU      MMCADAJWESDEYV 
HAMP            : AOONMH          TKIBEODVS       DUBTH           MQRVKLQUKLUHKUX YWBUPAQR        NWJJMDHK       
PWOSP           : LBAT            KBWUUFYIEIFJVNT IFEYYE          AEGMMGHDHUBYL  
XMPSEUMXAHPK    : XNDKYHWKF       BKWLL           RBCGTQUHHYPFH   MBXFEGEYTBEY    BWFBMKLR        HWWMBMV         XUFMMUHSAVV    
EDDCFRKMSAE     : NQPAPPABRPOM    SLYWWBBDDUGLVO  XPWCJYBYWK     
PEIKVRJI        : RBSCYTEWOLK     UUUUWEIDYQVE    WPVXUWXHKF      JBXTUQSAIAJYVX  YQSTTJ         
ENFQNIBFS       : POPLJYJ         HTVGACFGNTSN   
JVROBKBQFBUBQBL : PJLJCNTBLQWJQJ  EMBNNKIYRLWOHD  IVJDOCYSFWKEPFL
WDNGPRVXLLGMQY  : HGIRNAPCMESLYXO RLOYJ          
CXUSBHUROXPPR   : UNPTSSIMCFFQQIA LOLGKTJNUR      BBPQOHPTQBWYUU  UNGVIAAX        XWJOVY          INLORM         
BVQHJYW         : RIWYUYWILHNANT  WJWFLFH         MTQORL          MKIQSUGHBLNFS  
UUQIBFYDGDBEYCL : QMRABSMU       
WBTOQLHUHA      : PRNO            WHPRRNF         OVQQKMXL       
SYBYVWPEAVFD    : MRDOVK          TDNVXMHSMWLA    UERVBJVLYNYDQVM
LGIKLUGKX       : NKTMCSXWHOS     XFRBLKOKDXFXK   QYQRIOEYXLXVP   SMRPNHHH        ERAT            WHLJGCX         AAATJHJL        MRPQRQELAYKYI  
YQQIL           : CFDDSM          LMPJC           VOFOSXWRT       XUOXNUDDBF     
LPTKRSH         : UQXGENMHXH      UUUUWEIDYQVE    BOMEFAKJXNR     LFRDTK         
KLQGRWLD        : XWFMYLCKN       BNBO            DXBJAHRWMOKK   
VPQQV           : BHNNNP          CCJVK           KJTRSHVRAUYXPTP RAMGBFODHRYYJ  
QACIQNVRYMNLE   : MGPQYCRY        RBSCYTEWOLK     SCRUJENWMINWBWJ NKAANGOSV      
SUSHNCBMNGS     : MNVSLRRCVMSH    EUDJB           QRNAVWFRQIRRX   BRJFJCALPTRG   
VLDTPVTTGNJDF   : PSDUGSRDSS      AEVG            PBFJEMGXV       PJCPANIXBSE    
RUWXDRUXYICAXP  : PKRICRJTJXI     IAGMAGTV        PORAJLAGQGPN    XYIQBFH        
SCEGHAVFWS      : BMQQRDM         DUNWH           LRCBM           HLTNLOB        
KCRR            : WNAIQ           ECGBSROLDXYAGP  CFDDSM          NAVNSYBRBU      MQRVKLQUKLUHKUX ICFBDXS         TQXXJFJLKDCKL  
JMMHRECREMUG    : MOGXSDRXYRY     VMSD            MLPWLLUKCMXGJM  BVPXJJIYMDYE    MYIXWVYKVDE     IJCQGNDSMC      CFDCSGK        
MRDOVK          : SYBYVWPEAVFD    HVJOJTXKQRFAF   LHMQIFRFXKA    
YIEVD           : RTUBHFRX        GPEHGAOCRJAL    GKJPWP          GJGYGCESU       MMCADAJWESDEYV 
GGIX            : ONVIJHOYEBJRYK  OYUMAXHRWSF     CHTJCWSETAYCB  
TKIBEODVS       : HAMP            CJCDGCTCFYGEQ   GJGYGCESU       WPIUX           NGXQDCDX        KHDGTRKSJ       YPBOIMCAFY     
QCDET           : YODCDQXH        LBAT            TDNVXMHSMWLA    YPUGNBATUV     
URUTQGAOJSU     : DWDIWIPL        HEDCVBNTX       XWJOVY          VIILHA         
DUNWH           : FVLDCQRRAPBVDWF OMWTXXQJSSRAAE  SCEGHAVFWS      EUDJB           NGXQDCDX        EHOCMCFAD      
XLNDIIUBMAFGJ   : SLYWWBBDDUGLVO  DXHCWSSIHUTIA   AAPWM           HVJSV           HEDCVBNTX      
BGWTMYJWREOUAF  : DEAQUWRRFTABAVU WTSUN           MNEPUMCHTJKDE   PWGX            VXPD           
HFTVSYEETF      : OXIKX           RLOYJ           SQCTQBFHXFTFWJM YVWR           
WNAIQ           : KCRR            NDNFLPWAHSQL    JSFG            VREGKGVVWTEEL  
OPUCOEYI        : OGVKSXD         KFRQNTIULOWBV   VPJNNNKSQYBA    OCHNLDSVIKICML  GTUGILPQICKX   
PDNUWWB         : AVDC            WYRQWLULY      
SVRYCNHTKUVSN   : HSSCER          VCEEPWIQA       HDQFQPLEB      
IDTMTBLCODHC    : MTQORL          ICFBDXS         GTNUMNUFHNOGBE 
GBCYUXQTDEDWPAS : LVPQI           XTAWKJB         SFRDMPEALFHMKS 
NRSSNHMOUODYVH  : RTUBHFRX        DXHCWSSIHUTIA   AAPWM           GTNUMNUFHNOGBE 
CJCDGCTCFYGEQ   : TKIBEODVS       IAGMAGTV        VUMMPC          GEPDYGM        
YBUQWPHEDXATE   : DWDIWIPL        QSKYLSQYE      
SLYWWBBDDUGLVO  : EDDCFRKMSAE     XLNDIIUBMAFGJ   ONVIJHOYEBJRYK  DNWEPF          KTDIETTCBPCJI  
MUPORIN         : WBSEBPL         WTSUN           RLOYJ           PKDRWTEOKMWYAE 
PRNO            : OIQSIVXGWRKXHXF WBTOQLHUHA      PMWGCJ          DHMIYHDWECBM    PCKXQMJMTRLKNA 
HSSCER          : VEKD            SVRYCNHTKUVSN   QEBDXCPKYS      IAODO          
EUDJB           : SUSHNCBMNGS     DUNWH           GIAPFQGANFKWMMF VHQCCTH         IEAYLVQ        
PMWGCJ          : PRNO           
TATDNESIRHAC    : LCIERIK         VIILHA         
VGHPINNLWOMP    : VPJNNNKSQYBA    LXEYGMYYXIKMC   DFLQAROCLVYBG  
LVHUXC          : HVJOJTXKQRFAF   DMDBQULXW       LOLGKTJNUR      RMBBXODYHI     
UFNBXVVIYXK     : LQFCNADI        OUICFBXXQWY     IVJDOCYSFWKEPFL IAGMAGTV        AJCRRAAUWJRW    DIJTKOEYOF     
ETKNHXBFOP      : UKBKAVYKL       IICHRG          SGEWBK         
RBSCYTEWOLK     : PEIKVRJI        QACIQNVRYMNLE   NWJJMDHK       
JJNTINFDUBPKJ   : DFLQAROCLVYBG   CPHHUYMJTAP     OXIKX           GFLYX          
LQFCNADI        : UFNBXVVIYXK     GIAPFQGANFKWMMF SMXUYDEKDGSJBF  FHXEEHG        
ECGBSROLDXYAGP  : KCRR            IVJDOCYSFWKEPFL
LKIBURRIKAM     : BGLGSFQFPE      VPJNNNKSQYBA    ADKHJDAI       
AQJCWLKYFEPSHP  : DWTDCTNFNSXJTDI KDVKOWO         PORAJLAGQGPN   
HVJOJTXKQRFAF   : MRDOVK          LVHUXC          JFLE            MLRMFFTNE      
MFFFQJDDTEKXT   : QYQRIOEYXLXVP   QYRIPO          VUTDKUOISKKFIN  FHOR            EDVCXWQP       
HLWRHJISD       : XTAWKJB         GYYHPDWO        YDVTBTF         ONPEU          
DWDIWIPL        : URUTQGAOJSU     YBUQWPHEDXATE   PCKXQMJMTRLKNA  XHTXGREMCFPN    MNEPUMCHTJKDE   UFNEINYORGX    
URHGWMABWA      : IICHRG          FVOYVPSUSOPSJC  RYLSGXYT        GHTIFMATP       EHHQPYMJ       
CKIBCRKKKQ      : VBERNPNA        WYOQVWP         AQHXFSWGQ      
PNYBMHQAYO      : WOWUDGIBHBF     PYFXADDCYCCQ   
GUQSXTRASTKB    : WECRYEQWM       WJWFLFH         AVANVXDSMYJ     BBPQOHPTQBWYUU  FUEHIPFLIJY     WRMS           
OUICFBXXQWY     : UFNBXVVIYXK     VCEEPWIQA       QXKUS           FVKSJGNHO      
GPEHGAOCRJAL    : YIEVD           ONVIJHOYEBJRYK  HQYQCP         
CFVNITCEFELGELX : HPJVPTG         AXETABETB       HDQFQPLEB      
KDLDJTJ         : FAPW            PATVHOMVIME     YSOMMDBN        YWBUPAQR       
INERNRVQY       : DUAWBQWF        BNBO            QYRIPO         
GIOKOVP         : EMCTSKMPKILUGL  LXEYGMYYXIKMC   RYLSGXYT        VUMMPC         
DVOD            : OVQQKMXL        PJCPANIXBSE     INLORM         
BGLGSFQFPE      : FQFTJX          GLQIUV          LKIBURRIKAM     JUGSADWDGL      CSEG           
KUBGNBBTJQEAMVE : OGVKSXD         SOJAJKQ         FGKVSJPSHGDDBUD VUTDKUOISKKFIN 
UUUUWEIDYQVE    : JCEUDNRBWIAE    PEIKVRJI        LPTKRSH         IYHRGY          IRHIGNJLCPTVO  
DNQXO           : NGXQDCDX       
NPYHBR          : EDFCNDKSTRPDPAR ADMSPWIXU       HTTCSWYMBNKD    IIBSKIBYKEKRPP  TQXXJFJLKDCKL  
DHMIYHDWECBM    : PRNO            YDVTBTF         UYJYSXMUX      
CDGGMJTDJ       : UKBKAVYKL       LMSMSNDIBD      RHRUNSAMM      
DWDFGGWWK       : EANIOUMRBND     AJCRRAAUWJRW    DXBJAHRWMOKK    CTXODUQ        
JUGSADWDGL      : BGLGSFQFPE      DFLQAROCLVYBG   VOVMCIGV        NRRUGTHJCHOD   
IRTQ            : AITGUQ          XLJRLQMTX       QAAFGEXFKGT     VCEEPWIQA       MEIJXCHGSKTB    TIRAEVVCOBP     ODADHBAUGBFH   
GKJPWP          : OIQSIVXGWRKXHXF YIEVD           KJVVISTQQXWVN   YFVWLFHSDYGHMXJ ESHCPVHAQMBWTQ 
AUTHTQTDCOJUOOT : PFDRSFYQ        FXOLBRQGVP      HDQFQPLEB      
WIJHCGXIM       : LVPQI           CXLEMDBPNNIFWD  AFLT            CXXHF          
RCHJP           : CIWSPVPSAMYC    LDQNQYAIJFAPFMP AXETABETB      
GMRDF           : EDVCXWQP        VFERSY         
GIAPFQGANFKWMMF : EUDJB           LQFCNADI        XOBQ            TETLUY          NKAANGOSV      
URUOUEYMMHY     : OYUMAXHRWSF    
KFRQNTIULOWBV   : MNVSLRRCVMSH    LTYYYKMTPQ      OPUCOEYI        IYHRGY          GFPY            SDYWH          
AITGUQ          : IRTQ            HNIPXKXPSQRLFEA AAATJHJL        WMEBKP          REWT           
PIUUHIJQH       : VGAMBK          QMRABSMU        HWLILEFLUWXE   
COIS            : VEDQQKQXOSUA    FHXEEHG        
DEAQUWRRFTABAVU : SOJAJKQ         BGWTMYJWREOUAF  QNFIYBYTKOPBJUT PWGX           
NDVK            : RWWJQIOALYFH    GFPY            CFDCSGK        
EUDON           : EANIOUMRBND     XWJOVY         
DVBIYFIRAFL     : UFFQLRINTIGL    GBKJUYTRABBWFR  AWWLNPO         MLPWLLUKCMXGJM  QYRIPO          WJXCNWEQ        UYLLLKPJ       
MGSOIQJLEMI     : EDFCNDKSTRPDPAR GLBYMHPFFQPIE   JAEMBUDRDV     
BOMEFAKJXNR     : LPTKRSH         KKHOGG          CQEQEHRYU      
SCRUJENWMINWBWJ : QACIQNVRYMNLE   EUILCD          QRNAVWFRQIRRX  
LTYMINSONFAOS   : XTAWKJB         HYHAPFR        
ONVIJHOYEBJRYK  : GGIX            SLYWWBBDDUGLVO  GPEHGAOCRJAL    DFLQAROCLVYBG   GHTIFMATP      
KREETSO         : KORA           
MFXRFMN         : HLPDVYK         SGEWBK          VCGM            NLRMWQTSUALA   
DBWLMHBLLEUGF   : IMFTLTJUESCP    ORKHXIAATWSTU  
YPCGTVYLFNQD    : MAONXCXD        CKLIGACSGH     
WPVXUWXHKF      : FXOXPTQY        PEIKVRJI        WTSUN          
XSOVBWDDMHJJFK  : FOGE            HNIPXKXPSQRLFEA VMLNABRNOCTOFO 
LYLOHKHFJCEJLQ  : PJCPANIXBSE     JYNPGWHLKSXMCI 
VPJNNNKSQYBA    : OPUCOEYI        VGHPINNLWOMP    LKIBURRIKAM     AFLT            IYNSVC          PUTUNJEXRIRIB   XHTXGREMCFPN   
IMFTLTJUESCP    : DBWLMHBLLEUGF   AHEOGNEFBLA     DNWEPF          GTNUMNUFHNOGBE 
HYHAPFR         : FOGE            LTYMINSONFAOS   MQRVKLQUKLUHKUX RISQSFRDWKD    
UFRHYIHCKRK     : LUHTDPCUE       RUCJ            WYRQWLULY       OUPWTGEWE      
AFLT            : IBLMUGWJXJRLEBX WIJHCGXIM       VPJNNNKSQYBA    VQFKCTJS       
GXJLQGSPP       : CDVRWVXWHWMNCPE BFHXYCSPYKMSGD  TPMICBPGOQLXESK
IXNMS           : IMXNQKOGXC      HRNXEEW         FYVQNRIBDXESW   FDDWTVNXJPATQI 
EBTOKVYEHVEOH   : DUAWBQWF        AWWLNPO        
HQYQCP          : FXOXPTQY        GPEHGAOCRJAL    XUMTNWXWQA     
WHPRRNF         : IFDYJXKH        QBIDW           WBTOQLHUHA      WHLJGCX        
GBKJUYTRABBWFR  : QFVWCET         DVBIYFIRAFL     HLCYAPHH        WCKNQFTMS       NJJJLA          DIJTKOEYOF     
GYYHPDWO        : XTAWKJB         IFDYJXKH        HLWRHJISD       PUTUNJEXRIRIB   JAEMBUDRDV      GEPDYGM         GCUARMSSHAFUUOP
GGUY            : VEQLELEUTWQC    AEVG            KJVVISTQQXWVN  
CFDDSM          : GTEHLMYOWSPR    YQQIL           KCRR            TYHSYI         
RJSUKVTRNAXOCFE : SVCFQTD         UTQJROBNYSRBOB  UYLLLKPJ       
EUILCD          : SCRUJENWMINWBWJ
XFRBLKOKDXFXK   : LGIKLUGKX       KPXBFPDOFR      LXEYGMYYXIKMC   GFFPCS          RAMGBFODHRYYJ   LMOJYBWYVHG    
RCQTBFXILENIM   : KDVKOWO         BXBD            IEAYLVQ        
MRLLYDMK        : NYINVL          JBXTUQSAIAJYVX  OFIIKSOEPQIFVR 
DWTDCTNFNSXJTDI : AQJCWLKYFEPSHP  NYINVL          RMBLMA          XUMTNWXWQA     
QMRABSMU        : FTJLFAWCYT      UUQIBFYDGDBEYCL PIUUHIJQH       MVGOGRUSVVLSH   CPHHUYMJTAP    
ATKPHYU         : VGFHU           INLORM         
UYJO            : MVGOGRUSVVLSH   OVQQKMXL        PLQWDJICGRXBH   OFOYD          
OCHNLDSVIKICML  : OPUCOEYI        CWMHXFNWVQR     GHTIFMATP       IAODO           UYLLLKPJ       
BGECDOTKPO      : SOBKFNE         IIIIT           RFQWLX          TYHSYI          FDDWTVNXJPATQI  FVKSJGNHO      
KPXBFPDOFR      : QBIDW           XFRBLKOKDXFXK   EFOQMOYOOSMK    HXSLUFFUKX     
XNDKYHWKF       : XMPSEUMXAHPK    FVOYVPSUSOPSJC  BKKXKQ          PJCPANIXBSE     UVAIBCMTRTP    
TKDWB           : VCDU            VMSD            PYFXADDCYCCQ    XFHNELEU        WYTFDDHNVOUKY  
HRNXEEW         : IXNMS           YDRFIPTM        LRCBM           HALVXRUGEVHCEUO
LOLATDU         : FGKVSJPSHGDDBUD SWLTUWOLOWOO    UHUC            YNMI           
TAFSIEFNFBAIXC  : RBCGTQUHHYPFH   MJIM            FIDTLWOBLYFNPOE VCGM           
HTVGACFGNTSN    : KLIXOJKVYSD     ENFQNIBFS       IOEPUBSHVC      VUMMPC          ETXLVMPV       
XLJRLQMTX       : IRTQ            UTXATB          TETLUY         
KDVKOWO         : KLIXOJKVYSD     AQJCWLKYFEPSHP  RCQTBFXILENIM   BRJFJCALPTRG    FDWUFGPCXNO     WQVYDUGSKU     
EKTMLVRRLNKAFJN : JCEUDNRBWIAE    IOIGYSJOPXLMDUU UFHTMP          XFHNELEU       
DYIQVINGMJSB    : CDVRWVXWHWMNCPE DUAWBQWF        YDRFIPTM        IFKFSNTQW       ICFBDXS         GFPY            LHMQIFRFXKA    
IYNSVC          : SOJAJKQ         VPJNNNKSQYBA    CTTKN          
RWYEKLGS        : VREGKGVVWTEEL  
TKBUUTQEHWSS    : IVJDOCYSFWKEPFL DIJTKOEYOF     
VCDU            : XWFMYLCKN       TKDWB           YWCHI           YKIIUXLIPW      UQTNA          
VSTFNQERERA     : EDFCNDKSTRPDPAR RIWYUYWILHNANT  DNRO            VAHP            BUQDSSWUNS      MRPQRQELAYKYI  
PVJSSEM         : YHFOYTC         QAAFGEXFKGT     FKTQIVF         DYPAUQQRYQPMKT 
IVJDOCYSFWKEPFL : JVROBKBQFBUBQBL UFNBXVVIYXK     ECGBSROLDXYAGP  TKBUUTQEHWSS    RUCJ            YQSTTJ         
XPWCJYBYWK      : EDDCFRKMSAE     XOBQ            VUMMPC          GCUARMSSHAFUUOP
QPGDA           : VEQLELEUTWQC    NKTMCSXWHOS     UIFBUD          LNDAESN         HNABXAWESDWGH  
MEVRFOYCAF      : OIRIVRPTWGX     KXBFKDMPIA      GTNUMNUFHNOGBE  MLRNUFCMDFPSI  
HQXFIV          : CBWXNHATGDO     VAHP            KTDIETTCBPCJI   VREGKGVVWTEEL   TKHHYLNW        XAKH           
SWLTUWOLOWOO    : ISVAV           LOLATDU         EAAVYIGWSYT     MPHGYUCT        GGXQGXHOPCL     KHDGTRKSJ      
DUAWBQWF        : INERNRVQY       EBTOKVYEHVEOH   DYIQVINGMJSB    GDGYAYOPSATALOC CWARAUSFWEY     ROCTDPPJKX     
EAAVYIGWSYT     : DSUC            UNPTSSIMCFFQQIA NQPAPPABRPOM    SWLTUWOLOWOO    CHTJCWSETAYCB  
VQFKCTJS        : AFLT            BHNNNP          NDNFLPWAHSQL    OHRCFW         
NYINVL          : WOWUDGIBHBF     MRLLYDMK        DWTDCTNFNSXJTDI ESHCPVHAQMBWTQ 
UTXATB          : XLJRLQMTX       ERAT            TYHSYI         
ULETGGQMEHUQM   : BFHXYCSPYKMSGD  EANIOUMRBND     GDUGURB        
AHEOGNEFBLA     : IMFTLTJUESCP    SMRPNHHH        UFHTMP          OFIIKSOEPQIFVR  JYNPGWHLKSXMCI  MKIQSUGHBLNFS  
MCRNAMYHJ       : FAPW            WMTKOBRIRAKTYS 
PATVHOMVIME     : FAPW            FVLDCQRRAPBVDWF KDLDJTJ         WYOQVWP        
DKCKPEVSBKUSX   : GWAYWVCKKGB     UERVBJVLYNYDQVM
IYHRGY          : UUUUWEIDYQVE    KFRQNTIULOWBV   WOTJ            KXBFKDMPIA      PCKXQMJMTRLKNA  RLOYJ          
DUBTH           : HAMP            MOGXSDRXYRY     LSPAYSR         IBKQAAXJOQXPOYU HWLILEFLUWXE    VKHLQXIS       
CVCP            : WMTKOBRIRAKTYS  SMXUYDEKDGSJBF  WMEBKP          XUOXNUDDBF     
ORKHXIAATWSTU   : AOONMH          DBWLMHBLLEUGF   GVXXTMSOOMO     QRNAVWFRQIRRX   VUMMPC          MKIQSUGHBLNFS   PITGIKCCHNNMJ  
VEUCDOHXQCHOEEQ : MOGXSDRXYRY     CWNFWSDLPYNXA  
EFOQMOYOOSMK    : PXBMIAUQ        KPXBFPDOFR      KOKQQIIMNE      SIKFBXOH        UYJYSXMUX       PWGX            NRRUGTHJCHOD   
JNJOLNRAX       : YODCDQXH        WJWFLFH         VMSD            JYNPGWHLKSXMCI 
QAAFGEXFKGT     : IRTQ            PVJSSEM         VMSD            UFNEINYORGX    
UKBKAVYKL       : YXUTVAMTMULYCIO GLBYMHPFFQPIE   ETKNHXBFOP      CDGGMJTDJ       VOSDQR          FXOLBRQGVP     
AWWLNPO         : DVBIYFIRAFL     EBTOKVYEHVEOH   PLQWDJICGRXBH   NWCIXUWWOP      QSQHROFF        GTUGILPQICKX   
IFNKNV          : XSOYTPOMHXDBQGX MGQOD           EHOCMCFAD      
LBAT            : KLIXOJKVYSD     PWOSP           QCDET           CWRWSXJOMSJ     PCKXQMJMTRLKNA  TIRAEVVCOBP    
EPIHCIDBURJW    : WHOIHRIFNE      OHRCFW          BQXIFVWMGHWBV   NHNBSXCSARQT    ACDUPPFAGBVMI  
HLCYAPHH        : XASUHXVSCK      FTJLFAWCYT      GBKJUYTRABBWFR  FWXUGFCQ        HOADOOLVLMSQGKF MAIQPUPMHVHNME 
RUCJ            : GLBYMHPFFQPIE   LUHTDPCUE       UFRHYIHCKRK     IVJDOCYSFWKEPFL GUUYDUEXTMQX   
DMDBQULXW       : LVHUXC          DNWEPF          MMCADAJWESDEYV 
DAQUKPMTBOSBHC  : MRUPCXAUXDTJRM  SVCFQTD         HTTCSWYMBNKD    DRNAGCO        
MVGOGRUSVVLSH   : QMRABSMU        UYJO            MYIXWVYKVDE     CPHHUYMJTAP     REWT           
SDOS            : MNVSLRRCVMSH    KRXXSQLQLOOEWFL CSEG           
KDLWYNNRQWTCKQL : RIWYUYWILHNANT  LPXHHMYSXCY     GDUGURB         AXETABETB      
YDVTBTF         : EDFCNDKSTRPDPAR HLWRHJISD       DHMIYHDWECBM   
DQPIHIETOSS     : IBLMUGWJXJRLEBX AEVG            IDWGPRJWWG      FHOR            GCUARMSSHAFUUOP NWJJMDHK        DIJTKOEYOF     
GJGYGCESU       : YODCDQXH        UQXGENMHXH      YIEVD           TKIBEODVS       YGIFI           KTDIETTCBPCJI   PJCPANIXBSE     PFDRSFYQ       
WTSUN           : GTEHLMYOWSPR    HGIRNAPCMESLYXO BGWTMYJWREOUAF  MUPORIN         WPVXUWXHKF      RMBBXODYHI      KHDGTRKSJ      
PUTUNJEXRIRIB   : CDVRWVXWHWMNCPE VPJNNNKSQYBA    GYYHPDWO        RAYGOVIGM       BRJLLIBYCNVSJP 
WJWFLFH         : BVQHJYW         GUQSXTRASTKB    JNJOLNRAX       PMULNHUG        ADMSPWIXU      
BFHXYCSPYKMSGD  : GXJLQGSPP       ULETGGQMEHUQM   RMGGTVOKTBKKVB  TRTUKJEMHXJA    FWXUGFCQ        IJCQGNDSMC      EIDTBYQNO       HDQFQPLEB      
BFHXYCSPYKMSGD  : YPBOIMCAFY     
KBWUUFYIEIFJVNT : GLBYMHPFFQPIE   PWOSP           QYQRIOEYXLXVP   VMSD           
OYUMAXHRWSF     : GLBYMHPFFQPIE   GGIX            URUOUEYMMHY     WVPMHAHLG      
BKWLL           : XASUHXVSCK      XMPSEUMXAHPK    MAIQPUPMHVHNME 
IICHRG          : ETKNHXBFOP      URHGWMABWA      SMXUYDEKDGSJBF  WQEVWJLCKRODO   PJIUKQPTPVTIQ  
YSOMMDBN        : MAONXCXD        LTYYYKMTPQ      KDLDJTJ         RMBLMA          KCXBKR         
PPVXIVSPOTA     : IFEYYE          YPYEXSSPVM      LMOJYBWYVHG    
HNIPXKXPSQRLFEA : AITGUQ          XSOVBWDDMHJJFK  VUARMMCNT       IFKFSNTQW       SQCTQBFHXFTFWJM REWT           
INHXE           : JXKMDBP         VOSDQR          HDQFQPLEB      
XOBQ            : GIAPFQGANFKWMMF XPWCJYBYWK      POUO            UNGVIAAX        GMPMDFDEF      
RMGGTVOKTBKKVB  : BFHXYCSPYKMSGD  ETXLVMPV       
IIIIT           : TDILNYF         BGECDOTKPO      JNBSAQDU        ACDUPPFAGBVMI  
YDRFIPTM        : HRNXEEW         DYIQVINGMJSB    XUMTNWXWQA      HLTNLOB         GSOS           
AEVG            : VLDTPVTTGNJDF   GGUY            DQPIHIETOSS     XWJOVY         
QEBDXCPKYS      : HSSCER          MTQORL          FYYUSXDULR      GFPY            MRPQRQELAYKYI  
JBXTUQSAIAJYVX  : IXXSLTUK        PEIKVRJI        MRLLYDMK        NDNFLPWAHSQL    BRJLLIBYCNVSJP  HNABXAWESDWGH  
VCEEPWIQA       : SVRYCNHTKUVSN   OUICFBXXQWY     IRTQ            VBERNPNA        PSSOXWDBKYSYRJQ
TRTUKJEMHXJA    : MGPQYCRY        BFHXYCSPYKMSGD  QTHT            GHTIFMATP       PFDRSFYQ        SARBQC          GFPY           
KJVVISTQQXWVN   : GKJPWP          GGUY            FFIUDJEXCRQU    VMSD            VOSDQR         
GFWPBPMXAVEOFEB : FAPW            VMSD            BNBO            VNALMX          LYBCW          
XLOWJYPFPGFNETK : WECRYEQWM       YGIFI           EVYNVFYTKLHAHTD CQEQEHRYU       FYYUSXDULR     
BHDEW           : GFLYX          
EANIOUMRBND     : DWDFGGWWK       EUDON           ULETGGQMEHUQM   VUTDKUOISKKFIN 
KORA            : KREETSO         QSKYLSQYE       XNICHWLKJKLIVPB CFDCSGK        
JICYNXJBYTGFS   : NDNFLPWAHSQL    BVPXJJIYMDYE    OUPWTGEWE       ONPEU           QXKUS          
JSORKKGCN       : MYIXWVYKVDE     EHOCMCFAD      
IFEYYE          : KMOWTEDJ        PWOSP           PPVXIVSPOTA     BUQDSSWUNS      RYLSGXYT        QPNYL           MQLH           
JNXIDVUEWOMCHLN : IMXNQKOGXC      FVOYVPSUSOPSJC  RFQWLX          YVWR           
BHNNNP          : MPVWXYAAVD      VPQQV           VQFKCTJS        GIXCM           YPYEXSSPVM     
IAGMAGTV        : WECRYEQWM       RUWXDRUXYICAXP  CJCDGCTCFYGEQ   UFNBXVVIYXK     YVWR           
JTCMRWSONFSVTIY : FYDFQALXWVAD    QNYX            WMEBKP         
POKDGLLHRBHAWFR : IOEPUBSHVC      PORAJLAGQGPN    WPDUBDCJRTTSS   BRJLLIBYCNVSJP 
BUUSTNJIUEG     : JFLE            BRJLLIBYCNVSJP 
MFLCVV          : YONCR           BXBD            GSOS           
CHTJCWSETAYCB   : CIWSPVPSAMYC    GGIX            EAAVYIGWSYT     PJCPANIXBSE     SRNSWBVTEOXAHUB XAKH            ETXLVMPV       
WVPMHAHLG       : ROPFEQN         VJNJON          OYUMAXHRWSF     AOLYSNWSBVSGO   CFDCSGK         ODADHBAUGBFH   
XNICJH          : MLPWLLUKCMXGJM 
MOGXSDRXYRY     : JMMHRECREMUG    DUBTH           VEUCDOHXQCHOEEQ YPYEXSSPVM      GFVIKKWVJKLE    RAMGBFODHRYYJ  
VUARMMCNT       : HNIPXKXPSQRLFEA IDWGPRJWWG      LDQNQYAIJFAPFMP
TQOICQTJDGA     : EMBNNKIYRLWOHD  AJCRRAAUWJRW    VBERNPNA        UHUC            FUEHIPFLIJY    
FVOYVPSUSOPSJC  : URHGWMABWA      XNDKYHWKF       JNXIDVUEWOMCHLN VMISKWN         IWSMR          
LRCBM           : SCEGHAVFWS      HRNXEEW         YNMI            TYHSYI         
RWWJQIOALYFH    : NDVK            RLOYJ           HLTNLOB        
GDGYAYOPSATALOC : DUAWBQWF        FHOR            SFRDMPEALFHMKS  IRHIGNJLCPTVO  
DXHCWSSIHUTIA   : XLNDIIUBMAFGJ   NRSSNHMOUODYVH  YICLOAKKGV     
YGIFI           : GJGYGCESU       XLOWJYPFPGFNETK MTQORL          QNYX           
GWAYWVCKKGB     : MAONXCXD        DKCKPEVSBKUSX   SARBQC         
GIPE            : FFIUDJEXCRQU    JNBSAQDU        BKKXKQ          MQNLAXMULUV    
LOLGKTJNUR      : GLBYMHPFFQPIE   CXUSBHUROXPPR   LVHUXC          CWARAUSFWEY     OFOYD           BRJLLIBYCNVSJP 
AAEJ            : JYNPGWHLKSXMCI  GNFUDPPTU       UNGVIAAX        VXALTDB        
GIXCM           : BHNNNP          GVXXTMSOOMO     OECJHLCJVG      LWCKEULOLD     
NTMDAUVGYH      : TDILNYF         QRNAVWFRQIRRX   PYFXADDCYCCQ    GTNUMNUFHNOGBE  TMDOUB         
MPHGYUCT        : SWLTUWOLOWOO   
EVYNVFYTKLHAHTD : XLOWJYPFPGFNETK SJRVD           NRCKDQSYJWHTE   INLORM         
QYQRIOEYXLXVP   : LGIKLUGKX       MFFFQJDDTEKXT   KBWUUFYIEIFJVNT
OVQQKMXL        : OTUSLFNQ        WBTOQLHUHA      DVOD            UYJO            CKLIGACSGH      HNABXAWESDWGH  
IYPIHLOTDNKUW   : AVKV            NKTMCSXWHOS    
AVANVXDSMYJ     : DSUC            GUQSXTRASTKB    XAKH           
LXEYGMYYXIKMC   : CDVRWVXWHWMNCPE VGHPINNLWOMP    GIOKOVP         XFRBLKOKDXFXK   WYTFDDHNVOUKY   GMPMDFDEF       MAIQPUPMHVHNME 
AOLYSNWSBVSGO   : WVPMHAHLG       IEAYLVQ        
HALVXRUGEVHCEUO : TWLQQKORI       HRNXEEW         SGEWBK          KDMBJNMO        QXKUS          
KRXXSQLQLOOEWFL : SDOS            HBHEVTDX        WRMS           
FYDFQALXWVAD    : JTCMRWSONFSVTIY
RMBLMA          : DWTDCTNFNSXJTDI YSOMMDBN        HOADOOLVLMSQGKF BOPFAIGPIHHVEQF
FLWSDLWAS       : VMSD            WYRQWLULY       ARNFOUAGXK      IRHIGNJLCPTVO  
JXKMDBP         : OGVKSXD         INHXE           IOEPUBSHVC     
YONCR           : MFLCVV          JXRUULR        
VGFHU           : ATKPHYU         MNEPUMCHTJKDE   IFKFSNTQW       YPUGNBATUV     
NAVNSYBRBU      : UPIBOPRXAM      KCRR            QPNYL           AJGXUPALVPORDST
LSPAYSR         : DUBTH           JFLE            EHOUMLMHC      
SGEWBK          : TXHOWHYKOOLDL   ETKNHXBFOP      MFXRFMN         HALVXRUGEVHCEUO LFRDTK          MQLH           
JRCFARHVFDWJU   : KKHOGG          XFHNELEU        RAMGBFODHRYYJ   PITGIKCCHNNMJ  
EANYPOX         : QYRIPO          TEUPGXXCAVWAO   TKHHYLNW       
IOEPUBSHVC      : HTVGACFGNTSN    POKDGLLHRBHAWFR JXKMDBP         RBYDTQ          AEGMMGHDHUBYL   MNEPUMCHTJKDE   GYFW            YAYRIBWFX      
IOEPUBSHVC      : TMDOUB         
AJCRRAAUWJRW    : WBSEBPL         UFNBXVVIYXK     DWDFGGWWK       TQOICQTJDGA     WOTJ            JFLE            CCJVK          
SNOI            : XASUHXVSCK      BRJFJCALPTRG    QNFIYBYTKOPBJUT
PTMEXECBWLYALYJ : FOGE            ROPFEQN         KTEQKYEKU       ACLJPCQTIFTWG  
TDNVXMHSMWLA    : CDVRWVXWHWMNCPE SYBYVWPEAVFD    QCDET           CKLIGACSGH      MMCADAJWESDEYV  IFJHA          
VEDQQKQXOSUA    : OIQSIVXGWRKXHXF COIS            SMRPNHHH        ODADHBAUGBFH   
WOTJ            : EDFCNDKSTRPDPAR IYHRGY          AJCRRAAUWJRW    WPDUBDCJRTTSS   ESHCPVHAQMBWTQ 
PMULNHUG        : WJWFLFH         ERAT            MQNLAXMULUV    
RTVHPC          : CWRWSXJOMSJ     WQVYDUGSKU      GUUYDUEXTMQX   
GVXXTMSOOMO     : ORKHXIAATWSTU   GIXCM           ICHYWMBPM       VALUYFBC       
GXIVMDJ         : OJGMMWIKPBMO    OUPWTGEWE       ONPEU           CFDCSGK        
MEIJXCHGSKTB    : IRTQ            LIPI            GSOS           
RBCGTQUHHYPFH   : HGIRNAPCMESLYXO XMPSEUMXAHPK    TAFSIEFNFBAIXC 
SMXUYDEKDGSJBF  : LQFCNADI        CVCP            IICHRG          QTHT            QNKRT          
DNWEPF          : IMXNQKOGXC      SLYWWBBDDUGLVO  IMFTLTJUESCP    DMDBQULXW      
IBKQAAXJOQXPOYU : DUBTH           HBHEVTDX        JSFG            UHUC            CKLIGACSGH      QPNYL          
KXBFKDMPIA      : LGCQ            MEVRFOYCAF      IYHRGY         
MRUPCXAUXDTJRM  : DAQUKPMTBOSBHC  VPDOJGCAVGDYNX 
HBHEVTDX        : KRXXSQLQLOOEWFL IBKQAAXJOQXPOYU
NDNFLPWAHSQL    : WNAIQ           VQFKCTJS        JBXTUQSAIAJYVX  JICYNXJBYTGFS   EHOUMLMHC      
SJRVD           : EVYNVFYTKLHAHTD CXXHF           YNMI            WQEVWJLCKRODO   WYTFDDHNVOUKY   SFRDMPEALFHMKS  GUUYDUEXTMQX   
QRNAVWFRQIRRX   : UFFQLRINTIGL    FTJLFAWCYT      SUSHNCBMNGS     SCRUJENWMINWBWJ ORKHXIAATWSTU   NTMDAUVGYH      UMSXCKUWTRKTTU  FFVBIQXJD      
FFIUDJEXCRQU    : IXXSLTUK        CXLEMDBPNNIFWD  KJVVISTQQXWVN   GIPE            SVCFQTD         VXALTDB        
KTEQKYEKU       : PTMEXECBWLYALYJ OXIKX           PKDRWTEOKMWYAE  GXCXFUQYVV     
PORAJLAGQGPN    : RUWXDRUXYICAXP  AQJCWLKYFEPSHP  POKDGLLHRBHAWFR SACTAJVOUH      MLRNUFCMDFPSI  
BRJFJCALPTRG    : SUSHNCBMNGS     KDVKOWO         SNOI            MCENMYUKESDP   
SMRPNHHH        : CIWSPVPSAMYC    LGIKLUGKX       AHEOGNEFBLA     VEDQQKQXOSUA   
QSKYLSQYE       : YBUQWPHEDXATE   KORA            UERVBJVLYNYDQVM IBJYFFVQSAD    
SPWESAR         : BHSURUMN        OECJHLCJVG     
VMSD            : HTXNVSWKKW      JMMHRECREMUG    TKDWB           JNJOLNRAX       QAAFGEXFKGT     KBWUUFYIEIFJVNT KJVVISTQQXWVN   GFWPBPMXAVEOFEB
VMSD            : FLWSDLWAS       MLPWLLUKCMXGJM  BGYFJJETWYBRBA 
FWXUGFCQ        : HLCYAPHH        BFHXYCSPYKMSGD  WTRQDPIYTS      LDQNQYAIJFAPFMP
WCWKU           : AAPWM          
LCIERIK         : FQFTJX          TATDNESIRHAC    RMBBXODYHI      AAATJHJL        HDQFQPLEB      
IDWGPRJWWG      : TWLQQKORI       DQPIHIETOSS     VUARMMCNT       AXETABETB      
RNCVGAUKAFIOQ   : EDFCNDKSTRPDPAR RFQWLX          KXKOS           UTQJROBNYSRBOB 
YWCHI           : EHRFLCVNJ       VCDU           
PLQWDJICGRXBH   : VEQLELEUTWQC    UYJO            AWWLNPO         CFUYCHTCKE     
WPDUBDCJRTTSS   : GMQAAXPRAAYFAJF POKDGLLHRBHAWFR WOTJ            GMPMDFDEF      
BBPQOHPTQBWYUU  : CXUSBHUROXPPR   GUQSXTRASTKB    ERAT            BBNAGPACIAHF   
CWARAUSFWEY     : IXXSLTUK        DUAWBQWF        LOLGKTJNUR      VXPD           
XSOYTPOMHXDBQGX : AVDC            IFNKNV          VREGKGVVWTEEL   GMPMDFDEF      
BUQDSSWUNS      : PJLJCNTBLQWJQJ  VSTFNQERERA     IFEYYE          TJECURTF        PKDRWTEOKMWYAE  LDQNQYAIJFAPFMP RAMGBFODHRYYJ   ODADHBAUGBFH   
NWCIXUWWOP      : AWWLNPO         AFSOJRRS        MGQOD           OFOYD           HVJSV          
CWMHXFNWVQR     : OCHNLDSVIKICML  QVEEMDL        
VMISKWN         : FVOYVPSUSOPSJC  NRRUGTHJCHOD   
MLPWLLUKCMXGJM  : JMMHRECREMUG    DVBIYFIRAFL     XNICJH          VMSD            AAATJHJL        FIDTLWOBLYFNPOE HPJVPTG        
JSFG            : IXXSLTUK        WNAIQ           IBKQAAXJOQXPOYU
VBERNPNA        : WECRYEQWM       CKIBCRKKKQ      VCEEPWIQA       TQOICQTJDGA     QNKRT           TQYKFT          QYQATMYCON      WGCYP          
BNBO            : PKRICRJTJXI     AVAWCDL         KLQGRWLD        INERNRVQY       GFWPBPMXAVEOFEB BMQNCBA         TYHSYI         
AAPWM           : XLNDIIUBMAFGJ   NRSSNHMOUODYVH  WCWKU          
JNBSAQDU        : UNPTSSIMCFFQQIA IIIIT           GIPE            TUKLYBFIIAH     LMOJYBWYVHG    
LMSMSNDIBD      : CIWSPVPSAMYC    CDGGMJTDJ       CFXXGD          WYRQWLULY       YWBUPAQR        MVUXIFXLVXLYE  
ERAT            : LGIKLUGKX       UTXATB          PMULNHUG        BBPQOHPTQBWYUU 
BVPXJJIYMDYE    : JMMHRECREMUG    JICYNXJBYTGFS   ESHCPVHAQMBWTQ  KJTRSHVRAUYXPTP HWWMBMV         XBDWAMCLB      
WDWLXLGN        : ORPOSNESY       YFVWLFHSDYGHMXJ BNRHAYCKTUDA    AGXHIG         
POUO            : XOBQ            UERVBJVLYNYDQVM HTTCSWYMBNKD   
ORPOSNESY       : TXHOWHYKOOLDL   WDWLXLGN        NJJJLA          KXKOS           XMFCSNGSORQGAQO
DXBJAHRWMOKK    : CWLNINBDQMTNYLY KLQGRWLD        DWDFGGWWK       VUMMPC         
QYRIPO          : MFFFQJDDTEKXT   INERNRVQY       DVBIYFIRAFL     EANYPOX         WJXCNWEQ        LMPJC          
LFRDTK          : LPTKRSH         SGEWBK          XMFCSNGSORQGAQO
AFSOJRRS        : NWCIXUWWOP      VCGM            CFDCSGK        
BMQNCBA         : EMBNNKIYRLWOHD  BNBO            QTHT            TACFWAPFFN     
RBYDTQ          : IOEPUBSHVC      MLRMFFTNE       FVKSJGNHO       HUHXCXSLDMRUCDY
HXSLUFFUKX      : KPXBFPDOFR     
VPDOJGCAVGDYNX  : TDILNYF         MRUPCXAUXDTJRM  FKTQIVF         KKHOGG          WHLJGCX         MVUXIFXLVXLYE  
MBXFEGEYTBEY    : XMPSEUMXAHPK   
QYINRNEBUGE     : NKTMCSXWHOS     KXKOS          
OHRCFW          : VQFKCTJS        EPIHCIDBURJW    MLRMFFTNE       VKHLQXIS        MMCADAJWESDEYV  VXPD           
IUWMBD          : SOJAJKQ         RRBJYYYTTC      BXBD            INLORM         
UERVBJVLYNYDQVM : UCJYWLSCHEFKWYE SYBYVWPEAVFD    DKCKPEVSBKUSX   QSKYLSQYE       POUO            VOVMCIGV        VALUYFBC       
PBFJEMGXV       : VLDTPVTTGNJDF   MUBJQBIEUAG     PFDRSFYQ        LMOJYBWYVHG    
UIFBUD          : QPGDA           QNYX            OFOYD           EIDTBYQNO      
MYIXWVYKVDE     : JMMHRECREMUG    MVGOGRUSVVLSH   JSORKKGCN       DRNAGCO        
RYLSGXYT        : URHGWMABWA      GIOKOVP         IFEYYE          VOFOSXWRT      
WPIUX           : TKIBEODVS       VOSDQR         
VUTDKUOISKKFIN  : WOWUDGIBHBF     MFFFQJDDTEKXT   KUBGNBBTJQEAMVE EANIOUMRBND     PSSOXWDBKYSYRJQ AQHXFSWGQ      
DFLQAROCLVYBG   : VGHPINNLWOMP    JJNTINFDUBPKJ   JUGSADWDGL      ONVIJHOYEBJRYK  BQXIFVWMGHWBV   VALUYFBC        SFRDMPEALFHMKS 
CWRWSXJOMSJ     : CBWXNHATGDO     VMIQLFUNWVUNVH  LBAT            RTVHPC         
FOISBNAMEC      : MNVSLRRCVMSH    JCEUDNRBWIAE    SFRDMPEALFHMKS 
TEUPGXXCAVWAO   : QBIDW           EANYPOX         PYFXADDCYCCQ    VMLNABRNOCTOFO  TQXXJFJLKDCKL  
JFLE            : HVJOJTXKQRFAF   BUUSTNJIUEG     LSPAYSR         AJCRRAAUWJRW    RAYGOVIGM       TYHSYI          EIDTBYQNO      
KJGUEHKGVRLE    : VOSDQR          NLRMWQTSUALA   
PYFXADDCYCCQ    : PNYBMHQAYO      TKDWB           NTMDAUVGYH      TEUPGXXCAVWAO   KOKQQIIMNE      ULAYJCMKNQQN   
OXMU            : WECRYEQWM       UUALNVGSGB      ETXLVMPV       
YFVWLFHSDYGHMXJ : GKJPWP          WDWLXLGN        IWSMR          
WJXCNWEQ        : LRWBKKSQIU      DVBIYFIRAFL     QYRIPO          XNICHWLKJKLIVPB YPUGNBATUV     
FHOR            : MFFFQJDDTEKXT   DQPIHIETOSS     GDGYAYOPSATALOC
ESHCPVHAQMBWTQ  : GKJPWP          NYINVL          WOTJ            BVPXJJIYMDYE    WCKNQFTMS      
FKTQIVF         : PVJSSEM         VPDOJGCAVGDYNX 
CXXHF           : WIJHCGXIM       SJRVD           GDUGURB         MAIQPUPMHVHNME 
BHSURUMN        : NQPAPPABRPOM    SPWESAR         WYRQWLULY      
MGQOD           : HGIRNAPCMESLYXO IFNKNV          NWCIXUWWOP      CCJVK          
FAUPUM          : AXYS            RAYGOVIGM       IIBSKIBYKEKRPP 
QTHT            : OTUSLFNQ        PSDUGSRDSS      TRTUKJEMHXJA    SMXUYDEKDGSJBF  BMQNCBA        
FDWUFGPCXNO     : KDVKOWO         TETLUY          TQXXJFJLKDCKL   VXALTDB        
TETLUY          : GIAPFQGANFKWMMF XLJRLQMTX       FDWUFGPCXNO     VXPD           
CAVRUIS         : OIQSIVXGWRKXHXF
CCJVK           : VPQQV           AJCRRAAUWJRW    MGQOD          
UHUC            : PXBMIAUQ        LOLATDU         TQOICQTJDGA     IBKQAAXJOQXPOYU
WCKNQFTMS       : GBKJUYTRABBWFR  ESHCPVHAQMBWTQ  SQCTQBFHXFTFWJM
MTQORL          : BVQHJYW         IDTMTBLCODHC    QEBDXCPKYS      YGIFI           TQYKFT         
BGYFJJETWYBRBA  : VMSD           
ELEWSY          : EBBBNU          QPNYL           SDYWH          
LPXHHMYSXCY     : KDLWYNNRQWTCKQL UFHTMP          UQTNA          
KKHOGG          : QBIDW           BOMEFAKJXNR     JRCFARHVFDWJU   VPDOJGCAVGDYNX  ISGAP          
HXRIQVVU        : BQXIFVWMGHWBV   KBTEKULYKNMB    TJECURTF        ONPEU          
QVEEMDL         : CWMHXFNWVQR    
PMQORR          : WBSEBPL         RAMGBFODHRYYJ   AQHXFSWGQ       DRNAGCO        
CDVSJCITCAESX   : AVAWCDL         NGXQDCDX       
PSSOXWDBKYSYRJQ : VCEEPWIQA       VUTDKUOISKKFIN  CFPFLUKEYFGNK   PJIUKQPTPVTIQ  
XUMTNWXWQA      : IUDTTOCOCT      HQYQCP          DWTDCTNFNSXJTDI YDRFIPTM        OXHEP           GXCXFUQYVV      XUOXNUDDBF     
WUAWLSRCQOF     : HLPDVYK         KBTEKULYKNMB    ACLJPCQTIFTWG  
YGPAXYRHXMURDTS : CFXXGD          ROCTDPPJKX      MEAKMIPUDND    
MUBJQBIEUAG     : XTAWKJB         XASUHXVSCK      FVLDCQRRAPBVDWF PBFJEMGXV       CTXODUQ         TJECURTF       
QNKRT           : SMXUYDEKDGSJBF  VBERNPNA        AQHXFSWGQ      
RRBJYYYTTC      : IUWMBD          EHOUMLMHC       EDVCXWQP        HUHXCXSLDMRUCDY
OECJHLCJVG      : DSUC            GIXCM           SPWESAR         YPBOIMCAFY     
VOVMCIGV        : PSNECBHFTWB     JUGSADWDGL      UERVBJVLYNYDQVM LMPJC          
YNMI            : LOLATDU         LRCBM           SJRVD           WHLJGCX         TOJBMWBXLCQDJIC HVJSV          
NJJJLA          : GBKJUYTRABBWFR  ORPOSNESY       TACFWAPFFN      YQSTTJ         
PCKXQMJMTRLKNA  : PRNO            DWDIWIPL        IYHRGY          LBAT           
WHLJGCX         : LGIKLUGKX       WHPRRNF         VPDOJGCAVGDYNX  YNMI           
RMBBXODYHI      : PKRICRJTJXI     LVHUXC          WTSUN           LCIERIK        
FYVQNRIBDXESW   : IXNMS           ARNFOUAGXK      SRNSWBVTEOXAHUB UTQJROBNYSRBOB 
GHTIFMATP       : URHGWMABWA      ONVIJHOYEBJRYK  OCHNLDSVIKICML  TRTUKJEMHXJA    JAEMBUDRDV     
UFHTMP          : EKTMLVRRLNKAFJN AHEOGNEFBLA     LPXHHMYSXCY     CFXXGD         
TQYKFT          : CBWXNHATGDO     VGAMBK          VBERNPNA        MTQORL          BXBD            WYTFDDHNVOUKY  
IWSMR           : OMWTXXQJSSRAAE  FVOYVPSUSOPSJC  YFVWLFHSDYGHMXJ RISQSFRDWKD    
AAATJHJL        : UNPTSSIMCFFQQIA LGIKLUGKX       AITGUQ          LCIERIK         MLPWLLUKCMXGJM 
YPYEXSSPVM      : PPVXIVSPOTA     BHNNNP          MOGXSDRXYRY     CKLIGACSGH      KDMBJNMO        XMFCSNGSORQGAQO PJIUKQPTPVTIQ  
WYOQVWP         : SOBKFNE         CKIBCRKKKQ      PATVHOMVIME     WTRQDPIYTS     
MJIM            : DNRO            TAFSIEFNFBAIXC  RAYGOVIGM       QSQHROFF        BRJLLIBYCNVSJP 
KJTRSHVRAUYXPTP : XTAWKJB         QBIDW           VPQQV           BVPXJJIYMDYE    TKHHYLNW       
HWLILEFLUWXE    : PIUUHIJQH       DUBTH           AMBLFYAJHQVRNEW YPUGNBATUV     
MQRVKLQUKLUHKUX : HAMP            KCRR            HYHAPFR        
KLNIYYVEEJBD    : GCUARMSSHAFUUOP XMFCSNGSORQGAQO
HMWYGSLRMGC     : MCENMYUKESDP    MEAKMIPUDND    
BKKXKQ          : XNDKYHWKF       GIPE           
XHTXGREMCFPN    : DWDIWIPL        VPJNNNKSQYBA    XMFCSNGSORQGAQO TIRAEVVCOBP    
CKLIGACSGH      : YPCGTVYLFNQD    OVQQKMXL        TDNVXMHSMWLA    IBKQAAXJOQXPOYU YPYEXSSPVM      VREGKGVVWTEEL  
KTDIETTCBPCJI   : SLYWWBBDDUGLVO  HQXFIV          GJGYGCESU       ACLJPCQTIFTWG  
VMLNABRNOCTOFO  : EMCTSKMPKILUGL  XSOVBWDDMHJJFK  TEUPGXXCAVWAO  
OFIIKSOEPQIFVR  : MRLLYDMK        AHEOGNEFBLA     OPLDUQWLXU      RISQSFRDWKD     VIILHA         
CQEQEHRYU       : JNEQPDR         BOMEFAKJXNR     XLOWJYPFPGFNETK YPBOIMCAFY     
BQXIFVWMGHWBV   : FQFTJX          EPIHCIDBURJW    DFLQAROCLVYBG   HXRIQVVU       
QPNYL           : OIQSIVXGWRKXHXF IFEYYE          NAVNSYBRBU      IBKQAAXJOQXPOYU ELEWSY         
QNYX            : JTCMRWSONFSVTIY YGIFI           UIFBUD          XBDWAMCLB      
FHXEEHG         : TWLQQKORI       LQFCNADI        COIS            HOYPFQQRAFMKPT  PITOERBQQCVBKXJ
HOADOOLVLMSQGKF : HLCYAPHH        RMBLMA          YICLOAKKGV     
VNALMX          : SOJAJKQ         GFWPBPMXAVEOFEB RLOYJ           OUPWTGEWE       TACFWAPFFN     
RFQWLX          : LUHTDPCUE       BGECDOTKPO      JNXIDVUEWOMCHLN RNCVGAUKAFIOQ   LIPI            YQSTTJ         
GFVIKKWVJKLE    : MOGXSDRXYRY     GGXQGXHOPCL    
TOJBMWBXLCQDJIC : YNMI            GCUARMSSHAFUUOP
IJCQGNDSMC      : JMMHRECREMUG    BFHXYCSPYKMSGD  SRNSWBVTEOXAHUB BBNAGPACIAHF   
XNICHWLKJKLIVPB : KORA            WJXCNWEQ        EDVCXWQP       
AJGXUPALVPORDST : NAVNSYBRBU      WQVYDUGSKU     
GFFPCS          : XFRBLKOKDXFXK  
OFOYD           : UYJO            LOLGKTJNUR      NWCIXUWWOP      UIFBUD          NKAANGOSV      
AEGMMGHDHUBYL   : VEKD            AVAWCDL         PWOSP           IOEPUBSHVC      REWT           
CFPFLUKEYFGNK   : FQFTJX          PSSOXWDBKYSYRJQ
MNEPUMCHTJKDE   : BGWTMYJWREOUAF  DWDIWIPL        VGFHU           IOEPUBSHVC      FIDTLWOBLYFNPOE
CPHHUYMJTAP     : ISVAV           JJNTINFDUBPKJ   QMRABSMU        MVGOGRUSVVLSH   VCGM            ROCTDPPJKX     
HVJSV           : QSSKWAXLYO      RTUBHFRX        XLNDIIUBMAFGJ   NWCIXUWWOP      YNMI           
IAODO           : HSSCER          OCHNLDSVIKICML  VHQCCTH         PITGIKCCHNNMJ  
NKAANGOSV       : CXLEMDBPNNIFWD  QACIQNVRYMNLE   GIAPFQGANFKWMMF OFOYD          
CTXODUQ         : DWDFGGWWK       MUBJQBIEUAG     VXALTDB        
QYQATMYCON      : YXUTVAMTMULYCIO XWFMYLCKN       CXLEMDBPNNIFWD  VBERNPNA        YPUGNBATUV     
GGXQGXHOPCL     : SWLTUWOLOWOO    GFVIKKWVJKLE    WGCYP          
EHOUMLMHC       : WMTKOBRIRAKTYS  LSPAYSR         NDNFLPWAHSQL    RRBJYYYTTC      LHMQIFRFXKA    
XFHNELEU        : IUDTTOCOCT      GLQIUV          AVDC            TKDWB           EKTMLVRRLNKAFJN JRCFARHVFDWJU   VXALTDB        
KBTEKULYKNMB    : HXRIQVVU        WUAWLSRCQOF     NWJJMDHK       
TPMICBPGOQLXESK : GXJLQGSPP       GSOS           
NGXQDCDX        : TKIBEODVS       DUNWH           DNQXO           CDVSJCITCAESX  
FIDTLWOBLYFNPOE : TAFSIEFNFBAIXC  MLPWLLUKCMXGJM  MNEPUMCHTJKDE  
ADMSPWIXU       : NPYHBR          WJWFLFH         YPUGNBATUV     
BWFBMKLR        : XMPSEUMXAHPK   
WQVYDUGSKU      : CDVRWVXWHWMNCPE KDVKOWO         RTVHPC          AJGXUPALVPORDST IIBSKIBYKEKRPP 
SVCFQTD         : RJSUKVTRNAXOCFE DAQUKPMTBOSBHC  FFIUDJEXCRQU    MLRMFFTNE       TACFWAPFFN     
SACTAJVOUH      : VGAMBK          PORAJLAGQGPN    GYFW            HWWMBMV         UYJYSXMUX      
CFXXGD          : VJNJON          LMSMSNDIBD      YGPAXYRHXMURDTS UFHTMP         
OXIKX           : HFTVSYEETF      JJNTINFDUBPKJ   KTEQKYEKU      
ICHYWMBPM       : GVXXTMSOOMO     PKDRWTEOKMWYAE  WQEVWJLCKRODO   OXXBFB         
LMPJC           : YQQIL           QYRIPO          VOVMCIGV        NWJJMDHK        FPNHLKDTKQCOLP 
RLOYJ           : WDNGPRVXLLGMQY  HFTVSYEETF      MUPORIN         IYHRGY          RWWJQIOALYFH    VNALMX          MQNLAXMULUV    
HPJVPTG         : CFVNITCEFELGELX MLPWLLUKCMXGJM  JJTIF          
VOSDQR          : UKBKAVYKL       INHXE           KJVVISTQQXWVN   WPIUX           KJGUEHKGVRLE    QSQHROFF       
TJECURTF        : BUQDSSWUNS      HXRIQVVU        MUBJQBIEUAG     JYNPGWHLKSXMCI  GSOS           
GYFW            : UNPTSSIMCFFQQIA IOEPUBSHVC      SACTAJVOUH     
QNFIYBYTKOPBJUT : EHRFLCVNJ       DEAQUWRRFTABAVU SNOI           
KOKQQIIMNE      : AXYS            EMBNNKIYRLWOHD  HTXNVSWKKW      EFOQMOYOOSMK    PYFXADDCYCCQ    HUHXCXSLDMRUCDY
MLRMFFTNE       : HVJOJTXKQRFAF   RBYDTQ          OHRCFW          SVCFQTD         MLRNUFCMDFPSI  
OXHEP           : LRWBKKSQIU      XUMTNWXWQA      PJIUKQPTPVTIQ  
PKDRWTEOKMWYAE  : MUPORIN         KTEQKYEKU       BUQDSSWUNS      ICHYWMBPM       KDMBJNMO       
OPLDUQWLXU      : TWLQQKORI       QWJSOQVOF       ROPFEQN         OFIIKSOEPQIFVR 
VCGM            : MFXRFMN         TAFSIEFNFBAIXC  AFSOJRRS        CPHHUYMJTAP     VREGKGVVWTEEL  
WYRQWLULY       : PDNUWWB         UFRHYIHCKRK     FLWSDLWAS       LMSMSNDIBD      BHSURUMN        HNABXAWESDWGH  
KXKOS           : PSNECBHFTWB     RNCVGAUKAFIOQ   ORPOSNESY       QYINRNEBUGE     MQLH           
HEDCVBNTX       : URUTQGAOJSU     XLNDIIUBMAFGJ   VREGKGVVWTEEL  
RAYGOVIGM       : BLJLNGDJSLNLL   PUTUNJEXRIRIB   JFLE            FAUPUM          MJIM            VOFOSXWRT       TIRAEVVCOBP    
RISQSFRDWKD     : UECYGFHLAG      HYHAPFR         IWSMR           OFIIKSOEPQIFVR  MKIQSUGHBLNFS   RHRUNSAMM      
OJGMMWIKPBMO    : GXIVMDJ         HEXG            XUOXNUDDBF     
BNRHAYCKTUDA    : SOBKFNE         FVLDCQRRAPBVDWF WDWLXLGN       
HWWMBMV         : FVLDCQRRAPBVDWF XMPSEUMXAHPK    BVPXJJIYMDYE    SACTAJVOUH     
YKIIUXLIPW      : NQPAPPABRPOM    VCDU           
DRTFQXQLSV      : UYJYSXMUX       FYYUSXDULR      LDQNQYAIJFAPFMP
IFKFSNTQW       : DYIQVINGMJSB    HNIPXKXPSQRLFEA VGFHU          
CIGYIRHXQTB     : WMEBKP          EGNICJAKPHHO    TKHHYLNW       
PJCPANIXBSE     : VLDTPVTTGNJDF   DVOD            LYLOHKHFJCEJLQ  XNDKYHWKF       GJGYGCESU       CHTJCWSETAYCB   UXWHKBWGALBIG  
YWBUPAQR        : PSNECBHFTWB     VJNJON          HAMP            KDLDJTJ         LMSMSNDIBD     
WTRQDPIYTS      : CXLEMDBPNNIFWD  FWXUGFCQ        WYOQVWP        
FUEHIPFLIJY     : GUQSXTRASTKB    TQOICQTJDGA    
ICFBDXS         : SOBKFNE         KCRR            IDTMTBLCODHC    DYIQVINGMJSB   
VOFOSXWRT       : YQQIL           RYLSGXYT        RAYGOVIGM       TUKLYBFIIAH     NHNBSXCSARQT   
JYNPGWHLKSXMCI  : LYLOHKHFJCEJLQ  AHEOGNEFBLA     JNJOLNRAX       AAEJ            TJECURTF        LHQPSRF        
JJTIF           : HPJVPTG         OIESTRGGFTVANI  MAIQPUPMHVHNME 
GTNUMNUFHNOGBE  : IDTMTBLCODHC    NRSSNHMOUODYVH  IMFTLTJUESCP    MEVRFOYCAF      NTMDAUVGYH      VALUYFBC        DYPAUQQRYQPMKT 
AMBLFYAJHQVRNEW : HWLILEFLUWXE    HTTCSWYMBNKD    VFERSY         
MQLH            : XASUHXVSCK      IFEYYE          SGEWBK          KXKOS           MMCADAJWESDEYV 
ACLJPCQTIFTWG   : YHFOYTC         PTMEXECBWLYALYJ WUAWLSRCQOF     KTDIETTCBPCJI  
EHHQPYMJ        : URHGWMABWA     
SIKFBXOH        : EFOQMOYOOSMK    FPNHLKDTKQCOLP  MAIQPUPMHVHNME 
TUKLYBFIIAH     : JNBSAQDU        VOFOSXWRT      
HOYPFQQRAFMKPT  : FHXEEHG         XWJOVY          GMPMDFDEF      
PITOERBQQCVBKXJ : TXHOWHYKOOLDL   FHXEEHG         BUHJWRIWTEQGR  
GXCXFUQYVV      : KTEQKYEKU       XUMTNWXWQA     
GNFUDPPTU       : FQFTJX          AAEJ            OIESTRGGFTVANI 
ULAYJCMKNQQN    : PYFXADDCYCCQ    IEAYLVQ        
QSQHROFF        : AWWLNPO         MJIM            VOSDQR         
UMSXCKUWTRKTTU  : ISVAV           QRNAVWFRQIRRX   IBJYFFVQSAD    
GFLYX           : PSDUGSRDSS      JJNTINFDUBPKJ   BHDEW           HDQFQPLEB      
UQTNA           : VAHP            VCDU            LPXHHMYSXCY     CWNFWSDLPYNXA  
CFUYCHTCKE      : CBWXNHATGDO     PLQWDJICGRXBH  
JXRUULR         : YONCR           CTTKN          
TYHSYI          : CFDDSM          BGECDOTKPO      UTXATB          LRCBM           BNBO            JFLE            TMDOUB         
PFDRSFYQ        : BMQQRDM         AUTHTQTDCOJUOOT GJGYGCESU       TRTUKJEMHXJA    PBFJEMGXV      
BXBD            : AVDC            RCQTBFXILENIM   MFLCVV          IUWMBD          TQYKFT          YPUGNBATUV     
GDUGURB         : EHRFLCVNJ       ULETGGQMEHUQM   KDLWYNNRQWTCKQL CXXHF          
LWCKEULOLD      : GIXCM          
OUPWTGEWE       : UFRHYIHCKRK     JICYNXJBYTGFS   GXIVMDJ         VNALMX         
ARNFOUAGXK      : EMBNNKIYRLWOHD  LRWBKKSQIU      FLWSDLWAS       FYVQNRIBDXESW  
WMEBKP          : AITGUQ          CVCP            JTCMRWSONFSVTIY CIGYIRHXQTB    
VUMMPC          : CJCDGCTCFYGEQ   GIOKOVP         HTVGACFGNTSN    XPWCJYBYWK      ORKHXIAATWSTU   DXBJAHRWMOKK   
LIPI            : MEIJXCHGSKTB    RFQWLX         
VKHLQXIS        : DUBTH           OHRCFW         
HEXG            : MNVSLRRCVMSH    OJGMMWIKPBMO   
EIDTBYQNO       : FVLDCQRRAPBVDWF BFHXYCSPYKMSGD  UIFBUD          JFLE            PWGX           
SARBQC          : RTUBHFRX        QFVWCET         WHOIHRIFNE      TRTUKJEMHXJA    GWAYWVCKKGB    
MMCADAJWESDEYV  : CWLNINBDQMTNYLY PXBMIAUQ        UPIBOPRXAM      YIEVD           DMDBQULXW       TDNVXMHSMWLA    OHRCFW          MQLH           
JAEMBUDRDV      : MGSOIQJLEMI     GYYHPDWO        GHTIFMATP      
UYJYSXMUX       : DHMIYHDWECBM    EFOQMOYOOSMK    SACTAJVOUH      DRTFQXQLSV     
VHQCCTH         : EUDJB           IAODO          
SRNSWBVTEOXAHUB : IMXNQKOGXC      CHTJCWSETAYCB   FYVQNRIBDXESW   IJCQGNDSMC      EHOCMCFAD      
UTQJROBNYSRBOB  : AXYS            RJSUKVTRNAXOCFE RNCVGAUKAFIOQ   FYVQNRIBDXESW  
HTTCSWYMBNKD    : NPYHBR          DAQUKPMTBOSBHC  POUO            AMBLFYAJHQVRNEW BRJLLIBYCNVSJP 
GEPDYGM         : AOONMH          CJCDGCTCFYGEQ   GYYHPDWO        ROCTDPPJKX     
UNGVIAAX        : CXUSBHUROXPPR   XOBQ            AAEJ           
FFVBIQXJD       : IXXSLTUK        QRNAVWFRQIRRX   QMYCUANTHVRBOR  YPBOIMCAFY     
WQEVWJLCKRODO   : QFVWCET         IICHRG          SJRVD           ICHYWMBPM       EFUCFSJBVGH    
LNNLNLNU        : EBBBNU          TXHOWHYKOOLDL   AGXHIG         
LYBCW           : UFFQLRINTIGL    GFWPBPMXAVEOFEB
IBJYFFVQSAD     : QSKYLSQYE       UMSXCKUWTRKTTU 
OIESTRGGFTVANI  : AOONMH          PSDUGSRDSS      JJTIF           GNFUDPPTU      
QMYCUANTHVRBOR  : FFVBIQXJD      
EGNICJAKPHHO    : CIGYIRHXQTB     JKEWWVGLAKHCI   ETXLVMPV       
UYLLLKPJ        : UECYGFHLAG      DVBIYFIRAFL     RJSUKVTRNAXOCFE OCHNLDSVIKICML 
EDVCXWQP        : MFFFQJDDTEKXT   GMRDF           RRBJYYYTTC      XNICHWLKJKLIVPB
WYTFDDHNVOUKY   : GMQAAXPRAAYFAJF TKDWB           LXEYGMYYXIKMC   SJRVD           TQYKFT          UXWHKBWGALBIG  
JKEWWVGLAKHCI   : NQPAPPABRPOM    EGNICJAKPHHO   
VALUYFBC        : GVXXTMSOOMO     UERVBJVLYNYDQVM DFLQAROCLVYBG   GTNUMNUFHNOGBE 
ISGAP           : KKHOGG          UXWHKBWGALBIG  
YICLOAKKGV      : DXHCWSSIHUTIA   HOADOOLVLMSQGKF DRNAGCO        
SFRDMPEALFHMKS  : XASUHXVSCK      GBCYUXQTDEDWPAS GDGYAYOPSATALOC SJRVD           DFLQAROCLVYBG   FOISBNAMEC      XYIQBFH        
FYYUSXDULR      : PSNECBHFTWB     QEBDXCPKYS      XLOWJYPFPGFNETK DRTFQXQLSV      YQSTTJ         
VFERSY          : BMQQRDM         NQPAPPABRPOM    GMRDF           AMBLFYAJHQVRNEW
KDMBJNMO        : HALVXRUGEVHCEUO YPYEXSSPVM      PKDRWTEOKMWYAE 
BBNAGPACIAHF    : BBPQOHPTQBWYUU  IJCQGNDSMC     
ADKHJDAI        : OGVKSXD         XTAWKJB         POPLJYJ         LKIBURRIKAM    
MLRNUFCMDFPSI   : MEVRFOYCAF      PORAJLAGQGPN    MLRMFFTNE      
IIBSKIBYKEKRPP  : LTYYYKMTPQ      NPYHBR          FAUPUM          WQVYDUGSKU      CWNFWSDLPYNXA  
XUFMMUHSAVV     : XMPSEUMXAHPK    IFJHA           LMOJYBWYVHG    
MQNLAXMULUV     : GIPE            PMULNHUG        RLOYJ          
GCUARMSSHAFUUOP : GYYHPDWO        XPWCJYBYWK      DQPIHIETOSS     KLNIYYVEEJBD    TOJBMWBXLCQDJIC CWNFWSDLPYNXA  
LNDAESN         : IBLMUGWJXJRLEBX QPGDA           MCENMYUKESDP   
TACFWAPFFN      : PSDUGSRDSS      BMQNCBA         NJJJLA          VNALMX          SVCFQTD         NLRMWQTSUALA   
YAYRIBWFX       : JCEUDNRBWIAE    OMWTXXQJSSRAAE  IOEPUBSHVC     
UVAIBCMTRTP     : XNDKYHWKF       ROCTDPPJKX     
XUOXNUDDBF      : KMOWTEDJ        YQQIL           CVCP            XUMTNWXWQA      OJGMMWIKPBMO   
CWNFWSDLPYNXA   : XWFMYLCKN       VEUCDOHXQCHOEEQ UQTNA           IIBSKIBYKEKRPP  GCUARMSSHAFUUOP
NWJJMDHK        : HAMP            RBSCYTEWOLK     DQPIHIETOSS     KBTEKULYKNMB    LMPJC           NRRUGTHJCHOD   
FXOLBRQGVP      : AUTHTQTDCOJUOOT UKBKAVYKL       XAKH           
BOPFAIGPIHHVEQF : CXLEMDBPNNIFWD  RMBLMA         
TMDOUB          : NTMDAUVGYH      IOEPUBSHVC      TYHSYI         
IEAYLVQ         : PXBMIAUQ        EUDJB           RCQTBFXILENIM   AOLYSNWSBVSGO   ULAYJCMKNQQN    MVUXIFXLVXLYE  
AGXHIG          : WDWLXLGN        LNNLNLNU       
YPUGNBATUV      : QCDET           VGFHU           WJXCNWEQ        HWLILEFLUWXE    QYQATMYCON      ADMSPWIXU       BXBD           
XMFCSNGSORQGAQO : ORPOSNESY       LFRDTK          YPYEXSSPVM      KLNIYYVEEJBD    XHTXGREMCFPN   
XWJOVY          : CXUSBHUROXPPR   URUTQGAOJSU     EUDON           AEVG            HOYPFQQRAFMKPT 
FPNHLKDTKQCOLP  : AXYS            IFDYJXKH        LMPJC           SIKFBXOH       
GFPY            : AVKV            KMOWTEDJ        KFRQNTIULOWBV   NDVK            DYIQVINGMJSB    QEBDXCPKYS      TRTUKJEMHXJA   
SQCTQBFHXFTFWJM : UQXGENMHXH      HFTVSYEETF      HNIPXKXPSQRLFEA WCKNQFTMS       QXKUS          
VREGKGVVWTEEL   : WNAIQ           RWYEKLGS        HQXFIV          XSOYTPOMHXDBQGX CKLIGACSGH      VCGM            HEDCVBNTX      
REWT            : AITGUQ          MVGOGRUSVVLSH   HNIPXKXPSQRLFEA AEGMMGHDHUBYL   IRHIGNJLCPTVO  
PWGX            : BGWTMYJWREOUAF  DEAQUWRRFTABAVU EFOQMOYOOSMK    EIDTBYQNO       FVKSJGNHO      
NRCKDQSYJWHTE   : TWLQQKORI       BLJLNGDJSLNLL   EVYNVFYTKLHAHTD LHQPSRF        
SDYWH           : KFRQNTIULOWBV   ELEWSY         
DYPAUQQRYQPMKT  : PVJSSEM         GTNUMNUFHNOGBE 
NLRMWQTSUALA    : MFXRFMN         KJGUEHKGVRLE    TACFWAPFFN      LDQNQYAIJFAPFMP
LHMQIFRFXKA     : MRDOVK          DYIQVINGMJSB    EHOUMLMHC      
BRJLLIBYCNVSJP  : IOIGYSJOPXLMDUU PUTUNJEXRIRIB   JBXTUQSAIAJYVX  POKDGLLHRBHAWFR BUUSTNJIUEG     LOLGKTJNUR      MJIM            HTTCSWYMBNKD   
LDQNQYAIJFAPFMP : RCHJP           VUARMMCNT       FWXUGFCQ        BUQDSSWUNS      DRTFQXQLSV      NLRMWQTSUALA   
NHNBSXCSARQT    : EPIHCIDBURJW    VOFOSXWRT      
GMPMDFDEF       : XOBQ            LXEYGMYYXIKMC   WPDUBDCJRTTSS   XSOYTPOMHXDBQGX HOYPFQQRAFMKPT 
ONPEU           : HLWRHJISD       JICYNXJBYTGFS   GXIVMDJ         HXRIQVVU       
VXPD            : BGWTMYJWREOUAF  CWARAUSFWEY     OHRCFW          TETLUY          FVKSJGNHO      
QXKUS           : WBSEBPL         AVAWCDL         OUICFBXXQWY     JICYNXJBYTGFS   HALVXRUGEVHCEUO SQCTQBFHXFTFWJM
MKIQSUGHBLNFS   : BVQHJYW         AHEOGNEFBLA     ORKHXIAATWSTU   RISQSFRDWKD     MAIQPUPMHVHNME 
TIRAEVVCOBP     : CWLNINBDQMTNYLY FAPW            IRTQ            LBAT            XHTXGREMCFPN    RAYGOVIGM       FDDWTVNXJPATQI 
ACDUPPFAGBVMI   : EPIHCIDBURJW    IIIIT          
AXETABETB       : CDVRWVXWHWMNCPE PKRICRJTJXI     CFVNITCEFELGELX RCHJP           KDLWYNNRQWTCKQL IDWGPRJWWG     
RAMGBFODHRYYJ   : VPQQV           XFRBLKOKDXFXK   MOGXSDRXYRY     JRCFARHVFDWJU   BUQDSSWUNS      PMQORR         
AQHXFSWGQ       : CKIBCRKKKQ      VUTDKUOISKKFIN  PMQORR          QNKRT          
CSEG            : HLPDVYK         BGLGSFQFPE      SDOS           
IRHIGNJLCPTVO   : UUUUWEIDYQVE    GDGYAYOPSATALOC FLWSDLWAS       REWT            EHOCMCFAD      
GUUYDUEXTMQX    : RUCJ            RTVHPC          SJRVD          
KCXBKR          : VEQLELEUTWQC    YSOMMDBN       
UXWHKBWGALBIG   : VEQLELEUTWQC    PJCPANIXBSE     WYTFDDHNVOUKY   ISGAP           MAIQPUPMHVHNME 
HLTNLOB         : SCEGHAVFWS      YDRFIPTM        RWWJQIOALYFH    PJIUKQPTPVTIQ  
MRPQRQELAYKYI   : LGIKLUGKX       VSTFNQERERA     QEBDXCPKYS     
CFDCSGK         : JMMHRECREMUG    NDVK            KORA            WVPMHAHLG       GXIVMDJ         AFSOJRRS       
DRNAGCO         : GMQAAXPRAAYFAJF DAQUKPMTBOSBHC  MYIXWVYKVDE     PMQORR          YICLOAKKGV      GSOS           
FDDWTVNXJPATQI  : IXNMS           BGECDOTKPO      TIRAEVVCOBP    
TQXXJFJLKDCKL   : KCRR            NPYHBR          TEUPGXXCAVWAO   FDWUFGPCXNO    
YULEBIY         : FTJLFAWCYT     
XYIQBFH         : SGLFBSHSSBEQQW  RUWXDRUXYICAXP  SFRDMPEALFHMKS 
XBDWAMCLB       : BVPXJJIYMDYE    QNYX           
ODADHBAUGBFH    : JNEQPDR         IRTQ            WVPMHAHLG       VEDQQKQXOSUA    BUQDSSWUNS     
DIJTKOEYOF      : NKTMCSXWHOS     UFNBXVVIYXK     GBKJUYTRABBWFR  TKBUUTQEHWSS    DQPIHIETOSS    
LHQPSRF         : JYNPGWHLKSXMCI  NRCKDQSYJWHTE  
UFNEINYORGX     : XWFMYLCKN       CIWSPVPSAMYC    PSDUGSRDSS      DWDIWIPL        QAAFGEXFKGT    
KHDGTRKSJ       : TKIBEODVS       SWLTUWOLOWOO    WTSUN          
UUALNVGSGB      : OTUSLFNQ        QFVWCET         OXMU           
VIILHA          : HGIRNAPCMESLYXO URUTQGAOJSU     TATDNESIRHAC    OFIIKSOEPQIFVR 
OXXBFB          : YXUTVAMTMULYCIO ICHYWMBPM      
YVWR            : EBBBNU          XASUHXVSCK      AVAWCDL         HFTVSYEETF      JNXIDVUEWOMCHLN IAGMAGTV       
ROCTDPPJKX      : DUAWBQWF        YGPAXYRHXMURDTS CPHHUYMJTAP     GEPDYGM         UVAIBCMTRTP    
MVUXIFXLVXLYE   : LMSMSNDIBD      VPDOJGCAVGDYNX  IEAYLVQ        
IFJHA           : TDNVXMHSMWLA    XUFMMUHSAVV    
YQSTTJ          : MNVSLRRCVMSH    PEIKVRJI        IVJDOCYSFWKEPFL NJJJLA          RFQWLX          FYYUSXDULR     
FVKSJGNHO       : OIRIVRPTWGX     OUICFBXXQWY     BGECDOTKPO      RBYDTQ          PWGX            VXPD           
HDQFQPLEB       : SVRYCNHTKUVSN   CFVNITCEFELGELX AUTHTQTDCOJUOOT BFHXYCSPYKMSGD  INHXE           LCIERIK         GFLYX          
PITGIKCCHNNMJ   : FAOTJ           ORKHXIAATWSTU   JRCFARHVFDWJU   IAODO          
HUHXCXSLDMRUCDY : RBYDTQ          RRBJYYYTTC      KOKQQIIMNE     
WRMS            : FGKVSJPSHGDDBUD GUQSXTRASTKB    KRXXSQLQLOOEWFL
WGCYP           : DSUC            FAOTJ           VBERNPNA        GGXQGXHOPCL    
MCENMYUKESDP    : BRJFJCALPTRG    HMWYGSLRMGC     LNDAESN        
RHRUNSAMM       : CDGGMJTDJ       RISQSFRDWKD    
INLORM          : CXUSBHUROXPPR   DVOD            ATKPHYU         EVYNVFYTKLHAHTD IUWMBD         
MAIQPUPMHVHNME  : HLCYAPHH        BKWLL           LXEYGMYYXIKMC   CXXHF           JJTIF           SIKFBXOH        MKIQSUGHBLNFS   UXWHKBWGALBIG  
VXALTDB         : AAEJ            FFIUDJEXCRQU    FDWUFGPCXNO     CTXODUQ         XFHNELEU       
RJVGXQSEDUOVKMN : CIWSPVPSAMYC    GTUGILPQICKX   
TKHHYLNW        : OIRIVRPTWGX     HQXFIV          EANYPOX         KJTRSHVRAUYXPTP CIGYIRHXQTB    
PJIUKQPTPVTIQ   : IICHRG          PSSOXWDBKYSYRJQ YPYEXSSPVM      OXHEP           HLTNLOB        
LMOJYBWYVHG     : EMBNNKIYRLWOHD  XFRBLKOKDXFXK   PPVXIVSPOTA     JNBSAQDU        PBFJEMGXV       XUFMMUHSAVV    
GTUGILPQICKX    : OPUCOEYI        AWWLNPO         RJVGXQSEDUOVKMN
CTTKN           : VJNJON          IYNSVC          JXRUULR        
XAKH            : LVPQI           BLJLNGDJSLNLL   HQXFIV          CHTJCWSETAYCB   AVANVXDSMYJ     FXOLBRQGVP     
MEAKMIPUDND     : YGPAXYRHXMURDTS HMWYGSLRMGC    
BUHJWRIWTEQGR   : FAPW            PITOERBQQCVBKXJ
ETXLVMPV        : HTVGACFGNTSN    RMGGTVOKTBKKVB  CHTJCWSETAYCB   OXMU            EGNICJAKPHHO   
EHOCMCFAD       : DUNWH           IFNKNV          JSORKKGCN       SRNSWBVTEOXAHUB IRHIGNJLCPTVO  
HNABXAWESDWGH   : HTXNVSWKKW      QPGDA           JBXTUQSAIAJYVX  OVQQKMXL        WYRQWLULY      
GSOS            : YDRFIPTM        MFLCVV          MEIJXCHGSKTB    TPMICBPGOQLXESK TJECURTF        DRNAGCO        
NRRUGTHJCHOD    : JUGSADWDGL      EFOQMOYOOSMK    VMISKWN         NWJJMDHK       
EFUCFSJBVGH     : VMIQLFUNWVUNVH  WQEVWJLCKRODO  
YPBOIMCAFY      : TKIBEODVS       BFHXYCSPYKMSGD  OECJHLCJVG      CQEQEHRYU       FFVBIQXJD      
