PCIQITPP        : VLPKFL          ELMQDCCRXRJQKV  KUYTLGYCXJ      CPSVXUYTR       HBQDU           YVSIBNEHTRC     VGWTG           MDCRYCRAQJIOYHN
ECHF            : FBVBYMJUBVLKY   GHYAUN          CKNMSH          WARIRI         
TMLWTBWKKUEJQ   : ONPGXWGPVLBQDVO TLVTGVJG        AJPPQAWLQ       VTTLIUUO        OABULF         
GIHYMSPWOFNUMR  : HSVDPCRDYGFRNAD KAPBOBMRSW      OKGOIURXVULPI   XBXHMIHBJVTYDTE OHLGYQ         
TFXGSXCTU       : TTDRINJXU       AXGBUNCQ        GRYGBFVQWKYBI   SJUHKK         
HPQSJRCRCBHUQE  : HSLNGVUWA       MVHBHJFEHDWMH  
XTGMNKGVL       : SBFRALAGI       GPWRMRSRLOUI    SOMORBAYFSYRQTL HSWXIQX         HKNUROP        
OLRLGESY        : LQJSD           COXTXPDUSON     XRJA            MWWLNILRJXWWYF 
NKRPET          : BQEA            CCPMDXLKNUVEDSM LHBCNOTGFNU     WUGBQYXUA       CGXWMDSEEEEUNAA ESFLD           TDNJMC         
LQJSD           : OLRLGESY        EJENFJCSYEIMK   FSAGYE          MJAV           
OJWDWEYKUNVMY   : VRBDODJCILFUHLG PPHH            KXOKVJT         IXFB           
TTDRINJXU       : TFXGSXCTU       VDWE            VHMK            CRXLJLUNPR      UCTDGKYJEHKVMYR AYYNRIVNVWTAPL  FOXNXQODLYVT   
RGWBBALQ        : YETRE           KFQCDUBCSI      THKGIRSUPAXWE   XTLJQFH        
JTLPSVKIRXIVTCC : UQSOOJKGMJLY    YGWYDGPEIIPXO  
KRWLM           : HCEUFQIRQOOJYB  KSBMPTBPY      
DVBEWBSNP       : MMTHWFYQMA      RPUVFSBFKTK    
JBTCYELQEVP     : JUJXFF          LVANVCQT        VTQJAAHHLPUM    UEFEOQ          THAQMXHVAXBBAHW
ARLN            : IBCD            ELYTTXSPGR     
JYYO            : GDJXJKAIFPEX    VDWE            NJHHQGCHXRVAU   XWBMXIATTFEJK   QYTUUNNHKM     
WPITT           : KAMNTFCKEFSY    VIXQD           DGAPEXAPVMKV    DGWQKUTU       
KLHTNBWMIK      : PTOGPWAKXUWNAT  OVURGTKDVVAN   
OIVPIPDVBOWC    : GKASUINA        LQXOYRSVUYATCHP GRGONXWXCKOPD   VYEW           
BYTK            : SOMORBAYFSYRQTL ALODIYHWNPFOI  
PPECXXRBW       : TQOO            DRGEMBNRYFU     JJISTNS         GHYXKNQUQUNKK   JGCVSPJJQ      
LJMBRI          : EEDLHCYMS       KSXRYKPXKLET    JOAJTVNPKIMD   
DAVYC           : QFSRILLNHUD     TIKUL           SCOSWO          MXEYKASK        FAMJYWJRKWA     UCTDGKYJEHKVMYR IHOAXEPJXT     
YEPAELMAC       : VCKH            WTDDGGWHBMGXF   HKMWFAJKPQIQ   
GGDGXEGCQPRT    : YQLDQWUXXXL     PTOGPWAKXUWNAT  LDEQFQI         FNRCVKMROB      NPGNATJF        QOONCEK        
CMNDI           : JKVXBHKIUW      YMCD            SCOSWO          FMVSDY          LVQLULG        
HTNLLQRAD       : HTFYMQGCPE      HCNTVBNOUF      DGSCEKTAWY     
CIAKLHIQ        : STXCGF          TMHP            WVHPXJTX        KSBMPTBPY      
MHFE            : EUPNMWJF        KLUTYVMW       
RHPHKXYTUOFIFAI : HVIS            LMWBUWHDNYDHAJ  XTPFSIMYKI      TLTDNS         
VMRWWEGFWVSGDYJ : HIIOLKAMUVO     PODWFQQJBS      SQGWEMQPTRB     YQNBTIPOVT      XOQEVCLFNMO     RHWJXLTNU      
GYFSYEMTTUFYWN  : IOKAEJLKAYWQEG  EXCUFDLYH       BHQEUDFEXDETPI  EEPUYYEA        YTCHMQNSF       HKMWFAJKPQIQ    RHWJXLTNU      
SBFRALAGI       : XTGMNKGVL       CIFAVKPIESS     RIGGOBVBTK      XPNL            YWJPYU          XRJA            HKNUROP        
BQEA            : NKRPET          ALNLBFDDATV     ABJOTLKELO      MDPDWK         
CHBHCAOPWIMC    : QTCCRMC         VLMQSCSJJSM     UWSXVPPINLI     HFLYGDCTT       LDAFHLAM        RRFCXVWCTGUYWI 
JRWEUCWVPW      : OTAGMMYMQHRK    IXUVQYOHJDWFSWF
AXDQCDSEMTN     : EPAPUNVJVB      WSKWYRDIFKJRNI  TNDNNELVVOQV    STMIADNBI      
VCHUMVYWFR      : EGXUG           KOWVNUBGJPWBR   PRIUJBGKRFVD   
JMAIIPIMP       : MYSWLAAM        XEWNEPMB        FIXLTHLJPDVF   
PIIV            : MFJAWJNDALBB    LMJFUPSP        HCGKQWNBGQSTH   VSIYLJUHM       WPVDUVVAXJEOUEJ
MKWAAUFJQRFRQM  : JMUMMIQPE       LDEQFQI         GCRB            CCCKTJCGJR      KMCYVTLIWRA    
MYYMHJEPWT      : EASUN           KNVJX           KDDHPURHLHEPCRA FOXNXQODLYVT   
OCGMFSXEVAAB    : VEFDWKFLPX      WEVNFGJUKUF     ITCISSGNUXIPB  
SURKMHUBGVQ     : RFKNOUX         COXTXPDUSON     JIQNMF          TNDIOH          GYRJXHUQX       IPPPWERLIWS    
FUGEPETTL       : HLYFDYD         FKOJVVFLSBAE    IUYC           
CGGGEHGHTYD     : NWGDF           FOREDISH        OLHOJ           OGGXRBSYUVU    
KRUHSB          : VOOGPSYEQECJQBN HPSX            FSHHNOTDK       FWFEJ           BQVBBAGGKESBE  
JRKH            : FPDY            YWTDCY         
PYELSPRWY       : HSVDPCRDYGFRNAD YFPXOFBOTERLKFY CGNWJ           SFEE            AOSA            KXOKVJT         XTGKWWHLWKL    
EDIMLCMQPYINI   : XDIHAORFMV      BNXNPFBUFIV     NLTDNMIXFJNUF  
ONPGXWGPVLBQDVO : TMLWTBWKKUEJQ   PAFUASCUYQLCXBE FXSSLPO         CRIBQDMV        USHVOESESA     
WUIFHV          : DCPEL           PAHLCL          DGSCEKTAWY     
VMBUWOFAESRMT   : KWMBL           XAADIRTX        QGMFMD          WEVNFGJUKUF     BGFDILSRDKXLID  KUYTLGYCXJ      HWOQVVIPI       GLYHAE         
VMBUWOFAESRMT   : CRORG          
TLKFNEILSNINVNW : CLWQP           TLCSRBSWHKCQVTO
YTGAQDPWFVRXILO : VOOUYLKWWN      MYBSKOYVJ       MGGAQPIYEBDAYFB ALVCWJVKLOELW  
XCLNGWYBK       : XAADIRTX        FNFBJSBTEWIRJO  OVURGTKDVVAN    YOMPRIOFKUFW    LDWLKHYOCKI    
OIWNCX          : FQIISGEPLIE     LFSARJIYUIV     UAYHIM         
KXBP            : CJAXB           OCTYSFF         OEVFPCMELUTY    RXCEKYGJMVH    
XULRUWGKDGMPT   : CLWQP           BRIQNPQJLBCPOEG
MUVWEMHBAJYITY  : JTPMOMK         YQNBTIPOVT      KXURYV          MPCGTLAV        CEBPNQWFRFIFI  
JPJGDBECHQG     : AFHLJGXFNOH     ALGTISYTXT      GOEKDXNP        AHHKOUB         SJUHKK         
FVJAIE          : MTINBMLMXFURI   SSYXQUEDWTXVMOI GIEWNHEALWYO   
HIIOLKAMUVO     : VMRWWEGFWVSGDYJ WSKWYRDIFKJRNI  BHQEUDFEXDETPI  HGTCXWMXIQKMEO  IMKUKSKRVB      RFPBQASMLD     
HGPPLTTQDKWTPU  : CORINB          XDEVKMCIURPEPS  GNBWAADYRKEV   
RFKNOUX         : SURKMHUBGVQ     EBYJOMNCKM      DCLPBSREBJWN    RJFSMMV         KRQFEXUKQS      UCVITXCP       
JJFXEDOLKUDAH   : MYBJS           EVHSLKN         OSRCBFVQASXVTD  IWKLARUIJO     
WADHWWATCRBOI   : WNFI            GNAWHHG         XYGMSRXBXGRL    CKXNR          
MGUX            : FWCTXBC         XBFBNTNPMOQIEP  XMENR           LWGGOUHKHVGST   PGQBQHHUAEBQ   
CVWFLK          : GYRJXHUQX       FLVGTC          GACMVGFSG      
INTR            : LOBFMAKMKRGONR  XFKCB           YVSIBNEHTRC    
QRQYQPBKTUNJ    : XIBAMDBTXPNWTI  OQQYWJDVRHB     GTQS           
DXKAV           : AMQNAUQ         GCWCPFDIHK      DPOQFFWOTIPGH   HBQDU           FAQREPPBHSRN    HKMWFAJKPQIQ   
ERBLFNDQE       : AJMHPLK         ATLCMSQD        DLCSLAJIROQ     KNQRGPQPWP     
IRQDKRTASHVOUFR : FPGTEHJRXVND    XOFFEKGKOFKBAQ 
DEBYLGTORBDX    : XJRHGS          AJQL            QWJPH           NGTNHHPLF       WQKUMTUSUPJQ    FLRAPROXLIBATPE JGMWRVKWAUCOUQ 
HVDBOILHCNAJ    : NHHRPYWNT       SOLCEI          FUKLDFNP        TYGQNRV         CXYKO           DYKOFLFTRB      VTTLIUUO       
QFRLGWRJYDPUSIV : EWGDBQ          WUGBQYXUA       CHSVSJJBBC      HHAGWFWYG      
GSFEVGS         : AYRHO           AFAGQGY        
RAIHDUSVCKH     : OMCJBLAGTESEDPY RPDDEQY         KNVJX           NPONBMLBOKQDBE 
IARHFKEXS       : NHGFWFGGXDER    WVHFBMFFIENELVV BJFFEUMFJCCJS  
VBUBHQ          : LRCSUPCQJLLFLDY FHTPGFDJLHPKM   NUYGJQHDBBY    
AWBDIKIDEEFOO   : FGFQQCQLPXGFWF  UEFEOQ          TJOVLV          BQVBBAGGKESBE  
YOJI            : PTRSDRTEHP      YWJPYU          ALBWITPQTHYJ    QFGLDEWJMDI     TFOKQODVODLGK   QBAQ           
TMUOP           : XNNBWX          SWTLDGJHM       MEPFKSOMKYO     CUVCBPX         XYUGXMNLKU     
RKUYECC         : HTFYMQGCPE      SVMTHIV         VHJGDMPVS       OIBWMADSEDFFE   JIYSYHYWNCUG    RKUVSDXRPLIK   
GHLQRQ          : KGFPJGMORV      YECIPVNAMB      BIVGSWC        
VVMKNNBXWXT     : IWOBMQOHXFK     KSBMPTBPY       TBDHGSBQFSKPSJP
SLBL            : WSKWYRDIFKJRNI  XJQGABNTNN      HQDBDINR        LQREMBOUCPVVLKN QFDUTKKFFJKKCDU
OGHSLJXRSKKKD   : EKAV            QSPBBDEVVIUBG   XEWNEPMB        QEJSPTIDBBTNT  
IAWTPMWPJUKXPX  : OABQRDVIPBFV    XQURDFWKQHVU   
EDPKKKVVJPQ     : EGTPPYDMGCIH    XRJA            DQSUNHL        
DBYNKBMGRYDH    : IMVOPAMHE       THKFBNX         OPHAENN         FBGJSBQNACAP    ORXD            MXWA           
BTJSRKW         : BEBGSSA         CWIBMAVIRCARES  NNMWX          
DKKNIHYBXWE     : QAKPUPNMDIKRAQK KFIVRH         
YTOAGUT         : KIOAVXBYKRJS    TKVE            TSYSDYVMOE      FLKISPAL       
AEQD            : IBCD            AHTECQS         PHWCOCCL        XNOLQJFQ        DUOPIGXAS      
CWSNV           : HRNWOOHI        OHLBQGUGADY     WOPE           
QGDGRMI         : CECYTILARWDCFRP YHYANRNFQMSH    JXCAOWYJEFK    
NHWRGSGJYD      : GXXTBLMNKVVW    PVWVEKORSMQD    QTFMOYXYWUQIGN  IUEXNF          UNXTSVJD       
GDJXJKAIFPEX    : JYYO            GIWVBXJUVACYP   WACUNFST       
NDRFS           : EDUPHMMHSRUAECU RAFKKGNRSTISNRO
XGJWAQPGCQJH    : ROVSNSCYPCNEBQR EGKMYFUDFEOQ   
ORWXEXIJPNHYDMQ : TNDNNELVVOQV    CPYQDRRRSJNREO  NTUQKKHJPCO    
FSINCHNU        : KXLRMVCB        GYXTCXPNISV     SWJAHDNDEQWKS  
VYPHHMYBKY      : YVLV            BWSDU           TQRGASYJNTP     YJFPDR         
KIOAVXBYKRJS    : YTOAGUT         BPNSA           OEMLQV          VJYRGYOIVPDFXHN
TGRBUOA         : GUQNIULSRUPCWH  VREEN           OPHAENN        
ORBXGAYS        : SOHQDIBJIYWT    UEWEBHKF        PVWVEKORSMQD    FSCXSOKUVKF     HFOQ           
GDHWGF          : KYBGETQXLFNWGQN
HGHCRAQLJKOGAQY : KNVJEHOFWGO     OYTF            YPBCQLKHIGM    
IAORCNKE        : WWVEHKFMFKTLBL 
QLSW            : KABVCX          TIJRAIMBJCRM    QOCAEYJSJVTLEJS VVOANOABDYCXVME
NGAWKSAE        : WCYUESU         WXHBIFUUAAFPSP  OQBYPLQPEPLUP   FSYG            EFEKYBCWG      
JOVPQO          : DLOJF           DCVHXDUBGDBYRQ  PTAJMXAMXW     
HXRVPTJCXFSMX   : BMGGPORJS       SENPOSBMFR      QOCAEYJSJVTLEJS YMTCOHUGL       UFYJEYMOTEBASWQ
GNBILL          : WSNKFOFCSYICC   XKYHAUKTEYI     MTWO           
NRKWHIM         : VUFJWIOGI       SFHLSJOAOSA     NUFQSEYMJIDBQL  MCHU            NNFW           
WDIWUEORQRRV    : KSCXQODL        VBLRSYOTF       DTXKCGAJ        NYJKD          
GWFO            : YHYANRNFQMSH    YYGET           PBOMXPNOMTFVLD  OPPLXTUSPFX     KGMMLOUR       
GXXTBLMNKVVW    : NHWRGSGJYD      DPOQFFWOTIPGH   LRJUVKNXFMDG   
TDESAJ          : XVLMJHVHCI      KBSPFPSGEAII    QPTUW           PTGPVBHF        PBVH            KAPBOBMRSW      BNXCXANDE      
RACMVOSUTIICIG  : KQGGLSYRRLAF    LDIMJBSMIBQBFF  VTTLIUUO        LUSULEMRGDWJ    LUGIYRFRMQX     WVGIL          
JUJXFF          : JBTCYELQEVP     GNYBBVA         KFQCDUBCSI      YBKVYUOY        QYNLAKYDJNOAR   FQIPMMLH       
FBRKGLKRVDRXRP  : SBRIMISBH       DRGEMBNRYFU     ALWG            PFCMHT          ARCBMWAIYYQU   
KLLUVNFC        : MYSWLAAM       
RYTRHB          : KKMRUGRKJXK     KSXRYKPXKLET    CESJNPIBNDDR    LTYDSGY        
OFGYNTJFROYR    : EXCUFDLYH       CJMHDAA         NNSMJPDKX      
OGTCRQ          : CRWCCXBXRJGERJ  VEFDWKFLPX      JIQNMF          GSGX            IGYQO           LTMBMVHFX      
GWDSQEP         : UGHRAGQFQA      IAUWC           JXVHSDNNPANKE   VTKDU           RCFW           
NQVCXEDLAPSR    : UNQCF           TXNDTOQ         BQIYTARC       
RJNJSJNMCO      : CJAXB           BCJECHRHLRIGGCE DFVYRNRHHIO    
YTOPAEAOWWSVDY  : PFTMKPJDIXNBMX  BFTY            QFMOHCMLS       DFSEOYJ         QWCQBTNTPA      GTMDDPVRGB     
GOFXUYKIK       : HXFXJGOTCKPR    QFMOHCMLS       DIFETWVYDGEOJPB TXUDJUYKEXIS   
TYRWPP          : PQSJPPR         DQSI            OTSURPA        
LEOLKQCHP       : OXSPFVFFPUAQ    KWMBL           UHAKPYQHJYT     HQCEXHIEWFNHJWC PBVH            TJOVLV          PTVYDOG         AYYNRIVNVWTAPL 
FTWRCLWCIVORHT  : XNNBWX          CJKTXSL         XMENR          
IOKAEJLKAYWQEG  : GYFSYEMTTUFYWN  AJIMXCCCGG      NGTNHHPLF       AJTTEORIA      
CODBG           : KVTBXOQNSIBLSB  VXNAJBFEJRMRNIO AHHKOUB         AJTTEORIA      
OFHWD           : LBHEMKXYJVKGJYJ QKPVN           AILVEVLJ       
QMSFUHPWNYIAY   : VVKBTSAV        LNRFXGPSIXQIHVC UYSHL           DGINPVKOGPFSKPN
WQOEASSDTB      : EGKMYFUDFEOQ    IWOCUMB         NCCGOVGHDXJRRJ  BLACUUUCAORX    WXHBIFUUAAFPSP  EFHIRKDSDSHH   
IGRFJO          : QGMFMD          MPLTBB          IUEXNF          HBQDU           RCFW           
YKETR           : TITCKUOINDONXJ  EQWFX           BMGGPORJS       VRBDODJCILFUHLG SDTNICQ        
TITCKUOINDONXJ  : YKETR           GTUNRGIBNXAAIF  SMRI            YDYVKDEXB      
RKDCSVKEMJDW    : ESEWVGY         XRJA            DGMVOOPCOV     
ARJTCF          : BRMFJUWPLVPFE   FGDEFXPTP      
MBNUQSLFR       : OPPLXTUSPFX     TQTMSNLXFQLRUS  VDNQOQFPKLJCJJ 
XLHEOAABFO      : JATPMBCN        QFDUTKKFFJKKCDU
IMAKGJEIPDUSS   : XBFBNTNPMOQIEP  IWOCUMB         OAVKUPABBPWF    IVHNAISOFW      EODMBTCT       
JLEQFCRTJV      : MAIUTOPGWGQK    SFEE            DHJIPRSEA       WARIRI         
KXLRMVCB        : FSINCHNU        LBHEMKXYJVKGJYJ ITAV            WXHBIFUUAAFPSP  NLTDNMIXFJNUF   KLNHMLRGPJ     
NHHRPYWNT       : HVDBOILHCNAJ    XHPES           PDLRUSH         KSTQGLQAGQVSTCE FKYLFMPREXOOJPY DCXC            UEFEOQ         
GGEMWLOOFYMPLK  : JMUMMIQPE       WDGMIWU         LRCSUPCQJLLFLDY UFVIBNVUSWGY    GMQTJXQANOTUCIN
DAYFBWSJ        : XNWQTRGI        UFNK            JCYPRIFUMFYXOGY
NBIMODDW        : AFAGQGY         GHMXYN          HSGENRPQKYYHQJM PNLMFAS         CKXNR          
JKGUBX          : KUWA            ILCYRO         
AMQNAUQ         : DXKAV           MKUXOSTAYR      KCGCCJQITIVWSKK NUYWPMV        
TYDRRMBHQJUHMA  : UQSOOJKGMJLY    TGDPSMSJKPH     PTGPVBHF        RRFCXVWCTGUYWI  HXVQIINNKYAB   
XJRHGS          : DEBYLGTORBDX    SAARUIPEOXOGY   XICWEGEXJ       PIJTFJOLDAGM    GIEWNHEALWYO    GWLYJQRJLBGPSX 
HVTBJTVDVPC     : NKFCRLTO        NFCVQVYA        TXFBYDCE       
JVOKEFUYP       : SHMYDDYSDUPM    LWGGOUHKHVGST   PIUE            SDCYQWABMBOVN  
BUIKOPQJWBFSC   : LVHXUKFNOWD     URLLTF          DKNIUWHG        HWOQVVIPI       IXFB            THMBWUMIO      
PAULPYNCUD      : HSWXIQX         RHWJXLTNU      
YKJA            : FKERPNYUJY     
VDWE            : TTDRINJXU       JYYO            SLCWIO          CKLVLP          RSPRNF         
LVHXUKFNOWD     : BUIKOPQJWBFSC   EOLAKPVIDBF     LVANVCQT        CHJAPGKHRVUAO   RPMOXXDEO       CRORG           CESJNPIBNDDR   
TRGSFIQKX       : VAFW            SKDCXHAHSTWDYT  HPSX            OAOOWVGF        KSCXQODL        SRFPXBHV        PHWCOCCL       
VJSV            : OMCJBLAGTESEDPY KUTYN           ICAVMIUKBWDXHQ 
XVLMJHVHCI      : TDESAJ          UMWQQXF         EGSNLHTUYLBWSLE FVSOQRYXRJSTO   DFEXTQBOBOKOBH  DHJDPWBTBIGUH  
SWKXNHPT        : VCEYMRLFNT      YREUFAXFMT      KNCUJUENUOKTROD
XFSIFNGOIF      : QLDFXQRISMIH   
GBISKQQSUYGN    : EJENFJCSYEIMK   DMFBHHMTFODOQIW RGHSLGCT        YNDQPFK        
SOLCEI          : HVDBOILHCNAJ    TKEJDHL         LNQGOKHHXBDUN  
EPAPUNVJVB      : AXDQCDSEMTN     MWFOOGGSBXMTH   XITFGPRTRHVB   
DEPXPIR         : VJYRGYOIVPDFXHN LPDVSDMAPTYSO   AYYNRIVNVWTAPL 
DSSTR           : XPFMCPTW        OEMLQV          VNFYEIO        
IFOOPVVFVLCMJMK : HRTYUMNDU       DIFETWVYDGEOJPB OPPLXTUSPFX     QYTUUNNHKM     
UNRMOHU         : BHAGY           QALVXFMHPYLVAQP NFWFYQHAFDCVLYC FJDK            IRKAYRA        
TBBMWUYHBPXS    : WTECVPIHHTISPW  GPWRMRSRLOUI    BNBGKAA        
TYLHDX          : GJEEKFCYDXQKV   MNKBQYBUOYQC   
PJFNYWAN        : POXVADBLIFMODEB RPMOXXDEO       WJAUGKNA        GQWJCVPWSRRP    HNHKJ           UCWSOEJLKSM    
XVYB            : EDUPHMMHSRUAECU GXHQNGLR        VDWXBGCJBCMD    ALUCSTNIKNPVVBC LWLQRMICDGV     ALODIYHWNPFOI  
OXSPFVFFPUAQ    : LEOLKQCHP       MUDJPS          VCLCGAPSR       BYFUYJKTMPCEC   UCWSOEJLKSM    
HTFYMQGCPE      : HTNLLQRAD       RKUYECC         FBGJSBQNACAP    OISLWARKMCXKLXW
GJEEKFCYDXQKV   : TYLHDX          CRACOJ          MEPFKSOMKYO     GUWFQTRSTGI     FCBSVEEM        AWVSH           DANESDFUFWS    
QNSSGACDFEPXK   : LPUFMAHDCMRINN  MXEYKASK        BHAGY           PCXLRSOXDEW     XOFFEKGKOFKBAQ 
POXVADBLIFMODEB : PJFNYWAN        EOLAKPVIDBF     FOREDISH        YMTCOHUGL       AHHKOUB        
CTPVMWXPA       : NUYWPMV         UBQAMXL         EMVE           
TRDELSVLPVOSJAX : DCQDBN          HFWHU          
QEDTGHOXFBU     : BMKNF           NGMGGVKCOIW     HNHKJ           MHGBB           UJNVRVWUIUDNNLA
SWIO            : JYGQBXYLHSKNY   FGQEEQ          SVLPYJLC       
NVCHROYNFRXHRW  : YQLDQWUXXXL     HHYCBQE         CKNMSH          IITOO          
XCUGJJFRMCWIAG  : DCOCCOEYVPIDJXF WSNKFOFCSYICC   XOEDYMW         FGDEFXPTP       YNDQPFK        
QTUVDOMCDT      : OXTITIIDTWNQMAT UYSHL           BXDALTO        
DCOCCOEYVPIDJXF : XCUGJJFRMCWIAG  TRKBYADJ        FAAJTELXJNOIICO MIOGUOU         YTEB           
GHNFBJDWN       : ROKOJFXUHF      LRJUVKNXFMDG    XUDCUQXWOJUBXLG
LPUFMAHDCMRINN  : QNSSGACDFEPXK   XOQEVCLFNMO     FNFBJSBTEWIRJO 
WSKWYRDIFKJRNI  : AXDQCDSEMTN     HIIOLKAMUVO     SLBL            VXGLOSHRERNCVV  XJJUUSPFDHA     XVXWOCJHLSDQEJT FIXLTHLJPDVF   
GTWDCLGJOKXJTMY : INWWLSJENILISFH RUBIO           DSGQDCYXCT      HROYBNLVPY     
LSFITXNCFAOWOY  : UKHHIVEVPTAST   AJIMXCCCGG     
WTECVPIHHTISPW  : TBBMWUYHBPXS    NNAFLIIDOWQAVI  PVGLIKBCFPFCG   LRJUVKNXFMDG    XGQX           
KKMRUGRKJXK     : RYTRHB          EDUPHMMHSRUAECU EJVGYUTJQTJMF  
WBYEAUI         : OECCXPCRUYHWOE 
SALDJFLCWK      : DNYXRWBYOPBVKI  JQRHSFRXYWF     NNAFLIIDOWQAVI  NNFW            IKGJHYRIMV     
HUJA            : BHDMOTDJY       TEVXOJQL       
QTCCRMC         : CHBHCAOPWIMC    MFJAWJNDALBB    ALWG            UNONOCDGKAQ    
QBVQWGTR        : XVPQNJAPXTK     NHHGYDNI       
GUQNIULSRUPCWH  : TGRBUOA         EDNBRTUCFAB     TRKBYADJ        BDGWWDI        
RJWLYY          : EGKMYFUDFEOQ    SREBWPGLRYYT   
PCBIBJDTSLOL    : MFJAWJNDALBB    JDSCGVFQMAO     UHHOCIT         ORDGKPDPDNHLS   JFNDPTHKQTKXWXC
XGOSYKJDJQX     : IMVOPAMHE       FWFEJ           SBYCXGESCPLVA   HOHURREYGP      SEHJSR          TFAIERWLFYGEDLO TQDKGOKMXFBXGRL
DUPCTUTV        : OXJSWF          WXTAVBRJG       ESJMSRXGMEVAJN 
CXIHTBSIOUIVL   : IWNK            SBRIMISBH       SBYCXGESCPLVA   CVQJGFSFE       QGLNIGXTSIRJU  
WXLAIEXNHU      : TJSWSDD         NTLASRAFWQ     
LOBFMAKMKRGONR  : INTR            KBSPFPSGEAII    RIHAUIPJ        MPCGTLAV        MJWI            OGGXRBSYUVU    
KABVCX          : QLSW            IYQJDMDXFBHGCD  SWTLDGJHM       RNWY           
PAFUASCUYQLCXBE : ONPGXWGPVLBQDVO OJOHJUJ         WPWAIGBBPFN     BYFUYJKTMPCEC   IJXJ            NGMGGVKCOIW    
PODWFQQJBS      : VMRWWEGFWVSGDYJ GTKVVF          XSVGGVJRB       SHMYDDYSDUPM    MYSWLAAM        QUQVMQGWKWKJMV  XUJADKJIJQO     QFGLDEWJMDI    
YVLV            : VYPHHMYBKY      GFDFTDBHFGGKG   VYFDBCLOACCVPLU JBFQRKEMP      
LBIOWLJVCVX     : AFAGQGY         DLOJF           DLCSLAJIROQ    
WELMS           : XBFBNTNPMOQIEP 
LBHEMKXYJVKGJYJ : OFHWD           KXLRMVCB        VYODDNPTS       YEFCMIDNCWKC   
NGGYEKUEMTIA    : IWNK            GKJVM          
EQWFX           : YKETR           IJGFE           YECIPVNAMB     
RKCQUAEDLFMGUVM : GTKVVF          SPTXQLCCG       YBKPPNCDPROIWP  FAWEGVYLVTCCDN 
AYRHO           : GSFEVGS         VXGLOSHRERNCVV  JTRKTHEDJSRBYIL XVLTGGXBO       RRFCXVWCTGUYWI 
POYVGY          : NCCGOVGHDXJRRJ  HFOQ            PJNM           
EDUPHMMHSRUAECU : NDRFS           XVYB            KKMRUGRKJXK     BTEACRQ         EVHSLKN         FGFQQCQLPXGFWF  XQURDFWKQHVU    SRVY           
QODQI           : JEPLNLVHLHKP    YSUVUAYGV      
FWCTXBC         : MGUX            JIPA            CGNWJ           GBVNXS          QGYRIN          LDWLKHYOCKI    
CJAXB           : KXBP            RJNJSJNMCO      PBVH            TDTPPPTJKGYY    RWWFVMIJE      
MNQHFMHLQCO     : EVHSLKN         CXYKO           RACEXSXCPREXAIA QGWBEOSYLLYK    EMTOUJ         
STXCGF          : CIAKLHIQ        SCQQFTBXLBUCR   TUOUBVQRUBF    
KCYLEWQNYOOH    : FJWACCAHUMRXES  PSHHRIIHAKD     EVPQONEFOATECAY DLVCR           FJHNTUFQFU      BUQDGJEYJEF    
EAKJORXFVONOI   : HWIUK           BCAKMFMAFVOMY   HJJRVJKW       
SOTVBV          : BFTY            QYDGFTF        
NCWGQV          : OARTEPX         TKVE            HFWHU           WTOBEKUFPP     
HFAMGKXUEXDCMQS : NULMVXIHUJ     
EOLAKPVIDBF     : LVHXUKFNOWD     POXVADBLIFMODEB XUEVJIMXLB      KBYLXECWQKEWTGF WKNOUBQITD      MNHUMEFL       
TEGBJIPPUONY    : IKGJHYRIMV      SRVY            LQHHUNBEDSP    
QDCJVWNKLO      : XSVGGVJRB       RXCEKYGJMVH    
BMGGPORJS       : HXRVPTJCXFSMX   YKETR           OQBIHD          LBKON           CVQJGFSFE       GNAWHHG         GXPLXJURH      
LCIDU           : KVTBXOQNSIBLSB  WITDGQQGHGYIWTM HKMWFAJKPQIQ    IWOJ            HUHSYCMBUK     
TKEJDHL         : SOLCEI          ESKOWRWSAANOBD  FTUSGOEMOXL     CKXNR           YUVODOEPABXN   
FKCQVS          : AOKBGXFNHLQ     SFEE            JLNWVPPVM      
YIWFXL          : EUPNMWJF        DPITVMJVCTPPHFV IJGFE          
IGYVLJYIOV      : KKFQE           EGSNLHTUYLBWSLE VIHSUPB        
SFXCQMIDOBAKR   : HQDBVDIOVS      BWSDU           EQSM            NLTDNMIXFJNUF   FIUMISYF        JYQI            RXEND          
SOHQDIBJIYWT    : ORBXGAYS        KSXRYKPXKLET    URLLTF          XAHCH           PJNM            FPGCYCSSGUWNIYY SEHJSR         
FJWACCAHUMRXES  : KCYLEWQNYOOH    WEDPEN          LQXOYRSVUYATCHP QTXSXUWGVUOMXG  MCHU            OMEWLRYULQH    
OMCJBLAGTESEDPY : RAIHDUSVCKH     VJSV            AILVEVLJ       
XIBAMDBTXPNWTI  : QRQYQPBKTUNJ    DSYRLKIEU       TNDNNELVVOQV    CEJO            AQFAACV         NSOQAALSCLJW    ANHYRCVNBAFKLD 
KUBTWMWFHBXLEO  : NOFHNR          HQJTFIGDO       IUWUILHFRU     
JMUMMIQPE       : MKWAAUFJQRFRQM  GGEMWLOOFYMPLK  PSHHRIIHAKD     VTWMFJDUD       FSHHNOTDK       GHBAHEPCK       POVYWBNUCAD     DIXYSJMOTJOOK  
JMUMMIQPE       : THAQMXHVAXBBAHW
GUPADNNYQH      : MONRLGESFXY     NUWQQVWVCHQDU   YWJPYU          JFHPD          
EEDLHCYMS       : LJMBRI          OOHDPPHNTGURD   TRKBYADJ        NPONBMLBOKQDBE  GXFNPANWB      
XFHKTRDMYUS     : MMKAOPTQKU      CCMD           
KUWA            : JKGUBX          NMEYW           KRLLLIPQARSY    IJENML          HTDJGDUAV       PHNQIYF        
XRSVXYCLHEKVW   : KSXRYKPXKLET    JXVHSDNNPANKE   CJMHDAA        
VEHIABMOAHHV    : UFVIBNVUSWGY    KGMMLOUR       
FTUPROIQ        : BEJALAKGJBBJ    VIEDNXGVLSIGN   GXAKR          
KSXRYKPXKLET    : LJMBRI          RYTRHB          SOHQDIBJIYWT    XRSVXYCLHEKVW   VIXFADITUWYHNL  NNMWX           FIUMISYF       
GUGV            : GFDFTDBHFGGKG   FTUSGOEMOXL     SEHJSR          YSUVUAYGV      
PFTMKPJDIXNBMX  : YTOPAEAOWWSVDY  NLSLPENGPCGQPJ  JXCHHCFGCGNS    BSBSPNBVIGLF   
MPUW            : LWKOEIFRIVVW    XXEWYRFFC       TEOVSCOABO      FKJQAYTRDF      BLRATYNTSBTVV  
SJSYD           : LFLS            XVNDLMQKFXTYDXP PFDJADIKLWNK    IOJK           
FBVBYMJUBVLKY   : ECHF            HJCKHMKG        FNFBJSBTEWIRJO  DHJIPRSEA       HKMWFAJKPQIQ   
INWWLSJENILISFH : GTWDCLGJOKXJTMY QPTUW           GHOROVXGRIJG    CEJO            VTTLIUUO        IPMEGMQHTFR    
UMWQQXF         : XVLMJHVHCI      CQKKCYCUEHBV    OAOOWVGF        CRIBQDMV        FMRGGA          GSAOODFTVRMP   
TGVHQ           : EDNBRTUCFAB     ALODIYHWNPFOI   UNONOCDGKAQ    
DBLCAYULF       : FKERPNYUJY      GQPEI           ALWG            KDERRNMLITPI   
UTSNYCL         : OQQYWJDVRHB     LYQIVTVMPJXV    VTKDU           GDFXHLKK       
OJOHJUJ         : PAFUASCUYQLCXBE ERAENVJMDKMSCAB YJHDTDTRVDIQEHR TBDHGSBQFSKPSJP VIHSUPB        
DGMWERARTBQ     : CPXVPRV        
MYBJS           : JJFXEDOLKUDAH   CGNWJ           OKGOIURXVULPI   LRJUVKNXFMDG   
WTVJP           : XOEDYMW         QOCAEYJSJVTLEJS SOEPTHBAW       DQSI            EITXFKM        
UEWEBHKF        : ORBXGAYS        TIJRAIMBJCRM    BDGWWDI         OHCQDYCFVI     
YETRE           : RGWBBALQ        EJENFJCSYEIMK   AYNRPTOCARSVK   GDFXHLKK        DQSUNHL        
NHGFWFGGXDER    : IARHFKEXS       VVKBTSAV        BYVVQ           SIHOWRAEWK      TTJISMRHXBGLY   HXVQIINNKYAB   
NJOKOMORVBWLD   : VCLCGAPSR       NUYWPMV         FWPAYXITRGK    
HWIUK           : EAKJORXFVONOI   MYSWLAAM        CKFOWOLXMDYH   
BPMJWTJAA       : YASXK           KNKUIOFEXQHGBUU
BPNSA           : KIOAVXBYKRJS    HNHKJ           IKGJHYRIMV     
HQWD            : XUYAJTEL        JCEORBKF        HBQDU          
VOXAXWISHAVXNH  : FABHRPMQYFCL    XKTOEPWX       
JRYJVA          : HJQAB           ABJBT           AAUECBP        
JUBQCTNF        : SVMTHIV         ARCBMWAIYYQU   
JVOLTLTOVUNVK   : RMMORRUK        OFLPOFLUVFEVT  
SVMTHIV         : RKUYECC         JUBQCTNF        FKJQAYTRDF     
URLLTF          : BUIKOPQJWBFSC   SOHQDIBJIYWT    AQFAACV         VCLCGAPSR       FPGCYCSSGUWNIYY AILVEVLJ       
CWKANWWCSLXP    : PECFCHSUVMAOW   HKMWFAJKPQIQ   
TCWOXJIFU       : GYRJXHUQX       LJTOUEAKSW     
PPXD            : VYQI            XYUGXMNLKU      IJARY          
SLCWIO          : VDWE            BJJVJM          OQBIHD          GHVILDGEGVCI    PTNKFNGXYAXKH  
XNVAHIAWJV      : OECCXPCRUYHWOE  CIFFUW          XBXHMIHBJVTYDTE
GKASUINA        : OIVPIPDVBOWC    ABVVFSOSKBCRKX  XOPQYTUSGUUDW   DPCAS           PPRSKXX         MYBSKOYVJ       XNOLQJFQ       
DAEGSPKRAY      : PYVTW           JBQDRBSCJQY     IUYC           
XNNBWX          : TMUOP           FTWRCLWCIVORHT 
VIAXQKBJGJYIJCI : NGPLY           IQARVTHIRHVQ    XARBAJ         
KEDUXFWPEM      : JHSIIRU         CXYKO           NCCGOVGHDXJRRJ  FLKISPAL        TLTDNS         
HJCKHMKG        : FBVBYMJUBVLKY   APOKUEVA        PTTWUFSCKIUWDGH XYUGXMNLKU      MQVKFUNGACHV   
XHPES           : NHHRPYWNT       ICLLMESSOUATALK ETWBBOT         OHLBQGUGADY     FQVIUY          IEATSIOFIOW     HKNUROP        
OCTYSFF         : KXBP            EXYSUECMWEL     KQGGLSYRRLAF    HGTCXWMXIQKMEO  PQFXWXDR        PTAJMXAMXW     
CECYTILARWDCFRP : QGDGRMI         EUPNMWJF        AKTBYQQYSG      TQDKGOKMXFBXGRL
XNWQTRGI        : DAYFBWSJ        TSRPEIPUE       FLAWLUDXQIFN    ROLILDUGCNLAH  
AJMHPLK         : ERBLFNDQE       OEVFPCMELUTY    VTQJAAHHLPUM    TXNDTOQ         NUWQQVWVCHQDU   QRTHHMPFTP     
PLNAAQRWVV      : UQSOOJKGMJLY    BFTY            WOYFRACNCHRMKEC ORDGKPDPDNHLS   IGYQO           AAUECBP        
NLTOY           : GQWXRIKKEPDOKX  MJKTRAKNFUPBE   XSNT            EKVQMUFHOQKP    AAUECBP         QORLT           HXVQIINNKYAB   
FUKLDFNP        : HVDBOILHCNAJ    ARVOAGJ         BSFBWDNUU      
XFHKYYVOY       : KLJPTGFO        MJBVSWDYLMVSWIW QFDUTKKFFJKKCDU VTPIOSFD       
HSVDPCRDYGFRNAD : GIHYMSPWOFNUMR  PYELSPRWY       RCEADL          FDVXYJC        
GKOVEMBO        : JATPMBCN        YLOMCYOKOX      USHVOESESA     
CNXSNVBIT       : ISEKGCE         VDSNMACL        OOJJUMVJKPGBQTG JGMWRVKWAUCOUQ 
XWXEVGJPTJSUR   : MJBVSWDYLMVSWIW VTPIOSFD        MXWA            NTIBWQQSIVNNXB 
MNKBQYBUOYQC    : TYLHDX          VGYCCIDTDEWCY   DHNVOINWUCM     IYDPNNBS       
RLPXLOYPMHBCE   : GXHQNGLR        CLWQP           UFVIBNVUSWGY    ORXD            THMBWUMIO       SDCYQWABMBOVN  
XBFBNTNPMOQIEP  : MGUX            IMAKGJEIPDUSS   WELMS          
IMSVESKSRCHCEKI : HPFVPINQPJWDJH 
IJYL            : SOMORBAYFSYRQTL EITXFKM         XFFPTUB        
SCPI            : ENAYOGTMCREYCDC KUHKDPVRVJL    
GQWXRIKKEPDOKX  : NLTOY           SOMORBAYFSYRQTL SSYXQUEDWTXVMOI
SAXFIRNT        : BYVVQ           FJBLYJTUP       YPBCQLKHIGM     KRPLGNVNOGCMBK  YBKPPNCDPROIWP 
BRMFJUWPLVPFE   : ARJTCF          ORPPNQWTLOT     VHKXMUYKLXJVKUB
PLUUAFS         : CRVN            LQXOYRSVUYATCHP FTUSGOEMOXL     YDYVKDEXB       ACXIIKOENSME   
AUTFFLUAF       : DIGFLEP         JDSCGVFQMAO     FKJQAYTRDF      QEEKB          
TREEMDVAAM      : PQSJPPR         DRBI            XLUMBQJRBTCMLG 
GPWRMRSRLOUI    : XTGMNKGVL       TBBMWUYHBPXS    XDEVKMCIURPEPS  WVGF            QGYRIN         
AOWVQCU         : FLAWLUDXQIFN    GUIWVSLT        JFJMLTGMBS      OHLGYQ         
VYQI            : PPXD            MQUFJWBGP       TXFBYDCE       
NKFCRLTO        : HVTBJTVDVPC     KODVCYJT        EMVE           
GHYAUN          : ECHF            TBJRLJKRLDMMNDL NERTAUF         IMHBHXEAEKD     JUOTEBBFLA      FIUMISYF       
DYVTYTKDO       : ATTEIQIQAXX     SVQHHKMFBBKOK   DFLMMURNDWEERL  XAHCH           EKTWIN          LKDRK          
APOKUEVA        : HJCKHMKG       
POAFSGOT        : QSJAVE          AJPPQAWLQ       UKMNPH         
LJCQLALK        : LWKOEIFRIVVW    MUDJPS         
XNKV            : ESJMSRXGMEVAJN 
DNYXRWBYOPBVKI  : SALDJFLCWK      SREBWPGLRYYT   
GRXPVPBW        : MXEYKASK        RAAQHLQNFHWWX   EMVE            NYJKD          
LSDCEAR         : HXMS           
PSHHRIIHAKD     : KCYLEWQNYOOH    JMUMMIQPE       ALNLBFDDATV     XYFMGRJJXTOHA   PIUE            KSBMPTBPY       HXVQIINNKYAB    LQHHUNBEDSP    
UQSOOJKGMJLY    : JTLPSVKIRXIVTCC TYDRRMBHQJUHMA  PLNAAQRWVV      LQREMBOUCPVVLKN
PDLRUSH         : NHHRPYWNT       XJCMBMENBKE     LRPCUVNAIJTLKMG RCEADL          FXSSLPO         XTLJQFH         JTEVSFPLIAU    
CQILAPNMT       : TVWMTJNS        XPTROGCYVGTGC   YBKPPNCDPROIWP 
JKVXBHKIUW      : CMNDI           UYBWSNCBP       XDCGTVQXLILBAR 
VCLYNDVIMMK     : SYSPQUIA        XQHVEQUTJQRR    BMJWQVJW        SGGTN          
VXGLOSHRERNCVV  : WSKWYRDIFKJRNI  AYRHO           FOQHBLQSJUGMCG 
EQNAMPOLFRJPHWD : FSCXSOKUVKF     HYLVYTXSLNNM    DKNIUWHG       
SDRGRMOJQ       : PVGLIKBCFPFCG   JLLSTNTU       
XUEVJIMXLB      : EOLAKPVIDBF     OLTYFSW         SCTE            DHJDPWBTBIGUH  
COXTXPDUSON     : OLRLGESY        SURKMHUBGVQ     TIVWEDADD       KXDGMGNAHHTG    MWWLNILRJXWWYF  RQKU           
IWOULBNTBKYWUJL : JTAKXMWLTOEB    GASQVBDAH       MEHIBARVMURIUH  YVTJLBESV      
WMMYDMVBDY      : CKLVLP          MUDJPS          KRMJWJJGWF      NLSJLIGGOMW     IEATSIOFIOW    
VOOUYLKWWN      : YTGAQDPWFVRXILO SBRIMISBH       HPSX            WTJV            DLCSLAJIROQ    
ROVSNSCYPCNEBQR : XGJWAQPGCQJH    XDEVKMCIURPEPS  TVWMTJNS        FAWEGVYLVTCCDN 
TWWSSNIQMVDJTQ  : COML            FJBLYJTUP       UNEXCIGWWMHGLD  LBTDKURYMNLFH   FLKISPAL        BLRATYNTSBTVV  
NFSG            : BACPIICDMICKSDH TNGOLHEB       
NKTD            : HFYUKLCRBCTQO   RASLKAVHRFQ    
HJQAB           : JRYJVA          GNYBBVA         STMIADNBI       DYKOFLFTRB     
VXMPTAAMPVP     : VXNAJBFEJRMRNIO AYNRPTOCARSVK   AAUECBP        
RGVHNQNIEBEJPNT : THAQMXHVAXBBAHW HGQDCCCSNHWF    VTKDU           DQIYTLX        
NWWJXJBTKDGCC   : ESVRUHLHOWXCJ   RHWJXLTNU      
BTEACRQ         : EDUPHMMHSRUAECU SKXCDJ          BBWNLPIBXYNG    GHMXYN          UWHOMHV        
CXUGJLTDTJB     : KAJUI           OTSURPA         YTPONM         
UYBWSNCBP       : JKVXBHKIUW      SWTLDGJHM       BNKBGU          HODVBWMKXDTRYJ 
WSBBUDUMWWMU    : TQOO            JOAJTVNPKIMD    VTPIOSFD        HXVQIINNKYAB    VGWTG          
VGYCCIDTDEWCY   : MNKBQYBUOYQC    JGAPLFWF        RJFSMMV         GCRB            NHHGYDNI       
FAELYYMAURWJ    : WSTYKWRSOHJFQWI
VVKBTSAV        : QMSFUHPWNYIAY   NHGFWFGGXDER    UOSFFTXODWIDGI  FQVIUY          NGXQRAIGUQWNKCF BXNHIIOVLHRG   
KBSPFPSGEAII    : TDESAJ          LOBFMAKMKRGONR  EVLSFQ          LPEVLHFSVWJRXQ  HBXUSC         
HIYJDQGO        : KFBNGXRLEE      EKCSMDS         JLLSTNTU       
EKUFGPHDN       : LKSPMR          VBAFOYV        
EGKMYFUDFEOQ    : XGJWAQPGCQJH    WQOEASSDTB      RJWLYY          KWMBL           WDBJFPUWPEJ     JOHLRJT        
YRXEJGSTLFRSLHD : WDGMIWU         EBROPPNY       
WWVEHKFMFKTLBL  : IAORCNKE        PQSJPPR         YAWJUOS         ITCISSGNUXIPB   IXSEEBATBIRP   
AFAGQGY         : GSFEVGS         NBIMODDW        LBIOWLJVCVX     MEPFKSOMKYO    
TGDPSMSJKPH     : TYDRRMBHQJUHMA  JTRKTHEDJSRBYIL RDOV           
ARVOAGJ         : FUKLDFNP        CCPMDXLKNUVEDSM VHQUIYMGX      
IWNK            : CXIHTBSIOUIVL   NGGYEKUEMTIA    FSTJJDWMUX      YNFYLPTONKVYSN 
PTTWUFSCKIUWDGH : HJCKHMKG        WPWAIGBBPFN     GATHBCSLVE      IOWDWAFSONOBQ   PDTFQDLUE       QFDUTKKFFJKKCDU
OXTITIIDTWNQMAT : QTUVDOMCDT      DIXYSJMOTJOOK   TIUYHIXGTQHQNTG XOFFEKGKOFKBAQ 
TNCPUU          : GLKN            LNQGOKHHXBDUN   IQARVTHIRHVQ   
HGOE            : AHHKOUB         YOLTE          
WOFL            : AHJUQHXWV       PPHH            HDIOYLUPACOM   
BUJK            : UTUAYPXPSXAX    TMSAC           OQBYPLQPEPLUP   ACKTAPYXPQLJAUR
OECCXPCRUYHWOE  : WBYEAUI         XNVAHIAWJV      HYBVG           FPGTEHJRXVND    JBFQRKEMP       SVLPYJLC        QGLNIGXTSIRJU   YUVODOEPABXN   
ILCYRO          : JKGUBX          NWGDF           UIAXHOGXD       WNFI           
GTKVVF          : PODWFQQJBS      RKCQUAEDLFMGUVM ALWG            OVURGTKDVVAN   
IMVOPAMHE       : DBYNKBMGRYDH    XGOSYKJDJQX     CCHTXBEWONRW    NOJJ           
EDNBRTUCFAB     : GUQNIULSRUPCWH  TGVHQ           KFBNGXRLEE     
OAIIKEERNOE     : UGHRAGQFQA      UNQCF           MTJVBTRHPIDSDWG EVHLTOKFUYYAKQ  CPYQDRRRSJNREO  OQBYPLQPEPLUP   TLYN           
EVLSFQ          : KBSPFPSGEAII    CHFKLOMCAPURD  
JTPMOMK         : MUVWEMHBAJYITY  AILVEVLJ        FFNATKABSPUP   
TKWTY           : QALVXFMHPYLVAQP DIXYSJMOTJOOK   DVTAHYTFJUARUOB YAKHPNHQOKRGWWE
DHJJO           : XFSCWMV         VNFYEIO        
AFHLJGXFNOH     : JPJGDBECHQG     NDMCOXHDB       RYLMAF          ENAYOGTMCREYCDC LUGIYRFRMQX     RXCEKYGJMVH    
KWMBL           : VMBUWOFAESRMT   LEOLKQCHP       EGKMYFUDFEOQ    ROKOJFXUHF      CJMHDAA         DFEXTQBOBOKOBH 
UGHRAGQFQA      : GWDSQEP         OAIIKEERNOE     BMKNF           DGAPEXAPVMKV    ALODIYHWNPFOI  
HDPMMDYSBEH     : QDAMESIDWXQE    VUFJWIOGI       GQHDRGYBPIFDXD  OOJJUMVJKPGBQTG
LJDKVGWTBDDUF   : VHMK            QFSRILLNHUD     CHSVSJJBBC     
LLFLDMOUYCXXW   : YKPQBAPCKJOWK   XRUHYD          WIRASWUQXUVPQ   CCHTXBEWONRW    ESVRUHLHOWXCJ   ARYD            BTKQARIHWHVTUYE
EGTPPYDMGCIH    : EDPKKKVVJPQ     FSYG           
NDMCOXHDB       : AFHLJGXFNOH     SKDCXHAHSTWDYT  QQLGTGOK        NYTVEDR         PJVUXWGF        DRELSISE        WKDIOWVDUULGNUJ
TXVVWVVYBCSS    : LFLS            FJBLYJTUP       NNAFLIIDOWQAVI  CKVHNOFERDSORT  GMQTJXQANOTUCIN
SVJYXTIFHNSKFS  : LRQSRUWBYXA     HGTCXWMXIQKMEO  IMYYGBIFX      
IWOCUMB         : WQOEASSDTB      IMAKGJEIPDUSS   VWYJ            XEWNEPMB       
IYQJDMDXFBHGCD  : KABVCX          TSRPEIPUE       IJENML          GLYHAE          QLDFXQRISMIH   
HLDCXKXRUU      : RUBIO           TTJISMRHXBGLY   AAEKFD          IJQPRYKCFDIXMPW
WPWAIGBBPFN     : PAFUASCUYQLCXBE PTTWUFSCKIUWDGH CKLVLP          PYVTW          
DUWNBYQQIEVNEIL : CHSVSJJBBC      YASXK           DHJIPRSEA       LFMC            AWVYQJXDYL     
DGJCVHFGNGKFLAD : LDEQFQI         RWOYWALKSQW    
VAFW            : TRGSFIQKX       RUBIO           OOHDPPHNTGURD   YYGET           FXSOPTHYE      
XPLFNYLVMKYUWER : RCOMHRFLGWK     JUOTEBBFLA      CRIBQDMV       
JATPMBCN        : XLHEOAABFO      GKOVEMBO        VUFJWIOGI       KNBFOKWGY      
TLGB            : JXCHHCFGCGNS    GHMXYN          YJFPDR         
HYBVG           : OECCXPCRUYHWOE  QUQVMQGWKWKJMV  IWOBMQOHXFK    
WSNKFOFCSYICC   : GNBILL          XCUGJJFRMCWIAG 
SQGWEMQPTRB     : VMRWWEGFWVSGDYJ HEOJUHIKE       PJPX            LRLXYWM        
SCYCSWWGJCVQH   : VUFJWIOGI       CHJAPGKHRVUAO   IXUVQYOHJDWFSWF TIUYHIXGTQHQNTG
QPTUW           : TDESAJ          INWWLSJENILISFH XPFMCPTW       
LFLS            : SJSYD           TXVVWVVYBCSS    LTYDSGY        
CKLVLP          : VDWE            WMMYDMVBDY      WPWAIGBBPFN     RDOV            SOMORBAYFSYRQTL PBOMXPNOMTFVLD 
PQSJPPR         : TYRWPP          TREEMDVAAM      WWVEHKFMFKTLBL  UCLCNLM        
UNQCF           : NQVCXEDLAPSR    OAIIKEERNOE     QOBENMKUD       SKUR            WTOBEKUFPP     
TYGQNRV         : HVDBOILHCNAJ    LMJFUPSP        PQFXWXDR        RXEND           BQVBBAGGKESBE  
KODVCYJT        : NKFCRLTO        GLKN            AGKIHQEFHHUOKWO ABJBT           WNUTJAANUW      HLYFDYD         BCJECHRHLRIGGCE KNQRGPQPWP     
ALNLBFDDATV     : BQEA            PSHHRIIHAKD     QGYCREDIXOQVEPL MONRLGESFXY     BEBGSSA         FKOJVVFLSBAE    MJSEY           RCFW           
YHYANRNFQMSH    : QGDGRMI         GWFO            LVBYQQV         FXSOPTHYE       RPINHNGPB      
QJQAE           : UEAYCDAWJS      YECIPVNAMB      SWRWEPSJAOX     PAUHPMHKONRWU  
CRVN            : PLUUAFS         GFJJWLIVIB     
ERAENVJMDKMSCAB : OJOHJUJ         CHFKLOMCAPURD   DCXC            DEORFLWBNIAQ    DHJDPWBTBIGUH  
OTAGMMYMQHRK    : JRWEUCWVPW      XDIHAORFMV      NOJJ           
FHKYIQMG        : FSHHNOTDK       TEOVSCOABO      XDIHAORFMV     
BMKNF           : QEDTGHOXFBU     UGHRAGQFQA      CRWCCXBXRJGERJ  RWOYWALKSQW     AMOQXYGP        MHSOGHHKRHFJ   
PGIGCLM         : KFQCDUBCSI      KNVJEHOFWGO     WJAA           
XLEQVXB         : FEPQVENVNW      GBVNXS          LMWBUWHDNYDHAJ 
FIQF            : NFCVQVYA        PCFOHWGX        KIPVIHSCAXTWE   QBXIOGPKTS      ACXIIKOENSME   
JTAKXMWLTOEB    : IWOULBNTBKYWUJL COML            KLSWIAN         CIFAVKPIESS     HQDBDINR        VDNQOQFPKLJCJJ 
MFJAWJNDALBB    : PIIV            QTCCRMC         PCBIBJDTSLOL    SKXCDJ          CIDMPYAH        ALODIYHWNPFOI   QEJSPTIDBBTNT  
GLKN            : TNCPUU          KODVCYJT        KLSWIAN         EGXUG           QRTHHMPFTP     
UKHHIVEVPTAST   : LSFITXNCFAOWOY  IYYUTHGMIAIJM   YASXK           FREKDMHNISX     HWMKYVKKVRHCWXU JUOVRM         
YFPXOFBOTERLKFY : PYELSPRWY       MEAQRXIKVBXAW   FLVGTC          EQVPKNDSYHNFJER CPXVPRV        
MTJVBTRHPIDSDWG : OAIIKEERNOE     EASUN           WEDPEN          ORDGKPDPDNHLS   BJFFEUMFJCCJS   XQVXIMJFK      
EXCUFDLYH       : GYFSYEMTTUFYWN  OFGYNTJFROYR    XTPJGKHPWFTJCS 
NULMVXIHUJ      : HFAMGKXUEXDCMQS FSAGYE          PJNM            LRCSUPCQJLLFLDY
OQQYWJDVRHB     : QRQYQPBKTUNJ    UTSNYCL         ANHYRCVNBAFKLD  FFNATKABSPUP   
KVXPIYANOUYDSAL : RGVFHG          AQFAACV         WVGF           
WUBLOT          : LVQLULG         OQBYPLQPEPLUP  
LGOJAVKSIJSYT   : YYGET           PBVH           
BJJVJM          : SLCWIO          QGLNIGXTSIRJU   PLNYBRAVX       UKMNPH         
LYQIVTVMPJXV    : UTSNYCL         EVHLTOKFUYYAKQ  HDGJ            YAWJUOS         PTVYDOG        
IYYUTHGMIAIJM   : UKHHIVEVPTAST   LRPCUVNAIJTLKMG STMIADNBI       PJVUXWGF        MXKROJJYWPU     KFIVRH          GXMDQ          
HXFXJGOTCKPR    : GOFXUYKIK       PTNKFNGXYAXKH   RQHX           
CRWCCXBXRJGERJ  : OGTCRQ          BMKNF           GHBAHEPCK       NHHGYDNI        NOSBT          
EVHLTOKFUYYAKQ  : OAIIKEERNOE     LYQIVTVMPJXV    VIEDNXGVLSIGN   WNFI            TIVWEDADD       XYGMSRXBXGRL   
NSJMVOLYMD      : ICAVMIUKBWDXHQ  EEPUYYEA        PLDFMIHIJ       RCFW           
SKDCXHAHSTWDYT  : TRGSFIQKX       NDMCOXHDB       HXAKI           IDICOJBQOMOG   
AVRRPFMCRKQ     : AVVXF           JCCXKXRK       
KDHU            : VVXXPT          VJWOA           JGMWRVKWAUCOUQ 
RXDRHFB         : FABHRPMQYFCL    RPDDEQY         WALDOBDCU       OXUGCJTVAFBGDU 
AXGBUNCQ        : TFXGSXCTU       PMTAIMQULKU     IXSEEBATBIRP    NTIBWQQSIVNNXB 
VHMK            : TTDRINJXU       LJDKVGWTBDDUF   EFMU            RHAC            VDNQOQFPKLJCJJ  WIRLIEFYNR     
HXAKI           : SKDCXHAHSTWDYT  UWSXVPPINLI     QSPBBDEVVIUBG  
TDFN            : DPCAS           WVGF            IJGFE           YECIPVNAMB      RQQU           
KHNQ            : JTOHAOIRVNWD    IPPK            DXLLR           MMSKTUP         GKJVM          
QSJAVE          : POAFSGOT        YEPM            FAMJYWJRKWA     TIYT            TLYN            MMSKTUP         GWLMO          
AVVXF           : AVRRPFMCRKQ     IHOAXEPJXT      QWAJKUSF        SGGTN          
JQRHSFRXYWF     : SALDJFLCWK      EKCSMDS         PCXEKKT         GRBTMCVASNNUSDO
DSYRLKIEU       : XIBAMDBTXPNWTI  HCNTVBNOUF      MIOGUOU         ESJMSRXGMEVAJN  PTNKFNGXYAXKH  
CBYDYU          : MOFD            VBYLIPOGQOSCO   THAQMXHVAXBBAHW REILPI          QYNLAKYDJNOAR  
EFMU            : VHMK            HROYBNLVPY     
TNDNNELVVOQV    : AXDQCDSEMTN     ORWXEXIJPNHYDMQ XIBAMDBTXPNWTI  OBTKGCCUMFKC    XXEWYRFFC       JYMORTLQSNKDGUQ
CGRID           : IMKUKSKRVB      LCLTKFJ         RPINHNGPB      
KFBNGXRLEE      : HIYJDQGO        EDNBRTUCFAB     QKPVN           MTWO           
EBYJOMNCKM      : RFKNOUX         GHBAHEPCK       VCKH            JLNWVPPVM       ALIP           
BIADQTLWYY      : XUJADKJIJQO    
AOKBGXFNHLQ     : FKCQVS          OWCVNYGLOI      VHGXCNE        
UFUKKGWEJ       : MBESWBR         WXHBIFUUAAFPSP  OSRCBFVQASXVTD  VMCIL           NPCBMEPFHPFFXNU
GNYBBVA         : JUJXFF          HJQAB           UYBFDM          XXEWYRFFC       WJAUGKNA       
CCPMDXLKNUVEDSM : NKRPET          ARVOAGJ         FWPAYXITRGK     ALVCWJVKLOELW  
EWGDBQ          : QFRLGWRJYDPUSIV
HEKKHIKIKPAYUAM : UHAKPYQHJYT     HQDBVDIOVS      AOJDRYDRPQ     
OJESMAFLECR     : ADWISVGPVQ      KFQCDUBCSI     
FISNOFXWPLHCDJ  : JYGQBXYLHSKNY   NFCVQVYA        VCLCGAPSR      
XJQGABNTNN      : SLBL            WIMNMKR         GHMXYN          BYAXGGMNOM     
BTGTDLEWB       : EJVGYUTJQTJMF   YXIFKPKNE      
EASUN           : MYYMHJEPWT      MTJVBTRHPIDSDWG LVANVCQT        CVVAMPBIMHTFSKG HQDBVDIOVS      LQHHUNBEDSP    
YQLDQWUXXXL     : GGDGXEGCQPRT    NVCHROYNFRXHRW 
NYWPUDL         : AHJUQHXWV       NNAFLIIDOWQAVI 
PRWSNCSGY       : JXXEENBRGBOD    JJWYRQHTWJMOLRD AKTBYQQYSG     
KXYVCSVYQ       : WVHFBMFFIENELVV FYXXOIDRHR      RASLKAVHRFQ    
YEPM            : QSJAVE          GVPYNYX         IKGJHYRIMV     
MEAQRXIKVBXAW   : YFPXOFBOTERLKFY XHDTXSKYM       CWIBMAVIRCARES  HFLYGDCTT       JCCXKXRK        LKDRK           DUOPIGXAS      
BFTY            : YTOPAEAOWWSVDY  SOTVBV          PLNAAQRWVV      VOOGPSYEQECJQBN TEVOXQAREBX     GRBTMCVASNNUSDO
QDAMESIDWXQE    : HDPMMDYSBEH     ESVRUHLHOWXCJ   QGLNIGXTSIRJU  
WEDPEN          : FJWACCAHUMRXES  MTJVBTRHPIDSDWG YYGET           NYJKD          
CRACOJ          : GJEEKFCYDXQKV   EXHEXADKSOXTQN  CORINB          MTWO           
VEFDWKFLPX      : OCGMFSXEVAAB    OGTCRQ          ASBSNRTUJJPX    PJNM            EBROPPNY        MDPDWK         
SWTLDGJHM       : TMUOP           KABVCX          UYBWSNCBP       JBTUSJQFWMGLF  
OABQRDVIPBFV    : IAWTPMWPJUKXPX  OPPLXTUSPFX     RMMORRUK        XFSCWMV         VWPGQJUW       
KSTQGLQAGQVSTCE : NHHRPYWNT       DIGFLEP         GFJJWLIVIB      EKAV            XXVMGHKCNOBJ    FFNATKABSPUP   
QFSRILLNHUD     : DAVYC           LJDKVGWTBDDUF   QRKJDBPS        NYTVEDR         XEQFLJG         KXDGMGNAHHTG    NKLTH          
CBRMT           : WIMNMKR         KXOKVJT         AIONJHTWVCDTYYE VHJBIINMV      
DAYWCINAB       : DFLMMURNDWEERL  FAMJYWJRKWA     GCRB            WSTYKWRSOHJFQWI
DHNVOINWUCM     : MNKBQYBUOYQC    ICAVMIUKBWDXHQ  WNHNACJLKFHOLJ  UNXTSVJD       
YQNBTIPOVT      : VMRWWEGFWVSGDYJ MUVWEMHBAJYITY  XDEVKMCIURPEPS  YWQWR          
XSVGGVJRB       : PODWFQQJBS      QDCJVWNKLO      FCWABDXHGBS    
GXHQNGLR        : XVYB            RLPXLOYPMHBCE   PBFPPSLUWW      PTAJMXAMXW     
QQLGTGOK        : NDMCOXHDB       KLJPTGFO        CRORG          
NGPLY           : VIAXQKBJGJYIJCI FGPVIAOFSCRVK   EXYSUECMWEL     QNUYMO         
THKFBNX         : DBYNKBMGRYDH    HQJTFIGDO       FPDY           
LHBCNOTGFNU     : NKRPET          VWYJ            GTMDDPVRGB      PNLMFAS        
HBDTXQAN        : SAARUIPEOXOGY   IITOO           YBDIK           KUHKDPVRVJL    
BCAKMFMAFVOMY   : EAKJORXFVONOI   VODDJREFYLN    
COML            : TWWSSNIQMVDJTQ  JTAKXMWLTOEB    SEHJSR          THKGIRSUPAXWE  
AGKIHQEFHHUOKWO : KODVCYJT        CORSQBC        
LWKOEIFRIVVW    : MPUW            LJCQLALK        SRRLTLXGKD      JHBSXKVS       
HSLNGVUWA       : HPQSJRCRCBHUQE  MDBGMUKIDIGK    LUSULEMRGDWJ   
GHXWS           : YMTCOHUGL       OTJMRVEAOXTL   
MQLLBAPJHJRFGQP : QOCAEYJSJVTLEJS OWCVNYGLOI      NHXSKXBEMGOARJT
MBESWBR         : UFUKKGWEJ       HQDBVDIOVS      PGQBQHHUAEBQ    RQHX           
EXHEXADKSOXTQN  : CRACOJ          RRWVBODM        XNOLQJFQ        YNFYLPTONKVYSN  SXAILLYWXBDNCUX
XAADIRTX        : VMBUWOFAESRMT   XCLNGWYBK       RBPLFILTOIDITOX WDBJFPUWPEJ     BVSDURT         OABLOTETRXVAWP 
WCYUESU         : NGAWKSAE        DRBI            TIJRAIMBJCRM    UWHOMHV         TXFBYDCE       
SCQQFTBXLBUCR   : STXCGF          ELYTTXSPGR     
DRBI            : TREEMDVAAM      WCYUESU         QVLQXUNPAGT    
UEAYCDAWJS      : QJQAE           XEQFLJG        
TMVKDBGHARIU    : HCEUFQIRQOOJYB  IMYYGBIFX       PTNKFNGXYAXKH  
CVCV            : QLBAVLI         FAQREPPBHSRN    KNCCQYQTWQM    
KXURYV          : MUVWEMHBAJYITY  NPCBMEPFHPFFXNU
CWSNPK          : XKTOEPWX        JCEORBKF        HKNUROP         SWJAHDNDEQWKS  
EGTKKCRKU       : FQVIUY          YIGPTVDJUGE    
FTHDVDCIC       : XJJUUSPFDHA     POVYWBNUCAD     CGNWJ           TQMADWOIVNSB   
ABVVFSOSKBCRKX  : GKASUINA        OYTF            QFYGCSRAFLUAINK MQVKFUNGACHV   
UAVHWAOSHR      : HGUPWXEQGEN     TGUJCIOAUAJVQOG
LVANVCQT        : JBTCYELQEVP     LVHXUKFNOWD     EASUN           VBLRSYOTF       XEQFLJG         QLDFXQRISMIH    ARYD           
XOPQYTUSGUUDW   : GKASUINA        LAXN            SENPOSBMFR      YLOMCYOKOX     
KUTYN           : VJSV            HSWXIQX         GJXCVM          RASLKAVHRFQ    
QFMOHCMLS       : YTOPAEAOWWSVDY  GOFXUYKIK       EHOJGMNCSQQAT   VMVRJL          UYSHL           YECIPVNAMB     
MQUFJWBGP       : VYQI            MHGBB          
BNKBGU          : UYBWSNCBP       AJIMXCCCGG      MDBGMUKIDIGK   
ATLCMSQD        : ERBLFNDQE       MKXF            LPQAWA         
TQOO            : PPECXXRBW       WSBBUDUMWWMU    RQKU           
BIUIRR          : IITOO           DGINPVKOGPFSKPN ELYTTXSPGR      XYUGXMNLKU      NJHHQGCHXRVAU  
BHQEUDFEXDETPI  : GYFSYEMTTUFYWN  HIIOLKAMUVO     KFQCDUBCSI      OETFDKTMVGNH    RWOYWALKSQW     VYFABVWDXMEOKR 
KAMNTFCKEFSY    : WPITT           RNWY            XRUHYD          IGYQO           DJPKPT          JFNDPTHKQTKXWXC
LQXOYRSVUYATCHP : OIVPIPDVBOWC    FJWACCAHUMRXES  PLUUAFS         RBRCYWTSRJ      PLDFMIHIJ       HDIOYLUPACOM   
PBFPPSLUWW      : GXHQNGLR        TELDKLQQCKITWVH QUQVMQGWKWKJMV  CLDMSTNS       
CPYQDRRRSJNREO  : ORWXEXIJPNHYDMQ OAIIKEERNOE     KNCUJUENUOKTROD FDDIDPORA      
ASBSNRTUJJPX    : VEFDWKFLPX      PCXLRSOXDEW     CMIRMLXKL      
MWFOOGGSBXMTH   : EPAPUNVJVB      BCGAGQ          CMINNFGL        XWBMXIATTFEJK  
LNQGOKHHXBDUN   : SOLCEI          TNCPUU          KNJEWUEMTLSAWWE FHTPGFDJLHPKM   VWYJ           
KLSWIAN         : JTAKXMWLTOEB    GLKN            ICTX            BQEQR           AWVYQJXDYL     
JTRKTHEDJSRBYIL : AYRHO           TGDPSMSJKPH     OHLBQGUGADY     YEFCMIDNCWKC    XTPJGKHPWFTJCS 
RLKU            : JLJDAOGJFWBUII  GXMDQ          
AJQL            : DEBYLGTORBDX    JLICHIUGDSOBPF  GIEWNHEALWYO    FQIPMMLH       
PVEDUNANATWH    : MTWO           
GATHBCSLVE      : PTTWUFSCKIUWDGH KOBUCVGKCQOQVAU SFNNQEHOIA     
SKXCDJ          : BTEACRQ         MFJAWJNDALBB   
SHMYDDYSDUPM    : JVOKEFUYP       PODWFQQJBS      EUNEBOPTXONMUY  BQVBBAGGKESBE  
VOOGPSYEQECJQBN : KRUHSB          BFTY            SEWTAHGEAJGVAW  OVJKWHNDFWYWWBN XPFMCPTW        NNFW            GEXEFIKKSDJCYXS
MTPW            : SRRLTLXGKD      WVHFBMFFIENELVV TQTMSNLXFQLRUS  EBROPPNY       
QAKPUPNMDIKRAQK : DKKNIHYBXWE     NLSJLIGGOMW    
QOMWSXPTMMJ     : IJXJ            VHGXCNE         KNQRGPQPWP     
FGPVIAOFSCRVK   : NGPLY           FKYLFMPREXOOJPY HVVRKXCHRUM     OTSURPA        
PMTAIMQULKU     : AXGBUNCQ        ORPPNQWTLOT     GHBAHEPCK       ESEWVGY        
GHOROVXGRIJG    : INWWLSJENILISFH RIHAUIPJ       
CIFAVKPIESS     : SBFRALAGI       JTAKXMWLTOEB    YJHDTDTRVDIQEHR BMVQJGOHWBV    
LPEVLHFSVWJRXQ  : KBSPFPSGEAII    FNRCVKMROB      EJENFJCSYEIMK   XOEDYMW         HEOJUHIKE       QBAQ           
IAUWC           : GWDSQEP         HGUPWXEQGEN     HFOQ            DCXC            ELMQDCCRXRJQKV 
ECCOTMUM        : BGFDILSRDKXLID  PCXEKKT         AKSH           
PYVTW           : DAEGSPKRAY      WPWAIGBBPFN     PJVUXWGF        JBQDRBSCJQY     OABLOTETRXVAWP 
CEDAEMUEFHMFE   : HDGJ            BEFVD           FGDEFXPTP      
JIQNMF          : SURKMHUBGVQ     OGTCRQ          GHYXKNQUQUNKK   XVQWAHFHEL      GUHXFAEPSV     
ADWISVGPVQ      : OJESMAFLECR     QOONCEK         SOQOYP          GXPLXJURH       GSOXRMDMHQTULD 
ATTEIQIQAXX     : DYVTYTKDO       JBTUSJQFWMGLF   QFYGCSRAFLUAINK TQTMSNLXFQLRUS 
JIPA            : FWCTXBC         QHIWRK          LQREMBOUCPVVLKN BMJWQVJW        LTYDSGY        
DIGFLEP         : AUTFFLUAF       KSTQGLQAGQVSTCE YJHDTDTRVDIQEHR ESFLD           KODWWICYXV     
CVVAMPBIMHTFSKG : EASUN           JLICHIUGDSOBPF  VHQUIYMGX      
ILASDBRIJ       : QEEKB          
NWGDF           : CGGGEHGHTYD     ILCYRO          HGQDCCCSNHWF   
CEJO            : XIBAMDBTXPNWTI  INWWLSJENILISFH RYLMAF          OWLFHGJYGVKR    XUJADKJIJQO     HWMKYVKKVRHCWXU
MAIUTOPGWGQK    : JLEQFCRTJV      QKYSSI          ABJOTLKELO     
KNJEWUEMTLSAWWE : LNQGOKHHXBDUN   ABJBT           EKAV            GHVILDGEGVCI    BIVGSWC         GQWJCVPWSRRP    NHXSKXBEMGOARJT
LAXN            : XOPQYTUSGUUDW   FGHPGPMXPO      XPTROGCYVGTGC  
UHAKPYQHJYT     : LEOLKQCHP       HEKKHIKIKPAYUAM NRWFREBPW       FJDK           
JXXEENBRGBOD    : PRWSNCSGY       FBRDOPWMOX      NJHHQGCHXRVAU   ACXIIKOENSME   
AQHAF           : VCKH            NFWFYQHAFDCVLYC ALIP           
UOSFFTXODWIDGI  : VVKBTSAV        JOAJTVNPKIMD    VHJGDMPVS       EXLDYFPFPDYD    MEEKTGRFUAUG   
NMOOHWRVCWXVGXD : SLOVMRLIRYNLQFY RPINHNGPB       NPONBMLBOKQDBE  VIHSUPB        
UTUAYPXPSXAX    : BUJK            VODDJREFYLN     KLJPTGFO        LAGQ            OAWOIHMTDTHMMK 
ICTX            : KLSWIAN         TLVTGVJG        KFTA           
KFQCDUBCSI      : RGWBBALQ        JUJXFF          PGIGCLM         OJESMAFLECR     BHQEUDFEXDETPI  AMABMTQPI       FPGCYCSSGUWNIYY PGWCAMKMNQY    
VIXQD           : WPITT           BYVVQ           RIHAUIPJ        SMRI            VPPCUH          FBRDOPWMOX     
RUBIO           : GTWDCLGJOKXJTMY HLDCXKXRUU      VAFW            KNVIUXUBEFUMYDJ
IOFTQARKM       : FPGTEHJRXVND   
DPCAS           : GKASUINA        TDFN           
TBJRLJKRLDMMNDL : GHYAUN          FGFQQCQLPXGFWF  HFWHU          
SRRLTLXGKD      : LWKOEIFRIVVW    MTPW            JMMNLJAUXO     
NERTAUF         : GHYAUN          LVQLULG         WVGF            FLRAPROXLIBATPE YSUVUAYGV      
HQDBDINR        : SLBL            JTAKXMWLTOEB    CUVCBPX         KNVIUXUBEFUMYDJ
TEVOXQAREBX     : BFTY            LBTDKURYMNLFH  
EWFIOBI         : LBTDKURYMNLFH   YLOMCYOKOX     
JDSCGVFQMAO     : PCBIBJDTSLOL    AUTFFLUAF       QHIWRK         
EMUEDWVIXVAD    : CORINB          IMHBHXEAEKD    
FNJIWVRCQUKN    : MKUXOSTAYR      UBQAMXL         TDNJMC         
BACPIICDMICKSDH : NFSG            BRELLKYQWLJON   FIXLTHLJPDVF   
ICAVMIUKBWDXHQ  : VJSV            NSJMVOLYMD      DHNVOINWUCM     CRXLJLUNPR      AKSH           
KSFCBNFGDPJ     : QWPFACE         KOWRUQAL        PNLMFAS        
IOWDWAFSONOBQ   : PTTWUFSCKIUWDGH SRSCRADLDH      FMRGGA         
EQXXRIQYLS      : WNUTJAANUW      YDYVKDEXB       LMWBUWHDNYDHAJ  HUHSYCMBUK     
SBRIMISBH       : FBRKGLKRVDRXRP  CXIHTBSIOUIVL   VOOUYLKWWN      ETWBBOT         YASXK          
XHDTXSKYM       : MEAQRXIKVBXAW   XUYAJTEL        HLAMXQWU        PNSVPQRFBDXYXK 
GDXEWHUVS       : XITFGPRTRHVB   
LNRFXGPSIXQIHVC : QMSFUHPWNYIAY   MXEYKASK        EYYKTERJLPD    
OOHDPPHNTGURD   : EEDLHCYMS       VAFW            IBCD            BDGWWDI         VJYRGYOIVPDFXHN XLDD           
HQDBVDIOVS      : SFXCQMIDOBAKR   HEKKHIKIKPAYUAM EASUN           MBESWBR         SPTXQLCCG       CORSQBC        
OBTKGCCUMFKC    : TNDNNELVVOQV   
BYVVQ           : NHGFWFGGXDER    SAXFIRNT        VIXQD           LBKON           TFAIERWLFYGEDLO MUCYMNUOIWJAML  CHNTPESDCLS    
OARTEPX         : NCWGQV          RJSIHH          JUDJ            FCBGBHALJLRD    BYFUYJKTMPCEC  
EVHSLKN         : JJFXEDOLKUDAH   EDUPHMMHSRUAECU MNQHFMHLQCO     KQGGLSYRRLAF    NPGNATJF        OTSURPA        
SRAOEIBJWCIUBB  : DFLMMURNDWEERL  KNKUIOFEXQHGBUU CESJNPIBNDDR    ACXIIKOENSME   
RBPLFILTOIDITOX : XAADIRTX        ICLLMESSOUATALK
HPSX            : KRUHSB          TRGSFIQKX       VOOUYLKWWN      KGDIT           HSGENRPQKYYHQJM DNSCXJSD       
BCGAGQ          : MWFOOGGSBXMTH   DGSCEKTAWY      YDYVKDEXB       JGMWRVKWAUCOUQ  EFEKYBCWG      
HRTYUMNDU       : IFOOPVVFVLCMJMK YOMPRIOFKUFW   
YJHDTDTRVDIQEHR : OJOHJUJ         CIFAVKPIESS     DIGFLEP         KLJPTGFO        CRXLJLUNPR      SOMORBAYFSYRQTL VTPIOSFD        NHXSKXBEMGOARJT
PTOGPWAKXUWNAT  : KLHTNBWMIK      GGDGXEGCQPRT    JBTUSJQFWMGLF   TELDKLQQCKITWVH PAUHPMHKONRWU   KFIVRH          PNSVPQRFBDXYXK 
AFWFABYRYEAPIJ  : YTCHMQNSF      
QYDGFTF         : SOTVBV          LDEQFQI         FBGJSBQNACAP    FMTDGNEBSEX     BYAXGGMNOM     
GFDFTDBHFGGKG   : YVLV            GUGV            SIHOWRAEWK      BLACUUUCAORX    DLVCR           AKSH           
JYGQBXYLHSKNY   : SWIO            FISNOFXWPLHCDJ  CMINNFGL        IPPPWERLIWS     PGWCAMKMNQY    
JGAPLFWF        : VGYCCIDTDEWCY   TMLCEWV         FGDEFXPTP       WKPUJLJ         JGMWRVKWAUCOUQ 
XOQEVCLFNMO     : VMRWWEGFWVSGDYJ LPUFMAHDCMRINN  JLLSTNTU       
NMEYW           : KUWA            YRMDKXMEKYX     VPPCUH          JLNWVPPVM       LQKUD          
MKXF            : ATLCMSQD        CIDMPYAH        KQGGLSYRRLAF    UUWMUUEENBV     HWKPBXH         MCOJTO         
EFLPLI          : NLSLPENGPCGQPJ  CJKTXSL         LPQAWA         
WIMNMKR         : XJQGABNTNN      CBRMT           PPRSKXX         IJGFE           HROYBNLVPY     
QGMFMD          : VMBUWOFAESRMT   IGRFJO          WTJV            GSMGKGXVMF      GIEWNHEALWYO   
SEQRQ           : OQSOBVOCA       PLNYBRAVX      
PVWVEKORSMQD    : NHWRGSGJYD      ORBXGAYS        QRKJDBPS        LMWBUWHDNYDHAJ 
GSOYS           : JCYPRIFUMFYXOGY JJISTNS         KNVIUXUBEFUMYDJ BTKQARIHWHVTUYE
HIOTLINPCFJFXH  : VTWMFJDUD       VREEN           FGQEEQ         
VLPKFL          : PCIQITPP        XDEVKMCIURPEPS  RWOYWALKSQW     RPINHNGPB      
VODDJREFYLN     : BCAKMFMAFVOMY   UTUAYPXPSXAX    HOQUCUPNVPUKVUP TMLCEWV        
HBXUSC          : KBSPFPSGEAII    EKVQMUFHOQKP    PAHLCL          HQJTFIGDO      
CIDMPYAH        : MFJAWJNDALBB    MKXF            GRBTMCVASNNUSDO
GSLCKQFTILB     : NRWFREBPW       WKPUJLJ        
WOYFRACNCHRMKEC : PLNAAQRWVV      LDEQFQI         QBXIOGPKTS     
FKYLFMPREXOOJPY : NHHRPYWNT       FGPVIAOFSCRVK   PVGLIKBCFPFCG  
HAOBAQODYHPJ    : MEPFKSOMKYO    
UXQHWEOKUJOS    : EKCSMDS         FNFBJSBTEWIRJO  YVFNLAML        IMYYGBIFX       SGIQ           
DCPEL           : WUIFHV          RJFSMMV         ISEKGCE         KXDGMGNAHHTG    AKTBYQQYSG     
FABHRPMQYFCL    : VOXAXWISHAVXNH  RXDRHFB         FTUSGOEMOXL     JXCAOWYJEFK     EMVE           
BEJALAKGJBBJ    : FTUPROIQ        YPBCQLKHIGM     QLDFXQRISMIH   
DCLPBSREBJWN    : RFKNOUX         XQHVEQUTJQRR    QWCQBTNTPA      FREKDMHNISX     KRMJWJJGWF      IPMEGMQHTFR    
VUFJWIOGI       : NRKWHIM         HDPMMDYSBEH     JATPMBCN        SCYCSWWGJCVQH   OGOGG           OTUCRHNQPKPK   
HVIS            : RHPHKXYTUOFIFAI DFSEOYJ         ULPSWEX         RFPBQASMLD      KUHKDPVRVJL    
LDEQFQI         : GGDGXEGCQPRT    MKWAAUFJQRFRQM  DGJCVHFGNGKFLAD QYDGFTF         WOYFRACNCHRMKEC GEMHSX          CLDMSTNS       
LBNMKMDNIXUSV   : XEJHEBPRKI      PHWCOCCL       
JEPLNLVHLHKP    : QODQI           NYJKD          
RIHAUIPJ        : LOBFMAKMKRGONR  GHOROVXGRIJG    VIXQD           BGFDILSRDKXLID  TVENLAM         AMOQXYGP        HUONXT         
CMINNFGL        : MWFOOGGSBXMTH   JYGQBXYLHSKNY   QTXSXUWGVUOMXG  PVGLIKBCFPFCG  
RPDDEQY         : RAIHDUSVCKH     RXDRHFB        
EGXUG           : VCHUMVYWFR      GLKN            YNFYLPTONKVYSN 
FNRCVKMROB      : GGDGXEGCQPRT    LPEVLHFSVWJRXQ  QATXDPDNLBEKFB  IPMEGMQHTFR     FAIVKNLCGGCP    KNKUIOFEXQHGBUU NKLTH           PRIUJBGKRFVD   
FNRCVKMROB      : OMEWLRYULQH     WACUNFST        HROYBNLVPY     
CQKKCYCUEHBV    : UMWQQXF         OGQTXSIFHDB     VIEDNXGVLSIGN   NNFW           
OAOOWVGF        : TRGSFIQKX       UMWQQXF         QGWBEOSYLLYK    TMLCEWV         IHOAXEPJXT     
AJIMXCCCGG      : IOKAEJLKAYWQEG  LSFITXNCFAOWOY  BNKBGU          TKVE            XLDD           
QTXSXUWGVUOMXG  : FJWACCAHUMRXES  CMINNFGL        EKAV            BJFFEUMFJCCJS   WIRASWUQXUVPQ   OABULF         
UCLCNLM         : PQSJPPR         XJCMBMENBKE     NRWFREBPW       OWCVNYGLOI     
YMCD            : CMNDI           OABLOTETRXVAWP 
JLICHIUGDSOBPF  : AJQL            CVVAMPBIMHTFSKG GIDUDEHR        XJSER          
NLSLPENGPCGQPJ  : PFTMKPJDIXNBMX  EFLPLI          YWJPYU         
ESKOWRWSAANOBD  : TKEJDHL         CLCMRYKYR       QBKUO           FBRDOPWMOX     
QRKJDBPS        : QFSRILLNHUD     PVWVEKORSMQD    HQCEXHIEWFNHJWC AWVSH           RXHHSYWH       
GVPYNYX         : YEPM            JXVHSDNNPANKE   CXYKO           YSSYJQFC        OMYEJXMRJNUU   
TIJRAIMBJCRM    : QLSW            UEWEBHKF        WCYUESU         AJPPQAWLQ       XMENR          
QGYCREDIXOQVEPL : ALNLBFDDATV     SCTE           
NFCVQVYA        : HVTBJTVDVPC     FIQF            FISNOFXWPLHCDJ  HLYFDYD         DCVJ            KLUTYVMW        KFTA           
CJKTXSL         : FTWRCLWCIVORHT  EFLPLI         
RNWY            : KABVCX          KAMNTFCKEFSY    CCHTXBEWONRW   
HWJXUNPGVGNYEFU : GHMXYN          RPLJGDYRESMWIS  HFWHU           RFPBQASMLD     
FGFQQCQLPXGFWF  : AWBDIKIDEEFOO   EDUPHMMHSRUAECU TBJRLJKRLDMMNDL CCCKTJCGJR      QFDUTKKFFJKKCDU GIEWNHEALWYO   
EEJC            : SREBWPGLRYYT    LVBYQQV         GGHRBFS        
WTJV            : VOOUYLKWWN      QGMFMD          NUYWPMV        
WUHERKLXSERWVFM : WVHPXJTX        TQRGASYJNTP    
LRQSRUWBYXA     : SVJYXTIFHNSKFS  GXPLXJURH      
JXVHSDNNPANKE   : GWDSQEP         XRSVXYCLHEKVW   GVPYNYX         WUGBQYXUA       YRMDKXMEKYX     NOSBT          
HCNTVBNOUF      : HTNLLQRAD       DSYRLKIEU       YKPQBAPCKJOWK   MYFOHTKEVE      MDCRYCRAQJIOYHN
TIKUL           : DAVYC           KGFPJGMORV      JJISTNS        
EJENFJCSYEIMK   : LQJSD           GBISKQQSUYGN    YETRE           LPEVLHFSVWJRXQ  MEJSQRMCB      
TNGOLHEB        : NFSG            KIPVIHSCAXTWE   BWSDU           GQWJCVPWSRRP   
KOBUCVGKCQOQVAU : GATHBCSLVE      KSCXQODL        GYRJXHUQX       LRLXYWM        
BBWNLPIBXYNG    : BTEACRQ         JBTUSJQFWMGLF   QFTH            DUVGGNSM        YVTJLBESV      
QMPHNLJLRTOIK   : PJPX            PFDJADIKLWNK    FCVV           
EKCSMDS         : HIYJDQGO        JQRHSFRXYWF     UXQHWEOKUJOS   
QKISJ           : SVQHHKMFBBKOK   JGCXBLNYDJV    
IRNBGDIU        : DMFBHHMTFODOQIW LVQLULG        
SIHOWRAEWK      : NHGFWFGGXDER    GFDFTDBHFGGKG   MONRLGESFXY     ORXD            CJMHDAA        
RYLMAF          : AFHLJGXFNOH     CEJO            GUIWVSLT       
KAJUI           : CXUGJLTDTJB     BSFBWDNUU       IOJK           
KLJPTGFO        : XFHKYYVOY       QQLGTGOK        UTUAYPXPSXAX    YJHDTDTRVDIQEHR BQIYTARC       
OGOGG           : VUFJWIOGI       YHTW            VYEW            HDRSC           VBAFOYV        
FSCXSOKUVKF     : ORBXGAYS        EQNAMPOLFRJPHWD NCCGOVGHDXJRRJ  GEWPELS        
VCEYMRLFNT      : SWKXNHPT       
FJBLYJTUP       : SAXFIRNT        TWWSSNIQMVDJTQ  TXVVWVVYBCSS    ESFLD          
WNHNACJLKFHOLJ  : DHNVOINWUCM     YLIHFLFEAFOSPB 
DUJROVYBWKCIEWX : KKFQE           GFJJWLIVIB      EKTWIN          HWMKYVKKVRHCWXU
TNDIOH          : SURKMHUBGVQ     CHJAPGKHRVUAO   HPFVPINQPJWDJH 
CRXLJLUNPR      : TTDRINJXU       ICAVMIUKBWDXHQ  YJHDTDTRVDIQEHR PHNQIYF        
JHSIIRU         : KEDUXFWPEM      IITOO          
ABJBT           : JRYJVA          KODVCYJT        KNJEWUEMTLSAWWE GTMDDPVRGB      GRGONXWXCKOPD  
OWLFHGJYGVKR    : CEJO            VVWGEB          XYUGXMNLKU     
XJJUUSPFDHA     : WSKWYRDIFKJRNI  FTHDVDCIC       PXDD           
KBYLXECWQKEWTGF : EOLAKPVIDBF    
QWJPH           : DEBYLGTORBDX    IBCD            GYRJXHUQX       TXFBYDCE       
MEPFKSOMKYO     : TMUOP           GJEEKFCYDXQKV   AFAGQGY         HAOBAQODYHPJ    UFOBGKTW       
MONRLGESFXY     : GUPADNNYQH      ALNLBFDDATV     SIHOWRAEWK      QUQVMQGWKWKJMV  FWPAYXITRGK     PVRJRJYMRALKQES
QRICJRWYXOEIH   : XQHVEQUTJQRR    RHWJXLTNU      
VTWMFJDUD       : JMUMMIQPE       HIOTLINPCFJFXH  GOEKDXNP        FLRAPROXLIBATPE BQIYTARC       
CHJJI           : UIAXHOGXD       VYFDBCLOACCVPLU MNCKXF          EQVPKNDSYHNFJER
UYBFDM          : GNYBBVA         YTPONM         
CLWQP           : TLKFNEILSNINVNW XULRUWGKDGMPT   RLPXLOYPMHBCE   GFJJWLIVIB      HGQDCCCSNHWF   
ALGTISYTXT      : JPJGDBECHQG     MYFOHTKEVE      IPPPWERLIWS     YUVODOEPABXN   
OXJY            : NTIBWQQSIVNNXB 
RJFSMMV         : RFKNOUX         VGYCCIDTDEWCY   DCPEL           HHYCBQE         TRKBYADJ        PGQBQHHUAEBQ    NTLASRAFWQ     
LXLKOESQRYK     : MMSKTUP        
TLVTGVJG        : TMLWTBWKKUEJQ   ICTX            DMFBHHMTFODOQIW WVHPXJTX        RHWJXLTNU      
IQARVTHIRHVQ    : VIAXQKBJGJYIJCI TNCPUU         
HHYCBQE         : NVCHROYNFRXHRW  RJFSMMV         PHWCOCCL       
SAARUIPEOXOGY   : XJRHGS          HBDTXQAN       
EUPNMWJF        : MHFE            YIWFXL          CECYTILARWDCFRP UPKQMD          MHGBB          
SPTXQLCCG       : RKCQUAEDLFMGUVM HQDBVDIOVS      XDCNCENK        QBAQ           
CXYKO           : HVDBOILHCNAJ    MNQHFMHLQCO     KEDUXFWPEM      GVPYNYX         YEFCMIDNCWKC   
CORINB          : HGPPLTTQDKWTPU  CRACOJ          EMUEDWVIXVAD    CJIYH          
KSCXQODL        : WDIWUEORQRRV    TRGSFIQKX       KOBUCVGKCQOQVAU TEOVSCOABO      YVFNLAML        KAPBOBMRSW     
SFHLSJOAOSA     : NRKWHIM        
GQTIG           : WITDGQQGHGYIWTM WNFI           
SVQHHKMFBBKOK   : DYVTYTKDO       QKISJ           LVBYQQV        
TSRPEIPUE       : XNWQTRGI        IYQJDMDXFBHGCD  RGVFHG          UBQAMXL        
LMJFUPSP        : PIIV            TYGQNRV         OMEWLRYULQH    
MYSWLAAM        : JMAIIPIMP       KLLUVNFC        PODWFQQJBS      HWIUK           GTUNRGIBNXAAIF  NGXQRAIGUQWNKCF
OAVKUPABBPWF    : IMAKGJEIPDUSS   NCCGOVGHDXJRRJ  WPDPNIGDCT      GXAKR           DUOPIGXAS      
IRRPOJ          : JXCAOWYJEFK     ETWBBOT         TKKPFHYSPQQPUC  NDXAJGSAE       HKNUROP         HJJRVJKW       
GUWFQTRSTGI     : GJEEKFCYDXQKV   QVDVAAH         HBQDU           XVQWAHFHEL      GDFXHLKK        MHSOGHHKRHFJ   
GEVDWV          : QKYSSI          OTJMRVEAOXTL    FLRAPROXLIBATPE
XOEDYMW         : XCUGJJFRMCWIAG  WTVJP           LPEVLHFSVWJRXQ  SXAILLYWXBDNCUX
CLCMRYKYR       : ESKOWRWSAANOBD  QHIWRK         
QLBAVLI         : CVCV            YJFPDR         
HMAETXSXDRMAK   : RHAC            XFFPTUB        
NOFHNR          : KUBTWMWFHBXLEO  ICLLMESSOUATALK JBQDRBSCJQY     UTYEQJK        
GYXTCXPNISV     : FSINCHNU        EPBUFOLFLATH    HJYVXHUJQRXEQTO VBAFOYV        
SCOSWO          : DAVYC           CMNDI           ORDGKPDPDNHLS   ALIP           
QBVDRLRXSFRAN   : JGCVSPJJQ      
AHSAAJI         : JWPCPERCE       VIXFADITUWYHNL  GSAXHAMRBML     NDXAJGSAE      
HEOJUHIKE       : SQGWEMQPTRB     LPEVLHFSVWJRXQ  CUEXVMLANBICNE  XEQFLJG        
NCCGOVGHDXJRRJ  : WQOEASSDTB      POYVGY          KEDUXFWPEM      FSCXSOKUVKF     OAVKUPABBPWF   
MJBVSWDYLMVSWIW : XFHKYYVOY       XWXEVGJPTJSUR   YIBHEG          TIUYHIXGTQHQNTG JCEORBKF        RSPRNF         
WAAFQVNXCNIVH   : XDWHIB          CUVCBPX         TKKPFHYSPQQPUC  FBRDOPWMOX      QRTHHMPFTP     
WUGBQYXUA       : NKRPET          QFRLGWRJYDPUSIV JXVHSDNNPANKE   DSGQDCYXCT      TXNDTOQ        
JXCHHCFGCGNS    : PFTMKPJDIXNBMX  TLGB            QNUYMO          PTNKFNGXYAXKH  
DSGQDCYXCT      : GTWDCLGJOKXJTMY WUGBQYXUA       UFNK            HCEUFQIRQOOJYB 
DMFBHHMTFODOQIW : GBISKQQSUYGN    IRNBGDIU        TLVTGVJG        QVDVAAH         XQURDFWKQHVU   
QKPVN           : OFHWD           KFBNGXRLEE      XDCNCENK        AMABMTQPI       JGCVSPJJQ       AWVYQJXDYL     
EHOJGMNCSQQAT   : QFMOHCMLS       EVPQONEFOATECAY DIFETWVYDGEOJPB OLHOJ          
HGUPWXEQGEN     : UAVHWAOSHR      IAUWC           IXUVQYOHJDWFSWF JOMLSQK         GASQVBDAH       OHLBQGUGADY    
OEVFPCMELUTY    : KXBP            AJMHPLK         MHRBCWU         VNFYEIO        
ORPPNQWTLOT     : BRMFJUWPLVPFE   PMTAIMQULKU     YRMDKXMEKYX     KOWRUQAL       
TMSAC           : BUJK            DFLMMURNDWEERL  OABULF          TUOYIGAFHODRRAL
OGQTXSIFHDB     : CQKKCYCUEHBV    SRNURAKCVFP     CRORG          
EPBUFOLFLATH    : GYXTCXPNISV     RGHSLGCT        NNSMJPDKX       EEKDSXSNMCFPME 
PTGPVBHF        : TDESAJ          TYDRRMBHQJUHMA 
DFLMMURNDWEERL  : DYVTYTKDO       DAYWCINAB       SRAOEIBJWCIUBB  TMSAC          
FSHHNOTDK       : KRUHSB          JMUMMIQPE       FHKYIQMG        FEPQVENVNW      OEMLQV          VTTLIUUO       
VIEDNXGVLSIGN   : FTUPROIQ        EVHLTOKFUYYAKQ  CQKKCYCUEHBV    GESEOU         
KKFQE           : IGYVLJYIOV      DUJROVYBWKCIEWX VVXXPT          TEVXOJQL        GRGONXWXCKOPD  
MJKTRAKNFUPBE   : NLTOY           HWOQVVIPI       ANHYRCVNBAFKLD  FDDIDPORA       QEJSPTIDBBTNT  
GTUNRGIBNXAAIF  : TITCKUOINDONXJ  MYSWLAAM        VSIYLJUHM       QBXIOGPKTS     
MXEYKASK        : DAVYC           QNSSGACDFEPXK   GRXPVPBW        LNRFXGPSIXQIHVC JLLSTNTU        FQIPMMLH       
GSGX            : OGTCRQ          XVXWOCJHLSDQEJT
MUDJPS          : OXSPFVFFPUAQ    LJCQLALK        WMMYDMVBDY      QTJSKIQTH       FGQEEQ          PJOVRLURGAICJF 
XDCNCENK        : SPTXQLCCG       QKPVN           GYRJXHUQX      
FAMJYWJRKWA     : DAVYC           QSJAVE          DAYWCINAB       LWTWML         
EXYSUECMWEL     : OCTYSFF         NGPLY          
IYDPNNBS        : MNKBQYBUOYQC    TUOUBVQRUBF     GOEKDXNP        RQQU            SSYXQUEDWTXVMOI VYFABVWDXMEOKR 
NEONPIXN        : VDSNMACL        KYDLYPTIA      
DTJEMEJ         : HOQUCUPNVPUKVUP IKGJHYRIMV     
RGVFHG          : KVXPIYANOUYDSAL TSRPEIPUE       PJPX            SFEE           
KVTBXOQNSIBLSB  : CODBG           LCIDU           IUEXNF          YAKHPNHQOKRGWWE
EGSNLHTUYLBWSLE : XVLMJHVHCI      IGYVLJYIOV      RXCEKYGJMVH     NPONBMLBOKQDBE 
XARBAJ          : VIAXQKBJGJYIJCI
QEDTPXXQCELPP   : IJGFE          
MKUXOSTAYR      : AMQNAUQ         FNJIWVRCQUKN    EEPUYYEA        WNUTJAANUW     
BLACUUUCAORX    : WQOEASSDTB      GFDFTDBHFGGKG   VJYRGYOIVPDFXHN GGAEPOD         LQHHUNBEDSP     OEXT           
JBTUSJQFWMGLF   : SWTLDGJHM       ATTEIQIQAXX     PTOGPWAKXUWNAT  BBWNLPIBXYNG    UEFEOQ         
NGTNHHPLF       : DEBYLGTORBDX    IOKAEJLKAYWQEG  LWGGOUHKHVGST   IWKLARUIJO     
GHMXYN          : NBIMODDW        BTEACRQ         TLGB            XJQGABNTNN      HWJXUNPGVGNYEFU OPPLXTUSPFX     LFSARJIYUIV     XTLJQFH        
GHMXYN          : SWRWEPSJAOX    
KQGGLSYRRLAF    : RACMVOSUTIICIG  OCTYSFF         EVHSLKN         MKXF            VYFABVWDXMEOKR 
CSYV            : TQRGASYJNTP     OTJMRVEAOXTL    OAWOIHMTDTHMMK 
HFYUKLCRBCTQO   : NKTD            PBOMXPNOMTFVLD  XVLTGGXBO       PTAJMXAMXW     
HXMS            : LSDCEAR         VHQUIYMGX       BCJECHRHLRIGGCE
MMKAOPTQKU      : XFHKTRDMYUS     LKSPMR          YBDIK          
SEWTAHGEAJGVAW  : VOOGPSYEQECJQBN KMCFYFTQYW      XYUGXMNLKU      OGGXRBSYUVU    
JWPCPERCE       : AHSAAJI        
RACEXSXCPREXAIA : MNQHFMHLQCO     JXCAOWYJEFK     TIVWEDADD       EBROPPNY        CKVHNOFERDSORT  GRBTMCVASNNUSDO
QVLQXUNPAGT     : DRBI            ARCBMWAIYYQU   
IBCD            : ARLN            AEQD            OOHDPPHNTGURD   QWJPH           RXCEKYGJMVH    
GHBAHEPCK       : JMUMMIQPE       CRWCCXBXRJGERJ  EBYJOMNCKM      PMTAIMQULKU    
EVPQONEFOATECAY : KCYLEWQNYOOH    EHOJGMNCSQQAT   BEBGSSA         DANESDFUFWS     XYGMSRXBXGRL    IVODWI          JGCXBLNYDJV    
IACNDJVFJF      : PBVH            CEBPNQWFRFIFI  
YHXROTHFLXJQ    : LWLQRMICDGV     RMMORRUK        EKTXJKTBVOPAI   TDNJMC          SWJAHDNDEQWKS  
LKSPMR          : EKUFGPHDN       MMKAOPTQKU      GDFXHLKK        MCOJTO          TBDHGSBQFSKPSJP
VTQJAAHHLPUM    : JBTCYELQEVP     AJMHPLK         VYFDBCLOACCVPLU NTLASRAFWQ     
SENPOSBMFR      : HXRVPTJCXFSMX   XOPQYTUSGUUDW   NGMGGVKCOIW     BMJWQVJW       
QFTH            : BBWNLPIBXYNG    HRNWOOHI        FBGJSBQNACAP    UAYHIM         
OWPKN           : HWTUKRCNANT     GSOXRMDMHQTULD 
MPLTBB          : IGRFJO          QATXDPDNLBEKFB  QTFMOYXYWUQIGN  MJSEY          
QBKUO           : ESKOWRWSAANOBD 
JIFX            : OPHAENN         JBQDRBSCJQY     NDXAJGSAE      
YYGET           : GWFO            VAFW            LGOJAVKSIJSYT   WEDPEN          FQIISGEPLIE     FBGJSBQNACAP   
WKNOUBQITD      : EOLAKPVIDBF    
WEVNFGJUKUF     : OCGMFSXEVAAB    VMBUWOFAESRMT   TMHP            KGEIPWGTNOIY    KRQFEXUKQS      EHUK            CHNTPESDCLS     FQIPMMLH       
TUOUBVQRUBF     : STXCGF          IYDPNNBS        RDOV            OOVOXA          TIYT            TVENLAM         DLCSLAJIROQ    
YIBHEG          : MJBVSWDYLMVSWIW BEBGSSA        
CMJP            : FWFEJ           ROKOJFXUHF     
RBRCYWTSRJ      : LQXOYRSVUYATCHP JCCXKXRK       
UHHOCIT         : PCBIBJDTSLOL    OQBIHD          EAPPFBFFVH     
HFOQ            : ORBXGAYS        POYVGY          IAUWC           MYXFAYWDJGRITV  FKJQAYTRDF      IMHBHXEAEKD    
UFNK            : DAYFBWSJ        DSGQDCYXCT     
GFJJWLIVIB      : CRVN            KSTQGLQAGQVSTCE DUJROVYBWKCIEWX CLWQP           LRLXYWM        
TRKBYADJ        : DCOCCOEYVPIDJXF GUQNIULSRUPCWH  EEDLHCYMS       RJFSMMV         HDGJ           
ORDGKPDPDNHLS   : PCBIBJDTSLOL    PLNAAQRWVV      MTJVBTRHPIDSDWG SCOSWO         
VREEN           : TGRBUOA         HIOTLINPCFJFXH  GXJVQYYOGDU     MYXFAYWDJGRITV  TUTMOW          FDVXYJC         MDHMONG        
IDICOJBQOMOG    : SKDCXHAHSTWDYT  HCEUFQIRQOOJYB 
SMRI            : TITCKUOINDONXJ  VIXQD           VTTLIUUO        MYFOHTKEVE     
JNGQABJVT       : CKNMSH          MYXFAYWDJGRITV  VWPGQJUW        WKDIOWVDUULGNUJ XKYHAUKTEYI    
CHFKLOMCAPURD   : EVLSFQ          ERAENVJMDKMSCAB LRCSUPCQJLLFLDY XVPQNJAPXTK     GXPLXJURH      
XJCMBMENBKE     : PDLRUSH         UCLCNLM         TMETIXLKLMHTJ  
OQBIHD          : BMGGPORJS       SLCWIO          UHHOCIT         WVHFBMFFIENELVV KMSLOGHFXPA     YUVODOEPABXN    NPCBMEPFHPFFXNU
MOFD            : CBYDYU          BMVQJGOHWBV     PTAJMXAMXW      NSOQAALSCLJW   
HGTCXWMXIQKMEO  : HIIOLKAMUVO     OCTYSFF         SVJYXTIFHNSKFS 
HCGKQWNBGQSTH   : PIIV            DPOQFFWOTIPGH  
YLIHFLFEAFOSPB  : WNHNACJLKFHOLJ  XYDXKURB       
HDGJ            : LYQIVTVMPJXV    CEDAEMUEFHMFE   TRKBYADJ        OVMX           
SCHGFOXXKFYL    : VBLRSYOTF       XEJHEBPRKI      FPGTEHJRXVND    JUOTEBBFLA      GIWVBXJUVACYP   IRKAYRA        
ITAV            : KXLRMVCB       
GXJVQYYOGDU     : VREEN           HHAGWFWYG       EXLDYFPFPDYD   
POVYWBNUCAD     : JMUMMIQPE       FTHDVDCIC       XICWEGEXJ       XKTOEPWX       
OVJKWHNDFWYWWBN : VOOGPSYEQECJQBN WKPUJLJ         LVBYQQV         YSUVUAYGV       TUOYIGAFHODRRAL
EKAV            : OGHSLJXRSKKKD   KSTQGLQAGQVSTCE KNJEWUEMTLSAWWE QTXSXUWGVUOMXG  GEWPELS         NKRSKM          NJHHQGCHXRVAU  
XUYAJTEL        : HQWD            XHDTXSKYM       VMVRJL         
FCTRMSYBV       : IPQLSUW         MJWI           
XXEWYRFFC       : MPUW            TNDNNELVVOQV    GNYBBVA         BEBGSSA         RAAQHLQNFHWWX   QFGLDEWJMDI     GXFNPANWB      
BEFVD           : CEDAEMUEFHMFE   BXDALTO         GIEWNHEALWYO    IJQPRYKCFDIXMPW KYDLYPTIA      
HYLVYTXSLNNM    : EQNAMPOLFRJPHWD MHSOGHHKRHFJ   
JTOHAOIRVNWD    : KHNQ            DKNIUWHG        CHSVSJJBBC      VJWOA          
DKNIUWHG        : BUIKOPQJWBFSC   EQNAMPOLFRJPHWD JTOHAOIRVNWD    CUEXVMLANBICNE  IPCHJTACKUEFURY
GCRB            : MKWAAUFJQRFRQM  VGYCCIDTDEWCY   DAYWCINAB       AYYNRIVNVWTAPL 
HODVBWMKXDTRYJ  : UYBWSNCBP       TPOPK           GQXTRRAEPRDCI   LVBYQQV        
EBTP            : FPGTEHJRXVND    HWTUKRCNANT     FDAGYTQOBYFAUJB AKTBYQQYSG     
CKNMSH          : ECHF            NVCHROYNFRXHRW  JNGQABJVT       KVOIFATGQ       XTPFSIMYKI      SGIQ           
VBYLIPOGQOSCO   : CBYDYU          PNLMFAS        
VIXFADITUWYHNL  : KSXRYKPXKLET    AHSAAJI        
UIAXHOGXD       : ILCYRO          CHJJI           ILVNMTODCRUKM   GSAOODFTVRMP   
QTJSKIQTH       : MUDJPS          SEHJSR         
TMHP            : CIAKLHIQ        WEVNFGJUKUF     HWTUKRCNANT     KSBMPTBPY      
HOQUCUPNVPUKVUP : VODDJREFYLN     DTJEMEJ         EJRLVCKSVD      XPNL            DGAPEXAPVMKV    HTDJGDUAV       RMMORRUK        JTEVSFPLIAU    
MMTHWFYQMA      : DVBEWBSNP       LCLTKFJ         CKFOWOLXMDYH   
BHDMOTDJY       : HUJA            AXIDIUXCAJBNRGG LPQAWA          OTSURPA         PRIUJBGKRFVD   
BMVQJGOHWBV     : CIFAVKPIESS     MOFD            TXNDTOQ         QATXDPDNLBEKFB 
XDIDEAREOUMTHD  : RCOMHRFLGWK     PFDJADIKLWNK   
KPPKSCHMNPDUOF  : XDWHIB          JOMLSQK         LBTDKURYMNLFH   AXBEGLKPUJJGVG  RPINHNGPB      
XDWHIB          : WAAFQVNXCNIVH   KPPKSCHMNPDUOF  BMISFPMCCB      KDDHPURHLHEPCRA PTVYDOG         FAWEGVYLVTCCDN  HROYBNLVPY     
CGXWUUEXJQPBD   : LQREMBOUCPVVLKN MDHMONG         CKXNR          
FMVSDY          : CMNDI           LVQLULG         WKDIOWVDUULGNUJ
RGHSLGCT        : GBISKQQSUYGN    EPBUFOLFLATH    AXIDIUXCAJBNRGG FDVXYJC        
LVQLULG         : CMNDI           WUBLOT          NERTAUF         IRNBGDIU        FMVSDY         
LRPCUVNAIJTLKMG : PDLRUSH         IYYUTHGMIAIJM   ALWG            NUYGJQHDBBY     LHOUYTNVT      
VYFDBCLOACCVPLU : YVLV            CHJJI           VTQJAAHHLPUM    QKYSSI         
FNFBJSBTEWIRJO  : XCLNGWYBK       LPUFMAHDCMRINN  FBVBYMJUBVLKY   UXQHWEOKUJOS    KCGCCJQITIVWSKK IXUVQYOHJDWFSWF TLYN            MJVAUY         
IPQLSUW         : FCTRMSYBV       OOVOXA          RMMORRUK        AXBEGLKPUJJGVG  NUYGJQHDBBY     MHVM            RWOHBMJMVFPAS   REILPI         
VBLRSYOTF       : WDIWUEORQRRV    LVANVCQT        SCHGFOXXKFYL    GJXCVM          VVOANOABDYCXVME
CGNWJ           : PYELSPRWY       FWCTXBC         MYBJS           FTHDVDCIC       PJVUXWGF        NUWQQVWVCHQDU   YTESD          
CHSVSJJBBC      : QFRLGWRJYDPUSIV LJDKVGWTBDDUF   DUWNBYQQIEVNEIL JTOHAOIRVNWD    KXOKVJT         FFNATKABSPUP   
TXNDTOQ         : NQVCXEDLAPSR    AJMHPLK         WUGBQYXUA       BMVQJGOHWBV    
HQCEXHIEWFNHJWC : LEOLKQCHP       QRKJDBPS        YTEB            ALVCWJVKLOELW  
SLOVMRLIRYNLQFY : NMOOHWRVCWXVGXD NPGNATJF        WOPE           
XDEVKMCIURPEPS  : HGPPLTTQDKWTPU  GPWRMRSRLOUI    ROVSNSCYPCNEBQR YQNBTIPOVT      VLPKFL          SFNNQEHOIA      DUVGGNSM       
KGDIT           : HPSX            DWQGDNX         RFPBQASMLD     
TEOVSCOABO      : MPUW            FHKYIQMG        KSCXQODL        CLDMSTNS       
HVVRKXCHRUM     : FGPVIAOFSCRVK   DYKOFLFTRB      DVTAHYTFJUARUOB FDAGYTQOBYFAUJB
NYTVEDR         : NDMCOXHDB       QFSRILLNHUD     OSRCBFVQASXVTD 
YWQWR           : YQNBTIPOVT      TMLCEWV        
NRWFREBPW       : UHAKPYQHJYT     GSLCKQFTILB     UCLCNLM        
PBVH            : TDESAJ          LEOLKQCHP       CJAXB           LGOJAVKSIJSYT   IACNDJVFJF      GNAWHHG        
KRLLLIPQARSY    : KUWA            TUTMOW         
PQFEICJCJMR     : FKERPNYUJY      NPGNATJF        SREBWPGLRYYT   
CHJAPGKHRVUAO   : LVHXUKFNOWD     SCYCSWWGJCVQH   TNDIOH          HTDJGDUAV       XEWNEPMB        SWRWEPSJAOX     TQDKGOKMXFBXGRL
DIFETWVYDGEOJPB : GOFXUYKIK       IFOOPVVFVLCMJMK EHOJGMNCSQQAT  
XEJHEBPRKI      : LBNMKMDNIXUSV   SCHGFOXXKFYL    AHJUQHXWV       IPPK           
FKERPNYUJY      : YKJA            DBLCAYULF       PQFEICJCJMR     QWPFACE         GWLYJQRJLBGPSX 
JCYPRIFUMFYXOGY : DAYFBWSJ        GSOYS           RWOYWALKSQW    
AJPPQAWLQ       : TMLWTBWKKUEJQ   POAFSGOT        TIJRAIMBJCRM    COVCXQSFO       DJPOQNK        
KNVJEHOFWGO     : HGHCRAQLJKOGAQY PGIGCLM         SOMORBAYFSYRQTL LCLTKFJ         RRFCXVWCTGUYWI 
BBLDBBLAGNL     : PCFOHWGX        GCMHVRISVXP     IJXJ            GSAXHAMRBML     KGMMLOUR        KYGF           
DCXC            : NHHRPYWNT       ERAENVJMDKMSCAB IAUWC          
QOBENMKUD       : UNQCF           TEARXDASPPD    
UJHBNKNSLOG     : AWVYQJXDYL     
WTBUYDUCTMSWSG  : JCYSYUYFBFEIJQ 
EEPUYYEA        : GYFSYEMTTUFYWN  NSJMVOLYMD      MKUXOSTAYR      IVHNAISOFW     
OPHAENN         : DBYNKBMGRYDH    TGRBUOA         JIFX            ESEWVGY         OHCQDYCFVI     
JOAJTVNPKIMD    : LJMBRI          WSBBUDUMWWMU    UOSFFTXODWIDGI  BXNHIIOVLHRG    GNFRF          
YHVOEUPIWFY     : QVDVAAH         BQEQR          
OYTF            : HGHCRAQLJKOGAQY ABVVFSOSKBCRKX  ITCISSGNUXIPB  
AQFAACV         : XIBAMDBTXPNWTI  URLLTF          KVXPIYANOUYDSAL VPPCUH         
RGYHMQIT        : LQKUD          
WBJOLGV         : HSGENRPQKYYHQJM YKPQBAPCKJOWK   WQKUMTUSUPJQ    LDIMJBSMIBQBFF  TFOKQODVODLGK   CESJNPIBNDDR   
VLMQSCSJJSM     : CHBHCAOPWIMC    KUYTLGYCXJ      KYBGETQXLFNWGQN
RCEADL          : HSVDPCRDYGFRNAD PDLRUSH         SQNGJLB         VJYRGYOIVPDFXHN TMETIXLKLMHTJ   IUYC            GSAOODFTVRMP   
TTJISMRHXBGLY   : NHGFWFGGXDER    HLDCXKXRUU      RQSEOHB         KLNHMLRGPJ     
YRMDKXMEKYX     : NMEYW           JXVHSDNNPANKE   ORPPNQWTLOT     PJVUXWGF        XXVMGHKCNOBJ   
FXSSLPO         : ONPGXWGPVLBQDVO PDLRUSH         DIXYSJMOTJOOK   SSMPUQBK        MNHUMEFL        EKTXJKTBVOPAI   GIWVBXJUVACYP  
AHJUQHXWV       : WOFL            NYWPUDL         XEJHEBPRKI      JKPPLXWLOR     
QWPFACE         : KSFCBNFGDPJ     FKERPNYUJY     
GQPEI           : DBLCAYULF      
FEPQVENVNW      : XLEQVXB         FSHHNOTDK       XPXSAR         
FGQEEQ          : SWIO            HIOTLINPCFJFXH  MUDJPS          FSAGYE          KAPBOBMRSW     
BGFDILSRDKXLID  : VMBUWOFAESRMT   ECCOTMUM        RIHAUIPJ        VIXTIDJRTIDRLW 
XVNDLMQKFXTYDXP : SJSYD           ELYTTXSPGR      EVVAYBX        
AXIDIUXCAJBNRGG : BHDMOTDJY       RGHSLGCT        ELYTTXSPGR      TGCIA           XUDCUQXWOJUBXLG
FTUSGOEMOXL     : TKEJDHL         GUGV            PLUUAFS         FABHRPMQYFCL    LTMBMVHFX      
VDWXBGCJBCMD    : XVYB            FSAGYE          OOJJUMVJKPGBQTG
PQFXWXDR        : OCTYSFF         TYGQNRV         CPXVPRV        
WALDOBDCU       : RXDRHFB         KMCFYFTQYW      YVSIBNEHTRC    
FSAGYE          : LQJSD           NULMVXIHUJ      FGQEEQ          VDWXBGCJBCMD    GTMDDPVRGB      XYGMSRXBXGRL   
CIFFUW          : XNVAHIAWJV      DLOJF           FAWEGVYLVTCCDN 
CUVCBPX         : TMUOP           HQDBDINR        WAAFQVNXCNIVH   XYDXKURB        CJHSNUVNKLRM   
PLDFMIHIJ       : NSJMVOLYMD      LQXOYRSVUYATCHP GYRJXHUQX       HJYVXHUJQRXEQTO
DLVCR           : KCYLEWQNYOOH    GFDFTDBHFGGKG   NXMDEHVT       
GBVNXS          : FWCTXBC         XLEQVXB         RLWNQQGGXLDLE   MJWI            DVOIKTQ        
AOJDRYDRPQ      : HEKKHIKIKPAYUAM MHVM           
UEFEOQ          : JBTCYELQEVP     AWBDIKIDEEFOO   NHHRPYWNT       JBTUSJQFWMGLF   FPGTEHJRXVND    THAQMXHVAXBBAHW WTOBEKUFPP     
RDOV            : TGDPSMSJKPH     CKLVLP          TUOUBVQRUBF     VPPCUH          TEVXOJQL       
FEXCRVUFW       : CLSDQO          YIGPTVDJUGE    
PCFOHWGX        : FIQF            BBLDBBLAGNL     KGFPJGMORV     
BEBGSSA         : BTJSRKW         ALNLBFDDATV     EVPQONEFOATECAY YIBHEG          XXEWYRFFC       TPOPK           MJAV           
XQGUWKTBEPXMOM  : XPFMCPTW        GCMHVRISVXP     QWAJKUSF       
SRSCRADLDH      : IOWDWAFSONOBQ   TVENLAM         ACXIIKOENSME   
LBKON           : BMGGPORJS       BYVVQ           JCCXKXRK       
FWFEJ           : KRUHSB          XGOSYKJDJQX     CMJP           
FOREDISH        : CGGGEHGHTYD     POXVADBLIFMODEB NOSBT           DUOPIGXAS      
KCGCCJQITIVWSKK : AMQNAUQ         FNFBJSBTEWIRJO  SMFPDRVPBOPAI   MJWI           
QHIWRK          : JIPA            JDSCGVFQMAO     CLCMRYKYR       LHOUYTNVT       NTLASRAFWQ     
ICLLMESSOUATALK : XHPES           RBPLFILTOIDITOX NOFHNR          DEORFLWBNIAQ    DJPOQNK         NSOQAALSCLJW    CKVHNOFERDSORT 
HSGENRPQKYYHQJM : NBIMODDW        HPSX            WBJOLGV         FSTJJDWMUX      IMHBHXEAEKD     BSBSPNBVIGLF    DHUT           
NXMDEHVT        : DLVCR          
XPFMCPTW        : DSSTR           QPTUW           VOOGPSYEQECJQBN XQGUWKTBEPXMOM  LITHRNF        
YKPQBAPCKJOWK   : LLFLDMOUYCXXW   HCNTVBNOUF      WBJOLGV         GHVILDGEGVCI    CJHSNUVNKLRM    UCWSOEJLKSM    
XAHCH           : SOHQDIBJIYWT    DYVTYTKDO       PCXEKKT         SQNGJLB         XGQX           
XMENR           : MGUX            FTWRCLWCIVORHT  TIJRAIMBJCRM   
PJNM            : POYVGY          SOHQDIBJIYWT    NULMVXIHUJ      VEFDWKFLPX      RPLJGDYRESMWIS 
MYXFAYWDJGRITV  : HFOQ            VREEN           JNGQABJVT      
TELDKLQQCKITWVH : PBFPPSLUWW      PTOGPWAKXUWNAT 
KGFPJGMORV      : GHLQRQ          TIKUL           PCFOHWGX        FDVXYJC         LFSARJIYUIV     ILVNMTODCRUKM   LDAFHLAM       
BRELLKYQWLJON   : BACPIICDMICKSDH TIVWEDADD       RCOMHRFLGWK    
YHTW            : OGOGG          
BHAGY           : UNRMOHU         QNSSGACDFEPXK  
NNAFLIIDOWQAVI  : WTECVPIHHTISPW  SALDJFLCWK      TXVVWVVYBCSS    NYWPUDL         JOHLRJT         YTCHMQNSF      
HRNWOOHI        : CWSNV           QFTH            IJGFE           DNSCXJSD        GMQTJXQANOTUCIN
ALUCSTNIKNPVVBC : XVYB            MEJSQRMCB      
XSNT            : NLTOY           SRNURAKCVFP     QFDUTKKFFJKKCDU SJUHKK         
OETFDKTMVGNH    : BHQEUDFEXDETPI  FXAJFNNPMHCWWKR ACKTAPYXPQLJAUR
PCXEKKT         : JQRHSFRXYWF     ECCOTMUM        XAHCH           IXFB           
ISEKGCE         : CNXSNVBIT       DCPEL           DIYOQVITUJYBHVG
XFKCB           : INTR            UFOBGKTW       
IMKUKSKRVB      : HIIOLKAMUVO     CGRID           EFEKYBCWG       YTESD          
VHJGDMPVS       : RKUYECC         UOSFFTXODWIDGI  VBGIFIGBRPNN    UYSHL          
CUEXVMLANBICNE  : HEOJUHIKE       DKNIUWHG        JYMORTLQSNKDGUQ
GQHDRGYBPIFDXD  : HDPMMDYSBEH     EVVAYBX        
XITFGPRTRHVB    : EPAPUNVJVB      GDXEWHUVS       NBLOFWOR       
JHBSXKVS        : LWKOEIFRIVVW   
WVHFBMFFIENELVV : IARHFKEXS       KXYVCSVYQ       MTPW            OQBIHD          OABULF         
SOMORBAYFSYRQTL : XTGMNKGVL       BYTK            IJYL            GQWXRIKKEPDOKX  CKLVLP          YJHDTDTRVDIQEHR KNVJEHOFWGO     NUWQQVWVCHQDU  
SOMORBAYFSYRQTL : EJVGYUTJQTJMF  
QSVRHEY         : CLDMSTNS        JGCVSPJJQ      
KOWVNUBGJPWBR   : VCHUMVYWFR      GCMHVRISVXP     XPTROGCYVGTGC  
CYSE            : BVFEQ          
JXCAOWYJEFK     : QGDGRMI         FABHRPMQYFCL    IRRPOJ          RACEXSXCPREXAIA DVOIKTQ         HJJRVJKW       
PCXLRSOXDEW     : QNSSGACDFEPXK   ASBSNRTUJJPX   
XVLYOPQBN       : HLYFDYD         RXHHSYWH        TEARXDASPPD    
DFSEOYJ         : YTOPAEAOWWSVDY  HVIS           
XYDXKURB        : YLIHFLFEAFOSPB  CUVCBPX         QGYRIN         
WITDGQQGHGYIWTM : LCIDU           GQTIG           ABJOTLKELO      TVIWO           TLCSRBSWHKCQVTO
OQSOBVOCA       : SEQRQ           FCBSVEEM        MPCGTLAV       
NUFQSEYMJIDBQL  : NRKWHIM         KYGF           
PVGLIKBCFPFCG   : WTECVPIHHTISPW  SDRGRMOJQ       FKYLFMPREXOOJPY CMINNFGL        TDTPPPTJKGYY    CLDMSTNS        QWAJKUSF       
ETWBBOT         : XHPES           SBRIMISBH       IRRPOJ         
PJPX            : SQGWEMQPTRB     QMPHNLJLRTOIK   RGVFHG          AMABMTQPI       RRWVBODM       
QOCAEYJSJVTLEJS : QLSW            HXRVPTJCXFSMX   WTVJP           MQLLBAPJHJRFGQP OWCVNYGLOI      UBQAMXL         DVOIKTQ        
PBOMXPNOMTFVLD  : GWFO            CKLVLP          HFYUKLCRBCTQO   IMHBHXEAEKD     ALODIYHWNPFOI  
EUNEBOPTXONMUY  : SHMYDDYSDUPM    RJSIHH          UUWMUUEENBV     SPESXPDIQC      YVTJLBESV      
FPGTEHJRXVND    : IRQDKRTASHVOUFR OECCXPCRUYHWOE  IOFTQARKM       SCHGFOXXKFYL    EBTP            UEFEOQ         
BJFFEUMFJCCJS   : IARHFKEXS       MTJVBTRHPIDSDWG QTXSXUWGVUOMXG  HSWXIQX         RQSEOHB         AHTECQS        
VPPCUH          : VIXQD           NMEYW           AQFAACV         RDOV            EQSM           
OLTYFSW         : XUEVJIMXLB      BWSDU           YTEB            PNSVPQRFBDXYXK 
XRUHYD          : LLFLDMOUYCXXW   KAMNTFCKEFSY    HTDJGDUAV       NEJY            WJAUGKNA       
TPVFTXONNNDFRY  : ESVRUHLHOWXCJ   VOFAUD          LCLOHHSUUVCL   
ENAYOGTMCREYCDC : SCPI            AFHLJGXFNOH     HKNUROP        
YRNEMLUCC       : TSYSDYVMOE      MJWI            IJARY          
HHAGWFWYG       : QFRLGWRJYDPUSIV GXJVQYYOGDU     CKXNR           NYJKD          
FAAJTELXJNOIICO : DCOCCOEYVPIDJXF
QKYSSI          : MAIUTOPGWGQK    GEVDWV          VYFDBCLOACCVPLU TCNAKIHOJYNNR   NDXAJGSAE       IWOJ           
VRBDODJCILFUHLG : OJWDWEYKUNVMY   YKETR           UNEXCIGWWMHGLD 
VVWGEB          : OWLFHGJYGVKR    JJISTNS        
DRGEMBNRYFU     : PPECXXRBW       FBRKGLKRVDRXRP  RNWE            UWSXVPPINLI     GXPLXJURH      
VXNAJBFEJRMRNIO : CODBG           VXMPTAAMPVP     WJAUGKNA        CJIYH           RSWAKKJWB      
PPRSKXX         : GKASUINA        WIMNMKR         RPLJGDYRESMWIS  SYSPQUIA        EFHIRKDSDSHH   
CLSDQO          : FEXCRVUFW       ESVRUHLHOWXCJ  
OOVOXA          : TUOUBVQRUBF     IPQLSUW         XLDD            YTESD          
ELMQDCCRXRJQKV  : PCIQITPP        IAUWC          
IXUVQYOHJDWFSWF : JRWEUCWVPW      SCYCSWWGJCVQH   HGUPWXEQGEN     FNFBJSBTEWIRJO  TGUJCIOAUAJVQOG VGWTG          
ESEWVGY         : RKDCSVKEMJDW    PMTAIMQULKU     OPHAENN         ULPSWEX        
GQCYEXSOV       : QBXIOGPKTS      MVHBHJFEHDWMH   HOEAGLXECGMRW   MDCRYCRAQJIOYHN
LPQAWA          : ATLCMSQD        EFLPLI          BHDMOTDJY       XJSER           NHXSKXBEMGOARJT
TIYT            : QSJAVE          TUOUBVQRUBF    
OXJSWF          : DUPCTUTV        LDIMJBSMIBQBFF  LJTOUEAKSW      ACKTAPYXPQLJAUR CCMD           
WVHPXJTX        : CIAKLHIQ        WUHERKLXSERWVFM TLVTGVJG        QVJX           
LWTWML          : FAMJYWJRKWA     IOJK            YVTJLBESV      
LNDIVCCMQCV     : BYFUYJKTMPCEC  
YBKVYUOY        : JUJXFF          UKMNPH         
KAIVW           : QEJSPTIDBBTNT  
ULPSWEX         : HVIS            ESEWVGY         YNPWSHKSPBGBJDX OKGOIURXVULPI   BUQDGJEYJEF     TQMADWOIVNSB   
ABJOTLKELO      : BQEA            MAIUTOPGWGQK    WITDGQQGHGYIWTM RQSEOHB         YPBCQLKHIGM     OXUGCJTVAFBGDU 
JPLAPRLRCJQ     : QVDVAAH        
FCWABDXHGBS     : XSVGGVJRB       PGQBQHHUAEBQ   
VFGCSWUEM       : XQURDFWKQHVU    IUWUILHFRU     
FCBSVEEM        : GJEEKFCYDXQKV   OQSOBVOCA       NDXAJGSAE       SPESXPDIQC     
JOMLSQK         : HGUPWXEQGEN     KPPKSCHMNPDUOF  SBYCXGESCPLVA   TDTPPPTJKGYY    SCTE           
WNUTJAANUW      : KODVCYJT        EQXXRIQYLS      MKUXOSTAYR      RJSIHH          RHAC            GXMDQ          
AKSH            : ECCOTMUM        ICAVMIUKBWDXHQ  GFDFTDBHFGGKG   VGWTG          
VCLCGAPSR       : OXSPFVFFPUAQ    NJOKOMORVBWLD   URLLTF          FISNOFXWPLHCDJ 
EKVQMUFHOQKP    : NLTOY           HBXUSC          RPLJGDYRESMWIS  FKOJVVFLSBAE    NNSMJPDKX       GSAOODFTVRMP   
FOQHBLQSJUGMCG  : VXGLOSHRERNCVV  THAQMXHVAXBBAHW VMCIL          
WXHBIFUUAAFPSP  : NGAWKSAE        WQOEASSDTB      KXLRMVCB        UFUKKGWEJ       OXUGCJTVAFBGDU  XKYHAUKTEYI    
AWVSH           : GJEEKFCYDXQKV   QRKJDBPS        HYXIDIEDBDDQVQ 
GASQVBDAH       : IWOULBNTBKYWUJL HGUPWXEQGEN     IPCHJTACKUEFURY YNDQPFK        
WIRASWUQXUVPQ   : LLFLDMOUYCXXW   QTXSXUWGVUOMXG 
WQKUMTUSUPJQ    : DEBYLGTORBDX    WBJOLGV         BIVGSWC         MJAV            KASRA          
OQBYPLQPEPLUP   : NGAWKSAE        BUJK            OAIIKEERNOE     WUBLOT          GCMHVRISVXP     MDHMONG        
QFYGCSRAFLUAINK : ABVVFSOSKBCRKX  ATTEIQIQAXX     GSMGKGXVMF      LRLXYWM         WARIRI          NTLASRAFWQ     
GYRJXHUQX       : SURKMHUBGVQ     CVWFLK          TCWOXJIFU       KOBUCVGKCQOQVAU QWJPH           XDCNCENK        PLDFMIHIJ       GHVILDGEGVCI   
GYRJXHUQX       : LAGQ           
JJWYRQHTWJMOLRD : PRWSNCSGY       GEWPELS         QGLNIGXTSIRJU   HLTWVMDOB      
RNWE            : DRGEMBNRYFU     VTPIOSFD       
FGHPGPMXPO      : LAXN            HLYFDYD         MVHBHJFEHDWMH   WPVDUVVAXJEOUEJ QEJSPTIDBBTNT  
BMISFPMCCB      : XDWHIB         
NUYWPMV         : AMQNAUQ         CTPVMWXPA       NJOKOMORVBWLD   WTJV            JKPPLXWLOR     
CCCKTJCGJR      : MKWAAUFJQRFRQM  FGFQQCQLPXGFWF  SDCYQWABMBOVN   IJARY          
SSKBNRT         : QALVXFMHPYLVAQP ADEDYEXXWNOUVR  XBXHMIHBJVTYDTE
TVENLAM         : RIHAUIPJ        TUOUBVQRUBF     SRSCRADLDH      CPSVXUYTR      
PAHLCL          : WUIFHV          HBXUSC          HQJTFIGDO       WJAA           
OFXQO           : VDSNMACL        XBXHMIHBJVTYDTE RWQEERWQVO      IOBEKPOMHOJAJF 
KMCFYFTQYW      : SEWTAHGEAJGVAW  WALDOBDCU       ERAIHTPLVNLVDQG FLAWLUDXQIFN   
WDBJFPUWPEJ     : EGKMYFUDFEOQ    XAADIRTX       
QALVXFMHPYLVAQP : UNRMOHU         TKWTY           SSKBNRT         TDNJMC         
SOEPTHBAW       : WTVJP           KYBGETQXLFNWGQN DGMVOOPCOV      WFDWQXYDHXUVR  
WNFI            : WADHWWATCRBOI   ILCYRO          EVHLTOKFUYYAKQ  GQTIG          
VIXTIDJRTIDRLW  : BGFDILSRDKXLID 
ERAIHTPLVNLVDQG : KMCFYFTQYW      IUWUILHFRU      LQKUD           HOEAGLXECGMRW   VBAFOYV         RJUEO          
OPPLXTUSPFX     : GWFO            MBNUQSLFR       IFOOPVVFVLCMJMK OABQRDVIPBFV    GHMXYN          GUHXFAEPSV     
QUQVMQGWKWKJMV  : PODWFQQJBS      HYBVG           PBFPPSLUWW      MONRLGESFXY     MJAV           
RPLJGDYRESMWIS  : HWJXUNPGVGNYEFU PJNM            PPRSKXX         EKVQMUFHOQKP    FKOJVVFLSBAE    DCQDBN          UCTDGKYJEHKVMYR UNBYMLPDE      
RJSIHH          : OARTEPX         EUNEBOPTXONMUY  WNUTJAANUW      YREUFAXFMT      KLNHMLRGPJ     
OEMLQV          : KIOAVXBYKRJS    DSSTR           FSHHNOTDK      
PDTFQDLUE       : PTTWUFSCKIUWDGH GCWCPFDIHK      TGUJCIOAUAJVQOG RSWAKKJWB      
YASXK           : BPMJWTJAA       DUWNBYQQIEVNEIL UKHHIVEVPTAST   SBRIMISBH       PJVUXWGF       
UDANLHV         : OMEWLRYULQH    
VCAJTV          : UPKQMD          YOMPRIOFKUFW    IPMEGMQHTFR    
JBFQRKEMP       : YVLV            OECCXPCRUYHWOE  EJVGYUTJQTJMF   TQTMSNLXFQLRUS  TPVFQ          
NPGNATJF        : GGDGXEGCQPRT    EVHSLKN         SLOVMRLIRYNLQFY PQFEICJCJMR    
YREUFAXFMT      : SWKXNHPT        RJSIHH          DDNMY           QGYRIN         
XDCGTVQXLILBAR  : JKVXBHKIUW      UWSXVPPINLI     DQSI           
BNBGKAA         : TBBMWUYHBPXS    RACR            MDCRYCRAQJIOYHN
VFQVKFRL        : FBFU            JBQDRBSCJQY     EAPPFBFFVH     
UPKQMD          : EUPNMWJF        VCAJTV          IVHNAISOFW      NHXSKXBEMGOARJT
AMABMTQPI       : KFQCDUBCSI      QKPVN           PJPX            HJYVXHUJQRXEQTO MJWI            KNBFOKWGY      
YSSYJQFC        : GVPYNYX         QOONCEK         SSMPUQBK        NTUQKKHJPCO    
RIGGOBVBTK      : SBFRALAGI      
KMSLOGHFXPA     : OQBIHD          HQJTFIGDO      
KUYTLGYCXJ      : PCIQITPP        VMBUWOFAESRMT   VLMQSCSJJSM     RWOHBMJMVFPAS  
EXLDYFPFPDYD    : UOSFFTXODWIDGI  GXJVQYYOGDU    
HLYFDYD         : FUGEPETTL       KODVCYJT        NFCVQVYA        XVLYOPQBN       FGHPGPMXPO     
VCKH            : YEPAELMAC       EBYJOMNCKM      AQHAF           VBAFOYV        
JJISTNS         : PPECXXRBW       GSOYS           TIKUL           VVWGEB         
STMIADNBI       : AXDQCDSEMTN     HJQAB           IYYUTHGMIAIJM   LWGGOUHKHVGST   GWLMO          
IVHNAISOFW      : IMAKGJEIPDUSS   EEPUYYEA        UPKQMD          OSRCBFVQASXVTD  ORXD           
OHLBQGUGADY     : CWSNV           XHPES           JTRKTHEDJSRBYIL HGUPWXEQGEN    
PJVUXWGF        : NDMCOXHDB       IYYUTHGMIAIJM   PYVTW           CGNWJ           YRMDKXMEKYX     YASXK           XMPFKHPX       
COVCXQSFO       : AJPPQAWLQ       LCLOHHSUUVCL    FWPAYXITRGK     TGUJCIOAUAJVQOG
TVIWO           : WITDGQQGHGYIWTM LAGQ           
UWSXVPPINLI     : CHBHCAOPWIMC    HXAKI           DRGEMBNRYFU     XDCGTVQXLILBAR  CJHSNUVNKLRM    YBKPPNCDPROIWP 
RPUVFSBFKTK     : DVBEWBSNP       TPVFQ           NNMWX          
QGWBEOSYLLYK    : MNQHFMHLQCO     OAOOWVGF        NNFW           
OSRCBFVQASXVTD  : JJFXEDOLKUDAH   UFUKKGWEJ       NYTVEDR         IVHNAISOFW      MDBGMUKIDIGK    XMPFKHPX       
PPHH            : OJWDWEYKUNVMY   WOFL           
GIDUDEHR        : JLICHIUGDSOBPF  MEHIBARVMURIUH  VVOANOABDYCXVME LRJUVKNXFMDG    NNSMJPDKX       MCOJTO         
TUTMOW          : VREEN           KRLLLIPQARSY    MJVAUY         
VSIYLJUHM       : PIIV            GTUNRGIBNXAAIF  LRJUVKNXFMDG   
XDIHAORFMV      : EDIMLCMQPYINI   OTAGMMYMQHRK    FHKYIQMG       
TPOPK           : HODVBWMKXDTRYJ  BEBGSSA         EODMBTCT       
CCHTXBEWONRW    : IMVOPAMHE       LLFLDMOUYCXXW   RNWY           
UWGDGIUXNHVYDL  : KRMJWJJGWF      YAWJUOS         AILVEVLJ       
SYXWBGSBJYB     : THKGIRSUPAXWE  
NUWQQVWVCHQDU   : GUPADNNYQH      AJMHPLK         CGNWJ           SOMORBAYFSYRQTL YJFPDR         
YVFNLAML        : UXQHWEOKUJOS    KSCXQODL        LWGGOUHKHVGST   IMYYGBIFX       SCTE           
PTRSDRTEHP      : YOJI            VIHSUPB        
XICWEGEXJ       : XJRHGS          POVYWBNUCAD     CPXVPRV        
ALWG            : FBRKGLKRVDRXRP  QTCCRMC         DBLCAYULF       GTKVVF          LRPCUVNAIJTLKMG FYXXOIDRHR     
KIPVIHSCAXTWE   : FIQF            TNGOLHEB        ICLETYB        
OIBWMADSEDFFE   : RKUYECC         YUVODOEPABXN    EITXFKM        
EMTOUJ          : MNQHFMHLQCO     AHMKQLKJN      
FQIISGEPLIE     : OIWNCX          YYGET           NBLOFWOR       
LDIMJBSMIBQBFF  : RACMVOSUTIICIG  WBJOLGV         OXJSWF          IGYQO           AJTTEORIA      
WDGMIWU         : GGEMWLOOFYMPLK  YRXEJGSTLFRSLHD FAIVKNLCGGCP    RWQEERWQVO     
QBXIOGPKTS      : FIQF            WOYFRACNCHRMKEC GTUNRGIBNXAAIF  GQCYEXSOV       OWCVNYGLOI     
GCWCPFDIHK      : DXKAV           PDTFQDLUE       YBDIK           YTESD           PVRJRJYMRALKQES HUHSYCMBUK     
EJRLVCKSVD      : HOQUCUPNVPUKVUP CPXVPRV        
TMLCEWV         : JGAPLFWF        VODDJREFYLN     OAOOWVGF        YWQWR          
PFCMHT          : FBRKGLKRVDRXRP  UNEXCIGWWMHGLD  FLRAPROXLIBATPE
MCCWSIHMVFRHY   : GEMHSX          NTIBWQQSIVNNXB 
MVHBHJFEHDWMH   : HPQSJRCRCBHUQE  GQCYEXSOV       FGHPGPMXPO      FCVV            KASRA          
VBGIFIGBRPNN    : VHJGDMPVS       CWIBMAVIRCARES 
HWTUKRCNANT     : OWPKN           EBTP            TMHP            EITXFKM         YSUVUAYGV      
XYFMGRJJXTOHA   : PSHHRIIHAKD     JGCVSPJJQ      
BRIQNPQJLBCPOEG : XULRUWGKDGMPT   LQREMBOUCPVVLKN TQTMSNLXFQLRUS  JOHLRJT         MFPS            LHOUYTNVT      
MEJSQRMCB       : EJENFJCSYEIMK   ALUCSTNIKNPVVBC NBLOFWOR       
WSTYKWRSOHJFQWI : FAELYYMAURWJ    DAYWCINAB       DHUT           
MYBSKOYVJ       : YTGAQDPWFVRXILO GKASUINA        IMYYGBIFX       GSAXHAMRBML     IOJK           
OVURGTKDVVAN    : KLHTNBWMIK      XCLNGWYBK       GTKVVF         
OWCVNYGLOI      : AOKBGXFNHLQ     MQLLBAPJHJRFGQP UCLCNLM         QOCAEYJSJVTLEJS QBXIOGPKTS      MYFOHTKEVE      LPDVSDMAPTYSO  
JUDJ            : OARTEPX         KODWWICYXV     
MEHIBARVMURIUH  : IWOULBNTBKYWUJL GIDUDEHR        KSBMPTBPY       JFJMLTGMBS     
MEEKTGRFUAUG    : UOSFFTXODWIDGI  JGCVSPJJQ      
XPNL            : SBFRALAGI       HOQUCUPNVPUKVUP DCVJ           
VVXXPT          : KDHU            KKFQE           DPITVMJVCTPPHFV DGSCEKTAWY     
KNVIUXUBEFUMYDJ : RUBIO           HQDBDINR        GSOYS          
XQVXIMJFK       : MTJVBTRHPIDSDWG KTLLMGDNHJSDFB  WKPUJLJ        
DIXYSJMOTJOOK   : JMUMMIQPE       OXTITIIDTWNQMAT TKWTY           FXSSLPO         BVJMKRJTRVWB    UNXTSVJD        GACMVGFSG      
VHKXMUYKLXJVKUB : BRMFJUWPLVPFE   VCLLDHOVVD      ROKOJFXUHF      HDIOYLUPACOM   
FGDEFXPTP       : ARJTCF          XCUGJJFRMCWIAG  CEDAEMUEFHMFE   JGAPLFWF        UFVIBNVUSWGY    NDXAJGSAE      
DGAPEXAPVMKV    : WPITT           UGHRAGQFQA      HOQUCUPNVPUKVUP CPUHTY         
XVLTGGXBO       : AYRHO           HFYUKLCRBCTQO   GRGONXWXCKOPD   YBDIK           HWKPBXH        
GSMGKGXVMF      : QGMFMD          QFYGCSRAFLUAINK
EJVGYUTJQTJMF   : KKMRUGRKJXK     BTGTDLEWB       SOMORBAYFSYRQTL JBFQRKEMP       QTFMOYXYWUQIGN  GEMHSX          WTDDGGWHBMGXF   SXAILLYWXBDNCUX
UNEXCIGWWMHGLD  : TWWSSNIQMVDJTQ  VRBDODJCILFUHLG PFCMHT          ALIP            TGUJCIOAUAJVQOG
SBYCXGESCPLVA   : XGOSYKJDJQX     CXIHTBSIOUIVL   JOMLSQK         ARYD            HJJRVJKW       
DGWQKUTU        : WPITT           IPCHJTACKUEFURY
QSPBBDEVVIUBG   : OGHSLJXRSKKKD   HXAKI           YDYVKDEXB       GJXCVM          FJDK           
FBFU            : VFQVKFRL        FKOJVVFLSBAE   
DWQGDNX         : KGDIT           SDTNICQ         FQMVVOKKHJLPYAV
KTLLMGDNHJSDFB  : XQVXIMJFK       XEQFLJG         CKXNR          
IJENML          : KUWA            IYQJDMDXFBHGCD 
DPITVMJVCTPPHFV : YIWFXL          VVXXPT          BUQDGJEYJEF    
SDTNICQ         : YKETR           DWQGDNX         LRLXYWM         FIUMISYF       
KAPBOBMRSW      : GIHYMSPWOFNUMR  TDESAJ          KSCXQODL        FGQEEQ         
RLWNQQGGXLDLE   : GBVNXS          RXHHSYWH        ESFLD           THKGIRSUPAXWE  
FSTJJDWMUX      : IWNK            HSGENRPQKYYHQJM KGMMLOUR        JFHPD          
VMVRJL          : QFMOHCMLS       XUYAJTEL        DIYOQVITUJYBHVG
VJWOA           : KDHU            JTOHAOIRVNWD    CWIBMAVIRCARES 
UBQAMXL         : CTPVMWXPA       FNJIWVRCQUKN    TSRPEIPUE       QOCAEYJSJVTLEJS MDCRYCRAQJIOYHN
SFEE            : PYELSPRWY       JLEQFCRTJV      FKCQVS          RGVFHG         
BSFBWDNUU       : FUKLDFNP        KAJUI          
GEWPELS         : FSCXSOKUVKF     EKAV            JJWYRQHTWJMOLRD
HTDJGDUAV       : KUWA            HOQUCUPNVPUKVUP CHJAPGKHRVUAO   XRUHYD          AAEKFD         
GCMHVRISVXP     : BBLDBBLAGNL     XQGUWKTBEPXMOM  KOWVNUBGJPWBR   OQBYPLQPEPLUP   MHRBCWU         XTGKWWHLWKL     RCFW           
XVXWOCJHLSDQEJT : WSKWYRDIFKJRNI  GSGX           
LRCSUPCQJLLFLDY : VBUBHQ          GGEMWLOOFYMPLK  NULMVXIHUJ      CHFKLOMCAPURD  
YWJPYU          : SBFRALAGI       YOJI            GUPADNNYQH      NLSLPENGPCGQPJ 
MPCGTLAV        : MUVWEMHBAJYITY  LOBFMAKMKRGONR  OQSOBVOCA      
SYSPQUIA        : VCLYNDVIMMK     PPRSKXX         FFCHLMTWK       GNFRF          
TIUYHIXGTQHQNTG : OXTITIIDTWNQMAT SCYCSWWGJCVQH   MJBVSWDYLMVSWIW XVPQNJAPXTK     LFSARJIYUIV    
ADEDYEXXWNOUVR  : SSKBNRT         XQURDFWKQHVU   
RAAQHLQNFHWWX   : GRXPVPBW        XXEWYRFFC       MJAV           
FQVIUY          : XHPES           VVKBTSAV        EGTKKCRKU       BWSDU           YNPWSHKSPBGBJDX FCBGBHALJLRD    SXAILLYWXBDNCUX
CWIBMAVIRCARES  : BTJSRKW         MEAQRXIKVBXAW   VBGIFIGBRPNN    VJWOA           DJPOQNK         IUUIYWY         MWWLNILRJXWWYF 
PJOVRLURGAICJF  : MUDJPS          IHOAXEPJXT     
RHAC            : VHMK            HMAETXSXDRMAK   WNUTJAANUW      BUQDGJEYJEF    
MCHU            : NRKWHIM         FJWACCAHUMRXES  TEARXDASPPD    
LWLQRMICDGV     : XVYB            YHXROTHFLXJQ   
BNXCXANDE       : TDESAJ          MNCKXF         
NEJY            : XRUHYD          BWSDU           FDAGYTQOBYFAUJB
MIOGUOU         : DCOCCOEYVPIDJXF DSYRLKIEU       YPBCQLKHIGM     OHLGYQ         
GHVILDGEGVCI    : SLCWIO          KNJEWUEMTLSAWWE YKPQBAPCKJOWK   GYRJXHUQX       JTEVSFPLIAU    
FXAJFNNPMHCWWKR : OETFDKTMVGNH   
FHTPGFDJLHPKM   : VBUBHQ          LNQGOKHHXBDUN   NLSJLIGGOMW    
GRYGBFVQWKYBI   : TFXGSXCTU       DGINPVKOGPFSKPN XTPFSIMYKI     
LCLTKFJ         : CGRID           MMTHWFYQMA      KNVJEHOFWGO     KYBGETQXLFNWGQN YTCHMQNSF      
KMCYVTLIWRA     : MKWAAUFJQRFRQM  SXAILLYWXBDNCUX GGHRBFS        
BDGWWDI         : GUQNIULSRUPCWH  UEWEBHKF        OOHDPPHNTGURD   OEKGDDMIT      
ESVRUHLHOWXCJ   : NWWJXJBTKDGCC   LLFLDMOUYCXXW   QDAMESIDWXQE    TPVFTXONNNDFRY  CLSDQO          HWKPBXH        
DIYOQVITUJYBHVG : ISEKGCE         VMVRJL          MJSEY          
TKKPFHYSPQQPUC  : IRRPOJ          WAAFQVNXCNIVH   BLRATYNTSBTVV  
XKTOEPWX        : VOXAXWISHAVXNH  CWSNPK          POVYWBNUCAD    
HWOQVVIPI       : VMBUWOFAESRMT   BUIKOPQJWBFSC   MJKTRAKNFUPBE   CJHSNUVNKLRM    XXVMGHKCNOBJ    IWOBMQOHXFK     YTPONM         
IPCHJTACKUEFURY : DKNIUWHG        GASQVBDAH       DGWQKUTU        GIWVBXJUVACYP  
XQHVEQUTJQRR    : VCLYNDVIMMK     DCLPBSREBJWN    QRICJRWYXOEIH   TQDKGOKMXFBXGRL
CORSQBC         : AGKIHQEFHHUOKWO HQDBVDIOVS      GXPLXJURH       LDAFHLAM       
CGXWMDSEEEEUNAA : NKRPET          HFWHU           HYXIDIEDBDDQVQ  DHUT           
XVPQNJAPXTK     : QBVQWGTR        CHFKLOMCAPURD   TIUYHIXGTQHQNTG
VOFAUD          : TPVFTXONNNDFRY 
IITOO           : NVCHROYNFRXHRW  HBDTXQAN        BIUIRR          JHSIIRU         OTSURPA         DGMVOOPCOV      JGCVSPJJQ      
TJOVLV          : AWBDIKIDEEFOO   LEOLKQCHP       YTPONM         
JLNWVPPVM       : FKCQVS          EBYJOMNCKM      NMEYW          
NKRSKM          : EKAV            SMFPDRVPBOPAI   GNFRF          
LWGGOUHKHVGST   : MGUX            JVOKEFUYP       NGTNHHPLF       STMIADNBI       YVFNLAML        GJXCVM          AKTBYQQYSG     
DGSCEKTAWY      : HTNLLQRAD       WUIFHV          BCGAGQ          VVXXPT         
HQJTFIGDO       : KUBTWMWFHBXLEO  THKFBNX         HBXUSC          PAHLCL          KMSLOGHFXPA     XUDCUQXWOJUBXLG
TKVE            : YTOAGUT         NCWGQV          AJIMXCCCGG      NLTDNMIXFJNUF  
RMMORRUK        : JVOLTLTOVUNVK   OABQRDVIPBFV    YHXROTHFLXJQ    HOQUCUPNVPUKVUP IPQLSUW        
BVSDURT         : XAADIRTX        RXHHSYWH        IMHBHXEAEKD    
IGYQO           : OGTCRQ          PLNAAQRWVV      KAMNTFCKEFSY    LDIMJBSMIBQBFF  GESEOU          RFPBQASMLD     
TDTPPPTJKGYY    : CJAXB           PVGLIKBCFPFCG   JOMLSQK         KRPLGNVNOGCMBK 
SVLPYJLC        : SWIO            OECCXPCRUYHWOE 
DYKOFLFTRB      : HVDBOILHCNAJ    HJQAB           HVVRKXCHRUM     XQURDFWKQHVU   
LQREMBOUCPVVLKN : SLBL            UQSOOJKGMJLY    JIPA            CGXWUUEXJQPBD   BRIQNPQJLBCPOEG LKDRK          
VYODDNPTS       : LBHEMKXYJVKGJYJ EHUK            ITCISSGNUXIPB  
YMTCOHUGL       : HXRVPTJCXFSMX   POXVADBLIFMODEB GHXWS          
JCEORBKF        : HQWD            CWSNPK          MJBVSWDYLMVSWIW
XRJA            : OLRLGESY        SBFRALAGI       EDPKKKVVJPQ     RKDCSVKEMJDW    QUXSXGW        
NFWFYQHAFDCVLYC : UNRMOHU         AQHAF           YLOMCYOKOX      ORXD            WFDWQXYDHXUVR  
GOEKDXNP        : JPJGDBECHQG     VTWMFJDUD       IYDPNNBS       
BNXNPFBUFIV     : EDIMLCMQPYINI   EEKDSXSNMCFPME 
QVDVAAH         : GUWFQTRSTGI     DMFBHHMTFODOQIW YHVOEUPIWFY     JPLAPRLRCJQ     TQTMSNLXFQLRUS 
CJHSNUVNKLRM    : CUVCBPX         YKPQBAPCKJOWK   UWSXVPPINLI     HWOQVVIPI       MHVM            EHUK            XMPFKHPX       
QATXDPDNLBEKFB  : FNRCVKMROB      MPLTBB          BMVQJGOHWBV     KNQRGPQPWP     
FKOJVVFLSBAE    : FUGEPETTL       ALNLBFDDATV     EKVQMUFHOQKP    RPLJGDYRESMWIS  FBFU            QYNLAKYDJNOAR  
TQTMSNLXFQLRUS  : MBNUQSLFR       MTPW            ATTEIQIQAXX     JBFQRKEMP       BRIQNPQJLBCPOEG QVDVAAH         RQHX           
CVQJGFSFE       : CXIHTBSIOUIVL   BMGGPORJS       VNFYEIO         EHUK           
QWCQBTNTPA      : YTOPAEAOWWSVDY  DCLPBSREBJWN   
DLOJF           : JOVPQO          LBIOWLJVCVX     CIFFUW         
DCVJ            : NFCVQVYA        XPNL            XOFFEKGKOFKBAQ  JUOVRM          XPXSAR         
TCNAKIHOJYNNR   : QKYSSI          VCLLDHOVVD      SJUHKK         
HFLYGDCTT       : CHBHCAOPWIMC    MEAQRXIKVBXAW   HUONXT         
BWSDU           : VYPHHMYBKY      SFXCQMIDOBAKR   TNGOLHEB        OLTYFSW         FQVIUY          NEJY            YOLTE           HLCW           
HOHURREYGP      : XGOSYKJDJQX     AAEKFD         
VDSNMACL        : CNXSNVBIT       NEONPIXN        OFXQO           VWYJ            IXFB            DGINPVKOGPFSKPN CEBPNQWFRFIFI  
FPDY            : JRKH            THKFBNX         DNSCXJSD       
EYYKTERJLPD     : LNRFXGPSIXQIHVC JKPPLXWLOR      XRPTWREPQXTAG  
VCLLDHOVVD      : VHKXMUYKLXJVKUB TCNAKIHOJYNNR   GEXEFIKKSDJCYXS
XOFFEKGKOFKBAQ  : IRQDKRTASHVOUFR QNSSGACDFEPXK   OXTITIIDTWNQMAT DCVJ            GKJVM           XGQX           
LCLOHHSUUVCL    : TPVFTXONNNDFRY  COVCXQSFO      
AOSA            : PYELSPRWY       GQWJCVPWSRRP   
AHHKOUB         : JPJGDBECHQG     CODBG           POXVADBLIFMODEB HGOE            BUQDGJEYJEF    
FDVXYJC         : HSVDPCRDYGFRNAD VREEN           RGHSLGCT        KGFPJGMORV      YOMPRIOFKUFW    XYUGXMNLKU      CHNTPESDCLS    
AJTTEORIA       : IOKAEJLKAYWQEG  CODBG           LDIMJBSMIBQBFF  EVVAYBX         JMMNLJAUXO      CKVHNOFERDSORT 
JOHLRJT         : EGKMYFUDFEOQ    NNAFLIIDOWQAVI  BRIQNPQJLBCPOEG REILPI          JFNDPTHKQTKXWXC
TIVWEDADD       : COXTXPDUSON     EVHLTOKFUYYAKQ  RACEXSXCPREXAIA BRELLKYQWLJON   JUOVRM         
OFLPOFLUVFEVT   : JVOLTLTOVUNVK   GSOXRMDMHQTULD 
MDBGMUKIDIGK    : HSLNGVUWA       BNKBGU          OSRCBFVQASXVTD  THKGIRSUPAXWE   JGCVSPJJQ      
IPPK            : KHNQ            XEJHEBPRKI      YNPWSHKSPBGBJDX
XXVMGHKCNOBJ    : KSTQGLQAGQVSTCE YRMDKXMEKYX     HWOQVVIPI      
NNFW            : NRKWHIM         SALDJFLCWK      VOOGPSYEQECJQBN CQKKCYCUEHBV    QGWBEOSYLLYK    PAUHPMHKONRWU  
DHJIPRSEA       : JLEQFCRTJV      FBVBYMJUBVLKY   DUWNBYQQIEVNEIL
WKPUJLJ         : JGAPLFWF        GSLCKQFTILB     OVJKWHNDFWYWWBN XQVXIMJFK       AAEKFD          REILPI         
VTTLIUUO        : TMLWTBWKKUEJQ   HVDBOILHCNAJ    RACMVOSUTIICIG  INWWLSJENILISFH FSHHNOTDK       SMRI           
IWKLARUIJO      : JJFXEDOLKUDAH   NGTNHHPLF      
QOONCEK         : GGDGXEGCQPRT    ADWISVGPVQ      YSSYJQFC       
QTFMOYXYWUQIGN  : NHWRGSGJYD      MPLTBB          EJVGYUTJQTJMF  
RPMOXXDEO       : LVHXUKFNOWD     PJFNYWAN        TFAIERWLFYGEDLO SIVQJBAIWV      VNFYEIO         LHOUYTNVT       SGGTN          
TEVXOJQL        : HUJA            KKFQE           RDOV            EFHIRKDSDSHH   
DCQDBN          : TRDELSVLPVOSJAX RPLJGDYRESMWIS  LFMC           
RXHHSYWH        : QRKJDBPS        XVLYOPQBN       RLWNQQGGXLDLE   BVSDURT         SGVEAXGUI       YTEB            RAFKKGNRSTISNRO
XFSCWMV         : DHJJO           OABQRDVIPBFV    KPNQFTUHVO     
LUSULEMRGDWJ    : RACMVOSUTIICIG  HSLNGVUWA      
XEQFLJG         : QFSRILLNHUD     UEAYCDAWJS      LVANVCQT        HEOJUHIKE       KTLLMGDNHJSDFB  JGMWRVKWAUCOUQ 
QVJX            : WVHPXJTX       
LUGIYRFRMQX     : RACMVOSUTIICIG  AFHLJGXFNOH     XTGKWWHLWKL     HUHSYCMBUK     
KGEIPWGTNOIY    : WEVNFGJUKUF    
TPVFQ           : JBFQRKEMP       RPUVFSBFKTK     LRLXYWM         KVOIFATGQ       HUONXT         
QNUYMO          : NGPLY           JXCHHCFGCGNS    SWJAHDNDEQWKS  
GEXEFIKKSDJCYXS : VOOGPSYEQECJQBN VCLLDHOVVD      LITHRNF        
WPDPNIGDCT      : OAVKUPABBPWF   
DJPKPT          : KAMNTFCKEFSY   
UYSHL           : QMSFUHPWNYIAY   QTUVDOMCDT      QFMOHCMLS       VHJGDMPVS       XEWNEPMB       
KXOKVJT         : OJWDWEYKUNVMY   PYELSPRWY       CBRMT           CHSVSJJBBC     
YAMP            : XTPJGKHPWFTJCS 
SSMPUQBK        : FXSSLPO         YSSYJQFC        ROLILDUGCNLAH   DUOPIGXAS       RSWAKKJWB      
QGLNIGXTSIRJU   : CXIHTBSIOUIVL   OECCXPCRUYHWOE  BJJVJM          QDAMESIDWXQE    JJWYRQHTWJMOLRD DRELSISE        TFOKQODVODLGK   GUHXFAEPSV     
SRNURAKCVFP     : OGQTXSIFHDB     XSNT            SIVQJBAIWV      CESJNPIBNDDR   
AIONJHTWVCDTYYE : CBRMT          
ICLETYB         : KIPVIHSCAXTWE   YTPONM          YBKPPNCDPROIWP 
YNPWSHKSPBGBJDX : ULPSWEX         FQVIUY          IPPK            KNKUIOFEXQHGBUU
FCBGBHALJLRD    : OARTEPX         FQVIUY          BQIYTARC       
SQNGJLB         : RCEADL          XAHCH           SMFPDRVPBOPAI   IXSEEBATBIRP    BLRATYNTSBTVV  
XUJADKJIJQO     : PODWFQQJBS      BIADQTLWYY      CEJO           
RWOYWALKSQW     : DGJCVHFGNGKFLAD BMKNF           BHQEUDFEXDETPI  VLPKFL          JCYPRIFUMFYXOGY
KLUTYVMW        : MHFE            NFCVQVYA       
VWYJ            : IWOCUMB         LHBCNOTGFNU     LNQGOKHHXBDUN   VDSNMACL       
HSWXIQX         : XTGMNKGVL       PAULPYNCUD      KUTYN           BJFFEUMFJCCJS   DQIYTLX         QFGLDEWJMDI    
SUYEITUFIF      : SWJAHDNDEQWKS  
FBRDOPWMOX      : JXXEENBRGBOD    VIXQD           ESKOWRWSAANOBD  WAAFQVNXCNIVH  
VHQUIYMGX       : ARVOAGJ         CVVAMPBIMHTFSKG HXMS           
DXLLR           : KHNQ            NLTDNMIXFJNUF  
RCOMHRFLGWK     : XPLFNYLVMKYUWER XDIDEAREOUMTHD  BRELLKYQWLJON   AMOQXYGP        GQXTRRAEPRDCI   HJYVXHUJQRXEQTO ALIP           
LITHRNF         : XPFMCPTW        GEXEFIKKSDJCYXS DLCSLAJIROQ     SEHJSR          LONUHJMO       
MTINBMLMXFURI   : FVJAIE          CRORG           HYXIDIEDBDDQVQ 
FREKDMHNISX     : UKHHIVEVPTAST   DCLPBSREBJWN   
DQSI            : TYRWPP          WTVJP           XDCGTVQXLILBAR  KYBGETQXLFNWGQN
HCEUFQIRQOOJYB  : KRWLM           TMVKDBGHARIU    DSGQDCYXCT      IDICOJBQOMOG    GSOXRMDMHQTULD  PTNKFNGXYAXKH   XNOLQJFQ        VDNHLCGDXQCANE 
QFDUTKKFFJKKCDU : SLBL            XLHEOAABFO      XFHKYYVOY       PTTWUFSCKIUWDGH FGFQQCQLPXGFWF  XSNT            QWAJKUSF       
KYBGETQXLFNWGQN : GDHWGF          VLMQSCSJJSM     SOEPTHBAW       LCLTKFJ         DQSI            LQKUD           ACKTAPYXPQLJAUR FDDIDPORA      
XQURDFWKQHVU    : IAWTPMWPJUKXPX  EDUPHMMHSRUAECU DMFBHHMTFODOQIW VFGCSWUEM       ADEDYEXXWNOUVR  DYKOFLFTRB     
QUXSXGW         : XRJA            KNCCQYQTWQM     RACR            TUOYIGAFHODRRAL BXNHIIOVLHRG   
WVGF            : GPWRMRSRLOUI    KVXPIYANOUYDSAL TDFN            NERTAUF        
DLCSLAJIROQ     : ERBLFNDQE       LBIOWLJVCVX     VOOUYLKWWN      TUOUBVQRUBF     LITHRNF        
YHYWFMQCMJAS    : YIGPTVDJUGE     XUDCUQXWOJUBXLG
SREBWPGLRYYT    : RJWLYY          DNYXRWBYOPBVKI  EEJC            PQFEICJCJMR     LMWBUWHDNYDHAJ  DHJDPWBTBIGUH  
IMYYGBIFX       : SVJYXTIFHNSKFS  TMVKDBGHARIU    UXQHWEOKUJOS    YVFNLAML        MYBSKOYVJ      
TQRGASYJNTP     : VYPHHMYBKY      WUHERKLXSERWVFM CSYV            MHRBCWU         AWVYQJXDYL     
SGVEAXGUI       : RXHHSYWH        XTPFSIMYKI     
JKPPLXWLOR      : AHJUQHXWV       NUYWPMV         EYYKTERJLPD     MJSEY          
IXFB            : OJWDWEYKUNVMY   BUIKOPQJWBFSC   PCXEKKT         VDSNMACL        MWWLNILRJXWWYF 
QRTHHMPFTP      : AJMHPLK         GLKN            WAAFQVNXCNIVH   GRBTMCVASNNUSDO RAFKKGNRSTISNRO
AMOQXYGP        : BMKNF           RIHAUIPJ        RCOMHRFLGWK     KSBMPTBPY       TQDKGOKMXFBXGRL
GNAWHHG         : WADHWWATCRBOI   BMGGPORJS       PBVH           
NHHGYDNI        : QBVQWGTR        VGYCCIDTDEWCY   CRWCCXBXRJGERJ  UJNVRVWUIUDNNLA
FQMVVOKKHJLPYAV : DWQGDNX        
DTXKCGAJ        : WDIWUEORQRRV   
HLTWVMDOB       : JJWYRQHTWJMOLRD MBVJXLAVGKRXO  
LRLXYWM         : SQGWEMQPTRB     KOBUCVGKCQOQVAU GFJJWLIVIB      QFYGCSRAFLUAINK SDTNICQ         TPVFQ          
YOMPRIOFKUFW    : XCLNGWYBK       HRTYUMNDU       VCAJTV          FDVXYJC         JYMORTLQSNKDGUQ RACR           
OKGOIURXVULPI   : GIHYMSPWOFNUMR  MYBJS           ULPSWEX         PLNYBRAVX       CKXNR          
QIXHHNWYHFN     : KYGF           
SKUR            : UNQCF           RSPRNF         
JCCXKXRK        : AVRRPFMCRKQ     MEAQRXIKVBXAW   RBRCYWTSRJ      LBKON           YEFCMIDNCWKC   
OVMX            : HDGJ            YTCHMQNSF       VTKDU           OISLWARKMCXKLXW YNFYLPTONKVYSN 
DGINPVKOGPFSKPN : QMSFUHPWNYIAY   BIUIRR          GRYGBFVQWKYBI   VDSNMACL       
LAGQ            : UTUAYPXPSXAX    GYRJXHUQX       TVIWO           NNSMJPDKX       NHXSKXBEMGOARJT
RQSEOHB         : TTJISMRHXBGLY   BJFFEUMFJCCJS   ABJOTLKELO     
FJHNTUFQFU      : KCYLEWQNYOOH    JLJDAOGJFWBUII 
WARIRI          : ECHF            JLEQFCRTJV      QFYGCSRAFLUAINK FAWEGVYLVTCCDN 
EKTWIN          : DYVTYTKDO       DUJROVYBWKCIEWX DEORFLWBNIAQ    RWOHBMJMVFPAS  
DRELSISE        : NDMCOXHDB       QGLNIGXTSIRJU   MHRBCWU        
JYMORTLQSNKDGUQ : TNDNNELVVOQV    CUEXVMLANBICNE  YOMPRIOFKUFW    XWBMXIATTFEJK  
FKJQAYTRDF      : MPUW            SVMTHIV         AUTFFLUAF       HFOQ           
LBTDKURYMNLFH   : TWWSSNIQMVDJTQ  TEVOXQAREBX     EWFIOBI         KPPKSCHMNPDUOF 
SMFPDRVPBOPAI   : KCGCCJQITIVWSKK NKRSKM          SQNGJLB         XYUGXMNLKU      PRIUJBGKRFVD   
GQXTRRAEPRDCI   : HODVBWMKXDTRYJ  RCOMHRFLGWK     IRKAYRA        
KRQFEXUKQS      : RFKNOUX         WEVNFGJUKUF     UNONOCDGKAQ    
TJSWSDD         : WXLAIEXNHU      LQKUD           XGQX           
BYFUYJKTMPCEC   : OXSPFVFFPUAQ    PAFUASCUYQLCXBE OARTEPX         LNDIVCCMQCV    
WJAUGKNA        : PJFNYWAN        GNYBBVA         XRUHYD          VXNAJBFEJRMRNIO ROKOJFXUHF      YPBCQLKHIGM     OLHOJ           RKUVSDXRPLIK   
IJGFE           : EQWFX           YIWFXL          TDFN            WIMNMKR         QEDTPXXQCELPP   HRNWOOHI       
KRMJWJJGWF      : WMMYDMVBDY      DCLPBSREBJWN    UWGDGIUXNHVYDL 
OHCQDYCFVI      : UEWEBHKF        OPHAENN         YIGPTVDJUGE     CKFOWOLXMDYH    IVODWI         
KIESUMABVMTKV   : KYGF           
THAQMXHVAXBBAHW : JBTCYELQEVP     JMUMMIQPE       RGVHNQNIEBEJPNT CBYDYU          UEFEOQ          FOQHBLQSJUGMCG  FLRAPROXLIBATPE JGCVSPJJQ      
AHTECQS         : AEQD            BJFFEUMFJCCJS   HDRSC          
SOQOYP          : ADWISVGPVQ      TXUDJUYKEXIS    JCYSYUYFBFEIJQ 
UWHOMHV         : BTEACRQ         WCYUESU         GNFRF          
HWMKYVKKVRHCWXU : UKHHIVEVPTAST   CEJO            DUJROVYBWKCIEWX
SJUHKK          : TFXGSXCTU       JPJGDBECHQG     XSNT            TCNAKIHOJYNNR  
HJYVXHUJQRXEQTO : GYXTCXPNISV     PLDFMIHIJ       AMABMTQPI       RCOMHRFLGWK    
PIJTFJOLDAGM    : XJRHGS          GDFXHLKK        WACUNFST       
SCTE            : XUEVJIMXLB      QGYCREDIXOQVEPL JOMLSQK         YVFNLAML        MUCYMNUOIWJAML 
SFNNQEHOIA      : GATHBCSLVE      XDEVKMCIURPEPS  KASRA          
YECIPVNAMB      : GHLQRQ          EQWFX           QJQAE           TDFN            QFMOHCMLS       GJBMRF          TDNJMC          EQVPKNDSYHNFJER
MHRBCWU         : OEVFPCMELUTY    GCMHVRISVXP     TQRGASYJNTP     DRELSISE        EEKDSXSNMCFPME 
DPOQFFWOTIPGH   : DXKAV           GXXTBLMNKVVW    HCGKQWNBGQSTH   GGHRBFS        
IPMEGMQHTFR     : INWWLSJENILISFH DCLPBSREBJWN    FNRCVKMROB      VCAJTV         
GTMDDPVRGB      : YTOPAEAOWWSVDY  LHBCNOTGFNU     ABJBT           FSAGYE         
EQSM            : SFXCQMIDOBAKR   VPPCUH         
YTCHMQNSF       : GYFSYEMTTUFYWN  AFWFABYRYEAPIJ  NNAFLIIDOWQAVI  LCLTKFJ         OVMX            OABULF          DUVGGNSM       
AYNRPTOCARSVK   : YETRE           VXMPTAAMPVP     IEATSIOFIOW     XTGKWWHLWKL     QORLT          
YJFPDR          : VYPHHMYBKY      TLGB            QLBAVLI         NUWQQVWVCHQDU  
EODMBTCT        : IMAKGJEIPDUSS   TPOPK           RSWAKKJWB       MDCRYCRAQJIOYHN
LVBYQQV         : YHYANRNFQMSH    EEJC            SVQHHKMFBBKOK   OVJKWHNDFWYWWBN HODVBWMKXDTRYJ 
TVWMTJNS        : CQILAPNMT       ROVSNSCYPCNEBQR
TLYN            : OAIIKEERNOE     QSJAVE          FNFBJSBTEWIRJO 
DEORFLWBNIAQ    : ERAENVJMDKMSCAB ICLLMESSOUATALK EKTWIN         
QIFVEDUS        : VHJBIINMV       YXIFKPKNE      
HGQDCCCSNHWF    : RGVHNQNIEBEJPNT NWGDF           CLWQP           XJSER          
FSYG            : NGAWKSAE        EGTPPYDMGCIH   
JIYSYHYWNCUG    : RKUYECC         QORLT           SDCYQWABMBOVN  
CPUHTY          : DGAPEXAPVMKV    XLUMBQJRBTCMLG 
MMSKTUP         : KHNQ            QSJAVE          LXLKOESQRYK     UCTDGKYJEHKVMYR
TXUDJUYKEXIS    : GOFXUYKIK       SOQOYP          CJIYH           JCYSYUYFBFEIJQ 
FBGJSBQNACAP    : DBYNKBMGRYDH    HTFYMQGCPE      QYDGFTF         QFTH            YYGET           BFVELYJVCYNVCWK
MJSEY           : ALNLBFDDATV     MPLTBB          DIYOQVITUJYBHVG JKPPLXWLOR     
FVSOQRYXRJSTO   : XVLMJHVHCI      PECFCHSUVMAOW  
DANESDFUFWS     : GJEEKFCYDXQKV   EVPQONEFOATECAY
GLYHAE          : VMBUWOFAESRMT   IYQJDMDXFBHGCD  UFOBGKTW        HNHKJ           RWWFVMIJE       JTEVSFPLIAU     NOJJ           
UUWMUUEENBV     : MKXF            EUNEBOPTXONMUY  DFVYRNRHHIO    
GXAKR           : FTUPROIQ        OAVKUPABBPWF   
ROKOJFXUHF      : GHNFBJDWN       KWMBL           CMJP            VHKXMUYKLXJVKUB WJAUGKNA        IUYC           
NLSJLIGGOMW     : WMMYDMVBDY      QAKPUPNMDIKRAQK FHTPGFDJLHPKM   KRPLGNVNOGCMBK 
IJXJ            : PAFUASCUYQLCXBE QOMWSXPTMMJ     BBLDBBLAGNL    
JBQDRBSCJQY     : DAEGSPKRAY      PYVTW           NOFHNR          JIFX            VFQVKFRL        AWVYQJXDYL      RHWJXLTNU      
XYGMSRXBXGRL    : WADHWWATCRBOI   EVHLTOKFUYYAKQ  EVPQONEFOATECAY FSAGYE          GESEOU          KSBMPTBPY      
KVOIFATGQ       : CKNMSH          TPVFQ           NKLTH          
BUQDGJEYJEF     : KCYLEWQNYOOH    ULPSWEX         DPITVMJVCTPPHFV RHAC            AHHKOUB        
WXTAVBRJG       : DUPCTUTV        XYUGXMNLKU      BTKQARIHWHVTUYE VIHSUPB        
GXPLXJURH       : BMGGPORJS       ADWISVGPVQ      LRQSRUWBYXA     CHFKLOMCAPURD   DRGEMBNRYFU     CORSQBC        
OABULF          : TMLWTBWKKUEJQ   QTXSXUWGVUOMXG  TMSAC           WVHFBMFFIENELVV YTCHMQNSF      
VJYRGYOIVPDFXHN : KIOAVXBYKRJS    DEPXPIR         OOHDPPHNTGURD   BLACUUUCAORX    RCEADL          VWPGQJUW        UCVITXCP       
YAWJUOS         : WWVEHKFMFKTLBL  LYQIVTVMPJXV    UWGDGIUXNHVYDL  GUHXFAEPSV     
DVTAHYTFJUARUOB : TKWTY           HVVRKXCHRUM     FFCHLMTWK       IOBEKPOMHOJAJF 
GGAEPOD         : BLACUUUCAORX   
OABLOTETRXVAWP  : XAADIRTX        PYVTW           YMCD            KFTA           
IMHBHXEAEKD     : GHYAUN          EMUEDWVIXVAD    HFOQ            HSGENRPQKYYHQJM PBOMXPNOMTFVLD  BVSDURT         MCOJTO          QYTUUNNHKM     
CRORG           : VMBUWOFAESRMT   LVHXUKFNOWD     QQLGTGOK        OGQTXSIFHDB     MTINBMLMXFURI  
SRFPXBHV        : TRGSFIQKX      
JUOTEBBFLA      : GHYAUN          XPLFNYLVMKYUWER SCHGFOXXKFYL    AAUECBP        
NGXQRAIGUQWNKCF : VVKBTSAV        MYSWLAAM       
FPGCYCSSGUWNIYY : SOHQDIBJIYWT    URLLTF          KFQCDUBCSI      BVJMKRJTRVWB   
FWPAYXITRGK     : NJOKOMORVBWLD   CCPMDXLKNUVEDSM MONRLGESFXY     COVCXQSFO       ASMH            CLDMSTNS        USHVOESESA     
KPNQFTUHVO      : XFSCWMV         ALBWITPQTHYJ    EFHIRKDSDSHH   
ELYTTXSPGR      : ARLN            SCQQFTBXLBUCR   BIUIRR          XVNDLMQKFXTYDXP AXIDIUXCAJBNRGG
GRGONXWXCKOPD   : OIVPIPDVBOWC    ABJBT           KKFQE           XVLTGGXBO      
KXDGMGNAHHTG    : COXTXPDUSON     QFSRILLNHUD     DCPEL           HFWHU           FLKISPAL        UCWSOEJLKSM    
KOWRUQAL        : KSFCBNFGDPJ     ORPPNQWTLOT     RWQEERWQVO      NNSMJPDKX       KFTA           
XLDD            : OOHDPPHNTGURD   AJIMXCCCGG      OOVOXA          GEMHSX         
TSYSDYVMOE      : YTOAGUT         YRNEMLUCC       YGWYDGPEIIPXO  
OOJJUMVJKPGBQTG : CNXSNVBIT       HDPMMDYSBEH     VDWXBGCJBCMD   
FMTDGNEBSEX     : QYDGFTF         KGMMLOUR        HQWSNHFDYMVPVUT
SEHJSR          : XGOSYKJDJQX     SOHQDIBJIYWT    GUGV            COML            QTJSKIQTH       LITHRNF        
PGQBQHHUAEBQ    : MGUX            MBESWBR         RJFSMMV         FCWABDXHGBS     YLOMCYOKOX      CESJNPIBNDDR   
PLNYBRAVX       : BJJVJM          SEQRQ           OKGOIURXVULPI   SDCYQWABMBOVN   JFHPD          
ESFLD           : NKRPET          DIGFLEP         FJBLYJTUP       RLWNQQGGXLDLE   GTQS           
FXSOPTHYE       : VAFW            YHYANRNFQMSH   
YIGPTVDJUGE     : EGTKKCRKU       FEXCRVUFW       YHYWFMQCMJAS    OHCQDYCFVI      BCJECHRHLRIGGCE
DCVHXDUBGDBYRQ  : JOVPQO          JFHPD          
YPBCQLKHIGM     : HGHCRAQLJKOGAQY SAXFIRNT        BEJALAKGJBBJ    ABJOTLKELO      MIOGUOU         WJAUGKNA       
EVVAYBX         : XVNDLMQKFXTYDXP GQHDRGYBPIFDXD  AJTTEORIA       XYUGXMNLKU      UCVITXCP       
YEFCMIDNCWKC    : LBHEMKXYJVKGJYJ JTRKTHEDJSRBYIL CXYKO           JCCXKXRK        YDYVKDEXB      
MGGAQPIYEBDAYFB : YTGAQDPWFVRXILO QLDFXQRISMIH    DNSCXJSD       
GJBMRF          : YECIPVNAMB      YWTDCY          ITCISSGNUXIPB   LQHHUNBEDSP    
ALODIYHWNPFOI   : BYTK            XVYB            TGVHQ           UGHRAGQFQA      MFJAWJNDALBB    PBOMXPNOMTFVLD  FLKISPAL       
WJAA            : PGIGCLM         PAHLCL          UFVIBNVUSWGY    BQEQR          
AAUECBP         : JRYJVA          PLNAAQRWVV      NLTOY           VXMPTAAMPVP     JUOTEBBFLA      GWLMO          
PHNQIYF         : KUWA            CRXLJLUNPR     
HFWHU           : TRDELSVLPVOSJAX NCWGQV          TBJRLJKRLDMMNDL HWJXUNPGVGNYEFU CGXWMDSEEEEUNAA KXDGMGNAHHTG   
MJWI            : LOBFMAKMKRGONR  FCTRMSYBV       GBVNXS          KCGCCJQITIVWSKK YRNEMLUCC       AMABMTQPI      
GKJVM           : NGGYEKUEMTIA    KHNQ            XOFFEKGKOFKBAQ 
RQQU            : TDFN            IYDPNNBS        VNFYEIO        
YLOMCYOKOX      : GKOVEMBO        XOPQYTUSGUUDW   EWFIOBI         NFWFYQHAFDCVLYC PGQBQHHUAEBQ    IUEXNF         
LFMC            : DUWNBYQQIEVNEIL DCQDBN         
YBDIK           : HBDTXQAN        MMKAOPTQKU      GCWCPFDIHK      XVLTGGXBO       LTMBMVHFX       QBAQ           
TGCIA           : AXIDIUXCAJBNRGG LMWBUWHDNYDHAJ 
BXDALTO         : QTUVDOMCDT      BEFVD          
TFAIERWLFYGEDLO : XGOSYKJDJQX     BYVVQ           RPMOXXDEO       RSWAKKJWB      
BIVGSWC         : GHLQRQ          KNJEWUEMTLSAWWE WQKUMTUSUPJQ   
UFVIBNVUSWGY    : GGEMWLOOFYMPLK  VEHIABMOAHHV    RLPXLOYPMHBCE   FGDEFXPTP       WJAA           
FLVGTC          : CVWFLK          YFPXOFBOTERLKFY DUOPIGXAS      
GQWJCVPWSRRP    : PJFNYWAN        KNJEWUEMTLSAWWE TNGOLHEB        AOSA            JGMWRVKWAUCOUQ 
PXDD            : XJJUUSPFDHA     KLNHMLRGPJ      GNBWAADYRKEV   
XYUGXMNLKU      : TMUOP           PPXD            HJCKHMKG        BIUIRR          OWLFHGJYGVKR    SEWTAHGEAJGVAW  FDVXYJC         SMFPDRVPBOPAI  
XYUGXMNLKU      : WXTAVBRJG       EVVAYBX        
NGMGGVKCOIW     : QEDTGHOXFBU     PAFUASCUYQLCXBE SENPOSBMFR      BTKQARIHWHVTUYE
CMIRMLXKL       : ASBSNRTUJJPX   
IUWUILHFRU      : KUBTWMWFHBXLEO  VFGCSWUEM       ERAIHTPLVNLVDQG SDCYQWABMBOVN   KLNHMLRGPJ     
GESEOU          : VIEDNXGVLSIGN   IGYQO           XYGMSRXBXGRL    MFPS           
YTEB            : DCOCCOEYVPIDJXF HQCEXHIEWFNHJWC OLTYFSW         RXHHSYWH       
OTUCRHNQPKPK    : VUFJWIOGI       JGMWRVKWAUCOUQ 
BSBSPNBVIGLF    : PFTMKPJDIXNBMX  HSGENRPQKYYHQJM
MYFOHTKEVE      : HCNTVBNOUF      ALGTISYTXT      SMRI            OWCVNYGLOI     
MUCYMNUOIWJAML  : BYVVQ           SCTE           
VTKDU           : GWDSQEP         UTSNYCL         RGVHNQNIEBEJPNT OVMX           
DDNMY           : YREUFAXFMT      ALVCWJVKLOELW  
RXCEKYGJMVH     : KXBP            QDCJVWNKLO      AFHLJGXFNOH     EGSNLHTUYLBWSLE IBCD            DFEXTQBOBOKOBH 
GEMHSX          : LDEQFQI         MCCWSIHMVFRHY   EJVGYUTJQTJMF   XLDD           
OTSURPA         : TYRWPP          CXUGJLTDTJB     FGPVIAOFSCRVK   EVHSLKN         BHDMOTDJY       IITOO           FAIVKNLCGGCP    YAKHPNHQOKRGWWE
EMVE            : CTPVMWXPA       NKFCRLTO        GRXPVPBW        FABHRPMQYFCL   
THKGIRSUPAXWE   : RGWBBALQ        COML            SYXWBGSBJYB     RLWNQQGGXLDLE   MDBGMUKIDIGK    DFEXTQBOBOKOBH 
GWLMO           : QSJAVE          STMIADNBI       AAUECBP         MCOJTO         
FLAWLUDXQIFN    : XNWQTRGI        AOWVQCU         KMCFYFTQYW      LRJUVKNXFMDG    MQVKFUNGACHV    IQOSBEBTSHD    
PTAJMXAMXW      : JOVPQO          OCTYSFF         GXHQNGLR        HFYUKLCRBCTQO   MOFD            DTMTHFRYVJ     
LFSARJIYUIV     : OIWNCX          GHMXYN          KGFPJGMORV      TIUYHIXGTQHQNTG
FAIVKNLCGGCP    : FNRCVKMROB      WDGMIWU         OTSURPA        
CRIBQDMV        : ONPGXWGPVLBQDVO UMWQQXF         XPLFNYLVMKYUWER
MNHUMEFL        : EOLAKPVIDBF     FXSSLPO        
KNVJX           : MYYMHJEPWT      RAIHDUSVCKH     FIXLTHLJPDVF   
UCTDGKYJEHKVMYR : TTDRINJXU       DAVYC           RPLJGDYRESMWIS  MMSKTUP         GUHXFAEPSV     
OISLWARKMCXKLXW : HTFYMQGCPE      OVMX           
ASMH            : FWPAYXITRGK     JLJDAOGJFWBUII  TBDHGSBQFSKPSJP
LQKUD           : NMEYW           RGYHMQIT        ERAIHTPLVNLVDQG KYBGETQXLFNWGQN TJSWSDD        
IEATSIOFIOW     : XHPES           WMMYDMVBDY      AYNRPTOCARSVK   UTYEQJK        
EBROPPNY        : YRXEJGSTLFRSLHD VEFDWKFLPX      MTPW            RACEXSXCPREXAIA
HLAMXQWU        : XHDTXSKYM       RPINHNGPB       MDCRYCRAQJIOYHN
FDAGYTQOBYFAUJB : EBTP            HVVRKXCHRUM     NEJY           
BQEQR           : KLSWIAN         YHVOEUPIWFY     WJAA           
XEWNEPMB        : JMAIIPIMP       OGHSLJXRSKKKD   IWOCUMB         CHJAPGKHRVUAO   UYSHL          
UFOBGKTW        : MEPFKSOMKYO     XFKCB           GLYHAE          EFHIRKDSDSHH    BQIYTARC       
VDNQOQFPKLJCJJ  : MBNUQSLFR       JTAKXMWLTOEB    VHMK           
IWOBMQOHXFK     : VVMKNNBXWXT     HYBVG           HWOQVVIPI       UNBYMLPDE      
PECFCHSUVMAOW   : CWKANWWCSLXP    FVSOQRYXRJSTO   IUEXNF         
XBXHMIHBJVTYDTE : GIHYMSPWOFNUMR  XNVAHIAWJV      SSKBNRT         OFXQO          
YWTDCY          : JRKH            GJBMRF         
XTGKWWHLWKL     : PYELSPRWY       GCMHVRISVXP     LUGIYRFRMQX     AYNRPTOCARSVK  
WTOBEKUFPP      : NCWGQV          UNQCF           UEFEOQ         
DQIYTLX         : RGVHNQNIEBEJPNT HSWXIQX         EFHIRKDSDSHH   
JUOVRM          : UKHHIVEVPTAST   DCVJ            TIVWEDADD       OAWOIHMTDTHMMK 
DJPOQNK         : AJPPQAWLQ       ICLLMESSOUATALK CWIBMAVIRCARES 
QORLT           : NLTOY           AYNRPTOCARSVK   JIYSYHYWNCUG   
DGMVOOPCOV      : RKDCSVKEMJDW    SOEPTHBAW       IITOO          
JLJDAOGJFWBUII  : RLKU            FJHNTUFQFU      ASMH            PTVYDOG        
YDYVKDEXB       : TITCKUOINDONXJ  PLUUAFS         EQXXRIQYLS      BCGAGQ          QSPBBDEVVIUBG   YEFCMIDNCWKC   
ORXD            : DBYNKBMGRYDH    RLPXLOYPMHBCE   SIHOWRAEWK      IVHNAISOFW      NFWFYQHAFDCVLYC XUDCUQXWOJUBXLG
LPDVSDMAPTYSO   : DEPXPIR         OWCVNYGLOI     
BCJECHRHLRIGGCE : RJNJSJNMCO      KODVCYJT        HXMS            YIGPTVDJUGE    
SSYXQUEDWTXVMOI : FVJAIE          GQWXRIKKEPDOKX  IYDPNNBS       
RRWVBODM        : EXHEXADKSOXTQN  PJPX           
NSOQAALSCLJW    : XIBAMDBTXPNWTI  MOFD            ICLLMESSOUATALK
OTJMRVEAOXTL    : GHXWS           GEVDWV          CSYV            QLDFXQRISMIH   
UAYHIM          : OIWNCX          QFTH            HDIOYLUPACOM   
WFDWQXYDHXUVR   : SOEPTHBAW       NFWFYQHAFDCVLYC TBDHGSBQFSKPSJP
LKDRK           : DYVTYTKDO       MEAQRXIKVBXAW   LQREMBOUCPVVLKN
PFDJADIKLWNK    : SJSYD           QMPHNLJLRTOIK   XDIDEAREOUMTHD  QBAQ           
SIVQJBAIWV      : RPMOXXDEO       SRNURAKCVFP    
CJMHDAA         : OFGYNTJFROYR    XRSVXYCLHEKVW   KWMBL           SIHOWRAEWK      XJSER          
FFCHLMTWK       : SYSPQUIA        DVTAHYTFJUARUOB
KNCUJUENUOKTROD : SWKXNHPT        CPYQDRRRSJNREO  TEARXDASPPD    
VHGXCNE         : AOKBGXFNHLQ     QOMWSXPTMMJ    
XPTROGCYVGTGC   : CQILAPNMT       LAXN            KOWVNUBGJPWBR   UTYEQJK         XNOLQJFQ       
VWPGQJUW        : OABQRDVIPBFV    JNGQABJVT       VJYRGYOIVPDFXHN
QGYRIN          : FWCTXBC         GPWRMRSRLOUI    XYDXKURB        YREUFAXFMT      CKVHNOFERDSORT 
PNLMFAS         : NBIMODDW        LHBCNOTGFNU     KSFCBNFGDPJ     VBYLIPOGQOSCO   SRVY           
CPSVXUYTR       : PCIQITPP        TVENLAM        
ALBWITPQTHYJ    : YOJI            KPNQFTUHVO      GSAXHAMRBML     NKLTH          
RWQEERWQVO      : OFXQO           WDGMIWU         KOWRUQAL       
TMETIXLKLMHTJ   : XJCMBMENBKE     RCEADL          AWVYQJXDYL     
MDHMONG         : VREEN           CGXWUUEXJQPBD   OQBYPLQPEPLUP   NTUQKKHJPCO    
EKTXJKTBVOPAI   : YHXROTHFLXJQ    FXSSLPO        
BVJMKRJTRVWB    : DIXYSJMOTJOOK   FPGCYCSSGUWNIYY LQHHUNBEDSP     XTPJGKHPWFTJCS 
NOSBT           : CRWCCXBXRJGERJ  JXVHSDNNPANKE   FOREDISH        RWOHBMJMVFPAS   HWKPBXH        
VTPIOSFD        : XFHKYYVOY       XWXEVGJPTJSUR   WSBBUDUMWWMU    YJHDTDTRVDIQEHR RNWE           
HNHKJ           : PJFNYWAN        QEDTGHOXFBU     BPNSA           GLYHAE          HDIOYLUPACOM    LQHHUNBEDSP    
XTLJQFH         : RGWBBALQ        PDLRUSH         GHMXYN         
IUEXNF          : NHWRGSGJYD      IGRFJO          KVTBXOQNSIBLSB  YLOMCYOKOX      PECFCHSUVMAOW  
TDNJMC          : NKRPET          FNJIWVRCQUKN    YHXROTHFLXJQ    QALVXFMHPYLVAQP YECIPVNAMB     
THMBWUMIO       : BUIKOPQJWBFSC   RLPXLOYPMHBCE  
FCVV            : QMPHNLJLRTOIK   MVHBHJFEHDWMH  
FLRAPROXLIBATPE : DEBYLGTORBDX    NERTAUF         VTWMFJDUD       GEVDWV          PFCMHT          THAQMXHVAXBBAHW
JMMNLJAUXO      : SRRLTLXGKD      AJTTEORIA       VYEW            AXBEGLKPUJJGVG 
CKXNR           : WADHWWATCRBOI   NBIMODDW        TKEJDHL         CGXWUUEXJQPBD   HHAGWFWYG       KTLLMGDNHJSDFB  OKGOIURXVULPI  
GSAXHAMRBML     : AHSAAJI         BBLDBBLAGNL     MYBSKOYVJ       ALBWITPQTHYJ   
QLDFXQRISMIH    : XFSIFNGOIF      IYQJDMDXFBHGCD  LVANVCQT        BEJALAKGJBBJ    MGGAQPIYEBDAYFB OTJMRVEAOXTL    NHXSKXBEMGOARJT
LTMBMVHFX       : OGTCRQ          FTUSGOEMOXL     YBDIK          
OXUGCJTVAFBGDU  : RXDRHFB         ABJOTLKELO      WXHBIFUUAAFPSP 
NNMWX           : BTJSRKW         KSXRYKPXKLET    RPUVFSBFKTK     AILVEVLJ       
KRPLGNVNOGCMBK  : SAXFIRNT        TDTPPPTJKGYY    NLSJLIGGOMW     RAFKKGNRSTISNRO
KGMMLOUR        : GWFO            VEHIABMOAHHV    BBLDBBLAGNL     FSTJJDWMUX      FMTDGNEBSEX    
UFYJEYMOTEBASWQ : HXRVPTJCXFSMX  
DUVGGNSM        : BBWNLPIBXYNG    XDEVKMCIURPEPS  YTCHMQNSF      
HBQDU           : PCIQITPP        DXKAV           IGRFJO          HQWD            GUWFQTRSTGI    
AAEKFD          : HLDCXKXRUU      HTDJGDUAV       HOHURREYGP      WKPUJLJ        
VYEW            : OIVPIPDVBOWC    OGOGG           JMMNLJAUXO      IUYC           
YVSIBNEHTRC     : PCIQITPP        INTR            WALDOBDCU       WIRLIEFYNR     
UKMNPH          : POAFSGOT        BJJVJM          YBKVYUOY       
PHWCOCCL        : AEQD            TRGSFIQKX       LBNMKMDNIXUSV   HHYCBQE        
IKGJHYRIMV      : SALDJFLCWK      TEGBJIPPUONY    BPNSA           YEPM            DTJEMEJ        
HQWSNHFDYMVPVUT : FMTDGNEBSEX     ILVNMTODCRUKM   FIUMISYF       
AXBEGLKPUJJGVG  : KPPKSCHMNPDUOF  IPQLSUW         JMMNLJAUXO      HXVQIINNKYAB    IOJK            DQSUNHL        
FYXXOIDRHR      : KXYVCSVYQ       ALWG           
YOLTE           : HGOE            BWSDU           GJXCVM          HROYBNLVPY     
RFPBQASMLD      : HIIOLKAMUVO     HVIS            HWJXUNPGVGNYEFU KGDIT           IGYQO          
ILVNMTODCRUKM   : UIAXHOGXD       KGFPJGMORV      HQWSNHFDYMVPVUT
LDAFHLAM        : CHBHCAOPWIMC    KGFPJGMORV      CORSQBC        
DFEXTQBOBOKOBH  : XVLMJHVHCI      KWMBL           RXCEKYGJMVH     THKGIRSUPAXWE   JGCVSPJJQ      
GJXCVM          : KUTYN           VBLRSYOTF       QSPBBDEVVIUBG   LWGGOUHKHVGST   YOLTE           RCFW            IOBEKPOMHOJAJF 
IPPPWERLIWS     : SURKMHUBGVQ     JYGQBXYLHSKNY   ALGTISYTXT      CKFOWOLXMDYH   
VNFYEIO         : DSSTR           DHJJO           OEVFPCMELUTY    CVQJGFSFE       RPMOXXDEO       RQQU            MJAV            GDFXHLKK       
ARYD            : LLFLDMOUYCXXW   LVANVCQT        SBYCXGESCPLVA  
KDDHPURHLHEPCRA : MYYMHJEPWT      XDWHIB          BVFEQ          
LMWBUWHDNYDHAJ  : RHPHKXYTUOFIFAI XLEQVXB         EQXXRIQYLS      PVWVEKORSMQD    SREBWPGLRYYT    TGCIA           NLTDNMIXFJNUF  
LONUHJMO        : LITHRNF        
VVOANOABDYCXVME : QLSW            VBLRSYOTF       GIDUDEHR       
LJTOUEAKSW      : TCWOXJIFU       OXJSWF          ALIP           
CJIYH           : CORINB          VXNAJBFEJRMRNIO TXUDJUYKEXIS    YPRPNRXUYEHGGY 
PIUE            : JVOKEFUYP       PSHHRIIHAKD     TEARXDASPPD     PTNKFNGXYAXKH   JGCXBLNYDJV    
VHJBIINMV       : CBRMT           QIFVEDUS        PRIUJBGKRFVD   
XRPTWREPQXTAG   : EYYKTERJLPD    
KNKUIOFEXQHGBUU : BPMJWTJAA       SRAOEIBJWCIUBB  FNRCVKMROB      YNPWSHKSPBGBJDX
YTPONM          : CXUGJLTDTJB     UYBFDM          HWOQVVIPI       TJOVLV          ICLETYB        
TEARXDASPPD     : QOBENMKUD       XVLYOPQBN       MCHU            KNCUJUENUOKTROD PIUE           
XTPFSIMYKI      : RHPHKXYTUOFIFAI CKNMSH          GRYGBFVQWKYBI   SGVEAXGUI      
IHOAXEPJXT      : DAVYC           AVVXF           OAOOWVGF        PJOVRLURGAICJF  QYNLAKYDJNOAR  
RSPRNF          : VDWE            MJBVSWDYLMVSWIW SKUR            CMNNLPJKCG     
RPINHNGPB       : YHYANRNFQMSH    CGRID           NMOOHWRVCWXVGXD VLPKFL          KPPKSCHMNPDUOF  HLAMXQWU       
CLDMSTNS        : PBFPPSLUWW      LDEQFQI         TEOVSCOABO      QSVRHEY         PVGLIKBCFPFCG   FWPAYXITRGK    
DFVYRNRHHIO     : RJNJSJNMCO      UUWMUUEENBV    
CEBPNQWFRFIFI   : MUVWEMHBAJYITY  IACNDJVFJF      VDSNMACL       
ACKTAPYXPQLJAUR : BUJK            OETFDKTMVGNH    OXJSWF          KYBGETQXLFNWGQN
NTUQKKHJPCO     : ORWXEXIJPNHYDMQ YSSYJQFC        MDHMONG        
HYXIDIEDBDDQVQ  : AWVSH           CGXWMDSEEEEUNAA MTINBMLMXFURI  
XLUMBQJRBTCMLG  : TREEMDVAAM      CPUHTY         
MNCKXF          : CHJJI           BNXCXANDE       KODWWICYXV     
CKVHNOFERDSORT  : TXVVWVVYBCSS    RACEXSXCPREXAIA ICLLMESSOUATALK AJTTEORIA       QGYRIN          XPXSAR          QEEKB          
BMJWQVJW        : VCLYNDVIMMK     JIPA            SENPOSBMFR     
VMCIL           : UFUKKGWEJ       FOQHBLQSJUGMCG 
DNSCXJSD        : HPSX            HRNWOOHI        FPDY            MGGAQPIYEBDAYFB
MHGBB           : QEDTGHOXFBU     MQUFJWBGP       EUPNMWJF       
HDRSC           : OGOGG           AHTECQS         EITXFKM         TQDKGOKMXFBXGRL
OLHOJ           : CGGGEHGHTYD     EHOJGMNCSQQAT   WJAUGKNA       
RRFCXVWCTGUYWI  : CHBHCAOPWIMC    TYDRRMBHQJUHMA  AYRHO           KNVJEHOFWGO     USHVOESESA     
FLKISPAL        : YTOAGUT         KEDUXFWPEM      TWWSSNIQMVDJTQ  KXDGMGNAHHTG    ALODIYHWNPFOI  
KDERRNMLITPI    : DBLCAYULF       LQHHUNBEDSP    
NKLTH           : QFSRILLNHUD     FNRCVKMROB      KVOIFATGQ       ALBWITPQTHYJ   
SRVY            : EDUPHMMHSRUAECU TEGBJIPPUONY    PNLMFAS         HROYBNLVPY     
GHYXKNQUQUNKK   : PPECXXRBW       JIQNMF         
YUVODOEPABXN    : TKEJDHL         OECCXPCRUYHWOE  ALGTISYTXT      OQBIHD          OIBWMADSEDFFE  
RKUVSDXRPLIK    : RKUYECC         WJAUGKNA       
FAQREPPBHSRN    : DXKAV           CVCV           
ROLILDUGCNLAH   : XNWQTRGI        SSMPUQBK       
NRORYQITVBJY    : BYAXGGMNOM     
EQVPKNDSYHNFJER : YFPXOFBOTERLKFY CHJJI           YECIPVNAMB      TQMADWOIVNSB   
NUYGJQHDBBY     : VBUBHQ          LRPCUVNAIJTLKMG IPQLSUW        
MXKROJJYWPU     : IYYUTHGMIAIJM  
WKDIOWVDUULGNUJ : NDMCOXHDB       JNGQABJVT       FMVSDY         
WIRLIEFYNR      : VHMK            YVSIBNEHTRC    
MHVM            : IPQLSUW         AOJDRYDRPQ      CJHSNUVNKLRM   
GSOXRMDMHQTULD  : ADWISVGPVQ      OWPKN           OFLPOFLUVFEVT   HCEUFQIRQOOJYB 
KODWWICYXV      : DIGFLEP         JUDJ            MNCKXF         
NDXAJGSAE       : IRRPOJ          AHSAAJI         JIFX            QKYSSI          FCBSVEEM        FGDEFXPTP       NNSMJPDKX      
MJAV            : LQJSD           BEBGSSA         WQKUMTUSUPJQ    QUQVMQGWKWKJMV  RAAQHLQNFHWWX   VNFYEIO         VIHSUPB        
TQMADWOIVNSB    : FTHDVDCIC       ULPSWEX         EQVPKNDSYHNFJER
RWOHBMJMVFPAS   : IPQLSUW         KUYTLGYCXJ      EKTWIN          NOSBT          
KSBMPTBPY       : KRWLM           CIAKLHIQ        VVMKNNBXWXT     PSHHRIIHAKD     TMHP            MEHIBARVMURIUH  AMOQXYGP        XYGMSRXBXGRL   
GIWVBXJUVACYP   : GDJXJKAIFPEX    SCHGFOXXKFYL    FXSSLPO         IPCHJTACKUEFURY
NLTDNMIXFJNUF   : EDIMLCMQPYINI   KXLRMVCB        SFXCQMIDOBAKR   TKVE            DXLLR           LMWBUWHDNYDHAJ 
MFPS            : BRIQNPQJLBCPOEG GESEOU         
NPONBMLBOKQDBE  : RAIHDUSVCKH     EEDLHCYMS       NMOOHWRVCWXVGXD EGSNLHTUYLBWSLE
ESJMSRXGMEVAJN  : DUPCTUTV        XNKV            DSYRLKIEU      
YBKPPNCDPROIWP  : RKCQUAEDLFMGUVM SAXFIRNT        CQILAPNMT       UWSXVPPINLI     ICLETYB        
WVGIL           : RACMVOSUTIICIG 
ALIP            : EBYJOMNCKM      AQHAF           SCOSWO          UNEXCIGWWMHGLD  RCOMHRFLGWK     LJTOUEAKSW     
GRBTMCVASNNUSDO : JQRHSFRXYWF     BFTY            CIDMPYAH        RACEXSXCPREXAIA QRTHHMPFTP     
OMYEJXMRJNUU    : GVPYNYX        
KNCCQYQTWQM     : CVCV            QUXSXGW         DUOPIGXAS      
FJDK            : UNRMOHU         UHAKPYQHJYT     QSPBBDEVVIUBG   YSUVUAYGV      
NBLOFWOR        : XITFGPRTRHVB    FQIISGEPLIE     MEJSQRMCB       ITCISSGNUXIPB   YGWYDGPEIIPXO  
AILVEVLJ        : OFHWD           OMCJBLAGTESEDPY URLLTF          JTPMOMK         UWGDGIUXNHVYDL  NNMWX          
EITXFKM         : WTVJP           IJYL            OIBWMADSEDFFE   HWTUKRCNANT     HDRSC           RSWAKKJWB      
RWWFVMIJE       : CJAXB           GLYHAE         
GUIWVSLT        : AOWVQCU         RYLMAF         
JFJMLTGMBS      : AOWVQCU         MEHIBARVMURIUH 
UNXTSVJD        : NHWRGSGJYD      DHNVOINWUCM     DIXYSJMOTJOOK   MDPDWK         
PTNKFNGXYAXKH   : SLCWIO          HXFXJGOTCKPR    DSYRLKIEU       TMVKDBGHARIU    JXCHHCFGCGNS    HCEUFQIRQOOJYB  PIUE            NPCBMEPFHPFFXNU
PTNKFNGXYAXKH   : LHOUYTNVT       SXAILLYWXBDNCUX
WTDDGGWHBMGXF   : YEPAELMAC       EJVGYUTJQTJMF  
HKMWFAJKPQIQ    : YEPAELMAC       GYFSYEMTTUFYWN  DXKAV           LCIDU           FBVBYMJUBVLKY   CWKANWWCSLXP   
JCYSYUYFBFEIJQ  : WTBUYDUCTMSWSG  SOQOYP          TXUDJUYKEXIS    TFOKQODVODLGK  
HXVQIINNKYAB    : TYDRRMBHQJUHMA  NHGFWFGGXDER    NLTOY           PSHHRIIHAKD     WSBBUDUMWWMU    AXBEGLKPUJJGVG  CCMD           
LRJUVKNXFMDG    : GXXTBLMNKVVW    GHNFBJDWN       WTECVPIHHTISPW  MYBJS           GIDUDEHR        VSIYLJUHM       FLAWLUDXQIFN   
HOEAGLXECGMRW   : GQCYEXSOV       ERAIHTPLVNLVDQG
QWAJKUSF        : AVVXF           XQGUWKTBEPXMOM  PVGLIKBCFPFCG   QFDUTKKFFJKKCDU PVRJRJYMRALKQES
DVOIKTQ         : GBVNXS          JXCAOWYJEFK     QOCAEYJSJVTLEJS
DHJDPWBTBIGUH   : XVLMJHVHCI      XUEVJIMXLB      ERAENVJMDKMSCAB SREBWPGLRYYT   
OGGXRBSYUVU     : CGGGEHGHTYD     LOBFMAKMKRGONR  SEWTAHGEAJGVAW 
GIEWNHEALWYO    : FVJAIE          XJRHGS          AJQL            QGMFMD          FGFQQCQLPXGFWF  BEFVD          
BYAXGGMNOM      : XJQGABNTNN      QYDGFTF         NRORYQITVBJY   
QFGLDEWJMDI     : YOJI            PODWFQQJBS      XXEWYRFFC       HSWXIQX        
NPCBMEPFHPFFXNU : UFUKKGWEJ       KXURYV          OQBIHD          PTNKFNGXYAXKH   LTYDSGY        
DHUT            : HSGENRPQKYYHQJM WSTYKWRSOHJFQWI CGXWMDSEEEEUNAA RACR           
EHUK            : WEVNFGJUKUF     VYODDNPTS       CJHSNUVNKLRM    CVQJGFSFE      
HWKPBXH         : MKXF            XVLTGGXBO       ESVRUHLHOWXCJ   NOSBT           WACUNFST       
BTKQARIHWHVTUYE : LLFLDMOUYCXXW   GSOYS           WXTAVBRJG       NGMGGVKCOIW     MTWO           
UTYEQJK         : NOFHNR          IEATSIOFIOW     XPTROGCYVGTGC  
IWOJ            : LCIDU           QKYSSI          JGCVSPJJQ      
XPXSAR          : FEPQVENVNW      DCVJ            CKVHNOFERDSORT 
RACR            : BNBGKAA         QUXSXGW         YOMPRIOFKUFW    DHUT           
ANHYRCVNBAFKLD  : XIBAMDBTXPNWTI  OQQYWJDVRHB     MJKTRAKNFUPBE   IXSEEBATBIRP    QEEKB          
ITCISSGNUXIPB   : OCGMFSXEVAAB    WWVEHKFMFKTLBL  OYTF            VYODDNPTS       GJBMRF          NBLOFWOR       
HKNUROP         : XTGMNKGVL       SBFRALAGI       XHPES           CWSNPK          IRRPOJ          ENAYOGTMCREYCDC
LDWLKHYOCKI     : XCLNGWYBK       FWCTXBC        
SDCYQWABMBOVN   : JVOKEFUYP       RLPXLOYPMHBCE   CCCKTJCGJR      JIYSYHYWNCUG    PLNYBRAVX       IUWUILHFRU      SPESXPDIQC     
TGUJCIOAUAJVQOG : UAVHWAOSHR      IXUVQYOHJDWFSWF PDTFQDLUE       COVCXQSFO       UNEXCIGWWMHGLD 
VYFABVWDXMEOKR  : BHQEUDFEXDETPI  IYDPNNBS        KQGGLSYRRLAF   
EAPPFBFFVH      : UHHOCIT         VFQVKFRL        SGIQ           
TXFBYDCE        : HVTBJTVDVPC     VYQI            WCYUESU         QWJPH          
FDDIDPORA       : CPYQDRRRSJNREO  MJKTRAKNFUPBE   KYBGETQXLFNWGQN
OHLGYQ          : GIHYMSPWOFNUMR  AOWVQCU         MIOGUOU        
GXFNPANWB       : EEDLHCYMS       XXEWYRFFC      
BFVELYJVCYNVCWK : FBGJSBQNACAP   
IRKAYRA         : UNRMOHU         SCHGFOXXKFYL    GQXTRRAEPRDCI   GDFXHLKK        BVFEQ          
HPFVPINQPJWDJH  : IMSVESKSRCHCEKI TNDIOH         
NIPKMMWXWQLYQF  : QYNLAKYDJNOAR  
XMPFKHPX        : PJVUXWGF        OSRCBFVQASXVTD  CJHSNUVNKLRM   
FIXLTHLJPDVF    : JMAIIPIMP       WSKWYRDIFKJRNI  BACPIICDMICKSDH KNVJX          
TFOKQODVODLGK   : YOJI            WBJOLGV         QGLNIGXTSIRJU   JCYSYUYFBFEIJQ  MDPDWK         
OAWOIHMTDTHMMK  : UTUAYPXPSXAX    CSYV            JUOVRM         
RCFW            : GWDSQEP         IGRFJO          ALNLBFDDATV     NSJMVOLYMD      GCMHVRISVXP     GJXCVM         
RQHX            : HXFXJGOTCKPR    MBESWBR         TQTMSNLXFQLRUS 
VBAFOYV         : EKUFGPHDN       OGOGG           GYXTCXPNISV     ERAIHTPLVNLVDQG VCKH           
XKYHAUKTEYI     : GNBILL          JNGQABJVT       WXHBIFUUAAFPSP 
KASRA           : WQKUMTUSUPJQ    MVHBHJFEHDWMH   SFNNQEHOIA     
MQVKFUNGACHV    : HJCKHMKG        ABVVFSOSKBCRKX  FLAWLUDXQIFN   
FIUMISYF        : SFXCQMIDOBAKR   KSXRYKPXKLET    GHYAUN          SDTNICQ         HQWSNHFDYMVPVUT QEEKB          
XNOLQJFQ        : AEQD            GKASUINA        EXHEXADKSOXTQN  HCEUFQIRQOOJYB  XPTROGCYVGTGC  
RJUEO           : ERAIHTPLVNLVDQG
SWRWEPSJAOX     : QJQAE           GHMXYN          CHJAPGKHRVUAO  
JYQI            : SFXCQMIDOBAKR   MTWO           
GWLYJQRJLBGPSX  : XJRHGS          FKERPNYUJY     
PRIUJBGKRFVD    : VCHUMVYWFR      FNRCVKMROB      BHDMOTDJY       SMFPDRVPBOPAI   VHJBIINMV      
OMEWLRYULQH     : FJWACCAHUMRXES  FNRCVKMROB      LMJFUPSP        UDANLHV         KYGF           
UNONOCDGKAQ     : QTCCRMC         TGVHQ           KRQFEXUKQS     
HDIOYLUPACOM    : WOFL            LQXOYRSVUYATCHP VHKXMUYKLXJVKUB UAYHIM          HNHKJ          
NJHHQGCHXRVAU   : JYYO            BIUIRR          JXXEENBRGBOD    EKAV            IOBEKPOMHOJAJF 
MXWA            : DBYNKBMGRYDH    XWXEVGJPTJSUR  
AKTBYQQYSG      : CECYTILARWDCFRP PRWSNCSGY       DCPEL           EBTP            LWGGOUHKHVGST  
PTVYDOG         : LEOLKQCHP       LYQIVTVMPJXV    XDWHIB          JLJDAOGJFWBUII 
VGWTG           : PCIQITPP        WSBBUDUMWWMU    IXUVQYOHJDWFSWF AKSH           
YSUVUAYGV       : QODQI           GUGV            NERTAUF         OVJKWHNDFWYWWBN HWTUKRCNANT     FJDK           
FMRGGA          : UMWQQXF         IOWDWAFSONOBQ   JFNDPTHKQTKXWXC
XVQWAHFHEL      : JIQNMF          GUWFQTRSTGI    
ARCBMWAIYYQU    : FBRKGLKRVDRXRP  JUBQCTNF        QVLQXUNPAGT     EHPPFVEYRNYK   
XJSER           : JLICHIUGDSOBPF  LPQAWA          HGQDCCCSNHWF    CJMHDAA         RXEND          
YPRPNRXUYEHGGY  : CJIYH          
IOJK            : SJSYD           KAJUI           LWTWML          MYBSKOYVJ       AXBEGLKPUJJGVG 
KLNHMLRGPJ      : KXLRMVCB        TTJISMRHXBGLY   RJSIHH          PXDD            IUWUILHFRU      NTLASRAFWQ     
PAUHPMHKONRWU   : QJQAE           PTOGPWAKXUWNAT  NNFW           
KFIVRH          : DKKNIHYBXWE     IYYUTHGMIAIJM   PTOGPWAKXUWNAT 
DUOPIGXAS       : AEQD            MEAQRXIKVBXAW   OAVKUPABBPWF    FOREDISH        SSMPUQBK        FLVGTC          KNCCQYQTWQM     RHWJXLTNU      
RSWAKKJWB       : VXNAJBFEJRMRNIO PDTFQDLUE       SSMPUQBK        EODMBTCT        TFAIERWLFYGEDLO EITXFKM         YNFYLPTONKVYSN 
RASLKAVHRFQ     : NKTD            KXYVCSVYQ       KUTYN          
AHMKQLKJN       : EMTOUJ         
CKFOWOLXMDYH    : HWIUK           MMTHWFYQMA      OHCQDYCFVI      IPPPWERLIWS    
LHOUYTNVT       : LRPCUVNAIJTLKMG QHIWRK          BRIQNPQJLBCPOEG RPMOXXDEO       PTNKFNGXYAXKH   GACMVGFSG      
JGMWRVKWAUCOUQ  : DEBYLGTORBDX    CNXSNVBIT       KDHU            BCGAGQ          JGAPLFWF        XEQFLJG         GQWJCVPWSRRP    OTUCRHNQPKPK   
SGGTN           : VCLYNDVIMMK     AVVXF           RPMOXXDEO       DTMTHFRYVJ     
IVODWI          : EVPQONEFOATECAY OHCQDYCFVI     
VDNHLCGDXQCANE  : HCEUFQIRQOOJYB  GSAOODFTVRMP   
IXSEEBATBIRP    : WWVEHKFMFKTLBL  AXGBUNCQ        SQNGJLB         ANHYRCVNBAFKLD 
RXEND           : SFXCQMIDOBAKR   TYGQNRV         XJSER          
WPVDUVVAXJEOUEJ : PIIV            FGHPGPMXPO     
KNBFOKWGY       : JATPMBCN        AMABMTQPI       LTYDSGY        
EFEKYBCWG       : NGAWKSAE        BCGAGQ          IMKUKSKRVB      GXMDQ          
UCWSOEJLKSM     : PJFNYWAN        OXSPFVFFPUAQ    YKPQBAPCKJOWK   KXDGMGNAHHTG    CPXVPRV        
GNBWAADYRKEV    : HGPPLTTQDKWTPU  PXDD           
FAWEGVYLVTCCDN  : RKCQUAEDLFMGUVM ROVSNSCYPCNEBQR XDWHIB          CIFFUW          WARIRI         
YAKHPNHQOKRGWWE : TKWTY           KVTBXOQNSIBLSB  OTSURPA        
CESJNPIBNDDR    : RYTRHB          LVHXUKFNOWD     SRAOEIBJWCIUBB  WBJOLGV         SRNURAKCVFP     PGQBQHHUAEBQ   
QEJSPTIDBBTNT   : OGHSLJXRSKKKD   MFJAWJNDALBB    MJKTRAKNFUPBE   KAIVW           FGHPGPMXPO     
LQHHUNBEDSP     : TEGBJIPPUONY    PSHHRIIHAKD     EASUN           BLACUUUCAORX    GJBMRF          BVJMKRJTRVWB    HNHKJ           KDERRNMLITPI   
GUHXFAEPSV      : JIQNMF          OPPLXTUSPFX     QGLNIGXTSIRJU   YAWJUOS         UCTDGKYJEHKVMYR
CCMD            : XFHKTRDMYUS     OXJSWF          HXVQIINNKYAB   
AYYNRIVNVWTAPL  : TTDRINJXU       LEOLKQCHP       DEPXPIR         GCRB           
XGQX            : WTECVPIHHTISPW  XAHCH           XOFFEKGKOFKBAQ  TJSWSDD         GGHRBFS        
QEEKB           : AUTFFLUAF       ILASDBRIJ       CKVHNOFERDSORT  ANHYRCVNBAFKLD  FIUMISYF        MBVJXLAVGKRXO  
MDCRYCRAQJIOYHN : PCIQITPP        HCNTVBNOUF      GQCYEXSOV       BNBGKAA         UBQAMXL         EODMBTCT        HLAMXQWU       
JFHPD           : GUPADNNYQH      FSTJJDWMUX      PLNYBRAVX       DCVHXDUBGDBYRQ 
GDFXHLKK        : UTSNYCL         YETRE           GUWFQTRSTGI     LKSPMR          PIJTFJOLDAGM    VNFYEIO         IRKAYRA        
YNDQPFK         : GBISKQQSUYGN    XCUGJJFRMCWIAG  GASQVBDAH      
XWBMXIATTFEJK   : JYYO            MWFOOGGSBXMTH   JYMORTLQSNKDGUQ
SPESXPDIQC      : EUNEBOPTXONMUY  FCBSVEEM        SDCYQWABMBOVN   QYTUUNNHKM     
TUOYIGAFHODRRAL : TMSAC           OVJKWHNDFWYWWBN QUXSXGW        
GXMDQ           : IYYUTHGMIAIJM   RLKU            WNUTJAANUW      EFEKYBCWG       BQIYTARC       
HLCW            : BWSDU           JGCVSPJJQ      
NNSMJPDKX       : OFGYNTJFROYR    EPBUFOLFLATH    EKVQMUFHOQKP    GIDUDEHR        LAGQ            KOWRUQAL        NDXAJGSAE      
KFTA            : ICTX            NFCVQVYA        OABLOTETRXVAWP  KOWRUQAL       
NTLASRAFWQ      : WXLAIEXNHU      RJFSMMV         VTQJAAHHLPUM    QHIWRK          QFYGCSRAFLUAINK KLNHMLRGPJ     
EEKDSXSNMCFPME  : EPBUFOLFLATH    BNXNPFBUFIV     MHRBCWU        
ALVCWJVKLOELW   : YTGAQDPWFVRXILO CCPMDXLKNUVEDSM HQCEXHIEWFNHJWC DDNMY          
EFHIRKDSDSHH    : WQOEASSDTB      PPRSKXX         TEVXOJQL        KPNQFTUHVO      UFOBGKTW        DQIYTLX         OEKGDDMIT      
XUDCUQXWOJUBXLG : GHNFBJDWN       AXIDIUXCAJBNRGG HQJTFIGDO       YHYWFMQCMJAS    ORXD           
IJQPRYKCFDIXMPW : HLDCXKXRUU      BEFVD          
MCOJTO          : MKXF            LKSPMR          GIDUDEHR        IMHBHXEAEKD     GWLMO          
KYDLYPTIA       : NEONPIXN        BEFVD           OEKGDDMIT      
BQVBBAGGKESBE   : KRUHSB          AWBDIKIDEEFOO   TYGQNRV         SHMYDDYSDUPM   
PGWCAMKMNQY     : KFQCDUBCSI      JYGQBXYLHSKNY  
IUUIYWY         : CWIBMAVIRCARES 
ACXIIKOENSME    : PLUUAFS         FIQF            JXXEENBRGBOD    SRAOEIBJWCIUBB  SRSCRADLDH     
JGCVSPJJQ       : PPECXXRBW       QBVDRLRXSFRAN   QKPVN           QSVRHEY         XYFMGRJJXTOHA   MEEKTGRFUAUG    IITOO           MDBGMUKIDIGK   
JGCVSPJJQ       : THAQMXHVAXBBAHW DFEXTQBOBOKOBH  IWOJ            HLCW            NYJKD          
TLTDNS          : RHPHKXYTUOFIFAI KEDUXFWPEM     
KUHKDPVRVJL     : SCPI            HBDTXQAN        HVIS           
PNSVPQRFBDXYXK  : XHDTXSKYM       PTOGPWAKXUWNAT  OLTYFSW        
BXNHIIOVLHRG    : VVKBTSAV        JOAJTVNPKIMD    QUXSXGW        
DTMTHFRYVJ      : PTAJMXAMXW      SGGTN          
YNFYLPTONKVYSN  : IWNK            EXHEXADKSOXTQN  EGXUG           OVMX            RSWAKKJWB      
HUONXT          : RIHAUIPJ        HFLYGDCTT       TPVFQ          
KNQRGPQPWP      : ERBLFNDQE       KODVCYJT        QOMWSXPTMMJ     QATXDPDNLBEKFB 
DQSUNHL         : EDPKKKVVJPQ     YETRE           AXBEGLKPUJJGVG 
GMQTJXQANOTUCIN : GGEMWLOOFYMPLK  TXVVWVVYBCSS    HRNWOOHI       
OEKGDDMIT       : BDGWWDI         EFHIRKDSDSHH    KYDLYPTIA      
EHPPFVEYRNYK    : ARCBMWAIYYQU    USHVOESESA     
NYJKD           : WDIWUEORQRRV    GRXPVPBW        WEDPEN          JEPLNLVHLHKP    HHAGWFWYG       JGCVSPJJQ      
YXIFKPKNE       : BTGTDLEWB       QIFVEDUS       
IJARY           : PPXD            YRNEMLUCC       CCCKTJCGJR     
AWVYQJXDYL      : DUWNBYQQIEVNEIL KLSWIAN         QKPVN           UJHBNKNSLOG     TQRGASYJNTP     JBQDRBSCJQY     TMETIXLKLMHTJ  
KYGF            : BBLDBBLAGNL     NUFQSEYMJIDBQL  QIXHHNWYHFN     KIESUMABVMTKV   OMEWLRYULQH    
GNFRF           : JOAJTVNPKIMD    SYSPQUIA        NKRSKM          UWHOMHV        
HJJRVJKW        : EAKJORXFVONOI   IRRPOJ          JXCAOWYJEFK     SBYCXGESCPLVA  
MWWLNILRJXWWYF  : OLRLGESY        COXTXPDUSON     CWIBMAVIRCARES  IXFB           
WOPE            : CWSNV           SLOVMRLIRYNLQFY
XTPJGKHPWFTJCS  : EXCUFDLYH       JTRKTHEDJSRBYIL YAMP            BVJMKRJTRVWB   
REILPI          : CBYDYU          IPQLSUW         JOHLRJT         WKPUJLJ        
MHSOGHHKRHFJ    : BMKNF           GUWFQTRSTGI     HYLVYTXSLNNM   
LTYDSGY         : RYTRHB          LFLS            JIPA            NPCBMEPFHPFFXNU KNBFOKWGY      
IUYC            : FUGEPETTL       DAEGSPKRAY      RCEADL          ROKOJFXUHF      VYEW           
IQOSBEBTSHD     : FLAWLUDXQIFN   
SWJAHDNDEQWKS   : FSINCHNU        CWSNPK          YHXROTHFLXJQ    QNUYMO          SUYEITUFIF     
UNBYMLPDE       : RPLJGDYRESMWIS  IWOBMQOHXFK    
JFNDPTHKQTKXWXC : PCBIBJDTSLOL    KAMNTFCKEFSY    JOHLRJT         FMRGGA         
QYNLAKYDJNOAR   : JUJXFF          CBYDYU          FKOJVVFLSBAE    IHOAXEPJXT      NIPKMMWXWQLYQF  VIHSUPB        
TBDHGSBQFSKPSJP : VVMKNNBXWXT     OJOHJUJ         LKSPMR          ASMH            WFDWQXYDHXUVR  
MJVAUY          : FNFBJSBTEWIRJO  TUTMOW         
UCVITXCP        : RFKNOUX         VJYRGYOIVPDFXHN EVVAYBX        
GSAOODFTVRMP    : UMWQQXF         UIAXHOGXD       RCEADL          EKVQMUFHOQKP    VDNHLCGDXQCANE  YGWYDGPEIIPXO  
CMNNLPJKCG      : RSPRNF         
BQIYTARC        : NQVCXEDLAPSR    KLJPTGFO        VTWMFJDUD       FCBGBHALJLRD    UFOBGKTW        GXMDQ          
RQKU            : COXTXPDUSON     TQOO            FOXNXQODLYVT   
GTQS            : QRQYQPBKTUNJ    ESFLD          
SXAILLYWXBDNCUX : EXHEXADKSOXTQN  XOEDYMW         EJVGYUTJQTJMF   FQVIUY          KMCYVTLIWRA     PTNKFNGXYAXKH  
QYTUUNNHKM      : JYYO            IFOOPVVFVLCMJMK IMHBHXEAEKD     SPESXPDIQC     
GGHRBFS         : EEJC            KMCYVTLIWRA     DPOQFFWOTIPGH   XGQX           
SGIQ            : UXQHWEOKUJOS    CKNMSH          EAPPFBFFVH     
MTWO            : GNBILL          KFBNGXRLEE      CRACOJ          PVEDUNANATWH    BTKQARIHWHVTUYE JYQI           
USHVOESESA      : ONPGXWGPVLBQDVO GKOVEMBO        FWPAYXITRGK     RRFCXVWCTGUYWI  EHPPFVEYRNYK   
FOXNXQODLYVT    : TTDRINJXU       MYYMHJEPWT      RQKU           
MBVJXLAVGKRXO   : HLTWVMDOB       QEEKB          
CHNTPESDCLS     : BYVVQ           WEVNFGJUKUF     FDVXYJC        
YTESD           : CGNWJ           IMKUKSKRVB      OOVOXA          GCWCPFDIHK     
WACUNFST        : GDJXJKAIFPEX    FNRCVKMROB      PIJTFJOLDAGM    HWKPBXH        
NTIBWQQSIVNNXB  : XWXEVGJPTJSUR   AXGBUNCQ        OXJY            MCCWSIHMVFRHY  
GACMVGFSG       : CVWFLK          DIXYSJMOTJOOK   LHOUYTNVT      
PVRJRJYMRALKQES : MONRLGESFXY     GCWCPFDIHK      QWAJKUSF       
UJNVRVWUIUDNNLA : QEDTGHOXFBU     NHHGYDNI       
HROYBNLVPY      : GTWDCLGJOKXJTMY EFMU            WIMNMKR         FNRCVKMROB      XDWHIB          YOLTE           SRVY           
JGCXBLNYDJV     : QKISJ           EVPQONEFOATECAY PIUE            HUHSYCMBUK     
TQDKGOKMXFBXGRL : XGOSYKJDJQX     CECYTILARWDCFRP CHJAPGKHRVUAO   XQHVEQUTJQRR    AMOQXYGP        HDRSC          
JLLSTNTU        : SDRGRMOJQ       HIYJDQGO        XOQEVCLFNMO     MXEYKASK       
JTEVSFPLIAU     : PDLRUSH         HOQUCUPNVPUKVUP GHVILDGEGVCI    GLYHAE         
NHXSKXBEMGOARJT : MQLLBAPJHJRFGQP KNJEWUEMTLSAWWE YJHDTDTRVDIQEHR LPQAWA          UPKQMD          LAGQ            QLDFXQRISMIH   
FQIPMMLH        : JUJXFF          AJQL            MXEYKASK        WEVNFGJUKUF    
BVFEQ           : CYSE            KDDHPURHLHEPCRA IRKAYRA        
RAFKKGNRSTISNRO : NDRFS           RXHHSYWH        QRTHHMPFTP      KRPLGNVNOGCMBK 
XFFPTUB         : IJYL            HMAETXSXDRMAK  
OEXT            : BLACUUUCAORX   
QBAQ            : YOJI            LPEVLHFSVWJRXQ  SPTXQLCCG       YBDIK           PFDJADIKLWNK   
MDPDWK          : BQEA            VEFDWKFLPX      UNXTSVJD        TFOKQODVODLGK  
FFNATKABSPUP    : JTPMOMK         OQQYWJDVRHB     KSTQGLQAGQVSTCE CHSVSJJBBC     
YGWYDGPEIIPXO   : JTLPSVKIRXIVTCC TSYSDYVMOE      NBLOFWOR        GSAOODFTVRMP   
BLRATYNTSBTVV   : MPUW            TWWSSNIQMVDJTQ  TKKPFHYSPQQPUC  SQNGJLB        
TLCSRBSWHKCQVTO : TLKFNEILSNINVNW WITDGQQGHGYIWTM
CPXVPRV         : DGMWERARTBQ     YFPXOFBOTERLKFY PQFXWXDR        XICWEGEXJ       EJRLVCKSVD      UCWSOEJLKSM    
NOJJ            : IMVOPAMHE       OTAGMMYMQHRK    GLYHAE         
HUHSYCMBUK      : LCIDU           EQXXRIQYLS      GCWCPFDIHK      LUGIYRFRMQX     JGCXBLNYDJV    
IOBEKPOMHOJAJF  : OFXQO           DVTAHYTFJUARUOB GJXCVM          NJHHQGCHXRVAU  
YVTJLBESV       : IWOULBNTBKYWUJL BBWNLPIBXYNG    EUNEBOPTXONMUY  LWTWML         
VIHSUPB         : IGYVLJYIOV      OJOHJUJ         NMOOHWRVCWXVGXD PTRSDRTEHP      WXTAVBRJG       MJAV            QYNLAKYDJNOAR  
RHWJXLTNU       : VMRWWEGFWVSGDYJ GYFSYEMTTUFYWN  PAULPYNCUD      NWWJXJBTKDGCC   QRICJRWYXOEIH   TLVTGVJG        JBQDRBSCJQY     DUOPIGXAS      
