TNALXOCUCR      : DWQTTIT         GIVUFUNX        DQMQVWGOXODH   
YSMYEXR         : FARRBBUYGVPKFR  RMGIPJ          PHYSMAYPMJLUJR  TKTCETEYLJSCK   YBTGR          
CWTPRQ          : GRSLPRSK        OOKSOKBJBV      WIYHXKQ         RRFMC          
FVNNLH          : BQYYUAYASO      OOKSOKBJBV      GVVLJHI         PHYSMAYPMJLUJR  IDXGAAJALLNEJN  RPUXFLCWUTI    
LVCCXWHRDG      : ATRGMI          YLUHGCJXJIT     TKTCETEYLJSCK  
PGOPATUY        : YLUHGCJXJIT     TJWJSHUSFHFXBBS PHYSMAYPMJLUJR  FTFPP          
KQJXXFLMSV      : HKGAAFPFQSMME   AKDYTBAPQH      TLNQFARERTBWV   GIVUFUNX        VYORKM          ITNYWHFXHGACITU
GRSLPRSK        : CWTPRQ          BWDSPMTAWB      OEBTIBFU        RBOD            IMJVDOHQAAUQDTO
YUMHMEKIY       : WTIUYUYJQOU     SBFHF           NRSSHPFG        KXOESJOJP      
YMDKMBRXPKVG    : EWQWXRWSMXWPAU  GVVLJHI         YCCAVGSPUPELT   CGHESKGSEBPFW  
PBFIS           : SPYNCJCHVLIHMW  HKGAAFPFQSMME   BQLCWL          HKKYUKMSRSUDR  
SPYNCJCHVLIHMW  : PBFIS           DBWSYXNEORO    
XJORK           : DWQTTIT         BQYYUAYASO      EWQWXRWSMXWPAU  ORSLMESSBMD    
FGNYWQ          : QURWROQOYJVYUO  HNQYCWCACKE     DIXEDF          FTFPP          
HKGAAFPFQSMME   : KQJXXFLMSV      PBFIS           IUPIGBVLUGW     GKTSQIHDBKSRA  
WQUJQGXJQF      : BQCJC           WXFTDXFXFKFFD   AEFA           
AUPYLVGXCGBJXG  : AKDYTBAPQH      UIAVKQQSXGDDUI  RMGIPJ          GVVLJHI         KVXM            YXAOSAVECSCVD  
QURWROQOYJVYUO  : FGNYWQ          HQXB            OOKSOKBJBV      FWIVFNJUWQ      OSQDEALMBHI     OIPKTJMXFSWSD   RMKNKQDK       
LOBBNPYVNDEQ    : AIKYS           IHEWFJLL        OEVCAKPGT       IFPPCUDFR       DQYM            JKLBFQPHCUP     YTBP           
DWQTTIT         : TNALXOCUCR      XJORK           UOVVHUVFWUFPLSH CQSJTQDH        RERSMUM         AMBBWTSWXUBFUFY CTSRWPLXA       OFYVPSMRQTYQ   
AKDYTBAPQH      : KQJXXFLMSV      AUPYLVGXCGBJXG  DQMQVWGOXODH   
HKFXAGTQKYHX    : KSDHPDMSINFU    PSKNYJ          KGNN            CGHESKGSEBPFW  
HQXB            : QURWROQOYJVYUO  IHEWFJLL        ESAFR           OIPKTJMXFSWSD   XNDWTY          LBUA           
TPBEV           : YCCAVGSPUPELT   RRFMC           YLUHGCJXJIT     XSUDRTRLHGU     IMJVDOHQAAUQDTO XNDWTY         
BWDSPMTAWB      : GRSLPRSK        JSDBT           FTFPP          
XITQSSXSWHLXJM  : BSJSMVYUFQ      DQYM            DIXEDF          VHYEB          
BQYYUAYASO      : FVNNLH          XJORK           OEBTIBFU        NNCSJMUWRWTK    ITMRUPYYAVWYP  
OOKSOKBJBV      : CWTPRQ          FVNNLH          QURWROQOYJVYUO  FCWRPXWI        FTFPP          
BQCJC           : WQUJQGXJQF      LDRHL           FCWRPXWI       
UOVVHUVFWUFPLSH : DWQTTIT         AIKYS           PHORU           VHYEB          
FARRBBUYGVPKFR  : YSMYEXR         UYUIDPTQKSKJMWX HWSAFPUK        NRSSHPFG        WHKG            YXAOSAVECSCVD  
AIKYS           : LOBBNPYVNDEQ    UOVVHUVFWUFPLSH RHOKHKPJFRGLWES
WXFTDXFXFKFFD   : WQUJQGXJQF     
IGTJOQYBX       : OEVCAKPGT       ATRGMI          DIXEDF          RJQIEF         
RBDDCVNYVS      : DBWSYXNEORO     RMKNKQDK       
CQAAXLIFQJN     : DXQLOU          DQYM            PHYSMAYPMJLUJR 
EWQWXRWSMXWPAU  : YMDKMBRXPKVG    XJORK           TMQTM           GYDHCIUWYTF    
BRXTVRWXRIG     : ORSLMESSBMD     TMQTM          
BQLCWL          : PBFIS           TLNQFARERTBWV   GHOHEMDCHTQXJA  TJWJSHUSFHFXBBS RPUXFLCWUTI     GYDHCIUWYTF    
TLNQFARERTBWV   : KQJXXFLMSV      BQLCWL          AEFA           
UROOQNHBVH      : NQRPVITTECIKXK  UJJO            SBFHF           IMJVDOHQAAUQDTO
OUFLGAHUNBCN    : DXQLOU          NRSSHPFG        LQUVF           CTSRWPLXA       RPUXFLCWUTI    
GHOHEMDCHTQXJA  : BQLCWL          KGNN            TKTCETEYLJSCK   QDRDBYYA        PHORU          
IHEWFJLL        : LOBBNPYVNDEQ    HQXB            SBFHF           UYUIDPTQKSKJMWX XSUDRTRLHGU    
UIAVKQQSXGDDUI  : AUPYLVGXCGBJXG  CFEEBTGALULWP   FTFPP          
CEABQBDYKHX     : DXQLOU         
TLEGH           : MDWJWIGX        YLPOIQW         XSUDRTRLHGU     YTBP            PJGMI          
IDCYWWADCDAKK   : RMGIPJ          HWSAFPUK        TKTCETEYLJSCK   WDUJJPENDIMQB  
RMGIPJ          : YSMYEXR         AUPYLVGXCGBJXG  IDCYWWADCDAKK   ESAFR           ENEB            PHYSMAYPMJLUJR  LCNQUXFGNCLUJPV
BSJSMVYUFQ      : XITQSSXSWHLXJM  AEFA            TJWJSHUSFHFXBBS YXAOSAVECSCVD  
KSDHPDMSINFU    : HKFXAGTQKYHX    KGNN            GKTSQIHDBKSRA   HKKYUKMSRSUDR  
WIYHXKQ         : CWTPRQ          FWIVFNJUWQ      UJJO            HEVCTUKEPD      MIESP           JKLBFQPHCUP    
DBWSYXNEORO     : SPYNCJCHVLIHMW  RBDDCVNYVS     
VYABLUMYAHRAR   : HNQYCWCACKE     UJJO           
JSDBT           : BWDSPMTAWB      MDWJWIGX        PJGMI          
ESAFR           : HQXB            RMGIPJ          DQMQVWGOXODH    RPUXFLCWUTI    
LGICQGBQ        : OEVCAKPGT       OSQDEALMBHI     VHYEB          
NLTONEHPXAAQGDN : EAVF            MTBLUNU         ITMRUPYYAVWYP  
JGPOXFCFNEVT    : GIVUFUNX        RERSMUM         RRFMC           YLUHGCJXJIT     ORSLMESSBMD    
OEVCAKPGT       : LOBBNPYVNDEQ    IGTJOQYBX       LGICQGBQ        PHYSMAYPMJLUJR  CFEEBTGALULWP  
FWIVFNJUWQ      : QURWROQOYJVYUO  WIYHXKQ        
NQRPVITTECIKXK  : UROOQNHBVH      LQUVF          
LDRHL           : BQCJC           XNDWTY          RJQIEF         
GVVLJHI         : FVNNLH          YMDKMBRXPKVG    AUPYLVGXCGBJXG  MTBLUNU        
AUTRNJPXFK      : OEBTIBFU        CGHESKGSEBPFW   CWNXBFNSOV     
IUPIGBVLUGW     : HKGAAFPFQSMME   OEBTIBFU        EUIA            CFEEBTGALULWP  
OSQDEALMBHI     : QURWROQOYJVYUO  LGICQGBQ        HNQYCWCACKE    
WTIUYUYJQOU     : YUMHMEKIY       NNCSJMUWRWTK    HWSAFPUK        RBOD            QDRDBYYA       
PSKNYJ          : HKFXAGTQKYHX    EUIA           
OEBTIBFU        : GRSLPRSK        BQYYUAYASO      AUTRNJPXFK      IUPIGBVLUGW     OFYVPSMRQTYQ    PHORU           PJGMI          
MDWJWIGX        : TLEGH           JSDBT           NRSSHPFG        QDRDBYYA        YXAOSAVECSCVD  
GIVUFUNX        : TNALXOCUCR      KQJXXFLMSV      JGPOXFCFNEVT    ATRGMI          CTSRWPLXA      
DXQLOU          : CQAAXLIFQJN     OUFLGAHUNBCN    CEABQBDYKHX     BOKJATWSSCRW    BBDMDWMVROOPS   ITMRUPYYAVWYP  
IFPPCUDFR       : LOBBNPYVNDEQ    JKLBFQPHCUP     LCNQUXFGNCLUJPV
EAVF            : NLTONEHPXAAQGDN EBLHSGA        
ENEB            : RMGIPJ          BOKJATWSSCRW    WDUJJPENDIMQB   RJQIEF         
CQSJTQDH        : DWQTTIT         AEFA            AMBBWTSWXUBFUFY
ATRGMI          : LVCCXWHRDG      IGTJOQYBX       GIVUFUNX        HKKYUKMSRSUDR  
HNQYCWCACKE     : FGNYWQ          VYABLUMYAHRAR   OSQDEALMBHI     IMJVDOHQAAUQDTO YBTGR          
OIMQYIDTYGBJG   : MIESP           WHKG           
BOKJATWSSCRW    : DXQLOU          ENEB           
UJJO            : UROOQNHBVH      WIYHXKQ         VYABLUMYAHRAR   RHOKHKPJFRGLWES
RERSMUM         : DWQTTIT         JGPOXFCFNEVT   
DQYM            : LOBBNPYVNDEQ    XITQSSXSWHLXJM  CQAAXLIFQJN     AMBBWTSWXUBFUFY
BBDMDWMVROOPS   : DXQLOU          AMBBWTSWXUBFUFY RRFMC          
YCCAVGSPUPELT   : YMDKMBRXPKVG    TPBEV           KGNN            SBFHF           WHKG           
KGNN            : HKFXAGTQKYHX    GHOHEMDCHTQXJA  KSDHPDMSINFU    YCCAVGSPUPELT  
QBNNNJIEAAWLB   : SBFHF           YLUHGCJXJIT    
OCXWWPUO        : RRFMC           RBOD            LQUVF           TKTCETEYLJSCK  
GKTSQIHDBKSRA   : HKGAAFPFQSMME   KSDHPDMSINFU    IDXGAAJALLNEJN  ITMRUPYYAVWYP  
AEFA            : WQUJQGXJQF      TLNQFARERTBWV   BSJSMVYUFQ      CQSJTQDH        UYUIDPTQKSKJMWX
SBFHF           : YUMHMEKIY       UROOQNHBVH      IHEWFJLL        YCCAVGSPUPELT   QBNNNJIEAAWLB   PHORU           YBTGR          
HEVCTUKEPD      : WIYHXKQ         CTSRWPLXA      
AMBBWTSWXUBFUFY : DWQTTIT         CQSJTQDH        DQYM            BBDMDWMVROOPS   OFYVPSMRQTYQ   
MIESP           : WIYHXKQ         OIMQYIDTYGBJG  
RRFMC           : CWTPRQ          TPBEV           JGPOXFCFNEVT    BBDMDWMVROOPS   OCXWWPUO        OIPKTJMXFSWSD  
CGHESKGSEBPFW   : YMDKMBRXPKVG    HKFXAGTQKYHX    AUTRNJPXFK      UYUIDPTQKSKJMWX RBOD            YXAOSAVECSCVD  
MTBLUNU         : NLTONEHPXAAQGDN GVVLJHI         YLPOIQW         XSUDRTRLHGU     KVXM            YTBP           
JKLBFQPHCUP     : LOBBNPYVNDEQ    WIYHXKQ         IFPPCUDFR       XSUDRTRLHGU     RMKNKQDK        ITNYWHFXHGACITU GYDHCIUWYTF    
YLUHGCJXJIT     : LVCCXWHRDG      PGOPATUY        TPBEV           JGPOXFCFNEVT    QBNNNJIEAAWLB   OMUWYB         
EUIA            : IUPIGBVLUGW     PSKNYJ          IDXGAAJALLNEJN 
FCWRPXWI        : OOKSOKBJBV      BQCJC           NNCSJMUWRWTK    LCNQUXFGNCLUJPV GYDHCIUWYTF    
HKKYUKMSRSUDR   : PBFIS           KSDHPDMSINFU    ATRGMI         
NNCSJMUWRWTK    : BQYYUAYASO      WTIUYUYJQOU     FCWRPXWI        KXOESJOJP       IDXGAAJALLNEJN 
TJWJSHUSFHFXBBS : PGOPATUY        BQLCWL          BSJSMVYUFQ     
UYUIDPTQKSKJMWX : FARRBBUYGVPKFR  IHEWFJLL        AEFA            CGHESKGSEBPFW   WHKG            RJQIEF         
HWSAFPUK        : FARRBBUYGVPKFR  IDCYWWADCDAKK   WTIUYUYJQOU    
DIXEDF          : FGNYWQ          XITQSSXSWHLXJM  IGTJOQYBX      
EBLHSGA         : EAVF            YBTGR          
YLPOIQW         : TLEGH           MTBLUNU         CFEEBTGALULWP   LQUVF          
NRSSHPFG        : YUMHMEKIY       FARRBBUYGVPKFR  OUFLGAHUNBCN    MDWJWIGX       
PHYSMAYPMJLUJR  : YSMYEXR         FVNNLH          PGOPATUY        CQAAXLIFQJN     RMGIPJ          OEVCAKPGT      
WHKG            : FARRBBUYGVPKFR  OIMQYIDTYGBJG   YCCAVGSPUPELT   UYUIDPTQKSKJMWX
KXOESJOJP       : YUMHMEKIY       NNCSJMUWRWTK    RHOKHKPJFRGLWES ITMRUPYYAVWYP  
CFEEBTGALULWP   : UIAVKQQSXGDDUI  OEVCAKPGT       IUPIGBVLUGW     YLPOIQW         RPUXFLCWUTI     YXAOSAVECSCVD  
OMUWYB          : YLUHGCJXJIT     PJGMI          
LCNQUXFGNCLUJPV : RMGIPJ          IFPPCUDFR       FCWRPXWI        TMQTM          
VYORKM          : KQJXXFLMSV      PJGMI           RPUXFLCWUTI    
IDXGAAJALLNEJN  : FVNNLH          GKTSQIHDBKSRA   EUIA            NNCSJMUWRWTK    XSUDRTRLHGU     RHOKHKPJFRGLWES
RBOD            : GRSLPRSK        WTIUYUYJQOU     OCXWWPUO        CGHESKGSEBPFW  
XSUDRTRLHGU     : TPBEV           IHEWFJLL        TLEGH           MTBLUNU         JKLBFQPHCUP     IDXGAAJALLNEJN 
KVXM            : AUPYLVGXCGBJXG  MTBLUNU        
IMJVDOHQAAUQDTO : GRSLPRSK        TPBEV           UROOQNHBVH      HNQYCWCACKE     TKTCETEYLJSCK  
ORSLMESSBMD     : XJORK           BRXTVRWXRIG     JGPOXFCFNEVT   
LQUVF           : OUFLGAHUNBCN    NQRPVITTECIKXK  OCXWWPUO        YLPOIQW        
TKTCETEYLJSCK   : YSMYEXR         LVCCXWHRDG      GHOHEMDCHTQXJA  IDCYWWADCDAKK   OCXWWPUO        IMJVDOHQAAUQDTO
WDUJJPENDIMQB   : IDCYWWADCDAKK   ENEB           
OIPKTJMXFSWSD   : QURWROQOYJVYUO  HQXB            RRFMC          
XNDWTY          : HQXB            TPBEV           LDRHL          
DQMQVWGOXODH    : TNALXOCUCR      AKDYTBAPQH      ESAFR          
QDRDBYYA        : GHOHEMDCHTQXJA  WTIUYUYJQOU     MDWJWIGX       
CTSRWPLXA       : DWQTTIT         OUFLGAHUNBCN    GIVUFUNX        HEVCTUKEPD     
RMKNKQDK        : QURWROQOYJVYUO  RBDDCVNYVS      JKLBFQPHCUP     CWNXBFNSOV     
ITNYWHFXHGACITU : KQJXXFLMSV      JKLBFQPHCUP    
TMQTM           : EWQWXRWSMXWPAU  BRXTVRWXRIG     LCNQUXFGNCLUJPV
LBUA            : HQXB           
OFYVPSMRQTYQ    : DWQTTIT         OEBTIBFU        AMBBWTSWXUBFUFY
FTFPP           : PGOPATUY        FGNYWQ          BWDSPMTAWB      OOKSOKBJBV      UIAVKQQSXGDDUI 
RJQIEF          : IGTJOQYBX       LDRHL           ENEB            UYUIDPTQKSKJMWX
PHORU           : UOVVHUVFWUFPLSH GHOHEMDCHTQXJA  OEBTIBFU        SBFHF          
YTBP            : LOBBNPYVNDEQ    TLEGH           MTBLUNU        
PJGMI           : TLEGH           JSDBT           OEBTIBFU        OMUWYB          VYORKM         
RPUXFLCWUTI     : FVNNLH          BQLCWL          OUFLGAHUNBCN    ESAFR           CFEEBTGALULWP   VYORKM         
YBTGR           : YSMYEXR         HNQYCWCACKE     SBFHF           EBLHSGA        
CWNXBFNSOV      : AUTRNJPXFK      RMKNKQDK       
YXAOSAVECSCVD   : AUPYLVGXCGBJXG  FARRBBUYGVPKFR  BSJSMVYUFQ      MDWJWIGX        CGHESKGSEBPFW   CFEEBTGALULWP   GYDHCIUWYTF    
VHYEB           : XITQSSXSWHLXJM  UOVVHUVFWUFPLSH LGICQGBQ       
GYDHCIUWYTF     : EWQWXRWSMXWPAU  BQLCWL          JKLBFQPHCUP     FCWRPXWI        YXAOSAVECSCVD  
RHOKHKPJFRGLWES : AIKYS           UJJO            KXOESJOJP       IDXGAAJALLNEJN 
ITMRUPYYAVWYP   : BQYYUAYASO      NLTONEHPXAAQGDN DXQLOU          GKTSQIHDBKSRA   KXOESJOJP      
