TWUDUGGOXAQSJLT : BAVXIXUTMCQLR   HTDUI           JALMQMGXFXF     ONWB            FBDISUC        
JNSXE           : AKWFDQATVTTN    KCNDUUODDVBTEU  XJCWNNPYK       JWCKBEOFGRXML  
VFKMX           : GGIA            MQICJW          TTXYL           UASKNXCYYF      OBGQIHLI        MMFPBTLWQVMT   
XBBTXWASFGK     : TFYVDHPPJXCKPM  DOAHNKMUVKTY    TDLCUGJ         STSPGSK         XPJEGCQYD       LLKDU           KJENYXNLPILSX  
HBXQOSAX        : JNXC            RPNPN           BNXHLOKJJ      
UWMMSTYHRAHSCCS : SVMKDWW         MGLBKJSX        VOMIVYWIND      CCFVJHDQFFYRTH  MKYCN          
EOIKY           : OHVMCTTRQFU     DAGMB           XNUHBGRTQYEJKOK DWGQDIJXQHQFG   NAMDPHCHXNRCN   WDAAAIWVFCX    
RCKLSFLQNG      : DLPNRUCBB       STGVABDSK       CBYANFRDMCMT    SRXBXLXJFDPRR   IVTNK          
CUKXTUPTEKX     : UGFE            ESBFVJIAOVN     CBQLQ           TTXYL           AJQLMNYJLKS    
DBMRJXSXRWIDPP  : CAABOOFJVKA     XXXQNP          YDBYIHTLO      
JFYYH           : MQORHODO        WEOWOL          JLFWY           YXPIC           XMBT            SIEK           
MFPJWKN         : APJLTAAEYG      VFHMUYENUFDL    AIWM           
KWMMJFXHA       : TNBORTWHIL      GQWPTCMO        HYKBYK         
CXGFNVYWB       : XPVY            OPSYXDDRSI      MTTWIPBRET      KPMFDDVYR      
YKUNRKWOWKXI    : CRPR            UNMBRMUFUTFK    GEVEFWHAKBNFI   EAWKERJUO      
LWTQU           : GXYL            NNRFEYSSXRGEI   DAGMB           RBWOCEAJBGFEYL  LVFWMIDBJ      
SRDQALF         : RDIONRPXYE      IBXB            XWOLRAWP       
KEAKFLFSDSRUP   : NXGFUHEV        FUIHYOWXXUGLWQL QXPDNU          ETMOGSTCA       KWLQAM          KQVIVC          VLNKCSAP       
SAOEWIW         : RWQHGIPMRVDMMGV FKIMGYEJ        UAFRQ           YKGCCXTSPWBI    MIJMLV         
MQORHODO        : JFYYH           GPJWNRBNN       GOIQUXGJDGXCR   ISIHISJHYPAL    STGVABDSK      
PVOD            : ILUKQNKRXK     
AKWFDQATVTTN    : JNSXE           YXPIC           XDEYNDOJOBGNA   TDGOQBMLR      
TXXOKODDXTINIB  : CRTBCVAHEDGEOQ  CGOTDPIUHIMLJYJ IISHYSGY        IMKUNGHQQJVAS  
WEOWOL          : JFYYH           ITQOVSPWIB      GMXSQLNTDOSU    LTNORMRUNTB     OQMD            QAYUH          
UFFODYKQ        : OVSQWTINSWJ     YKGCCXTSPWBI    TKQHBKYABIDCE   NSRSNRXR       
GPWWCLCHKWQAFT  : WRUHPIQWYHGWKC  ROCMGLTHTUHPI   UQJCUKA         KUWYDPIBIVNS    EAWKERJUO      
CAABOOFJVKA     : DBMRJXSXRWIDPP  LNSLTKKTOYVWJSP RHLAVIELQBU     CGJNRUGGYDQA   
LNSLTKKTOYVWJSP : CAABOOFJVKA     KOMUWT          KSLEFMVBAIDC    XJCWNNPYK       PJUOBJQJWY      LCVM           
AJYCJBFARLMNXM  : QGMLIOGRKDYCVN  CYVFHMTXVRUY   
KCKXYUISJHOIS   : UGFE            KOMUWT          NDHBCLMYMW      DJBJIVLIXKQDOY  QYDURKBXWIA     JTFFKMAWJOYF   
XGKHFPSHUV      : XCMDBHXJTWDMIQG
IIPHWHRARR      : HJJBXBAEW       GXRFBIL         WLVQAABIQIVN    XPJUN          
OATXKK          : VWWUY           QGLPPTSGTDVG    HJJBXBAEW       PDJVWTLMKURYSA  XIWGHYXXISKAGVN
FUHM            : DUYLSVUJRGBEW  
PTXK            : JYFDRW          UYNRMUNMOHPCK   BQKRFUBOLHOGTMH XBPQJYL         ERIXJG          LSKQYHIOA      
UGFE            : CUKXTUPTEKX     KCKXYUISJHOIS   JGIKCERUH       GMXSQLNTDOSU    JBHNWTPWQNFL   
WNOEFO          : YPKBLKLVTTRC    JTOQATYEI       TMJGQMPOYL      IWPV           
YPKBLKLVTTRC    : WNOEFO          YKKLPALHVJRE    VQFKOL          XDEYNDOJOBGNA  
CTAAEGWNLDCIQ   : MFWNYMDEMBEITYU YKKLPALHVJRE    GRCQGHTIXRUUEC  PQQXXC          XWOLRAWP       
MXHKWYWYMHMJCGD : ODIMDMGX        SGUSFJUJNUF     ARWWWQIV        RIJW           
OFARHEXGRJKWTB  : KSLEFMVBAIDC    GJHFPPMDXOVIEKY MBVKBIBFHJYAU  
GAASWBPXOWLAB   : CXXU            EAWKERJUO      
DHJK            : XLNMTPEHUUIU    HVSBXDBVTRMRN   XJCWNNPYK       OVWGVQGIX       XOLNGRKP        IHYGBATLULE    
DTOBAIMK        : KXNRQPWGYUNLPJ  LFNIVMMRBUTK    WFMSLRJEDGSESJ  CXXU           
GMXOMXHLBYKP    : TSWGXSTOYVEFJH  CQGGDKF        
XPCRUJDHTGB     : TSWGXSTOYVEFJH  RNOKFSWLSHODT   NTJMYIOPPNRPRVY AQRHXO          CYMIK           IUIXFTRFTJ     
JCQVMYEBWSPWCCA : OVBU            JFVNWAPRRIN     KUWYDPIBIVNS    HBXRGHLIFY     
MSCKKEEGPIN     : TELHOORKPTPDGA  FPTLAKMVUMFVLQE CORTX           VRSW           
QPTBTNYGOEKNW   : FMKJMRPYLOPTUY  ARWWWQIV        ILUKQNKRXK      EPSYICEEOGWBSYN STANLWG        
MCCMFQF         : FOGRACGNYG      FTXQNDW         KQSRYPDSTRCG   
DQNIWGSM        : MPDEFFBYSCQ     WUAYYPN         EMDXV           RLBPXVU        
JEMMXA          : YJAW            TDSWQKKIFPKITSG VWBBXCGNXANBB  
HQQREPRQTW      : YKKLPALHVJRE    NAMDPHCHXNRCN   BMTWSTTKMEOSNE  AQRHXO          JALMQMGXFXF    
APJLTAAEYG      : MFPJWKN         GNHRHGHGO       TKQHBKYABIDCE  
NXKSMASMMAFF    : TEGARXSNSBJXX   CGRNPGTJSERQVM  EBKWCTBIARPWS  
JUMARLGTDRF     : TFFUNEIORDBR    CLDGNDU         IYXU            DHPDSIOBWOW     LIGFQOKXBD      HYDYBQH         JBLYJQJYVF     
TFFUNEIORDBR    : JUMARLGTDRF     GXYL            JWOVKLBHT       GVQOXFN         RXKPUXDNLTOS    AFTG           
QGWVLRI         : BSHJUAWOHELB    PRMJRVO         UNMBRMUFUTFK   
GKATQTWI        : KYDSCICY       
WEHC            : GXYL            NOBI           
XJIM            : NNRFEYSSXRGEI  
LPUIIBIFOANWIX  : XLNMTPEHUUIU    QHFMVGBS        PQNPPVPXKRMXK  
CRTBCVAHEDGEOQ  : TXXOKODDXTINIB 
RDIONRPXYE      : SRDQALF         ONCDDYMRB       QMMGAQL         TEYHDCYYIHB     KWFTIPU         IFIOHXKS        BRBUVB          MTTWIPBRET     
ODIMDMGX        : MXHKWYWYMHMJCGD YMBN            CBQLQ           XETMICJHBW     
JTOQATYEI       : WNOEFO          OLMI            RSGHKUVP       
WCVIQLAIKYOKPS  : GGIA            FUIHYOWXXUGLWQL XOLNGRKP        FTXQNDW         TMJGQMPOYL     
CXGLXWUUMNUIO   : VGBUIW          IBTMFVE         ARWWWQIV        TNVFSLDSVHR    
TFYVDHPPJXCKPM  : XBBTXWASFGK     KSLEFMVBAIDC    OSQWDL          UBIWTN         
IIFIRQ          : PEAL            MTUXYSIJWPX     IXQMDFO         PTOHYIS         KXKQDAT        
ONCDDYMRB       : RDIONRPXYE      JUGDEQPJ        VNNSVQOLKDWC   
ADEF            : QGMLIOGRKDYCVN  DJBJIVLIXKQDOY  QHUTDMA        
VWWUY           : OATXKK          INESIKXFV       LNQFNLDQJD     
KOMUWT          : LNSLTKKTOYVWJSP KCKXYUISJHOIS   ILYIYUNVN       EFJKPHCFUSJ     GHQGITPCIQST    IUYMHUE         PLAKTHCE        QBUVED         
QMMGAQL         : RDIONRPXYE      IBXB            FAQG            SXJJCIH         QKPA           
QAYRIYUPHKLE    : BAVXIXUTMCQLR   YAODEW         
IGSUUHRT        : BWPLIVVV        STUQLFWU       
XLNMTPEHUUIU    : DHJK            LPUIIBIFOANWIX  XPVY            PTOHYIS         MFID            RVIP            BTTQSXGLWOVI   
SVMKDWW         : UWMMSTYHRAHSCCS IYXU            VJPVIPMQNXB     WLMFBVFNPOSL   
GHQYDNJUHKUUYIO : FOGRACGNYG      IMKUNGHQQJVAS   STUQLFWU       
MWMHHJXAHKLN    : MQICJW          AYSBSAFHDVDD    KUVGUMWPDP      BNALA          
KXNRQPWGYUNLPJ  : DTOBAIMK        HIHGFXPHQBGWVJF CGJNRUGGYDQA    IWPV            KUVGUMWPDP     
XAEMYSVGC       : QOXVEEKLR       JWOVKLBHT       XBUPBHVL        GEVEFWHAKBNFI   WAIKNFR         QAYUH          
JLFWY           : JFYYH           MANCM           DMCEGERWCVETY   CBALPEGULTDOH   QKPA            FNAQN          
JYFDRW          : PTXK            XWDBGIFFTA      DBARUBLAAIC     HBXRGHLIFY     
XXVMKNXWOA      : KSLEFMVBAIDC    WMEGFOLIQ       MFNBOSU        
BAVXIXUTMCQLR   : TWUDUGGOXAQSJLT QAYRIYUPHKLE    BWPLIVVV        OVSQWTINSWJ     RPTIGFHKPIQH   
NXGFUHEV        : KEAKFLFSDSRUP   WAUIXI          NNQEHSVYKCY     DVYBQPBMAOGXXWE
SGUSFJUJNUF     : MXHKWYWYMHMJCGD AGMAGHNRONGUMTT JLBEUCMPXDOEOCS YDBYIHTLO       AYSBSAFHDVDD   
GGIA            : VFKMX           WCVIQLAIKYOKPS  GXRFBIL         LSQRFTOPQBJ     XMBT           
KTEFVTFCA       : MYGVNFYDJQ      XETMICJHBW      UQJCUKA         PQQXXC         
LGXSYEOTKAOVNM  : MBVKBIBFHJYAU   WLMFBVFNPOSL    FMVAKEW        
BSHJUAWOHELB    : QGWVLRI         ARRMGJGDKRMEYA  DGGNHASIPO      VYMWFJBS        RQVASFXHYCWVE   DLPNRUCBB       CQDBSP         
PDNCJM          : YXXTPUMYAOFMRYQ FHGEFCRROPLNIMS RPTIGFHKPIQH    ADCIHEQ         TODMHWTB       
KSLEFMVBAIDC    : LNSLTKKTOYVWJSP OFARHEXGRJKWTB  TFYVDHPPJXCKPM  XXVMKNXWOA      IISHYSGY        DMDVSXEX       
KNXN            : JNXC            GPJWNRBNN       UMJVGJWUINX    
PUQDXCSCQ       : ARWWWQIV        IHYGBATLULE    
LDUYXG          : KWFTIPU         OVWGVQGIX       HDMTO           ROCMGLTHTUHPI  
ESBFVJIAOVN     : CUKXTUPTEKX     SSQXUQSVTGGKLYI CTHAXRXJEFMDLB  TEQUFRTRXXUXT   PBQP           
LDFGV           : CRPR            XBPQJYL         DBARUBLAAIC    
GYBIPBWUVVSCY   : BRBUVB          WFGWQNSVOFEYGCQ
XDFVMPVCNL      : MQICJW          NSFEVLLMUVIKXQD
YOWHL           : BPIGWHBJMKGFXO  JBHNWTPWQNFL   
OMKWELTYJPTMR   : OBGQIHLI       
MUBIJ           : DAGMB           OGIIMRMHWMON    RIJW            BTTQSXGLWOVI   
GNHRHGHGO       : APJLTAAEYG      TNBORTWHIL      VNNSVQOLKDWC    ARWWWQIV        XWDBGIFFTA      RRIERK         
NDHBCLMYMW      : KCKXYUISJHOIS   AYCBJXR         EAWKERJUO      
ILICAFF         : QGLPPTSGTDVG    YPER            XUSPSKIQNKL    
RWQHGIPMRVDMMGV : SAOEWIW         CWHQFNGM        NUQLV           LMQLMUYLMIQJV  
LHCKVY          : MROEOVLDRN      NOBI           
FMKJMRPYLOPTUY  : QPTBTNYGOEKNW   GHQGITPCIQST    XCMDBHXJTWDMIQG OCGYGFLPG      
JSHNG           : PTOHYIS         WCMRXTWLQROYPJ 
TELHOORKPTPDGA  : MSCKKEEGPIN     MPDEFFBYSCQ     HCMGGOHIWXM     CWHQFNGM        ROKVIN          SLGEVPOAIKG     AQRHXO          KQSRYPDSTRCG   
ARRMGJGDKRMEYA  : BSHJUAWOHELB    NTJMYIOPPNRPRVY GIVQHSLWNATMSSP
XWQJEFXWQQSITYK : FPTLAKMVUMFVLQE IMKUNGHQQJVAS   RACHGFTTDI      XWDBGIFFTA      IYAONHUMRNLLV  
YCHNKRT         : MFWNYMDEMBEITYU XMBT           
CLDGNDU         : JUMARLGTDRF     QGLPPTSGTDVG    CYVFHMTXVRUY   
AMWHRXGKOYTK    : CMVTLHSNX       NGAODUMTVEPFQI  AAVL            SRXBXLXJFDPRR  
GXYL            : LWTQU           TFFUNEIORDBR    WEHC            OPSYXDDRSI     
NVAJMEVPNL      : GVQOXFN         RQVASFXHYCWVE   MCCYOCVVRODDM   PJUOBJQJWY     
IYXU            : JUMARLGTDRF     SVMKDWW         QWLHUX          CNTJJTCYWAM     NCARFYT         TKQHBKYABIDCE  
FPTLAKMVUMFVLQE : MSCKKEEGPIN     XWQJEFXWQQSITYK GWCQTIWUOCFVG   WFMSLRJEDGSESJ 
MGLBKJSX        : UWMMSTYHRAHSCCS STUQLFWU        EVMJDXQVPNOK   
OHVMCTTRQFU     : EOIKY           FRLLCVIXNTBGJ   IVTNK           XUSHGD         
TSWGXSTOYVEFJH  : GMXOMXHLBYKP    XPCRUJDHTGB     YGQQLNNRVQ      BQKRFUBOLHOGTMH FYBTBTKDIQQCAM  KWLQAM          SRXBXLXJFDPRR   LMQLMUYLMIQJV  
UBORP           : DGGNHASIPO      OSQWDL          FRPRWHD         TTXYL          
PEAL            : IIFIRQ          KHEHOLCPK       YKGCCXTSPWBI    HBXRGHLIFY     
UCFRE           : BAOWLWK        
KDFLXYAWW       : UBIWTN          RQVASFXHYCWVE   QYDURKBXWIA    
CGOTDPIUHIMLJYJ : TXXOKODDXTINIB  FWQJFRH         OMIHJNGWUKVBM   RQVASFXHYCWVE   UPSEYRCWCWICE   KPMFDDVYR      
DOAHNKMUVKTY    : XBBTXWASFGK     TRAMRHNBM       NTMUV           TCYDFBQFOQX    
RHLAVIELQBU     : CAABOOFJVKA     YMBN            GJHFPPMDXOVIEKY RRIERK          MCTFFLGANIGKRPN
QGLPPTSGTDVG    : OATXKK          ILICAFF         CLDGNDU         SSQXUQSVTGGKLYI QKPA            CYMIK          
QFDNGOHNBH      : WSXNBPV         TRAMRHNBM       MYGVNFYDJQ      XVNAICAGYQUSQRJ
JNXC            : HBXQOSAX        KNXN            MBVKBIBFHJYAU   UMXMGQCQAIGCLK  XIWGHYXXISKAGVN
TEGARXSNSBJXX   : NXKSMASMMAFF    YGQQLNNRVQ      PJUOBJQJWY      AJQLMNYJLKS    
QOXVEEKLR       : XAEMYSVGC       MTUXYSIJWPX     GOIQUXGJDGXCR   GKAVPNRALSKIM   VJUUOLAMO      
TEYHDCYYIHB     : RDIONRPXYE      BWPLIVVV        NOYWLFQSUGGF    RNOKFSWLSHODT   PQQXXC         
HVSBXDBVTRMRN   : DHJK            CMVTLHSNX       XBUPBHVL        WTEMHP          PQQXXC         
XBDPOYUOJA      : HJJBXBAEW       YSIBV          
KYDSCICY        : GKATQTWI        YXXTPUMYAOFMRYQ ETMOGSTCA       HBXRGHLIFY      NJVOGD         
DWFFUBY         : XMBT           
UPBS            : NNQEHSVYKCY     LIGFQOKXBD      JALMQMGXFXF    
HIHGFXPHQBGWVJF : KXNRQPWGYUNLPJ 
KHEHOLCPK       : PEAL            IRVYFDJXUVPKE   ONWB           
KCNDUUODDVBTEU  : JNSXE           ANIJMVDPEPK     NTJMYIOPPNRPRVY
MTUXYSIJWPX     : IIFIRQ          QOXVEEKLR       IMKUNGHQQJVAS   YJAW            WAIKNFR        
TQXGBAV         : VYMWFJBS        MQICJW          DQDJXFCRT       FXMJKXADR       STANLWG         LVFWMIDBJ       XCBMY          
VSXBVVE         : YKGCCXTSPWBI    ERIXJG         
AYONUJNWDWGC    : RQVASFXHYCWVE   OPSYXDDRSI      YPER            DJBJIVLIXKQDOY 
GPJWNRBNN       : MQORHODO        KNXN            AGMAGHNRONGUMTT FRLLCVIXNTBGJ   DCXUXDLKNFSVKTE HELD           
JGIKCERUH       : UGFE            XDEYNDOJOBGNA  
JWOVKLBHT       : TFFUNEIORDBR    XAEMYSVGC       EBNROOCOECEPUXN GEWTLG          JBLYJQJYVF      CYVFHMTXVRUY    EAWKERJUO      
WAUIXI          : NXGFUHEV        VWBBXCGNXANBB   LCVM           
BWPLIVVV        : IGSUUHRT        BAVXIXUTMCQLR   TEYHDCYYIHB     RDUW            RMYQLNDXL      
CNWJGHIWFTIGDC  : BRBUVB         
ADHKDPKGMAT     : IXQMDFO         WYMJK           ELMOHAHJMXT    
XPVY            : CXGFNVYWB       XLNMTPEHUUIU    FVGEVSLBUNWVJ   FNVUB           XKUC           
JVERFOP         : QWLHUX          GRCQGHTIXRUUEC  DMDVSXEX       
IXQMDFO         : IIFIRQ          ADHKDPKGMAT     DMCEGERWCVETY   ARWWWQIV        HBXRGHLIFY     
MANCM           : JLFWY           DTPFUA         
RPNPN           : HBXQOSAX        EBKWCTBIARPWS  
NOYWLFQSUGGF    : TEYHDCYYIHB     DGGNHASIPO     
YRKEJUQLITX     : YAODEW          RNOKFSWLSHODT   TMJGQMPOYL      UASKNXCYYF     
NNRFEYSSXRGEI   : LWTQU           XJIM            VFHMUYENUFDL    TNVFSLDSVHR     EAWKERJUO      
BPIGWHBJMKGFXO  : YOWHL           JFSQIWVSNSOW   
XUOMOVS         : FTXQNDW         TMKFGL          UYYBLW         
OLLGSRRUS       : VGBUIW          ROKVIN          BSYWIA          FBUD           
DAGMB           : EOIKY           LWTQU           MUBIJ           HDMTO           GIVQHSLWNATMSSP XKUC           
BNXHLOKJJ       : HBXQOSAX        IRVYFDJXUVPKE   SOILX           BSYWIA         
XXXQNP          : DBMRJXSXRWIDPP  OGIIMRMHWMON    JDNBSHSR       
YXXTPUMYAOFMRYQ : PDNCJM          KYDSCICY        FHGEFCRROPLNIMS MROEOVLDRN     
WASNKF          : RMYQLNDXL      
MFWNYMDEMBEITYU : CTAAEGWNLDCIQ   YCHNKRT         AVGXVPQ         NTMUV          
YMBN            : ODIMDMGX        RHLAVIELQBU     YGQQLNNRVQ      NTMUV          
AGMAGHNRONGUMTT : SGUSFJUJNUF     GPJWNRBNN       MPDEFFBYSCQ     VTPLVKYKKMDW    AHBKLO          XCMDBHXJTWDMIQG
YAODEW          : QAYRIYUPHKLE    YRKEJUQLITX     QHFMVGBS        ROKVIN         
DTREGSTNTBCTHJJ : YSLMXMRJEIVMQ   KMAMUJLJGMHE   
BYKVMEROGRFJ    : EBKWCTBIARPWS  
EIBXAFHTBWPC    : ILYIYUNVN       VMNYPITYXSRGU   UJWUDNUKV       ROCMGLTHTUHPI  
LMKUNLUXJJFBXL  : IUYO            ITQOVSPWIB      IGQIEIR        
FWQJFRH         : CGOTDPIUHIMLJYJ CORTX           FWSAALFKM       FXMJKXADR       KJENYXNLPILSX  
YQDBN           : GJHFPPMDXOVIEKY RSGHKUVP       
FOGRACGNYG      : MCCMFQF         GHQYDNJUHKUUYIO TEQUFRTRXXUXT   LSKQYHIOA      
ILYIYUNVN       : KOMUWT          EIBXAFHTBWPC    JAYXICBT        RXKPUXDNLTOS   
DGGNHASIPO      : BSHJUAWOHELB    UBORP           NOYWLFQSUGGF   
FUIHYOWXXUGLWQL : KEAKFLFSDSRUP   WCVIQLAIKYOKPS  SASSK           UASKNXCYYF     
GJHFPPMDXOVIEKY : OFARHEXGRJKWTB  RHLAVIELQBU     YQDBN           JRPSTTMHITCEX   CXXU           
IISHYSGY        : TXXOKODDXTINIB  KSLEFMVBAIDC    EMEXIDIMDNJ     GWCQTIWUOCFVG  
OLMI            : JTOQATYEI       UBIWTN         
GOIQUXGJDGXCR   : MQORHODO        QOXVEEKLR       AVOAVLEDTUALQ  
OSQWDL          : TFYVDHPPJXCKPM  UBORP           GJCSCYHOB       CNTJJTCYWAM    
FENESEPHMOOCX   : QHENEDW         WFMSLRJEDGSESJ  CNTJJTCYWAM     AVGXVPQ        
YXPIC           : JFYYH           AKWFDQATVTTN    EGSAXN         
GEQKSLBSPPA     : CMUFVEB        
TNBORTWHIL      : KWMMJFXHA       GNHRHGHGO       OVWGVQGIX       CFXCIQVRPJ      SOILX          
ISIHISJHYPAL    : MQORHODO        ERIXJG         
MPDEFFBYSCQ     : DQNIWGSM        TELHOORKPTPDGA  AGMAGHNRONGUMTT LIGFQOKXBD      CBQLQ          
XNUHBGRTQYEJKOK : EOIKY           RMYQLNDXL       MCCYOCVVRODDM   BNALA          
QXPDNU          : KEAKFLFSDSRUP   ROCMGLTHTUHPI   BQEW            LFBH           
UBIWTN          : TFYVDHPPJXCKPM  KDFLXYAWW       OLMI            QGMLIOGRKDYCVN  DVYBQPBMAOGXXWE MTTWIPBRET     
JLBEUCMPXDOEOCS : SGUSFJUJNUF     TMKFGL         
GKAVPNRALSKIM   : QOXVEEKLR       UCCUJSUERPOHL   QGMLIOGRKDYCVN  AAVL            OTQPIJENADBDW   BQEW           
VYMWFJBS        : BSHJUAWOHELB    TQXGBAV        
YXQDPUYQBLQ     : DBARUBLAAIC    
DHPDSIOBWOW     : JUMARLGTDRF     CDPOVWFARAQ     KALNOXKGKUCMRLC ASKQOONKY      
DVENYWOXW       : SOILX          
DMCEGERWCVETY   : JLFWY           IXQMDFO         CDPOVWFARAQ     FWSAALFKM       TDSWQKKIFPKITSG XMBT           
CPABFYXIWEXVD   : OVWGVQGIX       MHPJYDFMD       IWPV            DMDVSXEX       
VAWCPA          : GXRFBIL         FXMJKXADR       QBUVED          JALMQMGXFXF     PCSNOOUOPUTK   
VGBUIW          : CXGLXWUUMNUIO   OLLGSRRUS       LIGFQOKXBD      YVUSOVNGQJCXSM 
CXBGQCH         : OTQPIJENADBDW   CCFVJHDQFFYRTH  TMKFGL          POSVSOJ        
BHGBLHWOW       : OVSQWTINSWJ     OMIHJNGWUKVBM  
RTXJVGH         : NCARFYT         UMCGVJSTAOP    
HCMGGOHIWXM     : TELHOORKPTPDGA  JDNBSHSR        WJBRLIBPHGUEDF  HYCO           
TNOCQDJOTIKL    : FQIXEQAUVU      PTOHYIS         WLMFBVFNPOSL    WATJBVWVGK     
IUYO            : LMKUNLUXJJFBXL  XUSPSKIQNKL     WJBRLIBPHGUEDF 
CWHQFNGM        : RWQHGIPMRVDMMGV TELHOORKPTPDGA  IRVYFDJXUVPKE   LSQRFTOPQBJ     TODMHWTB        XCMDBHXJTWDMIQG
FKIMGYEJ        : SAOEWIW         AYCBJXR         INESIKXFV       LVFWMIDBJ      
JUGDEQPJ        : ONCDDYMRB       WCQEVAY         WJBRLIBPHGUEDF 
MIQRMPYEUOMINT  : STGVABDSK       GIVQHSLWNATMSSP EAWKERJUO      
XJCWNNPYK       : JNSXE           LNSLTKKTOYVWJSP DHJK            RACHGFTTDI      UYYBLW         
CORTX           : MSCKKEEGPIN     FWQJFRH         GJCSCYHOB       VJPVIPMQNXB     QWIJLNGG       
HJJBXBAEW       : IIPHWHRARR      OATXKK          XBDPOYUOJA      DWGQDIJXQHQFG  
QHENEDW         : FENESEPHMOOCX   SWLRNEBS        FQIXEQAUVU      WYMJK           KXKQDAT         LSKQYHIOA      
CMVTLHSNX       : AMWHRXGKOYTK    HVSBXDBVTRMRN  
KWFTIPU         : RDIONRPXYE      LDUYXG          EPSYICEEOGWBSYN WJBRLIBPHGUEDF 
SWLRNEBS        : QHENEDW         BQKRFUBOLHOGTMH ELMOHAHJMXT    
GVQOXFN         : TFFUNEIORDBR    NVAJMEVPNL      DJBJIVLIXKQDOY  HQHLTBPKYWEUOC  CQDBSP         
QWLHUX          : IYXU            JVERFOP         EFJKPHCFUSJ     CBYANFRDMCMT   
TDLCUGJ         : XBBTXWASFGK    
DWGQDIJXQHQFG   : EOIKY           HJJBXBAEW       ITQOVSPWIB      YJAW            ASKQOONKY      
UYNRMUNMOHPCK   : PTXK            RIJW            TMOOFNH         RXKPUXDNLTOS    EVMJDXQVPNOK    TCYDFBQFOQX    
IVENUMH         : LSKQYHIOA       AFTG           
WSXNBPV         : QFDNGOHNBH      TMJGQMPOYL      NSRSNRXR       
MQICJW          : VFKMX           MWMHHJXAHKLN    XDFVMPVCNL      TQXGBAV        
YJOGBRSOCQS     : EBKWCTBIARPWS   PLAKTHCE        WMEGFOLIQ       XPJUN          
NGAODUMTVEPFQI  : AMWHRXGKOYTK    DWNEEWGALGX     ITQOVSPWIB      AIWM            CTHAXRXJEFMDLB  WMEGFOLIQ       ONWB           
TTMTSVKCXCW     : GIWEA          
FQIXEQAUVU      : TNOCQDJOTIKL    QHENEDW        
PTOHYIS         : IIFIRQ          XLNMTPEHUUIU    JSHNG           TNOCQDJOTIKL    JXYGLX          IVTNK           VJUUOLAMO      
EMEXIDIMDNJ     : IISHYSGY        UQJCUKA        
UCCUJSUERPOHL   : GKAVPNRALSKIM   PQQXXC          FBDISUC        
RNOKFSWLSHODT   : XPCRUJDHTGB     TEYHDCYYIHB     YRKEJUQLITX     HNDVXYLJFCY     IPXRIH          BNALA          
QGMLIOGRKDYCVN  : AJYCJBFARLMNXM  ADEF            UBIWTN          GKAVPNRALSKIM   IBTMFVE         IBXB            EPSYICEEOGWBSYN TEQUFRTRXXUXT  
QGMLIOGRKDYCVN  : BVFMUIPFL      
HTDUI           : TWUDUGGOXAQSJLT XOLNGRKP        NSFEVLLMUVIKXQD YSIBV           GWCQTIWUOCFVG   FWYYFTOJ       
CDPOVWFARAQ     : DHPDSIOBWOW     DMCEGERWCVETY   YSLMXMRJEIVMQ   FRPRWHD         CYVFHMTXVRUY   
MFID            : XLNMTPEHUUIU    AVOAVLEDTUALQ   RSGHKUVP        MCCYOCVVRODDM   SXJJCIH         BTTQSXGLWOVI    JFVNWAPRRIN    
BNTARPPEYM      : JBLYJQJYVF      KWLQAM          HELD           
WUAYYPN         : DQNIWGSM        XBPQJYL         LALIFG         
OVWGVQGIX       : DHJK            LDUYXG          TNBORTWHIL      CPABFYXIWEXVD   UIRDGGQXH       DHKEQPWQUBUYKB 
NNQEHSVYKCY     : NXGFUHEV        UPBS            GIVQHSLWNATMSSP WCMRXTWLQROYPJ 
OVSQWTINSWJ     : UFFODYKQ        BAVXIXUTMCQLR   BHGBLHWOW       NAMDPHCHXNRCN   IFBGDKAJLGG    
EFJKPHCFUSJ     : KOMUWT          QWLHUX          YSLMXMRJEIVMQ   AVGXVPQ         FNAQN          
NGEY            : BQEW            ELMOHAHJMXT    
DVYBQPBMAOGXXWE : NXGFUHEV        UBIWTN          FHGEFCRROPLNIMS NHTOKRGLYCAECAA JHDPV          
GQWPTCMO        : KWMMJFXHA       GJCSCYHOB       VJPVIPMQNXB    
RDUW            : BWPLIVVV        OPSYXDDRSI      JHDPV           AJKSDEWLTTBADIQ
FCCHETYF        : UIRDGGQXH       XUSHGD         
AVOAVLEDTUALQ   : GOIQUXGJDGXCR   MFID            VNNSVQOLKDWC   
YGQQLNNRVQ      : TSWGXSTOYVEFJH  TEGARXSNSBJXX   YMBN            GIWEA           OVBU            WDAAAIWVFCX    
DWNEEWGALGX     : NGAODUMTVEPFQI  JWCKBEOFGRXML   GRCQGHTIXRUUEC  ILUKQNKRXK      XDEYNDOJOBGNA  
MBVKBIBFHJYAU   : OFARHEXGRJKWTB  LGXSYEOTKAOVNM  JNXC            IHYGBATLULE     AYSBSAFHDVDD   
OMIHJNGWUKVBM   : CGOTDPIUHIMLJYJ BHGBLHWOW       VSCDFFF        
IMKUNGHQQJVAS   : TXXOKODDXTINIB  GHQYDNJUHKUUYIO XWQJEFXWQQSITYK MTUXYSIJWPX     WRUHPIQWYHGWKC  QYDURKBXWIA     TKQHBKYABIDCE   BSYWIA         
BQKRFUBOLHOGTMH : PTXK            TSWGXSTOYVEFJH  SWLRNEBS        SASSK           JRPSTTMHITCEX  
WRUHPIQWYHGWKC  : GPWWCLCHKWQAFT  IMKUNGHQQJVAS   GEVEFWHAKBNFI   JFSQIWVSNSOW    WCMRXTWLQROYPJ 
NSFF            : LHHSTMY         AJKSDEWLTTBADIQ YKGCCXTSPWBI   
CGRNPGTJSERQVM  : NXKSMASMMAFF   
NUQLV           : RWQHGIPMRVDMMGV VQFKOL          UMJVGJWUINX    
TSNVNBQUG       : XQUOPTJWB      
XOLNGRKP        : DHJK            WCVIQLAIKYOKPS  HTDUI           YPSVKIQPON      EGSAXN         
QHFMVGBS        : LPUIIBIFOANWIX  YAODEW          FADGK           SSQXUQSVTGGKLYI EAWKERJUO      
OOCIHPHXQXSYR   : GHQGITPCIQST    RQVASFXHYCWVE   VRVUBYYWJT      MAOLSJGMBR     
PDJVWTLMKURYSA  : OATXKK          JFVEUBQGONQ    
LAQAECKUJINHDPC : FTXQNDW         SXJJCIH         WLVQAABIQIVN   
FHGEFCRROPLNIMS : PDNCJM          YXXTPUMYAOFMRYQ DVYBQPBMAOGXXWE GIWEA           WFGWQNSVOFEYGCQ
OJYSLJPWTGHXVJ  : YKGCCXTSPWBI    JAYXICBT       
DQDJXFCRT       : TQXGBAV         DRIYTBYNUL      XDEYNDOJOBGNA   XCBMY          
GJCSCYHOB       : OSQWDL          CORTX           GQWPTCMO        NAMDPHCHXNRCN   SLGEVPOAIKG     LFBH           
CKSAFY          : YVUSOVNGQJCXSM  TTXYL           FAQG           
FWSAALFKM       : FWQJFRH         DMCEGERWCVETY   XETMICJHBW      JFVEUBQGONQ     QYDURKBXWIA    
OGIIMRMHWMON    : MUBIJ           XXXQNP          OVBU            XIWGHYXXISKAGVN RFDDDHOWTHDCC  
TRAMRHNBM       : DOAHNKMUVKTY    QFDNGOHNBH      UMXMGQCQAIGCLK  XPJEGCQYD      
VOMIVYWIND      : UWMMSTYHRAHSCCS UNMBRMUFUTFK    KXKQDAT         QKPA           
XQLLXKAPXPJPR   : XETMICJHBW     
KALNOXKGKUCMRLC : DHPDSIOBWOW     NCARFYT         WCMRXTWLQROYPJ  ERIXJG         
EBNROOCOECEPUXN : JWOVKLBHT       ITQOVSPWIB      KQSRYPDSTRCG   
XBUPBHVL        : XAEMYSVGC       HVSBXDBVTRMRN   PPEJJHYDFTWB   
AAVL            : AMWHRXGKOYTK    GKAVPNRALSKIM   STSPGSK         QBUVED          XPJUN          
RSGHKUVP        : JTOQATYEI       YQDBN           MFID            WFMSLRJEDGSESJ  STANLWG        
CRPR            : YKUNRKWOWKXI    LDFGV           UQYDYVHBAGSVBU  WFMSLRJEDGSESJ  JFVEUBQGONQ    
NHTOKRGLYCAECAA : DVYBQPBMAOGXXWE ERIXJG          QAYUH          
FRLLCVIXNTBGJ   : OHVMCTTRQFU     GPJWNRBNN       VFHMUYENUFDL    ERIXJG          GPNUIJ          LNQFNLDQJD     
UAFRQ           : SAOEWIW         NSFAEAXNPL      TODMHWTB       
JWCKBEOFGRXML   : JNSXE           DWNEEWGALGX     FKMKXUFPSHIXHRW AJQLMNYJLKS     DTPFUA         
ANIJMVDPEPK     : KCNDUUODDVBTEU  GIVQHSLWNATMSSP
RPTIGFHKPIQH    : BAVXIXUTMCQLR   PDNCJM          WTEMHP         
WYMJK           : ADHKDPKGMAT     QHENEDW         ASKQOONKY       FNAQN          
MYGVNFYDJQ      : KTEFVTFCA       QFDNGOHNBH      YKKLPALHVJRE    IFBGDKAJLGG     XUSPSKIQNKL     CCFVJHDQFFYRTH 
LIGFQOKXBD      : JUMARLGTDRF     UPBS            MPDEFFBYSCQ     VGBUIW         
RMYQLNDXL       : BWPLIVVV        WASNKF          XNUHBGRTQYEJKOK
YSLMXMRJEIVMQ   : DTREGSTNTBCTHJJ CDPOVWFARAQ     EFJKPHCFUSJ     WTPAHGVTVVKERL  HBXRGHLIFY     
GHQGITPCIQST    : KOMUWT          FMKJMRPYLOPTUY  OOCIHPHXQXSYR   IGQIEIR        
VTPLVKYKKMDW    : AGMAGHNRONGUMTT INESIKXFV      
NSFEVLLMUVIKXQD : XDFVMPVCNL      HTDUI          
MHPJYDFMD       : CPABFYXIWEXVD   NCARFYT         WWUGSISELE      TDGOQBMLR      
YPSVKIQPON      : XOLNGRKP        MROEOVLDRN      OHGAEUNYDPEDORU
CCYXNLXGORTXH   : BAOWLWK         FYBTBTKDIQQCAM  UQJCUKA         TDGOQBMLR       RLBPXVU        
YKKLPALHVJRE    : YPKBLKLVTTRC    CTAAEGWNLDCIQ   HQQREPRQTW      MYGVNFYDJQ      WCQEVAY        
ITQOVSPWIB      : WEOWOL          LMKUNLUXJJFBXL  DWGQDIJXQHQFG   NGAODUMTVEPFQI  EBNROOCOECEPUXN
PRMJRVO         : QGWVLRI         XPJUN          
HYDYBQH         : JUMARLGTDRF     FRPRWHD         BSYWIA          XUSHGD         
AYCBJXR         : NDHBCLMYMW      FKIMGYEJ        GEWTLG          GEVEFWHAKBNFI   QUVLGHMXOTTS    MAOLSJGMBR     
VNNSVQOLKDWC    : ONCDDYMRB       GNHRHGHGO       AVOAVLEDTUALQ   RACHGFTTDI     
NTJMYIOPPNRPRVY : XPCRUJDHTGB     ARRMGJGDKRMEYA  KCNDUUODDVBTEU  AYSBSAFHDVDD   
NAMDPHCHXNRCN   : EOIKY           HQQREPRQTW      OVSQWTINSWJ     GJCSCYHOB       SASSK          
CBQLQ           : CUKXTUPTEKX     ODIMDMGX        MPDEFFBYSCQ     UASKNXCYYF     
VFHMUYENUFDL    : MFPJWKN         NNRFEYSSXRGEI   FRLLCVIXNTBGJ   JALMQMGXFXF    
RQVASFXHYCWVE   : BSHJUAWOHELB    NVAJMEVPNL      KDFLXYAWW       CGOTDPIUHIMLJYJ AYONUJNWDWGC    OOCIHPHXQXSYR  
MROEOVLDRN      : LHCKVY          YXXTPUMYAOFMRYQ YPSVKIQPON      LFNIVMMRBUTK    IWPV           
FKMKXUFPSHIXHRW : JWCKBEOFGRXML   IHYGBATLULE     YKGCCXTSPWBI    LSKQYHIOA      
OTQPIJENADBDW   : GKAVPNRALSKIM   CXBGQCH         MCTFFLGANIGKRPN
MCCYOCVVRODDM   : NVAJMEVPNL      XNUHBGRTQYEJKOK MFID            GMXSQLNTDOSU   
UMXMGQCQAIGCLK  : JNXC            TRAMRHNBM       GWCQTIWUOCFVG   JDNBSHSR       
IBTMFVE         : CXGLXWUUMNUIO   QGMLIOGRKDYCVN  JXYGLX          AVGXVPQ         JFVEUBQGONQ     CMUFVEB        
RACHGFTTDI      : XWQJEFXWQQSITYK XJCWNNPYK       VNNSVQOLKDWC    XWDBGIFFTA     
ROKVIN          : TELHOORKPTPDGA  OLLGSRRUS       YAODEW         
OPSYXDDRSI      : CXGFNVYWB       GXYL            AYONUJNWDWGC    RDUW           
YSIBV           : XBDPOYUOJA      HTDUI           RVIP           
HDLDGUWXLKTVXBL : RVIP            XDEYNDOJOBGNA  
VMNYPITYXSRGU   : EIBXAFHTBWPC    TCYDFBQFOQX    
XETMICJHBW      : ODIMDMGX        KTEFVTFCA       FWSAALFKM       XQLLXKAPXPJPR   YJAW            OVBU           
WTPAHGVTVVKERL  : YSLMXMRJEIVMQ   WFMSLRJEDGSESJ  OVBU           
LFNIVMMRBUTK    : DTOBAIMK        MROEOVLDRN      CYMIK          
UJWUDNUKV       : EIBXAFHTBWPC    JHDPV          
FRPRWHD         : UBORP           CDPOVWFARAQ     HYDYBQH        
UIRDGGQXH       : OVWGVQGIX       FCCHETYF       
STSPGSK         : XBBTXWASFGK     AAVL            DFTBFYGO        GIVQHSLWNATMSSP
GIWEA           : TTMTSVKCXCW     YGQQLNNRVQ      FHGEFCRROPLNIMS
VRVUBYYWJT      : OOCIHPHXQXSYR   QBUVED          HQHLTBPKYWEUOC  MFNBOSU         UMCGVJSTAOP    
SASSK           : FUIHYOWXXUGLWQL BQKRFUBOLHOGTMH NAMDPHCHXNRCN   DFTBFYGO        GEVEFWHAKBNFI   QAYUH          
LGCE            : IRVYFDJXUVPKE   EMDXV           BNEOVEV         TMOOFNH        
UQYDYVHBAGSVBU  : CRPR           
DRIYTBYNUL      : DQDJXFCRT       IPXRIH          WATJBVWVGK      LCVM            XRQYL           XUSHGD         
IUYMHUE         : KOMUWT          BAOWLWK         FTXQNDW        
ADCIHEQ         : PDNCJM          KUFJFHR         KQIINXVE       
ARWWWQIV        : MXHKWYWYMHMJCGD QPTBTNYGOEKNW   CXGLXWUUMNUIO   PUQDXCSCQ       GNHRHGHGO       IXQMDFO        
JXYGLX          : PTOHYIS         IBTMFVE         BMTWSTTKMEOSNE  XQUOPTJWB      
GWCQTIWUOCFVG   : FPTLAKMVUMFVLQE IISHYSGY        HTDUI           UMXMGQCQAIGCLK 
VJPVIPMQNXB     : SVMKDWW         CORTX           GQWPTCMO        UQJCUKA         XCBMY          
YJAW            : JEMMXA          MTUXYSIJWPX     DWGQDIJXQHQFG   XETMICJHBW      UYYBLW          SXOOOLVHYYDWIU  HYCO           
IWEYQMYN        : MCTFFLGANIGKRPN UASKNXCYYF     
DUYLSVUJRGBEW   : FUHM            FXMJKXADR       AJQLMNYJLKS     VSCDFFF         KVVRXVAFUETNCJ 
FADGK           : QHFMVGBS        AFTG            SXOOOLVHYYDWIU 
ELNDPPVFOKIT    : RFDDDHOWTHDCC   WWUGSISELE      EVMJDXQVPNOK   
IFBGDKAJLGG     : OVSQWTINSWJ     MYGVNFYDJQ      KQSRYPDSTRCG    JFSQIWVSNSOW   
LHHSTMY         : NSFF            BQEW            XRQYL           POSVSOJ         HYCO           
DCXUXDLKNFSVKTE : GPJWNRBNN       IYAONHUMRNLLV  
GEWTLG          : JWOVKLBHT       AYCBJXR         SHMSSMRRVVSRQE  XRXBMXQDME     
YPER            : ILICAFF         AYONUJNWDWGC    CGJNRUGGYDQA    QBUVED          LALIFG          IVTNK          
SSQXUQSVTGGKLYI : ESBFVJIAOVN     QGLPPTSGTDVG    QHFMVGBS       
UNMBRMUFUTFK    : YKUNRKWOWKXI    QGWVLRI         VOMIVYWIND      VLNKCSAP       
YVUSOVNGQJCXSM  : VGBUIW          CKSAFY          FVGEVSLBUNWVJ   DHKEQPWQUBUYKB 
RVIP            : XLNMTPEHUUIU    YSIBV           HDLDGUWXLKTVXBL RFDDDHOWTHDCC  
VQFKOL          : YPKBLKLVTTRC    NUQLV           QWIJLNGG       
KSRKRNHKCDBIU   : FVGEVSLBUNWVJ  
NSFAEAXNPL      : UAFRQ          
IRVYFDJXUVPKE   : KHEHOLCPK       BNXHLOKJJ       CWHQFNGM        LGCE            UYYBLW         
OHGAEUNYDPEDORU : YPSVKIQPON      WMEGFOLIQ       ASKQOONKY       ONWB           
DFTBFYGO        : STSPGSK         SASSK           UASKNXCYYF      JFVNWAPRRIN    
DLPNRUCBB       : RCKLSFLQNG      BSHJUAWOHELB    GRCQGHTIXRUUEC  CYMIK           VJUUOLAMO      
GXRFBIL         : IIPHWHRARR      GGIA            VAWCPA         
YDBYIHTLO       : DBMRJXSXRWIDPP  SGUSFJUJNUF     LMQLMUYLMIQJV  
TDSWQKKIFPKITSG : JEMMXA          DMCEGERWCVETY   XMBT            LCVM            LMQLMUYLMIQJV  
AIWM            : MFPJWKN         NGAODUMTVEPFQI  JFSQIWVSNSOW    XRQYL          
VRSW            : MSCKKEEGPIN     CQGGDKF        
CSOQOJTJG       : SXJJCIH         DHKEQPWQUBUYKB 
TTXYL           : VFKMX           CUKXTUPTEKX     UBORP           CKSAFY          THTQYJFJDRTJH  
JHDPV           : DVYBQPBMAOGXXWE RDUW            UJWUDNUKV      
XUSPSKIQNKL     : ILICAFF         IUYO            MYGVNFYDJQ      FBDISUC        
BAOWLWK         : UCFRE           CCYXNLXGORTXH   IUYMHUE        
SLGEVPOAIKG     : TELHOORKPTPDGA  GJCSCYHOB       XIWGHYXXISKAGVN
IBXB            : SRDQALF         QMMGAQL         QGMLIOGRKDYCVN  AJQLMNYJLKS     WCQEVAY         XKUC           
GRCQGHTIXRUUEC  : CTAAEGWNLDCIQ   JVERFOP         DWNEEWGALGX     DLPNRUCBB      
PJUOBJQJWY      : LNSLTKKTOYVWJSP NVAJMEVPNL      TEGARXSNSBJXX   IHYGBATLULE    
FAQG            : QMMGAQL         CKSAFY          HUBVEEFOQFK    
XBPQJYL         : PTXK            LDFGV           WUAYYPN         AJQLMNYJLKS     CYMIK           MIJMLV         
WFMSLRJEDGSESJ  : DTOBAIMK        FPTLAKMVUMFVLQE FENESEPHMOOCX   RSGHKUVP        CRPR            WTPAHGVTVVKERL 
RIJW            : MXHKWYWYMHMJCGD MUBIJ           UYNRMUNMOHPCK   KQSRYPDSTRCG    LTNORMRUNTB     TDGOQBMLR      
CFXCIQVRPJ      : TNBORTWHIL      NJVOGD         
NOBI            : WEHC            LHCKVY          FWYYFTOJ       
STGVABDSK       : RCKLSFLQNG      MQORHODO        MIQRMPYEUOMINT 
KUFJFHR         : ADCIHEQ         OCGYGFLPG      
MCUIUMRJAIKK    : VCVJ            GPNUIJ         
GEVEFWHAKBNFI   : YKUNRKWOWKXI    XAEMYSVGC       WRUHPIQWYHGWKC  AYCBJXR         SASSK           CBALPEGULTDOH  
LSQRFTOPQBJ     : GGIA            CWHQFNGM        XMBT            QAYUH          
ETMOGSTCA       : KEAKFLFSDSRUP   KYDSCICY        IVTNK           HUBVEEFOQFK    
AHBKLO          : AGMAGHNRONGUMTT OCGYGFLPG       XIWGHYXXISKAGVN
TODMHWTB        : PDNCJM          CWHQFNGM        UAFRQ           GMXSQLNTDOSU   
JRPSTTMHITCEX   : GJHFPPMDXOVIEKY BQKRFUBOLHOGTMH
FXMJKXADR       : TQXGBAV         FWQJFRH         VAWCPA          DUYLSVUJRGBEW  
IHYGBATLULE     : DHJK            PUQDXCSCQ       MBVKBIBFHJYAU   FKMKXUFPSHIXHRW PJUOBJQJWY      QWIJLNGG       
FTXQNDW         : MCCMFQF         WCVIQLAIKYOKPS  XUOMOVS         LAQAECKUJINHDPC IUYMHUE         XKUC           
HDMTO           : LDUYXG          DAGMB           TMJGQMPOYL      LSKQYHIOA       GPNUIJ         
ROCMGLTHTUHPI   : GPWWCLCHKWQAFT  LDUYXG          EIBXAFHTBWPC    QXPDNU          AQRHXO          WAIKNFR         DJBJIVLIXKQDOY  AYSBSAFHDVDD   
CNTJJTCYWAM     : IYXU            OSQWDL          FENESEPHMOOCX   KXKQDAT        
FYBTBTKDIQQCAM  : TSWGXSTOYVEFJH  CCYXNLXGORTXH   EMDXV           VTBIKRPXB      
IFIOHXKS        : RDIONRPXYE      GMXSQLNTDOSU    SHMSSMRRVVSRQE 
FVGEVSLBUNWVJ   : XPVY            YVUSOVNGQJCXSM  KSRKRNHKCDBIU   XMBT           
BRBUVB          : RDIONRPXYE      GYBIPBWUVVSCY   CNWJGHIWFTIGDC  DJBJIVLIXKQDOY  EVMJDXQVPNOK   
WLMFBVFNPOSL    : SVMKDWW         LGXSYEOTKAOVNM  TNOCQDJOTIKL    MKYCN           VJUUOLAMO       FBUD           
AJQLMNYJLKS     : CUKXTUPTEKX     TEGARXSNSBJXX   JWCKBEOFGRXML   DUYLSVUJRGBEW   IBXB            XBPQJYL        
CTHAXRXJEFMDLB  : ESBFVJIAOVN     NGAODUMTVEPFQI  CMUFVEB         TNVFSLDSVHR    
AVGXVPQ         : MFWNYMDEMBEITYU FENESEPHMOOCX   EFJKPHCFUSJ     IBTMFVE         WSKPM          
CGJNRUGGYDQA    : CAABOOFJVKA     KXNRQPWGYUNLPJ  YPER            XWDBGIFFTA     
KXKQDAT         : IIFIRQ          QHENEDW         VOMIVYWIND      CNTJJTCYWAM    
BMTWSTTKMEOSNE  : HQQREPRQTW      JXYGLX         
ILUKQNKRXK      : PVOD            QPTBTNYGOEKNW   DWNEEWGALGX     EPSYICEEOGWBSYN NSRSNRXR       
PPEJJHYDFTWB    : XBUPBHVL       
JFVEUBQGONQ     : PDJVWTLMKURYSA  FWSAALFKM       CRPR            IBTMFVE         XPJUN          
CBYANFRDMCMT    : RCKLSFLQNG      QWLHUX         
RBWOCEAJBGFEYL  : LWTQU           FNAQN          
NCARFYT         : IYXU            RTXJVGH         KALNOXKGKUCMRLC MHPJYDFMD       NCRLBA         
GMXSQLNTDOSU    : WEOWOL          UGFE            MCCYOCVVRODDM   TODMHWTB        IFIOHXKS        VSCDFFF        
XWDBGIFFTA      : JYFDRW          GNHRHGHGO       XWQJEFXWQQSITYK RACHGFTTDI      CGJNRUGGYDQA    EVMJDXQVPNOK   
XCMDBHXJTWDMIQG : XGKHFPSHUV      FMKJMRPYLOPTUY  AGMAGHNRONGUMTT CWHQFNGM       
HYKBYK          : KWMMJFXHA      
AQRHXO          : XPCRUJDHTGB     HQQREPRQTW      TELHOORKPTPDGA  ROCMGLTHTUHPI  
TMJGQMPOYL      : WNOEFO          WCVIQLAIKYOKPS  YRKEJUQLITX     WSXNBPV         HDMTO           SRXBXLXJFDPRR  
CXXU            : GAASWBPXOWLAB   DTOBAIMK        GJHFPPMDXOVIEKY UASKNXCYYF     
OCGYGFLPG       : FMKJMRPYLOPTUY  KUFJFHR         AHBKLO          KWLQAM         
HNDVXYLJFCY     : RNOKFSWLSHODT  
SXJJCIH         : QMMGAQL         MFID            LAQAECKUJINHDPC CSOQOJTJG       QHUTDMA         LLKDU          
OVBU            : JCQVMYEBWSPWCCA YGQQLNNRVQ      OGIIMRMHWMON    XETMICJHBW      WTPAHGVTVVKERL 
JBLYJQJYVF      : JUMARLGTDRF     JWOVKLBHT       BNTARPPEYM      VJUUOLAMO      
UQJCUKA         : GPWWCLCHKWQAFT  KTEFVTFCA       EMEXIDIMDNJ     CCYXNLXGORTXH   VJPVIPMQNXB     EVMJDXQVPNOK    SIEK           
KMAMUJLJGMHE    : DTREGSTNTBCTHJJ LCVM            HYCO           
IPXRIH          : RNOKFSWLSHODT   DRIYTBYNUL      NSRSNRXR       
EPSYICEEOGWBSYN : QPTBTNYGOEKNW   KWFTIPU         QGMLIOGRKDYCVN  ILUKQNKRXK      DBARUBLAAIC     VTBIKRPXB       NSRSNRXR       
IYAONHUMRNLLV   : XWQJEFXWQQSITYK DCXUXDLKNFSVKTE WATJBVWVGK      ELMOHAHJMXT     BNALA          
EBKWCTBIARPWS   : NXKSMASMMAFF    RPNPN           BYKVMEROGRFJ    YJOGBRSOCQS    
XIWGHYXXISKAGVN : OATXKK          JNXC            OGIIMRMHWMON    SLGEVPOAIKG     AHBKLO          FWYYFTOJ       
RRIERK          : GNHRHGHGO       RHLAVIELQBU     HUBVEEFOQFK    
STANLWG         : QPTBTNYGOEKNW   TQXGBAV         RSGHKUVP        IVTNK          
UPSEYRCWCWICE   : CGOTDPIUHIMLJYJ
PLAKTHCE        : KOMUWT          YJOGBRSOCQS     KUWYDPIBIVNS   
WAIKNFR         : XAEMYSVGC       MTUXYSIJWPX     ROCMGLTHTUHPI  
DJBJIVLIXKQDOY  : KCKXYUISJHOIS   ADEF            AYONUJNWDWGC    GVQOXFN         ROCMGLTHTUHPI   BRBUVB         
CCFVJHDQFFYRTH  : UWMMSTYHRAHSCCS CXBGQCH         MYGVNFYDJQ      ELMOHAHJMXT     SIEK           
CMUFVEB         : GEQKSLBSPPA     IBTMFVE         CTHAXRXJEFMDLB 
MCTFFLGANIGKRPN : RHLAVIELQBU     OTQPIJENADBDW   IWEYQMYN       
WSKPM           : AVGXVPQ         TDGOQBMLR      
BQEW            : QXPDNU          GKAVPNRALSKIM   NGEY            LHHSTMY         NCRLBA         
CBALPEGULTDOH   : JLFWY           GEVEFWHAKBNFI   JFVNWAPRRIN    
WTEMHP          : HVSBXDBVTRMRN   RPTIGFHKPIQH    QHUTDMA         OBGQIHLI        WWUGSISELE      NJVOGD         
DBARUBLAAIC     : JYFDRW          LDFGV           YXQDPUYQBLQ     EPSYICEEOGWBSYN CYVFHMTXVRUY    MFNBOSU        
KQSRYPDSTRCG    : MCCMFQF         TELHOORKPTPDGA  EBNROOCOECEPUXN IFBGDKAJLGG     RIJW            WCQEVAY        
WMEGFOLIQ       : XXVMKNXWOA      YJOGBRSOCQS     NGAODUMTVEPFQI  OHGAEUNYDPEDORU FNAQN           RYTWBV         
DTPFUA          : MANCM           JWCKBEOFGRXML  
XMBT            : JFYYH           GGIA            YCHNKRT         DWFFUBY         DMCEGERWCVETY   TDSWQKKIFPKITSG LSQRFTOPQBJ     FVGEVSLBUNWVJ  
XMBT            : EVMJDXQVPNOK   
AJKSDEWLTTBADIQ : RDUW            NSFF            CYMIK          
QHUTDMA         : ADEF            SXJJCIH         WTEMHP          QYDURKBXWIA    
MKYCN           : UWMMSTYHRAHSCCS WLMFBVFNPOSL   
INESIKXFV       : VWWUY           FKIMGYEJ        VTPLVKYKKMDW    ASKQOONKY      
CYVFHMTXVRUY    : AJYCJBFARLMNXM  CLDGNDU         JWOVKLBHT       CDPOVWFARAQ     DBARUBLAAIC    
WATJBVWVGK      : TNOCQDJOTIKL    DRIYTBYNUL      IYAONHUMRNLLV   PBQP           
AUMAAJVEKRJ     : UMJVGJWUINX    
EGSAXN          : YXPIC           XOLNGRKP        STUQLFWU       
EMDXV           : DQNIWGSM        LGCE            FYBTBTKDIQQCAM 
VSCDFFF         : OMIHJNGWUKVBM   DUYLSVUJRGBEW   GMXSQLNTDOSU    FNVUB          
RFDDDHOWTHDCC   : OGIIMRMHWMON    ELNDPPVFOKIT    RVIP           
CQGGDKF         : GMXOMXHLBYKP    VRSW           
QBUVED          : KOMUWT          VAWCPA          AAVL            VRVUBYYWJT      YPER           
JFSQIWVSNSOW    : BPIGWHBJMKGFXO  WRUHPIQWYHGWKC  IFBGDKAJLGG     AIWM            GIVQHSLWNATMSSP ELMOHAHJMXT    
QYDURKBXWIA     : KCKXYUISJHOIS   KDFLXYAWW       IMKUNGHQQJVAS   FWSAALFKM       QHUTDMA         QUVLGHMXOTTS   
KWLQAM          : KEAKFLFSDSRUP   TSWGXSTOYVEFJH  BNTARPPEYM      OCGYGFLPG      
GIVQHSLWNATMSSP : ARRMGJGDKRMEYA  DAGMB           MIQRMPYEUOMINT  NNQEHSVYKCY     ANIJMVDPEPK     STSPGSK         JFSQIWVSNSOW   
NCRLBA          : NCARFYT         BQEW            ELMOHAHJMXT    
TMKFGL          : XUOMOVS         JLBEUCMPXDOEOCS CXBGQCH         OQMD            EAWKERJUO      
JTFFKMAWJOYF    : KCKXYUISJHOIS   NTMUV          
UASKNXCYYF      : VFKMX           YRKEJUQLITX     FUIHYOWXXUGLWQL CBQLQ           IWEYQMYN        DFTBFYGO        CXXU            STUQLFWU       
SRXBXLXJFDPRR   : RCKLSFLQNG      AMWHRXGKOYTK    TSWGXSTOYVEFJH  TMJGQMPOYL     
OBGQIHLI        : VFKMX           OMKWELTYJPTMR   WTEMHP          NSRSNRXR        BNALA          
VWBBXCGNXANBB   : JEMMXA          WAUIXI          XWOLRAWP       
YKGCCXTSPWBI    : SAOEWIW         UFFODYKQ        PEAL            VSXBVVE         NSFF            OJYSLJPWTGHXVJ  FKMKXUFPSHIXHRW
LTNORMRUNTB     : WEOWOL          RIJW            STUQLFWU       
TEQUFRTRXXUXT   : ESBFVJIAOVN     FOGRACGNYG      QGMLIOGRKDYCVN  WWUGSISELE     
PQQXXC          : CTAAEGWNLDCIQ   KTEFVTFCA       TEYHDCYYIHB     HVSBXDBVTRMRN   UCCUJSUERPOHL  
OQMD            : WEOWOL          TMKFGL         
HQHLTBPKYWEUOC  : GVQOXFN         VRVUBYYWJT     
JDNBSHSR        : XXXQNP          HCMGGOHIWXM     UMXMGQCQAIGCLK  JBHNWTPWQNFL   
WLVQAABIQIVN    : IIPHWHRARR      LAQAECKUJINHDPC
LALIFG          : WUAYYPN         YPER            FWYYFTOJ       
JALMQMGXFXF     : TWUDUGGOXAQSJLT HQQREPRQTW      UPBS            VAWCPA          VFHMUYENUFDL    EVMJDXQVPNOK   
LCVM            : LNSLTKKTOYVWJSP WAUIXI          DRIYTBYNUL      TDSWQKKIFPKITSG KMAMUJLJGMHE   
WWUGSISELE      : MHPJYDFMD       ELNDPPVFOKIT    WTEMHP          TEQUFRTRXXUXT   MTTWIPBRET      LSKQYHIOA       XQUOPTJWB      
QKPA            : QMMGAQL         JLFWY           QGLPPTSGTDVG    VOMIVYWIND     
BNEOVEV         : LGCE            HUBVEEFOQFK     FWYYFTOJ       
JBHNWTPWQNFL    : UGFE            YOWHL           JDNBSHSR       
XPJEGCQYD       : XBBTXWASFGK     TRAMRHNBM       IGQIEIR        
ASKQOONKY       : DHPDSIOBWOW     DWGQDIJXQHQFG   WYMJK           OHGAEUNYDPEDORU INESIKXFV      
TMOOFNH         : UYNRMUNMOHPCK   LGCE           
STUQLFWU        : IGSUUHRT        GHQYDNJUHKUUYIO MGLBKJSX        EGSAXN          UASKNXCYYF      LTNORMRUNTB    
NTMUV           : DOAHNKMUVKTY    MFWNYMDEMBEITYU YMBN            JTFFKMAWJOYF    ERIXJG         
FNVUB           : XPVY            VSCDFFF         WDAAAIWVFCX    
VTBIKRPXB       : FYBTBTKDIQQCAM  EPSYICEEOGWBSYN
QWIJLNGG        : CORTX           VQFKOL          IHYGBATLULE    
WCMRXTWLQROYPJ  : JSHNG           NNQEHSVYKCY     WRUHPIQWYHGWKC  KALNOXKGKUCMRLC
BTTQSXGLWOVI    : XLNMTPEHUUIU    MUBIJ           MFID           
CQDBSP          : BSHJUAWOHELB    GVQOXFN        
TKQHBKYABIDCE   : UFFODYKQ        APJLTAAEYG      IYXU            IMKUNGHQQJVAS  
UYYBLW          : XUOMOVS         XJCWNNPYK       YJAW            IRVYFDJXUVPKE   FBDISUC        
JFVNWAPRRIN     : JCQVMYEBWSPWCCA MFID            DFTBFYGO        CBALPEGULTDOH  
BVFMUIPFL       : QGMLIOGRKDYCVN  RYTWBV         
LMQLMUYLMIQJV   : RWQHGIPMRVDMMGV TSWGXSTOYVEFJH  YDBYIHTLO       TDSWQKKIFPKITSG DEEDGFPFUUUU    MAOLSJGMBR      XUSHGD         
LLKDU           : XBBTXWASFGK     SXJJCIH        
IVTNK           : RCKLSFLQNG      OHVMCTTRQFU     PTOHYIS         YPER            ETMOGSTCA       STANLWG         SOILX          
VCVJ            : MCUIUMRJAIKK   
IWPV            : WNOEFO          KXNRQPWGYUNLPJ  CPABFYXIWEXVD   MROEOVLDRN      IUIXFTRFTJ     
KUWYDPIBIVNS    : GPWWCLCHKWQAFT  JCQVMYEBWSPWCCA PLAKTHCE       
KQIINXVE        : ADCIHEQ        
XDEYNDOJOBGNA   : AKWFDQATVTTN    YPKBLKLVTTRC    JGIKCERUH       DWNEEWGALGX     DQDJXFCRT       HDLDGUWXLKTVXBL ELMOHAHJMXT    
ELMOHAHJMXT     : ADHKDPKGMAT     SWLRNEBS        NGEY            IYAONHUMRNLLV   CCFVJHDQFFYRTH  JFSQIWVSNSOW    NCRLBA          XDEYNDOJOBGNA  
NSRSNRXR        : UFFODYKQ        WSXNBPV         ILUKQNKRXK      IPXRIH          EPSYICEEOGWBSYN OBGQIHLI       
LVFWMIDBJ       : LWTQU           TQXGBAV         FKIMGYEJ        UMCGVJSTAOP     XPJUN          
HUBVEEFOQFK     : FAQG            ETMOGSTCA       RRIERK          BNEOVEV        
TDGOQBMLR       : AKWFDQATVTTN    MHPJYDFMD       CCYXNLXGORTXH   RIJW            WSKPM          
JAYXICBT        : ILYIYUNVN       OJYSLJPWTGHXVJ  THTQYJFJDRTJH  
KQVIVC          : KEAKFLFSDSRUP  
MTTWIPBRET      : CXGFNVYWB       RDIONRPXYE      UBIWTN          WWUGSISELE     
SHMSSMRRVVSRQE  : GEWTLG          IFIOHXKS        UMJVGJWUINX    
MMFPBTLWQVMT    : VFKMX          
SOILX           : BNXHLOKJJ       TNBORTWHIL      DVENYWOXW       IVTNK          
ERIXJG          : PTXK            VSXBVVE         ISIHISJHYPAL    KALNOXKGKUCMRLC NHTOKRGLYCAECAA FRLLCVIXNTBGJ   NTMUV           FBDISUC        
CYMIK           : XPCRUJDHTGB     QGLPPTSGTDVG    LFNIVMMRBUTK    DLPNRUCBB       XBPQJYL         AJKSDEWLTTBADIQ QUVLGHMXOTTS   
XRQYL           : DRIYTBYNUL      LHHSTMY         AIWM           
XCBMY           : TQXGBAV         DQDJXFCRT       VJPVIPMQNXB    
FNAQN           : JLFWY           EFJKPHCFUSJ     WYMJK           RBWOCEAJBGFEYL  WMEGFOLIQ       MAOLSJGMBR     
WFGWQNSVOFEYGCQ : GYBIPBWUVVSCY   FHGEFCRROPLNIMS
DEEDGFPFUUUU    : LMQLMUYLMIQJV  
LSKQYHIOA       : PTXK            FOGRACGNYG      QHENEDW         IVENUMH         FKMKXUFPSHIXHRW HDMTO           WWUGSISELE     
DHKEQPWQUBUYKB  : OVWGVQGIX       YVUSOVNGQJCXSM  CSOQOJTJG      
RXKPUXDNLTOS    : TFFUNEIORDBR    ILYIYUNVN       UYNRMUNMOHPCK  
EVMJDXQVPNOK    : MGLBKJSX        UYNRMUNMOHPCK   ELNDPPVFOKIT    BRBUVB          XWDBGIFFTA      UQJCUKA         XMBT            JALMQMGXFXF    
KJENYXNLPILSX   : XBBTXWASFGK     FWQJFRH        
POSVSOJ         : CXBGQCH         LHHSTMY         VXYQG          
THTQYJFJDRTJH   : TTXYL           JAYXICBT       
IUIXFTRFTJ      : XPCRUJDHTGB     IWPV            LNQFNLDQJD     
MFNBOSU         : XXVMKNXWOA      VRVUBYYWJT      DBARUBLAAIC    
ONWB            : TWUDUGGOXAQSJLT KHEHOLCPK       NGAODUMTVEPFQI  OHGAEUNYDPEDORU
HELD            : GPJWNRBNN       BNTARPPEYM      VLNKCSAP       
VXYQG           : POSVSOJ        
WCQEVAY         : JUGDEQPJ        YKKLPALHVJRE    IBXB            KQSRYPDSTRCG   
GPNUIJ          : FRLLCVIXNTBGJ   MCUIUMRJAIKK    HDMTO          
AYSBSAFHDVDD    : MWMHHJXAHKLN    SGUSFJUJNUF     MBVKBIBFHJYAU   NTJMYIOPPNRPRVY ROCMGLTHTUHPI  
VJUUOLAMO       : QOXVEEKLR       PTOHYIS         DLPNRUCBB       WLMFBVFNPOSL    JBLYJQJYVF      KVVRXVAFUETNCJ 
XWOLRAWP        : SRDQALF         CTAAEGWNLDCIQ   VWBBXCGNXANBB   XKUC           
WJBRLIBPHGUEDF  : HCMGGOHIWXM     IUYO            JUGDEQPJ        KWFTIPU         AFTG            HYCO           
XVNAICAGYQUSQRJ : QFDNGOHNBH     
QUVLGHMXOTTS    : AYCBJXR         QYDURKBXWIA     CYMIK          
BSYWIA          : OLLGSRRUS       BNXHLOKJJ       IMKUNGHQQJVAS   HYDYBQH        
MAOLSJGMBR      : OOCIHPHXQXSYR   AYCBJXR         LMQLMUYLMIQJV   FNAQN           RYTWBV         
UMCGVJSTAOP     : RTXJVGH         VRVUBYYWJT      LVFWMIDBJ       PQNPPVPXKRMXK   QAYUH           MIJMLV         
PQNPPVPXKRMXK   : LPUIIBIFOANWIX  UMCGVJSTAOP    
FWYYFTOJ        : HTDUI           NOBI            XIWGHYXXISKAGVN LALIFG          BNEOVEV        
KUVGUMWPDP      : MWMHHJXAHKLN    KXNRQPWGYUNLPJ  HYCO           
SIEK            : JFYYH           UQJCUKA         CCFVJHDQFFYRTH 
PCSNOOUOPUTK    : VAWCPA         
FMVAKEW         : LGXSYEOTKAOVNM 
DMDVSXEX        : KSLEFMVBAIDC    JVERFOP         CPABFYXIWEXVD  
KPMFDDVYR       : CXGFNVYWB       CGOTDPIUHIMLJYJ
TNVFSLDSVHR     : CXGLXWUUMNUIO   NNRFEYSSXRGEI   CTHAXRXJEFMDLB 
LFBH            : QXPDNU          GJCSCYHOB      
BNALA           : MWMHHJXAHKLN    XNUHBGRTQYEJKOK RNOKFSWLSHODT   IYAONHUMRNLLV   OBGQIHLI       
AFTG            : TFFUNEIORDBR    IVENUMH         FADGK           WJBRLIBPHGUEDF 
SXOOOLVHYYDWIU  : YJAW            FADGK           QAYUH          
TCYDFBQFOQX     : DOAHNKMUVKTY    UYNRMUNMOHPCK   VMNYPITYXSRGU   FBDISUC        
XRXBMXQDME      : GEWTLG         
WDAAAIWVFCX     : EOIKY           YGQQLNNRVQ      FNVUB          
HYCO            : HCMGGOHIWXM     YJAW            LHHSTMY         KMAMUJLJGMHE    WJBRLIBPHGUEDF  KUVGUMWPDP     
UMJVGJWUINX     : KNXN            NUQLV           AUMAAJVEKRJ     SHMSSMRRVVSRQE 
RYTWBV          : WMEGFOLIQ       BVFMUIPFL       MAOLSJGMBR     
KVVRXVAFUETNCJ  : DUYLSVUJRGBEW   VJUUOLAMO       PBQP           
XPJUN           : IIPHWHRARR      YJOGBRSOCQS     AAVL            PRMJRVO         JFVEUBQGONQ     LVFWMIDBJ      
LNQFNLDQJD      : VWWUY           FRLLCVIXNTBGJ   IUIXFTRFTJ     
FBUD            : OLLGSRRUS       WLMFBVFNPOSL   
XKUC            : XPVY            DAGMB           IBXB            FTXQNDW         XWOLRAWP       
IGQIEIR         : LMKUNLUXJJFBXL  GHQGITPCIQST    XPJEGCQYD      
VLNKCSAP        : KEAKFLFSDSRUP   UNMBRMUFUTFK    HELD            RLBPXVU        
QAYUH           : WEOWOL          XAEMYSVGC       NHTOKRGLYCAECAA SASSK           LSQRFTOPQBJ     UMCGVJSTAOP     SXOOOLVHYYDWIU 
RLBPXVU         : DQNIWGSM        CCYXNLXGORTXH   VLNKCSAP       
HBXRGHLIFY      : JCQVMYEBWSPWCCA JYFDRW          PEAL            KYDSCICY        IXQMDFO         YSLMXMRJEIVMQ  
PBQP            : ESBFVJIAOVN     WATJBVWVGK      KVVRXVAFUETNCJ  EAWKERJUO      
NJVOGD          : KYDSCICY        CFXCIQVRPJ      WTEMHP         
XQUOPTJWB       : TSNVNBQUG       JXYGLX          WWUGSISELE     
XUSHGD          : OHVMCTTRQFU     FCCHETYF        HYDYBQH         DRIYTBYNUL      LMQLMUYLMIQJV  
FBDISUC         : TWUDUGGOXAQSJLT UCCUJSUERPOHL   XUSPSKIQNKL     UYYBLW          ERIXJG          TCYDFBQFOQX    
EAWKERJUO       : YKUNRKWOWKXI    GPWWCLCHKWQAFT  GAASWBPXOWLAB   NDHBCLMYMW      JWOVKLBHT       NNRFEYSSXRGEI   MIQRMPYEUOMINT  QHFMVGBS       
EAWKERJUO       : TMKFGL          PBQP           
MIJMLV          : SAOEWIW         XBPQJYL         UMCGVJSTAOP    
