MEUJRUWJQFQ     : TMBRPEAFUIMJT   QBHNKMC        
XVEKYYMR        : WCRQGHJSYXGX    FQNPTTJP        EDHPDNIPXVICL   TBWFSCSRMWT     BYRAA          
OIXRN           : LQUTT           VFILG           PPGFR           FXRRGAWCFOHRH   QAUURN          PPPQWCBSET     
XKLFWRB         : GKCCGEWCMDHN    RXRWHPVH        BQUNPNSD       
JXIURNLTNH      : GOMMKOAFHYEGEP  RMKVOY          GKERRS          HKSGGFDBL       EQRUGFASMSPYOAS
BIANBCDLAUYJ    : BWXCBSOTRUPQ    DSSCJKDS        YJBVURFDUXW    
LUAKMDTYCE      : FXJQRDVSE       DBRA            VVQFWCRAQOPKXR 
TRGPH           : YIHJGNJSYOTSV   BILLGDY        
QIYRWC          : PFLMCOQ         PFWUBAVHARX     BGHKPLBKCXV     VELOJBURXSFYH   VRLWVANEFVESNA  MNNKXOM         TULQGDQK       
CNVYOHTD        : BJEPLLXJIQO     AAEVJK          EARTSKFDG       KSWNS           UBYQGV         
VNQC            : IVKCPPHMLWJYPSU CNISWDPD        QODYOBELXPUUS   HLLHTISKVYGC   
RENMAHUPRKJ     : YDLXVSUVTALKQX  PCWJYHCSF       MXAEXAWCYCUWMSU VYFRUSUV       
LBYNWDDU        : CHLR            UFHTQYKOTN      TPFP            NGPJGFVFU       FTYCMQIFF       GXBQUELH       
UEVAIUNBW       : NPXIDPWLNN      HVIMXPSHCKIRDD  VOFI            GYOWKMMHUYBO   
TDPGDADURP      : QLWM            JTFUX           YFWIYCTMBDRIBHR DCPUNQFJAVA    
TCHVRGBXBEUFCUP : GVKUB           HLLHTISKVYGC   
KRTMLWDTCFYA    : FACQU           LXTAIEKRXQOXLE  YDLXVSUVTALKQX  VVUFWQYHG       IEKATYTTHPR    
OGSS            : SLAVMVJ         NFVJKYUX        XIWT            YLBNJGOPHOSQLCA
QLUSL           : DHOPUWQVPSJV    BPCNDU          XALJQJD         IBQOLPFMYICA    TUHNYPSF        KRGIYG         
YGGBBWB         : ORITS           KNPQT           AOYVAMCKIKXN    PGJBYNRL        TKFYMPWWSY      QMXIAQLLC       BSVILFUFQSH     IXJCCCVORF     
QUBEUEAYJYY     : RGSVGXIVB       VFJFTYDMUWDSW  
NGDHWWUTRGUQOE  : NOWPDPMWQ       EYIE            TPDVXGUFEMMABC  XTLUKE          YEOSMOECUUUORKO VVQFWCRAQOPKXR 
RDUFTQGXNMX     : OLUUQEWMPLWNHSF PHMMJ           MVBFX           PGEKKRBGBVHGVYQ
XYOIMWOVTLS     : YCIWRDVVRLEBM   YFWIYCTMBDRIBHR EUKCGT          HLCGRGOBEAE    
FBLVPPPJSNPOG   : HTFRWADSPWFTN   JAPYWS          QBONVAMKWJXFMM  XIWUDQADCA      WBRXMDJSGLJJY  
OTLOILNYUCVJBR  : YXQQGLFAG       TSYSTBITECGG    BTQP            HRICMEDDCAVEALB AVSFXWSGMO     
TIAVVX          : XPQEQF          AKBLUSRMUHIW    ISWJ            CFVALRFRETTFVLR GBGTDTNDITTCV   GOTBJRVOQ       UFRWPPEL       
NPXIDPWLNN      : UEVAIUNBW       DIFGPSBYPEYNJIC IVDQYBNFEQRY   
BCQN            : GYBMNTAUAYJSBB  SJXRWJJJMWY     TIRAPJQIUMBSBSI
PITORUG         : MJNHWOJQ        KGVNFKMEUPBLLV  SLAVMVJ         EIJTKSOCB       IAGLPDWH       
PQQNMQDCIDKOS   : JSAIRFIBES      JJITNV          JBHYNBWB        ERYCKAEYMM     
AHWIK           : OLUUQEWMPLWNHSF PYUSBHIEVBXKTPH WCRQGHJSYXGX    YNDISYTK        SEQIWFVQEJPYQ   JDNLXMFSS       HGFHPHV        
YXQQGLFAG       : OTLOILNYUCVJBR  HJWYCDGLWH      BSSNR           TBWFSCSRMWT    
QXDJLSARUJUIA   : SNAA            KUWPTPQBVOFIT   VQISICLHCSMQ    IYRLMVBBNIBWU   GKERRS         
RAXRIISHHKYPXES : DIFGPSBYPEYNJIC THSUXM          BYPS            BKMDLTW         AQLXUJBMRY      FTUQUCTINWMCFE 
SJFWVQRVK       : REDGITYWB       GIGN            EARTSKFDG       IEBBPGJHACXXK  
HGWHURKULSFEBM  : JDUTUHSUXMTJCWK LKGYUFRGS      
CFOIATCLBBHTUGF : ELXKIIRRWIFEII  YETF            TBWFSCSRMWT     RQNRJUGVHG      KTAJATGSQDFBGJ 
NLJXIDIDO       : DDATMSUE        AJJXMYCJOIQK    GYMTVDEGGY      QXMYDLPJK      
IUEXMI          : BJEPLLXJIQO     SGSVIA          TNYKIAYYQCKOG   HQDLN           TDBNLBFFJUP     ADLVEBHLISPHBSN IUNOWFYSK       VSYHLAEWPEJ    
BTFWXQXYYSVFXF  : NQFXHLD         YJNGPVKBJL      GQLTDAEMINVXC  
LQUTT           : OIXRN           TXIXMUYOSVXAFER FTCLUQYXVEJSV   GVFNHTFBKXXUB   XFDQV           CBAQOJKX       
YIHJGNJSYOTSV   : TRGPH           ANQXEVIQDDIGRU  JGPYJBFPF       NPVIMW         
SNRROKNVKUSV    : TMIHVWIGUOV     MIEWEJEWSI      CCDAHCMOA       RWMCVWT        
ORITS           : YGGBBWB         BKVHNJFPHRJBYQD JJITNV          MIWC           
DDATMSUE        : NLJXIDIDO       KTXKXYEOASPQMRK OYNJSPMLB       NTEYDAYNLTMJBX  LXXJXSYF        CIBPTGMDKVXXN   LEFFAYVVAW      HGFHPHV        
DDATMSUE        : PFVGCX         
PAGIPBAGN       : QBWKP          
CYMXWBMRK       : LQWMJV          QULSFOFQRW      KXICNOJH        PWCTUJIXUKSMIV 
KEMNEIDYDHNS    : EHEJNUIT        LMOFIYLTJAU     DAYECYINK       VCMKTEPOMDDTOX  TBWFSCSRMWT     NPVIMW         
UBAXDGLULMHJM   : HBPCMOHYE       MQHCQ           LSWYAOAC        ASCYOWPHSPTT    LFFNDYJFBKQBC   PPPQWCBSET     
XEVGOAUF        : XMTLDOFOG       OOYTHOU         TULQGDQK       
DIFGPSBYPEYNJIC : NPXIDPWLNN      RAXRIISHHKYPXES FXJQRDVSE       JDERILC         PRJFG          
VOOF            : IIYLQSDNQTGSB  
ADFXJWXFC       : HTFRWADSPWFTN   PLWOR           RQNRJUGVHG     
KMNTEGUDYCFOLP  : GNSKRYIFYCHXW   WOJNRF         
QLIHQJHVR       : RLQNYIKY        WIJDINLVYGCM    WJOKCIN         EWQUL          
HQFOUNAHBT      : DAKU            ROGYLJDNB       MFQWIKTFGAEA   
JQQKSVAFLS      : MJSVORHBW       ABIUFHKC        TNUASROVA       EYRNQW          DRNAGPCTOFMCF  
WBFP            : WMOHXXEKUMIPJ   WKDBHPB        
ONFV            : VQISICLHCSMQ    XEFLODRRHYUPOJH
VDKSQMATI       : MQIIH           DHENYNKHVNCD    CNCWH           QUUS            GQLTDAEMINVXC  
FACQU           : KRTMLWDTCFYA    GQNSCDBYRMS     LEFFAYVVAW      TBWFSCSRMWT    
SCOLCONHGB      : SATIIGS         TRKHWDIF        MFKNHWFCNSMYKMT LHXNKJVVOO      KUDOJX          UMYH           
UIVQGYDYRQBNY   : MPGJA           NFVJKYUX        VESAWQLIHHE     YJBVURFDUXW    
TBSKWTDBLQEA    : HAEWLGCLUCXKT   GWRPKCWCLPNM    FUYKFTOD        DLUWOK          MLRNMRXIV       IFSOKNKGLDWQ   
NGHOB           : XUUCKPBPEUO     WUTCHOUPPYKDYP  UQGUCHONLGGY   
KTXKXYEOASPQMRK : DDATMSUE        OYNJSPMLB       NPYUHLVWACL     CNCWH           PFYFPHKTLXAQ   
QEETRU          : PIXVWLHNCDQ     FJLTAWFBN       FJEVHA         
RCOB            : RVKXFLBRYUSWX   TBWFSCSRMWT     ISHLUQSSRD     
DCGNYGAWGH      : WKTHUUUBDSS     TRPDGUPCSDI     XUTTLTFMJJNEALU
IAFAO           : CYBFBN          BIFTGKXLDL      VCEVFAHY        CGPKOYAVUGDUJV 
KNPQT           : YGGBBWB         NOWPDPMWQ       UGGBSHCCWUI     LFFNDYJFBKQBC   TECBLNDFLUPKAUN
JOKDS           : JQOUAMJAQUQCMBQ GVKUB           YORUYCQ         PPLNNLFME      
EHEJNUIT        : KEMNEIDYDHNS    MMVPUWD         TTCST           ANIEGWXSTFPC    GQLECKMCINT    
HAEWLGCLUCXKT   : TBSKWTDBLQEA    BYRAA           JELEBBXRXODWD  
EGAVTGQ         : CBIMCHMPTNFPK   AJWIOQYDNSW     TGDGFMJQNKHV    FCCRDSNTYPL     JELEBBXRXODWD   EWQUL          
KXCTLWEGTL      : ANIEGWXSTFPC    SXFBXQAYSYSAAQV TWRTTWSYTPL    
BKVHNJFPHRJBYQD : ORITS           SROWISLDTSWH    PXGTWXNDDVLYUI  ODLEHHC        
MJNHWOJQ        : PITORUG         DDPLGPCKFCV     KQEJWWHEAHUAIQ  AYPEXDOJ       
IXIDL           : ABYGRMCRPGYMTJB KNXXXSTNW       NJYNJYOBD      
GWRPKCWCLPNM    : TBSKWTDBLQEA    HGTBWG          WKDBHPB         GNSKRYIFYCHXW   TBSUTY          XAEB           
GQNSCDBYRMS     : FACQU           YYVQ            ROJTVNVEKDST    PEDRXGYMBVU     NWGMR           NHACNXHCNM     
VQFBEBHDTYNVWR  : SREMPXF         YDBR            ARPOUCSLY      
OGWF            : VJDHBAVM        KMKGM           CPHL           
PUIRXLTSXMN     : LSNA            HPSEVALXFYU     LFGJCT         
FSUJUENQEDM     : JYGDMHRV        JTCNKAPXMCKIX   IYAYNXACIW      CWDQRJ          QFCPGMXWOV      VKMIIWNDNB      PWCTUJIXUKSMIV 
XVRGUYUKTD      : RQPKSNSRVWAMNQ  OTCIXPPYUQGEVSI GXJRSMLRL       RGOKTMQRXI      GKEAJGLKT      
TOYMNLC         : IWMJGTGQ        YOJBDGUXJ       JTCNKAPXMCKIX   VMCKPHSYMFYR    MAIRQTJMGHL    
SXFCUJRLN       : EVFGSKMFIHCWEID MFKNHWFCNSMYKMT KEOTUEECA       DSSCJKDS       
XQVVK           : XOHM            UVXJJ          
RJYEFDJATIOJVTT : EVFGSKMFIHCWEID RBAEBXSWH       JDUTUHSUXMTJCWK IEKYKHSMFJURCU 
RYTMKNABLARJVFL : XKWRYDXBRKRO    HJWYCDGLWH      TXQPDAVXBALBSJ  POEHRKJFFQMXI  
OLUUQEWMPLWNHSF : RDUFTQGXNMX     AHWIK           KOTLCSWRJ       LMYTKUUFGKEJD  
TYNEO           : FJQCUXOHY       LKMVGNQSKKIPRII XODNGEVARO      DVETK           FNHTLVYEEIKJ    MNLPRQXACM     
HBPCMOHYE       : UBAXDGLULMHJM   AEMCJABXJC      GDETKCOOHDGO   
MBQF            : KEOQP           REAXAYUADH      DNKQENJBBRIYRS  QLETBR          CYTEYX         
PRAEQNLLSLFT    : NGTTCVOIKPX     NOODYLPAKTHWPOD
MLRTO           : KXTNOBEBPU      VMXULFUTVFXFAAI XOUMXO         
VBXDAFCOGSV     : ITCLRWBIYFRQ    SNKAVMQFNMATYP  RGLWBWJIKUCQW   UCPCIQIKN       AAEVJK          FCCRDSNTYPL    
LQQPJ           : DOGUE           CIDTX           MXAEXAWCYCUWMSU
BVAO            : FKRSABADFIJQU   HWHRTNOPYK     
WQPIKKYT        : DIKNIUTUWIYMWV  VBMHVQUIQKGEO   KOYKTEOUPV     
AUMDAORI        : QMROLYNX        REAXAYUADH      IVLRA           YJBVURFDUXW    
QAUHQKQXMOB     : UCBMXMCQHJG     GOTBJRVOQ       OSBMB          
SATIIGS         : SCOLCONHGB      MJLQBMTQTAKM    KJBHPEWWK       VOLWOSYVFPUBMOD DSSCJKDS       
BCJVQMXHHG      : ELNENGM         CCXXAON         UNBQOTQI        KWDNDUJISFA    
XGOH            : MTBFC           WCYL            UKARMYCW        TBWFSCSRMWT     ALSUHMHRIYSFEWJ
BAXPPBTIB       : JYFJRYYICXXJGT  WYCW            NDOUCKA         PPRKTDMJF      
QLWM            : TDPGDADURP      HHHKINU         GJQLWXOSYLND    SXQCKU          AILERMPNXBETDOS CGPKOYAVUGDUJV  VCKCDLSLWCNYCM 
XQFVJRVQY       : CUGB            YDLXVSUVTALKQX  HJLN            CWDQRJ          SRFYWYWEXLHTGOJ
JWLAG           : SKTBFVS         HMFAKQLMV       VJAW            QRTUJPANERNR   
CHLR            : LBYNWDDU        FFGB            XIOUCIYJJSIE    OOYTHOU         QMEARBC        
NLHOCABYOVYHB   : MVKPAV          KHNOAKGY        UXEMBUAA        ENPIWRRAJARJ    JVXYFKGHWX      NSAB            PBSRAJYFSQPHQSD UBYQGV         
QVSJUUTUITDTX   : DIKNIUTUWIYMWV  REIRPU          TPUIVRWFBAPIYKF TFIG           
IQJVC           : IQRRYKVTONJYES  KOYKTEOUPV      MEVVJ           RWMCVWT        
KGVNFKMEUPBLLV  : PITORUG         CCXXAON         REUJTQ          HTSKJK         
JRRGANJWM       : TMNGLAXB        ROLKNRVK       
FFGB            : CHLR            MLYDK           FCCRDSNTYPL    
ANQXEVIQDDIGRU  : YIHJGNJSYOTSV   RGLWBWJIKUCQW   EUHGAFUIOMETEFW AICOCHEYQ      
PEWJMYYVVNSDSAG : NWFOR           DRXGRQDEUS      ALQMXYSCVW      VRTAYBJAPKRGUEV GPXBIUHUYYB     XYIIL           VFJVLPDECLWVEWO DAWGRHJX       
CUTABRKTUQCE    : EYIE            PETI            XJRLJHPLH      
WHCDGLRFMOCBHFV : ALSUHMHRIYSFEWJ XHOCTPMD       
OYNJSPMLB       : DDATMSUE        KTXKXYEOASPQMRK MJKMHC          KLOPDU          DGJY            REUJTQ         
ITIMEIVGNCTG    : OQJUMCFXPBS     WBKBNI          HKSGGFDBL      
IWMJGTGQ        : TOYMNLC         UFHTQYKOTN      CJCCDAFYLGXU   
HGTBWG          : GWRPKCWCLPNM    UAPMQ           KRGIYG         
AOYVAMCKIKXN    : YGGBBWB         VJAW            XPKQLTT        
GVOFKYM         : QJWSPOOLWUMCTW  QODYOBELXPUUS   TFAKPG          GYOWKMMHUYBO   
HFPOLJRKSIMHII  : TYWOCPVTWGUS    VPNHQRR         TTKASCVFMBJA    HXMEBO         
WKTHUUUBDSS     : DCGNYGAWGH      YPUQREKQQBGP    QNQHPVXJIQ      QOEO            TNYKIAYYQCKOG   CNISWDPD        WJOKCIN        
DRVKBBAROJMA    : PGJBYNRL        AVQBBJUB        KNXXXSTNW       IEDUNDQSWY     
WMOHXXEKUMIPJ   : WBFP            SIWHFVOVLPRSEN  LMWPV          
SDEEIVASYDSTSF  : RNVF            XSOGNKVHRCKOEYN
ULFJAN          : MXBJKKCSSM      XPQEQF          QRTUJPANERNR    XAEB           
YRSTGBLS        : OGJULAOV        RBQKSHYFGVRJPQ  AMBFATP        
GVRLGPNARRULMCT : UKARMYCW       
OYQOMBPHTLPWY   : HPSEVALXFYU     GNITTUE        
LGGDTNVHNNB     : PYFSEBFGPT      XVBHIYI         BSVILFUFQSH    
YPNUWETQU       : SXEBUPSAFEE     EFFFMJYOGQYOXXG
RLQNYIKY        : QLIHQJHVR       ACHYMCMSDNQ     UXEMBUAA        TMAR            DQNDQSJACOV     KNQWMAJLC      
VFXCBLXI        : JDUTUHSUXMTJCWK CJNFKS          AYPEXDOJ       
NMOOCCJCIFUD    : YBDVG           EXLMCRQW        FUBHEAA         UDUJAGFHQKGRT  
MQHCQ           : UBAXDGLULMHJM   XKKCPFW        
OPKMWIOXWO      : AVYFYOSHGWRN    HVESEQD        
ACUOSASCCBKWFB  : NQEHBNSDLV      EPNGAPUCWCDPWNM TFIG            FYOAQTRYKYRE   
XLNOEEGOQFYGF   : NCDMPCKKWA      JSDTWVU         QWBNVBUC        GDFXPJEHJHUSJYL RNJPGCGFRJX     CXHIMVYRUKH     AVSFXWSGMO     
WOBCLPULLXP     : UEHEBDN        
KOTLCSWRJ       : OLUUQEWMPLWNHSF WEOELTBHRNSRWIL CGVRJMVMNG      CJLCN           ODRUGEV         WXFBGAC         KMTVIKTDEM     
VSRNXTVERSSU    : LQKJM           QFSVAUPWQNEHIRV OWPXXUL         QAYKD           BWPRNGGRFTKOGTB
GLSUWSKLDCIO    : JSOATRXRKUML    OWPXXUL         CYTEYX          GQLTDAEMINVXC  
DOWMRSFKIG      : PYQTAFEGAQR     NHWLSCQO       
EKAAFVWLHP      : KQEJWWHEAHUAIQ  QXDVNV         
GKTTNVCFCFTYSL  : JVRKMUXEMYFVN   FKSRFACSLWD     OJXBNXVPCUIC   
AXDGEKS         : MYCXWI          GNDOEQMOOXUNIY 
MXBJKKCSSM      : ULFJAN          YTMMSLRWTEIS    JQQLTKBSN       NSQKHVH         PEDRXGYMBVU    
MDKPIP          : KHNOAKGY        RBQKSHYFGVRJPQ  UGEALEHPS      
COPPLSOPBU      : QMUUELRLFEYOSYO PRJFG          
UAOSDX          : XAKLAR          TNUASROVA       PEDRXGYMBVU     TEOAKT         
PCYI            : HVIMXPSHCKIRDD  KEOTUEECA       TKSVECINHVCMOX  QSFVNIG        
NXUB            : DDPLGPCKFCV     BJSTJBWGG       XUMLNFON        FKSRFACSLWD     BBMXS          
DQKFHDWTVL      : XYUNJ           OEHPBPNWMG      IXEQEIDEQXKJ    HHALFKVIMCETK  
YHNTJCNP        : CLXBIFFQSAA     POSJUPUMRPC    
UFHTQYKOTN      : LBYNWDDU        IWMJGTGQ        LSWYAOAC       
WEOELTBHRNSRWIL : KOTLCSWRJ       FUYWVN          HHALFKVIMCETK   QMEARBC        
KBXPWEWSWVFN    : PIXVWLHNCDQ     UCPCIQIKN       PLEGVRASQJP     KMBPOMEWNTAKG   QRGLQOVPV      
SROWISLDTSWH    : BKVHNJFPHRJBYQD XJGYNHJTDJ      JENS            HQDLN           MIEWEJEWSI      CSHTNS         
OGWDPKENCD      : KGJHQE          MJSVORHBW       XNFPTAWPTC      IAHNDF          JELEBBXRXODWD  
YYQWEEOXXDWHV   : AJWIOQYDNSW    
MPGJA           : UIVQGYDYRQBNY  
BGTEVEKKIQE     : JFEYJL          DAYECYINK       MWJTTDYANYQCKYI SMLSH           LCEMTMFGKN     
PXGVEU          : LMOFIYLTJAU     XWRPCFGX        NCEEO           OAFKMS         
DXTM            : JYGDMHRV        DQNDQSJACOV     CAORKGBOHE      XHCEMEUEQC      MNKGTW          RHPHM           AMWC           
GBMMMMJNSETRK   : DFAKKYOD        PLTMYYBGN       RGSVGXIVB       TGDGFMJQNKHV    NGTTCVOIKPX    
CTVID           : QGRDECMH        MJMSFXTYTTIPS   REUJTQ         
GKJLFGQ         : UXEMBUAA        KYWRRQV         LJRPBGIOHLUDPM 
CDCIEOVSDFHYJB  : YPUQREKQQBGP    OKTEMBE         REVLPO          MGINT           NOODYLPAKTHWPOD
WIUQGDTTMGEAOK  : PJXOSFIGGUN     ANTQHYCP        UXJJQNRLDEGU   
UMVWW           : QEHXLGDRYQHGBOJ PXGTWXNDDVLYUI  KNUFUSPSFO      XVYQOQVWMQ     
OSURYC          : MFKXI           ENPIWRRAJARJ    UGVJPNYTAQRBF  
KGJHQE          : OGWDPKENCD      KEOQP           FURTBHBRY       YTMMSLRWTEIS    UGGBSHCCWUI     WSPKBIOWQR      VESAWQLIHHE     PPPQWCBSET     
XKWRYDXBRKRO    : RYTMKNABLARJVFL XNFPTAWPTC      NPVIMW          PFVGCX          UHAE           
NOWPDPMWQ       : NGDHWWUTRGUQOE  KNPQT          
QCXALQHOOT      : UPIRBY          CSCTAGG         ONCGHWW         LJRPBGIOHLUDPM  FXJQRDVSE      
HUQH            : PHSIL           CIBPTGMDKVXXN   FAKFMSCUH       KDLEFSTCCFB    
LSNA            : PUIRXLTSXMN     GRIMOAXBXK      JUER            XRNMYNCKAUFOPYM UUEOJKAITFYH    PETI           
DOOUTFHR        : WBVNOKM         FGVWSFTVPCDDOTK WYFAG           DGJY            POEHRKJFFQMXI  
YIAYKOQRDHNQ    : LQWMJV          YIBLUAUFGL      QCVQSQXNBSVCFW  ELUW           
IHYGSRV         : VOBOVLSSINRFS   WYCW            FYOAQTRYKYRE   
JYKYVHGE        : FUYKFTOD        NQAS           
EFHFHRTXMYFCP   : DGJY            NQFXHLD         CVPVYJ         
LYVRUN          : MAKDK           DTKRQFNFIXEEQIJ JELEBBXRXODWD  
QYPD            : CPRM            GEOAIQHLMCSOI  
MKGSJ           : SIIFUWL         TXIXMUYOSVXAFER WHUXBAXL        DBRA           
ASQHNMFA        : OTCIXPPYUQGEVSI RBAEBXSWH       CMISCEGG        LPITWMFHBAXLRBL ONSTQ           HFADVKX        
NCDMPCKKWA      : XLNOEEGOQFYGF   MDASUKDPGAQDIH  PYFSEBFGPT      VYJYKYVQAIYPCA 
PYQTAFEGAQR     : DOWMRSFKIG      PHSIL           XOHM            WTGGBVFAYKJA    FCCRDSNTYPL     UDUJAGFHQKGRT  
LKIYYQBMGGRS    : WFAXPASRCNCA    WEAO            QFCPGMXWOV      OAKJHKAGRN      MOCLQAUSJI     
WDITFJKEDGEKMN  : GAHC           
DHOPUWQVPSJV    : QLUSL          
DQYAVIUBTHIYPM  : GKUQ            SRFYWYWEXLHTGOJ QXMYDLPJK      
CCXIKMAHJ       : BFIFMCMRLINLRLX OXBJOJOBTGSGCFX AICOCHEYQ      
DCLMAMSTMSRWP   : KHNOAKGY        FTUQUCTINWMCFE  JVKAMQJQEDVR    WOKCXFYNLXCCYQD WHUXBAXL       
QWEQOSDR        : CJCCDAFYLGXU    KOYKTEOUPV      ESXIAOAYYIAJV   AFEJD           WOJNRF          NINKSD         
BCIN            : WHUXBAXL       
PYUSBHIEVBXKTPH : AHWIK           VGLHFYAJ        HFADVKX         NHWLSCQO       
LBJPTYJWSFAU    : PPGFR           MAKDK           AJBEETAWPH      IFROBCOYNDFKYO  GKERRS         
NWFOR           : PEWJMYYVVNSDSAG HBUUMQYEHPOBWBF HUWAFONTDSAF    VTFGHHRVKWBOXP  IVLRA           SWWHWF         
QBGWAJUKEMS     : WISLE           NYMGDB          YPJSHMY         COPJSNNTG       WSPKBIOWQR      RVROOKAOEYXO    MLRNMRXIV       AYYKNRNANGUNQJP
QBGWAJUKEMS     : UFRWPPEL        TBKXDHGWQPVBJPU
YVAOP           : WKFKY           RVKXFLBRYUSWX   KPIN           
AOTFQOUELAS     : ISXMQTAF        MKANVUASNGB     RXRWHPVH        LXOUAMAMIBGII  
BLJJ            : XYUNJ           LAGLDJUYXBQY    OXGOPFTBYY     
JTFUX           : TDPGDADURP      MLYDK           MBMCNOVPEQVPUKH CQMYOJNY        GKERRS          PGEKKRBGBVHGVYQ
POTNQKDSLTM     : QRKYSTILEOWY    CNFX            MENBK           MIVTJSSDWSRTISY AAJYSSGUDFQWPCB
KEOQP           : MBQF            KGJHQE          EMBVJNFKMM     
LXTAIEKRXQOXLE  : KRTMLWDTCFYA    MYCXWI          DWPOIPK         OUPPLVCV        VQYN            BDHXAC          IFROBCOYNDFKYO 
HTFRWADSPWFTN   : FBLVPPPJSNPOG   ADFXJWXFC       SDYROGKXKFQGHIF DIVDS           USUMYOYPWUQUN   TBKXDHGWQPVBJPU
LEKKBKU         : OQJUMCFXPBS     MBMCNOVPEQVPUKH RNJPGCGFRJX    
UMDNE           : GNVHTDCBFEJAL   ULKGL          
BKPIFWBEXGXP    : ISXMQTAF        EJEMQDLXYCLGSK 
FJQCUXOHY       : TYNEO           LXXJXSYF        OGTUAYHA        YYQRHSHFGKBDNST IKVIQHIDSQEPC  
CGVRJMVMNG      : KOTLCSWRJ       YSYUDE          RQHNVYIFINJUJBX IPAGTDP        
YNBCSB          : DWPOIPK         MIQVCW          XTEOFM          AQJFUHVMM      
SQOXCFCXFQ      : QSFVNIG        
GRIMOAXBXK      : LSNA            UCBMXMCQHJG     EWFJBHSPQDO    
GOPUSRNVDGPRG   : ADLVEBHLISPHBSN JVRKMUXEMYFVN   EPWS           
YJPHCXPUI       : BTQP            PFYFPHKTLXAQ    GTMQBEWHBSNVPL 
JKDMIQDOF       : XODNGEVARO      IUNOWFYSK      
JAPYWS          : FBLVPPPJSNPOG   CWFRNL          YBDVG           FUQPEP          XJMXEBEYWCHUH   EHBLTJJPSCKYB   IAHNDF         
MMOEMAWTCWJWFO  : PHSIL           QNQHPVXJIQ      YSEJQIQE       
PSUXJBOQWYTO    : RGSVGXIVB       CNISWDPD        ODLEHHC         ODRUGEV         SPFQOPHITUW     XOUMXO         
SIIFUWL         : MKGSJ           JSVHPCBFL       GOTBJRVOQ       XTLUKE          KMTVIKTDEM     
WKDBHPB         : WBFP            GWRPKCWCLPNM    FBNEWNJMRUMSTXX VHSOIFMJRPMVK   CCDAHCMOA       MFYKJ           GFNOPDDQMPTOQ   SFEHVKLIENIF   
GJGBHEKK        : KHNOAKGY        ADKJM           ORDKLUGMVJP    
EJUXXUQIFXECLPB : BFIFMCMRLINLRLX GOMMKOAFHYEGEP  VUQBA          
VFILG           : OIXRN           PGEKKRBGBVHGVYQ
RRETYLGJHMU     : WEAO            HQDLN           NRGNKDWA        CBAQOJKX       
MTBFC           : XGOH            XLJEWTFYNGG     VWJNSYSLLAVMNM  VJAW           
DILRYNQUSYIBYC  : QEHXLGDRYQHGBOJ GJQSWJHQIBUQVYQ XTTFUOHKGMUU    GNSKRYIFYCHXW   DCPUNQFJAVA     IIYLQSDNQTGSB  
GXSRFEBTA       : VBNHXQXKKC      CDBCYDDB        SUBILRUHA      
HVIMXPSHCKIRDD  : UEVAIUNBW       PCYI            ANIEGWXSTFPC   
ELNENGM         : BCJVQMXHHG      EJEMQDLXYCLGSK  LWPTHCQPBNKQTHC KXICNOJH       
BEVIFPK         : TFGKXQMKFG      MAORREUUPETEI  
WGUMGNHN        : TMAR            XIHCYPUWR       BJSTJBWGG       VXUVGNYUD      
RXJWBVDOJHF     : DPYRKERRSHL     PCWJYHCSF       BLWXCMEPDL      GMQKIYKSXB      KMTVIKTDEM      HKSGGFDBL       IXJCCCVORF     
TTTAPEHFO       : QBWKP           FWOHG           XQBFUQPDN       AICOCHEYQ      
FURTBHBRY       : KGJHQE          XXQLGFT        
PIRTGUIRFPJ     : IVKCPPHMLWJYPSU QGRDECMH        JKMDWTUOOF      AQQOWBMHJEQSO   NGPJGFVFU       RBGAVFUWJ      
JFEYJL          : BGTEVEKKIQE     YHBGOQQTB       TNYKIAYYQCKOG   VELOJBURXSFYH   XVYQOQVWMQ     
XIOUCIYJJSIE    : CHLR            ELXKIIRRWIFEII  CSBUOJOF       
SXEBUPSAFEE     : YPNUWETQU       FTXX            WWCFHEGYCFQTT   LTEERVJCQHWIUJX VYFRUSUV        HNDLCHPDHJDWM   DRQLXFLGYS     
KKSVVAU         : FGVWSFTVPCDDOTK YYQRHSHFGKBDNST
QRKYSTILEOWY    : POTNQKDSLTM     PWJWAO          CJCCDAFYLGXU    TRPDGUPCSDI     BIMLEMKUAXYFDYG SPFQOPHITUW    
DAKU            : HQFOUNAHBT      NXLTPKAAPYLGAUY ICNWOXUSWSWASI 
MDASUKDPGAQDIH  : NCDMPCKKWA      XRMWMRNOWSP     FXRRGAWCFOHRH  
TJQPTDWJCVXHY   : JYGDMHRV        WYFAG           IAVRI           VOLWOSYVFPUBMOD
DRXGRQDEUS      : PEWJMYYVVNSDSAG VMXULFUTVFXFAAI UNDJ            SIFR            KREWIPHWCGE    
WLSHVQBHITB     : IKGF            NOODYLPAKTHWPOD HYIVVSKJCIKEWT 
QMROLYNX        : AUMDAORI        CIDTX           XBPY            FUYKFTOD        CJQMDVYUEOYOJB  ERYCKAEYMM     
IVKCPPHMLWJYPSU : VNQC            PIRTGUIRFPJ     MYBVXODXTQ      WXNKRRRMPBQJKN 
WCRQGHJSYXGX    : XVEKYYMR        AHWIK           RGOKTMQRXI      VJXW            FJEOABTC        CIBPTGMDKVXXN   CGUL           
FDWDPBSII       : TFSEQLUXCCHWNHM ONDTINJRHUNQB   MMRPQYBVVPVS   
THSUXM          : RAXRIISHHKYPXES REAXAYUADH     
HJWYCDGLWH      : YXQQGLFAG       RYTMKNABLARJVFL NGXUPNQQK      
DFAKKYOD        : GBMMMMJNSETRK   TSYSTBITECGG    ADKJM           CJQMDVYUEOYOJB 
JLLRHTKETWWBIUC : HDUQMH          PIML            ATNHFFTE        POEHRKJFFQMXI  
XKXWRKBYMLK     : IKGF            IOGHHOA         FCCPPGERBUO     GYOWKMMHUYBO   
CPRM            : QYPD            SXINSFXHM       BYPS            QBONVAMKWJXFMM  MFQWIKTFGAEA    QXDVNV         
DGMYQQUQOVBJ    : SJVSOX          OLFKJFUICJU     WSVQGWC        
MJKMHC          : OYNJSPMLB       TUAXJMGGGEA     EJVTMLTM       
KCMXODB         : SXGPKLAJODDC    KKFTVVN         QEHXLGDRYQHGBOJ UNBQOTQI        LRCDKVWHOSEN    LNOYWUMSYXU    
UPJAVXCOOWH     : HRMYKFLDUFU     SJVSOX          RRQOOV          EARTSKFDG      
VJQVXBHKKLMUP   : MDUS            MCQVHUXSXRQCO   KREWIPHWCGE    
SEEVMBLXBJV     : LSWYAOAC        ARPOUCSLY      
YNDISYTK        : AHWIK           ITCLRWBIYFRQ    RVKXFLBRYUSWX  
RNEFAQTUGUPNYMA : JQQLTKBSN       RVCKBTKTJ       PFVGCX         
ABDKW           : KBGQV           FEEQHFJ         UCIXYUSLDBS     UBYQGV         
LKMVGNQSKKIPRII : TYNEO           EYFJOVSLLWRJPS  UAOX            HELYYFGB       
DOGUE           : LQQPJ           QGRDECMH        CPMES          
HHHKINU         : QLWM            KGHLON          IVLRA          
WISLE           : QBGWAJUKEMS     LXOUAMAMIBGII  
BWTLICD         : PFLMCOQ         JSAIRFIBES      PGEKKDEGHCHD    YETF            QRGLQOVPV      
KLOPDU          : OYNJSPMLB       CUGB           
HDUQMH          : JLLRHTKETWWBIUC CGUHG           WOGNNJHDEG      JBEAHSHBRVFCMP 
ACHYMCMSDNQ     : RLQNYIKY        KUWPTPQBVOFIT   GKUQ            TEXDPCR         PCWJYHCSF      
CYBFBN          : IAFAO          
PDULPE          : RMOELQNMU       BTQP            ANDEIWQF        MNKGTW          FBMXIRGSOJJXPEW XOUMXO         
MVDTWGXEFMIUGNK : VPVFIROMOVSJ    GUSDTWXRBTM    
MMVPUWD         : EHEJNUIT        JVKAMQJQEDVR    WOKCXFYNLXCCYQD VMCKPHSYMFYR    DRQLXFLGYS     
PGJBYNRL        : YGGBBWB         DRVKBBAROJMA    MQIIH           VYFRUSUV       
WIJDINLVYGCM    : QLIHQJHVR       UUEOJKAITFYH    HKSGGFDBL       IIYLQSDNQTGSB   ODNYOO         
YCIWRDVVRLEBM   : XYOIMWOVTLS     BDUOJX          DPLUSUFKERFHHR  WUTCHOUPPYKDYP 
QGRDECMH        : CTVID           PIRTGUIRFPJ     DOGUE           INYRBGL        
CUGB            : XQFVJRVQY       KLOPDU          SFBBWRXQ        HEBFUQGG        FNHTLVYEEIKJ   
IQWJU           : YDLXVSUVTALKQX  OXGOPFTBYY     
GMKDK           : TRPDGUPCSDI     GOLHGFBHYL      FAKFMSCUH      
OPDEUTKOWQQJB   : OCGUJEQTND      VYJYKYVQAIYPCA 
MVKPAV          : NLHOCABYOVYHB   LIMVCMNMSWRUQA 
YHBGOQQTB       : JFEYJL          EJVTMLTM        IFSOKNKGLDWQ   
ISXMQTAF        : AOTFQOUELAS     BKPIFWBEXGXP    HHSEUCQNJOJL   
QYFR            : UIVPE           KFBU            UJKAEEB        
RQPKSNSRVWAMNQ  : XVRGUYUKTD      TMIHVWIGUOV     NKLBQURJTJUAQSQ EDHPDNIPXVICL   JRQEEHEWFCRRQT  LRTQAXEA        XUTTLTFMJJNEALU
QLOKLEBFGIYY    : ITCLRWBIYFRQ    MNLPRQXACM      PJXSQ           BIFTGKXLDL     
HRMYKFLDUFU     : UPJAVXCOOWH     BSJSQHTYGKKTCP 
CWFRNL          : JAPYWS          LFGJCT          PRJFG          
BDUOJX          : YCIWRDVVRLEBM   DPYRKERRSHL     DCECMPARPSIVTA  MJLQBMTQTAKM    NSAB            VFJVLPDECLWVEWO
PJXOSFIGGUN     : WIUQGDTTMGEAOK  KQTHYHNGUX      NPYUHLVWACL     GOMMKOAFHYEGEP  SUBILRUHA       UDUJAGFHQKGRT  
XIXUCCRHVHVGK   : FXJQRDVSE       CTVRAWGCNCVON  
EYIE            : NGDHWWUTRGUQOE  CUTABRKTUQCE    EIOJMRQF        UMFWLXFX       
ANTQHYCP        : WIUQGDTTMGEAOK  DIVDS           TFUIOQSOODHBAQC ROGWXKGQAWVQTME QFCPGMXWOV      OWPXXUL         JUCAQWPK       
WFAXPASRCNCA    : LKIYYQBMGGRS    JUER            DCLQGUI         MOCLQAUSJI      NHACNXHCNM      GQLTDAEMINVXC  
XJGYNHJTDJ      : SROWISLDTSWH    NVTBH           GNSKRYIFYCHXW   MVBFX          
YCTAGJIEQIEGJWY : EIJTKSOCB      
KDQIDAQC        : WREGHYNQFDLCE   NQEHBNSDLV      QHUFXFA         JEXWNOFMH       NHWLSCQO       
XLJEWTFYNGG     : MTBFC           MFFJLO          BJBPCM          UCIXYUSLDBS    
OMPYQYKPA       : IVEPMEG         OOJCUSMP        EJVTMLTM       
DDPLGPCKFCV     : MJNHWOJQ        NXUB            MGMODOFBFULN    LFFNDYJFBKQBC   NCEEO          
ISNOTDUC        : FORPKWPTFLMDSYK JPBLNTQMES      RULP           
LQWMJV          : CYMXWBMRK       YIAYKOQRDHNQ    LRCDKVWHOSEN   
AVYFYOSHGWRN    : OPKMWIOXWO     
PGIKTYF         : WHLGL           RDFOSUGDQJRBQ  
VJDHBAVM        : OGWF            IFSOKNKGLDWQ   
TOUSTWJ         : HBUUMQYEHPOBWBF MDUS            BARN            VELOJBURXSFYH  
EPJYFLOM        : KOSGMITGVWDESKM KFFXWGVNLFOYN   QSCEKJLGGEWE    MOLN            TKSVECINHVCMOX  HYIVVSKJCIKEWT 
CGUHG           : HDUQMH          SEQIWFVQEJPYQ  
SLAVMVJ         : OGSS            PITORUG         DDKSTX          YKIYINYSASAABR 
SXINSFXHM       : CPRM            NGPJGFVFU       ANIEGWXSTFPC    QTXPLB         
RNVF            : SDEEIVASYDSTSF  YIBLUAUFGL      VHSOIFMJRPMVK   QBONVAMKWJXFMM  ELRA           
KBGQV           : ABDKW           WSPSCJXENDKYD   EDLH            TIRAPJQIUMBSBSI
AMJLOFAKQ       : MJSVORHBW       YHBBSIT         EHBLTJJPSCKYB   NIDYNG          YYQRHSHFGKBDNST
DPYRKERRSHL     : RXJWBVDOJHF     BDUOJX          VTXFQSLMC       MLRNMRXIV       YAFRDRVHTYC    
FQNPTTJP        : XVEKYYMR        XACBQJQCFFMR    RBAEBXSWH       LCWDSCFTGIVQVGL WODMBL          WEFYJYWTYCGAWH  RTUKURDGALSH   
LEVWSDAGU       : HBUUMQYEHPOBWBF WODMBL          BLRKLCO        
JKMDWTUOOF      : PIRTGUIRFPJ     QJWSPOOLWUMCTW 
XMTLDOFOG       : XEVGOAUF        QOEO            PLWOR          
ALPYG           : CNVQDSWCVWELLAB MFKNHWFCNSMYKMT DHEQWRTHDA      AAJYSSGUDFQWPCB
YMOPY           : YTWYHGAOPYF     KBQPJXOI        MAKDK           SLMWNGPIKEXUDS  UHWSMUFIMKUIDNO KREWIPHWCGE    
CCXXAON         : BCJVQMXHHG      KGVNFKMEUPBLLV  KANOXUFOICSADOF EJRO            KJBHPEWWK       PKYE           
PLTMYYBGN       : GBMMMMJNSETRK   QAUURN          LJGNVDLA       
YPUQREKQQBGP    : WKTHUUUBDSS     CDCIEOVSDFHYJB  XAKLAR          AJBEETAWPH     
LUCLURBCJOXV    : GJQSWJHQIBUQVYQ DTKRQFNFIXEEQIJ PEDRXGYMBVU     JFSLDQEYHMVLRD 
XYUNJ           : DQKFHDWTVL      BLJJ            BUDXBRVGI       LAMGPTMPIHMKYH 
GGMXKAOCBXTGLO  : XRNMYNCKAUFOPYM LJCEAVLBVU      VVJFCVROSPGX    LHEQHBCMMUGAONX
WLCYPMNOKC      : OEHPBPNWMG      NVQXMKHQG      
MYCXWI          : AXDGEKS         LXTAIEKRXQOXLE  BARN            CFVALRFRETTFVLR
JGRJVTNVPT      : KMKGM           ROQDJUTF        RBGAVFUWJ       GEOAIQHLMCSOI  
FEEQHFJ         : ABDKW           UMYH            MTURFTKXVLFIOVI
TXIXMUYOSVXAFER : LQUTT           MKGSJ           VFJVLPDECLWVEWO VVQFWCRAQOPKXR  TMSIT          
CNFX            : POTNQKDSLTM    
BFIFMCMRLINLRLX : CCXIKMAHJ       EJUXXUQIFXECLPB NVTBH           MDEKN           GDETKCOOHDGO   
KMKGM           : OGWF            JGRJVTNVPT      FUQPEP          GTMQBEWHBSNVPL 
OTCIXPPYUQGEVSI : XVRGUYUKTD      ASQHNMFA        FTXX            DCECMPARPSIVTA 
NVTBH           : XJGYNHJTDJ      BFIFMCMRLINLRLX TPFP            NQAS            IWITDWMHS      
NFDATNJJXA      : KANOXUFOICSADOF RWMCVWT         SPFQOPHITUW     BBMXS          
CIDTX           : LQQPJ           QMROLYNX        XODNGEVARO      MMRPQYBVVPVS    WHCCDWWFI       NWGMR          
OQJUMCFXPBS     : ITIMEIVGNCTG    LEKKBKU         TBSUTY         
IIJPLJMBUVBUBD  : SCTEIQGAOXMBS   EBDIXUPJNCV    
EYFJOVSLLWRJPS  : LKMVGNQSKKIPRII PHSIL           YIBLUAUFGL      FNHTLVYEEIKJ    XHCEMEUEQC      IAHNDF          MMMCUKKFR      
JENS            : SROWISLDTSWH    VTXFQSLMC       HTSKJK         
BEKDAIEWJKFQJ   : VJXW            GEFCVSDVIC     
AAJS            : VVJFCVROSPGX    XIWUDQADCA      LIMVCMNMSWRUQA  XVBHIYI        
WREGHYNQFDLCE   : KDQIDAQC        OEHPBPNWMG      LYUAWFAO        PXXOYJSPF       TNSEUMEJGJCX    RDFOSUGDQJRBQ   MNNKXOM         MADPM          
MJSVORHBW       : JQQKSVAFLS      OGWDPKENCD      AMJLOFAKQ       QULSFOFQRW     
MKANVUASNGB     : AOTFQOUELAS     VWJNSYSLLAVMNM  GGFIFVTWPYK    
FQQNTCPBUEK     : KNXXXSTNW       VBMHVQUIQKGEO   OOYTHOU         MCQVHUXSXRQCO   AFEJD           NVQXMKHQG       ASVNS          
CBIMCHMPTNFPK   : EGAVTGQ         RPWKEXABUE      PBSRAJYFSQPHQSD
KANOXUFOICSADOF : CCXXAON         NFDATNJJXA      ROGWXKGQAWVQTME DSLRPEODDDESAAL
EJRO            : CCXXAON         MPBPCINSGV      UHWSMUFIMKUIDNO DBRA            IEBBPGJHACXXK  
VWJNSYSLLAVMNM  : MTBFC           MKANVUASNGB     HXEDCRU         WHCCDWWFI      
JSDTWVU         : XLNOEEGOQFYGF   EFFKVDQHES      AMBFATP        
MCRTLJIKGHV     : UGOXIBAUYSOLN   UDQHR           QPBQIQLSPFUB    WOKCXFYNLXCCYQD
DWPOIPK         : LXTAIEKRXQOXLE  YNBCSB          TIRAPJQIUMBSBSI TBAMGKHDM      
GXJRSMLRL       : XVRGUYUKTD      WOGNNJHDEG     
TXKLTYXFJGOHCR  : KQMLRNETBUA     UNIDM           FTUQUCTINWMCFE  WLRIMHK        
RGOKTMQRXI      : XVRGUYUKTD      WCRQGHJSYXGX    HTSKJK         
NTEYDAYNLTMJBX  : DDATMSUE        SRDCFQLO       
PHSIL           : HUQH            PYQTAFEGAQR     MMOEMAWTCWJWFO  EYFJOVSLLWRJPS  OURQM           EMIYXROS        ISVNTFDBUANXL  
QBWKP           : PAGIPBAGN       TTTAPEHFO       YOJBDGUXJ       UMFWLXFX        JEXWNOFMH      
CNVQDSWCVWELLAB : ALPYG           JUER            TKFYMPWWSY     
BYPS            : RAXRIISHHKYPXES CPRM            AKOUQNHJR       QRGLQOVPV      
IBUWUXUFPKKE    : ROQDJUTF        SVMLWHNOBKEQW   AICOCHEYQ       KRGIYG         
BJCB            : WXFBGAC        
AASLNSM         : BRWUUDVTN      
VOBOVLSSINRFS   : IHYGSRV         DSLRPEODDDESAAL ICNWOXUSWSWASI 
QDPCHAEKMEKHPY  : TSYSTBITECGG   
FMVTNMRYF       : SREMPXF         IEKATYTTHPR     MVYRWGGYDX     
JUER            : LSNA            WFAXPASRCNCA    CNVQDSWCVWELLAB LVKCPCVVRIXBLM  IVHP            XMJVEDEHAIMO    AVSFXWSGMO     
OKTEMBE         : CDCIEOVSDFHYJB  EDHPDNIPXVICL   QNMS           
LSWYAOAC        : UBAXDGLULMHJM   UFHTQYKOTN      SEEVMBLXBJV     WSPKBIOWQR      ADEBWOWILWDXS   GAGMJJ          UBKXEMAISBOP    TWRTTWSYTPL    
LSWYAOAC        : VYJYKYVQAIYPCA 
MAPA            : KHWSVW          QFTSRGWCT      
HBUUMQYEHPOBWBF : NWFOR           TOUSTWJ         LEVWSDAGU       YVLPBLAEPMKNQCP AJBEETAWPH     
TSYSTBITECGG    : OTLOILNYUCVJBR  DFAKKYOD        QDPCHAEKMEKHPY  QUUS           
ITCLRWBIYFRQ    : VBXDAFCOGSV     YNDISYTK        QLOKLEBFGIYY    OSBNQQBLUBJUA   QFTSRGWCT      
SNAA            : QXDJLSARUJUIA   JSOATRXRKUML    CHNCSFMTRFAGC   XAEB           
WVSPPTXKAD      : DCPUNQFJAVA     KBIRCBFFJN      LAMGPTMPIHMKYH 
HXEDCRU         : VWJNSYSLLAVMNM  FYUDTKPJO      
SFBBWRXQ        : CUGB            FUQPEP          UTEXEOXRUC      NMHLRYC         QXMYDLPJK       NINKSD         
ASCYOWPHSPTT    : UBAXDGLULMHJM   YEND            UNDJ            JDNLXMFSS      
MDUS            : VJQVXBHKKLMUP   TOUSTWJ        
XLEAEJBFHS      : MQIIH           CPMES           EPWS           
ABIUFHKC        : JQQKSVAFLS      JIEHOUFAYH      GVKUB           YEOSMOECUUUORKO FALVUNIXBSBJ    OQIGG           NSAB           
TVPNRKCWIVFGH   : SGSVIA          EEOKYFQIGDEDIIL WPQJSF         
GNVHTDCBFEJAL   : UMDNE           CYXEKJUVNBHGP   KREWIPHWCGE    
KOSGMITGVWDESKM : EPJYFLOM        QCVQSQXNBSVCFW  RSFAVW         
WSPSCJXENDKYD   : KBGQV           LVVXJYVMLJ      BRWUUDVTN      
SQNMWCWRIUONBJ  : WPFGLYH         CNKBEMIPMX      LHEQHBCMMUGAONX SPFQOPHITUW    
NLWIBPKNNPDSC   : SLMWNGPIKEXUDS 
WBVNOKM         : DOOUTFHR        TWMUEEMMNXFSKJW OLXHCHAJJDRPNYV
HEBFUQGG        : CUGB            THDKAGUW        EQRUGFASMSPYOAS
UTODVHOLWGOQ    : TMAR            EKYQEB          UVXJJ           PFVGCX          RBMAAHU        
QNMODD          : WTGOHJ          KHWSVW          WYAFHY          LTEERVJCQHWIUJX
PWJWAO          : QRKYSTILEOWY    UUEOJKAITFYH    LIMVCMNMSWRUQA 
TUDLPWCVUJM     : WUTCHOUPPYKDYP  BLJDEAQ        
HUWAFONTDSAF    : NWFOR           OXYPETAYDMOPK   UBKXEMAISBOP    MAORREUUPETEI  
YOJBDGUXJ       : TOYMNLC         QBWKP           DGJY            NDIIESUVPEYL   
QGLMCUBKEVIEDY  : PFWUBAVHARX     TOCIJ           KEYFGEAPMVGKEUQ EXLMCRQW       
AEMCJABXJC      : HBPCMOHYE       DTAY            BPCNDU          YETF            TEOAKT         
PXCYGUIRHMPKWV  : GBGTDTNDITTCV   QRCVHDJUWPGVOQB USUMYOYPWUQUN   KTAJATGSQDFBGJ  GQLTDAEMINVXC  
FBNEWNJMRUMSTXX : WKDBHPB        
OXYPETAYDMOPK   : HUWAFONTDSAF    BNREEDEI        EARTSKFDG       UJIMSC         
XRNMYNCKAUFOPYM : LSNA            GGMXKAOCBXTGLO  UXWF            SFEHVKLIENIF   
YDLXVSUVTALKQX  : RENMAHUPRKJ     KRTMLWDTCFYA    XQFVJRVQY       IQWJU           VQPBMAMLPY      SEQIWFVQEJPYQ   TKSVECINHVCMOX  XSOGNKVHRCKOEYN
YDLXVSUVTALKQX  : XHOCTPMD        OGTUAYHA       
QRLFQBIBBFHRUI  : CXJRBPAYCEMARW  XIHCYPUWR       NIPYRRFECQQ     DYKM            HRICMEDDCAVEALB
LHMYIIRFG       : KHNOAKGY        WCYL           
FTXX            : SXEBUPSAFEE     OTCIXPPYUQGEVSI AFEJD           GTYSRGQHJFBASKK QMEARBC        
TRKHWDIF        : SCOLCONHGB      IVLRA           OCGUJEQTND      AMBFATP         SCKTEUTJ       
LMOFIYLTJAU     : KEMNEIDYDHNS    PXGVEU          KBTIWIWDLHC     XIWUDQADCA      UCMYIJFECGLGIY  KVIXXWTKKTMB   
INYRBGL         : QGRDECMH        UCBMXMCQHJG     FUQPEP          RRQOOV          FXRRGAWCFOHRH   BMSRWXPEYF     
FGVWSFTVPCDDOTK : DOOUTFHR        KKSVVAU         LSSJFNU         UPIRBY          LMWPV           VVQFWCRAQOPKXR  KVIXXWTKKTMB   
VVUFWQYHG       : KRTMLWDTCFYA    THDKAGUW        EGOTD           ELXKIIRRWIFEII  JVXYFKGHWX     
BJEPLLXJIQO     : CNVYOHTD        IUEXMI          WYFAG           CCDAHCMOA       UGEALEHPS       TBKXDHGWQPVBJPU
OGJULAOV        : YRSTGBLS        CPMES           VFJVLPDECLWVEWO CJQMDVYUEOYOJB 
KUWPTPQBVOFIT   : QXDJLSARUJUIA   ACHYMCMSDNQ     VBMHVQUIQKGEO   NKGHGTRYQDYE    EIOJMRQF        UJKAEEB        
TFSEQLUXCCHWNHM : FDWDPBSII       SXGPKLAJODDC    TNTEUL         
JYFJRYYICXXJGT  : BAXPPBTIB       YMGOTYCLUWSLE  
ABYGRMCRPGYMTJB : IXIDL           XIWT            SKTBFVS         JVKAMQJQEDVR    ECKTQBS        
UDNEWOGFTEFD    : KBTIWIWDLHC     CPMES           ACILFKMWFY     
BKMDLTW         : RAXRIISHHKYPXES JSEQVXHMXFSTIWL XNFPTAWPTC      HMJCMMFQTPCMKWA KMBPOMEWNTAKG   IYRLMVBBNIBWU   JBHYNBWB        SVMLWHNOBKEQW  
XPQEQF          : TIAVVX          ULFJAN          BQHOJTOKM       TTCXSWJOUK     
AJJXMYCJOIQK    : NLJXIDIDO       JYGDMHRV        NKGHGTRYQDYE    RATDHDAEYHIRM   HHALFKVIMCETK  
YNBAXOFMKFLKUEO : NQEHBNSDLV      JGPYJBFPF       OJLWG           NIDYNG         
JQOUAMJAQUQCMBQ : JOKDS           CRMUXDFBA       TEXDPCR         LMYTKUUFGKEJD  
OUPPLVCV        : LXTAIEKRXQOXLE  VBNHXQXKKC      SDYTTD          WXEWBYG        
PIXVWLHNCDQ     : QEETRU          KBXPWEWSWVFN    MJMSFXTYTTIPS   ONDTINJRHUNQB   TJBMVWOAXGAD    RJKCNKBDPTAV   
MQIIH           : VDKSQMATI       PGJBYNRL        XLEAEJBFHS      NPVIMW         
WKFKY           : YVAOP           MFKXI          
AQLXUJBMRY      : RAXRIISHHKYPXES
QNQHPVXJIQ      : WKTHUUUBDSS     MMOEMAWTCWJWFO 
SXGPKLAJODDC    : KCMXODB         TFSEQLUXCCHWNHM VRXFKFCAYF      YVLPBLAEPMKNQCP CPMES           GWSF            CJQMDVYUEOYOJB 
XODNGEVARO      : TYNEO           JKDMIQDOF       CIDTX           HXQKRJNHE       QWBNVBUC        NKKMSTNCYB     
KKFTVVN         : KCMXODB         QHUFXFA        
VTFGHHRVKWBOXP  : NWFOR           KDMOFHLOU       RDFOSUGDQJRBQ   RQLGOKXK       
LXXJXSYF        : DDATMSUE        FJQCUXOHY       WEAO           
LMYHKMYIIEQPN   : CJCCDAFYLGXU    SAPSJONEX      
OBGPPGHLRFJC    : EYRNQW          ARPOUCSLY      
EDLH            : KBGQV           KHNOAKGY        WWCFHEGYCFQTT   CPMES          
YIBLUAUFGL      : YIAYKOQRDHNQ    RNVF            EYFJOVSLLWRJPS  TFAKPG         
TWMUEEMMNXFSKJW : WBVNOKM         JBEAHSHBRVFCMP  FGGWRVRXCOK    
MLYDK           : FFGB            JTFUX           TOCIJ           NIHGVDQWV       RRKYNTQD       
EVFGSKMFIHCWEID : SXFCUJRLN       RJYEFDJATIOJVTT LSJFGOGSGDPY    YFTFI          
VQPBMAMLPY      : YDLXVSUVTALKQX  IBQOLPFMYICA    UAKEMQEHUYUABLV GPYAIHT         NXTS           
QEHXLGDRYQHGBOJ : UMVWW           DILRYNQUSYIBYC  KCMXODB         FAKFMSCUH      
SREMPXF         : VQFBEBHDTYNVWR  FMVTNMRYF       IKGF            LMWPV           QVQLJWTXXF     
KFFXWGVNLFOYN   : EPJYFLOM        PFWUBAVHARX     MAKDK           EWQUL          
SNKAVMQFNMATYP  : VBXDAFCOGSV     TFIG            PPLNNLFME      
EJEMQDLXYCLGSK  : BKPIFWBEXGXP    ELNENGM         TFUIOQSOODHBAQC WBKBNI          CKJTA          
MFKXI           : OSURYC          WKFKY           TULQGDQK        PMUDA          
MBMCNOVPEQVPUKH : JTFUX           LEKKBKU         AKOUQNHJR       LYBMFHRHYGDGRJ  PMUDA          
YHBBSIT         : AMJLOFAKQ      
DIKNIUTUWIYMWV  : WQPIKKYT        QVSJUUTUITDTX   BLIKDPKLSQFFT   QMDYEBTDL      
EMBVJNFKMM      : KEOQP           JSAIRFIBES      KGHLON          YAFRDRVHTYC     OGTUAYHA       
NFVJKYUX        : OGSS            UIVQGYDYRQBNY   XTTFUOHKGMUU    VKMIIWNDNB      VAGNWH          MOCLQAUSJI      BLJDEAQ        
DULBTTAHTVLAK   : QSCEKJLGGEWE    HPSEVALXFYU     UYTEXOWMXEK     HMXQYEYME       PRJFG          
VWDCJPQWGWTRJ   : JPBLNTQMES      VQISICLHCSMQ    GVFNHTFBKXXUB   MVYRWGGYDX     
MJMSFXTYTTIPS   : CTVID           PIXVWLHNCDQ     VUWPHMDMVXNEP   YORUYCQ         KSWNS          
PFLMCOQ         : QIYRWC          BWTLICD         CJLCYTIOAY      NRXFPPBCLHWNEP  IMQAACU         LWMAGEU        
HJLN            : XQFVJRVQY       WHILAAEE        GDOQHLIM        ASVNS           ISHLUQSSRD     
HHSEUCQNJOJL    : ISXMQTAF        THDKAGUW        BQHOJTOKM       AKBLUSRMUHIW   
DTBX            : TSSL            EPNGAPUCWCDPWNM UAPMQ          
REDGITYWB       : SJFWVQRVK       GYOWKMMHUYBO    FPNEHXKCNU     
IQRRYKVTONJYES  : IQJVC           WBVEUNRFBLCPLOB MWJTTDYANYQCKYI
PXGTWXNDDVLYUI  : BKVHNJFPHRJBYQD UMVWW           JSAGIU          PIYCFDSASPCSQY  QFCPGMXWOV      NGYQWS          FGGWRVRXCOK    
FSRWKQJH        : KQTHYHNGUX      HPSEVALXFYU     CPGEAROWTB      RSFAVW          PSMQAWQKRQFNLSH
BWXCBSOTRUPQ    : BIANBCDLAUYJ   
DTAY            : AEMCJABXJC      XRMWMRNOWSP     NTDSQNK         GCQITFKFIDLQRDY DHEQWRTHDA      RXJKIJGNTE      NMHLRYC        
AVQBBJUB        : DRVKBBAROJMA    OTOWSRTF        JVKAMQJQEDVR    IGIYYKRMRYCIRFN JHMJWWEROQHRHS  KOBXEIRLPWWES   MPWVJJFQPXDNIFD AVSFXWSGMO     
OMEDNDCP        : LJCEAVLBVU      DPLUSUFKERFHHR  EFFKVDQHES     
WEAO            : LKIYYQBMGGRS    RRETYLGJHMU     LXXJXSYF        OYHBPBOXNNCCDO  KTSGRPEADFWIQ   UYTEXOWMXEK     GMQKIYKSXB      AMWC           
PFWUBAVHARX     : QIYRWC          QGLMCUBKEVIEDY  KFFXWGVNLFOYN   RCDFP           DSSCJKDS       
VJXW            : WCRQGHJSYXGX    BEKDAIEWJKFQJ   TDAAEI          ASVNS          
OLMSCPWRWT      : PIYCFDSASPCSQY  IXEQEIDEQXKJ    HXMEBO         
YJDRQAM         : HXQKRJNHE       TEOAKT          BSVILFUFQSH    
CJCCDAFYLGXU    : IWMJGTGQ        QWEQOSDR        QRKYSTILEOWY    LMYHKMYIIEQPN   UBKXEMAISBOP   
KHNOAKGY        : NLHOCABYOVYHB   MDKPIP          DCLMAMSTMSRWP   GJGBHEKK        LHMYIIRFG       EDLH            WMHASPUXQGQ    
HXQKRJNHE       : XODNGEVARO      YJDRQAM        
SGSVIA          : IUEXMI          TVPNRKCWIVFGH   WTGGBVFAYKJA    HHALFKVIMCETK  
UIVPE           : QYFR            BQHOJTOKM       KTAJATGSQDFBGJ  HYIVVSKJCIKEWT  AWJUB          
YTWYHGAOPYF     : YMOPY           WPFGLYH         YEOSMOECUUUORKO QAUURN          IAVRI           JUHEL           YJBVURFDUXW    
SQQAVGSCBRN     : XEBRFWUFEGLS    BRWUUDVTN      
PIML            : JLLRHTKETWWBIUC XACBQJQCFFMR    WNGOXC          FOXNJLEJSDCFODB
QWBNVBUC        : XLNOEEGOQFYGF   XODNGEVARO      IYAYNXACIW      SLMWNGPIKEXUDS  SKTBFVS         UNDJ            FHNLMKVNKOFTIM 
JSEQVXHMXFSTIWL : BKMDLTW         AILERMPNXBETDOS CGPKOYAVUGDUJV 
BBGNOIHNJWK     : XOUMXO         
ROQDJUTF        : JGRJVTNVPT      IBUWUXUFPKKE    RCXXRD          UCMYIJFECGLGIY  GXBQUELH       
DTVJN           : EFFKVDQHES     
TMBRPEAFUIMJT   : MEUJRUWJQFQ     JPBLNTQMES      YASQPVOCDMW     TTKASCVFMBJA   
THDKAGUW        : HEBFUQGG        VVUFWQYHG       HHSEUCQNJOJL    YEND            NIBJM           AICOCHEYQ       EQCJ            IXJCCCVORF     
CSGWORMGLYJ     : VPNHQRR         ANDEIWQF        GIGN            TFIG           
ONDTINJRHUNQB   : FDWDPBSII       PIXVWLHNCDQ     VGLHFYAJ        FUQPEP          GPXBIUHUYYB    
SJVSOX          : DGMYQQUQOVBJ    UPJAVXCOOWH     MGXLWVOVJPML    MPBPCINSGV     
UUEOJKAITFYH    : LSNA            WIJDINLVYGCM    PWJWAO          WCYL            BSUP            XHCEMEUEQC      XXPHQQL         KHAEJDFXC      
VRXFKFCAYF      : SXGPKLAJODDC    TFAJPEQQTTPWT  
RPWKEXABUE      : CBIMCHMPTNFPK   DGJY            LMWPV           UPRICQQWSDLWC  
FORPKWPTFLMDSYK : ISNOTDUC        HCVLQBHSTK      NCKAFDBXLHHH    MTKHJAXDEA      BBMXS           XVYQOQVWMQ     
YJDDESCQY       : IPOUPP         
RCXXRD          : ROQDJUTF        BYTD            BTQP            GVFNHTFBKXXUB   IXEQEIDEQXKJ    NIBJM           PBSRAJYFSQPHQSD EBDIXUPJNCV    
JSAGIU          : PXGTWXNDDVLYUI  VFJVLPDECLWVEWO
VHSOIFMJRPMVK   : WKDBHPB         RNVF           
OLRGNPHFUUQOWYY : CKTCXAYN        MVBFX          
OXBJOJOBTGSGCFX : CCXIKMAHJ       SMLSH           WVEDXJGROF      JELEBBXRXODWD  
QSCEKJLGGEWE    : EPJYFLOM        DULBTTAHTVLAK   MCFPXBNJCDQKTYM TEXDPCR         XVBHIYI        
XVTVXD          : WBVEUNRFBLCPLOB EHBLTJJPSCKYB   AXIWKUODYTKDQR  TFIG           
JSODYIMENMXH    : UCBMXMCQHJG     VFJVLPDECLWVEWO
ALQMXYSCVW      : PEWJMYYVVNSDSAG LSJFGOGSGDPY    VQISICLHCSMQ    DTKRQFNFIXEEQIJ
TTCST           : EHEJNUIT        AKBLUSRMUHIW    TVMJAKOQHCM     PVHORWW         LOHJGJGPLWRKL   UGLYQNEEIPCKDD 
EDYUJ           : GNITTUE         XKKCPFW        
DVETK           : TYNEO           XNFPTAWPTC      SKTBFVS         ICNWOXUSWSWASI  HDCG           
BQHOJTOKM       : XPQEQF          HHSEUCQNJOJL    UIVPE           XBWQOQCMWXTE    CLNEVPJOICV    
GKCCGEWCMDHN    : XKLFWRB         REIRPU          TTCXSWJOUK     
QOEO            : WKTHUUUBDSS     XMTLDOFOG       MNNKXOM        
XACBQJQCFFMR    : FQNPTTJP        PIML            TNYKIAYYQCKOG   PKYE           
UEDYMIW         : SGEV           
WCYL            : XGOH            LHMYIIRFG       UUEOJKAITFYH    SDYROGKXKFQGHIF GUVMXLCYYNTUTF  NCEEO           LJRPBGIOHLUDPM  UGLYQNEEIPCKDD 
PCGFWG          : WTGOHJ          YYDGHWVFXUJFVS  NDIIESUVPEYL   
YIXKBCPIOKKLQ   : MNSYL           MFKNHWFCNSMYKMT NKLBQURJTJUAQSQ QGPRV          
MGXLWVOVJPML    : SJVSOX         
TKFYMPWWSY      : YGGBBWB         CNVQDSWCVWELLAB UUVHD           ODNYOO         
BPCNDU          : QLUSL           AEMCJABXJC      BQUNPNSD        QBHNKMC         DCLQGUI        
RBAEBXSWH       : RJYEFDJATIOJVTT ASQHNMFA        FQNPTTJP        TDAAEI          IEDUNDQSWY     
LSJFGOGSGDPY    : EVFGSKMFIHCWEID ALQMXYSCVW      WXNKRRRMPBQJKN 
HCVLQBHSTK      : FORPKWPTFLMDSYK SMLSH           XPKQLTT         RBMAAHU        
XNVSLDFYYOHF    : KBIRCBFFJN     
NXLTPKAAPYLGAUY : DAKU            EEOKYFQIGDEDIIL OYHBPBOXNNCCDO  QAUURN         
IVVVROJ         : OUCGJY          JELEBBXRXODWD   QXMYDLPJK      
WJYLSE          : GNMHJUJWB       LXOUAMAMIBGII  
GEFCVSDVIC      : BEKDAIEWJKFQJ   ADOLNSQPOEQ     IFSOKNKGLDWQ   
OEHPBPNWMG      : DQKFHDWTVL      WLCYPMNOKC      WREGHYNQFDLCE   WMHASPUXQGQ     PYFSEBFGPT     
VGLHFYAJ        : PYUSBHIEVBXKTPH ONDTINJRHUNQB   XTLUKE         
JPBLNTQMES      : ISNOTDUC        VWDCJPQWGWTRJ   TMBRPEAFUIMJT   UKARMYCW        SVMLWHNOBKEQW  
UXEMBUAA        : NLHOCABYOVYHB   RLQNYIKY        GKJLFGQ         NUHDONJS        OBMRPYAGOIWHBJ 
IOFOCPTC        : BSSNR           EEBQVNKPUJ      BIMLEMKUAXYFDYG SIFR            IFSOKNKGLDWQ    JDFUIVKGAYO    
FUYWVN          : WEOELTBHRNSRWIL NGXUPNQQK      
REAXAYUADH      : MBQF            AUMDAORI        THSUXM         
AKBLUSRMUHIW    : TIAVVX          HHSEUCQNJOJL    TTCST           TPUIVRWFBAPIYKF YKIYINYSASAABR  CYTEYX         
OSBNQQBLUBJUA   : ITCLRWBIYFRQ    UDQHR           MJLQBMTQTAKM    QULSFOFQRW     
UGOXIBAUYSOLN   : MCRTLJIKGHV     HRWGEGHVLDIDT   JRQEEHEWFCRRQT  DHEQWRTHDA     
TNYKIAYYQCKOG   : IUEXMI          WKTHUUUBDSS     JFEYJL          XACBQJQCFFMR    SIFR            CSBUOJOF        RQHNVYIFINJUJBX
JIEHOUFAYH      : ABIUFHKC        IKGF            NUHDONJS        JUCAQWPK        ECKTQBS        
XALJQJD         : QLUSL           LIMVCMNMSWRUQA  XHOCTPMD       
KQMLRNETBUA     : TXKLTYXFJGOHCR 
FJEOABTC        : WCRQGHJSYXGX    JBEAHSHBRVFCMP  GITVPR         
CYXEKJUVNBHGP   : GNVHTDCBFEJAL   NDOUCKA         ANDEIWQF       
XEBRFWUFEGLS    : SQQAVGSCBRN     WSPKBIOWQR      XOWHNXPOG      
MOLN            : EPJYFLOM        YICH            TMNGLAXB        PHMMJ           IXPVHUDBCPIWPQW CSBUOJOF       
KNXXXSTNW       : IXIDL           DRVKBBAROJMA    FQQNTCPBUEK     VJAW            UAPMQ          
TMAR            : RLQNYIKY        WGUMGNHN        UTODVHOLWGOQ    GJMN            LYBMFHRHYGDGRJ  JGTP           
CLXBIFFQSAA     : YHNTJCNP        TOCIJ           DDKSTX          QAUURN         
OLVIXLGVJBSYXX  : VPNHQRR        
NYMGDB          : QBGWAJUKEMS     LYUAWFAO        PJGGWNMFOW      KKIWALUGUMU    
GJMN            : TMAR           
GNDOEQMOOXUNIY  : AXDGEKS         LMWPV           PEDRXGYMBVU     QTXPLB         
JYGDMHRV        : FSUJUENQEDM     DXTM            TJQPTDWJCVXHY   AJJXMYCJOIQK    EWFJBHSPQDO     DSLRPEODDDESAAL
UDQHR           : MCRTLJIKGHV     OSBNQQBLUBJUA   TYWOCPVTWGUS    CNKBEMIPMX      JBHSRUVOQCGX   
KXTNOBEBPU      : MLRTO           RVKXFLBRYUSWX  
NKKMSTNCYB      : XODNGEVARO      YJNGPVKBJL      KRGIYG         
TYWOCPVTWGUS    : HFPOLJRKSIMHII  UDQHR           UPRICQQWSDLWC   JHMJWWEROQHRHS 
JTCNKAPXMCKIX   : FSUJUENQEDM     TOYMNLC         XSOGNKVHRCKOEYN GWSF           
KXBVTASIELHYI   : TMNGLAXB        WEYJCTEMAHINMBJ TBSUTY         
VBMHVQUIQKGEO   : WQPIKKYT        FQQNTCPBUEK     KUWPTPQBVOFIT  
MNSYL           : YIXKBCPIOKKLQ   MFYKJ           HTSKJK          NIBJM          
UFYQPECW        : ELXKIIRRWIFEII  PLEGVRASQJP    
MPBPCINSGV      : EJRO            SJVSOX          REUJTQ         
SEQIWFVQEJPYQ   : AHWIK           CGUHG           YDLXVSUVTALKQX  KTSGRPEADFWIQ  
RGSVGXIVB       : QUBEUEAYJYY     GBMMMMJNSETRK   PSUXJBOQWYTO   
AKOUQNHJR       : BYPS            MBMCNOVPEQVPUKH
TPFP            : LBYNWDDU        NVTBH           CFVALRFRETTFVLR EIOJMRQF       
JYXLPM          : ICNWOXUSWSWASI 
YICH            : MOLN            UCPCIQIKN       DVHKTEU         PWCTUJIXUKSMIV 
MFKNHWFCNSMYKMT : SCOLCONHGB      SXFCUJRLN       ALPYG           YIXKBCPIOKKLQ   XAHJFTWLQ       SFEHVKLIENIF    MXAEXAWCYCUWMSU LCEMTMFGKN     
ULKGL           : UMDNE           CKTCXAYN        HVESEQD         BLRKLCO         PVHORWW        
TDAAEI          : VJXW            RBAEBXSWH       WYFAG           GUVMXLCYYNTUTF  HLLHTISKVYGC   
NSQSDHAAMFPFR   : GKUQ            IBQOLPFMYICA    YSYUDE          EARTSKFDG      
RGLWBWJIKUCQW   : VBXDAFCOGSV     ANQXEVIQDDIGRU  KAOCTSUPG       OSXKVE          PJGGWNMFOW      KBIRCBFFJN     
WHILAAEE        : HJLN            QNMS           
HEVMUDE         : ULBCHXMWUTSO    CIBPTGMDKVXXN   MGINT           SRPOWVODXCMN    GEOAIQHLMCSOI  
UKARMYCW        : XGOH            GVRLGPNARRULMCT JPBLNTQMES      GJQSWJHQIBUQVYQ PIYCFDSASPCSQY 
YBDVG           : NMOOCCJCIFUD    JAPYWS          XNFPTAWPTC      TIAUKQMTJAKG    IMIPJCY         HMWTABM         LFXSDCORFSUEK  
DQNDQSJACOV     : RLQNYIKY        DXTM           
LYUAWFAO        : WREGHYNQFDLCE   NYMGDB          UTXSRYXEGFCGBNC QULSFOFQRW      GDETKCOOHDGO    VVQFWCRAQOPKXR  MADPM          
BSSNR           : YXQQGLFAG       IOFOCPTC        USUMYOYPWUQUN  
SPDVSVJYNEIP    : NCKAFDBXLHHH    JUCAQWPK        GYOWKMMHUYBO   
YMWMNR          : RQNRJUGVHG      BNREEDEI       
KAOCTSUPG       : RGLWBWJIKUCQW   LMWPV           QFSVAUPWQNEHIRV GAHC            ISVNTFDBUANXL   SAPSJONEX      
MCFPXBNJCDQKTYM : QSCEKJLGGEWE   
YYVQ            : GQNSCDBYRMS    
HQDLN           : IUEXMI          SROWISLDTSWH    RRETYLGJHMU     DBPRHYKMEQB    
GDFXPJEHJHUSJYL : XLNOEEGOQFYGF   YASQPVOCDMW     UGVJPNYTAQRBF  
UNIDM           : TXKLTYXFJGOHCR  ELRA           
YFWIYCTMBDRIBHR : TDPGDADURP      XYOIMWOVTLS     EOKKJSBKA       FFMFHYKDMNHYDH  RSFAVW         
QBONVAMKWJXFMM  : FBLVPPPJSNPOG   CPRM            RNVF            LIMVCMNMSWRUQA  IMQAACU         SCTEIQGAOXMBS  
OTOWSRTF        : AVQBBJUB        PMUDA          
WYFAG           : DOOUTFHR        TJQPTDWJCVXHY   BJEPLLXJIQO     TDAAEI          LHJCBHC        
IYAYNXACIW      : FSUJUENQEDM     QWBNVBUC        WWCFHEGYCFQTT   MAIRQTJMGHL     VFJFTYDMUWDSW  
IEYWUNRJNK      : KBQPJXOI        UCIXYUSLDBS     EPWS           
JSAIRFIBES      : PQQNMQDCIDKOS   BWTLICD         EMBVJNFKMM      SWKVECSVRRGU    KMTVIKTDEM      HGFHPHV         PPSCSTMNHRUXFJ 
EUPFUS          : PPPQWCBSET      GQLTDAEMINVXC  
TFYA            : TPDVXGUFEMMABC  PGEKKDEGHCHD    FXJQRDVSE       ABSBXNXRN      
VUWPHMDMVXNEP   : MJMSFXTYTTIPS   GNMHJUJWB       WUTCHOUPPYKDYP 
OSXKVE          : RGLWBWJIKUCQW   YEND            UXJJQNRLDEGU    PEDRXGYMBVU    
LJCEAVLBVU      : GGMXKAOCBXTGLO  OMEDNDCP       
TRPDGUPCSDI     : DCGNYGAWGH      QRKYSTILEOWY    GMKDK           WSPKBIOWQR      WWCFHEGYCFQTT   TWRTTWSYTPL     CTVRAWGCNCVON  
WYCW            : BAXPPBTIB       IHYGSRV         VTXFQSLMC       TFIG           
ADOLNSQPOEQ     : GEFCVSDVIC      BYRAA           VVQFWCRAQOPKXR 
YPJSHMY         : QBGWAJUKEMS    
CDUILGH         : LAGLDJUYXBQY    MAULHPK         LCEMTMFGKN     
KEWKHOVW        : ELXKIIRRWIFEII  NRXFPPBCLHWNEP 
OOYTHOU         : XEVGOAUF        CHLR            FQQNTCPBUEK     IBQOLPFMYICA    FOXNJLEJSDCFODB
XOHM            : XQVVK           PYQTAFEGAQR     DHEQWRTHDA     
KQTHYHNGUX      : PJXOSFIGGUN     FSRWKQJH        MXAEXAWCYCUWMSU
SIWHFVOVLPRSEN  : WMOHXXEKUMIPJ   JYJDBGJF        RATDHDAEYHIRM   LKGYUFRGS       IEDUNDQSWY      EPWS           
EEBQVNKPUJ      : IOFOCPTC        DIVDS           FTCLUQYXVEJSV   DAWGRHJX       
LSSJFNU         : FGVWSFTVPCDDOTK RRQOOV         
UCBMXMCQHJG     : QAUHQKQXMOB     GRIMOAXBXK      INYRBGL         JSODYIMENMXH    BBQGVFT         ROGWXKGQAWVQTME IAVRI           CHNCSFMTRFAGC  
NKGHGTRYQDYE    : KUWPTPQBVOFIT   AJJXMYCJOIQK   
TOCIJ           : QGLMCUBKEVIEDY  MLYDK           CLXBIFFQSAA     XAKLAR          NGXUPNQQK      
FNHTLVYEEIKJ    : TYNEO           CUGB            EYFJOVSLLWRJPS 
WPFGLYH         : SQNMWCWRIUONBJ  YTWYHGAOPYF     EUKCGT          CSHTNS         
DGJY            : OYNJSPMLB       DOOUTFHR        EFHFHRTXMYFCP   YOJBDGUXJ       RPWKEXABUE      MFYKJ           UCIXYUSLDBS     YJBVURFDUXW    
ADKJM           : GJGBHEKK        DFAKKYOD        RMOELQNMU       CMISCEGG        IYRLMVBBNIBWU   MXAEXAWCYCUWMSU RRKYNTQD       
YTMMSLRWTEIS    : MXBJKKCSSM      KGJHQE          UHWSMUFIMKUIDNO IHCP           
XAKLAR          : UAOSDX          YPUQREKQQBGP    TOCIJ           KDMOFHLOU       SJXRWJJJMWY    
DAYECYINK       : KEMNEIDYDHNS    BGTEVEKKIQE     JVXYFKGHWX      MAORREUUPETEI  
GJQSWJHQIBUQVYQ : DILRYNQUSYIBYC  LUCLURBCJOXV    UKARMYCW       
LCWDSCFTGIVQVGL : FQNPTTJP        KHWSVW          JJITNV         
SDYROGKXKFQGHIF : HTFRWADSPWFTN   WCYL            OURQM           ROJTVNVEKDST    PFYFPHKTLXAQ    TRQVGRTXTOGYVQE
KEYFGEAPMVGKEUQ : QGLMCUBKEVIEDY  EFFFMJYOGQYOXXG XFDQV           WJOKCIN        
AQQOWBMHJEQSO   : PIRTGUIRFPJ     HTSKJK          IYRLMVBBNIBWU   ODNYOO         
LYBMFHRHYGDGRJ  : MBMCNOVPEQVPUKH TMAR            VCFIDIIABK      EFFFMJYOGQYOXXG QTXPLB         
KJBBC           : CGUL            GFNOPDDQMPTOQ  
BGHKPLBKCXV     : QIYRWC          VFJVLPDECLWVEWO LWMAGEU        
BLIKDPKLSQFFT   : DIKNIUTUWIYMWV  BIMLEMKUAXYFDYG GPYAIHT         UUISS           IFSXOFXPDQW    
OURQM           : PHSIL           SDYROGKXKFQGHIF
WTGOHJ          : QNMODD          PCGFWG          TPDVXGUFEMMABC  HLLHTISKVYGC   
LHXNKJVVOO      : SCOLCONHGB      GTCTADFWRCRCUMS
AJWIOQYDNSW     : EGAVTGQ         YYQWEEOXXDWHV   MEASF           EWFJBHSPQDO     FPNEHXKCNU     
OTYWL           : SIFR            IXPVHUDBCPIWPQW QRCVHDJUWPGVOQB GGFIFVTWPYK     SPRIMQTGAAAODQU
GKUQ            : DQYAVIUBTHIYPM  ACHYMCMSDNQ     NSQSDHAAMFPFR   HCXEBSTOPKG     QBHNKMC        
KBTIWIWDLHC     : LMOFIYLTJAU     UDNEWOGFTEFD    FUBHEAA         KUDOJX         
XUUCKPBPEUO     : NGHOB           NCKAFDBXLHHH    OBMRPYAGOIWHBJ  NITRIVVAULN    
GYMTVDEGGY      : NLJXIDIDO       WYMYXOMJUVG     BOFVRHSOJB      IIDVFRDKSFR     LRURUPIEFH     
GJQLWXOSYLND    : QLWM            FUQPEP         
EEOKYFQIGDEDIIL : TVPNRKCWIVFGH   NXLTPKAAPYLGAUY UGGBSHCCWUI     GPYAIHT        
JDUTUHSUXMTJCWK : HGWHURKULSFEBM  RJYEFDJATIOJVTT VFXCBLXI        KYSGITSG        OSBMB          
BYTD            : RCXXRD          VVQFWCRAQOPKXR 
MNLPRQXACM      : TYNEO           QLOKLEBFGIYY    REIRPU          EYRNQW          GPYAIHT        
IKGF            : WLSHVQBHITB     XKXWRKBYMLK     SREMPXF         JIEHOUFAYH      DRQLXFLGYS     
BARN            : TOUSTWJ         MYCXWI          VRLWVANEFVESNA 
DQVOYANUFUHSIYM : KBIRCBFFJN     
WODMBL          : FQNPTTJP        LEVWSDAGU       RVKXFLBRYUSWX   PSMQAWQKRQFNLSH
JQQLTKBSN       : MXBJKKCSSM      RNEFAQTUGUPNYMA JGPYJBFPF       UEFT           
QCVQSQXNBSVCFW  : YIAYKOQRDHNQ    KOSGMITGVWDESKM UXJJQNRLDEGU    CKTCXAYN        UCMYIJFECGLGIY 
UAOX            : LKMVGNQSKKIPRII FUBEP          
NIHGVDQWV       : MLYDK           JVRKMUXEMYFVN   XXPHQQL        
RNJPGCGFRJX     : XLNOEEGOQFYGF   LEKKBKU         VCMKTEPOMDDTOX  TXQPDAVXBALBSJ  SCRPGJQSOCL    
MGMODOFBFULN    : DDPLGPCKFCV     UUISS          
JSVHPCBFL       : SIIFUWL         KNUFUSPSFO      JSOATRXRKUML    HRFI            BGFKGEQEFD     
NPYUHLVWACL     : KTXKXYEOASPQMRK PJXOSFIGGUN     MEASF          
HDXIISWXXGR     : MLRNMRXIV       LMYTKUUFGKEJD   VIBBQQ          JHFBLASFRNVCH  
PJXSQ           : QLOKLEBFGIYY    TMNGLAXB        QSFVNIG         XSOGNKVHRCKOEYN LCEMTMFGKN      SRDCFQLO       
LGCLCKY         : VVQFWCRAQOPKXR  DCLQGUI         HFADVKX        
JYEXPLBPVLIS    : TFUIOQSOODHBAQC LMWPV           IPOUPP          WEYJCTEMAHINMBJ AMBFATP        
ICECTNANGMY     : LMYTKUUFGKEJD  
RMOELQNMU       : PDULPE          ADKJM           YRSWMNKGJL     
EGOTD           : VVUFWQYHG       GDOQHLIM        VCFIDIIABK     
EXLMCRQW        : NMOOCCJCIFUD    QGLMCUBKEVIEDY 
TMNGLAXB        : JRRGANJWM       MOLN            KXBVTASIELHYI   PJXSQ           DTKRQFNFIXEEQIJ YASQPVOCDMW     JDERILC         HXMEBO         
CMISCEGG        : ASQHNMFA        ADKJM           TWRTTWSYTPL    
XBPY            : QMROLYNX        LWMAGEU        
QMUUELRLFEYOSYO : COPPLSOPBU      CNISWDPD        MFFJLO          SUTB            AWJUB          
STICMKIUTUSWNTE : ROLKNRVK        CSBUOJOF       
GYBMNTAUAYJSBB  : BCQN            LFFNDYJFBKQBC  
TUAXJMGGGEA     : MJKMHC          LFGJCT         
RVKXFLBRYUSWX   : RCOB            YVAOP           YNDISYTK        KXTNOBEBPU      WODMBL         
ISWJ            : TIAVVX          GIGN           
REIRPU          : QVSJUUTUITDTX   GKCCGEWCMDHN    MNLPRQXACM      JJITNV          RQNRJUGVHG      NXTS            KMTVIKTDEM      DTFVPSRTDERTFXU
WEFYJYWTYCGAWH  : FQNPTTJP        XFDQV           VYFRUSUV       
REVLPO          : CDCIEOVSDFHYJB  IFROBCOYNDFKYO 
YYDGHWVFXUJFVS  : PCGFWG          CDBCYDDB       
TPDVXGUFEMMABC  : NGDHWWUTRGUQOE  TFYA            WTGOHJ          OXGOPFTBYY     
KBQPJXOI        : YMOPY           IEYWUNRJNK      ULBCHXMWUTSO   
NDOUCKA         : BAXPPBTIB       CYXEKJUVNBHGP   KJVUCYMHUEOOSBR AWJUB          
CFVALRFRETTFVLR : TIAVVX          MYCXWI          TPFP           
CJLCYTIOAY      : PFLMCOQ         FTYCMQIFF       USUMYOYPWUQUN   WSXLCQI        
CJLCN           : KOTLCSWRJ      
XNFPTAWPTC      : OGWDPKENCD      XKWRYDXBRKRO    BKMDLTW         DVETK           YBDVG           QMXIAQLLC       RDRANX         
FWOHG           : TTTAPEHFO       FFMFHYKDMNHYDH  LRCDKVWHOSEN   
KHWSVW          : MAPA            QNMODD          LCWDSCFTGIVQVGL LVKCPCVVRIXBLM  BHCBKWD         JVRKMUXEMYFVN  
GBGTDTNDITTCV   : TIAVVX          PXCYGUIRHMPKWV  TNTEUL         
TPUIVRWFBAPIYKF : QVSJUUTUITDTX   AKBLUSRMUHIW    JHMJWWEROQHRHS 
FNBLHGHVJPRDT   : VQISICLHCSMQ    SNWSCIH         SCKTEUTJ       
VOFRWDJW        : KJBHPEWWK       SCRPGJQSOCL    
MYBVXODXTQ      : IVKCPPHMLWJYPSU DIVDS           MAKDK           OCGUJEQTND      GMOMDRPTYN     
HAFOXOHRUBHQP   : WXFBGAC        
KNQWMAJLC       : RLQNYIKY        XUJXTGCEKQOWCJX SRFYWYWEXLHTGOJ
LQKJM           : VSRNXTVERSSU    KGHLON          BTQP            AMWC           
IVEPMEG         : OMPYQYKPA       HRQXFCDPN       UPIRBY          KYWRRQV         NHACNXHCNM     
WBVEUNRFBLCPLOB : IQRRYKVTONJYES  XVTVXD          UVMBKYVPEFOO    UQGUCHONLGGY   
TMIHVWIGUOV     : SNRROKNVKUSV    RQPKSNSRVWAMNQ  VGXBKLW        
TDES            : LXOWMOOJ        WHLARNCJDQEFMPG OXAYBVULSAUI   
CWDQRJ          : FSUJUENQEDM     XQFVJRVQY       BTQP            DCECMPARPSIVTA 
DNKQENJBBRIYRS  : MBQF            VBNHXQXKKC      VPVFIROMOVSJ    PVHORWW        
MIEWEJEWSI      : SNRROKNVKUSV    SROWISLDTSWH    LVKCPCVVRIXBLM  OOJCUSMP        MAULHPK         MEVVJ          
VBNHXQXKKC      : GXSRFEBTA       OUPPLVCV        DNKQENJBBRIYRS  NWGMR          
TDBNLBFFJUP     : IUEXMI          WUTCHOUPPYKDYP  NJYNJYOBD       GEOAIQHLMCSOI  
TTCXSWJOUK      : XPQEQF          GKCCGEWCMDHN    VKMIIWNDNB      JDFUIVKGAYO     UBQVPM         
DIVDS           : HTFRWADSPWFTN   ANTQHYCP        EEBQVNKPUJ      MYBVXODXTQ     
FTCLUQYXVEJSV   : LQUTT           EEBQVNKPUJ      QBHNKMC        
NRGNKDWA        : RRETYLGJHMU     ROLKNRVK       
KFBU            : QYFR            ANDEIWQF        CDBCYDDB        GXLOJYMSGLVLD  
GOMMKOAFHYEGEP  : JXIURNLTNH      EJUXXUQIFXECLPB PJXOSFIGGUN     UCMYIJFECGLGIY 
CRMUXDFBA       : JQOUAMJAQUQCMBQ ANDEIWQF       
CMOFI           : WBKBNI          GOMAHDMVYOAG    XEJXMIIAWLX    
MYHBJXBQI       : CJNFKS          GCQITFKFIDLQRDY HNDLCHPDHJDWM   ISHLUQSSRD     
WOGNNJHDEG      : HDUQMH          GXJRSMLRL       LJRPBGIOHLUDPM 
JJITNV          : PQQNMQDCIDKOS   ORITS           LCWDSCFTGIVQVGL REIRPU         
TGDGFMJQNKHV    : EGAVTGQ         GBMMMMJNSETRK  
FKRSABADFIJQU   : BVAO            JYJDBGJF        BWURFPCTRSRUQI 
MIQVCW          : YNBCSB          BDHXAC         
KEOTUEECA       : SXFCUJRLN       PCYI            COPJSNNTG       OYHBPBOXNNCCDO  LFXSDCORFSUEK  
HMJCMMFQTPCMKWA : BKMDLTW         NPVIMW          FYOAQTRYKYRE   
PXXOYJSPF       : WREGHYNQFDLCE   SWWHWF          UEFT            FPNEHXKCNU      FGGWRVRXCOK    
TKSVECINHVCMOX  : PCYI            EPJYFLOM        YDLXVSUVTALKQX  OOJCUSMP        TFAKPG          WPQJSF          WSXLCQI         BRWUUDVTN      
TKSVECINHVCMOX  : FYUDTKPJO      
QKPOK           : LMWPV          
EIJTKSOCB       : PITORUG         YCTAGJIEQIEGJWY LTAEHHMWMLGRORL
WLXUPAEFHCJVQH  : WNGOXC          VCFIDIIABK      POSJUPUMRPC     UEFT           
HRQXFCDPN       : IVEPMEG         ARWDJSDG        FCCPPGERBUO     QFTSRGWCT      
CJNFKS          : VFXCBLXI        MYHBJXBQI       RJKCNKBDPTAV    OLXHCHAJJDRPNYV BILLGDY        
VQYN            : LXTAIEKRXQOXLE  RWMCVWT        
FUBHEAA         : NMOOCCJCIFUD    KBTIWIWDLHC     HMFAKQLMV       VESAWQLIHHE     LLDHQ           KPIN           
BIFTGKXLDL      : IAFAO           QLOKLEBFGIYY   
FUYKFTOD        : TBSKWTDBLQEA    JYKYVHGE        QMROLYNX        HLCGRGOBEAE    
QSFVNIG         : PCYI            SQOXCFCXFQ      PJXSQ           RQLGOKXK        HFADVKX        
KGHLON          : HHHKINU         EMBVJNFKMM      LQKJM           FXRRGAWCFOHRH  
XAHJFTWLQ       : MFKNHWFCNSMYKMT KOBXEIRLPWWES  
XWRPCFGX        : PXGVEU          YSEJQIQE        ONSTQ           RQLGOKXK        KPYVWRATH      
ELXKIIRRWIFEII  : CFOIATCLBBHTUGF XIOUCIYJJSIE    VVUFWQYHG       UFYQPECW        KEWKHOVW        LJMGRIS         KTAJATGSQDFBGJ 
UPIRBY          : QCXALQHOOT      FGVWSFTVPCDDOTK IVEPMEG         AYYKNRNANGUNQJP XOUMXO          KVIXXWTKKTMB   
CXJRBPAYCEMARW  : QRLFQBIBBFHRUI  SDYTTD          HRICMEDDCAVEALB
LPITWMFHBAXLRBL : ASQHNMFA        GTCTADFWRCRCUMS
DLUWOK          : TBSKWTDBLQEA    GUVMXLCYYNTUTF  DSSCJKDS       
PPGFR           : OIXRN           LBJPTYJWSFAU    DCECMPARPSIVTA  RBRWWK          IMQAACU         PSMQAWQKRQFNLSH
CDJT            : IAVRI          
FRBK            : TNTEUL         
EKYQEB          : UTODVHOLWGOQ    VXUVGNYUD       RXJKIJGNTE      XPKQLTT        
NGPJGFVFU       : LBYNWDDU        PIRTGUIRFPJ     SXINSFXHM       QLETBR          YSYUDE          NWGMR          
LAGLDJUYXBQY    : BLJJ            CDUILGH         GGXOUVY        
SDYTTD          : OUPPLVCV        CXJRBPAYCEMARW  OUCGJY         
XTEOFM          : YNBCSB          DTKRQFNFIXEEQIJ SXQCKU         
BTQP            : OTLOILNYUCVJBR  YJPHCXPUI       PDULPE          RCXXRD          LQKJM           CWDQRJ          GKERRS          UBYQGV         
RXRWHPVH        : XKLFWRB         AOTFQOUELAS    
PGEKKDEGHCHD    : BWTLICD         TFYA           
XIWT            : OGSS            ABYGRMCRPGYMTJB IBQOLPFMYICA    IWITDWMHS       INLBVS         
QMDYEBTDL       : DIKNIUTUWIYMWV  GUMM            FTUQUCTINWMCFE 
CSCTAGG         : QCXALQHOOT     
MMUVOEYYCHVX    : RMKVOY          XMJVEDEHAIMO    SIBCAGUQ       
PLWOR           : ADFXJWXFC       XMTLDOFOG       SKTBFVS         HPGE           
IVLRA           : AUMDAORI        NWFOR           HHHKINU         TRKHWDIF        TEGNGNKC        JVKAMQJQEDVR    WTGGBVFAYKJA    QONM           
VVJFCVROSPGX    : GGMXKAOCBXTGLO  AAJS            YORUYCQ         PFPHOE         
HCXEBSTOPKG     : GKUQ            PYFSEBFGPT      BSJSQHTYGKKTCP 
TEGNGNKC        : IVLRA           UFKVB          
REUJTQ          : KGVNFKMEUPBLLV  OYNJSPMLB       CTVID           MPBPCINSGV      CNKBEMIPMX      XOWHNXPOG      
COPJSNNTG       : QBGWAJUKEMS     KEOTUEECA       ROJYCHR         ACILFKMWFY      UEFT            PVHORWW         DRQLXFLGYS     
KYWRRQV         : GKJLFGQ         IVEPMEG         GAGMJJ         
GDOQHLIM        : HJLN            EGOTD           EFFFMJYOGQYOXXG RXJKIJGNTE     
TIAUKQMTJAKG    : YBDVG           JDFUIVKGAYO    
VQISICLHCSMQ    : QXDJLSARUJUIA   ONFV            VWDCJPQWGWTRJ   ALQMXYSCVW      FNBLHGHVJPRDT   LBCXWQAQL       PBUKHXRPO      
TFUIOQSOODHBAQC : ANTQHYCP        EJEMQDLXYCLGSK  JYEXPLBPVLIS    GOLHGFBHYL      TYYTDFKOPRORWKD
WNGOXC          : PIML            WLXUPAEFHCJVQH  TFGKXQMKFG      MVYRWGGYDX     
ANIEGWXSTFPC    : EHEJNUIT        KXCTLWEGTL      HVIMXPSHCKIRDD  SXINSFXHM      
GVKUB           : TCHVRGBXBEUFCUP JOKDS           ABIUFHKC        NJYNJYOBD       PBSRAJYFSQPHQSD
WBKBNI          : ITIMEIVGNCTG    EJEMQDLXYCLGSK  CMOFI          
WYMYXOMJUVG     : GYMTVDEGGY      SHYY           
OAXGFTM         : LBCXWQAQL       GTCTADFWRCRCUMS KRGIYG         
GKEAJGLKT       : XVRGUYUKTD      XEJXMIIAWLX    
BSUP            : UUEOJKAITFYH    EARTSKFDG      
UEHEBDN         : WOBCLPULLXP     VPNHQRR         EOKKJSBKA       MEQUDJBCQI      BWPRNGGRFTKOGTB JDERILC        
TNUASROVA       : JQQKSVAFLS      UAOSDX          HRIMS           BLWXCMEPDL      BLRKLCO        
BDKJOWFMA       : SWKVECSVRRGU    JEXWNOFMH       VYJYKYVQAIYPCA  HRICMEDDCAVEALB
HPSEVALXFYU     : PUIRXLTSXMN     OYQOMBPHTLPWY   DULBTTAHTVLAK   FSRWKQJH        DBPRHYKMEQB     LHJCBHC        
ORDKLUGMVJP     : GJGBHEKK        TECBLNDFLUPKAUN IEBBPGJHACXXK  
UGGBSHCCWUI     : KNPQT           KGJHQE          EEOKYFQIGDEDIIL UEFT           
XTTFUOHKGMUU    : DILRYNQUSYIBYC  NFVJKYUX        RJKCNKBDPTAV    JBHYNBWB        BMSRWXPEYF      NMHLRYC        
DHENYNKHVNCD    : VDKSQMATI       TNSEUMEJGJCX   
GDNOYNJUSEJCQR  : EMIYXROS        YJNGPVKBJL      QMXIAQLLC       NOODYLPAKTHWPOD
LMWPV           : WMOHXXEKUMIPJ   FGVWSFTVPCDDOTK SREMPXF         RPWKEXABUE      GNDOEQMOOXUNIY  KAOCTSUPG       JYEXPLBPVLIS    QKPOK          
LMWPV           : POSJUPUMRPC    
FUQPEP          : JAPYWS          KMKGM           SFBBWRXQ        INYRBGL         ONDTINJRHUNQB   GJQLWXOSYLND    JBHYNBWB       
GUVMXLCYYNTUTF  : WCYL            TDAAEI          DLUWOK          UFKVB           QNMS            MVBFX           GXLOJYMSGLVLD  
LXOWMOOJ        : TDES            TIRAPJQIUMBSBSI
VELOJBURXSFYH   : QIYRWC          JFEYJL          TOUSTWJ         JGTP            BWPRNGGRFTKOGTB JUCAQWPK       
XIWUDQADCA      : FBLVPPPJSNPOG   AAJS            LMOFIYLTJAU     UCPCIQIKN       SJXRWJJJMWY    
CNISWDPD        : VNQC            WKTHUUUBDSS     PSUXJBOQWYTO    QMUUELRLFEYOSYO VPVFIROMOVSJ   
GOTBJRVOQ       : TIAVVX          QAUHQKQXMOB     SIIFUWL         CPHL            VFJVLPDECLWVEWO
XRMWMRNOWSP     : MDASUKDPGAQDIH  DTAY            FXDYKSOLAI      FFMFHYKDMNHYDH  PPSCSTMNHRUXFJ 
WFCPEHHJXNYRQIK : NTMFFBCFFPE    
YDQYUFVHXLYUEQO : GIGN            LMYVKBBVYFAI   
VRTAYBJAPKRGUEV : PEWJMYYVVNSDSAG TBWFSCSRMWT     NIPYRRFECQQ    
KNUFUSPSFO      : UMVWW           JSVHPCBFL      
LFFNDYJFBKQBC   : UBAXDGLULMHJM   KNPQT           DDPLGPCKFCV     GYBMNTAUAYJSBB  BGFKGEQEFD     
ULBCHXMWUTSO    : HEVMUDE         KBQPJXOI        PMUDA          
LTAEHHMWMLGRORL : EIJTKSOCB       PETI            CKTCXAYN        VMXULFUTVFXFAAI CTVRAWGCNCVON  
VPNHQRR         : HFPOLJRKSIMHII  CSGWORMGLYJ     OLVIXLGVJBSYXX  UEHEBDN        
GOMAHDMVYOAG    : CMOFI           EBDIXUPJNCV    
MENBK           : POTNQKDSLTM     NGXUPNQQK       EWQUL           BWURFPCTRSRUQI 
PETI            : CUTABRKTUQCE    LSNA            LTAEHHMWMLGRORL OYHBPBOXNNCCDO  EBDIXUPJNCV    
LVKCPCVVRIXBLM  : JUER            KHWSVW          MIEWEJEWSI      OXAYBVULSAUI   
MEASF           : AJWIOQYDNSW     NPYUHLVWACL     VOFI            XHOCTPMD       
WSPKBIOWQR      : KGJHQE          QBGWAJUKEMS     LSWYAOAC        XEBRFWUFEGLS    TRPDGUPCSDI    
ODLEHHC         : BKVHNJFPHRJBYQD PSUXJBOQWYTO    ARPOUCSLY      
RCDFP           : PFWUBAVHARX    
RVCKBTKTJ       : RNEFAQTUGUPNYMA QOJFHOBDFGCKA  
XTLUKE          : NGDHWWUTRGUQOE  SIIFUWL         VGLHFYAJ        NGXUPNQQK      
YJRFQBJSSMVAEA  : OWPXXUL         WSVQGWC         PFYFPHKTLXAQ    SCTEIQGAOXMBS  
ADEBWOWILWDXS   : LSWYAOAC        GAGMJJ          GEOOKCFHVEAPFAU SPFQOPHITUW    
EYRNQW          : JQQKSVAFLS      OBGPPGHLRFJC    MNLPRQXACM      GEOAIQHLMCSOI  
TJBMVWOAXGAD    : PIXVWLHNCDQ     TIRAPJQIUMBSBSI
DCECMPARPSIVTA  : BDUOJX          OTCIXPPYUQGEVSI CWDQRJ          PPGFR          
KYSGITSG        : JDUTUHSUXMTJCWK CCDAHCMOA       FJLTAWFBN       YMXFVJVRFKUQ    FKSRFACSLWD    
JGTP            : TMAR            VELOJBURXSFYH   TODKGHH         JDNLXMFSS       DSLRPEODDDESAAL AICOCHEYQ      
YEND            : ASCYOWPHSPTT    THDKAGUW        OSXKVE          FTYCMQIFF      
QPBQIQLSPFUB    : MCRTLJIKGHV     HPGE           
VTXFQSLMC       : DPYRKERRSHL     JENS            WYCW            QAYKD           IMQAACU        
GTFFXTK         : ISVNTFDBUANXL   KKIWALUGUMU     QMEARBC        
MAKDK           : LYVRUN          LBJPTYJWSFAU    YMOPY           KFFXWGVNLFOYN   MYBVXODXTQ      KUDOJX          XUMLNFON        NGYQWS         
MAKDK           : BSVILFUFQSH     OJXBNXVPCUIC   
QFSVAUPWQNEHIRV : VSRNXTVERSSU    KAOCTSUPG       SWWHWF          AYYKNRNANGUNQJP RIOGQNEK       
OCGUJEQTND      : OPDEUTKOWQQJB   TRKHWDIF        MYBVXODXTQ      ASVNS          
XIHCYPUWR       : WGUMGNHN        QRLFQBIBBFHRUI  QULSFOFQRW      MXAEXAWCYCUWMSU NINKSD         
OOJCUSMP        : OMPYQYKPA       MIEWEJEWSI      TKSVECINHVCMOX  XSOGNKVHRCKOEYN QNMS           
YETF            : CFOIATCLBBHTUGF BWTLICD         AEMCJABXJC      NGXUPNQQK       DRNAGPCTOFMCF  
ELRA            : RNVF            UNIDM          
WWCFHEGYCFQTT   : SXEBUPSAFEE     EDLH            IYAYNXACIW      TRPDGUPCSDI     BDHXAC         
FXDYKSOLAI      : XRMWMRNOWSP     GEOOKCFHVEAPFAU HVESEQD         AYPEXDOJ       
BOFVRHSOJB      : GYMTVDEGGY      DHEQWRTHDA      EUHGAFUIOMETEFW BBMXS          
QJWSPOOLWUMCTW  : GVOFKYM         JKMDWTUOOF     
KJVUCYMHUEOOSBR : NDOUCKA         EJVTMLTM       
RBQKSHYFGVRJPQ  : YRSTGBLS        MDKPIP          HYRVULHDH       XEJXMIIAWLX    
CCDAHCMOA       : SNRROKNVKUSV    WKDBHPB         BJEPLLXJIQO     KYSGITSG        PPRKTDMJF      
GOLHGFBHYL      : GMKDK           TFUIOQSOODHBAQC HKSGGFDBL      
IMIPJCY         : YBDVG           XOUMXO          BWURFPCTRSRUQI 
UGEALEHPS       : MDKPIP          BJEPLLXJIQO     RYXFFB         
PJGGWNMFOW      : NYMGDB          RGLWBWJIKUCQW   UTXSRYXEGFCGBNC NQFXHLD        
CAORKGBOHE      : DXTM            NKLBQURJTJUAQSQ CSHTNS          IXPVHUDBCPIWPQW
NKLBQURJTJUAQSQ : RQPKSNSRVWAMNQ  YIXKBCPIOKKLQ   CAORKGBOHE      MAULHPK         CQMYOJNY        QODYOBELXPUUS   CPHL            SCRPGJQSOCL    
XHCEMEUEQC      : DXTM            EYFJOVSLLWRJPS  UUEOJKAITFYH    BQUNPNSD       
FJLTAWFBN       : QEETRU          KYSGITSG        KOYKTEOUPV      TECBLNDFLUPKAUN
UXWF            : XRNMYNCKAUFOPYM NGXUPNQQK       CKJTA           CBAQOJKX       
YVLPBLAEPMKNQCP : HBUUMQYEHPOBWBF SXGPKLAJODDC    XXPHQQL        
JYJDBGJF        : SIWHFVOVLPRSEN  FKRSABADFIJQU  
MAULHPK         : CDUILGH         MIEWEJEWSI      NKLBQURJTJUAQSQ EOKKJSBKA       EWFJBHSPQDO    
EDHPDNIPXVICL   : XVEKYYMR        RQPKSNSRVWAMNQ  OKTEMBE         DDKSTX          FAKFMSCUH       OAFKMS          GGFIFVTWPYK     VUQBA          
MMRPQYBVVPVS    : FDWDPBSII       CIDTX           EQRUGFASMSPYOAS
EIOJMRQF        : EYIE            KUWPTPQBVOFIT   TPFP            TVMJAKOQHCM    
GNMHJUJWB       : WJYLSE          VUWPHMDMVXNEP  
JSOATRXRKUML    : GLSUWSKLDCIO    SNAA            JSVHPCBFL       XQBFUQPDN      
VCMKTEPOMDDTOX  : KEMNEIDYDHNS    RNJPGCGFRJX     QRCVHDJUWPGVOQB
LBCXWQAQL       : VQISICLHCSMQ    OAXGFTM         VKMIIWNDNB      TRQVGRTXTOGYVQE
LVVXJYVMLJ      : WSPSCJXENDKYD  
RYXFFB          : UGEALEHPS       JVRKMUXEMYFVN   VESAWQLIHHE    
VCFIDIIABK      : LYBMFHRHYGDGRJ  EGOTD           WLXUPAEFHCJVQH  CXHIMVYRUKH     OFSVHAKJVPXPHES
OLFKJFUICJU     : DGMYQQUQOVBJ    YDBR            NQAS            OWPXXUL         NMHLRYC        
PMMPRRTTQV      : IXEQEIDEQXKJ    KMTVIKTDEM      JBHSRUVOQCGX   
YYJJANV         : SPFQOPHITUW    
CIBPTGMDKVXXN   : DDATMSUE        HUQH            WCRQGHJSYXGX    HEVMUDE         BMSRWXPEYF     
LEFFAYVVAW      : DDATMSUE        FACQU           VPVFIROMOVSJ    XXQLGFT         DCLQGUI        
MIWC            : ORITS           WYAFHY          IAVRI           ISHLUQSSRD     
QGPRV           : YIXKBCPIOKKLQ   WYAFHY         
BIMLEMKUAXYFDYG : QRKYSTILEOWY    IOFOCPTC        BLIKDPKLSQFFT   WLRIMHK         IAVRI           YORUYCQ        
WGYTUKRWPKEHFC  : JLTRLIPXXX     
GNITTUE         : OYQOMBPHTLPWY   EDYUJ          
UCPCIQIKN       : VBXDAFCOGSV     KBXPWEWSWVFN    YICH            XIWUDQADCA     
LIMVCMNMSWRUQA  : MVKPAV          AAJS            PWJWAO          XALJQJD         QBONVAMKWJXFMM  YRSWMNKGJL     
BUDXBRVGI       : XYUNJ           EDCLEELU        MMMCUKKFR      
OYHBPBOXNNCCDO  : WEAO            NXLTPKAAPYLGAUY KEOTUEECA       PETI            MEQUDJBCQI      AYPEXDOJ        ONSTQ          
BJSTJBWGG       : NXUB            WGUMGNHN        SVMLWHNOBKEQW  
IBQOLPFMYICA    : QLUSL           VQPBMAMLPY      NSQSDHAAMFPFR   OOYTHOU         XIWT           
CPMES           : DOGUE           XLEAEJBFHS      OGJULAOV        UDNEWOGFTEFD    SXGPKLAJODDC    EDLH            KHAEJDFXC      
VPVFIROMOVSJ    : MVDTWGXEFMIUGNK DNKQENJBBRIYRS  CNISWDPD        LEFFAYVVAW      LHEQHBCMMUGAONX VIBBQQ          JHFBLASFRNVCH  
TBWFSCSRMWT     : XVEKYYMR        YXQQGLFAG       CFOIATCLBBHTUGF KEMNEIDYDHNS    FACQU           RCOB            XGOH            VRTAYBJAPKRGUEV
TBWFSCSRMWT     : BWPRNGGRFTKOGTB LHJCBHC        
AJBEETAWPH      : LBJPTYJWSFAU    YPUQREKQQBGP    HBUUMQYEHPOBWBF YAFRDRVHTYC    
HYRVULHDH       : RBQKSHYFGVRJPQ  PWMXS          
ANDEIWQF        : PDULPE          CSGWORMGLYJ     CYXEKJUVNBHGP   KFBU            CRMUXDFBA       DCPUNQFJAVA     NJYNJYOBD       GYOWKMMHUYBO   
EFFFMJYOGQYOXXG : YPNUWETQU       KEYFGEAPMVGKEUQ LYBMFHRHYGDGRJ  GDOQHLIM        YRSWMNKGJL      HKSGGFDBL      
UTEXEOXRUC      : SFBBWRXQ        BKTWDVTT        WXEWBYG        
TUHNYPSF        : QLUSL           WSVQGWC        
CGUL            : WCRQGHJSYXGX    KJBBC           EWFJBHSPQDO     RXJKIJGNTE     
TCVRI           : LMYTKUUFGKEJD  
MFYKJ           : WKDBHPB         MNSYL           DGJY            ICNWOXUSWSWASI 
KDMOFHLOU       : VTFGHHRVKWBOXP  XAKLAR          NUHDONJS        VIBBQQ         
GNSKRYIFYCHXW   : KMNTEGUDYCFOLP  GWRPKCWCLPNM    DILRYNQUSYIBYC  XJGYNHJTDJ      PKYE            CLNEVPJOICV    
SJXRWJJJMWY     : BCQN            XAKLAR          XIWUDQADCA      BNREEDEI        YKIYINYSASAABR  UCIXYUSLDBS    
EMIYXROS        : PHSIL           GDNOYNJUSEJCQR  FKSRFACSLWD     PBUKHXRPO      
GUMM            : QMDYEBTDL       ROGWXKGQAWVQTME AILERMPNXBETDOS
RVROOKAOEYXO    : QBGWAJUKEMS     JDFUIVKGAYO     UBYQGV         
MNKGTW          : DXTM            PDULPE          OXGOPFTBYY      DAWGRHJX        PRJFG          
UXJJQNRLDEGU    : WIUQGDTTMGEAOK  OSXKVE          QCVQSQXNBSVCFW  RQNRJUGVHG     
XJRLJHPLH       : CUTABRKTUQCE   
UUVHD           : TKFYMPWWSY      MAORREUUPETEI  
EUKCGT          : XYOIMWOVTLS     WPFGLYH         KQEJWWHEAHUAIQ  PGEKKRBGBVHGVYQ
WMHASPUXQGQ     : KHNOAKGY        OEHPBPNWMG      MIVTJSSDWSRTISY
RATDHDAEYHIRM   : AJJXMYCJOIQK    SIWHFVOVLPRSEN  ENPIWRRAJARJ    TNSEUMEJGJCX    FPNEHXKCNU     
CQMYOJNY        : JTFUX           NKLBQURJTJUAQSQ RBMAAHU        
IOGHHOA         : XKXWRKBYMLK     QONM            IAGLPDWH        NIDYNG          PPSCSTMNHRUXFJ 
GAGMJJ          : LSWYAOAC        KYWRRQV         ADEBWOWILWDXS   KBIRCBFFJN     
OKUWCJCHAOI     : ROLKNRVK        AILERMPNXBETDOS
XXQLGFT         : FURTBHBRY       LEFFAYVVAW      UJKAEEB        
NIPYRRFECQQ     : QRLFQBIBBFHRUI  VRTAYBJAPKRGUEV LNOYWUMSYXU    
ENPIWRRAJARJ    : NLHOCABYOVYHB   OSURYC          RATDHDAEYHIRM   UBKXEMAISBOP    ADLVEBHLISPHBSN NVQXMKHQG      
IVHP            : JUER            QMHDCCJCSWCURLH VKMIIWNDNB      VOLWOSYVFPUBMOD
YDBR            : VQFBEBHDTYNVWR  OLFKJFUICJU     ARWDJSDG        RQHNVYIFINJUJBX BSJSQHTYGKKTCP 
SLMWNGPIKEXUDS  : YMOPY           NLWIBPKNNPDSC   QWBNVBUC        LFXSDCORFSUEK   CJQMDVYUEOYOJB  MADPM           PPLNNLFME      
DCPUNQFJAVA     : TDPGDADURP      DILRYNQUSYIBYC  WVSPPTXKAD      ANDEIWQF        WXNKRRRMPBQJKN 
BBQGVFT         : UCBMXMCQHJG     BGFKGEQEFD      UHWSMUFIMKUIDNO
UAKEMQEHUYUABLV : VQPBMAMLPY      RBCNYQ          AWJUB          
CDBCYDDB        : GXSRFEBTA       YYDGHWVFXUJFVS  KFBU            BHCBKWD         VRLWVANEFVESNA 
WHCCDWWFI       : CIDTX           VWJNSYSLLAVMNM  RQNRJUGVHG      ROJYCHR         QLETBR          YMXFVJVRFKUQ   
RBGAVFUWJ       : PIRTGUIRFPJ     JGRJVTNVPT     
UBKXEMAISBOP    : LSWYAOAC        HUWAFONTDSAF    CJCCDAFYLGXU    ENPIWRRAJARJ    MEVVJ           IKVIQHIDSQEPC  
RRQOOV          : UPJAVXCOOWH     INYRBGL         LSSJFNU         SRDCFQLO       
QODYOBELXPUUS   : VNQC            GVOFKYM         NKLBQURJTJUAQSQ CPHL           
VXUVGNYUD       : WGUMGNHN        EKYQEB         
OUCGJY          : IVVVROJ         SDYTTD          NGYQWS          EVPDVTAWSJTKBLD
CNKBEMIPMX      : SQNMWCWRIUONBJ  UDQHR           REUJTQ         
KTSGRPEADFWIQ   : WEAO            SEQIWFVQEJPYQ   HRICMEDDCAVEALB
FTUQUCTINWMCFE  : RAXRIISHHKYPXES DCLMAMSTMSRWP   TXKLTYXFJGOHCR  QMDYEBTDL      
GPYAIHT         : VQPBMAMLPY      BLIKDPKLSQFFT   EEOKYFQIGDEDIIL MNLPRQXACM      CXHIMVYRUKH    
NTDSQNK         : DTAY            FRFGDIMUNKEDHYD
SGALBDFJSDXUKCL : MJLQBMTQTAKM   
TNSEUMEJGJCX    : WREGHYNQFDLCE   DHENYNKHVNCD    RATDHDAEYHIRM   LKGYUFRGS      
ODRUGEV         : KOTLCSWRJ       PSUXJBOQWYTO    HLCGRGOBEAE     BGFKGEQEFD      LAMGPTMPIHMKYH  KPIN            HLLHTISKVYGC   
LHEQHBCMMUGAONX : GGMXKAOCBXTGLO  SQNMWCWRIUONBJ  VPVFIROMOVSJ    IGIYYKRMRYCIRFN
RJKCNKBDPTAV    : PIXVWLHNCDQ     CJNFKS          XTTFUOHKGMUU    TNTEUL          INLBVS         
WHLGL           : PGIKTYF         JVKAMQJQEDVR    UHWSMUFIMKUIDNO
QMHDCCJCSWCURLH : IVHP            WEYJCTEMAHINMBJ
ARWDJSDG        : HRQXFCDPN       YDBR            LRURUPIEFH      LOHJGJGPLWRKL   VFJFTYDMUWDSW  
CPHL            : OGWF            GOTBJRVOQ       NKLBQURJTJUAQSQ QODYOBELXPUUS   QRTUJPANERNR   
MCQVHUXSXRQCO   : VJQVXBHKKLMUP   FQQNTCPBUEK     TBSUTY         
OXGOPFTBYY      : BLJJ            IQWJU           TPDVXGUFEMMABC  MNKGTW         
TEXDPCR         : ACHYMCMSDNQ     JQOUAMJAQUQCMBQ QSCEKJLGGEWE   
UNBQOTQI        : BCJVQMXHHG      KCMXODB         IEKATYTTHPR     HVESEQD         QRGLQOVPV      
SWWHWF          : NWFOR           PXXOYJSPF       QFSVAUPWQNEHIRV
MLRNMRXIV       : TBSKWTDBLQEA    QBGWAJUKEMS     DPYRKERRSHL     HDXIISWXXGR     UGLYQNEEIPCKDD 
ONCGHWW         : QCXALQHOOT      TVMJAKOQHCM     UEFT            BILLGDY         BLJDEAQ        
PLEGVRASQJP     : KBXPWEWSWVFN    UFYQPECW        LRTQAXEA        GTCTADFWRCRCUMS HCDEXNQRBT      YYQRHSHFGKBDNST
IEKATYTTHPR     : KRTMLWDTCFYA    FMVTNMRYF       UNBQOTQI        XSOGNKVHRCKOEYN PEDRXGYMBVU    
DVHKTEU         : YICH            HKSGGFDBL      
RCSNTUIMEALMG   : HLLHTISKVYGC   
PCWJYHCSF       : RENMAHUPRKJ     RXJWBVDOJHF     ACHYMCMSDNQ     OAKJHKAGRN      UMFWLXFX       
POSJUPUMRPC     : YHNTJCNP        WLXUPAEFHCJVQH  LMWPV          
KMBPOMEWNTAKG   : KBXPWEWSWVFN    BKMDLTW         LRTQAXEA       
TIRAPJQIUMBSBSI : BCQN            KBGQV           DWPOIPK         LXOWMOOJ        TJBMVWOAXGAD   
HTSKJK          : KGVNFKMEUPBLLV  JENS            RGOKTMQRXI      MNSYL           AQQOWBMHJEQSO  
PHMMJ           : RDUFTQGXNMX     MOLN            OBMRPYAGOIWHBJ 
SKTBFVS         : JWLAG           ABYGRMCRPGYMTJB QWBNVBUC        DVETK           PLWOR          
NCKAFDBXLHHH    : FORPKWPTFLMDSYK SPDVSVJYNEIP    XUUCKPBPEUO     TMSIT          
RQNRJUGVHG      : CFOIATCLBBHTUGF ADFXJWXFC       YMWMNR          REIRPU          UXJJQNRLDEGU    WHCCDWWFI       VFJFTYDMUWDSW  
RBRWWK          : PPGFR           MEVVJ           BLJDEAQ        
KOYKTEOUPV      : WQPIKKYT        IQJVC           QWEQOSDR        FJLTAWFBN       NITRIVVAULN    
XBWQOQCMWXTE    : BQHOJTOKM       GMOMDRPTYN     
LFGJCT          : PUIRXLTSXMN     CWFRNL          TUAXJMGGGEA     NHACNXHCNM      PVHORWW         OJXBNXVPCUIC   
PIYCFDSASPCSQY  : PXGTWXNDDVLYUI  OLMSCPWRWT      UKARMYCW        OBMRPYAGOIWHBJ  AAJYSSGUDFQWPCB
IPOUPP          : YJDDESCQY       JYEXPLBPVLIS   
TECBLNDFLUPKAUN : KNPQT           ORDKLUGMVJP     FJLTAWFBN       KBIRCBFFJN      TFAKPG         
UJKAEEB         : QYFR            KUWPTPQBVOFIT   XXQLGFT         IAHNDF         
MTKHJAXDEA      : FORPKWPTFLMDSYK BDHXAC         
ROJYCHR         : COPJSNNTG       WHCCDWWFI       VCEVFAHY        CGPKOYAVUGDUJV  SIECPBJLPVSS   
HMFAKQLMV       : JWLAG           FUBHEAA         PPRKTDMJF      
NQEHBNSDLV      : ACUOSASCCBKWFB  KDQIDAQC        YNBAXOFMKFLKUEO
NCEEO           : PXGVEU          DDPLGPCKFCV     WCYL           
JVXYFKGHWX      : NLHOCABYOVYHB   VVUFWQYHG       DAYECYINK      
JVKAMQJQEDVR    : DCLMAMSTMSRWP   MMVPUWD         ABYGRMCRPGYMTJB AVQBBJUB        IVLRA           WHLGL           TVMJAKOQHCM    
GIGN            : SJFWVQRVK       CSGWORMGLYJ     ISWJ            YDQYUFVHXLYUEQO
UTXSRYXEGFCGBNC : LYUAWFAO        PJGGWNMFOW      SUBILRUHA      
NQFXHLD         : BTFWXQXYYSVFXF  EFHFHRTXMYFCP   PJGGWNMFOW      FALVUNIXBSBJ    EWFJBHSPQDO    
GEOOKCFHVEAPFAU : ADEBWOWILWDXS   FXDYKSOLAI      ISHLUQSSRD     
IYRLMVBBNIBWU   : QXDJLSARUJUIA   BKMDLTW         ADKJM           AQQOWBMHJEQSO  
DDKSTX          : SLAVMVJ         CLXBIFFQSAA     EDHPDNIPXVICL  
YFTFI           : EVFGSKMFIHCWEID HKSGGFDBL      
LKGYUFRGS       : HGWHURKULSFEBM  SIWHFVOVLPRSEN  TNSEUMEJGJCX    CYTEYX          QONM            GXBQUELH       
IVDQYBNFEQRY    : NPXIDPWLNN      GCQITFKFIDLQRDY ROGYLJDNB      
PWMXS           : HYRVULHDH       XMJVEDEHAIMO    BMSRWXPEYF     
IEDUNDQSWY      : DRVKBBAROJMA    RBAEBXSWH       SIWHFVOVLPRSEN  JLTRLIPXXX      ERYCKAEYMM     
MJLQBMTQTAKM    : SATIIGS         BDUOJX          OSBNQQBLUBJUA   SGALBDFJSDXUKCL UCMYIJFECGLGIY  DPLUSUFKERFHHR  XHOCTPMD        PRJFG          
WEYJCTEMAHINMBJ : KXBVTASIELHYI   JYEXPLBPVLIS    QMHDCCJCSWCURLH NQAS           
AYYKNRNANGUNQJP : QBGWAJUKEMS     UPIRBY          QFSVAUPWQNEHIRV
NQAS            : JYKYVHGE        NVTBH           OLFKJFUICJU     WEYJCTEMAHINMBJ
GFNOPDDQMPTOQ   : WKDBHPB         KJBBC          
CKTCXAYN        : OLRGNPHFUUQOWYY ULKGL           QCVQSQXNBSVCFW  LTAEHHMWMLGRORL WUTCHOUPPYKDYP  OSBMB           CVPVYJ         
IGIYYKRMRYCIRFN : AVQBBJUB        LHEQHBCMMUGAONX UBNUS          
SFEHVKLIENIF    : WKDBHPB         XRNMYNCKAUFOPYM MFKNHWFCNSMYKMT BRWUUDVTN      
WYAFHY          : QNMODD          MIWC            QGPRV           PFPHOE         
TSSL            : DTBX            SIBCAGUQ       
UVMBKYVPEFOO    : WBVEUNRFBLCPLOB SXQCKU         
WTGGBVFAYKJA    : PYQTAFEGAQR     SGSVIA          IVLRA           LJMGRIS        
DTKRQFNFIXEEQIJ : LYVRUN          LUCLURBCJOXV    ALQMXYSCVW      TMNGLAXB        XTEOFM          RRKYNTQD       
AAEVJK          : CNVYOHTD        VBXDAFCOGSV     TFAKPG          NSQKHVH        
HRWGEGHVLDIDT   : UGOXIBAUYSOLN   KOBXEIRLPWWES   RQLGOKXK       
TYYTDFKOPRORWKD : TFUIOQSOODHBAQC IIPTDOYBLUU     OJXBNXVPCUIC    FHNLMKVNKOFTIM 
HLCGRGOBEAE     : XYOIMWOVTLS     FUYKFTOD        ODRUGEV         FXRRGAWCFOHRH   QNMS           
GAHC            : WDITFJKEDGEKMN  KAOCTSUPG       KWDNDUJISFA    
GVFNHTFBKXXUB   : LQUTT           VWDCJPQWGWTRJ   RCXXRD         
EOKKJSBKA       : YFWIYCTMBDRIBHR UEHEBDN         MAULHPK         XEFLODRRHYUPOJH
ROJTVNVEKDST    : GQNSCDBYRMS     SDYROGKXKFQGHIF XSOGNKVHRCKOEYN IAGLPDWH       
XUJXTGCEKQOWCJX : KNQWMAJLC       SPFQOPHITUW     NITRIVVAULN     CHNCSFMTRFAGC  
JBHYNBWB        : PQQNMQDCIDKOS   BKMDLTW         XTTFUOHKGMUU    FUQPEP          TRQVGRTXTOGYVQE
CNCWH           : VDKSQMATI       KTXKXYEOASPQMRK FYOAQTRYKYRE   
UFKVB           : TEGNGNKC        GUVMXLCYYNTUTF  GDQIJMVJFYBFOB 
XFDQV           : LQUTT           KEYFGEAPMVGKEUQ WEFYJYWTYCGAWH 
TFAJPEQQTTPWT   : VRXFKFCAYF      WLRIMHK         WOJNRF          PWCTUJIXUKSMIV 
LXOUAMAMIBGII   : AOTFQOUELAS     WISLE           WJYLSE          FTYCMQIFF       SPRIMQTGAAAODQU
YEOSMOECUUUORKO : NGDHWWUTRGUQOE  ABIUFHKC        YTWYHGAOPYF     LJMGRIS         HWHRTNOPYK     
FALVUNIXBSBJ    : ABIUFHKC        NQFXHLD         AMWC           
KUDOJX          : SCOLCONHGB      KBTIWIWDLHC     MAKDK           GWSF            BGFKGEQEFD      FUBEP           QXDVNV         
BDHXAC          : LXTAIEKRXQOXLE  MIQVCW          WWCFHEGYCFQTT   MTKHJAXDEA      VIBBQQ         
RPEFUET         : NRXFPPBCLHWNEP  TEOAKT         
BHCBKWD         : KHWSVW          CDBCYDDB        FJEVHA         
BNREEDEI        : OXYPETAYDMOPK   YMWMNR          SJXRWJJJMWY     UHWSMUFIMKUIDNO IXPVHUDBCPIWPQW PPPQWCBSET     
HRFI            : JSVHPCBFL       YLBNJGOPHOSQLCA LNOYWUMSYXU     VFJFTYDMUWDSW  
UCMYIJFECGLGIY  : LMOFIYLTJAU     ROQDJUTF        QCVQSQXNBSVCFW  GOMMKOAFHYEGEP  MJLQBMTQTAKM   
NUHDONJS        : UXEMBUAA        JIEHOUFAYH      KDMOFHLOU       KWDNDUJISFA    
TBAMGKHDM       : DWPOIPK         SUTB            VFJFTYDMUWDSW  
EWFJBHSPQDO     : GRIMOAXBXK      JYGDMHRV        AJWIOQYDNSW     MAULHPK         CGUL            NQFXHLD         OWPXXUL         OLXHCHAJJDRPNYV
EWFJBHSPQDO     : VOFI           
QLETBR          : MBQF            NGPJGFVFU       WHCCDWWFI       QAUURN          XHOCTPMD        JFSLDQEYHMVLRD  LMYTKUUFGKEJD   GDQIJMVJFYBFOB 
QLETBR          : OFSVHAKJVPXPHES
VJAW            : JWLAG           AOYVAMCKIKXN    MTBFC           KNXXXSTNW       UMYH            UQGUCHONLGGY    CLNEVPJOICV    
MEVVJ           : IQJVC           MIEWEJEWSI      UBKXEMAISBOP    RBRWWK          UBNUS          
ROGWXKGQAWVQTME : ANTQHYCP        KANOXUFOICSADOF UCBMXMCQHJG     GUMM            KQEJWWHEAHUAIQ  LVHXOCMROKHKU  
IFROBCOYNDFKYO  : LBJPTYJWSFAU    LXTAIEKRXQOXLE  REVLPO          EVPDVTAWSJTKBLD
QFCPGMXWOV      : FSUJUENQEDM     LKIYYQBMGGRS    ANTQHYCP        PXGTWXNDDVLYUI  VCEVFAHY       
HRIMS           : TNUASROVA       MADPM          
RMKVOY          : JXIURNLTNH      MMUVOEYYCHVX   
FCCRDSNTYPL     : EGAVTGQ         VBXDAFCOGSV     FFGB            PYQTAFEGAQR     PMUDA           UGLYQNEEIPCKDD 
FJEVHA          : QEETRU          BHCBKWD         GKERRS          XVBHIYI         IKVIQHIDSQEPC  
ALSUHMHRIYSFEWJ : XGOH            WHCDGLRFMOCBHFV AQJFUHVMM      
ADLVEBHLISPHBSN : IUEXMI          GOPUSRNVDGPRG   ENPIWRRAJARJ    BMSRWXPEYF     
GGXNUHHEG       : CHNCSFMTRFAGC   IAGLPDWH       
LMYVKBBVYFAI    : YDQYUFVHXLYUEQO IIDVFRDKSFR     VRLWVANEFVESNA 
KBIRCBFFJN      : WVSPPTXKAD      XNVSLDFYYOHF    RGLWBWJIKUCQW   DQVOYANUFUHSIYM GAGMJJ          TECBLNDFLUPKAUN NHACNXHCNM      EBDIXUPJNCV    
YJNGPVKBJL      : BTFWXQXYYSVFXF  NKKMSTNCYB      GDNOYNJUSEJCQR 
VMXULFUTVFXFAAI : MLRTO           DRXGRQDEUS      LTAEHHMWMLGRORL CLNEVPJOICV    
ISVNTFDBUANXL   : PHSIL           KAOCTSUPG       GTFFXTK         MAJWAOEG        GXBQUELH       
XJMXEBEYWCHUH   : JAPYWS          HELYYFGB       
XSOGNKVHRCKOEYN : SDEEIVASYDSTSF  YDLXVSUVTALKQX  JTCNKAPXMCKIX   PJXSQ           OOJCUSMP        IEKATYTTHPR     ROJTVNVEKDST    PFXJUO         
XSOGNKVHRCKOEYN : ODNYOO         
YLBNJGOPHOSQLCA : OGSS            HRFI            XEJXMIIAWLX    
UPRICQQWSDLWC   : RPWKEXABUE      TYWOCPVTWGUS   
OBMRPYAGOIWHBJ  : UXEMBUAA        XUUCKPBPEUO     PHMMJ           PIYCFDSASPCSQY  JUHEL          
CSHTNS          : SROWISLDTSWH    WPFGLYH         CAORKGBOHE     
ELUW            : YIAYKOQRDHNQ    OGTUAYHA       
JVRKMUXEMYFVN   : GKTTNVCFCFTYSL  GOPUSRNVDGPRG   NIHGVDQWV       KHWSVW          RYXFFB          QHUFXFA         YRSWMNKGJL      LRTQAXEA       
SXQCKU          : QLWM            XTEOFM          UVMBKYVPEFOO   
ROLKNRVK        : JRRGANJWM       STICMKIUTUSWNTE NRGNKDWA        OKUWCJCHAOI    
NTMFFBCFFPE     : WFCPEHHJXNYRQIK BMSRWXPEYF      PFXJUO         
LTEERVJCQHWIUJX : SXEBUPSAFEE     QNMODD          FOXNJLEJSDCFODB QMXIAQLLC      
IIDVFRDKSFR     : GYMTVDEGGY      LMYVKBBVYFAI    JDERILC         BBMXS           LOHJGJGPLWRKL  
WXNKRRRMPBQJKN  : IVKCPPHMLWJYPSU LSJFGOGSGDPY    DCPUNQFJAVA     VCKCDLSLWCNYCM 
FXRRGAWCFOHRH   : OIXRN           MDASUKDPGAQDIH  INYRBGL         KGHLON          HLCGRGOBEAE     KQEJWWHEAHUAIQ 
JHMJWWEROQHRHS  : AVQBBJUB        TYWOCPVTWGUS    TPUIVRWFBAPIYKF NGTTCVOIKPX    
XMJVEDEHAIMO    : JUER            MMUVOEYYCHVX    PWMXS           YSYUDE          VUQBA          
HVESEQD         : OPKMWIOXWO      ULKGL           FXDYKSOLAI      UNBQOTQI       
QHUFXFA         : KDQIDAQC        KKFTVVN         JVRKMUXEMYFVN   IHCP           
XEFLODRRHYUPOJH : ONFV            EOKKJSBKA       LJMGRIS         UBNUS           ERYCKAEYMM     
GMOMDRPTYN      : MYBVXODXTQ      XBWQOQCMWXTE    IIPTDOYBLUU     QXMYDLPJK      
YSEJQIQE        : MMOEMAWTCWJWFO  XWRPCFGX       
UYTEXOWMXEK     : DULBTTAHTVLAK   WEAO           
QAUURN          : OIXRN           PLTMYYBGN       YTWYHGAOPYF     NXLTPKAAPYLGAUY CLXBIFFQSAA     QLETBR          IUNOWFYSK       IMQAACU        
QAUURN          : BWURFPCTRSRUQI 
TBSUTY          : GWRPKCWCLPNM    OQJUMCFXPBS     KXBVTASIELHYI   MCQVHUXSXRQCO   GQLECKMCINT    
MIVTJSSDWSRTISY : POTNQKDSLTM     WMHASPUXQGQ     RHPHM           ABSBXNXRN      
YRSWMNKGJL      : RMOELQNMU       LIMVCMNMSWRUQA  EFFFMJYOGQYOXXG JVRKMUXEMYFVN   AICOCHEYQ      
EHBLTJJPSCKYB   : JAPYWS          AMJLOFAKQ       XVTVXD          OAFKMS         
SVMLWHNOBKEQW   : IBUWUXUFPKKE    BKMDLTW         JPBLNTQMES      BJSTJBWGG       SUTB           
AILERMPNXBETDOS : QLWM            JSEQVXHMXFSTIWL GUMM            OKUWCJCHAOI     WSXLCQI         OFSVHAKJVPXPHES RIOGQNEK       
UNDJ            : DRXGRQDEUS      ASCYOWPHSPTT    QWBNVBUC       
ARPOUCSLY       : VQFBEBHDTYNVWR  SEEVMBLXBJV     OBGPPGHLRFJC    ODLEHHC         CPGEAROWTB      ATNHFFTE        SRPOWVODXCMN   
LJRPBGIOHLUDPM  : GKJLFGQ         QCXALQHOOT      WCYL            WOGNNJHDEG     
WHLARNCJDQEFMPG : TDES           
DPLUSUFKERFHHR  : YCIWRDVVRLEBM   OMEDNDCP        MJLQBMTQTAKM    IIYLQSDNQTGSB  
GCQITFKFIDLQRDY : DTAY            MYHBJXBQI       IVDQYBNFEQRY    VYJYKYVQAIYPCA 
GPXBIUHUYYB     : PEWJMYYVVNSDSAG ONDTINJRHUNQB   GYOWKMMHUYBO   
IUNOWFYSK       : IUEXMI          JKDMIQDOF       QAUURN          SHYY           
XUMLNFON        : NXUB            MAKDK           VOFI            JBEAHSHBRVFCMP  GGFIFVTWPYK     LHJCBHC        
UFRWPPEL        : TIAVVX          QBGWAJUKEMS    
FOXNJLEJSDCFODB : PIML            OOYTHOU         LTEERVJCQHWIUJX MAJWAOEG        IIPTDOYBLUU     ERYCKAEYMM     
OQIGG           : ABIUFHKC       
BLWXCMEPDL      : RXJWBVDOJHF     TNUASROVA       YKIYINYSASAABR 
DBPRHYKMEQB     : HQDLN           HPSEVALXFYU     EUHGAFUIOMETEFW
TFAKPG          : GVOFKYM         YIBLUAUFGL      TKSVECINHVCMOX  TECBLNDFLUPKAUN AAEVJK          HWHRTNOPYK     
SIFR            : DRXGRQDEUS      IOFOCPTC        TNYKIAYYQCKOG   OTYWL           XOWHNXPOG      
JGPYJBFPF       : YIHJGNJSYOTSV   YNBAXOFMKFLKUEO JQQLTKBSN      
HMWTABM         : YBDVG           EPNGAPUCWCDPWNM
MGINT           : CDCIEOVSDFHYJB  HEVMUDE         CKJTA           PMUDA          
TNTEUL          : TFSEQLUXCCHWNHM GBGTDTNDITTCV   FRBK            RJKCNKBDPTAV    NDIIESUVPEYL   
FRFGDIMUNKEDHYD : NTDSQNK        
NGXUPNQQK       : HJWYCDGLWH      FUYWVN          TOCIJ           MENBK           XTLUKE          YETF            UXWF           
KOBXEIRLPWWES   : AVQBBJUB        XAHJFTWLQ       HRWGEGHVLDIDT  
OWPXXUL         : VSRNXTVERSSU    GLSUWSKLDCIO    ANTQHYCP        YJRFQBJSSMVAEA  OLFKJFUICJU     EWFJBHSPQDO     OYCTWTUXOMPKD  
CKJTA           : EJEMQDLXYCLGSK  UXWF            MGINT           OAFKMS          LVHXOCMROKHKU  
KKIWALUGUMU     : NYMGDB          GTFFXTK         JDNLXMFSS      
JRQEEHEWFCRRQT  : RQPKSNSRVWAMNQ  UGOXIBAUYSOLN   FBMXIRGSOJJXPEW CHNCSFMTRFAGC   BRWUUDVTN      
CPGEAROWTB      : FSRWKQJH        ARPOUCSLY       OAKJHKAGRN      AVSFXWSGMO     
AXIWKUODYTKDQR  : XVTVXD          QVQLJWTXXF     
KJBHPEWWK       : SATIIGS         CCXXAON         VOFRWDJW        NIDYNG         
QAYKD           : VSRNXTVERSSU    VTXFQSLMC      
MDEKN           : BFIFMCMRLINLRLX GKERRS          NVQXMKHQG      
YSYUDE          : CGVRJMVMNG      NSQSDHAAMFPFR   NGPJGFVFU       XMJVEDEHAIMO   
UMYH            : SCOLCONHGB      FEEQHFJ         VJAW            CYTEYX          BLJDEAQ         GUSDTWXRBTM    
GWSF            : SXGPKLAJODDC    JTCNKAPXMCKIX   KUDOJX          XUTTLTFMJJNEALU GDQIJMVJFYBFOB 
FFMFHYKDMNHYDH  : YFWIYCTMBDRIBHR FWOHG           XRMWMRNOWSP     SWKVECSVRRGU    QUUS            AAJYSSGUDFQWPCB
VGXBKLW         : TMIHVWIGUOV     VFJFTYDMUWDSW  
MEQUDJBCQI      : UEHEBDN         OYHBPBOXNNCCDO 
WPQJSF          : TVPNRKCWIVFGH   TKSVECINHVCMOX  SUBILRUHA       HDCG            FUBEP          
BGFKGEQEFD      : JSVHPCBFL       LFFNDYJFBKQBC   BBQGVFT         ODRUGEV         KUDOJX         
EFFKVDQHES      : JSDTWVU         OMEDNDCP        DTVJN           KPYVWRATH      
OLXHCHAJJDRPNYV : WBVNOKM         CJNFKS          EWFJBHSPQDO    
FBMXIRGSOJJXPEW : PDULPE          JRQEEHEWFCRRQT 
QULSFOFQRW      : CYMXWBMRK       MJSVORHBW       OSBNQQBLUBJUA   LYUAWFAO        XIHCYPUWR       XYIIL          
IXEQEIDEQXKJ    : DQKFHDWTVL      OLMSCPWRWT      RCXXRD          PMMPRRTTQV      KPIN           
TVMJAKOQHCM     : TTCST           EIOJMRQF        ONCGHWW         JVKAMQJQEDVR   
QRGLQOVPV       : KBXPWEWSWVFN    BWTLICD         BYPS            UNBQOTQI       
VESAWQLIHHE     : UIVQGYDYRQBNY   KGJHQE          FUBHEAA         RYXFFB          JBEAHSHBRVFCMP 
TFGKXQMKFG      : BEVIFPK         WNGOXC          VCKCDLSLWCNYCM 
NRXFPPBCLHWNEP  : PFLMCOQ         KEWKHOVW        RPEFUET         SUBILRUHA      
MWJTTDYANYQCKYI : BGTEVEKKIQE     IQRRYKVTONJYES 
MAORREUUPETEI   : BEVIFPK         HUWAFONTDSAF    DAYECYINK       UUVHD           XQBFUQPDN      
FXJQRDVSE       : LUAKMDTYCE      DIFGPSBYPEYNJIC QCXALQHOOT      XIXUCCRHVHVGK   TFYA            PKYE           
RWMCVWT         : SNRROKNVKUSV    IQJVC           NFDATNJJXA      VQYN            FKSRFACSLWD    
XIDPN           : EUHGAFUIOMETEFW RIOGQNEK       
MFFJLO          : XLJEWTFYNGG     QMUUELRLFEYOSYO LJMGRIS         VOFI            KRGIYG         
TODKGHH         : JGTP            VYJYKYVQAIYPCA  AJGEGWHCQQYSX  
NSQKHVH         : MXBJKKCSSM      AAEVJK          SUTB            PPPQWCBSET      HFADVKX        
RSFAVW          : KOSGMITGVWDESKM FSRWKQJH        YFWIYCTMBDRIBHR LVHXOCMROKHKU  
YMXFVJVRFKUQ    : KYSGITSG        WHCCDWWFI       RHPHM          
EARTSKFDG       : CNVYOHTD        SJFWVQRVK       UPJAVXCOOWH     OXYPETAYDMOPK   NSQSDHAAMFPFR   BSUP           
IAHNDF          : OGWDPKENCD      JAPYWS          EYFJOVSLLWRJPS  UJKAEEB        
UHWSMUFIMKUIDNO : YMOPY           EJRO            YTMMSLRWTEIS    BBQGVFT         WHLGL           BNREEDEI       
FLYRQCBHKBQAEXK : AJGEGWHCQQYSX  
FKSRFACSLWD     : GKTTNVCFCFTYSL  NXUB            KYSGITSG        EMIYXROS        RWMCVWT         PYFSEBFGPT      ICNWOXUSWSWASI 
MTURFTKXVLFIOVI : FEEQHFJ        
WUTCHOUPPYKDYP  : NGHOB           YCIWRDVVRLEBM   TUDLPWCVUJM     VUWPHMDMVXNEP   TDBNLBFFJUP     CKTCXAYN        OYCTWTUXOMPKD  
LJMGRIS         : ELXKIIRRWIFEII  WTGGBVFAYKJA    YEOSMOECUUUORKO XEFLODRRHYUPOJH MFFJLO          XKKCPFW        
GGXOUVY         : LAGLDJUYXBQY   
SWKVECSVRRGU    : JSAIRFIBES      BDKJOWFMA       FFMFHYKDMNHYDH  UHAE           
VOFI            : UEVAIUNBW       MEASF           EWFJBHSPQDO     XUMLNFON        MFFJLO         
LAMGPTMPIHMKYH  : XYUNJ           WVSPPTXKAD      ODRUGEV        
JDNLXMFSS       : AHWIK           ASCYOWPHSPTT    JGTP            KKIWALUGUMU    
LRTQAXEA        : RQPKSNSRVWAMNQ  PLEGVRASQJP     KMBPOMEWNTAKG   JVRKMUXEMYFVN  
KREWIPHWCGE     : DRXGRQDEUS      VJQVXBHKKLMUP   YMOPY           GNVHTDCBFEJAL   NGYQWS          GITVPR         
PKYE            : CCXXAON         XACBQJQCFFMR    GNSKRYIFYCHXW   FXJQRDVSE       CYTEYX         
LLDHQ           : FUBHEAA         XPKQLTT        
YKIYINYSASAABR  : SLAVMVJ         AKBLUSRMUHIW    SJXRWJJJMWY     BLWXCMEPDL      XOUMXO          JBHSRUVOQCGX   
ATNHFFTE        : JLLRHTKETWWBIUC ARPOUCSLY       TEOAKT         
ESXIAOAYYIAJV   : QWEQOSDR        RBCNYQ         
CYTEYX          : MBQF            GLSUWSKLDCIO    AKBLUSRMUHIW    LKGYUFRGS       UMYH            PKYE            UGVJPNYTAQRBF  
IXPVHUDBCPIWPQW : MOLN            OTYWL           CAORKGBOHE      BNREEDEI        IEBBPGJHACXXK  
SXFBXQAYSYSAAQV : KXCTLWEGTL      FYOAQTRYKYRE   
ROGYLJDNB       : HQFOUNAHBT      IVDQYBNFEQRY    PSMQAWQKRQFNLSH VAGNWH         
KQEJWWHEAHUAIQ  : MJNHWOJQ        EKAAFVWLHP      EUKCGT          ROGWXKGQAWVQTME FXRRGAWCFOHRH  
CSBUOJOF        : XIOUCIYJJSIE    TNYKIAYYQCKOG   MOLN            STICMKIUTUSWNTE MOCLQAUSJI     
QRCVHDJUWPGVOQB : PXCYGUIRHMPKWV  OTYWL           VCMKTEPOMDDTOX  EBDIXUPJNCV    
XXPHQQL         : UUEOJKAITFYH    NIHGVDQWV       YVLPBLAEPMKNQCP
SIBCAGUQ        : MMUVOEYYCHVX    TSSL           
WOKCXFYNLXCCYQD : DCLMAMSTMSRWP   MMVPUWD         MCRTLJIKGHV     XYIIL          
IMQAACU         : PFLMCOQ         QBONVAMKWJXFMM  PPGFR           VTXFQSLMC       QAUURN         
DYKM            : QRLFQBIBBFHRUI 
BMSRWXPEYF      : INYRBGL         XTTFUOHKGMUU    CIBPTGMDKVXXN   PWMXS           ADLVEBHLISPHBSN NTMFFBCFFPE     NGTTCVOIKPX     JLTRLIPXXX     
BMSRWXPEYF      : MMMCUKKFR      
WHUXBAXL        : MKGSJ           DCLMAMSTMSRWP   BCIN            AFEJD           XUTTLTFMJJNEALU
QNMS            : OKTEMBE         WHILAAEE        GUVMXLCYYNTUTF  OOJCUSMP        HLCGRGOBEAE     NGYQWS          HHALFKVIMCETK  
XYIIL           : PEWJMYYVVNSDSAG QULSFOFQRW      WOKCXFYNLXCCYQD JELEBBXRXODWD  
MXAEXAWCYCUWMSU : RENMAHUPRKJ     LQQPJ           MFKNHWFCNSMYKMT KQTHYHNGUX      ADKJM           XIHCYPUWR      
SUBILRUHA       : GXSRFEBTA       PJXOSFIGGUN     UTXSRYXEGFCGBNC WPQJSF          NRXFPPBCLHWNEP  DAWGRHJX       
GKERRS          : JXIURNLTNH      QXDJLSARUJUIA   LBJPTYJWSFAU    JTFUX           BTQP            FJEVHA          MDEKN          
TWRTTWSYTPL     : KXCTLWEGTL      LSWYAOAC        TRPDGUPCSDI     CMISCEGG        GMQKIYKSXB     
NDIIESUVPEYL    : YOJBDGUXJ       PCGFWG          TNTEUL         
LRCDKVWHOSEN    : KCMXODB         LQWMJV          FWOHG           VFJVLPDECLWVEWO IAVRI           QMEARBC        
DHEQWRTHDA      : ALPYG           DTAY            UGOXIBAUYSOLN   XOHM            BOFVRHSOJB     
AYPEXDOJ        : MJNHWOJQ        VFXCBLXI        FXDYKSOLAI      OYHBPBOXNNCCDO 
SPFQOPHITUW     : PSUXJBOQWYTO    QRKYSTILEOWY    NFDATNJJXA      SQNMWCWRIUONBJ  ADEBWOWILWDXS   YYJJANV         XUJXTGCEKQOWCJX WJOKCIN        
DBRA            : LUAKMDTYCE      MKGSJ           EJRO            OJLWG           PFVGCX          QMEARBC         BWURFPCTRSRUQI 
NJYNJYOBD       : IXIDL           TDBNLBFFJUP     GVKUB           ANDEIWQF        UQGUCHONLGGY    ISHLUQSSRD     
FTYCMQIFF       : LBYNWDDU        CJLCYTIOAY      YEND            LXOUAMAMIBGII   LRURUPIEFH      NHWLSCQO       
NPVIMW          : YIHJGNJSYOTSV   KEMNEIDYDHNS    XKWRYDXBRKRO    MQIIH           HMJCMMFQTPCMKWA LJGNVDLA       
QONM            : IVLRA           IOGHHOA         LKGYUFRGS       YYQRHSHFGKBDNST
WLRIMHK         : TXKLTYXFJGOHCR  BIMLEMKUAXYFDYG TFAJPEQQTTPWT   VRLWVANEFVESNA 
VRLWVANEFVESNA  : QIYRWC          BARN            CDBCYDDB        LMYVKBBVYFAI    WLRIMHK        
BWPRNGGRFTKOGTB : VSRNXTVERSSU    UEHEBDN         VELOJBURXSFYH   TBWFSCSRMWT    
RULP            : ISNOTDUC        UQGUCHONLGGY   
LFXSDCORFSUEK   : YBDVG           KEOTUEECA       SLMWNGPIKEXUDS  VCEVFAHY       
USUMYOYPWUQUN   : HTFRWADSPWFTN   PXCYGUIRHMPKWV  BSSNR           CJLCYTIOAY      ODNYOO         
GDETKCOOHDGO    : HBPCMOHYE       BFIFMCMRLINLRLX LYUAWFAO        OSBMB           BBMXS          
DSLRPEODDDESAAL : KANOXUFOICSADOF VOBOVLSSINRFS   JYGDMHRV        JGTP           
PYFSEBFGPT      : LGGDTNVHNNB     NCDMPCKKWA      OEHPBPNWMG      HCXEBSTOPKG     FKSRFACSLWD    
VCEVFAHY        : IAFAO           ROJYCHR         QFCPGMXWOV      LFXSDCORFSUEK  
ONSTQ           : ASQHNMFA        XWRPCFGX        OYHBPBOXNNCCDO 
NSAB            : NLHOCABYOVYHB   BDUOJX          ABIUFHKC        WXEWBYG        
PBUKHXRPO       : VQISICLHCSMQ    EMIYXROS       
GMQKIYKSXB      : RXJWBVDOJHF     WEAO            TWRTTWSYTPL     NIBJM          
MVBFX           : RDUFTQGXNMX     XJGYNHJTDJ      OLRGNPHFUUQOWYY GUVMXLCYYNTUTF  GTYSRGQHJFBASKK
YASQPVOCDMW     : TMBRPEAFUIMJT   GDFXPJEHJHUSJYL TMNGLAXB        RBCNYQ         
BJBPCM          : XLJEWTFYNGG    
BYRAA           : XVEKYYMR        HAEWLGCLUCXKT   ADOLNSQPOEQ     ISHLUQSSRD     
OYCTWTUXOMPKD   : OWPXXUL         WUTCHOUPPYKDYP 
PPRKTDMJF       : BAXPPBTIB       CCDAHCMOA       HMFAKQLMV       XPKQLTT        
KHAEJDFXC       : UUEOJKAITFYH    CPMES           SHYY           
RBCNYQ          : UAKEMQEHUYUABLV ESXIAOAYYIAJV   YASQPVOCDMW    
RDFOSUGDQJRBQ   : PGIKTYF         WREGHYNQFDLCE   VTFGHHRVKWBOXP 
NXTS            : VQPBMAMLPY      REIRPU         
WXFBGAC         : KOTLCSWRJ       BJCB            HAFOXOHRUBHQP   JBEAHSHBRVFCMP  SCRPGJQSOCL    
PEDRXGYMBVU     : GQNSCDBYRMS     MXBJKKCSSM      UAOSDX          LUCLURBCJOXV    GNDOEQMOOXUNIY  OSXKVE          IEKATYTTHPR    
NGYQWS          : PXGTWXNDDVLYUI  MAKDK           OUCGJY          KREWIPHWCGE     QNMS            MAJWAOEG        UBQVPM         
XOWHNXPOG       : XEBRFWUFEGLS    REUJTQ          SIFR           
SRFYWYWEXLHTGOJ : XQFVJRVQY       DQYAVIUBTHIYPM  KNQWMAJLC       IAVRI          
OAKJHKAGRN      : LKIYYQBMGGRS    PCWJYHCSF       CPGEAROWTB     
HELYYFGB        : LKMVGNQSKKIPRII XJMXEBEYWCHUH   LWPTHCQPBNKQTHC
FAKFMSCUH       : HUQH            GMKDK           QEHXLGDRYQHGBOJ EDHPDNIPXVICL   FGGWRVRXCOK    
IXOUJVHJCYYJJF  : GGFIFVTWPYK     GQLECKMCINT     GQLTDAEMINVXC  
IHCP            : YTMMSLRWTEIS    QHUFXFA         GXBQUELH       
IWITDWMHS       : NVTBH           XIWT           
UDUJAGFHQKGRT   : NMOOCCJCIFUD    PYQTAFEGAQR     PJXOSFIGGUN     UVXJJ           UAPMQ          
XQBFUQPDN       : TTTAPEHFO       JSOATRXRKUML    MAORREUUPETEI   VAGNWH         
WSXLCQI         : CJLCYTIOAY      TKSVECINHVCMOX  AILERMPNXBETDOS
VFJVLPDECLWVEWO : PEWJMYYVVNSDSAG BDUOJX          TXIXMUYOSVXAFER OGJULAOV        JSAGIU          JSODYIMENMXH    BGHKPLBKCXV     GOTBJRVOQ      
VFJVLPDECLWVEWO : LRCDKVWHOSEN    EPWS           
EJVTMLTM        : MJKMHC          YHBGOQQTB       OMPYQYKPA       KJVUCYMHUEOOSBR
RXJKIJGNTE      : DTAY            EKYQEB          GDOQHLIM        CGUL           
LJGNVDLA        : PLTMYYBGN       NPVIMW         
AFEJD           : QWEQOSDR        FQQNTCPBUEK     FTXX            WHUXBAXL        GXLOJYMSGLVLD  
XOUMXO          : MLRTO           PSUXJBOQWYTO    PDULPE          BBGNOIHNJWK     UPIRBY          IMIPJCY         YKIYINYSASAABR 
IAVRI           : TJQPTDWJCVXHY   YTWYHGAOPYF     UCBMXMCQHJG     CDJT            MIWC            BIMLEMKUAXYFDYG LRCDKVWHOSEN    SRFYWYWEXLHTGOJ
IAVRI           : HPGE           
LNOYWUMSYXU     : KCMXODB         NIPYRRFECQQ     HRFI           
ACILFKMWFY      : UDNEWOGFTEFD    COPJSNNTG      
UMFWLXFX        : EYIE            QBWKP           PCWJYHCSF       GTMQBEWHBSNVPL 
SMLSH           : BGTEVEKKIQE     OXBJOJOBTGSGCFX HCVLQBHSTK     
NIBJM           : THDKAGUW        RCXXRD          MNSYL           GMQKIYKSXB     
LWPTHCQPBNKQTHC : ELNENGM         HELYYFGB       
OAFKMS          : PXGVEU          EDHPDNIPXVICL   EHBLTJJPSCKYB   CKJTA           CLNEVPJOICV    
VVQFWCRAQOPKXR  : LUAKMDTYCE      NGDHWWUTRGUQOE  TXIXMUYOSVXAFER FGVWSFTVPCDDOTK LYUAWFAO        ADOLNSQPOEQ     BYTD            LGCLCKY        
NVQXMKHQG       : WLCYPMNOKC      FQQNTCPBUEK     ENPIWRRAJARJ    MDEKN          
QOJFHOBDFGCKA   : RVCKBTKTJ       IIYLQSDNQTGSB  
BQUNPNSD        : XKLFWRB         BPCNDU          XHCEMEUEQC     
JEXWNOFMH       : KDQIDAQC        QBWKP           BDKJOWFMA      
VMCKPHSYMFYR    : TOYMNLC         MMVPUWD         CGPKOYAVUGDUJV 
QMXIAQLLC       : YGGBBWB         XNFPTAWPTC      GDNOYNJUSEJCQR  LTEERVJCQHWIUJX
JBEAHSHBRVFCMP  : HDUQMH          TWMUEEMMNXFSKJW FJEOABTC        XUMLNFON        VESAWQLIHHE     WXFBGAC        
LCEMTMFGKN      : BGTEVEKKIQE     MFKNHWFCNSMYKMT CDUILGH         PJXSQ           LMYTKUUFGKEJD  
DAWGRHJX        : PEWJMYYVVNSDSAG EEBQVNKPUJ      MNKGTW          SUBILRUHA      
QRTUJPANERNR    : JWLAG           ULFJAN          CPHL           
RHPHM           : DXTM            MIVTJSSDWSRTISY YMXFVJVRFKUQ   
TBKXDHGWQPVBJPU : QBGWAJUKEMS     HTFRWADSPWFTN   BJEPLLXJIQO     JBHSRUVOQCGX   
YMGOTYCLUWSLE   : JYFJRYYICXXJGT  DCLQGUI         PFPHOE         
MAJWAOEG        : ISVNTFDBUANXL   FOXNJLEJSDCFODB NGYQWS         
VYJYKYVQAIYPCA  : NCDMPCKKWA      OPDEUTKOWQQJB   LSWYAOAC        BDKJOWFMA       GCQITFKFIDLQRDY TODKGHH        
QVQLJWTXXF      : SREMPXF         AXIWKUODYTKDQR  XHOCTPMD       
XVBHIYI         : LGGDTNVHNNB     AAJS            QSCEKJLGGEWE    FJEVHA         
XUTTLTFMJJNEALU : DCGNYGAWGH      RQPKSNSRVWAMNQ  GWSF            WHUXBAXL        UHAE            LVHXOIEMS      
UUISS           : BLIKDPKLSQFFT   MGMODOFBFULN    DTFVPSRTDERTFXU
PSMQAWQKRQFNLSH : FSRWKQJH        WODMBL          PPGFR           ROGYLJDNB      
GTCTADFWRCRCUMS : LHXNKJVVOO      LPITWMFHBAXLRBL OAXGFTM         PLEGVRASQJP    
GGFIFVTWPYK     : MKANVUASNGB     OTYWL           EDHPDNIPXVICL   XUMLNFON        IXOUJVHJCYYJJF  VOLWOSYVFPUBMOD
SUTB            : QMUUELRLFEYOSYO TBAMGKHDM       SVMLWHNOBKEQW   NSQKHVH        
VUQBA           : EJUXXUQIFXECLPB EDHPDNIPXVICL   XMJVEDEHAIMO   
UCIXYUSLDBS     : ABDKW           XLJEWTFYNGG     IEYWUNRJNK      DGJY            SJXRWJJJMWY     BLRKLCO        
HPGE            : PLWOR           QPBQIQLSPFUB    IAVRI          
HRICMEDDCAVEALB : OTLOILNYUCVJBR  QRLFQBIBBFHRUI  CXJRBPAYCEMARW  BDKJOWFMA       KTSGRPEADFWIQ   BLJDEAQ        
VYFRUSUV        : RENMAHUPRKJ     SXEBUPSAFEE     PGJBYNRL        WEFYJYWTYCGAWH 
JDERILC         : DIFGPSBYPEYNJIC TMNGLAXB        UEHEBDN         IIDVFRDKSFR    
TEOAKT          : UAOSDX          AEMCJABXJC      YJDRQAM         RPEFUET         ATNHFFTE       
KPIN            : YVAOP           FUBHEAA         ODRUGEV         IXEQEIDEQXKJ    POEHRKJFFQMXI  
KTAJATGSQDFBGJ  : CFOIATCLBBHTUGF PXCYGUIRHMPKWV  UIVPE           ELXKIIRRWIFEII  IIYLQSDNQTGSB  
QUUS            : VDKSQMATI       TSYSTBITECGG    FFMFHYKDMNHYDH  EVPDVTAWSJTKBLD MNNKXOM        
CJQMDVYUEOYOJB  : QMROLYNX        DFAKKYOD        OGJULAOV        SXGPKLAJODDC    SLMWNGPIKEXUDS 
JUHEL           : YTWYHGAOPYF     OBMRPYAGOIWHBJ  YYQRHSHFGKBDNST
KMTVIKTDEM      : KOTLCSWRJ       SIIFUWL         RXJWBVDOJHF     JSAIRFIBES      REIRPU          PMMPRRTTQV     
NGTTCVOIKPX     : PRAEQNLLSLFT    GBMMMMJNSETRK   JHMJWWEROQHRHS  BMSRWXPEYF     
QBHNKMC         : MEUJRUWJQFQ     BPCNDU          GKUQ            FTCLUQYXVEJSV   ASVNS          
YORUYCQ         : JOKDS           MJMSFXTYTTIPS   VVJFCVROSPGX    BIMLEMKUAXYFDYG
IEKYKHSMFJURCU  : RJYEFDJATIOJVTT
UVXJJ           : XQVVK           UTODVHOLWGOQ    UDUJAGFHQKGRT  
LHJCBHC         : WYFAG           HPSEVALXFYU     TBWFSCSRMWT     XUMLNFON       
XHOCTPMD        : WHCDGLRFMOCBHFV YDLXVSUVTALKQX  XALJQJD         MEASF           MJLQBMTQTAKM    QLETBR          QVQLJWTXXF     
BKTWDVTT        : UTEXEOXRUC      SNWSCIH         INLBVS         
SRDCFQLO        : NTEYDAYNLTMJBX  PJXSQ           RRQOOV         
MVYRWGGYDX      : FMVTNMRYF       VWDCJPQWGWTRJ   WNGOXC         
IIPTDOYBLUU     : TYYTDFKOPRORWKD GMOMDRPTYN      FOXNJLEJSDCFODB GTYSRGQHJFBASKK
MAIRQTJMGHL     : TOYMNLC         IYAYNXACIW     
EUHGAFUIOMETEFW : ANQXEVIQDDIGRU  BOFVRHSOJB      DBPRHYKMEQB     XIDPN          
ASVNS           : FQQNTCPBUEK     HJLN            VJXW            OCGUJEQTND      QBHNKMC        
HMXQYEYME       : DULBTTAHTVLAK  
HLLHTISKVYGC    : VNQC            TCHVRGBXBEUFCUP TDAAEI          WTGOHJ          ODRUGEV         RCSNTUIMEALMG  
DTFVPSRTDERTFXU : REIRPU          UUISS          
CBAQOJKX        : LQUTT           RRETYLGJHMU     UXWF           
WVEDXJGROF      : OXBJOJOBTGSGCFX MMMCUKKFR      
KWDNDUJISFA     : BCJVQMXHHG      GAHC            NUHDONJS        RRKYNTQD       
ICNWOXUSWSWASI  : DAKU            VOBOVLSSINRFS   DVETK           JYXLPM          MFYKJ           FKSRFACSLWD    
KAOTMLYAOTL     : KVIXXWTKKTMB   
OSBMB           : QAUHQKQXMOB     JDUTUHSUXMTJCWK CKTCXAYN        GDETKCOOHDGO    PDHPXQ         
ABSBXNXRN       : TFYA            MIVTJSSDWSRTISY
KVIXXWTKKTMB    : LMOFIYLTJAU     FGVWSFTVPCDDOTK UPIRBY          KAOTMLYAOTL    
YAFRDRVHTYC     : DPYRKERRSHL     EMBVJNFKMM      AJBEETAWPH      YYQRHSHFGKBDNST
WSVQGWC         : DGMYQQUQOVBJ    YJRFQBJSSMVAEA  TUHNYPSF        HFADVKX        
HCDEXNQRBT      : PLEGVRASQJP    
CVPVYJ          : EFHFHRTXMYFCP   CKTCXAYN        EDCLEELU       
JFSLDQEYHMVLRD  : LUCLURBCJOXV    QLETBR         
WJOKCIN         : QLIHQJHVR       WKTHUUUBDSS     KEYFGEAPMVGKEUQ SPFQOPHITUW     HGFHPHV         IUFIPMDELF     
SPRIMQTGAAAODQU : OTYWL           LXOUAMAMIBGII  
AICOCHEYQ       : ANQXEVIQDDIGRU  CCXIKMAHJ       TTTAPEHFO       IBUWUXUFPKKE    THDKAGUW        JGTP            YRSWMNKGJL     
JUCAQWPK        : ANTQHYCP        JIEHOUFAYH      SPDVSVJYNEIP    VELOJBURXSFYH   PWCTUJIXUKSMIV 
EDCLEELU        : BUDXBRVGI       CVPVYJ          SGEV           
EPNGAPUCWCDPWNM : ACUOSASCCBKWFB  DTBX            HMWTABM        
PFYFPHKTLXAQ    : KTXKXYEOASPQMRK YJPHCXPUI       SDYROGKXKFQGHIF YJRFQBJSSMVAEA 
UAPMQ           : HGTBWG          DTBX            KNXXXSTNW       UDUJAGFHQKGRT  
NITRIVVAULN     : XUUCKPBPEUO     KOYKTEOUPV      XUJXTGCEKQOWCJX POEHRKJFFQMXI  
BSVILFUFQSH     : YGGBBWB         LGGDTNVHNNB     YJDRQAM         MAKDK          
ECKTQBS         : ABYGRMCRPGYMTJB JIEHOUFAYH      IAGLPDWH       
LMYTKUUFGKEJD   : OLUUQEWMPLWNHSF JQOUAMJAQUQCMBQ HDXIISWXXGR     ICECTNANGMY     TCVRI           QLETBR          LCEMTMFGKN     
RQHNVYIFINJUJBX : CGVRJMVMNG      TNYKIAYYQCKOG   YDBR           
HKSGGFDBL       : JXIURNLTNH      ITIMEIVGNCTG    RXJWBVDOJHF     WIJDINLVYGCM    GOLHGFBHYL      EFFFMJYOGQYOXXG DVHKTEU         YFTFI          
HKSGGFDBL       : JDFUIVKGAYO    
LRURUPIEFH      : GYMTVDEGGY      ARWDJSDG        FTYCMQIFF      
NOODYLPAKTHWPOD : PRAEQNLLSLFT    CDCIEOVSDFHYJB  WLSHVQBHITB     GDNOYNJUSEJCQR  SCRPGJQSOCL    
TFIG            : QVSJUUTUITDTX   ACUOSASCCBKWFB  SNKAVMQFNMATYP  CSGWORMGLYJ     XVTVXD          WYCW           
BBMXS           : NXUB            NFDATNJJXA      FORPKWPTFLMDSYK BOFVRHSOJB      IIDVFRDKSFR     GDETKCOOHDGO   
CXHIMVYRUKH     : XLNOEEGOQFYGF   VCFIDIIABK      GPYAIHT         JBHSRUVOQCGX   
UEFT            : JQQLTKBSN       PXXOYJSPF       WLXUPAEFHCJVQH  COPJSNNTG       UGGBSHCCWUI     ONCGHWW        
TXQPDAVXBALBSJ  : RYTMKNABLARJVFL RNJPGCGFRJX    
RQLGOKXK        : VTFGHHRVKWBOXP  QSFVNIG         XWRPCFGX        HRWGEGHVLDIDT  
IFSOKNKGLDWQ    : TBSKWTDBLQEA    YHBGOQQTB       VJDHBAVM        GEFCVSDVIC      IOFOCPTC       
UQGUCHONLGGY    : NGHOB           WBVEUNRFBLCPLOB VJAW            NJYNJYOBD       RULP           
VKMIIWNDNB      : FSUJUENQEDM     NFVJKYUX        TTCXSWJOUK      LBCXWQAQL       IVHP           
AJGEGWHCQQYSX   : TODKGHH         FLYRQCBHKBQAEXK
JLTRLIPXXX      : WGYTUKRWPKEHFC  IEDUNDQSWY      BMSRWXPEYF      FCCPPGERBUO    
WOJNRF          : KMNTEGUDYCFOLP  QWEQOSDR        TFAJPEQQTTPWT  
BLRKLCO         : LEVWSDAGU       ULKGL           TNUASROVA       UCIXYUSLDBS    
SNWSCIH         : FNBLHGHVJPRDT   BKTWDVTT        PVHORWW        
BSJSQHTYGKKTCP  : HRMYKFLDUFU     HCXEBSTOPKG     YDBR           
FCCPPGERBUO     : XKXWRKBYMLK     HRQXFCDPN       JLTRLIPXXX     
WXEWBYG         : OUPPLVCV        UTEXEOXRUC      NSAB           
PPPQWCBSET      : OIXRN           UBAXDGLULMHJM   KGJHQE          EUPFUS          BNREEDEI        NSQKHVH        
KXICNOJH        : CYMXWBMRK       ELNENGM        
EVPDVTAWSJTKBLD : OUCGJY          IFROBCOYNDFKYO  QUUS           
OGTUAYHA        : FJQCUXOHY       YDLXVSUVTALKQX  EMBVJNFKMM      ELUW            SCKTEUTJ       
KPYVWRATH       : XWRPCFGX        EFFKVDQHES      CGPKOYAVUGDUJV 
PDHPXQ          : OSBMB           EQRUGFASMSPYOAS
KSWNS           : CNVYOHTD        MJMSFXTYTTIPS  
VOLWOSYVFPUBMOD : SATIIGS         TJQPTDWJCVXHY   IVHP            GGFIFVTWPYK    
VIBBQQ          : HDXIISWXXGR     VPVFIROMOVSJ    KDMOFHLOU       BDHXAC         
JELEBBXRXODWD   : HAEWLGCLUCXKT   EGAVTGQ         OGWDPKENCD      LYVRUN          OXBJOJOBTGSGCFX IVVVROJ         XYIIL           KGYYPKXVAQVQ   
JELEBBXRXODWD   : MMMCUKKFR      
VAGNWH          : NFVJKYUX        ROGYLJDNB       XQBFUQPDN      
MNNKXOM         : QIYRWC          WREGHYNQFDLCE   QOEO            QUUS           
HNDLCHPDHJDWM   : SXEBUPSAFEE     MYHBJXBQI      
AMWC            : DXTM            WEAO            LQKJM           FALVUNIXBSBJ    QXMYDLPJK      
MADPM           : WREGHYNQFDLCE   LYUAWFAO        SLMWNGPIKEXUDS  HRIMS          
EWQUL           : QLIHQJHVR       EGAVTGQ         KFFXWGVNLFOYN   MENBK           EQCJ           
DCLQGUI         : WFAXPASRCNCA    BPCNDU          LGCLCKY         LEFFAYVVAW      YMGOTYCLUWSLE  
DRNAGPCTOFMCF   : JQQKSVAFLS      YETF            THPNCWSEPFAFGO  VSYHLAEWPEJ    
TTKASCVFMBJA    : HFPOLJRKSIMHII  TMBRPEAFUIMJT  
PWDBAUQCCJF     : UGVJPNYTAQRBF  
XKKCPFW         : MQHCQ           EDYUJ           LJMGRIS        
PWCTUJIXUKSMIV  : CYMXWBMRK       FSUJUENQEDM     YICH            TFAJPEQQTTPWT   JUCAQWPK       
ISHLUQSSRD      : RCOB            HJLN            MYHBJXBQI       MIWC            GEOOKCFHVEAPFAU NJYNJYOBD       BYRAA          
TULQGDQK        : QIYRWC          XEVGOAUF        MFKXI          
NWGMR           : GQNSCDBYRMS     CIDTX           VBNHXQXKKC      NGPJGFVFU      
HFADVKX         : ASQHNMFA        PYUSBHIEVBXKTPH LGCLCKY         QSFVNIG         NSQKHVH         WSVQGWC         LOHJGJGPLWRKL  
XVYQOQVWMQ      : UMVWW           JFEYJL          FORPKWPTFLMDSYK
GYOWKMMHUYBO    : UEVAIUNBW       GVOFKYM         XKXWRKBYMLK     REDGITYWB       SPDVSVJYNEIP    ANDEIWQF        GPXBIUHUYYB     LVHXOIEMS      
GQLECKMCINT     : EHEJNUIT        TBSUTY          IXOUJVHJCYYJJF  SAPSJONEX      
EPWS            : GOPUSRNVDGPRG   XLEAEJBFHS      IEYWUNRJNK      SIWHFVOVLPRSEN  VFJVLPDECLWVEWO ODNYOO         
HYIVVSKJCIKEWT  : WLSHVQBHITB     EPJYFLOM        UIVPE          
QFTSRGWCT       : MAPA            ITCLRWBIYFRQ    HRQXFCDPN      
AAJYSSGUDFQWPCB : POTNQKDSLTM     ALPYG           PIYCFDSASPCSQY  FFMFHYKDMNHYDH 
PFXJUO          : XSOGNKVHRCKOEYN NTMFFBCFFPE    
OJLWG           : YNBAXOFMKFLKUEO DBRA           
SAPSJONEX       : LMYHKMYIIEQPN   KAOCTSUPG       GQLECKMCINT    
HDCG            : DVETK           WPQJSF         
GITVPR          : FJEOABTC        KREWIPHWCGE    
KGYYPKXVAQVQ    : JELEBBXRXODWD   WBRXMDJSGLJJY  
HHALFKVIMCETK   : DQKFHDWTVL      WEOELTBHRNSRWIL AJJXMYCJOIQK    SGSVIA          QNMS           
RDRANX          : XNFPTAWPTC      GXBQUELH       
PPLNNLFME       : JOKDS           SNKAVMQFNMATYP  SLMWNGPIKEXUDS 
TMSIT           : TXIXMUYOSVXAFER NCKAFDBXLHHH   
GDQIJMVJFYBFOB  : UFKVB           QLETBR          GWSF            LOHJGJGPLWRKL  
EQRUGFASMSPYOAS : JXIURNLTNH      HEBFUQGG        MMRPQYBVVPVS    PDHPXQ         
GXLOJYMSGLVLD   : KFBU            GUVMXLCYYNTUTF  AFEJD          
THPNCWSEPFAFGO  : DRNAGPCTOFMCF  
CHNCSFMTRFAGC   : SNAA            UCBMXMCQHJG     XUJXTGCEKQOWCJX GGXNUHHEG       JRQEEHEWFCRRQT 
JBHSRUVOQCGX    : UDQHR           PMMPRRTTQV      YKIYINYSASAABR  TBKXDHGWQPVBJPU CXHIMVYRUKH    
OFSVHAKJVPXPHES : VCFIDIIABK      QLETBR          AILERMPNXBETDOS
IIYLQSDNQTGSB   : VOOF            DILRYNQUSYIBYC  WIJDINLVYGCM    DPLUSUFKERFHHR  QOJFHOBDFGCKA   KTAJATGSQDFBGJ 
XPKQLTT         : AOYVAMCKIKXN    HCVLQBHSTK      EKYQEB          LLDHQ           PPRKTDMJF      
FPNEHXKCNU      : REDGITYWB       AJWIOQYDNSW     PXXOYJSPF       RATDHDAEYHIRM  
PGEKKRBGBVHGVYQ : RDUFTQGXNMX     JTFUX           VFILG           EUKCGT         
NMHLRYC         : SFBBWRXQ        DTAY            XTTFUOHKGMUU    OLFKJFUICJU    
IAGLPDWH        : PITORUG         IOGHHOA         ROJTVNVEKDST    GGXNUHHEG       ECKTQBS        
BRWUUDVTN       : AASLNSM         WSPSCJXENDKYD   SQQAVGSCBRN     TKSVECINHVCMOX  SFEHVKLIENIF    JRQEEHEWFCRRQT 
PMUDA           : MFKXI           MBMCNOVPEQVPUKH OTOWSRTF        ULBCHXMWUTSO    FCCRDSNTYPL     MGINT          
MOCLQAUSJI      : LKIYYQBMGGRS    WFAXPASRCNCA    NFVJKYUX        CSBUOJOF       
MFQWIKTFGAEA    : HQFOUNAHBT      CPRM           
IPAGTDP         : CGVRJMVMNG     
RTUKURDGALSH    : FQNPTTJP        CLNEVPJOICV    
SRPOWVODXCMN    : HEVMUDE         ARPOUCSLY      
UJIMSC          : OXYPETAYDMOPK   RRKYNTQD       
POEHRKJFFQMXI   : RYTMKNABLARJVFL DOOUTFHR        JLLRHTKETWWBIUC KPIN            NITRIVVAULN     ERYCKAEYMM     
NHACNXHCNM      : GQNSCDBYRMS     WFAXPASRCNCA    IVEPMEG         LFGJCT          KBIRCBFFJN     
AWJUB           : UIVPE           QMUUELRLFEYOSYO NDOUCKA         UAKEMQEHUYUABLV AMBFATP        
MPWVJJFQPXDNIFD : AVQBBJUB        LVHXOIEMS      
HGFHPHV         : AHWIK           DDATMSUE        JSAIRFIBES      WJOKCIN        
GXBQUELH        : LBYNWDDU        ROQDJUTF        LKGYUFRGS       ISVNTFDBUANXL   IHCP            RDRANX         
JDFUIVKGAYO     : IOFOCPTC        TTCXSWJOUK      TIAUKQMTJAKG    RVROOKAOEYXO    HKSGGFDBL       FUBEP           NINKSD         
CGPKOYAVUGDUJV  : IAFAO           QLWM            JSEQVXHMXFSTIWL ROJYCHR         VMCKPHSYMFYR    KPYVWRATH      
NHWLSCQO        : DOWMRSFKIG      PYUSBHIEVBXKTPH KDQIDAQC        FTYCMQIFF      
PBSRAJYFSQPHQSD : NLHOCABYOVYHB   CBIMCHMPTNFPK   RCXXRD          GVKUB          
BILLGDY         : TRGPH           CJNFKS          ONCGHWW         INLBVS         
BLJDEAQ         : TUDLPWCVUJM     NFVJKYUX        ONCGHWW         RBRWWK          UMYH            HRICMEDDCAVEALB
CLNEVPJOICV     : BQHOJTOKM       GNSKRYIFYCHXW   VJAW            VMXULFUTVFXFAAI OAFKMS          RTUKURDGALSH   
WBRXMDJSGLJJY   : FBLVPPPJSNPOG   KGYYPKXVAQVQ    VCKCDLSLWCNYCM 
PFVGCX          : DDATMSUE        XKWRYDXBRKRO    RNEFAQTUGUPNYMA UTODVHOLWGOQ    DBRA           
PFPHOE          : VVJFCVROSPGX    WYAFHY          YMGOTYCLUWSLE  
SCRPGJQSOCL     : RNJPGCGFRJX     VOFRWDJW        NKLBQURJTJUAQSQ WXFBGAC         NOODYLPAKTHWPOD
PVHORWW         : TTCST           ULKGL           DNKQENJBBRIYRS  COPJSNNTG       LFGJCT          SNWSCIH        
FYOAQTRYKYRE    : ACUOSASCCBKWFB  IHYGSRV         HMJCMMFQTPCMKWA CNCWH           SXFBXQAYSYSAAQV
LVHXOCMROKHKU   : ROGWXKGQAWVQTME CKJTA           RSFAVW          FGGWRVRXCOK    
CTVRAWGCNCVON   : XIXUCCRHVHVGK   TRPDGUPCSDI     LTAEHHMWMLGRORL
GTYSRGQHJFBASKK : FTXX            MVBFX           IIPTDOYBLUU     HWHRTNOPYK     
LOHJGJGPLWRKL   : TTCST           ARWDJSDG        IIDVFRDKSFR     HFADVKX         GDQIJMVJFYBFOB 
FUBEP           : UAOX            KUDOJX          WPQJSF          JDFUIVKGAYO    
NIDYNG          : AMJLOFAKQ       YNBAXOFMKFLKUEO IOGHHOA         KJBHPEWWK      
GQLTDAEMINVXC   : BTFWXQXYYSVFXF  VDKSQMATI       GLSUWSKLDCIO    WFAXPASRCNCA    PXCYGUIRHMPKWV  EUPFUS          IXOUJVHJCYYJJF 
QMEARBC         : CHLR            WEOELTBHRNSRWIL FTXX            GTFFXTK         LRCDKVWHOSEN    DBRA           
QXMYDLPJK       : NLJXIDIDO       DQYAVIUBTHIYPM  SFBBWRXQ        IVVVROJ         GMOMDRPTYN      AMWC           
AVSFXWSGMO      : OTLOILNYUCVJBR  XLNOEEGOQFYGF   JUER            AVQBBJUB        CPGEAROWTB     
OJXBNXVPCUIC    : GKTTNVCFCFTYSL  MAKDK           LFGJCT          TYYTDFKOPRORWKD
IFSXOFXPDQW     : BLIKDPKLSQFFT   LWMAGEU        
PRJFG           : DIFGPSBYPEYNJIC COPPLSOPBU      CWFRNL          DULBTTAHTVLAK   MNKGTW          MJLQBMTQTAKM   
TRQVGRTXTOGYVQE : SDYROGKXKFQGHIF LBCXWQAQL       JBHYNBWB       
QTXPLB          : SXINSFXHM       GNDOEQMOOXUNIY  LYBMFHRHYGDGRJ 
IEBBPGJHACXXK   : SJFWVQRVK       EJRO            ORDKLUGMVJP     IXPVHUDBCPIWPQW
RIOGQNEK        : QFSVAUPWQNEHIRV AILERMPNXBETDOS XIDPN           HXMEBO         
UBNUS           : IGIYYKRMRYCIRFN MEVVJ           XEFLODRRHYUPOJH HWHRTNOPYK     
VCKCDLSLWCNYCM  : QLWM            WXNKRRRMPBQJKN  TFGKXQMKFG      WBRXMDJSGLJJY  
UGVJPNYTAQRBF   : OSURYC          GDFXPJEHJHUSJYL CYTEYX          PWDBAUQCCJF     UBQVPM         
UGLYQNEEIPCKDD  : TTCST           WCYL            MLRNMRXIV       FCCRDSNTYPL    
RRKYNTQD        : MLYDK           ADKJM           DTKRQFNFIXEEQIJ KWDNDUJISFA     UJIMSC         
KDLEFSTCCFB     : HUQH           
UHAE            : XKWRYDXBRKRO    SWKVECSVRRGU    XUTTLTFMJJNEALU
EQCJ            : THDKAGUW        EWQUL          
UBQVPM          : TTCXSWJOUK      NGYQWS          UGVJPNYTAQRBF  
SHYY            : WYMYXOMJUVG     IUNOWFYSK       KHAEJDFXC      
GEOAIQHLMCSOI   : QYPD            JGRJVTNVPT      HEVMUDE         TDBNLBFFJUP     EYRNQW         
SCTEIQGAOXMBS   : IIJPLJMBUVBUBD  QBONVAMKWJXFMM  YJRFQBJSSMVAEA 
DRQLXFLGYS      : SXEBUPSAFEE     MMVPUWD         IKGF            COPJSNNTG      
LWMAGEU         : PFLMCOQ         BGHKPLBKCXV     XBPY            IFSXOFXPDQW    
YYQRHSHFGKBDNST : FJQCUXOHY       KKSVVAU         AMJLOFAKQ       PLEGVRASQJP     QONM            JUHEL           YAFRDRVHTYC    
RBMAAHU         : UTODVHOLWGOQ    HCVLQBHSTK      CQMYOJNY        PPSCSTMNHRUXFJ 
FHNLMKVNKOFTIM  : QWBNVBUC        TYYTDFKOPRORWKD ODNYOO         
QXDVNV          : EKAAFVWLHP      CPRM            KUDOJX         
PPSCSTMNHRUXFJ  : JSAIRFIBES      XRMWMRNOWSP     IOGHHOA         RBMAAHU        
BWURFPCTRSRUQI  : FKRSABADFIJQU   MENBK           IMIPJCY         QAUURN          DBRA           
IXJCCCVORF      : YGGBBWB         RXJWBVDOJHF     THDKAGUW       
ODNYOO          : WIJDINLVYGCM    TKFYMPWWSY      AQQOWBMHJEQSO   XSOGNKVHRCKOEYN USUMYOYPWUQUN   EPWS            FHNLMKVNKOFTIM 
JHFBLASFRNVCH   : HDXIISWXXGR     VPVFIROMOVSJ    AQJFUHVMM       KRGIYG         
AQJFUHVMM       : YNBCSB          ALSUHMHRIYSFEWJ JHFBLASFRNVCH  
DSSCJKDS        : BIANBCDLAUYJ    SXFCUJRLN       SATIIGS         PFWUBAVHARX     DLUWOK         
IUFIPMDELF      : WJOKCIN        
SIECPBJLPVSS    : ROJYCHR        
OXAYBVULSAUI    : TDES            LVKCPCVVRIXBLM 
AMBFATP         : YRSTGBLS        JSDTWVU         TRKHWDIF        JYEXPLBPVLIS    AWJUB           INLBVS         
VFJFTYDMUWDSW   : QUBEUEAYJYY     IYAYNXACIW      ARWDJSDG        RQNRJUGVHG      HRFI            TBAMGKHDM       VGXBKLW        
VSYHLAEWPEJ     : IUEXMI          DRNAGPCTOFMCF  
MMMCUKKFR       : EYFJOVSLLWRJPS  BUDXBRVGI       BMSRWXPEYF      WVEDXJGROF      JELEBBXRXODWD  
GUSDTWXRBTM     : MVDTWGXEFMIUGNK UMYH           
EBDIXUPJNCV     : IIJPLJMBUVBUBD  RCXXRD          GOMAHDMVYOAG    PETI            KBIRCBFFJN      QRCVHDJUWPGVOQB
GTMQBEWHBSNVPL  : YJPHCXPUI       KMKGM           UMFWLXFX       
SGEV            : UEDYMIW         EDCLEELU       
FYUDTKPJO       : HXEDCRU         TKSVECINHVCMOX 
LVHXOIEMS       : XUTTLTFMJJNEALU GYOWKMMHUYBO    MPWVJJFQPXDNIFD
FGGWRVRXCOK     : TWMUEEMMNXFSKJW PXGTWXNDDVLYUI  PXXOYJSPF       FAKFMSCUH       LVHXOCMROKHKU  
NINKSD          : QWEQOSDR        SFBBWRXQ        XIHCYPUWR       JDFUIVKGAYO    
KRGIYG          : QLUSL           HGTBWG          IBUWUXUFPKKE    NKKMSTNCYB      OAXGFTM         MFFJLO          JHFBLASFRNVCH  
INLBVS          : XIWT            RJKCNKBDPTAV    BKTWDVTT        BILLGDY         AMBFATP        
ERYCKAEYMM      : PQQNMQDCIDKOS   QMROLYNX        IEDUNDQSWY      XEFLODRRHYUPOJH FOXNJLEJSDCFODB POEHRKJFFQMXI  
UBYQGV          : CNVYOHTD        NLHOCABYOVYHB   ABDKW           BTQP            RVROOKAOEYXO   
XEJXMIIAWLX     : CMOFI           GKEAJGLKT       RBQKSHYFGVRJPQ  YLBNJGOPHOSQLCA
SCKTEUTJ        : TRKHWDIF        FNBLHGHVJPRDT   OGTUAYHA       
HXMEBO          : HFPOLJRKSIMHII  OLMSCPWRWT      TMNGLAXB        RIOGQNEK       
IKVIQHIDSQEPC   : FJQCUXOHY       UBKXEMAISBOP    FJEVHA         
HWHRTNOPYK      : BVAO            YEOSMOECUUUORKO TFAKPG          GTYSRGQHJFBASKK UBNUS          
XAEB            : GWRPKCWCLPNM    ULFJAN          SNAA           
YJBVURFDUXW     : BIANBCDLAUYJ    UIVQGYDYRQBNY   AUMDAORI        YTWYHGAOPYF     DGJY           
