JJYJCJ          : DGPEGP          QKOYWMCLWXP     VWPWSUKQJQCB   
FOQRTIT         : FHIPEF          PBCS            JRVYOIHECL      PCXCHJWWGT     
HBLIXBY         : MJBEHBKT        EMGQY           IHJTUQIG        OFJRWG          SJWUFXNVFIB     LMYHLCCCWKL     KELASILNESAONID
RCIITTPVFBXOGH  : NJUNSHISQPEK    WHFS            PRIPWGCXEXQJFW  KNMYCBQHJCPU    PGGYN           JPYFPJUG       
LXBD            : HERQCPD         PMQJ            XEDKWIWSDXSE    UDRJRKLXK      
JAGRDRC         : UYDOGSEAPUEM    CGRSDYWSUIY     BUCRFDLPNVKDLE  WGIJQDSAHHJS   
VBMPFUBYQS      : TSJX            PSAPIS          HRORADMNQPAGYAT RVQBWBTFYK     
WTVNADYOCATWMTD : OFEL            GJDKAKNVNTJEUM  CGRSDYWSUIY     TJWTTGQMJX     
XXIBVK          : PUQEU           MCFVBDGWIYW     UONXJNGTW      
NPNOPEJND       : XLNNVWY         YFGNGWQCLMT     PCQCAC          PQVL            ESBLHD          JNORVGKQGRCOGUO
JRGOQU          : CSLGBH          YKSQTYMRN      
SPPFLV          : PUYDJHLH        IAAFJVKKFXEBOF 
LVUN            : CGBMXVYWLUSGIFA KRGUOATMCL     
HDHYSYQXIGB     : LQIANI          ELYXTJUSYSHNIE 
RUVHNSAHKSOYQBK : XALPGCGMNCCYW   LXDJTBFIHN     
XAIHGPIYQAWCIB  : OECBM           DLPYJMNOW       SAMC            TOUEQHVPTICA    XLSNARMKGLOLMHW CPIF            POSHSSDUKCRK   
BXOKMIMVUFKTXNH : XLPOAOHMI       MHJTD          
NHUUNNEPEGMI    : PUIVNHOJRFNF    UDOSNHN         UNYCSUVDRVCXAKB NCAHW           EKVPFBTQ        DETRBI         
PARQOC          : BIRNHQMBERRTG   XLACBAFXYMS     GOCHUC         
YPBWWLQVAAI     : VYJSV           SMEIG           FNYARRWWDVKBN  
IGLXTR          : RSQKGNTJAKIKQO  JVRSKKOXSA     
AXDJOULH        : OTNOQD          KKQIXTKKQLYGBBD YXKFKTUFV       SEFNESMRFQEFOUA MCRYUTHNSQLODE  BUCRFDLPNVKDLE  FXUKOUNR       
CLQCBRBBERW     : NJUNSHISQPEK    XHSONX          BVUSEFFQDYDJ    HUNHBRKIJUPNT  
UHTD            : CCHQ            RTPDYFYOC       NPWMY          
HBHYRKWUTO      : FWLFDCWIVFAP    CKEVRKXNCCLYWK  CKFOA           XKSXIYOKYRGO   
HXEJJU          : VVOEIHVD        VIUGTMQIDX      VAQGHPFAOLM    
NPOOTJNCEUVHJEK : BOKRTJOHPR      TDEUSGFTUW      XFVWA           NIEORMAPDWGTP  
FCDFWYTPGTT     : JFPHWA          HUCXDYTABHVDHSG GJLMMBAYUCKB    CGOLTROQRVI    
DQESGTJ         : YMRMDACTOLL     YIXWNL         
DWEHSDQEJBWOGD  : JHMIBD          XALPGCGMNCCYW   OOGDICWDCADAC   CEHAYQPSRNRORO 
FCPULJQ         : AMGUABAQFIH     NNSC           
NKIIQESV        : RTPDYFYOC       CGBMXVYWLUSGIFA JMIXMUKCJWP     IUAIJWQYDJMO   
PAQKD           : EYMAEQRCWFSYXG  GOLN            VABXCVVHAFVLE   BXCYRRMLS      
QMLOERTXWVOU    : YYYMAYXKWOGT    UQDNVUDLBHRMD  
XLNNVWY         : NPNOPEJND       QMDKWIACNNJJP   CTCUHVDNBYHT    HUCXDYTABHVDHSG CNLNQAJ         GSKX           
BRLLJLCWR       : GKVYNG          LDBGYJEGF       AVPFCDM        
NGXEKPX         : KAIMQYAOHVARQD  RMXLOFYUXVQII   VGJPXRGAQYLRIM  KLFTB           KOAC            YEOPIIPFQT      NHGQFWNKIYHTMU  MRYNFT         
MWAHGAVUQ       : TADIYXQRR       YNVXFEGDDCCS    BVUSEFFQDYDJ    OMAVCWBNHLKG    NQWUASXH        QWXRNXUYEMPH   
TRJUJWGULLT     : MPWJ            VABXCVVHAFVLE  
XIJVMWLNIAKKI   : JIIUQA          GNIPODCIWWEAX   SHMKEYAILEXHMGG MRQYNWPLAPBN    JROKF          
MGNFA           : BOIIILCOPA      LIKMK           KXQQCGQPQF      OEOHYSHELGERNED XJSVJKJIHKM     FFBDSMSV       
WMFIJNEUYXXWI   : MMBACP          IPOEALTY        ERDCGVBEL      
SXJGLRHXERSQAJW : WQTRBMVJR       DJOKQ           MWPHYUO        
STOXFYMJ        : SATGEXIEDNQ     NYFLHKUHNSVVVJ  FABIICDRYHCHYT 
NJUNSHISQPEK    : RCIITTPVFBXOGH  CLQCBRBBERW     CSCCDTGDA       XROUJMKSWRI     WDHVOI          FFFQUXD        
EOSWHSGGUA      : RYPPN           JVRILFGJKE     
KAIJ            : THXVS           WWDOWMB         KBPYFSHB        FBGX           
RFDDCQVLYOEQUO  : ELYXTJUSYSHNIE  GTILDS          XVLSLEIJUDASY  
BFIYPDH         : HOUNUSQWKYLUIR  UYTRMXRHUWFJIBH HBEP            RVQBWBTFYK      YBEWRJVUY      
YJYJKHUYBAEFFU  : RPUMYGYBNKWLKG  CIOLUMY         TWUYRHDUDPRKKY  YIXWNL          GCYTEBE        
QWUXNROG        : NYFLHKUHNSVVVJ  EUNDHWLLHMJTUE  XKCHJNGMMMJH    IKLKNA          ELYXTJUSYSHNIE 
UQUMUC          : LWBGM           BHJOG          
VMKFYTCXXCDDJAI : SGQVOHQ         FAFFQ           XCDPLSFCL       PHLITJFFWHBDBA  VDLYKOI         CAHFU           KLWHSBJENMIEM  
YFBPAPV         : PMQJ            FQEFDGFIQFFA    NVEWWTWOLQ     
MMQYJU          : SATGEXIEDNQ     AUYNPHBK        LRTRU           RVABWARMUJBMBUB BUCRFDLPNVKDLE 
FJWMIQO         : QMMUUVAHL      
OTOTDQF         : YGQFBX          MDMMMTKYVPOUAU  NQQKVAIOSCW    
QMJGMAEGOQYQDUB : HGFKXFJP        HAXG            QAQN            DYHUEIXFHBXOPT  FGHFWNPMGKSI    YLDGKVSBWRET   
EAXPSMY         : JVRSKKOXSA      FOLHOHOJSJRDNS  PIOYHIFKFPJQLFC
IPEMGLU         : DFWPYTYJCUDFWM  LXDJTBFIHN      TYYARSGEURJNLCJ UDKYMXRPQGS    
YHFLJJUXDTO     : JHWUQIEGJPVPLU 
QRQXRQNLGO      : OCLQEG          IVYIWTKSQAISVNM KDVTOFNCYQJXJY  GNIPODCIWWEAX  
OECBM           : XAIHGPIYQAWCIB  MNEFWBSX        YTMEBXVHDL      TJDWBX         
YKPIPBRCX       : DPVOIA          YPAWVDVPFAF     HWRVNF          AVJUVKWPD       TFMWMELRERJDUS 
FSHLLBE         : UNYCSUVDRVCXAKB ADTDSKASTHLV    LIRCKCWUBT      UONXJNGTW       AAAYGRKPRY      IVLLQJYPP      
VVYHCNFQTJU     : DJLHG           EVFJU           KOAC            JNORVGKQGRCOGUO PEOIB           GHLCVSAYMSYJMWC
AVTPGLTX        : JHMIBD          BUIWDIIRO       PAAXBDLOKWYCSLF THXVS           VWPWSUKQJQCB   
RPUMYGYBNKWLKG  : YJYJKHUYBAEFFU  VABXCVVHAFVLE  
ANIWWDGX        : WITACNXS        OMAVCWBNHLKG    QQTDEXICWSG     FFQJEYKS        EMWRNYLGVLLTVO 
APHNJ           : HKTNVIFNJPLMUN  UGSDYJMRVOXNIR  RNAFPMWWKOW     CQFMUJ          FXDPMILHTQUSVH 
EEAYSYIRCV      : DXQNOW          ISIJQSOXLWN     JMDYY           IWVKY          
BJPHYP          : HTSQPNQ         PUIVNHOJRFNF   
HOUNUSQWKYLUIR  : BFIYPDH         PTHWAVLO        LGXCBQAIAOA    
IQTIYOMWTOIJX   : TETMBFQRAE     
BVPSQFNLVLVW    : TOUEQHVPTICA   
SGQVOHQ         : VMKFYTCXXCDDJAI BKXEIPKMLVK     RQHTTWLLOAUGEQ  QSJH           
JHMIBD          : DWEHSDQEJBWOGD  AVTPGLTX        LYASXMRIVNOW    FFBDSMSV       
MBYPWQIPVYDU    : TIVPE           SNIJYELCENXBWY  UFNRQBXB       
CRJWXA          : QJFBEGVKBEKTI   EVFJU           CLVBAUDC        HTMTNCYQFQUQ    UARYK          
NJMOS           : QAGPUK          TXNPHN          LLFNV           UBQU           
BEWEVLIWBHQM    : NLOBPLEMCAL     AQQWCTJDQMR     FKVEPETXTIE    
OLDJVFCHDCJY    : DDQGRQOMSAEEGC 
SNHOJI          : NMICYF          WHFS            JEYQBLAPRLJNN   KLHBAIYQ       
GPQRXPUFG       : GNKHMSOEWA      BTTFJGKYNJTKI  
FXUJHSQLAV      : CIQWBUQMC       YTTHRELYQAGF    JKCB            OQPWGENWCDJGOJB
JUGDKNRTYMAODTO : YCDDGCGLRVYXD   APLIJUPQTYRWDRL EGBIKXANIVCCMI 
PVCYCAUNHPGVQDK : UIHWVRQ         SWVNMI          FNYARRWWDVKBN   KGLNXGAAWSLRI  
ASHL            : IEIXJBX         KSNIVJKQIEVQG   GCYTEBE         XDOX           
YFGNGWQCLMT     : NPNOPEJND       PCQCAC          DLIORVXNIYWOAQR TGTY           
OTNOQD          : AXDJOULH        PDRVQAAJN       MBPHBTAG       
GKVYNG          : BRLLJLCWR       PTHWAVLO        LBNEXXD         RPMMVIGPRGEHXG  BIRNHQMBERRTG   TETMBFQRAE      VGQIRDCS        XOUHNGQLJFDVQ  
NCJYJLFRYNQSPEH : EKVPFBTQ        DEVYDLQXDUAVUH 
NVGCMYF         : MXCILJAWDH      XIFOCGL         XPKMQPFLS      
HPJHFRLTTWUFIC  : TAWCMN          BSKR            MWOMY           XQGIMQUG        LNUNSJDNADXTE  
KPPFITOUKK      : HBEP            MMBACP          VBXSTJLCXLU    
OYCTNLMYSRRGNN  : DPVOIA          HXMLPOLROSDER   JIIIJYRGE       LGPPQGBLUCW     XTOFGWHBP      
JVOLUBE         : PDXJTOHFIGPWHG  QLUFFUYB        WAPX           
GOJULTHOIISFYE  : KYASRBVHHSUGWPD OXXTC           MWOMY          
XALPGCGMNCCYW   : RUVHNSAHKSOYQBK DWEHSDQEJBWOGD  CGABAPH         RQHTTWLLOAUGEQ 
FMOTWJFSTV      : ETLRQWAGI       RCHK            CHVWPPDGKJOR    WQTRBMVJR      
EOJDVDCVOT      : BJEYHII        
SATGEXIEDNQ     : STOXFYMJ        MMQYJU          WRTHUBTRLMWRC   VGQIRDCS        OACBJIRXOMSEI   YLDGKVSBWRET   
KNERHAQLEFUKDX  : TXNPHN          PGJRD           LPYYKXSHDJWU   
BOIIILCOPA      : MGNFA           JPYFPJUG        PCELYMGUWNW    
TDNLVABAR       : LFIAG           LOKWAWEKWMANQ   BHJOG           QKOYWMCLWXP    
AIXGQSQ         : FFQJEYKS        LQIANI          RECWPYMBASDOFX  FVRYTBMKHEOXKK  MVHIWFYUHSX     JVRILFGJKE     
SFXKQGUCIJRKJM  : QAGPUK          TDRWPHBMVG      ACSQJNEFOKCVSR  TPMWCKANJAQKRO  WWFAQAWGPOTLBM  GPQDPVXKNOAG    MOQRVHOECOG     ODULUKQTNN     
YALYDNSOPCMWUIP : BMIMPCXUW       BMLRBFKYKT     
DXQNOW          : EEAYSYIRCV      CIQWBUQMC       IAAFJVKKFXEBOF  TFACEQPTD      
QHUKRGYIFYTGDK  : NCAHW           UKIBHEHRIYAB    IKLKNA          SQAKQXXLYGLPS  
TADIYXQRR       : MWAHGAVUQ       AGSWDLOHE      
PIMGIXYR        : PUQEU           OOSSTESDTUFJ    GOGMY          
JKBJUIKOOPBNJCT : ACSXRGPOVTPVG   SNIJYELCENXBWY  LMJCLQ          FXUKOUNR       
DTLWLK          : PTHWAVLO        EMGQY           IWPMVXNMQGQKDJP XETQCECP        MFELEOJU        DBKKXSTSTHC     PIOYHIFKFPJQLFC NTXM           
WXUHVTYQ        : OMRBOTVMC       HRKDLG          APLIJUPQTYRWDRL DSWOICFYUYUYRXS
LRPGCAXQSYGCDA  : IXXOIRWHT       EWFIPFVXMQNWHBK XJSVJKJIHKM     KSNIVJKQIEVQG  
JWJGIV          : WXEYCPYXEDUXCR  HAUPWFQPTBHSXVA BYUGHGBLJGOHJB  DTDF            RCMVGRHOABJQRLD RKHJMBHGPMNPW  
HTSQPNQ         : BJPHYP          YTLPGHJR        MRSSW          
VECL            : OJXBFEVMNCFEEUH TUKHIQUAOF      AFYHXLYMV       FUBRJR          SFLIIBCLLFLHRTM AQQWCTJDQMR    
ENJWGIGLOG      : XGBORS          UAMF           
XFTEOQA         : AMVMRHNASNE     BEXUDU          CSFUCYVKKF     
KTRDJILFOO      : BKXEIPKMLVK     AKRWNWIBC       TONLEUAF        NTXM           
AUIJ            : AWRKTEVABELXLEL BOKRTJOHPR      UIFJVYDLRWHCAKM BGMFDLQ        
PUYDJHLH        : SPPFLV          XAIUSXFHJJKSKWY FTHJKJTLWPPXS   FRCYND          KVYNVOMP        TYYARSGEURJNLCJ MJMGSKAC       
ILEYOELKVQVGDBV : EQOVAGKRHB      QCPHIKRDFQVBEB 
VVOEIHVD        : HXEJJU          GDHRDA          GXUDMHKJKKO     DCTJ            BMLRBFKYKT     
YOQLVGTJ        : YCRF            HFJB           
UAOGMNAI        : QJFBEGVKBEKTI   PBJHIO          BMIMPCXUW       HUNHBRKIJUPNT   VBXSTJLCXLU     KELASILNESAONID
DLPYJMNOW       : XAIHGPIYQAWCIB  VPXPIHFNOVX     BYLH            SLNCLP         
KAIMQYAOHVARQD  : NGXEKPX         ACSXRGPOVTPVG   RHAX           
YPWYBSEMJDYXTN  : PDXJTOHFIGPWHG  BGKDNOJFJOH     HSRPXUMFJKT     FQGCA          
TAWCMN          : HPJHFRLTTWUFIC  XCDPLSFCL       MNULINTCJSPUJPS
OELK            : MPWJ            XHSONX          YTWPPAVF       
GDHRDA          : VVOEIHVD        KCTTOKMDLA      YMGOBCKPEN      MHHJAGFOFUDCBWD WCVHW           JERQC          
EBJL            : YEJK            IQAKG           MOQRVHOECOG     PKRIMXSYOKRAU  
SOOSK           : FSRFABY         VCXPBM         
NEFMHTCLJGWVLD  : VAQGHPFAOLM     ERQAQCRH        SKUPBNAEBC     
UUFULJVVU       : XKCEQWIR       
QMDKWIACNNJJP   : XLNNVWY         KDVTOFNCYQJXJY  BIYHS           UEWBRACCBIHQ   
UYTRMXRHUWFJIBH : BFIYPDH         IXFTPLKAV       JLWYHTFOKRP     NYYYHMFHVCFCEX 
PXSTKP          : ASLSLRTTRRRDUQG IRCBAIHHQOSC    FXWSWEKE       
LRRYDDQA        : TLXDDOTRHVXNED  RKDIKLLMUCQJ    RSYGNSSGVLLBJQ  TYYARSGEURJNLCJ BVLAC          
PUQEU           : XXIBVK          PIMGIXYR        YPAWVDVPFAF     QNYBEXMTXRVJ   
MPHR            : MYSCKATD        OSSBYSDAJGK     TEXAPYPOVJIQVWN
PUIVNHOJRFNF    : NHUUNNEPEGMI    BJPHYP          IQLFMRLQIWKGG   XTOFGWHBP      
HGFKXFJP        : QMJGMAEGOQYQDUB LXPQEIQULOGH    EBDHYYS         ICMLEPFY       
CUWMJPTD        : EAASCOACDWYXMT  YCRF            EVHYK           RMLOTUIUSIHCRBH VGTLWSODIECG   
MXCILJAWDH      : NVGCMYF         IHTSGQNLEXHITY  JIIUQA          RYLGOSDWYGJKVOG MUDNFWX         YIXWNL          WRPFWDWGPRI    
JIRP            : UFAOPKPEYRKLX   JSTDUYYS        DLEAVSH         JXCG           
DPVOIA          : YKPIPBRCX       OYCTNLMYSRRGNN  BPRQOLHPCTW     NTXM           
FXGOPD          : YEJK            GNKHMSOEWA      BDQTMCT         AICK           
IPRKAGVADC      : XQJS            SJDOU           OVXCQKKGYPIMLIU MOQRVHOECOG    
QNSIDGNVED      : EYMAEQRCWFSYXG  BWAHRIEATOQYJSG RLHUTADRKENU   
FWLFDCWIVFAP    : HBHYRKWUTO      RGOKFNHAWY      XHXAHLUAS      
BVQDC           : EQOVAGKRHB      NGBHTG          CCIFRIGSJBBSJEF NSSDGON         BIPIVKYUINPJBUE
NSGGDMORITUQBT  : SJDOU           SYDSDRMPNKU    
GYEDICKIRFLOWPS : HVXLJ           KACRXFHYHOUWIKT VXHVICVFVFCJHHE CGBMXVYWLUSGIFA
DNWL            : KKQIXTKKQLYGBBD EMLYRNNFBAKM    GNIUHYYIRFYOV   RQBLTEDEHF      GYLVKPHCCV      UQDNVUDLBHRMD  
LAIVVFMWYOD     : NBIFNX          TYETHARXMLLJC   TGTY            TEJAKFSRQSPT    OHHKUJBDE       ILTFIXQQTI     
UIHWVRQ         : PVCYCAUNHPGVQDK QJFBEGVKBEKTI   BIRNHQMBERRTG  
EFXTAQYNPKH     : PTHWAVLO        SMYKRAHKGSWTJK  EYMAEQRCWFSYXG  FWBA            XKJSQQNTST      PKRIMXSYOKRAU  
MPWJ            : TRJUJWGULLT     OELK            LXPQEIQULOGH    WPEL            JNGHSXV         DMRKJN          FFXIATESNO     
JGWAMXWWHTSA    : MJBEHBKT        GDWPV           UMDTOUKIGCGMEE  YKYHJWPJ        FXUKOUNR        QBQCOSCAQCCA   
WESWAUNBLDN     : FGWWVYNVVFHUSNK DADK            ESCWNWRFGNLMIG  KSNIVJKQIEVQG   VDLVFQYQ       
GAKDJIOS        : ASLSLRTTRRRDUQG XTAD            FRCYND          KAGWCVCYCW     
OFEL            : WTVNADYOCATWMTD GJLMMBAYUCKB   
MHXOUUUPRUK     : HERQCPD         PDGKPXVQ        FNYARRWWDVKBN  
XXNLQUNCAAMPS   : BSHQWWEQ        FHIPEF         
EAASCOACDWYXMT  : CUWMJPTD        SLTTGAXDCLQ     VETUC           RYLGOSDWYGJKVOG
ACSXRGPOVTPVG   : JKBJUIKOOPBNJCT KAIMQYAOHVARQD  LXPQEIQULOGH    WYTFN           EMLYRNNFBAKM    XLPOAOHMI      
OCLQEG          : QRQXRQNLGO      SEXFFIACVN      RSQKGNTJAKIKQO  KLHBAIYQ        PTBRVCBGTYWI   
SJXVGXVTR       : HUIKBPJLQI      VHFFVYDUMLT     LGAXNU          WQDRQU         
VTLT            : RFDCGHFKPHSDYQ  HKSQPWIMMLFALY  EUKH           
TLDPFSOOA       : PSIEAYDEY       JGWH            VXHVICVFVFCJHHE PXTUCGOULFBSK   XDOX           
SNWWUSPEQNMOJ   : BNRNFLSHPHGYNY  IVYIWTKSQAISVNM VPXPIHFNOVX    
ICEENYSJKV      : QLHYTLJLAE      RVABWARMUJBMBUB MRYNFT         
SQPHQ           : UBXGHPEKMQPOYDX HWPDW          
AGSWDLOHE       : TADIYXQRR       WKIEWILTEPLPYJ  KWTRHU          TDEUSGFTUW      FGHFWNPMGKSI   
UTNFCP          : GAJMGLUKFTS     JEYQBLAPRLJNN   EMGQY          
HFJCQVXRO       : UJRWRYAE       
IXJEXPYWT       : VOMTET          EWFIPFVXMQNWHBK YMWDE          
NDQR            : TDDJ            XMOKVRLLAUFE   
MFGRWQBCCDSXDNN : DJLHG           CLVBAUDC        EAUWQNELJJHT   
VLDCMUBLONCUG   : JFRYGFBMIETLCIN FFRI           
UTADLYTMEVRWU   : NOOTENEMYKS     NKTJQFMDGEURL   SYDSDRMPNKU     RMKHD           ILNTWBJFTPVOK  
KKQIXTKKQLYGBBD : AXDJOULH        DNWL            IQAKG           CIOLUMY         FJEXVEGDUTKKBC 
WXEYCPYXEDUXCR  : JWJGIV          XEDKWIWSDXSE    LFIAG           TYYARSGEURJNLCJ RMYTQVNASI     
PELXC           : OMRBOTVMC       PQVL            ACSQJNEFOKCVSR  NYPSILWPU       KXOOIIEJLEAHY  
LPXYQ           : TUKHIQUAOF      XTGOKVOQAE     
BRJLQIPQMHPKNS  : TQYGS           TIBUBMGBHRPWF   KFUTIFD        
LWBGM           : UQUMUC          KNMYCBQHJCPU    FRCYND         
RNKBYCYXS       : TYETHARXMLLJC   IHJTUQIG        XTAD            VYXMQH          MEXDTQXWSVQBUVX TEXAPYPOVJIQVWN
YMRMDACTOLL     : DQESGTJ         HUCXDYTABHVDHSG BSKR           
YEJK            : EBJL            FXGOPD          KYMMMBBPQ       JXOR            UEWBRACCBIHQ    DXCM           
NSQUMEHNDJNE    : LMPUXIDAWOC     XEDKWIWSDXSE    KRGUOATMCL      CNAFIFCGKP     
VFONSUQWOHJBJ   : GHOYFAW         GJLMMBAYUCKB    DVYWNXCRAYPDHO 
HVXLJ           : GYEDICKIRFLOWPS DMIYMTTKSBSFCVC LOKWAWEKWMANQ  
FGELORRXHVDDBT  : IXXOIRWHT       ONFMYIPCA       TEEBMSBPJJK    
VOMTET          : IXJEXPYWT       DIXSHTGB        SFLIIBCLLFLHRTM GNIUHYYIRFYOV   FFFQUXD        
HERQCPD         : LXBD            MHXOUUUPRUK     JGWH           
HKTNVIFNJPLMUN  : APHNJ           JWFFMMCDXY      GVYSQQEBJD     
OJXBFEVMNCFEEUH : VECL            BEXUDU         
ETLRQWAGI       : FMOTWJFSTV      QQTDEXICWSG     XNWEJFJQCCRVD   CSFUCYVKKF      XOUHNGQLJFDVQ  
SWKIFCTDFAJ     : DPOHDXCPGH      EXNMKIJQV       YRXEWC          LGAXNU          HFJB            HNQYSGJAPXWRRUM
MWFTCLPLFV      : WDUWUUMJ        THBHS           RAID            OMAVCWBNHLKG    EPYIDSURRR      KYNVRKLHLTQY   
RQYQQ           : VRSGXDYJW       XTWIUCXGDP      VDLVFQYQ       
YIAVUIDWD       : CDAH           
DDQGRQOMSAEEGC  : OLDJVFCHDCJY    LVJXDIATNPHUEH  CSLGBH          PSNVNSQXUVGUT   NTXM           
ASLSLRTTRRRDUQG : PXSTKP          GAKDJIOS        HBCFEAVQCMAG    UDHHMODDQWS     XLPOAOHMI      
TLXDDOTRHVXNED  : LRRYDDQA        WRKDGGIDH       TKVVEJF         LGXCBQAIAOA    
EVMYKGS         : PXYUMTKVIQYDP   AFYHXLYMV       VXHVICVFVFCJHHE HLGDEQPRE       YEOPIIPFQT     
BKXEIPKMLVK     : SGQVOHQ         KTRDJILFOO      MDMMMTKYVPOUAU  HFSWM          
BYKVIHV         : HDST            CBXAOBVCM      
LYASXMRIVNOW    : JHMIBD          FSTTV           FWBA            OFJRWG         
NBIFNX          : LAIVVFMWYOD     OFJRWG          ITNGSFQ        
LIKMK           : MGNFA           EDUCSHRJ        WQVWKBIX        VMFJUPKBEALMSS  BANDAKXLE       KNRRWFBCVX      RMYTQVNASI     
KUEHRQG         : MGLT            SUMOKBYMWXHJ    XIFOCGL         HLGDEQPRE       HCPTKENS        PSFSFSHAFGXVXUV FGHFWNPMGKSI   
LEHFODSEAVTD    : YWTKEO          LGPPQGBLUCW     QJTBIJJ         QHFOBDW        
YQER            : VCIQPPRIBB      VPKXVPMEMPGO    KLLKRYUX        ESPGJAVDFY      AFVHJFKPWMNCK   LGAQNHLEJ      
PCQCAC          : NPNOPEJND       YFGNGWQCLMT     DHSHMMHTOQV     YNVXFEGDDCCS    BIRNHQMBERRTG   GJIMSXVCIX     
EJPWRJIYSQNVL   : IPGJMJXTKFNC    MBPHBTAG        JOFUXFOOCFN     THXVS           QGJTXDSOSIHGHX  OHDTI          
XHNBQMT         : VRSGXDYJW       BFCCN           YKSQTYMRN       DBKKXSTSTHC    
HXMLPOLROSDER   : OYCTNLMYSRRGNN  VXHVICVFVFCJHHE FQEFDGFIQFFA    JMDYY          
PDXJTOHFIGPWHG  : JVOLUBE         YPWYBSEMJDYXTN  JFRYGFBMIETLCIN
EDUCSHRJ        : LIKMK           KRGUOATMCL      ECBRCLSLUPBGA   WGSQILXFQ      
LXPQEIQULOGH    : HGFKXFJP        MPWJ            ACSXRGPOVTPVG  
NOOTENEMYKS     : UTADLYTMEVRWU   HGJYCW          LVJXDIATNPHUEH  XETQCECP        QXDAHCNI        IJUYLHIDBL     
MNEFWBSX        : OECBM           FQEFDGFIQFFA    JXWKSRLKQVAFUR  MEXDTQXWSVQBUVX
MCCD            : QKYCQNSQJ       TOPNQKW        
PTHWAVLO        : HOUNUSQWKYLUIR  GKVYNG          DTLWLK          EFXTAQYNPKH     YMWDE          
SEXFFIACVN      : OCLQEG          TKDPVBWJ        ILNTWBJFTPVOK   TEXX           
DLKXLCKNGNPV    : BMUHEDXEG       YIXWNL          XOUHNGQLJFDVQ  
WSKSG           : EUKH            UQWVLYPMTETY    DWWXILLHNIN    
NYFLHKUHNSVVVJ  : STOXFYMJ        QWUXNROG        DRDWQKBTIDILYLY VAQGHPFAOLM    
TUKHIQUAOF      : VECL            LPXYQ           PBJHIO          VPKXVPMEMPGO    VGQIRDCS       
JRSQSG          : IHTSGQNLEXHITY  JMIXMUKCJWP     LLUILMQ         ECBRCLSLUPBGA  
AUYNPHBK        : MMQYJU          NMICYF          VYXMQH         
YGOICJUJTO      : DGPEGP          SYDSDRMPNKU     GJDKAKNVNTJEUM  JLWYHTFOKRP    
UDOSNHN         : NHUUNNEPEGMI    HAYWTJII        XTWIUCXGDP     
CUVFP           : XWGDHUOIY       TPMWCKANJAQKRO  LRUGDXDQFWJQDOP
SHFVRIUAYFEIBO  : ONAEKFFWO       VGJPXRGAQYLRIM  QVLFFL          AMGUABAQFIH     WQWWKJWSBH     
PXYUMTKVIQYDP   : EVMYKGS         TUIXMYHPWL      TCGUXGYTLRHLMBU QLUFFUYB        TSQI            JMFHRFEFTB      ETTDSWFHHTP    
UNYCSUVDRVCXAKB : NHUUNNEPEGMI    FSHLLBE         JYJWCXFU       
OSOON           : CGBMXVYWLUSGIFA TYYARSGEURJNLCJ UARYK           NFENFKNDLR      CTAQQFTCJPDSYP 
KYASRBVHHSUGWPD : GOJULTHOIISFYE  CKEVRKXNCCLYWK  IPIVOSFCKUDANN  PBCS            YHFBJYWPMVWDWND
SVQUVRHWKY      : SJWUFXNVFIB     TFMWMELRERJDUS 
APFEAGETYGRGNL  : FABIICDRYHCHYT  WWXVFS          WDHVOI          LYGIYO          FFXIATESNO     
WITACNXS        : ANIWWDGX        YCDDGCGLRVYXD   ROCLOQAF        MFELEOJU       
TMUQX           : NMICYF          KWTRHU          FNYARRWWDVKBN  
GAJMGLUKFTS     : UTNFCP          CKEVRKXNCCLYWK  MUDNFWX        
DJLHG           : VVYHCNFQTJU     MFGRWQBCCDSXDNN BDQTMCT         KOBQA           ILTFIXQQTI     
DIXSHTGB        : VOMTET          JPYFPJUG        GOCHUC         
BUIWDIIRO       : AVTPGLTX        KACRXFHYHOUWIKT RHAX            TKVVEJF         MNULINTCJSPUJPS
NCAHW           : NHUUNNEPEGMI    QHUKRGYIFYTGDK  DQTGGF          BSKR            QDVUDTYFKRCPL  
MGLT            : KUEHRQG         IAFNHE          DEVYDLQXDUAVUH  BMUHEDXEG      
HAXG            : QMJGMAEGOQYQDUB CDAH            CEHAYQPSRNRORO 
FABIICDRYHCHYT  : STOXFYMJ        APFEAGETYGRGNL  FUBRJR          NLOBPLEMCAL     IWJSUUWQ        TEXAPYPOVJIQVWN
MXEWUGJCRG      : WHFS            SLCVDOQWA       TCGUXGYTLRHLMBU KFUTIFD         YMWDE          
YGQFBX          : OTOTDQF         TQYGS           AAAYGRKPRY      WPEL            CNAFIFCGKP      QHFOBDW        
DHSHMMHTOQV     : PCQCAC          IXFTPLKAV       KSXHRHG         YYMXBAMYAJPOB   MNULINTCJSPUJPS
UKIBHEHRIYAB    : QHUKRGYIFYTGDK  OSMEENCKBK      LRUGDXDQFWJQDOP
ISIJQSOXLWN     : EEAYSYIRCV      CQLX            XPAQXCPULQOTYTG KJQWT           DUGGXAPCHNP     WLVJHFOMEUSNU   EDXYIYY        
GHOYFAW         : VFONSUQWOHJBJ   RDCB            QIDFTRSQJTCRC   VPKXVPMEMPGO    ILGX            TONLEUAF        FSRFABY        
IXXOIRWHT       : LRPGCAXQSYGCDA  FGELORRXHVDDBT 
KCTTOKMDLA      : GDHRDA          QPUITOHBVMXW    JMME           
YAIIOKOQ        : BVUSEFFQDYDJ    HUCXDYTABHVDHSG
FAFFQ           : VMKFYTCXXCDDJAI QJFBEGVKBEKTI  
AQXVPKYLGNVUSJ  : ECMRGESDBCR     BWAHRIEATOQYJSG BDNT            PNGEG           MOBXAWDRFB     
VIUGTMQIDX      : HXEJJU          YSANVD          BDQTMCT         JOFUXFOOCFN     LMYHLCCCWKL    
FGWWVYNVVFHUSNK : WESWAUNBLDN     EGFA           
LDBGYJEGF       : BRLLJLCWR       SPDBNXH         MUNDDXNMPNIENMY AVJUVKWPD       CQFMUJ         
YNVXFEGDDCCS    : MWAHGAVUQ       PCQCAC          PDGKPXVQ        AUXB            LQIANI          GNIPODCIWWEAX   CCIFRIGSJBBSJEF
XAIUSXFHJJKSKWY : PUYDJHLH        SFLIIBCLLFLHRTM EHATWR         
CRSQNSXTYB      : GOCOFRJHCFKF    QENK           
DGPEGP          : JJYJCJ          YGOICJUJTO      YTTHRELYQAGF    DWMROSGAYVJYTI 
CINJSYUDTIAS    : EBUHLLNMIP      DMRKJN          BGMFDLQ         FFXIATESNO     
FKVVYOT         : PSFSFSHAFGXVXUV AHPIFEW        
PXSVEIAMB       : PCXCHJWWGT      XTGOKVOQAE     
QJFBEGVKBEKTI   : CRJWXA          UAOGMNAI        UIHWVRQ         FAFFQ           DPSIKRDYMMOY    ETMIMADD       
FENGVK          : CIQWBUQMC       SJDOU           DSWOICFYUYUYRXS FJXENXTWUTXVMD  ENBYDVNGUFBYDW  TFACEQPTD      
NKTJQFMDGEURL   : UTADLYTMEVRWU   ATOYBOHTCEVJMJD CRUT           
WRTHUBTRLMWRC   : SATGEXIEDNQ     RFGYUOOU        NEBATWARIWPTTG  FJEXVEGDUTKKBC  WPEL            UIFJVYDLRWHCAKM ECRLFJUMWW     
NMICYF          : SNHOJI          AUYNPHBK        TMUQX           HCSJAHM         RDCB            LLMQNNTRNJQFJQB WDUWUUMJ        ASEEESEVF      
NMICYF          : HNQYSGJAPXWRRUM
PKAVSEQKPOJKK   : CTOO            WGIJQDSAHHJS    UBUJTFNYC      
HNNYYA          : CKFOA          
TCDHROLQTAJ     : TONLEUAF        ERQAQCRH        WQDRQU         
AFYHXLYMV       : VECL            EVMYKGS         KLLKRYUX        PBPDOSJANS      FQGCA          
YOTPCSQCTKFWUYN : HDST            ULEBTJVHSFFS   
PHGYNJEOSC      : JKCB            NYPSILWPU       ELYXTJUSYSHNIE  DWRQEFWQ        DTHUUBAEGRIBWN 
TQYGS           : BRJLQIPQMHPKNS  YGQFBX          KJKUDOSGS       IHTSGQNLEXHITY  VETUC          
CIQWBUQMC       : FXUJHSQLAV      DXQNOW          FENGVK          KLFTB           RFJHGG          NFENFKNDLR      FYLLA           MHJTD          
HBEP            : BFIYPDH         KPPFITOUKK      RGOKFNHAWY     
MYSCKATD        : MPHR            VHFFVYDUMLT     KWTRHU          WRPFWDWGPRI    
WWXVFS          : APFEAGETYGRGNL  SUMOKBYMWXHJ    UONXJNGTW       MWPHYUO        
HBCFEAVQCMAG    : ASLSLRTTRRRDUQG BJYQKSSTVPYBMMI MRSSW           CGMQNHODHGWONNR GOVCRVUTBUPGDJ 
QAGPUK          : NJMOS           SFXKQGUCIJRKJM  BOKRTJOHPR      OMMKYRASR       QCPHIKRDFQVBEB 
WEFCB           : XPAQXCPULQOTYTG ESCWNWRFGNLMIG  GQLSQDVBYJM    
CYKULR          : KYMMMBBPQ       ITMEWQHL        WRKDGGIDH       TWUYRHDUDPRKKY  JMFHRFEFTB      HIKUQU         
PYCPVVUKXBEQBM  : LGPPQGBLUCW     QJTBIJJ         DXCM           
XXKVCP          : OJATLTA         ILGX            EPYIDSURRR     
GUCF            : NGBHTG          CCIFRIGSJBBSJEF IWVKY           KQWTMF          PTBRVCBGTYWI   
WSBWJBYBYWVLVY  : EKVPFBTQ        OIBVKIQQAETK    JIIIJYRGE      
MCFVBDGWIYW     : XXIBVK          FFQJEYKS        SWIEQULAUXYKRO  MNULINTCJSPUJPS PTBRVCBGTYWI   
VBXFA           : RAID            UCBMH          
GWDJX           : TGTY            NIFJCRIPVAQJF   POEDEKNOE       RVABWARMUJBMBUB OACBJIRXOMSEI  
KXFWVEP         : EWJE            WYTFN           KFKQIMLTGN      HAUPWFQPTBHSXVA TPBD           
HUIKBPJLQI      : SJXVGXVTR       SYDSDRMPNKU     JERQC           EVHYK           DTHUUBAEGRIBWN 
OJATLTA         : XXKVCP          IIAKRYKKMGVWFIM UCLFREXOQUARIB  FCSYTXNNBEIUHJ  OACBJIRXOMSEI  
WKIEWILTEPLPYJ  : AGSWDLOHE       UYDOGSEAPUEM    DLEAVSH         RUCAXRHYDUYPC  
LMPUXIDAWOC     : NSQUMEHNDJNE    XROUJMKSWRI     LFIAG           XLSNARMKGLOLMHW DEVYDLQXDUAVUH 
AWRKTEVABELXLEL : AUIJ            IQLFMRLQIWKGG   CKEVRKXNCCLYWK  RTPDYFYOC       OHMN           
FUBRJR          : VECL            FABIICDRYHCHYT  HLCPMCXGH      
HCSJAHM         : NMICYF         
KJKUDOSGS       : TQYGS           CDAH            SMWNTUUMKQ      WKNEIPTWYC     
TSJX            : VBMPFUBYQS     
MGCNXLHMVKHFK   : YTWPPAVF        JXOR            RFJHGG          JNGHSXV        
RDCB            : GHOYFAW         NMICYF          RNAFPMWWKOW     USBXJKHLMQRK    AFGQ            RMLOTUIUSIHCRBH
WHFS            : RCIITTPVFBXOGH  SNHOJI          MXEWUGJCRG      WDHVOI          CSLGBH          VJFCMOVQXIX    
XQJS            : IPRKAGVADC      AUXB            AQQWCTJDQMR     BFCCN           JMFHRFEFTB     
KXQQCGQPQF      : MGNFA           XIFOCGL         VYXMQH         
BNRNFLSHPHGYNY  : SNWWUSPEQNMOJ   VYXMQH          WGNKFJCNGF      KXOOIIEJLEAHY   NVEWWTWOLQ     
NRAHVKHMDJTV    : SKSJKYKNRPKTL   KGQHGHFOQEUJ   
KCNNP           : EKXFIMFFEAO     ESBLHD          PAAXBDLOKWYCSLF DJOKQ           QPKSDOIWLIYQNP 
DUSVEKEKJTM     : NIFJCRIPVAQJF  
JEYQBLAPRLJNN   : SNHOJI          UTNFCP         
PBJHIO          : UAOGMNAI        TUKHIQUAOF      UTYFMHGEBKWPFYP
DLIORVXNIYWOAQR : YFGNGWQCLMT     BYLH           
QIDFTRSQJTCRC   : GHOYFAW         MCRYUTHNSQLODE  KLWHSBJENMIEM  
VHFFVYDUMLT     : SJXVGXVTR       MYSCKATD        TMLMRF          NGBHTG          HUBYEWT         QKYCQNSQJ       UCLFREXOQUARIB 
CTCUHVDNBYHT    : XLNNVWY         SWIEQULAUXYKRO  HNQYSGJAPXWRRUM
QPUITOHBVMXW    : KCTTOKMDLA      LTPTYOBUTGEC    SLTTGAXDCLQ     JRVYOIHECL     
SJDOU           : IPRKAGVADC      NSGGDMORITUQBT  FENGVK          WQVWKBIX       
KACRXFHYHOUWIKT : GYEDICKIRFLOWPS BUIWDIIRO       LBQKBCMDDNJDOX  XKSXIYOKYRGO   
EKXFIMFFEAO     : KCNNP           FKVEPETXTIE     ERQAQCRH        AFVHJFKPWMNCK   NTUWACFQ        XRUT           
OMRBOTVMC       : WXUHVTYQ        PELXC           DVMIYPYVDEPXEK  QGTLT           YRXEWC          BVDS           
NJSKIDUDTBPUIYJ : MOQRVHOECOG    
EQOVAGKRHB      : ILEYOELKVQVGDBV BVQDC           MAPGE           XFVWA           UYQTLEKNKLM     TPBD           
DPOHDXCPGH      : SWKIFCTDFAJ     LMJCLQ         
LBNEXXD         : GKVYNG          RHAX            VFJJWLYK       
MJBEHBKT        : HBLIXBY         JGWAMXWWHTSA    MXBDFXEQGNLDTJ 
TUIXMYHPWL      : PXYUMTKVIQYDP   TGTY            YYMXBAMYAJPOB   DKNWFEVH        NIEORMAPDWGTP  
FSTTV           : LYASXMRIVNOW    HOPTKGQO        PVBMVJHXJQBAMUX CKFOA           JCQDNBBKBGCNLR 
XWGDHUOIY       : CUVFP           XPAQXCPULQOTYTG YXYJE           UDHHMODDQWS     QLHYTLJLAE      RMKHD          
JLSFGQPEDONVNBD : KYMMMBBPQ       NHGQFWNKIYHTMU  PTBRVCBGTYWI   
TXNPHN          : NJMOS           KNERHAQLEFUKDX  HJGHR           TPMWCKANJAQKRO  PSYXMJLRCIQW    PEOIB          
PQVL            : NPNOPEJND       PELXC           AIXSQJMTKYJY    SPDBNXH         BUKMYSQKID      UMLXLSW        
EMGQY           : HBLIXBY         DTLWLK          UTNFCP          PDPVQHJBKI      EHATWR          TFACEQPTD      
XHSONX          : CLQCBRBBERW     OELK            MMBACP          IYHPCYPCV       BJEYHII        
BVTCC           : MWPHYUO         PNGEG          
XCDPLSFCL       : VMKFYTCXXCDDJAI TAWCMN         
PSIEAYDEY       : TLDPFSOOA       UFAOPKPEYRKLX   EYMAEQRCWFSYXG  JVJMPOLGYOA     GQLSQDVBYJM    
YPAWVDVPFAF     : YKPIPBRCX       PUQEU           TYWFOIHAMGKHCV  PBPDOSJANS      MVHIWFYUHSX    
EKVPFBTQ        : NHUUNNEPEGMI    NCJYJLFRYNQSPEH WSBWJBYBYWVLVY  BIRNHQMBERRTG   RTPDYFYOC       TETMBFQRAE     
LLMQNNTRNJQFJQB : NMICYF          MLHS            WWFAQAWGPOTLBM  CRUT           
MSUOA           : EPYIDSURRR      RECWPYMBASDOFX  COVFC          
SMYKRAHKGSWTJK  : EFXTAQYNPKH     ELYXTJUSYSHNIE  WWDOWMB        
GDWPV           : JGWAMXWWHTSA    LLFNV           TLPYBJBNOH      BANDAKXLE      
YMGOBCKPEN      : GDHRDA          MRSSW           IHLWPR          VGTLWSODIECG   
RMXLOFYUXVQII   : NGXEKPX         VDLYKOI        
ONAEKFFWO       : SHFVRIUAYFEIBO  JKCB            TYWFOIHAMGKHCV  HKIUOFLOI      
BSHQWWEQ        : XXNLQUNCAAMPS   UBXGHPEKMQPOYDX MAAGAVBCSKSTA   LGAQNHLEJ      
CDAH            : YIAVUIDWD       HAXG            KJKUDOSGS       QXDAHCNI        MAAGAVBCSKSTA  
UFAOPKPEYRKLX   : JIRP            PSIEAYDEY       GJDKAKNVNTJEUM  UYDOGSEAPUEM    GQWBHCLMERKU   
KOPLHWFET       : NTNEH           MRSSW          
XFNBFW          : VFJJWLYK       
CCHQ            : UHTD            KRGUOATMCL      BXVE           
TIBUBMGBHRPWF   : BRJLQIPQMHPKNS  LLFNV           MUNDDXNMPNIENMY PBPDOSJANS     
TKDPVBWJ        : SEXFFIACVN      HPDNRDJDXVJI    SKMBSEMNU      
CGLGLU          : CKEVRKXNCCLYWK  XROUJMKSWRI     XGCUHAJXASNHPL  EJTNYDXOTUMVNME GSKX           
IPGJMJXTKFNC    : EJPWRJIYSQNVL   SUMOKBYMWXHJ    TGUFNUFIJHU     PDPVQHJBKI      FSMRTSUAD       VFRVHOFTATG     GOFFERFVUUOQH  
UBXGHPEKMQPOYDX : SQPHQ           BSHQWWEQ        EWFIPFVXMQNWHBK DBRJRWBBFN      KELASILNESAONID
BVUSEFFQDYDJ    : CLQCBRBBERW     MWAHGAVUQ       YAIIOKOQ        IUAWQHUNAFRH    JLJPBLN         HIKUQU          XOUHNGQLJFDVQ  
GNKHMSOEWA      : GPQRXPUFG       FXGOPD          RJTRCSJGELPM   
PRIPWGCXEXQJFW  : RCIITTPVFBXOGH  CIOLUMY         ICMLEPFY        UELORKDAIOL    
IXFTPLKAV       : UYTRMXRHUWFJIBH DHSHMMHTOQV     HSAXJCCDPQKM    MUNDDXNMPNIENMY HLCPMCXGH       CGOLTROQRVI    
UMDTOUKIGCGMEE  : JGWAMXWWHTSA    APLIJUPQTYRWDRL CGMQNHODHGWONNR XTGOKVOQAE     
EVFJU           : VVYHCNFQTJU     CRJWXA          SLCVDOQWA       BFCCN          
SUMOKBYMWXHJ    : KUEHRQG         WWXVFS          IPGJMJXTKFNC    IEIXJBX         ITNGSFQ        
EBYOJHSPUWWOCST : XGCUHAJXASNHPL  LWDNIWTOEBTJPK 
PDGKPXVQ        : MHXOUUUPRUK     YNVXFEGDDCCS    IHLWPR          EAUWQNELJJHT   
KPXSCCWDDN      : OUIWGLJTKRAH    FJXENXTWUTXVMD  QWXRNXUYEMPH    PSNVNSQXUVGUT  
LGFIFCYJWUXOXEY : GOLN            MFELEOJU        OACBJIRXOMSEI  
EWJE            : KXFWVEP         MMBACP          MDMMMTKYVPOUAU  BWAHRIEATOQYJSG CSFUCYVKKF      DXJG            QBQCOSCAQCCA   
YCDDGCGLRVYXD   : JUGDKNRTYMAODTO WITACNXS        AORAN           DXJG            CEBWJBBNURJXJKX
FHIPEF          : FOQRTIT         XXNLQUNCAAMPS   AXVTQCRTEESAVQT UTYFMHGEBKWPFYP ULEBTJVHSFFS    WLVJHFOMEUSNU   BIPIVKYUINPJBUE
SFTTV           : UTYFMHGEBKWPFYP UFNRQBXB        GVYSQQEBJD      HWPDW          
RFDCGHFKPHSDYQ  : VTLT            QAQN            RECWPYMBASDOFX  SQAKQXXLYGLPS   CEBWJBBNURJXJKX
YTMEBXVHDL      : OECBM           XMMTW           UQWVLYPMTETY    COVFC           LMYHLCCCWKL    
JGWH            : TLDPFSOOA       HERQCPD         QGTLT           ECBRCLSLUPBGA   TYCSF          
QMMUUVAHL       : FJWMIQO         NQQKVAIOSCW     NTUWACFQ       
BOKRTJOHPR      : NPOOTJNCEUVHJEK AUIJ            QAGPUK          KFUTIFD         OMAVCWBNHLKG    SQLEDWFJVJHYJJ 
OCKAETGDBPV     : PSAPIS          YUKMWGKCLTQEK   IAFNHE          DCTJ            RORVWULPIC      GSKX            FXDPMILHTQUSVH 
CQLX            : ISIJQSOXLWN     GPQDPVXKNOAG    XKSXIYOKYRGO    DBTLKXAGBG     
SLCVDOQWA       : MXEWUGJCRG      EVFJU           HFHM            XPILHPGNWSA     XJSVJKJIHKM     DTHUUBAEGRIBWN 
ESBLHD          : NPNOPEJND       KCNNP           JFPHWA          CGABAPH         WGLVOERGK       MRQYNWPLAPBN    NRMSMDXA       
HKSQPWIMMLFALY  : VTLT            EWFIPFVXMQNWHBK EMWRNYLGVLLTVO  USBXJKHLMQRK   
ADTDSKASTHLV    : FSHLLBE         RDVUSWB        
UYRFJ           : IKLKNA          JXWKSRLKQVAFUR  XRUT           
VCKGOY          : VETUC           RQHTTWLLOAUGEQ  LPYYKXSHDJWU    KNDUSKDMWFK    
TCGUXGYTLRHLMBU : PXYUMTKVIQYDP   MXEWUGJCRG      OMMKYRASR       IEIXJBX         OMMQKEIB        WUENEGRCTJUDS  
WQVWKBIX        : LIKMK           SJDOU           WBLXDJVWCBRXHV  JMME            MEXDTQXWSVQBUVX
KIGBIAXK        : XHXAHLUAS       POEDEKNOE      
SKOTE           : GNIPODCIWWEAX   DWVNYBTGDNIK   
NLOBPLEMCAL     : BEWEVLIWBHQM    FABIICDRYHCHYT  DPSIKRDYMMOY    MYBQGTODVB      DMRKJN         
EUNDHWLLHMJTUE  : QWUXNROG        PLVMQX          KXOOIIEJLEAHY   CEBWJBBNURJXJKX
KYMMMBBPQ       : YEJK            CYKULR          JLSFGQPEDONVNBD RSYGNSSGVLLBJQ  JRVYOIHECL      OHDTI          
TDRWPHBMVG      : SFXKQGUCIJRKJM  BMLRBFKYKT      KAGWCVCYCW     
USHEFSXAAG      : RSQKGNTJAKIKQO  QCPHIKRDFQVBEB 
YSANVD          : VIUGTMQIDX      HSAXJCCDPQKM    DMIYMTTKSBSFCVC IWPMVXNMQGQKDJP
MSASL           : VETUC           RWGAVPEQYEAWF   ANXG            ODULUKQTNN      YGHKNGFE       
IUAWQHUNAFRH    : BVUSEFFQDYDJ    CULAGFWYEWFN    ODULUKQTNN     
RHAX            : KAIMQYAOHVARQD  BUIWDIIRO       LBNEXXD         DPAXUWDYD       KYNVRKLHLTQY   
YTWPPAVF        : OELK            MGCNXLHMVKHFK   MUNDDXNMPNIENMY RMKHD           UJNKSEV        
VXHVICVFVFCJHHE : GYEDICKIRFLOWPS TLDPFSOOA       EVMYKGS         HXMLPOLROSDER   RFMJUVM         PHLITJFFWHBDBA  VKDK            CPIF           
IVYIWTKSQAISVNM : QRQXRQNLGO      SNWWUSPEQNMOJ   PGGYN           DLEAVSH         AVJUVKWPD       GJIMSXVCIX      ERDCGVBEL      
LTPTYOBUTGEC    : QPUITOHBVMXW    TONLEUAF        XMOKVRLLAUFE    WWDOWMB         VWPWSUKQJQCB    TEXAPYPOVJIQVWN
KSXHRHG         : DHSHMMHTOQV     JIIIJYRGE       DUGGXAPCHNP    
TYETHARXMLLJC   : LAIVVFMWYOD     RNKBYCYXS       BMUHEDXEG       DYFXKUJF       
IQLFMRLQIWKGG   : PUIVNHOJRFNF    AWRKTEVABELXLEL
PMQJ            : LXBD            YFBPAPV         PLVMQX          JERQC           NVEWWTWOLQ      COVFC           UBQU            AFGQ           
WDUWUUMJ        : MWFTCLPLFV      NMICYF          FTHJKJTLWPPXS   IHLWPR          YKSQTYMRN      
XLPIEBNSVYMEXWK : JPYFPJUG       
BDQTMCT         : FXGOPD          DJLHG           VIUGTMQIDX      RFMJUVM         CGMQNHODHGWONNR
ASPUH           : KFUTIFD         HCBAAMLDE      
CFMTNQXDMTFY    : CIOLUMY         GNQSOFCUO       GTILDS          UQDNVUDLBHRMD  
DVMIYPYVDEPXEK  : OMRBOTVMC       PSAPIS          CEBWJBBNURJXJKX
BSNEAAAOT       : SFLIIBCLLFLHRTM SNIJYELCENXBWY  VDLVFQYQ       
TGTY            : YFGNGWQCLMT     LAIVVFMWYOD     GWDJX           TUIXMYHPWL      XHXAHLUAS       EPYIDSURRR      BMLRBFKYKT      MEXDTQXWSVQBUVX
TGTY            : NRMSMDXA       
TDDJ            : NDQR            XTWIUCXGDP      XLACBAFXYMS     DUGGXAPCHNP     TSQI           
EYMAEQRCWFSYXG  : PAQKD           QNSIDGNVED      EFXTAQYNPKH     PSIEAYDEY       JNGHSXV         YLDGKVSBWRET   
XIFOCGL         : NVGCMYF         KUEHRQG         KXQQCGQPQF      WCVHW           FSNJIVXGXULUD   CSFUCYVKKF      MIVC            AHRCFVDQBK     
AKRWNWIBC       : KTRDJILFOO      JCXDIAWHL       GYLVKPHCCV     
OEOHYSHELGERNED : MGNFA           OVNHY           TGUFNUFIJHU     YXKRQ           UTYFMHGEBKWPFYP XKCEQWIR        FGHFWNPMGKSI    AHPIFEW        
THBHS           : MWFTCLPLFV      KAROUUWAVA      RMYTQVNASI     
RKDIKLLMUCQJ    : LRRYDDQA        GXUDMHKJKKO     DKCAGRYJHNRGLJ  BXVE           
PDRVQAAJN       : OTNOQD          DPSIKRDYMMOY    JMIXMUKCJWP     FXUKOUNR        JDNGJQEMJLLSF  
OIBVKIQQAETK    : WSBWJBYBYWVLVY  IRCBAIHHQOSC    UBQU           
FWBA            : EFXTAQYNPKH     LYASXMRIVNOW    IHJTUQIG        FGHFWNPMGKSI   
TMLMRF          : VHFFVYDUMLT     HUBYEWT         WENDLFG         PNGEG          
IHJTUQIG        : HBLIXBY         RNKBYCYXS       FWBA            TEEBMSBPJJK     FCSYTXNNBEIUHJ 
HSAXJCCDPQKM    : IXFTPLKAV       YSANVD          UAKFASDVL       TGIUJXSMKOWUO   WPEL           
KNMYCBQHJCPU    : RCIITTPVFBXOGH  LWBGM           LIRCKCWUBT      IQAKG          
MLHS            : LLMQNNTRNJQFJQB NUYEINT         JMDYY           FSRFABY         LRUGDXDQFWJQDOP
ONFMYIPCA       : FGELORRXHVDDBT  FVRYTBMKHEOXKK  UCLFREXOQUARIB  YYYMAYXKWOGT    FOLHOHOJSJRDNS  HKIUOFLOI      
MMBACP          : WMFIJNEUYXXWI   KPPFITOUKK      XHSONX          EWJE            JVJMPOLGYOA     ANXG           
EQSOAUEVSSHAON  : MCTXGJFLHGLTAD  GTILDS          MOQRVHOECOG    
CSCCDTGDA       : NJUNSHISQPEK    OXBAVMXLOQJQJE  SWIEQULAUXYKRO  VCXPBM         
RDVUSWB         : ADTDSKASTHLV    OVXCQKKGYPIMLIU WRKDGGIDH       FNDEPIMWC       FFRI           
RPMMVIGPRGEHXG  : GKVYNG          UOJKVUUFL       DJOKQ           UOUEBLCUXHHKG  
CKEVRKXNCCLYWK  : HBHYRKWUTO      KYASRBVHHSUGWPD GAJMGLUKFTS     AWRKTEVABELXLEL CGLGLU          CCIFRIGSJBBSJEF TJUJBNBWUPBY    VJFCMOVQXIX    
HDST            : BYKVIHV         YOTPCSQCTKFWUYN UKVTXWKHMPEK    KUQWXUXWGYXTTR 
PEXF            : EDXYIYY        
HJGHR           : TXNPHN          FXUKOUNR        HRMCWN         
JFPHWA          : FCDFWYTPGTT     ESBLHD          BHJOG           KRGUOATMCL      MRYNFT          LRUGDXDQFWJQDOP
MFJAE           : RCMVGRHOABJQRLD
KHQNBMGSSGXSPJ  : OEKUV           RUCAXRHYDUYPC  
WDKGIBPHDXVIHVP : AIXSQJMTKYJY   
JYJWCXFU        : UNYCSUVDRVCXAKB WCVHW           XPILHPGNWSA     USBXJKHLMQRK    RPFMUHHTXX     
OSMEENCKBK      : UKIBHEHRIYAB    UMLXLSW        
EBDHYYS         : HGFKXFJP        WCVHW           DETRBI          WAPX            PCELYMGUWNW    
XKCHJNGMMMJH    : QWUXNROG        WYUKNVUE        DEVYDLQXDUAVUH  KSNIVJKQIEVQG  
FTHJKJTLWPPXS   : PUYDJHLH        WDUWUUMJ        KAROUUWAVA      MRYNFT         
YTTHRELYQAGF    : FXUJHSQLAV      DGPEGP          QWXRNXUYEMPH    UBUJTFNYC      
UOVXTSFEDRAO    : LGPPQGBLUCW     AWAVPQPNNKCFUG  GCYTEBE        
RGOKFNHAWY      : FWLFDCWIVFAP    HBEP            HAYWTJII        KNRRWFBCVX      DWRQEFWQ       
JBWLJCCETXENSLT : HGJYCW          SJWUFXNVFIB     PCXCHJWWGT     
DWMROSGAYVJYTI  : DGPEGP          WYTFN           RVIEEKYVH       QCPHIKRDFQVBEB  UARYK           YBEWRJVUY      
FJFQS           : BUKMYSQKID     
SYDSDRMPNKU     : NSGGDMORITUQBT  UTADLYTMEVRWU   YGOICJUJTO      HUIKBPJLQI      FVRYTBMKHEOXKK  IVLLQJYPP      
XPAQXCPULQOTYTG : ISIJQSOXLWN     WEFCB           XWGDHUOIY       WDHVOI          TNAK           
MBPHBTAG        : OTNOQD          EJPWRJIYSQNVL   SMEIG           CGABAPH         ULEBTJVHSFFS    KGLNXGAAWSLRI  
OXBAVMXLOQJQJE  : CSCCDTGDA       SFLIIBCLLFLHRTM
AUXB            : YNVXFEGDDCCS    XQJS            JIIUQA          QYVCRRWO        BEXUDU          AHRCFVDQBK     
GJDKAKNVNTJEUM  : WTVNADYOCATWMTD YGOICJUJTO      UFAOPKPEYRKLX   JIIIJYRGE      
QBEEPXNIHSMJPN  : SKUPBNAEBC      TEXX           
HVWMGWATU       : OOGDICWDCADAC   JMME            BIXRBWBUD      
QGTLT           : OMRBOTVMC       JGWH           
EWFIPFVXMQNWHBK : LRPGCAXQSYGCDA  IXJEXPYWT       UBXGHPEKMQPOYDX HKSQPWIMMLFALY  ICRHNUEI        GOCHUC         
WHDGH           : SWFWEABIDQC    
ACSQJNEFOKCVSR  : SFXKQGUCIJRKJM  PELXC           PXTUCGOULFBSK   HSRPXUMFJKT     TFRTLCOFRM      TNAK           
RSQKGNTJAKIKQO  : IGLXTR          OCLQEG          USHEFSXAAG      CGBMXVYWLUSGIFA
VPXPIHFNOVX     : DLPYJMNOW       SNWWUSPEQNMOJ   OVNHY           LQIANI          HCPTKENS        YKSQTYMRN       GSPVUWILMQ     
TTLXNEP         : RNAFPMWWKOW    
KFUTIFD         : BRJLQIPQMHPKNS  MXEWUGJCRG      BOKRTJOHPR      ASPUH           DUGGXAPCHNP    
XROUJMKSWRI     : NJUNSHISQPEK    LMPUXIDAWOC     CGLGLU          JMAC            RPFMUHHTXX     
NIFJCRIPVAQJF   : GWDJX           DUSVEKEKJTM     YTLPGHJR        GQLSQDVBYJM     UMENV          
DPSIKRDYMMOY    : QJFBEGVKBEKTI   NLOBPLEMCAL     PDRVQAAJN       EMWRNYLGVLLTVO  FFRI           
LQPWGYDPDUA     : LGXCBQAIAOA    
SAMC            : XAIHGPIYQAWCIB  IIAKRYKKMGVWFIM ISSLRQMBCXK     JFRYGFBMIETLCIN
AIXSQJMTKYJY    : PQVL            WDKGIBPHDXVIHVP CBXAOBVCM       LFIAG           PSNVNSQXUVGUT   BUOUODXOSEXTNH  ILNTWBJFTPVOK   VJFCMOVQXIX    
SKSJKYKNRPKTL   : NRAHVKHMDJTV    BJEYHII         MRSSW           RQHTTWLLOAUGEQ  HLCPMCXGH      
UAKFASDVL       : HSAXJCCDPQKM    EJTNYDXOTUMVNME JXWKSRLKQVAFUR 
IIAKRYKKMGVWFIM : OJATLTA         SAMC            AVJUVKWPD      
YWTKEO          : LEHFODSEAVTD    PXTUCGOULFBSK   HCBAAMLDE       RIIE            RAIOOWDGPNWUQM  IMFHMPYRXT     
OVNHY           : OEOHYSHELGERNED VPXPIHFNOVX     MUDNFWX        
TOUEQHVPTICA    : XAIHGPIYQAWCIB  BVPSQFNLVLVW    HAUPWFQPTBHSXVA BANDAKXLE      
BIRNHQMBERRTG   : PARQOC          GKVYNG          UIHWVRQ         PCQCAC          EKVPFBTQ       
HOPTKGQO        : FSTTV           TABUBOGKHYBNCPL QMTEDSHMW      
XMMTW           : YTMEBXVHDL      DPAXUWDYD       DBRJRWBBFN     
UGSDYJMRVOXNIR  : APHNJ           OEKUV           QXXTKMLGNQ      BGKDNOJFJOH     QBQCOSCAQCCA   
YCLOXXUOOROD    : AJHVKBFPWIFQUQP CAHFU           TNDAPEJ        
IAAFJVKKFXEBOF  : SPPFLV          DXQNOW          HIKUQU         
YYMXBAMYAJPOB   : DHSHMMHTOQV     TUIXMYHPWL      TYCSF           BXVE           
RKPTMUFIIPPGUT  : TKVVEJF         SKUPBNAEBC     
CLVBAUDC        : CRJWXA          MFGRWQBCCDSXDNN NVEWWTWOLQ     
ECTUQWYKJQEWM   : BANDAKXLE       ILTFIXQQTI     
HUCXDYTABHVDHSG : FCDFWYTPGTT     XLNNVWY         YMRMDACTOLL     YAIIOKOQ        JVRSKKOXSA     
DKNWFEVH        : TUIXMYHPWL      RJTRCSJGELPM    CTOO           
GXUDMHKJKKO     : VVOEIHVD        RKDIKLLMUCQJ    XMOKVRLLAUFE   
GOLN            : PAQKD           LGFIFCYJWUXOXEY IWJSUUWQ        HCPTKENS       
OUIWGLJTKRAH    : KPXSCCWDDN      EPYIDSURRR      ESCWNWRFGNLMIG  KJQWT           QXDAHCNI       
QPYOSOXFXI      : CRUT           
NUYEINT         : MLHS            DSXGKHUAV      
KDVTOFNCYQJXJY  : QRQXRQNLGO      QMDKWIACNNJJP   NGBHTG          BIYHS           NTXM           
ATOYBOHTCEVJMJD : NKTJQFMDGEURL   EVHYK          
VGJPXRGAQYLRIM  : NGXEKPX         SHFVRIUAYFEIBO  WBLXDJVWCBRXHV 
JIIIJYRGE       : OYCTNLMYSRRGNN  WSBWJBYBYWVLVY  KSXHRHG         GJDKAKNVNTJEUM  ETMIMADD        FFXIATESNO     
CNLNQAJ         : XLNNVWY         TBITPEIINWIGM   QCPHIKRDFQVBEB 
JCXDIAWHL       : AKRWNWIBC       RWGAVPEQYEAWF   KOBQA           WGLVOERGK      
RAID            : MWFTCLPLFV      VBXFA           VDLYKOI        
SLTTGAXDCLQ     : EAASCOACDWYXMT  QPUITOHBVMXW    XVLSLEIJUDASY   OHHKUJBDE       XVVYXKM         HWPDW          
FQEFDGFIQFFA    : YFBPAPV         HXMLPOLROSDER   MNEFWBSX        HPKLFAAUMAMPUEI
VRSGXDYJW       : RQYQQ           XHNBQMT         EMLYRNNFBAKM    WWDOWMB        
PXTUCGOULFBSK   : TLDPFSOOA       ACSQJNEFOKCVSR  YWTKEO          VESPXICOVLCU   
XTAD            : GAKDJIOS        RNKBYCYXS       XNPCEGWIM       QXXTKMLGNQ      ECRLFJUMWW     
AXVTQCRTEESAVQT : FHIPEF          LRTRU           RCMVGRHOABJQRLD
VCIQPPRIBB      : YQER            RFGYUOOU        JMIXMUKCJWP    
WBLXDJVWCBRXHV  : WQVWKBIX        VGJPXRGAQYLRIM  NGBHTG          SLNCLP          BGMFDLQ        
HRKDLG          : WXUHVTYQ        FJLSAVQYB      
VYXMQH          : RNKBYCYXS       AUYNPHBK        KXQQCGQPQF      BNRNFLSHPHGYNY  QCPHIKRDFQVBEB  MRSUEIJFGCE    
TPMWCKANJAQKRO  : SFXKQGUCIJRKJM  CUVFP           TXNPHN          SWVNMI          OHDTI          
NGBHTG          : BVQDC           GUCF            VHFFVYDUMLT     KDVTOFNCYQJXJY  WBLXDJVWCBRXHV  RNAFPMWWKOW     FNDEPIMWC      
AORAN           : YCDDGCGLRVYXD   TJUJBNBWUPBY   
SWVNMI          : PVCYCAUNHPGVQDK TPMWCKANJAQKRO  KTAIMKTXIHQXHJN CQFMUJ          RUCAXRHYDUYPC  
QVLFFL          : SHFVRIUAYFEIBO  WYTFN           BSKR            NTUWACFQ       
RFMJUVM         : VXHVICVFVFCJHHE BDQTMCT        
PSAPIS          : VBMPFUBYQS      OCKAETGDBPV     DVMIYPYVDEPXEK  XXSYSBEEA       IJUYLHIDBL      UBQU           
VYJSV           : YPBWWLQVAAI     PSYXMJLRCIQW    RCUEYPIDOJ      ATXFDPGHL      
HGJYCW          : NOOTENEMYKS     JBWLJCCETXENSLT VPKXVPMEMPGO    GSKX            FCSYTXNNBEIUHJ  UCFSTAO        
JKCB            : FXUJHSQLAV      PHGYNJEOSC      ONAEKFFWO       LWDNIWTOEBTJPK 
OMMKYRASR       : QAGPUK          TCGUXGYTLRHLMBU RMLOTUIUSIHCRBH
DMIYMTTKSBSFCVC : HVXLJ           YSANVD          RCMVGRHOABJQRLD ERDCGVBEL      
HPKLFAAUMAMPUEI : FQEFDGFIQFFA    NEPI            TEEBMSBPJJK    
RSYGNSSGVLLBJQ  : LRRYDDQA        KYMMMBBPQ       RMKHD          
TGUFNUFIJHU     : IPGJMJXTKFNC    OEOHYSHELGERNED MDMMMTKYVPOUAU 
CCHCVBBEQ       : AWAVPQPNNKCFUG  QKILWNYFY      
WYUKNVUE        : XKCHJNGMMMJH    QAQN            BIXRBWBUD      
OMAVCWBNHLKG    : MWAHGAVUQ       ANIWWDGX        MWFTCLPLFV      BOKRTJOHPR      RCHK           
MQQITTOKQ       : YYYMAYXKWOGT    VWPWSUKQJQCB   
JLWYHTFOKRP     : UYTRMXRHUWFJIBH YGOICJUJTO      GJIMSXVCIX      BAJIVPSVXAWV    GSKX           
UOJKVUUFL       : RPMMVIGPRGEHXG  VNOJGATQVOWNEI  NQQKVAIOSCW    
VESPXICOVLCU    : PXTUCGOULFBSK   BYLH            WQDRQU         
LOSBBLS         : SWFWEABIDQC     VCXPBM          UULDXT         
IHTSGQNLEXHITY  : MXCILJAWDH      JRSQSG          TQYGS           UKVTXWKHMPEK    PAAXBDLOKWYCSLF UMLXLSW        
CBXAOBVCM       : BYKVIHV         AIXSQJMTKYJY    LTEVQUERM       CTAQQFTCJPDSYP  WENDLFG        
VNOJGATQVOWNEI  : UOJKVUUFL       ELYXTJUSYSHNIE 
DRDWQKBTIDILYLY : NYFLHKUHNSVVVJ  YAVXALET       
JOFUXFOOCFN     : EJPWRJIYSQNVL   VIUGTMQIDX      OXXTC           RWGAVPEQYEAWF   JSTDUYYS        DFUAJKNXJVLNXN 
JVJMPOLGYOA     : PSIEAYDEY       MMBACP          EMLYRNNFBAKM   
UKVTXWKHMPEK    : HDST            IHTSGQNLEXHITY  JMDYY           XRUT            RLHUTADRKENU    FDXCXGUQE      
SYXXMPKKBYA     : SMWNTUUMKQ      LGAXNU          YIXWNL         
LIRCKCWUBT      : FSHLLBE         KNMYCBQHJCPU    RONBTX         
XEDKWIWSDXSE    : LXBD            WXEYCPYXEDUXCR  NSQUMEHNDJNE   
IOWLNYCBJWGT    : EBJLOF          HFSWM           REISUHKLDUTTSS 
FRCYND          : PUYDJHLH        GAKDJIOS        LWBGM          
SPDBNXH         : LDBGYJEGF       PQVL            QFSNQFFGH      
QNYBEXMTXRVJ    : PUQEU           KHJWLYPTPFEFVY  TEJAKFSRQSPT    TJUJBNBWUPBY    ORODAXTHUJTFK   JMAC           
EERJXWLLATERY   : TYYARSGEURJNLCJ HUNHBRKIJUPNT   WQWWKJWSBH     
HWRVNF          : YKPIPBRCX       MWOMY          
QLUFFUYB        : JVOLUBE         PXYUMTKVIQYDP  
PHLITJFFWHBDBA  : VMKFYTCXXCDDJAI VXHVICVFVFCJHHE
JWFFMMCDXY      : HKTNVIFNJPLMUN  QAQN           
EUKH            : VTLT            WSKSG           CGABAPH         MJMGSKAC       
APLIJUPQTYRWDRL : JUGDKNRTYMAODTO WXUHVTYQ        UMDTOUKIGCGMEE  UONXJNGTW       UMLXLSW        
QQTDEXICWSG     : ANIWWDGX        ETLRQWAGI       OVXCQKKGYPIMLIU
DQTGGF          : NCAHW           XGCUHAJXASNHPL  LTEVQUERM       OKMETAIPOS      FJEXVEGDUTKKBC 
RCHK            : FMOTWJFSTV      OMAVCWBNHLKG    DFWPYTYJCUDFWM  IQAKG           ORODAXTHUJTFK   TNDAPEJ        
ICTNVF          : TABUBOGKHYBNCPL
OXXTC           : GOJULTHOIISFYE  JOFUXFOOCFN     BUKMYSQKID     
CHVWPPDGKJOR    : FMOTWJFSTV      YVUGOP         
IWJSUUWQ        : FABIICDRYHCHYT  GOLN            DCTJ            RMLOTUIUSIHCRBH
SXLJWLDYKHIG    : BMLRBFKYKT     
YXKFKTUFV       : AXDJOULH        HLCPMCXGH       LMYHLCCCWKL     EGFA           
CGYWBVOLROY     : GPQDPVXKNOAG    PQNOEYKQIIRQS   IVLLQJYPP      
LLFNV           : NJMOS           GDWPV           TIBUBMGBHRPWF   JTOCXVAQVVASPTY
VETUC           : EAASCOACDWYXMT  TQYGS           VCKGOY          MSASL           GPTRFLTB       
DPAXUWDYD       : RHAX            XMMTW           PGGYN           MXBDFXEQGNLDTJ 
XGBORS          : ENJWGIGLOG      TWUYRHDUDPRKKY  JFRYGFBMIETLCIN
RTPDYFYOC       : UHTD            NKIIQESV        AWRKTEVABELXLEL EKVPFBTQ        LOKWAWEKWMANQ   NEBATWARIWPTTG 
IYHPCYPCV       : XHSONX          PBCS           
IWPMVXNMQGQKDJP : DTLWLK          YSANVD          JMFHRFEFTB     
OOSSTESDTUFJ    : PIMGIXYR        UQWVLYPMTETY    FCSYTXNNBEIUHJ 
BWIBOUWNLLG     : HLCPMCXGH      
DSWOICFYUYUYRXS : WXUHVTYQ        FENGVK          LRTRU           NSSDGON        
FFQJEYKS        : ANIWWDGX        AIXGQSQ         MCFVBDGWIYW     EMLYRNNFBAKM   
JIIUQA          : XIJVMWLNIAKKI   MXCILJAWDH      AUXB            TEJAKFSRQSPT   
JXOR            : YEJK            MGCNXLHMVKHFK   YUKMWGKCLTQEK  
UQWVLYPMTETY    : WSKSG           YTMEBXVHDL      OOSSTESDTUFJ    JVRILFGJKE     
DFWPYTYJCUDFWM  : IPEMGLU         RCHK            WLVJHFOMEUSNU  
MHHJAGFOFUDCBWD : GDHRDA         
BJYQKSSTVPYBMMI : HBCFEAVQCMAG    LYGIYO         
VPKXVPMEMPGO    : YQER            TUKHIQUAOF      GHOYFAW         HGJYCW          ICRHNUEI        MCRYUTHNSQLODE  RIIE           
JPQSO           : TLPYBJBNOH      ITNGSFQ         BXVE           
DKCAGRYJHNRGLJ  : RKDIKLLMUCQJ    UIFJVYDLRWHCAKM ODULUKQTNN     
KHJWLYPTPFEFVY  : QNYBEXMTXRVJ   
HFHM            : SLCVDOQWA       DSXGKHUAV       PVBMVJHXJQBAMUX QKYCQNSQJ       VFJJWLYK        PESSWOFYUIYK   
PGGYN           : RCIITTPVFBXOGH  IVYIWTKSQAISVNM DPAXUWDYD       FNYARRWWDVKBN  
SWIEQULAUXYKRO  : MCFVBDGWIYW     CTCUHVDNBYHT    CSCCDTGDA       JXWKSRLKQVAFUR 
XWNATUFDHMSO    : MYBQGTODVB      QMTEDSHMW      
TETMBFQRAE      : IQTIYOMWTOIJX   GKVYNG          EKVPFBTQ        QXXTKMLGNQ      QAQN            MNULINTCJSPUJPS
WCVHW           : GDHRDA          XIFOCGL         JYJWCXFU        EBDHYYS        
YUKMWGKCLTQEK   : OCKAETGDBPV     JXOR            GQWBHCLMERKU   
XPKMQPFLS       : NVGCMYF         VTWNYEOVUDQFUYO GJIMSXVCIX     
IPOEALTY        : WMFIJNEUYXXWI   DWWXILLHNIN     HCPTKENS       
GOGMY           : PIMGIXYR        ATUAVJNYNDI     YIXWNL         
ASEEESEVF       : NMICYF          LVJXDIATNPHUEH  WLVJHFOMEUSNU  
OVXCQKKGYPIMLIU : IPRKAGVADC      RDVUSWB         QQTDEXICWSG     KOAC            XETQCECP       
WDHVOI          : NJUNSHISQPEK    APFEAGETYGRGNL  WHFS            XPAQXCPULQOTYTG BPRQOLHPCTW    
SMWNTUUMKQ      : KJKUDOSGS       SYXXMPKKBYA     EHATWR         
MJXXSWPBJBJGTI  : QFSNQFFGH       MXBDFXEQGNLDTJ  SBVWUDUT        AFVHJFKPWMNCK   SHMKEYAILEXHMGG SQAKQXXLYGLPS   HDFYPY         
CGBMXVYWLUSGIFA : LVUN            NKIIQESV        GYEDICKIRFLOWPS OSOON           RSQKGNTJAKIKQO 
RJTRCSJGELPM    : GNKHMSOEWA      DKNWFEVH       
BYLH            : DLPYJMNOW       DLIORVXNIYWOAQR VESPXICOVLCU    AHPIFEW        
XHXAHLUAS       : FWLFDCWIVFAP    KIGBIAXK        TGTY            REISUHKLDUTTSS 
HUBYEWT         : VHFFVYDUMLT     TMLMRF          XVVYXKM        
PDPVQHJBKI      : EMGQY           IPGJMJXTKFNC    RVQBWBTFYK      MIVC            RYPPN          
SLNCLP          : DLPYJMNOW       WBLXDJVWCBRXHV  IQAKG          
XKJSQQNTST      : EFXTAQYNPKH     QDVUDTYFKRCPL   KAROUUWAVA      TJWTTGQMJX     
OFJRWG          : HBLIXBY         LYASXMRIVNOW    NBIFNX          XPCUKWCN       
HRORADMNQPAGYAT : VBMPFUBYQS      LNUNSJDNADXTE  
SMEIG           : YPBWWLQVAAI     MBPHBTAG        VAQGHPFAOLM     LMJCLQ         
EXNMKIJQV       : SWKIFCTDFAJ     EPYIDSURRR     
IKLKNA          : QWUXNROG        QHUKRGYIFYTGDK  UYRFJ           XMOKVRLLAUFE    YKYHJWPJ        MRSUEIJFGCE     UCFSTAO        
HPDNRDJDXVJI    : TKDPVBWJ       
JMDYY           : EEAYSYIRCV      HXMLPOLROSDER   MLHS            UKVTXWKHMPEK    DCTJ            HWPDW          
HLGDEQPRE       : EVMYKGS         KUEHRQG         FFBDSMSV       
SFLIIBCLLFLHRTM : VECL            VOMTET          XAIUSXFHJJKSKWY BSNEAAAOT       OXBAVMXLOQJQJE 
IQAKG           : EBJL            KKQIXTKKQLYGBBD KNMYCBQHJCPU    RCHK            SLNCLP          FVRYTBMKHEOXKK  SAHL           
XNPCEGWIM       : XTAD            DADK            RFGYUOOU        CEHAYQPSRNRORO 
PAAXBDLOKWYCSLF : AVTPGLTX        KCNNP           IHTSGQNLEXHITY  UONXJNGTW       QWXRNXUYEMPH    PBACQSBPWH      GPTRFLTB       
CIOLUMY         : YJYJKHUYBAEFFU  KKQIXTKKQLYGBBD PRIPWGCXEXQJFW  CFMTNQXDMTFY    TKVVEJF         LYGIYO         
QFSNQFFGH       : SPDBNXH         MJXXSWPBJBJGTI  GOCOFRJHCFKF    MUDNFWX        
FJLSAVQYB       : HRKDLG          YMWDE           RMKHD           OMMQKEIB       
LGPPQGBLUCW     : OYCTNLMYSRRGNN  LEHFODSEAVTD    PYCPVVUKXBEQBM  UOVXTSFEDRAO    BTTFJGKYNJTKI  
IRCBAIHHQOSC    : PXSTKP          OIBVKIQQAETK    RMKHD           FDXCXGUQE       QENK           
TABUBOGKHYBNCPL : HOPTKGQO        ICTNVF          KGLNXGAAWSLRI   UJRWRYAE        LMJCLQ          KNDUSKDMWFK    
MAPGE           : EQOVAGKRHB      DJOKQ           DTDF           
GOCOFRJHCFKF    : CRSQNSXTYB      QFSNQFFGH       FSMRTSUAD      
LVJXDIATNPHUEH  : DDQGRQOMSAEEGC  NOOTENEMYKS     ASEEESEVF       MOBXAWDRFB     
KLFTB           : NGXEKPX         CIQWBUQMC       AVPFCDM         VCXPBM         
KIYT            : CNAFIFCGKP     
DADK            : WESWAUNBLDN     XNPCEGWIM       THXVS           JXWKSRLKQVAFUR 
OHMN            : AWRKTEVABELXLEL
XPILHPGNWSA     : SLCVDOQWA       JYJWCXFU        RCUEYPIDOJ      CYREFRBK       
XTOFGWHBP       : OYCTNLMYSRRGNN  PUIVNHOJRFNF    BMIMPCXUW       XXVBLVAIVXSK   
DSXGKHUAV       : NUYEINT         HFHM            VBIYRGBWIW     
RFGYUOOU        : WRTHUBTRLMWRC   VCIQPPRIBB      XNPCEGWIM       RWGAVPEQYEAWF   KXOOIIEJLEAHY   UCBMH           BUOUODXOSEXTNH  QPKSDOIWLIYQNP 
QGJLWRRV        : NVEWWTWOLQ     
UONXJNGTW       : XXIBVK          FSHLLBE         WWXVFS          APLIJUPQTYRWDRL PAAXBDLOKWYCSLF HSRPXUMFJKT    
VTWNYEOVUDQFUYO : XPKMQPFLS       KVYNVOMP       
XGCUHAJXASNHPL  : CGLGLU          EBYOJHSPUWWOCST DQTGGF          TDEUSGFTUW      FFBDSMSV        YGHKNGFE       
LFIAG           : TDNLVABAR       WXEYCPYXEDUXCR  LMPUXIDAWOC     AIXSQJMTKYJY    RQBLTEDEHF      EHBMYMNXL      
OEKUV           : KHQNBMGSSGXSPJ  UGSDYJMRVOXNIR  EPYIDSURRR      HIKUQU         
RWGAVPEQYEAWF   : MSASL           JCXDIAWHL       JOFUXFOOCFN     RFGYUOOU       
LOKWAWEKWMANQ   : TDNLVABAR       HVXLJ           RTPDYFYOC       CGMQNHODHGWONNR
KOAC            : NGXEKPX         VVYHCNFQTJU     OVXCQKKGYPIMLIU VFJJWLYK       
IEIXJBX         : ASHL            SUMOKBYMWXHJ    TCGUXGYTLRHLMBU KFKQIMLTGN     
DWWXILLHNIN     : WSKSG           IPOEALTY        BBHDINRBH       FNDEPIMWC      
HAYWTJII        : UDOSNHN         RGOKFNHAWY      EGFA           
KWTRHU          : AGSWDLOHE       TMUQX           MYSCKATD        VKDK            XLPOAOHMI       SQAKQXXLYGLPS   WMBTGJB        
ISSLRQMBCXK     : SAMC            UYQTLEKNKLM    
IYRRBQOU        : CNAFIFCGKP      RUCAXRHYDUYPC  
WGNKFJCNGF      : BNRNFLSHPHGYNY  RVABWARMUJBMBUB KNRRWFBCVX     
YXKRQ           : OEOHYSHELGERNED QKOYWMCLWXP     CTOO           
UTYFMHGEBKWPFYP : PBJHIO          FHIPEF          SFTTV           OEOHYSHELGERNED HLQRLW          KGQHGHFOQEUJ   
MCTXGJFLHGLTAD  : EQSOAUEVSSHAON  WQTRBMVJR       FSNJIVXGXULUD   YIXWNL         
WYTFN           : ACSXRGPOVTPVG   KXFWVEP         DWMROSGAYVJYTI  QVLFFL         
LTEVQUERM       : CBXAOBVCM       DQTGGF          EPYIDSURRR      HIKUQU         
GOPEUYL         : SANWLJBKAXQR    UELORKDAIOL     MOBXAWDRFB     
JSTDUYYS        : JIRP            JOFUXFOOCFN     PEOIB          
SANWLJBKAXQR    : GOPEUYL         VDLYKOI        
MXBDFXEQGNLDTJ  : MJBEHBKT        DPAXUWDYD       MJXXSWPBJBJGTI  YXYJE           CKFOA           XOUHNGQLJFDVQ  
SEFNESMRFQEFOUA : AXDJOULH        JMME            VNLYRC          ANXG           
IAFNHE          : MGLT            OCKAETGDBPV     LXDJTBFIHN     
BMIMPCXUW       : YALYDNSOPCMWUIP UAOGMNAI        XTOFGWHBP       ROCLOQAF       
AMGUABAQFIH     : FCPULJQ         SHFVRIUAYFEIBO  JXCG            LLUILMQ         MVHIWFYUHSX     BVDS            NPWMY          
KLLKRYUX        : YQER            AFYHXLYMV       BVLAC          
VKDK            : VXHVICVFVFCJHHE KWTRHU          TJUJBNBWUPBY   
FJXENXTWUTXVMD  : FENGVK          KPXSCCWDDN      TFRTLCOFRM      HFJB            OSSBYSDAJGK    
VGQIRDCS        : GKVYNG          SATGEXIEDNQ     TUKHIQUAOF      WGLVOERGK       RPFMUHHTXX      LGXCBQAIAOA    
AMVMRHNASNE     : XFTEOQA        
LXDJTBFIHN      : RUVHNSAHKSOYQBK IPEMGLU         IAFNHE         
NEPI            : HPKLFAAUMAMPUEI SNIJYELCENXBWY  YAVXALET       
TBITPEIINWIGM   : CNLNQAJ         GNQSOFCUO       QYVCRRWO        LYGIYO         
NYPSILWPU       : PELXC           PHGYNJEOSC     
DCTJ            : VVOEIHVD        OCKAETGDBPV     IWJSUUWQ        JMDYY           BPRQOLHPCTW     HNQYSGJAPXWRRUM
CSLGBH          : JRGOQU          DDQGRQOMSAEEGC  WHFS           
IPIVOSFCKUDANN  : KYASRBVHHSUGWPD RQBLTEDEHF     
KFKQIMLTGN      : KXFWVEP         IEIXJBX         FOLHOHOJSJRDNS  MOBXAWDRFB     
RVQBWBTFYK      : VBMPFUBYQS      BFIYPDH         PDPVQHJBKI     
EMLYRNNFBAKM    : DNWL            ACSXRGPOVTPVG   VRSGXDYJW       JVJMPOLGYOA     FFQJEYKS        YXYJE           BMLRBFKYKT      UBQU           
EMLYRNNFBAKM    : QHFOBDW        
UYDOGSEAPUEM    : JAGRDRC         WKIEWILTEPLPYJ  UFAOPKPEYRKLX   QKOYWMCLWXP     WGSQILXFQ      
XTWIUCXGDP      : RQYQQ           UDOSNHN         TDDJ            SWFWEABIDQC     BMUHEDXEG       HKIUOFLOI      
QXXTKMLGNQ      : UGSDYJMRVOXNIR  XTAD            TETMBFQRAE      WENDLFG        
TJDWBX          : OECBM           YTLPGHJR        IWVKY           DWVNYBTGDNIK   
PVBMVJHXJQBAMUX : FSTTV           HFHM            TLPYBJBNOH      JNGHSXV        
QKYCQNSQJ       : MCCD            VHFFVYDUMLT     HFHM            VFJJWLYK        ECMRGESDBCR    
TGIUJXSMKOWUO   : HSAXJCCDPQKM    TFMWMELRERJDUS  HDFYPY          DXCM           
LQIANI          : HDHYSYQXIGB     AIXGQSQ         YNVXFEGDDCCS    VPXPIHFNOVX    
ETMIMADD        : QJFBEGVKBEKTI   JIIIJYRGE      
HAUPWFQPTBHSXVA : JWJGIV          KXFWVEP         TOUEQHVPTICA    ENBYDVNGUFBYDW  HRMCWN         
OKMETAIPOS      : DQTGGF          QLHYTLJLAE      BEXUDU         
RVIEEKYVH       : DWMROSGAYVJYTI  MOQRVHOECOG     SJWUFXNVFIB    
MYBQGTODVB      : NLOBPLEMCAL     XWNATUFDHMSO    GOFFERFVUUOQH   WUENEGRCTJUDS   KWIRK          
JPYFPJUG        : RCIITTPVFBXOGH  BOIIILCOPA      DIXSHTGB        XLPIEBNSVYMEXWK
YXYJE           : XWGDHUOIY       MXBDFXEQGNLDTJ  EMLYRNNFBAKM   
TEEBMSBPJJK     : FGELORRXHVDDBT  IHJTUQIG        HPKLFAAUMAMPUEI
MIEJRTI         : KLWHSBJENMIEM   DFUAJKNXJVLNXN 
LRTRU           : MMQYJU          AXVTQCRTEESAVQT DSWOICFYUYUYRXS PYROYPL         TPBD           
SWFWEABIDQC     : WHDGH           LOSBBLS         XTWIUCXGDP      UCLFREXOQUARIB  DEVYDLQXDUAVUH 
GNQSOFCUO       : CFMTNQXDMTFY    TBITPEIINWIGM   BTTFJGKYNJTKI   UCFSTAO        
QYVCRRWO        : AUXB            TBITPEIINWIGM   OMMQKEIB        RQBLTEDEHF     
PLVMQX          : EUNDHWLLHMJTUE  PMQJ            AQQWCTJDQMR    
BBHDINRBH       : DWWXILLHNIN    
ILGX            : GHOYFAW         XXKVCP          AVJUVKWPD       CTOO            DVYWNXCRAYPDHO 
WWFAQAWGPOTLBM  : SFXKQGUCIJRKJM  LLMQNNTRNJQFJQB WQVUCRRMQJQDRI  HKIUOFLOI      
RONBTX          : LIRCKCWUBT      WGLVOERGK       EHBMYMNXL      
NYYYHMFHVCFCEX  : UYTRMXRHUWFJIBH
DETRBI          : NHUUNNEPEGMI    EBDHYYS         HTMTNCYQFQUQ   
NTNEH           : KOPLHWFET       NNSC            FXWSWEKE        XKSXIYOKYRGO    GHLCVSAYMSYJMWC RAIOOWDGPNWUQM 
BHJOG           : UQUMUC          TDNLVABAR       JFPHWA          GSPVUWILMQ     
NQWUASXH        : MWAHGAVUQ       XJSVJKJIHKM    
EGBIKXANIVCCMI  : JUGDKNRTYMAODTO YAVXALET        TJWTTGQMJX     
EJTNYDXOTUMVNME : CGLGLU          UAKFASDVL       UMLXLSW         UPRBRDHF       
QKOYWMCLWXP     : JJYJCJ          TDNLVABAR       YXKRQ           UYDOGSEAPUEM    CSFUCYVKKF     
KXOOIIEJLEAHY   : PELXC           BNRNFLSHPHGYNY  EUNDHWLLHMJTUE  RFGYUOOU        PCXCHJWWGT      EAUWQNELJJHT   
EPYIDSURRR      : MWFTCLPLFV      XXKVCP          MSUOA           TGTY            OUIWGLJTKRAH    EXNMKIJQV       OEKUV           LTEVQUERM      
EPYIDSURRR      : UJFFAL         
TDEUSGFTUW      : NPOOTJNCEUVHJEK AGSWDLOHE       XGCUHAJXASNHPL  QGJTXDSOSIHGHX 
GDNRIPCHFI      : QSJH            VGTLWSODIECG   
ESCWNWRFGNLMIG  : WESWAUNBLDN     WEFCB           OUIWGLJTKRAH   
QAQN            : QMJGMAEGOQYQDUB RFDCGHFKPHSDYQ  WYUKNVUE        JWFFMMCDXY      TETMBFQRAE     
WQTRBMVJR       : SXJGLRHXERSQAJW FMOTWJFSTV      MCTXGJFLHGLTAD  MUDNFWX         UDECGJBYKOUKG  
KVYNVOMP        : PUYDJHLH        VTWNYEOVUDQFUYO
UDHHMODDQWS     : ASLSLRTTRRRDUQG XWGDHUOIY       VNLYRC          PNACJLPJC      
VLRP            : RUCAXRHYDUYPC  
ELYXTJUSYSHNIE  : HDHYSYQXIGB     RFDDCQVLYOEQUO  QWUXNROG        PHGYNJEOSC      SMYKRAHKGSWTJK  VNOJGATQVOWNEI  UAMF           
NNSC            : FCPULJQ         NTNEH           KAGWCVCYCW     
XFVWA           : NPOOTJNCEUVHJEK EQOVAGKRHB      BVLAC           HRMCWN         
TONLEUAF        : KTRDJILFOO      GHOYFAW         TCDHROLQTAJ     LTPTYOBUTGEC    VBIYRGBWIW     
TOPNQKW         : MCCD            FKVEPETXTIE     BYUGHGBLJGOHJB  GPTRFLTB        BRIAAX         
UDRJRKLXK       : LXBD            DBRJRWBBFN      ECMRGESDBCR    
TIVPE           : MBYPWQIPVYDU    UMENV           XPCUKWCN       
GPQDPVXKNOAG    : SFXKQGUCIJRKJM  CQLX            CGYWBVOLROY     BXVE           
YMWDE           : IXJEXPYWT       PTHWAVLO        MXEWUGJCRG      FJLSAVQYB       WAQSKA         
WQVUCRRMQJQDRI  : WWFAQAWGPOTLBM  QXDAHCNI        BGKDNOJFJOH    
UYQTLEKNKLM     : EQOVAGKRHB      ISSLRQMBCXK     FKVEPETXTIE     AOPRAQVO        LYGIYO          EDXYIYY        
KRGUOATMCL      : LVUN            NSQUMEHNDJNE    EDUCSHRJ        CCHQ            JFPHWA          DTDF            PTBRVCBGTYWI   
QCPHIKRDFQVBEB  : ILEYOELKVQVGDBV QAGPUK          USHEFSXAAG      DWMROSGAYVJYTI  CNLNQAJ         VYXMQH          SKMBSEMNU       UWMPTRBAQAGY   
QCPHIKRDFQVBEB  : PCXCHJWWGT     
RNAFPMWWKOW     : APHNJ           RDCB            TTLXNEP         NGBHTG          MWOMY           ROCLOQAF       
DBRJRWBBFN      : UBXGHPEKMQPOYDX XMMTW           UDRJRKLXK       KUQWXUXWGYXTTR  GCYTEBE        
ITMEWQHL        : CYKULR          XYPJCKXCQ      
XLSNARMKGLOLMHW : XAIHGPIYQAWCIB  LMPUXIDAWOC    
EBJLOF          : IOWLNYCBJWGT    WRKDGGIDH       DMRKJN         
KTAIMKTXIHQXHJN : SWVNMI          AVPFCDM        
RYLGOSDWYGJKVOG : MXCILJAWDH      EAASCOACDWYXMT  WKNEIPTWYC      ODULUKQTNN     
KJQWT           : ISIJQSOXLWN     OUIWGLJTKRAH    BVLAC           LPYYKXSHDJWU   
XETQCECP        : DTLWLK          NOOTENEMYKS     OVXCQKKGYPIMLIU AGLBXMN        
WRKDGGIDH       : TLXDDOTRHVXNED  CYKULR          RDVUSWB         EBJLOF          KWIRK           KNDUSKDMWFK    
MUNDDXNMPNIENMY : LDBGYJEGF       TIBUBMGBHRPWF   IXFTPLKAV       YTWPPAVF        HCBAAMLDE       EHBMYMNXL      
RFJHGG          : CIQWBUQMC       MGCNXLHMVKHFK  
QLHYTLJLAE      : ICEENYSJKV      XWGDHUOIY       OKMETAIPOS     
EHATWR          : XAIUSXFHJJKSKWY EMGQY           SMWNTUUMKQ      KAGWCVCYCW     
FXWSWEKE        : PXSTKP          NTNEH           AAAYGRKPRY     
TKVVEJF         : TLXDDOTRHVXNED  BUIWDIIRO       RKPTMUFIIPPGUT  CIOLUMY        
FSMRTSUAD       : IPGJMJXTKFNC    GOCOFRJHCFKF    CPIF           
VAQGHPFAOLM     : HXEJJU          NEFMHTCLJGWVLD  NYFLHKUHNSVVVJ  SMEIG           JMIXMUKCJWP     AOPRAQVO        ECBRCLSLUPBGA  
BJEYHII         : EOJDVDCVOT      XHSONX          SKSJKYKNRPKTL  
OOGDICWDCADAC   : DWEHSDQEJBWOGD  HVWMGWATU       FSNJIVXGXULUD   IJUYLHIDBL      POSHSSDUKCRK   
GJLMMBAYUCKB    : FCDFWYTPGTT     OFEL            VFONSUQWOHJBJ   JCBJHXOMX       JHWUQIEGJPVPLU 
RMKHD           : UTADLYTMEVRWU   XWGDHUOIY       YTWPPAVF        RSYGNSSGVLLBJQ  FJLSAVQYB       IRCBAIHHQOSC    VFRVHOFTATG    
PGJRD           : KNERHAQLEFUKDX  FOLHOHOJSJRDNS  MVHIWFYUHSX     ATUAVJNYNDI     AICK            IJUYLHIDBL     
VFRVHOFTATG     : IPGJMJXTKFNC    RMKHD          
THXVS           : KAIJ            AVTPGLTX        EJPWRJIYSQNVL   DADK            BFCCN           NHGQFWNKIYHTMU  RPFMUHHTXX     
XMOKVRLLAUFE    : NDQR            LTPTYOBUTGEC    GXUDMHKJKKO     IKLKNA         
DLEAVSH         : JIRP            WKIEWILTEPLPYJ  IVYIWTKSQAISVNM UJFFAL         
SBVWUDUT        : MJXXSWPBJBJGTI  QMTEDSHMW       HRMCWN         
YTLPGHJR        : HTSQPNQ         NIFJCRIPVAQJF   TJDWBX          LRUGDXDQFWJQDOP
KOBQA           : DJLHG           JCXDIAWHL       BSKR            YVUGOP          BIPIVKYUINPJBUE YHFBJYWPMVWDWND
CEHAYQPSRNRORO  : DWEHSDQEJBWOGD  HAXG            XNPCEGWIM      
POEDEKNOE       : GWDJX           KIGBIAXK       
BSKR            : HPJHFRLTTWUFIC  YMRMDACTOLL     NCAHW           QVLFFL          KOBQA           YVUGOP          EHBMYMNXL      
RVABWARMUJBMBUB : MMQYJU          ICEENYSJKV      GWDJX           WGNKFJCNGF      FNDEPIMWC       MUDNFWX         KOFBPENPWU      HIKUQU         
MRSSW           : HTSQPNQ         HBCFEAVQCMAG    YMGOBCKPEN      KOPLHWFET       SKSJKYKNRPKTL   UAMF           
GNIPODCIWWEAX   : XIJVMWLNIAKKI   QRQXRQNLGO      YNVXFEGDDCCS    SKOTE          
AQQWCTJDQMR     : BEWEVLIWBHQM    VECL            XQJS            PLVMQX          BFCCN          
FKVEPETXTIE     : BEWEVLIWBHQM    EKXFIMFFEAO     TOPNQKW         UYQTLEKNKLM     WQWWKJWSBH     
QDVUDTYFKRCPL   : NCAHW           XKJSQQNTST      YYYMAYXKWOGT    DVYWNXCRAYPDHO 
UCBMH           : VBXFA           RFGYUOOU        BVDS           
YEOPIIPFQT      : NGXEKPX         EVMYKGS         WQWWKJWSBH      BGMFDLQ        
JXCG            : JIRP            AMGUABAQFIH     NEBATWARIWPTTG 
VFJJWLYK        : LBNEXXD         XFNBFW          HFHM            KOAC            QKYCQNSQJ      
VMFJUPKBEALMSS  : LIKMK           ITNGSFQ        
MWOMY           : HPJHFRLTTWUFIC  GOJULTHOIISFYE  HWRVNF          RNAFPMWWKOW     CSFUCYVKKF      EDXYIYY        
QXDAHCNI        : NOOTENEMYKS     CDAH            OUIWGLJTKRAH    WQVUCRRMQJQDRI 
RECWPYMBASDOFX  : AIXGQSQ         MSUOA           RFDCGHFKPHSDYQ  ECRLFJUMWW     
KLHBAIYQ        : SNHOJI          OCLQEG          TWUYRHDUDPRKKY  USBXJKHLMQRK    DXJG           
ESPGJAVDFY      : YQER           
WAPX            : JVOLUBE         EBDHYYS         TYWFOIHAMGKHCV 
JERQC           : GDHRDA          HUIKBPJLQI      PMQJ            AWAVPQPNNKCFUG 
CPIF            : XAIHGPIYQAWCIB  VXHVICVFVFCJHHE FSMRTSUAD       FYLLA          
TEJAKFSRQSPT    : LAIVVFMWYOD     QNYBEXMTXRVJ    JIIUQA          XVVYXKM         YAVXALET       
QWXRNXUYEMPH    : MWAHGAVUQ       KPXSCCWDDN      YTTHRELYQAGF    PAAXBDLOKWYCSLF LMJCLQ         
TYYARSGEURJNLCJ : IPEMGLU         PUYDJHLH        LRRYDDQA        WXEYCPYXEDUXCR  OSOON           EERJXWLLATERY  
XJSVJKJIHKM     : MGNFA           LRPGCAXQSYGCDA  SLCVDOQWA       NQWUASXH       
AVJUVKWPD       : YKPIPBRCX       LDBGYJEGF       IVYIWTKSQAISVNM IIAKRYKKMGVWFIM ILGX           
TYWFOIHAMGKHCV  : YPAWVDVPFAF     ONAEKFFWO       WAPX            BWAHRIEATOQYJSG
NEBATWARIWPTTG  : WRTHUBTRLMWRC   RTPDYFYOC       JXCG            FQGCA          
AAAYGRKPRY      : FSHLLBE         YGQFBX          FXWSWEKE        QMTEDSHMW      
CGABAPH         : XALPGCGMNCCYW   ESBLHD          MBPHBTAG        EUKH            HTMTNCYQFQUQ    QXAVLUWOTVCUWYB
PBCS            : FOQRTIT         KYASRBVHHSUGWPD IYHPCYPCV      
KRLGORIQU       : JHWUQIEGJPVPLU 
PBACQSBPWH      : PAAXBDLOKWYCSLF BGKDNOJFJOH     ECBRCLSLUPBGA  
XJKGOCJQ        : XDOX            IMFHMPYRXT     
HCPTKENS        : KUEHRQG         VPXPIHFNOVX     GOLN            IPOEALTY       
ICMLEPFY        : HGFKXFJP        PRIPWGCXEXQJFW  WGSQILXFQ      
WWDOWMB         : KAIJ            SMYKRAHKGSWTJK  LTPTYOBUTGEC    VRSGXDYJW       WRPFWDWGPRI    
CGRSDYWSUIY     : JAGRDRC         WTVNADYOCATWMTD
BTTFJGKYNJTKI   : GPQRXPUFG       LGPPQGBLUCW     GNQSOFCUO       PSYXMJLRCIQW    XXSYSBEEA      
BGKDNOJFJOH     : YPWYBSEMJDYXTN  UGSDYJMRVOXNIR  WQVUCRRMQJQDRI  PBACQSBPWH      GSPVUWILMQ      UQDNVUDLBHRMD  
ICRHNUEI        : EWFIPFVXMQNWHBK VPKXVPMEMPGO    TSQI            MRYNFT         
PQNOEYKQIIRQS   : CGYWBVOLROY     DXJG            QBQCOSCAQCCA   
GJIMSXVCIX      : PCQCAC          IVYIWTKSQAISVNM JLWYHTFOKRP     XPKMQPFLS       KGLNXGAAWSLRI   ETTDSWFHHTP     JMAC           
RORVWULPIC      : OCKAETGDBPV     JNORVGKQGRCOGUO DJOKQ           XYPJCKXCQ       RMYTQVNASI      UDECGJBYKOUKG  
JNORVGKQGRCOGUO : NPNOPEJND       VVYHCNFQTJU     RORVWULPIC      GTILDS         
AWAVPQPNNKCFUG  : UOVXTSFEDRAO    CCHCVBBEQ       JERQC           BYUGHGBLJGOHJB  WKNEIPTWYC     
FVRYTBMKHEOXKK  : AIXGQSQ         ONFMYIPCA       SYDSDRMPNKU     IQAKG           EGFA           
OMMQKEIB        : TCGUXGYTLRHLMBU FJLSAVQYB       QYVCRRWO        CTOO           
XNWEJFJQCCRVD   : ETLRQWAGI      
JMIXMUKCJWP     : NKIIQESV        JRSQSG          PDRVQAAJN       VCIQPPRIBB      VAQGHPFAOLM    
IVLLQJYPP       : FSHLLBE         SYDSDRMPNKU     CGYWBVOLROY     KNDUSKDMWFK    
VABXCVVHAFVLE   : PAQKD           TRJUJWGULLT     RPUMYGYBNKWLKG  XLACBAFXYMS     GCYTEBE        
GQLSQDVBYJM     : WEFCB           PSIEAYDEY       NIFJCRIPVAQJF   JNGHSXV        
SNIJYELCENXBWY  : MBYPWQIPVYDU    JKBJUIKOOPBNJCT BSNEAAAOT       NEPI           
SKMBSEMNU       : TKDPVBWJ        QCPHIKRDFQVBEB  UDKYMXRPQGS     CGOLTROQRVI     QENK           
JVRSKKOXSA      : IGLXTR          EAXPSMY         HUCXDYTABHVDHSG BVLAC          
XLACBAFXYMS     : PARQOC          TDDJ            VABXCVVHAFVLE   LNUNSJDNADXTE  
BVFFLSCDF       : QGJTXDSOSIHGHX  GOVCRVUTBUPGDJ 
UAMF            : ENJWGIGLOG      ELYXTJUSYSHNIE  MRSSW           AGLBXMN        
LBQKBCMDDNJDOX  : KACRXFHYHOUWIKT TSQI           
BYUGHGBLJGOHJB  : JWJGIV          TOPNQKW         AWAVPQPNNKCFUG  MHJTD           SQLEDWFJVJHYJJ 
AOPRAQVO        : UYQTLEKNKLM     VAQGHPFAOLM     UIFJVYDLRWHCAKM
CCIFRIGSJBBSJEF : BVQDC           YNVXFEGDDCCS    GUCF            CKEVRKXNCCLYWK  IUAIJWQYDJMO   
NVEWWTWOLQ      : YFBPAPV         BNRNFLSHPHGYNY  PMQJ            CLVBAUDC        QGJLWRRV        HUNHBRKIJUPNT  
FNDEPIMWC       : RDVUSWB         NGBHTG          DWWXILLHNIN     RVABWARMUJBMBUB JCBJHXOMX      
DUGGXAPCHNP     : ISIJQSOXLWN     KSXHRHG         TDDJ            KFUTIFD        
ROCLOQAF        : WITACNXS        BMIMPCXUW       RNAFPMWWKOW    
FSNJIVXGXULUD   : XIFOCGL         MCTXGJFLHGLTAD  OOGDICWDCADAC   HSRPXUMFJKT    
UDKYMXRPQGS     : IPEMGLU         SKMBSEMNU       FOLHOHOJSJRDNS  ITNGSFQ         PKRIMXSYOKRAU  
ULEBTJVHSFFS    : YOTPCSQCTKFWUYN FHIPEF          MBPHBTAG        BAJIVPSVXAWV   
FNYARRWWDVKBN   : YPBWWLQVAAI     PVCYCAUNHPGVQDK MHXOUUUPRUK     TMUQX           PGGYN          
TWUYRHDUDPRKKY  : YJYJKHUYBAEFFU  CYKULR          XGBORS          KLHBAIYQ        PTBRVCBGTYWI   
EMWRNYLGVLLTVO  : ANIWWDGX        HKSQPWIMMLFALY  DPSIKRDYMMOY    GCYTEBE        
AJHVKBFPWIFQUQP : YCLOXXUOOROD    DEVYDLQXDUAVUH  MRQYNWPLAPBN    TEXX           
UELORKDAIOL     : PRIPWGCXEXQJFW  GOPEUYL         SAHL           
MDMMMTKYVPOUAU  : OTOTDQF         BKXEIPKMLVK     EWJE            TGUFNUFIJHU    
UNDHIJU         : UJRWRYAE        RMYTQVNASI     
BFCCN           : XHNBQMT         XQJS            EVFJU           THXVS           AQQWCTJDQMR    
PSFSFSHAFGXVXUV : KUEHRQG         FKVVYOT         GCYTEBE         RAIOOWDGPNWUQM 
GTILDS          : RFDDCQVLYOEQUO  CFMTNQXDMTFY    EQSOAUEVSSHAON  JNORVGKQGRCOGUO PESSWOFYUIYK   
YRXEWC          : SWKIFCTDFAJ     OMRBOTVMC       ITNGSFQ         BEXUDU         
PSNVNSQXUVGUT   : DDQGRQOMSAEEGC  KPXSCCWDDN      AIXSQJMTKYJY    VBIYRGBWIW     
PSYXMJLRCIQW    : TXNPHN          VYJSV           BTTFJGKYNJTKI   XOUHNGQLJFDVQ  
XVLSLEIJUDASY   : RFDDCQVLYOEQUO  SLTTGAXDCLQ     TNDAPEJ        
YVUGOP          : CHVWPPDGKJOR    KOBQA           BSKR            AFGQ           
MCRYUTHNSQLODE  : AXDJOULH        QIDFTRSQJTCRC   VPKXVPMEMPGO    RQBLTEDEHF      XXVBLVAIVXSK    UULDXT         
JMME            : KCTTOKMDLA      WQVWKBIX        HVWMGWATU       SEFNESMRFQEFOUA
PYROYPL         : LRTRU           UPRBRDHF       
ECMRGESDBCR     : AQXVPKYLGNVUSJ  QKYCQNSQJ       UDRJRKLXK      
VDLYKOI         : VMKFYTCXXCDDJAI RMXLOFYUXVQII   RAID            SANWLJBKAXQR    BRIAAX         
BPRQOLHPCTW     : DPVOIA          WDHVOI          DCTJ            WGIJQDSAHHJS    YGHKNGFE       
XKCEQWIR        : UUFULJVVU       OEOHYSHELGERNED
COVFC           : MSUOA           YTMEBXVHDL      PMQJ           
RQHTTWLLOAUGEQ  : SGQVOHQ         XALPGCGMNCCYW   VCKGOY          SKSJKYKNRPKTL   CQFMUJ         
MOQRVHOECOG     : SFXKQGUCIJRKJM  EBJL            IPRKAGVADC      NJSKIDUDTBPUIYJ EQSOAUEVSSHAON  RVIEEKYVH       GVYSQQEBJD      RCMVGRHOABJQRLD
MNULINTCJSPUJPS : TAWCMN          BUIWDIIRO       DHSHMMHTOQV     MCFVBDGWIYW     TETMBFQRAE      SQAKQXXLYGLPS   ERDCGVBEL      
TJUJBNBWUPBY    : CKEVRKXNCCLYWK  AORAN           QNYBEXMTXRVJ    VKDK           
JRVYOIHECL      : FOQRTIT         QPUITOHBVMXW    KYMMMBBPQ       ODULUKQTNN     
UCLFREXOQUARIB  : OJATLTA         VHFFVYDUMLT     ONFMYIPCA       SWFWEABIDQC    
FSRFABY         : SOOSK           GHOYFAW         MLHS            WGLVOERGK      
CQFMUJ          : APHNJ           LDBGYJEGF       SWVNMI          RQHTTWLLOAUGEQ  LWDNIWTOEBTJPK 
LGAXNU          : SJXVGXVTR       SWKIFCTDFAJ     SYXXMPKKBYA    
LLUILMQ         : JRSQSG          AMGUABAQFIH     IHLWPR         
DYHUEIXFHBXOPT  : QMJGMAEGOQYQDUB ODULUKQTNN     
NHGQFWNKIYHTMU  : NGXEKPX         JLSFGQPEDONVNBD THXVS           XXSYSBEEA      
BAJIVPSVXAWV    : JLWYHTFOKRP     ULEBTJVHSFFS    AGBCHHLHEQU    
ORODAXTHUJTFK   : QNYBEXMTXRVJ    RCHK            SKUPBNAEBC     
YYYMAYXKWOGT    : QMLOERTXWVOU    ONFMYIPCA       MQQITTOKQ       QDVUDTYFKRCPL   LYGIYO          JMFHRFEFTB     
GSKX            : XLNNVWY         CGLGLU          OCKAETGDBPV     HGJYCW          JLWYHTFOKRP    
FOLHOHOJSJRDNS  : EAXPSMY         ONFMYIPCA       KFKQIMLTGN      PGJRD           UDKYMXRPQGS     OQPWGENWCDJGOJB
MFELEOJU        : DTLWLK          WITACNXS        LGFIFCYJWUXOXEY QSJH           
FJEXVEGDUTKKBC  : KKQIXTKKQLYGBBD WRTHUBTRLMWRC   DQTGGF         
TLPYBJBNOH      : GDWPV           JPQSO           PVBMVJHXJQBAMUX FFBDSMSV        QGJTXDSOSIHGHX  DWVNYBTGDNIK    ECRLFJUMWW      JDNGJQEMJLLSF  
UWMPTRBAQAGY    : QCPHIKRDFQVBEB  BIPIVKYUINPJBUE
CTOO            : PKAVSEQKPOJKK   DKNWFEVH        YXKRQ           ILGX            OMMQKEIB        WPEL            LMJCLQ         
QMTEDSHMW       : HOPTKGQO        XWNATUFDHMSO    SBVWUDUT        AAAYGRKPRY     
DEVYDLQXDUAVUH  : NCJYJLFRYNQSPEH MGLT            LMPUXIDAWOC     XKCHJNGMMMJH    SWFWEABIDQC     AJHVKBFPWIFQUQP RLHUTADRKENU   
XLPOAOHMI       : BXOKMIMVUFKTXNH ACSXRGPOVTPVG   ASLSLRTTRRRDUQG KWTRHU          DBTLKXAGBG     
RCUEYPIDOJ      : VYJSV           XPILHPGNWSA     XTUFTISCMSXRVDQ LRUGDXDQFWJQDOP
CAHFU           : VMKFYTCXXCDDJAI YCLOXXUOOROD    MUDNFWX         VJFCMOVQXIX    
ERQAQCRH        : NEFMHTCLJGWVLD  TCDHROLQTAJ     EKXFIMFFEAO     OSSBYSDAJGK    
GPTRFLTB        : VETUC           PAAXBDLOKWYCSLF TOPNQKW        
USBXJKHLMQRK    : RDCB            HKSQPWIMMLFALY  JYJWCXFU        KLHBAIYQ        CTAQQFTCJPDSYP 
XCTAUYT         : JMAC            NRMSMDXA       
FCSYTXNNBEIUHJ  : OJATLTA         IHJTUQIG        HGJYCW          OOSSTESDTUFJ   
TSQI            : PXYUMTKVIQYDP   TDDJ            ICRHNUEI        LBQKBCMDDNJDOX 
KSNIVJKQIEVQG   : ASHL            LRPGCAXQSYGCDA  WESWAUNBLDN     XKCHJNGMMMJH    XVVYXKM        
PBPDOSJANS      : AFYHXLYMV       YPAWVDVPFAF     TIBUBMGBHRPWF   ILNTWBJFTPVOK   UDECGJBYKOUKG  
UMENV           : NIFJCRIPVAQJF   TIVPE           AGLBXMN        
XQGIMQUG        : HPJHFRLTTWUFIC  PEOIB           DBTLKXAGBG     
YCRF            : YOQLVGTJ        CUWMJPTD       
KGLNXGAAWSLRI   : PVCYCAUNHPGVQDK MBPHBTAG        TABUBOGKHYBNCPL GJIMSXVCIX     
FGHFWNPMGKSI    : QMJGMAEGOQYQDUB AGSWDLOHE       KUEHRQG         OEOHYSHELGERNED FWBA           
WAQSKA          : YMWDE           JVRILFGJKE     
BANDAKXLE       : LIKMK           GDWPV           TOUEQHVPTICA    ECTUQWYKJQEWM  
DJOKQ           : SXJGLRHXERSQAJW KCNNP           RPMMVIGPRGEHXG  MAPGE           RORVWULPIC      LGAQNHLEJ      
BIYHS           : QMDKWIACNNJJP   KDVTOFNCYQJXJY 
PESSWOFYUIYK    : HFHM            GTILDS          DYFXKUJF        BXVE           
BUKMYSQKID      : PQVL            FJFQS           OXXTC           RIIE           
WGLVOERGK       : ESBLHD          JCXDIAWHL       VGQIRDCS        RONBTX          FSRFABY         ITNGSFQ        
YKYHJWPJ        : JGWAMXWWHTSA    IKLKNA          PNACJLPJC       ERDCGVBEL      
CKFOA           : HBHYRKWUTO      HNNYYA          FSTTV           MXBDFXEQGNLDTJ 
HSRPXUMFJKT     : YPWYBSEMJDYXTN  ACSQJNEFOKCVSR  UONXJNGTW       FSNJIVXGXULUD  
ECBRCLSLUPBGA   : EDUCSHRJ        JRSQSG          JGWH            VAQGHPFAOLM     PBACQSBPWH     
TFRTLCOFRM      : ACSQJNEFOKCVSR  FJXENXTWUTXVMD  HCBAAMLDE      
HTMTNCYQFQUQ    : CRJWXA          DETRBI          CGABAPH        
GOCHUC          : PARQOC          DIXSHTGB        EWFIPFVXMQNWHBK
OHHKUJBDE       : LAIVVFMWYOD     SLTTGAXDCLQ     JFRYGFBMIETLCIN HUEMRGFMRH      VBXSTJLCXLU    
GNIUHYYIRFYOV   : DNWL            VOMTET          HCBAAMLDE       APKTEOXAANNAPV 
WKNEIPTWYC      : KJKUDOSGS       RYLGOSDWYGJKVOG AWAVPQPNNKCFUG 
VNLYRC          : SEFNESMRFQEFOUA UDHHMODDQWS    
HLCPMCXGH       : FUBRJR          IXFTPLKAV       SKSJKYKNRPKTL   YXKFKTUFV       BWIBOUWNLLG     NPWMY          
UFNRQBXB        : MBYPWQIPVYDU    SFTTV          
UARYK           : CRJWXA          OSOON           DWMROSGAYVJYTI  QHFOBDW        
MWPHYUO         : SXJGLRHXERSQAJW WWXVFS          BVTCC          
AGBCHHLHEQU     : BAJIVPSVXAWV    NIEORMAPDWGTP  
JXWKSRLKQVAFUR  : MNEFWBSX        UYRFJ           UAKFASDVL       SWIEQULAUXYKRO  DADK            OJMUUPSKEKQSRVA
WPEL            : MPWJ            YGQFBX          WRTHUBTRLMWRC   HSAXJCCDPQKM    CTOO            KBPYFSHB        FLIFQSQQCMRMQI 
KNRRWFBCVX      : LIKMK           RGOKFNHAWY      WGNKFJCNGF      POSHSSDUKCRK   
GVYSQQEBJD      : HKTNVIFNJPLMUN  SFTTV           MOQRVHOECOG     UEWBRACCBIHQ   
PAXEWNI         : JLJPBLN         NTXM           
DVYWNXCRAYPDHO  : VFONSUQWOHJBJ   ILGX            QDVUDTYFKRCPL   VBXSTJLCXLU    
AFVHJFKPWMNCK   : YQER            EKXFIMFFEAO     MJXXSWPBJBJGTI 
MVHIWFYUHSX     : AIXGQSQ         YPAWVDVPFAF     AMGUABAQFIH     PGJRD           CTAQQFTCJPDSYP 
KBPYFSHB        : KAIJ            WPEL           
SHMKEYAILEXHMGG : XIJVMWLNIAKKI   MJXXSWPBJBJGTI  DXCM           
HCBAAMLDE       : ASPUH           YWTKEO          MUNDDXNMPNIENMY TFRTLCOFRM      GNIUHYYIRFYOV  
IWVKY           : EEAYSYIRCV      GUCF            TJDWBX          BGMFDLQ        
TNDAPEJ         : YCLOXXUOOROD    RCHK            XVLSLEIJUDASY   ENBYDVNGUFBYDW 
IHLWPR          : YMGOBCKPEN      PDGKPXVQ        WDUWUUMJ        LLUILMQ         RKHJMBHGPMNPW  
ATUAVJNYNDI     : GOGMY           PGJRD           FYLLA           QENK           
BUOUODXOSEXTNH  : AIXSQJMTKYJY    RFGYUOOU       
MAAGAVBCSKSTA   : BSHQWWEQ        CDAH           
ENBYDVNGUFBYDW  : FENGVK          HAUPWFQPTBHSXVA TNDAPEJ         JCBJHXOMX       LSVFMKSFMB     
NFENFKNDLR      : OSOON           CIQWBUQMC       BRIAAX          EVHYK           RMLOTUIUSIHCRBH
XKSXIYOKYRGO    : HBHYRKWUTO      KACRXFHYHOUWIKT CQLX            NTNEH          
DTDF            : JWJGIV          MAPGE           KRGUOATMCL      KOFBPENPWU     
AVPFCDM         : BRLLJLCWR       KLFTB           KTAIMKTXIHQXHJN TJWTTGQMJX     
SQAKQXXLYGLPS   : QHUKRGYIFYTGDK  RFDCGHFKPHSDYQ  MJXXSWPBJBJGTI  KWTRHU          MNULINTCJSPUJPS HKIUOFLOI      
JCBJHXOMX       : GJLMMBAYUCKB    FNDEPIMWC       ENBYDVNGUFBYDW 
LNUNSJDNADXTE   : HPJHFRLTTWUFIC  HRORADMNQPAGYAT XLACBAFXYMS     UEWBRACCBIHQ    FXDPMILHTQUSVH 
FFFQUXD         : NJUNSHISQPEK    VOMTET          CYREFRBK       
AHPIFEW         : FKVVYOT         OEOHYSHELGERNED BYLH           
SKUPBNAEBC      : NEFMHTCLJGWVLD  QBEEPXNIHSMJPN  RKPTMUFIIPPGUT  ORODAXTHUJTFK   XYPJCKXCQ       LPYYKXSHDJWU   
BVLAC           : LRRYDDQA        KLLKRYUX        XFVWA           KJQWT           JVRSKKOXSA      PCELYMGUWNW    
HUNHBRKIJUPNT   : CLQCBRBBERW     UAOGMNAI        EERJXWLLATERY   NVEWWTWOLQ      BUCRFDLPNVKDLE  APKTEOXAANNAPV 
JFRYGFBMIETLCIN : VLDCMUBLONCUG   PDXJTOHFIGPWHG  SAMC            XGBORS          OHHKUJBDE      
BUCRFDLPNVKDLE  : JAGRDRC         AXDJOULH        MMQYJU          HUNHBRKIJUPNT  
UJRWRYAE        : HFJCQVXRO       TABUBOGKHYBNCPL UNDHIJU        
EBUHLLNMIP      : CINJSYUDTIAS   
NSSDGON         : BVQDC           DSWOICFYUYUYRXS
CULAGFWYEWFN    : IUAWQHUNAFRH   
ILNTWBJFTPVOK   : UTADLYTMEVRWU   SEXFFIACVN      AIXSQJMTKYJY    PBPDOSJANS     
XYPJCKXCQ       : ITMEWQHL        RORVWULPIC      SKUPBNAEBC      QKILWNYFY      
BRIAAX          : TOPNQKW         VDLYKOI         NFENFKNDLR      LPYYKXSHDJWU    XOUHNGQLJFDVQ  
ILTFIXQQTI      : LAIVVFMWYOD     DJLHG           ECTUQWYKJQEWM   YBEWRJVUY      
ITNGSFQ         : NBIFNX          SUMOKBYMWXHJ    JPQSO           VMFJUPKBEALMSS  UDKYMXRPQGS     YRXEWC          WGLVOERGK       YHFBJYWPMVWDWND
RQBLTEDEHF      : DNWL            LFIAG           IPIVOSFCKUDANN  QYVCRRWO        MCRYUTHNSQLODE 
NQQKVAIOSCW     : OTOTDQF         QMMUUVAHL       UOJKVUUFL       PCXCHJWWGT     
KQWTMF          : GUCF            HKIUOFLOI      
LWDNIWTOEBTJPK  : EBYOJHSPUWWOCST JKCB            CQFMUJ          DFUAJKNXJVLNXN  YGHKNGFE        LGXCBQAIAOA    
AICK            : FXGOPD          PGJRD           FFRI           
UOUEBLCUXHHKG   : RPMMVIGPRGEHXG  OACBJIRXOMSEI  
APKTEOXAANNAPV  : GNIUHYYIRFYOV   HUNHBRKIJUPNT  
CTAQQFTCJPDSYP  : OSOON           CBXAOBVCM       USBXJKHLMQRK    MVHIWFYUHSX     IJUYLHIDBL      TPBD           
MRQYNWPLAPBN    : XIJVMWLNIAKKI   ESBLHD          AJHVKBFPWIFQUQP
SJWUFXNVFIB     : HBLIXBY         SVQUVRHWKY      JBWLJCCETXENSLT RVIEEKYVH      
AGLBXMN         : XETQCECP        UAMF            UMENV           EAUWQNELJJHT   
GOFFERFVUUOQH   : IPGJMJXTKFNC    MYBQGTODVB     
LMJCLQ          : JKBJUIKOOPBNJCT DPOHDXCPGH      SMEIG           TABUBOGKHYBNCPL QWXRNXUYEMPH    CTOO           
OJMUUPSKEKQSRVA : JXWKSRLKQVAFUR 
EVHYK           : CUWMJPTD        HUIKBPJLQI      ATOYBOHTCEVJMJD NFENFKNDLR      HRMCWN         
GYLVKPHCCV      : DNWL            AKRWNWIBC      
QSJH            : SGQVOHQ         GDNRIPCHFI      MFELEOJU        VDLVFQYQ       
TNAK            : XPAQXCPULQOTYTG ACSQJNEFOKCVSR 
RIIE            : YWTKEO          VPKXVPMEMPGO    BUKMYSQKID     
HLQRLW          : UTYFMHGEBKWPFYP CNAFIFCGKP      ATXFDPGHL      
WUENEGRCTJUDS   : TCGUXGYTLRHLMBU MYBQGTODVB      KLWHSBJENMIEM  
WGIJQDSAHHJS    : JAGRDRC         PKAVSEQKPOJKK   BPRQOLHPCTW    
BEXUDU          : XFTEOQA         OJXBFEVMNCFEEUH AUXB            OKMETAIPOS      YRXEWC         
SAHL            : IQAKG           UELORKDAIOL     PCXCHJWWGT      TPBD           
BWAHRIEATOQYJSG : QNSIDGNVED      AQXVPKYLGNVUSJ  EWJE            TYWFOIHAMGKHCV 
CYREFRBK        : XPILHPGNWSA     FFFQUXD         KGQHGHFOQEUJ    KNDUSKDMWFK     HNQYSGJAPXWRRUM
CGOLTROQRVI     : FCDFWYTPGTT     IXFTPLKAV       SKMBSEMNU       HUEMRGFMRH     
BIXRBWBUD       : HVWMGWATU       WYUKNVUE        ECRLFJUMWW     
WENDLFG         : TMLMRF          CBXAOBVCM       QXXTKMLGNQ     
UIFJVYDLRWHCAKM : AUIJ            WRTHUBTRLMWRC   DKCAGRYJHNRGLJ  AOPRAQVO       
CNAFIFCGKP      : NSQUMEHNDJNE    YGQFBX          KIYT            IYRRBQOU        HLQRLW         
XXSYSBEEA       : PSAPIS          BTTFJGKYNJTKI   NHGQFWNKIYHTMU  KOFBPENPWU     
KLWHSBJENMIEM   : VMKFYTCXXCDDJAI QIDFTRSQJTCRC   MIEJRTI         WUENEGRCTJUDS   QENK           
MRSUEIJFGCE     : VYXMQH          IKLKNA         
FLIFQSQQCMRMQI  : WPEL            JHWUQIEGJPVPLU 
BMLRBFKYKT      : YALYDNSOPCMWUIP VVOEIHVD        TDRWPHBMVG      TGTY            SXLJWLDYKHIG    EMLYRNNFBAKM    LRUGDXDQFWJQDOP
RCMVGRHOABJQRLD : JWJGIV          MFJAE           AXVTQCRTEESAVQT DMIYMTTKSBSFCVC MOQRVHOECOG     VBIYRGBWIW     
XVVYXKM         : SLTTGAXDCLQ     HUBYEWT         TEJAKFSRQSPT    KSNIVJKQIEVQG   MIVC           
MUDNFWX         : MXCILJAWDH      GAJMGLUKFTS     OVNHY           QFSNQFFGH       WQTRBMVJR       RVABWARMUJBMBUB CAHFU           KAROUUWAVA     
BMUHEDXEG       : DLKXLCKNGNPV    MGLT            TYETHARXMLLJC   XTWIUCXGDP      YAVXALET       
XXVBLVAIVXSK    : XTOFGWHBP       MCRYUTHNSQLODE  FYLLA          
HFSWM           : BKXEIPKMLVK     IOWLNYCBJWGT    ETTDSWFHHTP    
WLVJHFOMEUSNU   : ISIJQSOXLWN     FHIPEF          DFWPYTYJCUDFWM  ASEEESEVF       JNGHSXV        
LYGIYO          : APFEAGETYGRGNL  BJYQKSSTVPYBMMI CIOLUMY         TBITPEIINWIGM   UYQTLEKNKLM     YYYMAYXKWOGT    XRUT            JROKF          
LYGIYO          : QKILWNYFY      
YKSQTYMRN       : JRGOQU          XHNBQMT         WDUWUUMJ        VPXPIHFNOVX    
OACBJIRXOMSEI   : SATGEXIEDNQ     GWDJX           OJATLTA         LGFIFCYJWUXOXEY UOUEBLCUXHHKG  
QJTBIJJ         : LEHFODSEAVTD    PYCPVVUKXBEQBM  XRUT            DWVNYBTGDNIK   
VCXPBM          : SOOSK           CSCCDTGDA       LOSBBLS         KLFTB          
PTBRVCBGTYWI    : OCLQEG          GUCF            MCFVBDGWIYW     JLSFGQPEDONVNBD KRGUOATMCL      TWUYRHDUDPRKKY 
CSFUCYVKKF      : XFTEOQA         ETLRQWAGI       EWJE            XIFOCGL         QKOYWMCLWXP     MWOMY          
IJUYLHIDBL      : NOOTENEMYKS     PSAPIS          OOGDICWDCADAC   PGJRD           CTAQQFTCJPDSYP 
ANXG            : MSASL           MMBACP          SEFNESMRFQEFOUA
WGSQILXFQ       : EDUCSHRJ        UYDOGSEAPUEM    ICMLEPFY       
DBKKXSTSTHC     : DTLWLK          XHNBQMT         DXCM           
KGQHGHFOQEUJ    : NRAHVKHMDJTV    UTYFMHGEBKWPFYP CYREFRBK       
FXUKOUNR        : AXDJOULH        JKBJUIKOOPBNJCT JGWAMXWWHTSA    PDRVQAAJN       HJGHR          
XPCUKWCN        : OFJRWG          TIVPE           AHRCFVDQBK     
NTUWACFQ        : EKXFIMFFEAO     QMMUUVAHL       QVLFFL          XTGOKVOQAE     
JMFHRFEFTB      : PXYUMTKVIQYDP   CYKULR          XQJS            IWPMVXNMQGQKDJP YYYMAYXKWOGT    REISUHKLDUTTSS 
MIVC            : XIFOCGL         PDPVQHJBKI      XVVYXKM        
QPKSDOIWLIYQNP  : KCNNP           RFGYUOOU       
WETGYANET       : NTXM           
YIXWNL          : DQESGTJ         YJYJKHUYBAEFFU  MXCILJAWDH      DLKXLCKNGNPV    SYXXMPKKBYA     GOGMY           MCTXGJFLHGLTAD 
DXJG            : EWJE            YCDDGCGLRVYXD   KLHBAIYQ        PQNOEYKQIIRQS  
TFACEQPTD       : DXQNOW          FENGVK          EMGQY          
YAVXALET        : DRDWQKBTIDILYLY NEPI            EGBIKXANIVCCMI  TEJAKFSRQSPT    BMUHEDXEG       CGMQNHODHGWONNR
FFBDSMSV        : MGNFA           JHMIBD          HLGDEQPRE       XGCUHAJXASNHPL  TLPYBJBNOH     
CEBWJBBNURJXJKX : YCDDGCGLRVYXD   RFDCGHFKPHSDYQ  EUNDHWLLHMJTUE  DVMIYPYVDEPXEK 
KAROUUWAVA      : THBHS           FTHJKJTLWPPXS   XKJSQQNTST      MUDNFWX        
KUQWXUXWGYXTTR  : HDST            DBRJRWBBFN     
UBQU            : NJMOS           PMQJ            OIBVKIQQAETK    PSAPIS          EMLYRNNFBAKM   
BVDS            : OMRBOTVMC       AMGUABAQFIH     UCBMH           USEUYJVVU      
XRUT            : EKXFIMFFEAO     UYRFJ           UKVTXWKHMPEK    LYGIYO          QJTBIJJ        
PEOIB           : VVYHCNFQTJU     TXNPHN          JSTDUYYS        XQGIMQUG       
FYLLA           : CIQWBUQMC       CPIF            ATUAVJNYNDI     XXVBLVAIVXSK    JNGHSXV        
HUEMRGFMRH      : OHHKUJBDE       CGOLTROQRVI    
UCFSTAO         : HGJYCW          IKLKNA          GNQSOFCUO      
RUCAXRHYDUYPC   : WKIEWILTEPLPYJ  KHQNBMGSSGXSPJ  SWVNMI          IYRRBQOU        VLRP           
WRPFWDWGPRI     : MXCILJAWDH      MYSCKATD        WWDOWMB        
MEXDTQXWSVQBUVX : RNKBYCYXS       MNEFWBSX        WQVWKBIX        TGTY           
ODULUKQTNN      : SFXKQGUCIJRKJM  MSASL           IUAWQHUNAFRH    DKCAGRYJHNRGLJ  RYLGOSDWYGJKVOG JRVYOIHECL      DYHUEIXFHBXOPT 
GHLCVSAYMSYJMWC : VVYHCNFQTJU     NTNEH          
RYPPN           : EOSWHSGGUA      PDPVQHJBKI     
KYNVRKLHLTQY    : MWFTCLPLFV      RHAX           
MRYNFT          : NGXEKPX         ICEENYSJKV      JFPHWA          FTHJKJTLWPPXS   ICRHNUEI       
QGJTXDSOSIHGHX  : EJPWRJIYSQNVL   TDEUSGFTUW      BVFFLSCDF       TLPYBJBNOH      NRMSMDXA       
BIPIVKYUINPJBUE : BVQDC           FHIPEF          KOBQA           UWMPTRBAQAGY   
LMYHLCCCWKL     : HBLIXBY         VIUGTMQIDX      YTMEBXVHDL      YXKFKTUFV      
RLHUTADRKENU    : QNSIDGNVED      UKVTXWKHMPEK    DEVYDLQXDUAVUH 
DFUAJKNXJVLNXN  : JOFUXFOOCFN     MIEJRTI         LWDNIWTOEBTJPK 
JCQDNBBKBGCNLR  : FSTTV          
HWPDW           : SQPHQ           SFTTV           SLTTGAXDCLQ     JMDYY          
PNACJLPJC       : UDHHMODDQWS     YKYHJWPJ        GCYTEBE        
UEWBRACCBIHQ    : QMDKWIACNNJJP   YEJK            GVYSQQEBJD      LNUNSJDNADXTE   PCELYMGUWNW    
YBEWRJVUY       : BFIYPDH         DWMROSGAYVJYTI  ILTFIXQQTI      PKRIMXSYOKRAU  
UBUJTFNYC       : PKAVSEQKPOJKK   YTTHRELYQAGF   
VDLVFQYQ        : WESWAUNBLDN     RQYQQ           BSNEAAAOT       QSJH           
RMYTQVNASI      : WXEYCPYXEDUXCR  LIKMK           THBHS           RORVWULPIC      UNDHIJU         UJNKSEV        
EGFA            : FGWWVYNVVFHUSNK YXKFKTUFV       HAYWTJII        FVRYTBMKHEOXKK  KOFBPENPWU     
YHFBJYWPMVWDWND : KYASRBVHHSUGWPD KOBQA           ITNGSFQ        
BDNT            : AQXVPKYLGNVUSJ 
DWVNYBTGDNIK    : SKOTE           TJDWBX          TLPYBJBNOH      QJTBIJJ        
JVRILFGJKE      : EOSWHSGGUA      AIXGQSQ         UQWVLYPMTETY    WAQSKA         
QXAVLUWOTVCUWYB : CGABAPH         NRMSMDXA       
MJMGSKAC        : PUYDJHLH        EUKH           
HKIUOFLOI       : ONAEKFFWO       ONFMYIPCA       XTWIUCXGDP      WWFAQAWGPOTLBM  SQAKQXXLYGLPS   KQWTMF         
AFGQ            : RDCB            PMQJ            YVUGOP          SQLEDWFJVJHYJJ 
ETTDSWFHHTP     : PXYUMTKVIQYDP   GJIMSXVCIX      HFSWM          
FQGCA           : YPWYBSEMJDYXTN  AFYHXLYMV       NEBATWARIWPTTG 
KWIRK           : MYBQGTODVB      WRKDGGIDH      
ATXFDPGHL       : VYJSV           HLQRLW         
LGAQNHLEJ       : YQER            BSHQWWEQ        DJOKQ          
WQWWKJWSBH      : SHFVRIUAYFEIBO  EERJXWLLATERY   FKVEPETXTIE     YEOPIIPFQT     
ECRLFJUMWW      : WRTHUBTRLMWRC   XTAD            RECWPYMBASDOFX  TLPYBJBNOH      BIXRBWBUD      
DWRQEFWQ        : PHGYNJEOSC      RGOKFNHAWY     
TJWTTGQMJX      : WTVNADYOCATWMTD XKJSQQNTST      EGBIKXANIVCCMI  AVPFCDM         USEUYJVVU      
PCXCHJWWGT      : FOQRTIT         PXSVEIAMB       JBWLJCCETXENSLT KXOOIIEJLEAHY   QCPHIKRDFQVBEB  NQQKVAIOSCW     SAHL            PNGEG          
JTOCXVAQVVASPTY : LLFNV          
JLJPBLN         : BVUSEFFQDYDJ    PAXEWNI        
TYCSF           : JGWH            YYMXBAMYAJPOB  
POSHSSDUKCRK    : XAIHGPIYQAWCIB  OOGDICWDCADAC   KNRRWFBCVX     
JHWUQIEGJPVPLU  : YHFLJJUXDTO     GJLMMBAYUCKB    KRLGORIQU       FLIFQSQQCMRMQI 
EAUWQNELJJHT    : MFGRWQBCCDSXDNN PDGKPXVQ        KXOOIIEJLEAHY   AGLBXMN         YDFYWJUSH      
YGHKNGFE        : MSASL           XGCUHAJXASNHPL  BPRQOLHPCTW     LWDNIWTOEBTJPK 
JMAC            : XROUJMKSWRI     QNYBEXMTXRVJ    GJIMSXVCIX      XCTAUYT        
RPFMUHHTXX      : JYJWCXFU        XROUJMKSWRI     VGQIRDCS        THXVS          
MHJTD           : BXOKMIMVUFKTXNH CIQWBUQMC       BYUGHGBLJGOHJB  PKRIMXSYOKRAU  
UJFFAL          : EPYIDSURRR      DLEAVSH         PNGEG          
GCYTEBE         : YJYJKHUYBAEFFU  ASHL            UOVXTSFEDRAO    DBRJRWBBFN      VABXCVVHAFVLE   EMWRNYLGVLLTVO  PSFSFSHAFGXVXUV PNACJLPJC      
GCYTEBE         : PCELYMGUWNW     DYFXKUJF       
RMLOTUIUSIHCRBH : CUWMJPTD        RDCB            OMMKYRASR       IWJSUUWQ        NFENFKNDLR     
XTUFTISCMSXRVDQ : RCUEYPIDOJ      NTXM           
PCELYMGUWNW     : BOIIILCOPA      EBDHYYS         BVLAC           UEWBRACCBIHQ    GCYTEBE        
QHFOBDW         : LEHFODSEAVTD    YGQFBX          EMLYRNNFBAKM    UARYK           FFXIATESNO     
LPYYKXSHDJWU    : KNERHAQLEFUKDX  VCKGOY          KJQWT           SKUPBNAEBC      BRIAAX          XDOX            AHRCFVDQBK     
CGMQNHODHGWONNR : HBCFEAVQCMAG    UMDTOUKIGCGMEE  BDQTMCT         LOKWAWEKWMANQ   YAVXALET        JROKF          
KOFBPENPWU      : RVABWARMUJBMBUB DTDF            XXSYSBEEA       EGFA            DMRKJN         
GSPVUWILMQ      : VPXPIHFNOVX     BHJOG           BGKDNOJFJOH     KAGWCVCYCW     
RAIOOWDGPNWUQM  : YWTKEO          NTNEH           PSFSFSHAFGXVXUV
FDXCXGUQE       : UKVTXWKHMPEK    IRCBAIHHQOSC   
PNGEG           : AQXVPKYLGNVUSJ  BVTCC           TMLMRF          PCXCHJWWGT      UJFFAL         
VGTLWSODIECG    : CUWMJPTD        YMGOBCKPEN      GDNRIPCHFI     
OHDTI           : EJPWRJIYSQNVL   KYMMMBBPQ       TPMWCKANJAQKRO 
UQDNVUDLBHRMD   : QMLOERTXWVOU    DNWL            CFMTNQXDMTFY    BGKDNOJFJOH    
GQWBHCLMERKU    : UFAOPKPEYRKLX   YUKMWGKCLTQEK  
NRMSMDXA        : ESBLHD          TGTY            XCTAUYT         QGJTXDSOSIHGHX  QXAVLUWOTVCUWYB UDECGJBYKOUKG  
TFMWMELRERJDUS  : YKPIPBRCX       SVQUVRHWKY      TGIUJXSMKOWUO  
HFJB            : YOQLVGTJ        SWKIFCTDFAJ     FJXENXTWUTXVMD 
HDFYPY          : MJXXSWPBJBJGTI  TGIUJXSMKOWUO  
VWPWSUKQJQCB    : JJYJCJ          AVTPGLTX        LTPTYOBUTGEC    MQQITTOKQ       PIOYHIFKFPJQLFC
WMBTGJB         : KWTRHU         
UDECGJBYKOUKG   : WQTRBMVJR       RORVWULPIC      PBPDOSJANS      NRMSMDXA       
FBGX            : KAIJ           
XDOX            : ASHL            TLDPFSOOA       XJKGOCJQ        LPYYKXSHDJWU   
DBTLKXAGBG      : CQLX            XLPOAOHMI       XQGIMQUG        NTXM           
JROKF           : XIJVMWLNIAKKI   LYGIYO          CGMQNHODHGWONNR
HRMCWN          : HJGHR           HAUPWFQPTBHSXVA XFVWA           SBVWUDUT        EVHYK          
VBIYRGBWIW      : DSXGKHUAV       TONLEUAF        PSNVNSQXUVGUT   RCMVGRHOABJQRLD
UULDXT          : LOSBBLS         MCRYUTHNSQLODE 
KNDUSKDMWFK     : VCKGOY          TABUBOGKHYBNCPL WRKDGGIDH       IVLLQJYPP       CYREFRBK       
PIOYHIFKFPJQLFC : EAXPSMY         DTLWLK          VWPWSUKQJQCB   
FXDPMILHTQUSVH  : APHNJ           OCKAETGDBPV     LNUNSJDNADXTE  
NPWMY           : UHTD            AMGUABAQFIH     HLCPMCXGH      
UJNKSEV         : YTWPPAVF        RMYTQVNASI     
JNGHSXV         : MPWJ            MGCNXLHMVKHFK   EYMAEQRCWFSYXG  PVBMVJHXJQBAMUX GQLSQDVBYJM     WLVJHFOMEUSNU   FYLLA          
LGXCBQAIAOA     : HOUNUSQWKYLUIR  TLXDDOTRHVXNED  LQPWGYDPDUA     VGQIRDCS        LWDNIWTOEBTJPK 
DYFXKUJF        : TYETHARXMLLJC   PESSWOFYUIYK    GCYTEBE         DMRKJN         
HIKUQU          : CYKULR          BVUSEFFQDYDJ    IAAFJVKKFXEBOF  OEKUV           LTEVQUERM       RVABWARMUJBMBUB
OSSBYSDAJGK     : MPHR            FJXENXTWUTXVMD  ERQAQCRH       
UMLXLSW         : PQVL            OSMEENCKBK      IHTSGQNLEXHITY  APLIJUPQTYRWDRL EJTNYDXOTUMVNME LSVFMKSFMB     
NIEORMAPDWGTP   : NPOOTJNCEUVHJEK TUIXMYHPWL      AGBCHHLHEQU    
UPRBRDHF        : EJTNYDXOTUMVNME PYROYPL        
ERDCGVBEL       : WMFIJNEUYXXWI   IVYIWTKSQAISVNM DMIYMTTKSBSFCVC MNULINTCJSPUJPS YKYHJWPJ       
KAGWCVCYCW      : GAKDJIOS        TDRWPHBMVG      NNSC            EHATWR          GSPVUWILMQ     
DTHUUBAEGRIBWN  : PHGYNJEOSC      HUIKBPJLQI      SLCVDOQWA      
SQLEDWFJVJHYJJ  : BOKRTJOHPR      BYUGHGBLJGOHJB  AFGQ           
DMRKJN          : MPWJ            CINJSYUDTIAS    NLOBPLEMCAL     EBJLOF          KOFBPENPWU      DYFXKUJF       
LRUGDXDQFWJQDOP : CUVFP           UKIBHEHRIYAB    MLHS            JFPHWA          YTLPGHJR        RCUEYPIDOJ      BMLRBFKYKT     
XOUHNGQLJFDVQ   : GKVYNG          ETLRQWAGI       DLKXLCKNGNPV    BVUSEFFQDYDJ    MXBDFXEQGNLDTJ  PSYXMJLRCIQW    BRIAAX         
JDNGJQEMJLLSF   : PDRVQAAJN       TLPYBJBNOH      IMFHMPYRXT     
IUAIJWQYDJMO    : NKIIQESV        CCIFRIGSJBBSJEF
QKILWNYFY       : CCHCVBBEQ       XYPJCKXCQ       LYGIYO         
MOBXAWDRFB      : AQXVPKYLGNVUSJ  LVJXDIATNPHUEH  GOPEUYL         KFKQIMLTGN     
PKRIMXSYOKRAU   : EBJL            EFXTAQYNPKH     UDKYMXRPQGS     YBEWRJVUY       MHJTD          
YLDGKVSBWRET    : QMJGMAEGOQYQDUB SATGEXIEDNQ     EYMAEQRCWFSYXG 
VBXSTJLCXLU     : KPPFITOUKK      UAOGMNAI        OHHKUJBDE       DVYWNXCRAYPDHO 
AHRCFVDQBK      : XIFOCGL         AUXB            XPCUKWCN        LPYYKXSHDJWU   
YDFYWJUSH       : EAUWQNELJJHT   
QBQCOSCAQCCA    : JGWAMXWWHTSA    EWJE            UGSDYJMRVOXNIR  PQNOEYKQIIRQS  
FFRI            : VLDCMUBLONCUG   RDVUSWB         DPSIKRDYMMOY    AICK           
USEUYJVVU       : BVDS            TJWTTGQMJX     
QENK            : CRSQNSXTYB      IRCBAIHHQOSC    SKMBSEMNU       ATUAVJNYNDI     KLWHSBJENMIEM  
GOVCRVUTBUPGDJ  : HBCFEAVQCMAG    BVFFLSCDF      
BGMFDLQ         : AUIJ            CINJSYUDTIAS    WBLXDJVWCBRXHV  YEOPIIPFQT      IWVKY           TEXX           
HNQYSGJAPXWRRUM : SWKIFCTDFAJ     NMICYF          CTCUHVDNBYHT    DCTJ            CYREFRBK       
VJFCMOVQXIX     : WHFS            CKEVRKXNCCLYWK  AIXSQJMTKYJY    CAHFU          
TPBD            : KXFWVEP         EQOVAGKRHB      LRTRU           CTAQQFTCJPDSYP  SAHL           
TEXAPYPOVJIQVWN : MPHR            RNKBYCYXS       FABIICDRYHCHYT  LTPTYOBUTGEC   
CRUT            : NKTJQFMDGEURL   LLMQNNTRNJQFJQB QPYOSOXFXI     
NTXM            : DTLWLK          KTRDJILFOO      DPVOIA          DDQGRQOMSAEEGC  KDVTOFNCYQJXJY  PAXEWNI         WETGYANET       XTUFTISCMSXRVDQ
NTXM            : DBTLKXAGBG     
TEXX            : SEXFFIACVN      QBEEPXNIHSMJPN  AJHVKBFPWIFQUQP BGMFDLQ        
REISUHKLDUTTSS  : IOWLNYCBJWGT    XHXAHLUAS       JMFHRFEFTB     
BXCYRRMLS       : PAQKD          
IMFHMPYRXT      : YWTKEO          XJKGOCJQ        JDNGJQEMJLLSF  
FFXIATESNO      : MPWJ            APFEAGETYGRGNL  CINJSYUDTIAS    JIIIJYRGE       QHFOBDW        
LSVFMKSFMB      : ENBYDVNGUFBYDW  UMLXLSW        
RKHJMBHGPMNPW   : JWJGIV          IHLWPR         
KELASILNESAONID : HBLIXBY         UAOGMNAI        UBXGHPEKMQPOYDX
DXCM            : YEJK            PYCPVVUKXBEQBM  TGIUJXSMKOWUO   SHMKEYAILEXHMGG DBKKXSTSTHC    
OQPWGENWCDJGOJB : FXUJHSQLAV      FOLHOHOJSJRDNS 
WQDRQU          : SJXVGXVTR       TCDHROLQTAJ     VESPXICOVLCU   
BXVE            : CCHQ            RKDIKLLMUCQJ    YYMXBAMYAJPOB   JPQSO           GPQDPVXKNOAG    PESSWOFYUIYK   
XTGOKVOQAE      : LPXYQ           PXSVEIAMB       UMDTOUKIGCGMEE  NTUWACFQ       
EHBMYMNXL       : LFIAG           RONBTX          MUNDDXNMPNIENMY BSKR           
EDXYIYY         : ISIJQSOXLWN     PEXF            UYQTLEKNKLM     MWOMY          
