HOWEJ           : KCOCHRERIMN     GIIBEINY       
LDCBP           : FODGRKAQVG      WSQATWDIHIWX    DRLRJWJIYRBCQC  HTCECFSBEVRMD  
BHDICHXGLDXIIIA : DBFRACF         QSPTUMF         XYDO           
DVRLLQRULDB     : UTMRWXQWAPV     JYKYYTHFQFRJAON KXIDAQDGBCVCK   UKKDUNCDNWUB   
GQUHAARCJPKUU   : DGVXXEGAPIWNIRI MFRGVBOC       
FETFFWEW        : XQUE            HCCFWUSWKDYYHU  DGVXXEGAPIWNIRI EBDIUTRRICLFS   WSPNMG         
PPAMCFNULG      : LWDWGDJOLEBO   
VHSN            : YECHDWO         NBWATVLDFRYQDA  CCGW           
CEWABIH         : HIBHNXIEWX      CWUOYMVFCWI     JVHMNGXJMAM     OJRM            PQRHSKSDBB     
CPLBTKKLBMXF    : WIAGCWJW        RCHLKNSCLWJE    IVIUSBH         QLATNWTFBOLXWSX VWIUDEP         PSOQIPGA       
OAGURCEKQ       : JTXRAQJVURTGI  
PWPRXAY         : XYPTRXKDKXRA    RTTJNHKBJKRHYAG REYOCQXGJOLS   
CORDICPTDFU     : BBCJYVS         GVTNXV          QCWWEHGXVHG     IIOFCDFNAFRYCPD SBDVQRLPK      
XJKGGDJNP       : BPARBSNDUKXGG   FJKH            FMXMIHS         UNHSTUJYPC      RNXJWXEXVXC     UMBYIAXFECXRVMM
GFYXWYXWFCNW    : DHVPHIV         SSKWEQHSXXTB    GITVL           XJPC           
YAXSFDPQDBBJIE  : ENLV            NRTHQ           ISCWYNYS        LGJPVV          YHRUQQT         LXHGOLPGKV     
XUWECXCAAAY     : ABLUIWOCUK      CJQC            WHQROTSP        HDNPRQMYHYG     UIIMAUDRFRR     HWPTFNVF        ILKNMTUPFTR     INFDRCCF       
XUWECXCAAAY     : MYAHQHW        
EMDL            : RWNNVBP         PEXBDHTYSGTF   
FJHMOY          : FPFKG          
TBHELLBJ        : PWJQVWIKYPVCTH  KDKVOFKTBHQJEJ 
BNLBR           : BBCJYVS         VUEMIVGIVH      QSGOWVKMJY      YJPHPCLPDS      FTMEEEWQXOX    
BTOHXDMJRTVBGK  : PYUEOLUWHH      XRSDJBCLQEPVS   TEBQK          
MFDT            : AFGVGCOXFRFA    OWLC            IYCRNM          RUWJEHFYRIIOOC  FSMPMJHAY      
OHOAQPNETHTUBIE : AWEPSW          KWLCIQSQJW      QSPTUMF         RTQBCKMEUKE    
LSNFMJGVVHIDK   : JARVWGXWBENNXJ  GYVCVVA         OPQKIGDTH       FQNIJKGEPKQAUL  SQXXBR          PSOQIPGA       
QCJICCXSG       : VFIGTRFJ        URXTMGXRHLTRJEL CMWHEQUFHA      JKUKIM          XPFYSKOPURPLDVX APBUEW          VWIUDEP        
AAPEKVHYPU      : RKUE            JJDXNJTOWC      DEHTFLEJAHXQT   RSHUH          
CGLXDUGI        : WEYDTEPY        SNWRCJG         KCOCHRERIMN     CQMKSGWJYAJJ    HDWNCOSBRPGXNB 
KCJWK           : HNFBICFXFNRKNQ  XOFL            VMHAQDTBQGQFBM  FTMNNMECM      
YKHIFHKUNVSVW   : TAUCOSOWCKTLD   VTBUEAVAKBQPTA  UYAQCHIFSWNEPS  WMDLBK         
SBLAOLFJUPR     : UCPUT           IJOSXKIBBH      QNEKHGYYLMQHKXS SITOWEP        
RDECRENYMSJYPWU : KYYKNYKDUNGX    EPPGOFAJRQSH    PSKAVOHGIA     
URTQVHQKSXW     : AYQVYD          MQGTOJITISXUQ   SOBTPL          NOWTONVHLE      XYDO           
NQXGTCIMIX      : DRSPLMTUAUFFPFO HPODMNDLOH      CSJYJ           TEBQK           IBTCPHBYU       TNRKNSDSOXOOL  
WSWWKWRTT       : QRQJHOCHGW      GPILNABKPPIPXU  UCKEXLRHEA     
PKIWDUPBRGPK    : XKFUXGKFOQLH    UPXKAVOMDTQXA   HFUVUBQWMXBKPJV
VFIGTRFJ        : QCJICCXSG       BPARBSNDUKXGG   YAAWVTLT        HDWNCOSBRPGXNB 
XHLJGGFCUUNFT   : UKVDPXE         KXICR           CSJYJ           KGCFTCMWLAEG    FLBUFCYVI       CIDKCOVWHMP    
AJUURKFXI       : ABLUIWOCUK      XFWQWQ          TVVEXTFIR       CCGW           
HOIBVSPUCEGKM   : IIOUGUDLSJVFHH  GPRTKXCYNRBMLA  PJSCGSA        
MHKCOEVQPQNIDV  : JRTEQVKBON      PWJQVWIKYPVCTH  NMLOLOJHAOO     GPATTYG        
LIPATQWOJTQPCDC : OFEGPEYOKNHTCQY UYAQCHIFSWNEPS  QJDQODICAWDPHJL
PLCUAGQQXJHGMDP : DCEEHXIXWQ      BBNEBHIOOBYRKB  CMKQOQKHVMSNF   DGVXXEGAPIWNIRI UMBYIAXFECXRVMM
LHAHBYVMUOC     : JIFXQALSDIN     MYMQAXI         XXKCBJASLOXNC   YBTOJTOHRUOJI   QSOHYE          BQLKOGMORYQRNY  JAATGEWVKB      QPJKYTMHDETX   
TEQKRSHTBXMAJTI : BQWHLMXHE       GJBMVEKGJEBXTD  QSLBAOJKU      
WXVLIX          : FGXUHRRCMR      XGLUNXYYXHYQBUL HWPEQ           IQWFIPUWPCEOEHG
JARVWGXWBENNXJ  : LSNFMJGVVHIDK   WYRCSB          YNORGA          NQXOJPWGVS      YHRUQQT         WSPNMG          BXUTWDDMAC     
RKUE            : AAPEKVHYPU      USABSPTLNTBS    PNKNJXPDRUPCEWK CUQYPLEGT      
GYVCVVA         : LSNFMJGVVHIDK   JFHMOSDMHI      EOQKXDWFUB      VUEMIVGIVH      KAVMMAUXFTGS    OMAYTOBLHHVRHUK QKKQKQWLHHIWPCH
EADNCULADLW     : TBRUNBOHF       HBVDMPXM        KAVMMAUXFTGS    XNGTQL         
RMTPVQHJNOVTNRX : YNQCJNRDC       VABEQSOEL      
OATUDWLFR       : YAEWQXQXSB     
FUJECDTXTR      : PALMCPAPGQGSX   LYFQFOCTEP      YSMGJ           UYAQCHIFSWNEPS  CRSQECGUFBXNYWS
DBFRACF         : BHDICHXGLDXIIIA UXEQQAGQ       
CRKFNGIKRNEQVB  : PMVLGYKKMFJ     QCGUY          
AFGVGCOXFRFA    : MFDT            TROGGEQD        YFXVCJKNK      
JHOMBYROHCBBPH  : CVLHXFR         IIJX            APBUEW          TWTK            XFWQWQ          MRVHMNWVDBUG   
NJUQQDM         : YXLK            XOFL           
FBUN            : PBGSADURF       MPAQGANTWHT    
DPNM            : BQWHLMXHE       ILTV            YTRXSJVFP       OMAYTOBLHHVRHUK FBUQLUGAPWI    
EYYGSPNURRNYKBK : MRJNHCPTPRCUBOT BBQIBXUIOPGGWHL VDTMQMSNLSDLCG  UYAQCHIFSWNEPS  CCGW           
RCNFBSIYIECXUO  : QDUWBUD         ENLV            SHTBMJQGAGGHHMX TWTK            ORVEYIPYPLLDBAJ
BQWHLMXHE       : TEQKRSHTBXMAJTI DPNM            CJQC            TOUOUFOGK       VFNLACXCFHVHHMQ MHOXE          
WGCAQLSSYA      : UPJRUIMLFJPUU   UKKDUNCDNWUB    TNUEDLPCQF     
UKVDPXE         : XHLJGGFCUUNFT   HWJGX           OSFDKM         
MCNFYXRNVBUN    : JTXRAQJVURTGI   FWTLMQHGRGEH    UIBYQLEJ        SACIPLSRLEG    
BPARBSNDUKXGG   : XJKGGDJNP       VFIGTRFJ        QHHYHUR         HBVDMPXM        SMDAYCHSAB     
XGHMULABMAU     : YLFSDHR         USVDBYJLMKW     MOFHDAJPH      
VXXJXYBXSF      : AXHUFPNLEPYJNXX QAIPX           QCCVCT          TROHIU         
IIOUGUDLSJVFHH  : HOIBVSPUCEGKM   JJDXNJTOWC      SLHPOCUNFTBFWQB MFRGVBOC        TROHIU          TVVEXTFIR      
IUIFXHDVSB      : FSQWXOW        
WYRCSB          : JARVWGXWBENNXJ  AJAVUCBALBLRS  
IXSFCEBNAIUKS   : LIJCDYRPHUET    PJSCGSA         KBHTFTS         SOBTPL         
FEMF            : XVHPLMMR        PSKAVOHGIA     
PBGSADURF       : FBUN            WSBYFMLQYGI     QWTHFRSSRGY     SBDVQRLPK       NLOBIF         
URXTMGXRHLTRJEL : QCJICCXSG       ENLV            IUHV           
LPEQDVTJPT      : GBGYUOQNRVYU    VPSDYTFUCKR     PWACVHHRUMXXRU 
MMWCH           : TWJGVVBAOUARQYW QDANV           KIDVHKUGVDU     VEPVMLORMIMUHCB RWNNVBP         MQJWDPLEPCYJ   
BBCJYVS         : CORDICPTDFU     BNLBR           DUYCQIVEBUAHNOT LWTPHCUM        XBYEBWU         HGSDWEXFEP     
QKYWVRJ         : CJQC            XWGGYIO         HDWNCOSBRPGXNB 
XCQUWDMQUY      : BOMICH          QRQJHOCHGW      HTDGVNDHTIRSU   QKJUQ          
RBLJE           : GVTNXV          KGSYJ           JAATGEWVKB     
OPQKIGDTH       : LSNFMJGVVHIDK   GNOD            PMVLGYKKMFJ     PQCCKCI        
RYOGAQY         : OFLRSGJPPSXQY   CFOAFQM         SHOHCO          MRJNHCPTPRCUBOT SQXXBR          GPILNABKPPIPXU 
NEJFYKITNV      : TPRNDGYMWMSA    FQNIJKGEPKQAUL  FBHPKE          QSGOWVKMJY      EFTSQVNJQIXG    CCIEA          
SNRKGFTMKPVN    : BPAQWJYQGBU     WSPNMG         
UCPUT           : SBLAOLFJUPR     USXKVRSVHMUP    IWTOJR         
RHVDOXNAR       : IIDJEO          PHABNORKXCI     YAAWVTLT        LVWVPSWGODRBXM  YULF           
VWWL            : MBGSQCAK        UJCACKICCE      FMLNVVM         JQCWWOMTJCUOVV  LWDWGDJOLEBO    MIAAVXE        
HRYBGJQCABAESW  : NBNRXDCRDW      MPOMLTENLKUQ    VJMBPCU        
KRIJUYHJYBNXA   : KCMCDMKFTVKQ    TWPOWJN         FVWJXXNFSPI    
JRTEQVKBON      : MHKCOEVQPQNIDV  QJSWQSIQS       JUCKFEDU        CJLYBCGUUQRLF   BBQIBXUIOPGGWHL UUDUARWEFJ      AMFQFFNSENDGPN  QCGUY          
RPHLMIXESHCRQN  : LIJCDYRPHUET    DEHTFLEJAHXQT   VGEBCFGYVK      FPFKG           YOHWTOBTVA     
TBRUNBOHF       : EADNCULADLW     KBXEDN          TAUCOSOWCKTLD   NDBD            QWNJTDTFVBXLYBO PLEGHWEXHMH     KUSNFPHH        HGSDWEXFEP     
FSJUG           : OWTRXYXNGQ      PXFTYRPDBVQ     HCGASFFLON      RWNNVBP         OKGTNTI        
OVVCKEBRYKTREH  : LFUYOWJEPITDK   DLPJE           YBTOJTOHRUOJI   QJDQODICAWDPHJL
XKFUXGKFOQLH    : PKIWDUPBRGPK    NCLDNE         
IPQWNMCA        : DYJDVDFEKBSUVT 
DRSPLMTUAUFFPFO : NQXGTCIMIX      SWFKMMLXTE      IUWELYNHLMW     DJKONLTIALBN    UABQPJD         XYDO           
LFUYOWJEPITDK   : OVVCKEBRYKTREH  MRJNHCPTPRCUBOT FSXIGKNXE       FWJLUJGSILPFY   CCKGWCFP       
YNORGA          : JARVWGXWBENNXJ  GBWWRCIHVMJ     HWSNEDKIBT      DGVXXEGAPIWNIRI DLPJE           SCWVLQWPPEYFGX 
AXHUFPNLEPYJNXX : VXXJXYBXSF      DQTEAIEKO       YAEWQXQXSB      CCGW           
JEDRA           : TTWDWROW        JQCWWOMTJCUOVV  YDHWNBIHOO      JVHMNGXJMAM     EFTSQVNJQIXG   
DTFSIYYLGCLQWQG : SNWRCJG         RPIKB           WVTY            KUSNFPHH        DQVI           
CKFBVSBVFKCIDC  : XYPTRXKDKXRA    YAFTVPTAIXCF   
IXXDJXDUGF      : CWUOYMVFCWI     FMXMIHS         JAJERCSIJDK    
WEYDTEPY        : CGLXDUGI        NBNRXDCRDW      NCHFYOXGVSCYT   UUDUARWEFJ      WMDLBK         
NRJJYTLIYPYHOXN : RTAQSSOUIKPLCP  HTDGVNDHTIRSU   XRCINUDQXMX     PSPNDWGBVQEB    TROKGB          VTGPISV        
XQUE            : FETFFWEW        PWJQVWIKYPVCTH  EGOKTJM         SKYNBKMID       QFNDKGLBJJAMGF  XVHPLMMR       
DCEEHXIXWQ      : PLCUAGQQXJHGMDP KDKVOFKTBHQJEJ  XNRQDYMCHLYU    STPF           
QCXQVLBXC       : ODAFKAVHEPICAFP
HSCUQANNH       : VVHEPWULWRASCF  NOHU            AWCNJ           RSHUH          
QJSWQSIQS       : JRTEQVKBON      DIMVDQEJASVTD   LQMNTA          JYKYYTHFQFRJAON
DJDBCBMFYQI     : QRQJHOCHGW      CWMKSSTRMRKU    ETMJYXOVMEK     GITVL           SRUONLI         VWIUDEP         KMXNHJEUA      
JKECNSPUG       : DYSULULO        RPIKB           YHRUQQT        
GBGYUOQNRVYU    : LPEQDVTJPT      FWTLMQHGRGEH    FEVKUVPQUKJBLF  KQQJISI         YAEWQXQXSB     
CVLHXFR         : JHOMBYROHCBBPH  TMHFYBCWSU     
OFLRSGJPPSXQY   : RYOGAQY         PAKCILEYHNXAF  
LPNBH           : SCRPOQIGA       HTDGVNDHTIRSU   UHDPXJVEABQQD   UCAR           
BEIFA           : NKJSFSNVCBW     CMYYCOGFWJA     NCLDNE          TTKKXNTVS      
OXCHH           : XRAPEHVYWDRQ    XNGTQL          TJVSCYJJAAMHQL 
OTMHAWY         : WSBYFMLQYGI     SEHOWYMHIPSPJ   BPSPSTBWCLSYY   DLHTAH         
PWJQVWIKYPVCTH  : TBHELLBJ        MHKCOEVQPQNIDV  XQUE            YHFB           
VGXWKHEDVASFDPE : XMTSDH         
FDEXACGMDV      : GSRLQUC         KHMAQSGIHAYSKD  VYUJMHDCQN     
FRTOPAMMKU      : TRCWMGNILG      GWYJGMLCYSH     FWJLUJGSILPFY  
QQRJWUBDQIH     : XNRQDYMCHLYU    FPFKG           QTQUQKIJRPA    
GJBMVEKGJEBXTD  : TEQKRSHTBXMAJTI PHABNORKXCI     BCSXBQYRN       FBHPKE          AJUVOQOETGDQPT  POJU            VHNRUTN        
HQIBJBUUXSV     : BOMICH          KWDLMST         NFGNBWFQJFE    
LELIK           : IUHV            VABEQSOEL       VWPQ            GITVL           RDLJTKUHNMH     CYWSVGSSTOKNKN  CRAGDETJFVGTS   YBTOJTOHRUOJI  
KWSO            : JIFXQALSDIN     SNFOFYMN       
BBNEBHIOOBYRKB  : PLCUAGQQXJHGMDP WSPNMG         
FYGBFT          : OWLC            JKUKIM         
SCRPOQIGA       : LPNBH           POYIXWWVMG      XAOTIYSPKHULTJT YJPHPCLPDS      GQSQSXW        
HNQIUYAMCYEMATT : WQUERBXI        TWPOWJN         TWIRSMT         GHUQIEECNDCT    JAJERCSIJDK    
CWHVEBBVQPOCVOO : KUGELCYBHSYBAG  TMDMNIWDTRW     CSLWHDVL       
CFOAFQM         : RYOGAQY        
PSWSPQWROGQSJRR : MDTWWHUQX       CMYYCOGFWJA     JFOPGDVASWVEUWN
HGFEXTJAYACGS   : DTBEWLRTPKXBKQ  WSBYFMLQYGI     FOFTMR          DHUMWX         
QLKPE           : CRLMRIJPXSGJ    DHVPHIV         UYAQCHIFSWNEPS  SCWVLQWPPEYFGX  GDEVQSARSL     
IDTWJKSTCMWKSEQ : JQTVTPOUPMJV    KXICR           SKYNBKMID       BPAQWJYQGBU    
XCTYFXIXNBJAQ   : OQQBMDXAHXPNAV  TOJCGTJIDYD    
AYQVYD          : URTQVHQKSXW     JVXMLRKOTDSSEWI CCNOQMKAVCPBRFF NEGJCAMSJIP     BEXBOD          PNSVE          
TWJGVVBAOUARQYW : MMWCH           FMLNVVM         TGLVEYDCVQB    
JUCKFEDU        : JRTEQVKBON      GSRLQUC         GBWWRCIHVMJ     WHQROTSP        GPIH           
FODGRKAQVG      : LDCBP           UJCACKICCE      ODAFKAVHEPICAFP CGUY           
SHOHCO          : RYOGAQY         UABQPJD         GBYWIQJTLEIPMPB
UPXKAVOMDTQXA   : PKIWDUPBRGPK    DUYCQIVEBUAHNOT YBWPMROWC      
OFEGPEYOKNHTCQY : LIPATQWOJTQPCDC LWTPHCUM        WPQGHIWRKAFYR   VTBUEAVAKBQPTA  PSOYRGSDYWW     LLNYNCSQVKWU    UCKEXLRHEA      NRQHGDAQ       
UTJU            : FSGIXPTBINH     VEPVMLORMIMUHCB
JQTVTPOUPMJV    : IDTWJKSTCMWKSEQ CUKAHBHLHRYHG   VJYQH           PNQN           
SNWRCJG         : CGLXDUGI        DTFSIYYLGCLQWQG UJCACKICCE      WPQGHIWRKAFYR   NTJEOJMONREIRY  TWIRSMT         WSPNMG         
EIFF            : SQXXBR          WHQROTSP        JCUWXT          EUBPGYBMRJAJP   FTMNNMECM      
ABLUIWOCUK      : XUWECXCAAAY     AJUURKFXI       GDYFBO          KXIDAQDGBCVCK   HQTOGVIC       
KFJYRHSKXPCAAK  : YLFSDHR         FBHBSQER        CVLTIYWMM      
GVTNXV          : CORDICPTDFU     RBLJE           FGXUHRRCMR      EIIYSMVRVEOXPW 
LSYIHDDSWPAHRR  : RAXBVMXAQPMAEGS RQPOAGFYABOHMC  FTMNNMECM      
KCOCHRERIMN     : HOWEJ           CGLXDUGI        WVTY            LDNPY           QWNJTDTFVBXLYBO JCUWXT         
ANARBUSLDWRXTH  : QCWWEHGXVHG     OKTQRCCHH      
DYSULULO        : JKECNSPUG       HXGVVNBSV       HNFBICFXFNRKNQ  GQSQSXW         PKPUIHP        
FSYNIORIDTCGP   : FJKH            NFJHSVCEGR      RSHUH           IVIUSBH         XPFYSKOPURPLDVX
SSUKSOTSSVL     : DUYCQIVEBUAHNOT FVVXQVRAMGUF    KIDVHKUGVDU     DAFQNRACP       SRUONLI         PSOQIPGA       
JJDXNJTOWC      : AAPEKVHYPU      IIOUGUDLSJVFHH  FGXUHRRCMR      WYUQTFQHEUTBBQ  DSRAFOAVEGOQV  
RMJLRPBPK       : SXOIACDOWBMI    KQHSMFDVOOF     HWPTFNVF        VJMBPCU         UYAQCHIFSWNEPS  TWTK           
KWOBTIVPVLB     : BGCGSSOM        NKJSFSNVCBW     TROGGEQD        FSXIGKNXE       OKGTNTI        
RAXBVMXAQPMAEGS : LSYIHDDSWPAHRR  WNXXPTCDAUFYRJ  PQUKQGORWMIM    TCPQX           UJYWKTOR        FTTANFOPWOV    
VDCIDQK         : MEDYETURRUWDN   OKTQRCCHH      
BGOAUPHMRFNN    : BXBASBO         JFOPGDVASWVEUWN TEBQK           CCKGWCFP       
NNLGD           : RPIKB           GBWWRCIHVMJ     FMXMIHS         OWTRXYXNGQ     
KJHRIMTQPNDMQ   : HWPEQ           YHRUQQT         UPDHEUEYI      
BQHTB           : UUGLXXGPBNMNPR  TMHFYBCWSU      VFNLACXCFHVHHMQ
LIJCDYRPHUET    : IXSFCEBNAIUKS   RPHLMIXESHCRQN  MBGSQCAK        QTQUQKIJRPA    
NMRAIIQVOFPY    : NEUHUOJNBAUTPB  NTVVOC         
IIDJEO          : RHVDOXNAR       KWLCIQSQJW     
NQXOJPWGVS      : JARVWGXWBENNXJ  BUNIRXTHXPPG    LDNHREOHAXRN    XWGGYIO         IPUAOG         
JFHMOSDMHI      : GYVCVVA         IGPEIRYBNLO     BCIM            QRBUFCNS        XYDO           
IRNQUYUMTKDUY   : UUGLXXGPBNMNPR  NLALJTWRL       BBQIBXUIOPGGWHL
KXVHRLSYTFPOK   : SWFKMMLXTE      KBXEDN          YAHEWQGRSCVVNAT QDLYLGQMGMJT    JOWXOJ          IFSDVQNUNOWAFKY
VVHEPWULWRASCF  : HSCUQANNH      
DUYCQIVEBUAHNOT : BBCJYVS         UPXKAVOMDTQXA   SSUKSOTSSVL    
MPAQGANTWHT     : FBUN            MLAMCNUO        KHMAQSGIHAYSKD  XDPPYJRUNR      ALYUSDEDCWPEX   HWPTFNVF       
JYGPT           : AWEPSW          XLCBNVOPA       EFIGDGIEIV     
TMPPTQMTAA      : FCSPWQVLRJUFW   OJRM            MYAHQHW        
USXKVRSVHMUP    : UCPUT           DEHTFLEJAHXQT   LLASIYQNT       LOIISDYHLAAE    RNXJWXEXVXC    
MBGSQCAK        : VWWL            LIJCDYRPHUET   
PCLJPHLR        : QDYVPTR         CPHMCNJNTMRBFXP FKRRRMPBCT      UJYWKTOR        VDTMQMSNLSDLCG  SMDAYCHSAB      NOTDDNWT        UVQG           
ILTV            : DPNM            TSHWNMIY        FJKH            ETMJYXOVMEK     DNUMMHCHQECMPQP
NOHU            : HSCUQANNH       USABSPTLNTBS    QVNMMDQYKYXMNM 
CMKQOQKHVMSNF   : PLCUAGQQXJHGMDP LSLYYQ          ARSUEAPOLVIYSV  SOBTPL         
BOMICH          : XCQUWDMQUY      HQIBJBUUXSV     YYDPFGK         NCRLHHROJIIOJ  
NUAJ            : UTMRWXQWAPV     HSUQAAHFUVXKKK  ISCWYNYS        VABEQSOEL      
PALMCPAPGQGSX   : FUJECDTXTR      USOBOWUJORBT    BXBASBO        
GSRLQUC         : FDEXACGMDV      JUCKFEDU        WQUERBXI        VHGTFDJ         PLEGHWEXHMH     LVWVPSWGODRBXM  QKKQKQWLHHIWPCH UURBJFQPPO     
GSRLQUC         : AJAVUCBALBLRS  
EGOKTJM         : XQUE            JYHFKBQHGN      CWUOYMVFCWI     PQRHSKSDBB     
NCGYQKQQA       : KHMAQSGIHAYSKD  SOBTPL         
JJQIP           : ALYUSDEDCWPEX   HIUK           
DIMVDQEJASVTD   : QJSWQSIQS       NMLOLOJHAOO    
CQMKSGWJYAJJ    : CGLXDUGI        AOFYKM         
DTBEWLRTPKXBKQ  : HGFEXTJAYACGS   EOKRM           FONOJTYKUYC     NTVVOC          QSOHYE          PEXBDHTYSGTF   
HVKJNATIG       : HIBHNXIEWX      LGJPVV         
TFSEOEJIGNIR    : BUNIRXTHXPPG    QRQJHOCHGW      JKUKIM          UUDUARWEFJ      TVPTSEDA       
CJQC            : XUWECXCAAAY     BQWHLMXHE       QKYWVRJ         AAVLSSIGTCDC    WCMWGTECDN      HTCECFSBEVRMD  
BUNIRXTHXPPG    : NQXOJPWGVS      TFSEOEJIGNIR    HFUVUBQWMXBKPJV FMXMIHS         RIOLSSCC        KGCFTCMWLAEG    KNNSEKQYHAAOYH 
LMEPBLYMRPULUY  : WIAGCWJW        UREYMTMQLXAU   
NBNRXDCRDW      : HRYBGJQCABAESW  WEYDTEPY        GBYWIQJTLEIPMPB FTTANFOPWOV    
EOQKXDWFUB      : GYVCVVA         JFHJHNPAEBF     HIUK           
WNKMKX          : FPFKG          
JVXMLRKOTDSSEWI : AYQVYD          UNHSTUJYPC     
HIBHNXIEWX      : CEWABIH         HVKJNATIG       MDTWWHUQX       FMOSMOSNW      
JKNVTLVIXNS     : JIFXQALSDIN     HWPTFNVF       
HXJBFG          : ELYKUXUJOQCI    QAIPX           RULFBGREYERSPHV GCXNJFLFURIF    OFTAGQYNUT     
DQTEAIEKO       : AXHUFPNLEPYJNXX JIFXQALSDIN     YBWLBINVPDNYQXB PLEGHWEXHMH     TVHWEXIP        FTMEEEWQXOX     OSFDKM         
KENUT           : QRQJHOCHGW      TVPTSEDA        QQBSOUOEHPXGF  
QHHYHUR         : BPARBSNDUKXGG   PKRKMADLPB      UURBJFQPPO     
FSGIXPTBINH     : UTJU            PUSA            WNXXPTCDAUFYRJ 
XNSNPDTGANRQUAP : DHUMWX          OPYQHCMKVSE     TWIRSMT        
UJCACKICCE      : VWWL            FODGRKAQVG      SNWRCJG         FPGNBBDBDDBKC   JQJVTG          SQXXBR          TOUOUFOGK       XXKCBJASLOXNC  
KUOUSDN         : MTDFRPPUSART    ELSSDVLJI       HBVDMPXM        AJUVOQOETGDQPT 
USABSPTLNTBS    : RKUE            NOHU            VFNLACXCFHVHHMQ
LWTPHCUM        : BBCJYVS         OFEGPEYOKNHTCQY OTXWOJFRLLCCB   QSLBAOJKU      
AWEPSW          : OHOAQPNETHTUBIE JYGPT           UWHUBUPTYMI     TOJCGTJIDYD     VQWHBLMFQRSRW  
IGPEIRYBNLO     : JFHMOSDMHI      JKUKIM         
MHAAGTSNWNCI    : FVCPX           MFRGVBOC        QHYNBHOVPLKMPA  RTTJNHKBJKRHYAG PRROTXEKKBU    
AMHULC          : YNQCJNRDC       UUDUARWEFJ      JVVBDXTPOMKG    VFFJXLNSHC      MQJWDPLEPCYJ   
TSHFKJ          : QCWWEHGXVHG     WYLCCLYOBM     
XUUHJEHKKCDABS  : KBHTFTS         SSKWEQHSXXTB    YGTKB          
JIFXQALSDIN     : LHAHBYVMUOC     KWSO            JKNVTLVIXNS     DQTEAIEKO       GNOD           
NAWTXTQHDUPN    : XGLUNXYYXHYQBUL LPWYISBYX       GCXNJFLFURIF    EXNJAESOIHAXDN  XFWQWQ         
TSHWNMIY        : ILTV            IJOSXKIBBH      UXFVST          VJYQH           YGUCTPOIYS     
GPRTKXCYNRBMLA  : HOIBVSPUCEGKM   DAUBVSU         NOTDDNWT       
CJLYBCGUUQRLF   : JRTEQVKBON      RPIKB           PQUKQGORWMIM    DMQYIJGEVLIAKB 
KXICR           : XHLJGGFCUUNFT   IDTWJKSTCMWKSEQ RPIKB           CVLTIYWMM       IRANTIKF       
MRJNHCPTPRCUBOT : EYYGSPNURRNYKBK RYOGAQY         LFUYOWJEPITDK   IEGCINO         XRAPEHVYWDRQ    YHRUQQT         RWNNVBP         SOBTPL         
QDANV           : MMWCH           UUGLXXGPBNMNPR 
YBWLBINVPDNYQXB : DQTEAIEKO       QLATNWTFBOLXWSX ILKNMTUPFTR     FBUQLUGAPWI     SCWVLQWPPEYFGX 
TRCWMGNILG      : FRTOPAMMKU      RETKFAIXTV      JJUGJYBX        VHNRUTN        
NVJKX           : PSOYRGSDYWW     UPDHEUEYI      
IJOSXKIBBH      : SBLAOLFJUPR     TSHWNMIY        KDKVOFKTBHQJEJ  UPDHEUEYI      
YLFSDHR         : XGHMULABMAU     KFJYRHSKXPCAAK  SUHOQ          
PHABNORKXCI     : RHVDOXNAR       GJBMVEKGJEBXTD  ORMQOHMXCITRSHC UVQG           
MTDFRPPUSART    : KUOUSDN         DYJDVDFEKBSUVT  FTMEEEWQXOX    
WPQGHIWRKAFYR   : OFEGPEYOKNHTCQY SNWRCJG         NCHFYOXGVSCYT   TNCMAGMQYSANQ  
AWCNJ           : HSCUQANNH       MLAMCNUO        SXOIACDOWBMI    TEBQK          
QRQJHOCHGW      : WSWWKWRTT       XCQUWDMQUY      DJDBCBMFYQI     TFSEOEJIGNIR    KENUT           OWTRXYXNGQ      JYKYYTHFQFRJAON AOFYKM         
FMLNVVM         : VWWL            TWJGVVBAOUARQYW VJYQH           IIOFCDFNAFRYCPD
HPVGJ           : VHGTFDJ        
IGSW            : IBXJO           SOBTPL         
RPIKB           : DTFSIYYLGCLQWQG JKECNSPUG       NNLGD           CJLYBCGUUQRLF   KXICR           UUNBRUINCLWN    WVLB           
YECHDWO         : VHSN            DVPGKY          ETMJYXOVMEK     RCHLKNSCLWJE    FBUQLUGAPWI    
LDNHREOHAXRN    : NQXOJPWGVS      BCSXBQYRN       KGQTVO          NCRLHHROJIIOJ   HIUK            REYOCQXGJOLS   
XIFQAXBLBVMFX   : HCCFWUSWKDYYHU  PCJSGUIBUYJHWB  OURKEJFSWCTC    VHLNPHNJYGN     MVKUJEQSRHPNK  
KWLCIQSQJW      : OHOAQPNETHTUBIE IIDJEO          JIQMJHUKHSUWIDF
SWFKMMLXTE      : DRSPLMTUAUFFPFO KXVHRLSYTFPOK   NPVVFJ          VHGTFDJ         QCWWEHGXVHG    
TGLVEYDCVQB     : TWJGVVBAOUARQYW UUGLXXGPBNMNPR  YAAWVTLT        TPRNDGYMWMSA    DKIISQJOL       YOHWTOBTVA      CPLKHNQD       
SKYNBKMID       : XQUE            IDTWJKSTCMWKSEQ ODAFKAVHEPICAFP DVGBO          
OQYDCY          : HXGVVNBSV       KWDLMST         SOBTPL         
IWTOJR          : UCPUT           OMAYTOBLHHVRHUK VFNLACXCFHVHHMQ
IUWELYNHLMW     : DRSPLMTUAUFFPFO BVDPRLBO        IHHLJC          CCIEA           MBDYFNG        
WKWDVLTWOVVOETK : UXFVST          AEDIAHGJMELCDME BEYMTEH         JFOPGDVASWVEUWN OKGTNTI        
FCSPWQVLRJUFW   : TMPPTQMTAA      DAFQNRACP       QQBSOUOEHPXGF  
RVCQYYDSV       : AMFQFFNSENDGPN  VPSDYTFUCKR     QSLBAOJKU      
QSKX            : FQNIJKGEPKQAUL  LDOLGNTJ        EFTSQVNJQIXG   
WVTY            : DTFSIYYLGCLQWQG KCOCHRERIMN     BGCGSSOM        YTRXSJVFP       YFLPCPA         QWDL           
JYHFKBQHGN      : EGOKTJM         QNEKHGYYLMQHKXS
AMCR            : AMFQFFNSENDGPN  TJVSCYJJAAMHQL 
DWJBSCTE        : NPVVFJ          GCIHTMBGGMFPU   JQRVN           DSRAFOAVEGOQV  
KBXEDN          : TBRUNBOHF       KXVHRLSYTFPOK   UTMRWXQWAPV     NMLOLOJHAOO    
CWUOYMVFCWI     : CEWABIH         IXXDJXDUGF      EGOKTJM         CCGW           
YAHEWQGRSCVVNAT : KXVHRLSYTFPOK   PCBUELAAAYGQEWU WNXXPTCDAUFYRJ  RPYVJWBGQXAD   
FJKH            : XJKGGDJNP       FSYNIORIDTCGP   ILTV            LQMNTA          TEIYSXPGMJMAWW 
HXGVVNBSV       : DYSULULO        OQYDCY          KGCFTCMWLAEG    WRFNBMUKWLC     JHCXFPEEAQRFB   VHNRUTN        
UXYYWR          : MPOMLTENLKUQ    BCKCLBLQMWCF    RSHUH           YHFB            TROHIU         
PNKNJXPDRUPCEWK : RKUE            XLCBNVOPA       JFHJHNPAEBF    
FGXUHRRCMR      : WXVLIX          GVTNXV          JJDXNJTOWC      KEBFSNOSLUC     OJRM           
NPVVFJ          : SWFKMMLXTE      DWJBSCTE        IAEQBAVPRU      QSGOWVKMJY      VFFJXLNSHC     
UUGLXXGPBNMNPR  : BQHTB           IRNQUYUMTKDUY   QDANV           TGLVEYDCVQB     CJHXWGFFABFRVAI LDNPY           GWYJGMLCYSH     OKTQRCCHH      
QNEKHGYYLMQHKXS : SBLAOLFJUPR     JYHFKBQHGN      LMBGXBU        
TNYFOXNEBD      : WHVCFEXFY       ILKNMTUPFTR     NTVVOC          IIBV           
QVNMMDQYKYXMNM  : NOHU            LWLPOKCP        FVCPX          
UXEQQAGQ        : DBFRACF         JCNEEGL         FMXMIHS         USVDBYJLMKW    
WQUERBXI        : HNQIUYAMCYEMATT GSRLQUC         SYJANSPH       
LWLPOKCP        : QVNMMDQYKYXMNM  YOHWTOBTVA     
QDUWBUD         : RCNFBSIYIECXUO 
ODAFKAVHEPICAFP : QCXQVLBXC       FODGRKAQVG      SKYNBKMID       PCJSGUIBUYJHWB  PNSVE          
QFNDKGLBJJAMGF  : XQUE            VJMBPCU         NBWATVLDFRYQDA 
UIJCUJXDN       : YSMGJ           PBVSITJN        NBWATVLDFRYQDA  WMDLBK         
NRPVHPOPDSAJ    : BGCGSSOM        JYKYYTHFQFRJAON
DVPGKY          : YECHDWO         EFTSQVNJQIXG    CPLKHNQD       
TTWDWROW        : JEDRA           YAFTVPTAIXCF    KEANQGJNVNSKYCD
ENLV            : YAXSFDPQDBBJIE  RCNFBSIYIECXUO  URXTMGXRHLTRJEL HCCFWUSWKDYYHU 
HFUVUBQWMXBKPJV : PKIWDUPBRGPK    BUNIRXTHXPPG    GBWWRCIHVMJ     KHMAQSGIHAYSKD  YFXVCJKNK       NRQHGDAQ        UXSVJBFWGKOJ   
UPJRUIMLFJPUU   : WGCAQLSSYA      NEGJCAMSJIP     QDLYLGQMGMJT    SYJANSPH        DRLRJWJIYRBCQC  KUGELCYBHSYBAG  BQLKOGMORYQRNY  IKEMAANSSEJC   
BCSXBQYRN       : GJBMVEKGJEBXTD  LDNHREOHAXRN    HSUQAAHFUVXKKK  PSOYRGSDYWW     DHUMWX         
POYIXWWVMG      : SCRPOQIGA       NTJEOJMONREIRY  ALYUSDEDCWPEX   UYAQCHIFSWNEPS  ILKNMTUPFTR    
JQCWWOMTJCUOVV  : VWWL            JEDRA           UXSVJBFWGKOJ   
OWLC            : MFDT            FYGBFT          IKEMAANSSEJC   
CRLMRIJPXSGJ    : QLKPE           UIIMAUDRFRR     ROKUYFVVBM     
KHIYVD          : UNHSTUJYPC      EBDIUTRRICLFS  
YAAWVTLT        : VFIGTRFJ        RHVDOXNAR       TGLVEYDCVQB     AUTETBLYO       CFRF            UPDHEUEYI       GPIH            NTVVOC         
NFJHSVCEGR      : FSYNIORIDTCGP   NLOBIF         
YXLK            : NJUQQDM         WVLB            RTQBCKMEUKE    
UTMRWXQWAPV     : DVRLLQRULDB     NUAJ            KBXEDN          SNFOFYMN        LSLYYQ          DGVXXEGAPIWNIRI
BPAQWJYQGBU     : SNRKGFTMKPVN    IDTWJKSTCMWKSEQ
UWNTKXH         : RTAQSSOUIKPLCP  SLHPOCUNFTBFWQB AJUVOQOETGDQPT 
RTAQSSOUIKPLCP  : NRJJYTLIYPYHOXN UWNTKXH         TEIYSXPGMJMAWW 
YYDPFGK         : BOMICH          DJKBPOCSULTS    TNRKNSDSOXOOL   CCKGWCFP       
CJHXWGFFABFRVAI : UUGLXXGPBNMNPR  TODQHGQPTEI     YHFB           
IUHV            : URXTMGXRHLTRJEL LELIK           PQRHSKSDBB     
YXVXEOGKYCMLKKK : TODQHGQPTEI     RCHLKNSCLWJE    OQQBMDXAHXPNAV  MDCKKAEG       
PPURWMNWU       : VWPQ            CKRTYPUE        VDTMQMSNLSDLCG 
HPODMNDLOH      : NQXGTCIMIX      ROTMUSJRHBRI    USVDBYJLMKW     VTGPISV         YGUCTPOIYS     
WSBYFMLQYGI     : PBGSADURF       OTMHAWY         HGFEXTJAYACGS   NDBD            QRBUFCNS       
CCNOQMKAVCPBRFF : AYQVYD          YHLUIRYTKCB     FSQWXOW         NRQHGDAQ       
TODQHGQPTEI     : CJHXWGFFABFRVAI YXVXEOGKYCMLKKK VLAJPSBBGD     
LQMNTA          : QJSWQSIQS       FJKH            XNKIKEA         NLALJTWRL       SUHOQ          
MPOMLTENLKUQ    : HRYBGJQCABAESW  UXYYWR          LMBGXBU         JVVBDXTPOMKG    GISIUXBSOP     
JTXRAQJVURTGI   : OAGURCEKQ       MCNFYXRNVBUN    TNRKNSDSOXOOL  
TEIYSXPGMJMAWW  : FJKH            RTAQSSOUIKPLCP 
NEGJCAMSJIP     : AYQVYD          UPJRUIMLFJPUU   DGVXXEGAPIWNIRI TWPOWJN         CJTIQCW         CVNRYDMUQYTGS   CSLPR          
CWMKSSTRMRKU    : DJDBCBMFYQI     RIOLSSCC        SHTBMJQGAGGHHMX
VHGTFDJ         : GSRLQUC         HPVGJ           SWFKMMLXTE      NEUHUOJNBAUTPB  PQUKQGORWMIM   
KTNKGIUQXXV     : AMFQFFNSENDGPN 
KGQEAK          : WAFMJORRTXVCNK  SYJANSPH        VJYQH           UMBYIAXFECXRVMM
UUNBRUINCLWN    : RPIKB           XGLUNXYYXHYQBUL BJHQCDH         AUTETBLYO       TROGGEQD        UUDUARWEFJ      DMQYIJGEVLIAKB 
QDLYLGQMGMJT    : KXVHRLSYTFPOK   UPJRUIMLFJPUU   IWSPBIBCWLX     BCIM            UYAQCHIFSWNEPS 
AAVLSSIGTCDC    : CJQC            DKIISQJOL       BBQIBXUIOPGGWHL MQJWDPLEPCYJ   
GQPVQIACI       : XLCBNVOPA       JFHJHNPAEBF     RNXJWXEXVXC     UURBJFQPPO      TNUEDLPCQF      BSIQNOBENK     
IYCRNM          : MFDT            PJSCGSA        
IOLGCEYNMTPRXIA : WSQATWDIHIWX    IXAGRYOBH       EPPGOFAJRQSH    EBDIUTRRICLFS   QKJUQ          
XWGGYIO         : QKYWVRJ         NQXOJPWGVS     
TPRNDGYMWMSA    : NEJFYKITNV      TGLVEYDCVQB     QMXUIITRR      
SNFOFYMN        : KWSO            UTMRWXQWAPV     MLAMCNUO        UABQPJD        
ELYKUXUJOQCI    : HXJBFG          LDOLGNTJ        SSKWEQHSXXTB    PFCF            OAGTELDATVESK  
FOFTMR          : HGFEXTJAYACGS   JCUWXT         
OKICRYHRLV      : BVDPRLBO        ENRRLEXT        DPFOUEIWUMBS    PTTCJT          CRAGDETJFVGTS   VQWHBLMFQRSRW  
PJSCGSA         : HOIBVSPUCEGKM   IXSFCEBNAIUKS   IYCRNM          DJKONLTIALBN    ORMQOHMXCITRSHC
HSUQAAHFUVXKKK  : NUAJ            BCSXBQYRN       SCWVLQWPPEYFGX 
MDTWWHUQX       : PSWSPQWROGQSJRR HIBHNXIEWX      CFRF            YGTKB          
JCNEEGL         : UXEQQAGQ        KCMCDMKFTVKQ    CFOV            EUBPGYBMRJAJP   PWACVHHRUMXXRU 
BEXBOD          : AYQVYD          EAPJH           FEVKUVPQUKJBLF 
KDKVOFKTBHQJEJ  : TBHELLBJ        DCEEHXIXWQ      IJOSXKIBBH      FVVXQVRAMGUF    OSFDKM         
LSLYYQ          : CMKQOQKHVMSNF   UTMRWXQWAPV     HQTOGVIC       
MQGTOJITISXUQ   : URTQVHQKSXW     SYMYXVAGW       CJTIQCW         YULF            HRXOOAYPOTW     PEXBDHTYSGTF   
BCKCLBLQMWCF    : UXYYWR          KIDVHKUGVDU     YDBKUWJM        IHHLJC          XXKCBJASLOXNC  
BGCGSSOM        : KWOBTIVPVLB     WVTY            NRPVHPOPDSAJ    KCMCDMKFTVKQ    LRNQDLUUCTFTQ   DTVROO          HQTOGVIC       
XUDI            : KGSYJ           WYLCCLYOBM      CROXWSG         SITOWEP         VLAJPSBBGD     
DEHTFLEJAHXQT   : AAPEKVHYPU      RPHLMIXESHCRQN  USXKVRSVHMUP    KUGELCYBHSYBAG  OQQBMDXAHXPNAV  VFFJXLNSHC      JAJERCSIJDK    
UYGV            : TWCTNKVSQMPTA   AJFHSKBJHREO    XRCINUDQXMX     TKBCFYDSDFECV   QJDQODICAWDPHJL IBTCPHBYU       SPMIIFWEF      
KEBFSNOSLUC     : FGXUHRRCMR      QQBSOUOEHPXGF   XBVCNXSLWCXMYN  CSLWHDVL       
XGLUNXYYXHYQBUL : WXVLIX          NAWTXTQHDUPN    UUNBRUINCLWN    VABEQSOEL       KAVMMAUXFTGS   
DJKONLTIALBN    : DRSPLMTUAUFFPFO PJSCGSA         RADKRUI         ORMQOHMXCITRSHC SPWEQIIV        AJUVOQOETGDQPT  RQPOAGFYABOHMC  CGUY           
DJKONLTIALBN    : UMBYIAXFECXRVMM
FPGNBBDBDDBKC   : UJCACKICCE      RTQBCKMEUKE     RNXJWXEXVXC    
LYFQFOCTEP      : FUJECDTXTR      FMOSMOSNW       QJCMTUKY        OFTAGQYNUT      TOJCGTJIDYD    
ORDQFLXUUMY     : UOYRHBJVUF      OMAYTOBLHHVRHUK YHRUQQT         TNUEDLPCQF     
PCBUELAAAYGQEWU : YAHEWQGRSCVVNAT UYAQCHIFSWNEPS  VLAJPSBBGD      REYOCQXGJOLS   
ELSSDVLJI       : KUOUSDN         GQSQSXW         BSIQNOBENK     
GDYFBO          : ABLUIWOCUK      QJCMTUKY        BQLKOGMORYQRNY 
FMOSMOSNW       : HIBHNXIEWX      LYFQFOCTEP      LFQYXVLD        HDNPRQMYHYG     TJVSCYJJAAMHQL 
UWHUBUPTYMI     : AWEPSW          KYYKNYKDUNGX   
WSQATWDIHIWX    : LDCBP           IOLGCEYNMTPRXIA HTDGVNDHTIRSU   FSMPMJHAY       TWPOWJN         PSKAVOHGIA      YHRUQQT        
JOWXOJ          : KXVHRLSYTFPOK   QDYVPTR         WHVCFEXFY       RADKRUI         QSOHYE         
LTPOOI          : LGJPVV         
PUSA            : FSGIXPTBINH     DRLRJWJIYRBCQC  QKKQKQWLHHIWPCH
NRTHQ           : YAXSFDPQDBBJIE  HDWNCOSBRPGXNB 
QAIPX           : VXXJXYBXSF      HXJBFG          EIIYSMVRVEOXPW  GIIBEINY        IFSDVQNUNOWAFKY HSSKMSKRHPQUS  
AMJABVUORMD     : LRTMEGHJBLQVN  
UOYRHBJVUF      : ORDQFLXUUMY     XNKIKEA         SXOIACDOWBMI    EMRGICKIYB      FUFFYGM        
LFVLNMJC        : QWNJTDTFVBXLYBO NFGNBWFQJFE     BXUTWDDMAC      JMDVJO         
YNQCJNRDC       : RMTPVQHJNOVTNRX AMHULC          IVIUSBH         OEAWUMPKFAMB   
MALNRV          : BXUTWDDMAC     
ETMJYXOVMEK     : DJDBCBMFYQI     ILTV            YECHDWO        
GBWWRCIHVMJ     : YNORGA          JUCKFEDU        NNLGD           HFUVUBQWMXBKPJV QDYVPTR         KQQJISI         HTCECFSBEVRMD  
BJHQCDH         : UUNBRUINCLWN    KUSNFPHH        CGUY           
YTRXSJVFP       : DPNM            WVTY            XNKIKEA         EBDIUTRRICLFS  
DYJDVDFEKBSUVT  : IPQWNMCA        MTDFRPPUSART    UUDUARWEFJ     
DKIISQJOL       : TGLVEYDCVQB     AAVLSSIGTCDC    OWTRXYXNGQ      FNCHTBGEJQCERN  TROHIU         
JWEQMNUNWAJ     : GJGKKCCFTV      WRFNBMUKWLC     ALYUSDEDCWPEX   PKPUIHP         STPF           
FQNIJKGEPKQAUL  : LSNFMJGVVHIDK   NEJFYKITNV      QSKX            IAEQBAVPRU      NQNY            HNKST           IXQM           
FBHPKE          : NEJFYKITNV      GJBMVEKGJEBXTD 
CSJYJ           : NQXGTCIMIX      XHLJGGFCUUNFT   VUEMIVGIVH      PBVSITJN        GITVL          
YSMGJ           : FUJECDTXTR      UIJCUJXDN       LFQYXVLD       
QTLWADJQFFDYMGI : IPUAOG          TTKKXNTVS       PQCCKCI        
QMXUIITRR       : TPRNDGYMWMSA    UHVMPGBEKLA     ROTNLKEEX       SPWEQIIV        PGSKN           UKKDUNCDNWUB   
MEDYETURRUWDN   : VDCIDQK         LVWVPSWGODRBXM 
ISCWYNYS        : YAXSFDPQDBBJIE  NUAJ            PBVSITJN        MPEJEIMFPABYSC  YHRUQQT         USOBOWUJORBT    GDEVQSARSL     
XNKIKEA         : LQMNTA          UOYRHBJVUF      YTRXSJVFP      
RELS            : NOTDDNWT       
HNFBICFXFNRKNQ  : KCJWK           DYSULULO        FOSIXOIBOQOYJIH EVKLQFM         PKRKMADLPB      AMFQFFNSENDGPN 
MLAMCNUO        : MPAQGANTWHT     AWCNJ           SNFOFYMN        LWDWGDJOLEBO    XRAPEHVYWDRQ    JVALAYSPIVA    
WVLB            : RPIKB           YXLK            WIAGCWJW        XOFL            JPLFANV        
EORRTS          : PNPLLXNSE       SHTBMJQGAGGHHMX MOFHDAJPH       NBWATVLDFRYQDA  UXSVJBFWGKOJ    KMXNHJEUA       HSSKMSKRHPQUS  
VABEQSOEL       : RMTPVQHJNOVTNRX LELIK           NUAJ            XGLUNXYYXHYQBUL
SXOIACDOWBMI    : RMJLRPBPK       AWCNJ           UOYRHBJVUF      UREYMTMQLXAU    FSSBUYDATHGPY   LDAHJFXCAI     
WPSQHOLKNMNRDII : PTTCJT          YANXOI         
TWCTNKVSQMPTA   : UYGV            LDOLGNTJ        RXBUM          
XYPTRXKDKXRA    : PWPRXAY         CKFBVSBVFKCIDC  GWYJGMLCYSH     BEYMTEH         CYWSVGSSTOKNKN 
WIAGCWJW        : CPLBTKKLBMXF    LMEPBLYMRPULUY  WVLB            CUKAHBHLHRYHG   LOIISDYHLAAE   
VUEMIVGIVH      : BNLBR           GYVCVVA         CSJYJ           EUBPGYBMRJAJP   QQBSOUOEHPXGF  
MDBMNGYOYYEXHFF : WMDLBK          GDEVQSARSL     
EOKRM           : DTBEWLRTPKXBKQ  XMTSDH          OYDX           
XAOTIYSPKHULTJT : SCRPOQIGA       BBQIBXUIOPGGWHL FQGBEXLTSPN    
AUTETBLYO       : YAAWVTLT        UUNBRUINCLWN    NEUHUOJNBAUTPB  YBWPMROWC      
PAKCILEYHNXAF   : OFLRSGJPPSXQY   HBVDMPXM        WCMWGTECDN      DJTXBWHHPYYEGP 
HBVDMPXM        : EADNCULADLW     BPARBSNDUKXGG   KUOUSDN         PAKCILEYHNXAF   UABQPJD         DPFOUEIWUMBS    BXBASBO         QPJKYTMHDETX   
RSHUH           : AAPEKVHYPU      HSCUQANNH       FSYNIORIDTCGP   UXYYWR         
KAVMMAUXFTGS    : GYVCVVA         EADNCULADLW     XGLUNXYYXHYQBUL
IAEQBAVPRU      : NPVVFJ          FQNIJKGEPKQAUL 
FMXMIHS         : XJKGGDJNP       IXXDJXDUGF      NNLGD           BUNIRXTHXPPG    UXEQQAGQ       
JQJVTG          : UJCACKICCE      ESISYTYLE       JVHMNGXJMAM    
YAFTVPTAIXCF    : CKFBVSBVFKCIDC  TTWDWROW        RXBUM           IIJX            OTXWOJFRLLCCB  
TAUCOSOWCKTLD   : YKHIFHKUNVSVW   TBRUNBOHF       FVCPX           NRQHGDAQ        UCFOOHXG        MQJWDPLEPCYJ   
HWJGX           : UKVDPXE         PNPLLXNSE       KQHSMFDVOOF     GDEVQSARSL     
NTJEOJMONREIRY  : SNWRCJG         POYIXWWVMG      UNHSTUJYPC     
HTDGVNDHTIRSU   : XCQUWDMQUY      NRJJYTLIYPYHOXN LPNBH           WSQATWDIHIWX    QWTHFRSSRGY     DDULGGMBBQHFUF  QSOHYE          VPSDYTFUCKR    
RIOLSSCC        : BUNIRXTHXPPG    CWMKSSTRMRKU    ACMJEKYY        IKETLTKQOFEL    WKBDKU         
SQXXBR          : LSNFMJGVVHIDK   RYOGAQY         EIFF            UJCACKICCE      NCHFYOXGVSCYT  
PBVSITJN        : UIJCUJXDN       CSJYJ           ISCWYNYS        EBDIUTRRICLFS  
FVVXQVRAMGUF    : SSUKSOTSSVL     KDKVOFKTBHQJEJ  XLCBNVOPA       XJPC            MYAHQHW        
YLERLEUDD       : TROGGEQD        VWIUDEP        
HBEPV           : GCFETPCGLCTQ    PFWCWFEUS       WKBDKU         
DAUBVSU         : GPRTKXCYNRBMLA  LGJPVV          NEUHUOJNBAUTPB  QDYVPTR         YHLUIRYTKCB     WJAWXFEUAUSNH  
NUJTROEQCIJPMEV : ILKNMTUPFTR     CRSQECGUFBXNYWS
PDTVSPN         : PDKQEETS       
PIYNDTKQQTK     : KEANQGJNVNSKYCD
IPCN            : KGCFTCMWLAEG    PSOQIPGA       
LDNPY           : KCOCHRERIMN     UUGLXXGPBNMNPR  AFTHD          
HCCFWUSWKDYYHU  : FETFFWEW        XIFQAXBLBVMFX   ENLV            FOSIXOIBOQOYJIH
XOFL            : KCJWK           NJUQQDM         WVLB            CVLTIYWMM       UPPMQFI        
NDBD            : TBRUNBOHF       WSBYFMLQYGI     KHMAQSGIHAYSKD  FKRRRMPBCT      DQVI           
OHSFIBONGUMBPKL : PFWCWFEUS       XLCBNVOPA      
LMBGXBU         : QNEKHGYYLMQHKXS MPOMLTENLKUQ    RUABWTNUNJBDJR 
OWTRXYXNGQ      : FSJUG           NNLGD           QRQJHOCHGW      DKIISQJOL       GVXKGGLHWGXC   
RULFBGREYERSPHV : HXJBFG          KBHTFTS         JVVBDXTPOMKG    FWJLUJGSILPFY   QPJKYTMHDETX   
FWTLMQHGRGEH    : MCNFYXRNVBUN    GBGYUOQNRVYU    GPATTYG         IRANTIKF       
XCHSNOVWI       : IIBV           
XNRQDYMCHLYU    : DCEEHXIXWQ      QQRJWUBDQIH     SSKWEQHSXXTB   
RCHLKNSCLWJE    : CPLBTKKLBMXF    YECHDWO         YXVXEOGKYCMLKKK
ACMJEKYY        : RIOLSSCC        QWNJTDTFVBXLYBO
EAPJH           : BEXBOD          FOSIXOIBOQOYJIH QRBUFCNS        CSLWHDVL       
IEGCINO         : MRJNHCPTPRCUBOT
DHVPHIV         : GFYXWYXWFCNW    QLKPE           WYUQTFQHEUTBBQ  DTVROO         
KBHTFTS         : IXSFCEBNAIUKS   XUUHJEHKKCDABS  RULFBGREYERSPHV PCWE           
WAFMJORRTXVCNK  : KGQEAK          LLASIYQNT       OPYQHCMKVSE    
RUWJEHFYRIIOOC  : MFDT            TMHFYBCWSU     
SYJANSPH        : WQUERBXI        UPJRUIMLFJPUU   KGQEAK          LRNQDLUUCTFTQ  
LGJPVV          : YAXSFDPQDBBJIE  HVKJNATIG       LTPOOI          DAUBVSU         FPFKG           JJUGJYBX        QKJUQ          
NQNY            : FQNIJKGEPKQAUL 
UHVMPGBEKLA     : QMXUIITRR      
UABQPJD         : DRSPLMTUAUFFPFO SHOHCO          SNFOFYMN        HBVDMPXM        WGVXSPQXWSP     DTVROO         
ROTNLKEEX       : QMXUIITRR       XKEHOJBRYAFBGL  SRUONLI        
CUKAHBHLHRYHG   : JQTVTPOUPMJV    WIAGCWJW        BJMTFTCH       
KHMAQSGIHAYSKD  : FDEXACGMDV      MPAQGANTWHT     NCGYQKQQA       HFUVUBQWMXBKPJV NDBD            XDPPYJRUNR     
KGCFTCMWLAEG    : XHLJGGFCUUNFT   BUNIRXTHXPPG    HXGVVNBSV       IPCN           
OMAYTOBLHHVRHUK : GYVCVVA         DPNM            IWTOJR          ORDQFLXUUMY     YFXVCJKNK       PDKQEETS        DMQYIJGEVLIAKB 
XKEHOJBRYAFBGL  : ROTNLKEEX       PFWCWFEUS       TNRKNSDSOXOOL  
UXFVST          : TSHWNMIY        WKWDVLTWOVVOETK HNKST           RBVTBOXIWDET    YULF           
GCFETPCGLCTQ    : HBEPV           WPAYQONVVSY     IBXJO          
KCMCDMKFTVKQ    : KRIJUYHJYBNXA   JCNEEGL         BGCGSSOM       
PNPLLXNSE       : EORRTS          HWJGX           EMRGICKIYB      EXNJAESOIHAXDN  LEWMR           REYOCQXGJOLS    XYDO           
KGSYJ           : RBLJE           XUDI            WYLCCLYOBM      ALYUSDEDCWPEX   STPF           
RUYTIEXW        : IIOFCDFNAFRYCPD
FSMPMJHAY       : MFDT            WSQATWDIHIWX   
NYJIEUVKPU      : UPDHEUEYI       FWJLUJGSILPFY  
EMRGICKIYB      : UOYRHBJVUF      PNPLLXNSE       EXNJAESOIHAXDN  TOJCGTJIDYD     ROKUYFVVBM     
UNFHX           : LWDWGDJOLEBO    LFQYXVLD        IHHLJC         
JYKYYTHFQFRJAON : DVRLLQRULDB     QJSWQSIQS       QRQJHOCHGW      NRPVHPOPDSAJ   
GVXKGGLHWGXC    : OWTRXYXNGQ      JCUWXT          SRUONLI        
VTBUEAVAKBQPTA  : YKHIFHKUNVSVW   OFEGPEYOKNHTCQY PKDC            IIBV           
KQHSMFDVOOF     : RMJLRPBPK       HWJGX           PCWE            GHUQIEECNDCT   
XDPPYJRUNR      : MPAQGANTWHT     KHMAQSGIHAYSKD  LDOLGNTJ        UCKEXLRHEA     
NEUHUOJNBAUTPB  : NMRAIIQVOFPY    VHGTFDJ         AUTETBLYO       DAUBVSU        
LRNQDLUUCTFTQ   : BGCGSSOM        SYJANSPH        GPATTYG         KITOIJTXEFFAI  
NKJSFSNVCBW     : BEIFA           KWOBTIVPVLB     WNXXPTCDAUFYRJ  ALQMWIXPHJY     RWNNVBP         BSIQNOBENK     
VQUYP           : AFTHD          
QDYVPTR         : PCLJPHLR        JOWXOJ          GBWWRCIHVMJ     DAUBVSU         BSIQNOBENK     
QWNJTDTFVBXLYBO : TBRUNBOHF       KCOCHRERIMN     LFVLNMJC        ACMJEKYY        PFWCWFEUS      
GNOD            : OPQKIGDTH       JIFXQALSDIN    
GJGKKCCFTV      : JWEQMNUNWAJ     OFTAGQYNUT      INFDRCCF       
SLHPOCUNFTBFWQB : IIOUGUDLSJVFHH  UWNTKXH         AJFHSKBJHREO    HWSNEDKIBT      VLAJPSBBGD     
ESISYTYLE       : JQJVTG         
NLALJTWRL       : IRNQUYUMTKDUY   LQMNTA          QCWWEHGXVHG     CJTIQCW        
VGEBCFGYVK      : RPHLMIXESHCRQN  LOIISDYHLAAE    MBDYFNG        
CFOV            : JCNEEGL         EMKTM           YAEWQXQXSB      QQBSOUOEHPXGF  
IWSPBIBCWLX     : QDLYLGQMGMJT    EMKTM           UIIMAUDRFRR     FUFFYGM         JAATGEWVKB     
DJKBPOCSULTS    : YYDPFGK         IPUAOG         
BVDPRLBO        : IUWELYNHLMW     OKICRYHRLV     
QSPTUMF         : BHDICHXGLDXIIIA OHOAQPNETHTUBIE BEYMTEH         UCFOOHXG       
IKETLTKQOFEL    : RIOLSSCC        MPEJEIMFPABYSC  OPHJYVLYD      
CMWHEQUFHA      : QCJICCXSG       LWDWGDJOLEBO    GAUPN           UJYWKTOR        XRSDJBCLQEPVS   CGUY           
ARSUEAPOLVIYSV  : CMKQOQKHVMSNF   ENRRLEXT        EPPGOFAJRQSH    MRVHMNWVDBUG    OPHJYVLYD      
HDVSEA          : GPATTYG        
BJMTFTCH        : CUKAHBHLHRYHG  
CYNAFNRTB       : GAUPN          
FBHBSQER        : KFJYRHSKXPCAAK 
LRTMEGHJBLQVN   : AMJABVUORMD     DTVROO          JIQMJHUKHSUWIDF PFCF            PKDC           
LPWYISBYX       : NAWTXTQHDUPN    TNUEDLPCQF      PSOLCCDWXTMIEH 
GBYWIQJTLEIPMPB : SHOHCO          NBNRXDCRDW      YULF           
DRLRJWJIYRBCQC  : LDCBP           UPJRUIMLFJPUU   PUSA            QWDL           
YDHWNBIHOO      : JEDRA           KOATOP          MIAAVXE        
GCIHTMBGGMFPU   : DWJBSCTE        HWPEQ           CPHMCNJNTMRBFXP
KXIDAQDGBCVCK   : DVRLLQRULDB     ABLUIWOCUK      SEHOWYMHIPSPJ   GHUQIEECNDCT   
QCWWEHGXVHG     : CORDICPTDFU     ANARBUSLDWRXTH  TSHFKJ          SWFKMMLXTE      NLALJTWRL       CPHMCNJNTMRBFXP NMLOLOJHAOO    
TOUOUFOGK       : BQWHLMXHE       UJCACKICCE      UCFOOHXG        PEXBDHTYSGTF   
WNXXPTCDAUFYRJ  : RAXBVMXAQPMAEGS FSGIXPTBINH     YAHEWQGRSCVVNAT NKJSFSNVCBW     GAUPN           KNNSEKQYHAAOYH 
AJFHSKBJHREO    : UYGV            SLHPOCUNFTBFWQB IIOFCDFNAFRYCPD CSLWHDVL       
KYYKNYKDUNGX    : RDECRENYMSJYPWU UWHUBUPTYMI     WJAWXFEUAUSNH  
LWDWGDJOLEBO    : PPAMCFNULG      VWWL            MLAMCNUO        UNFHX           CMWHEQUFHA      TWOEEOIJSX     
IHTWQHVRTLQERNR : UHDPXJVEABQQD   OFTAGQYNUT      MBDYFNG        
LDOLGNTJ        : QSKX            ELYKUXUJOQCI    TWCTNKVSQMPTA   XDPPYJRUNR     
KWDLMST         : HQIBJBUUXSV     OQYDCY          MYAHQHW        
PSOYRGSDYWW     : OFEGPEYOKNHTCQY NVJKX           BCSXBQYRN       XBVCNXSLWCXMYN 
RXBUM           : TWCTNKVSQMPTA   YAFTVPTAIXCF    OPHJYVLYD      
BCIM            : JFHMOSDMHI      QDLYLGQMGMJT    SQRXMHQBAF      VLAJPSBBGD     
TMHFYBCWSU      : CVLHXFR         BQHTB           RUWJEHFYRIIOOC  SSRGUVMRUGE     UPPMQFI        
ROTMUSJRHBRI    : HPODMNDLOH      PVVFKOVMDYK    
GWYJGMLCYSH     : FRTOPAMMKU      UUGLXXGPBNMNPR  XYPTRXKDKXRA   
VJYQH           : JQTVTPOUPMJV    TSHWNMIY        FMLNVVM         KGQEAK          JHCXFPEEAQRFB   CROXWSG         RWNNVBP        
IVIUSBH         : CPLBTKKLBMXF    FSYNIORIDTCGP   YNQCJNRDC       JCUWXT          PCWE            CCKGWCFP       
KIDVHKUGVDU     : MMWCH           SSUKSOTSSVL     BCKCLBLQMWCF   
FVCPX           : MHAAGTSNWNCI    QVNMMDQYKYXMNM  TAUCOSOWCKTLD   HCNWKEGXRIYD    MWIHIHQJBUBIXAD
BYRILBHTXA      : IIOFCDFNAFRYCPD BQLKOGMORYQRNY  UCFOOHXG       
HNKST           : FQNIJKGEPKQAUL  UXFVST          SHTBMJQGAGGHHMX MQJWDPLEPCYJ   
AEDIAHGJMELCDME : WKWDVLTWOVVOETK WPAYQONVVSY     VHLNPHNJYGN    
FOSIXOIBOQOYJIH : HNFBICFXFNRKNQ  HCCFWUSWKDYYHU  EAPJH           OPYQHCMKVSE     EUBPGYBMRJAJP  
OKTQRCCHH       : ANARBUSLDWRXTH  VDCIDQK         UUGLXXGPBNMNPR  WGVXSPQXWSP     PCWE            HJACO          
LMDRQKJJSHB     : CFRF            PWSLTEJRTQK     GDEVQSARSL     
IPUAOG          : NQXOJPWGVS      QTLWADJQFFDYMGI DJKBPOCSULTS   
XRCINUDQXMX     : NRJJYTLIYPYHOXN UYGV            PNQN           
XMTSDH          : VGXWKHEDVASFDPE EOKRM           PQUKQGORWMIM    JAATGEWVKB     
PCJSGUIBUYJHWB  : XIFQAXBLBVMFX   ODAFKAVHEPICAFP QSGOWVKMJY     
FPFKG           : FJHMOY          RPHLMIXESHCRQN  QQRJWUBDQIH     WNKMKX          LGJPVV          KOATOP          HCGASFFLON     
WGVXSPQXWSP     : UABQPJD         OKTQRCCHH       IHHLJC         
EIIYSMVRVEOXPW  : GVTNXV          QAIPX           BXUTWDDMAC      NLOBIF         
WHVCFEXFY       : TNYFOXNEBD      JOWXOJ          NMLOLOJHAOO    
VWPQ            : LELIK           PPURWMNWU       TROGGEQD        GCXNJFLFURIF   
RUABWTNUNJBDJR  : LMBGXBU        
YOHWTOBTVA      : RPHLMIXESHCRQN  TGLVEYDCVQB     LWLPOKCP        WKBDKU         
RADKRUI         : DJKONLTIALBN    JOWXOJ          GHUQIEECNDCT    IKEMAANSSEJC   
VFNLACXCFHVHHMQ : BQWHLMXHE       BQHTB           USABSPTLNTBS    IWTOJR          ENRRLEXT        FVWJXXNFSPI     APBUEW         
GIIBEINY        : HOWEJ           QAIPX           JJUGJYBX        JFOPGDVASWVEUWN
QJCMTUKY        : LYFQFOCTEP      GDYFBO          QWTHFRSSRGY    
WCMWGTECDN      : CJQC            PAKCILEYHNXAF   INFDRCCF       
USVDBYJLMKW     : XGHMULABMAU     UXEQQAGQ        HPODMNDLOH      IBPM           
WYUQTFQHEUTBBQ  : JJDXNJTOWC      DHVPHIV         EMKTM           GDEVQSARSL      EFIGDGIEIV     
DTVROO          : BGCGSSOM        DHVPHIV         UABQPJD         LRTMEGHJBLQVN   IIOFCDFNAFRYCPD
TROGGEQD        : AFGVGCOXFRFA    KWOBTIVPVLB     UUNBRUINCLWN    YLERLEUDD       VWPQ           
NCHFYOXGVSCYT   : WEYDTEPY        WPQGHIWRKAFYR   SQXXBR          OOXYESPOHAKURAP
HWPEQ           : WXVLIX          KJHRIMTQPNDMQ   GCIHTMBGGMFPU  
UHDPXJVEABQQD   : LPNBH           IHTWQHVRTLQERNR JKUKIM          SRUONLI        
VEPVMLORMIMUHCB : MMWCH           UTJU            EXNJAESOIHAXDN 
JVHMNGXJMAM     : CEWABIH         JEDRA           JQJVTG          OLSEUVYOXHDYD   QCGUY          
QSGOWVKMJY      : BNLBR           NEJFYKITNV      NPVVFJ          PCJSGUIBUYJHWB 
WHQROTSP        : XUWECXCAAAY     JUCKFEDU        EIFF            KGQTVO          UYAQCHIFSWNEPS 
QWTHFRSSRGY     : PBGSADURF       HTDGVNDHTIRSU   QJCMTUKY        PCWE            CROXWSG         WMDLBK          VHLNPHNJYGN    
YFXVCJKNK       : AFGVGCOXFRFA    HFUVUBQWMXBKPJV OMAYTOBLHHVRHUK
KUGELCYBHSYBAG  : CWHVEBBVQPOCVOO UPJRUIMLFJPUU   DEHTFLEJAHXQT   EVKLQFM         QKKQKQWLHHIWPCH
SYMYXVAGW       : MQGTOJITISXUQ   UIBYQLEJ        INUDPIK         STPF            EUBPGYBMRJAJP  
IIJX            : JHOMBYROHCBBPH  YAFTVPTAIXCF    CKRTYPUE        PSPNDWGBVQEB    AFTHD          
YJPHPCLPDS      : BNLBR           SCRPOQIGA       NFGNBWFQJFE    
EVKLQFM         : HNFBICFXFNRKNQ  KUGELCYBHSYBAG 
FNCHTBGEJQCERN  : DKIISQJOL      
BEYMTEH         : WKWDVLTWOVVOETK XYPTRXKDKXRA    QSPTUMF        
LFQYXVLD        : FMOSMOSNW       YSMGJ           UNFHX           CFRF            UIBYQLEJ       
YHLUIRYTKCB     : CCNOQMKAVCPBRFF DAUBVSU        
PXFTYRPDBVQ     : FSJUG          
MPEJEIMFPABYSC  : ISCWYNYS        IKETLTKQOFEL    OPYQHCMKVSE     SSRGUVMRUGE     AJAVUCBALBLRS  
FEVKUVPQUKJBLF  : GBGYUOQNRVYU    BEXBOD          NFGNBWFQJFE     SRUONLI         TVPTSEDA        OJRM           
SSKWEQHSXXTB    : GFYXWYXWFCNW    XUUHJEHKKCDABS  ELYKUXUJOQCI    XNRQDYMCHLYU    RETKFAIXTV      JMDVJO         
METT            : WSPNMG          SITOWEP        
SEHOWYMHIPSPJ   : OTMHAWY         KXIDAQDGBCVCK   QKKQKQWLHHIWPCH
IVNOMUINS       : CPHMCNJNTMRBFXP GITVL          
QTQUQKIJRPA     : QQRJWUBDQIH     LIJCDYRPHUET    PNQN            SQRXMHQBAF     
OOXYESPOHAKURAP : NCHFYOXGVSCYT   PLEGHWEXHMH     JKUKIM          RPYVJWBGQXAD    MVKUJEQSRHPNK  
PLEGHWEXHMH     : TBRUNBOHF       GSRLQUC         DQTEAIEKO       OOXYESPOHAKURAP TEBQK          
CKRTYPUE        : PPURWMNWU       IIJX            HDWNCOSBRPGXNB 
KUSNFPHH        : TBRUNBOHF       DTFSIYYLGCLQWQG BJHQCDH        
HWSNEDKIBT      : YNORGA          SLHPOCUNFTBFWQB MHOXE          
LVWVPSWGODRBXM  : RHVDOXNAR       GSRLQUC         MEDYETURRUWDN   OFTAGQYNUT     
GCXNJFLFURIF    : HXJBFG          NAWTXTQHDUPN    VWPQ            UCFOOHXG       
JCUWXT          : EIFF            KCOCHRERIMN     FOFTMR          GVXKGGLHWGXC    IVIUSBH         WSPNMG          JFOPGDVASWVEUWN
PNSVE           : AYQVYD          ODAFKAVHEPICAFP MFRGVBOC       
PFWCWFEUS       : HBEPV           OHSFIBONGUMBPKL XKEHOJBRYAFBGL  QWNJTDTFVBXLYBO SPWEQIIV       
DGVXXEGAPIWNIRI : GQUHAARCJPKUU   FETFFWEW        PLCUAGQQXJHGMDP YNORGA          UTMRWXQWAPV     NEGJCAMSJIP     SQRXMHQBAF     
HDWNCOSBRPGXNB  : CGLXDUGI        VFIGTRFJ        QKYWVRJ         NRTHQ           CKRTYPUE        GHUQIEECNDCT    KITOIJTXEFFAI  
QKKQKQWLHHIWPCH : GYVCVVA         GSRLQUC         PUSA            KUGELCYBHSYBAG  SEHOWYMHIPSPJ   VFFJXLNSHC     
LLNYNCSQVKWU    : OFEGPEYOKNHTCQY
ALQMWIXPHJY     : NKJSFSNVCBW     VHNRUTN         TWOEEOIJSX     
TVHWEXIP        : DQTEAIEKO      
IFSDVQNUNOWAFKY : KXVHRLSYTFPOK   QAIPX           OFUQJCTOMQ      FTMNNMECM      
KOATOP          : YDHWNBIHOO      FPFKG          
MYMQAXI         : LHAHBYVMUOC     PTTCJT          WYLCCLYOBM      HCGASFFLON      TMDMNIWDTRW    
GPILNABKPPIPXU  : WSWWKWRTT       RYOGAQY         SPWEQIIV       
NFGNBWFQJFE     : HQIBJBUUXSV     LFVLNMJC        YJPHPCLPDS      FEVKUVPQUKJBLF 
HCNWKEGXRIYD    : FVCPX           YGTKB          
PNQN            : JQTVTPOUPMJV    XRCINUDQXMX     QTQUQKIJRPA     DHUMWX          XRSDJBCLQEPVS  
HDNPRQMYHYG     : XUWECXCAAAY     FMOSMOSNW       KRVWRRHBGJXL    OTXWOJFRLLCCB   JVALAYSPIVA    
ENRRLEXT        : OKICRYHRLV      ARSUEAPOLVIYSV  VFNLACXCFHVHHMQ
QCCVCT          : VXXJXYBXSF     
SHTBMJQGAGGHHMX : RCNFBSIYIECXUO  CWMKSSTRMRKU    EORRTS          HNKST          
DPFOUEIWUMBS    : OKICRYHRLV      HBVDMPXM       
UCKEXLRHEA      : WSWWKWRTT       OFEGPEYOKNHTCQY XDPPYJRUNR      VFFJXLNSHC      FONOJTYKUYC     FQGBEXLTSPN    
KGQTVO          : LDNHREOHAXRN    WHQROTSP        JPLFANV         TNUEDLPCQF      OYDX           
YFLPCPA         : WVTY            UVQG           
MOFHDAJPH       : XGHMULABMAU     EORRTS          CSLPR          
BBQIBXUIOPGGWHL : EYYGSPNURRNYKBK JRTEQVKBON      IRNQUYUMTKDUY   AAVLSSIGTCDC    XAOTIYSPKHULTJT YHRUQQT         QNSWNESM       
WPAYQONVVSY     : GCFETPCGLCTQ    AEDIAHGJMELCDME RTQBCKMEUKE     HKCHHOMSSXGCVG 
JIQMJHUKHSUWIDF : KWLCIQSQJW      LRTMEGHJBLQVN   BPSPSTBWCLSYY  
KQQJISI         : GBGYUOQNRVYU    GBWWRCIHVMJ     WRFNBMUKWLC     TNUEDLPCQF     
IXAGRYOBH       : IOLGCEYNMTPRXIA DAFQNRACP       PDKQEETS        HGSDWEXFEP     
PSPNDWGBVQEB    : NRJJYTLIYPYHOXN IIJX            TCPQX          
RTQBCKMEUKE     : OHOAQPNETHTUBIE YXLK            FPGNBBDBDDBKC   WPAYQONVVSY    
CFRF            : YAAWVTLT        MDTWWHUQX       LMDRQKJJSHB     LFQYXVLD       
XVHPLMMR        : FEMF            XQUE            XNGTQL         
JKUKIM          : QCJICCXSG       FYGBFT          TFSEOEJIGNIR    IGPEIRYBNLO     UHDPXJVEABQQD   OOXYESPOHAKURAP GPIH            TWOEEOIJSX     
CPHMCNJNTMRBFXP : PCLJPHLR        GCIHTMBGGMFPU   QCWWEHGXVHG     IVNOMUINS       TCPQX          
VYUJMHDCQN      : FDEXACGMDV      FVWJXXNFSPI    
EXNJAESOIHAXDN  : NAWTXTQHDUPN    PNPLLXNSE       EMRGICKIYB      VEPVMLORMIMUHCB OQQBMDXAHXPNAV  MRVHMNWVDBUG   
FSQWXOW         : IUIFXHDVSB      CCNOQMKAVCPBRFF UIIMAUDRFRR    
XLCBNVOPA       : JYGPT           PNKNJXPDRUPCEWK GQPVQIACI       FVVXQVRAMGUF    OHSFIBONGUMBPKL
DLPJE           : OVVCKEBRYKTREH  YNORGA         
UNHSTUJYPC      : XJKGGDJNP       JVXMLRKOTDSSEWI KHIYVD          NTJEOJMONREIRY  BXUTWDDMAC      WMDLBK          IKEMAANSSEJC   
PQUKQGORWMIM    : RAXBVMXAQPMAEGS CJLYBCGUUQRLF   VHGTFDJ         XMTSDH          FONOJTYKUYC     TTKKXNTVS      
XRAPEHVYWDRQ    : OXCHH           MRJNHCPTPRCUBOT MLAMCNUO       
EPPGOFAJRQSH    : RDECRENYMSJYPWU IOLGCEYNMTPRXIA ARSUEAPOLVIYSV 
PTTCJT          : OKICRYHRLV      WPSQHOLKNMNRDII MYMQAXI        
LLASIYQNT       : USXKVRSVHMUP    WAFMJORRTXVCNK  CROXWSG        
QACGGQOI        : DDULGGMBBQHFUF  VHNRUTN        
GAUPN           : CMWHEQUFHA      CYNAFNRTB       WNXXPTCDAUFYRJ  APBUEW          XRSDJBCLQEPVS  
MHOXE           : BQWHLMXHE       HWSNEDKIBT      SRUONLI         GDEVQSARSL     
JPLFANV         : WVLB            KGQTVO          QQBSOUOEHPXGF  
JFHJHNPAEBF     : EOQKXDWFUB      PNKNJXPDRUPCEWK GQPVQIACI       HCGASFFLON     
DAFQNRACP       : SSUKSOTSSVL     FCSPWQVLRJUFW   IXAGRYOBH      
PCWE            : KBHTFTS         KQHSMFDVOOF     IVIUSBH         OKTQRCCHH       QWTHFRSSRGY    
WRFNBMUKWLC     : HXGVVNBSV       JWEQMNUNWAJ     KQQJISI         OAGTELDATVESK   INFDRCCF       
PFCF            : ELYKUXUJOQCI    LRTMEGHJBLQVN   SITOWEP        
FLBUFCYVI       : XHLJGGFCUUNFT  
AFTHD           : LDNPY           VQUYP           IIJX            PKDC            NRQHGDAQ       
OQQBMDXAHXPNAV  : XCTYFXIXNBJAQ   YXVXEOGKYCMLKKK DEHTFLEJAHXQT   EXNJAESOIHAXDN 
HJACO           : OKTQRCCHH       RPYVJWBGQXAD   
EMKTM           : CFOV            IWSPBIBCWLX     WYUQTFQHEUTBBQ  RDLJTKUHNMH    
PVVFKOVMDYK     : ROTMUSJRHBRI    NBWATVLDFRYQDA 
GITVL           : GFYXWYXWFCNW    DJDBCBMFYQI     LELIK           CSJYJ           IVNOMUINS       CMYYCOGFWJA    
UUDUARWEFJ      : JRTEQVKBON      WEYDTEPY        TFSEOEJIGNIR    AMHULC          UUNBRUINCLWN    DYJDVDFEKBSUVT  LXHGOLPGKV      TNRKNSDSOXOOL  
TCPQX           : RAXBVMXAQPMAEGS PSPNDWGBVQEB    CPHMCNJNTMRBFXP
BPSPSTBWCLSYY   : OTMHAWY         JIQMJHUKHSUWIDF OEAWUMPKFAMB    SACIPLSRLEG    
TWPOWJN         : KRIJUYHJYBNXA   HNQIUYAMCYEMATT NEGJCAMSJIP     WSQATWDIHIWX    YGTKB           PWSLTEJRTQK    
QWDL            : WVTY            DRLRJWJIYRBCQC  OEAWUMPKFAMB    JAJERCSIJDK    
UCAR            : LPNBH           HSSKMSKRHPQUS  
PMVLGYKKMFJ     : CRKFNGIKRNEQVB  OPQKIGDTH      
RDLJTKUHNMH     : LELIK           EMKTM          
XJPC            : GFYXWYXWFCNW    FVVXQVRAMGUF    FTTANFOPWOV    
JHCXFPEEAQRFB   : HXGVVNBSV       VJYQH          
YGTKB           : XUUHJEHKKCDABS  MDTWWHUQX       HCNWKEGXRIYD    TWPOWJN        
FKRRRMPBCT      : PCLJPHLR        NDBD            KMXNHJEUA      
NCRLHHROJIIOJ   : BOMICH          LDNHREOHAXRN   
PSKAVOHGIA      : RDECRENYMSJYPWU FEMF            WSQATWDIHIWX    BQLKOGMORYQRNY 
UREYMTMQLXAU    : LMEPBLYMRPULUY  SXOIACDOWBMI    IRANTIKF       
OEAWUMPKFAMB    : YNQCJNRDC       BPSPSTBWCLSYY   QWDL            CVLTIYWMM       PQRHSKSDBB     
UJYWKTOR        : RAXBVMXAQPMAEGS PCLJPHLR        CMWHEQUFHA      XCMVTBPJ        OURKEJFSWCTC   
DLHTAH          : OTMHAWY         EFIGDGIEIV     
WYLCCLYOBM      : TSHFKJ          XUDI            KGSYJ           MYMQAXI         UKKDUNCDNWUB   
CYWSVGSSTOKNKN  : LELIK           XYPTRXKDKXRA   
TKBCFYDSDFECV   : UYGV            NCLDNE          WKBDKU         
ORMQOHMXCITRSHC : PHABNORKXCI     PJSCGSA         DJKONLTIALBN   
IXQM            : FQNIJKGEPKQAUL  DDULGGMBBQHFUF  LDAHJFXCAI      YBTOJTOHRUOJI   QKJUQ          
XNGTQL          : EADNCULADLW     OXCHH           XVHPLMMR        OLSEUVYOXHDYD   YANXOI         
UIIMAUDRFRR     : XUWECXCAAAY     CRLMRIJPXSGJ    IWSPBIBCWLX     FSQWXOW         TVPTSEDA        PRROTXEKKBU    
ALYUSDEDCWPEX   : MPAQGANTWHT     JJQIP           POYIXWWVMG      JWEQMNUNWAJ     KGSYJ          
KRVWRRHBGJXL    : HDNPRQMYHYG     LOIISDYHLAAE    PKDC            SUHOQ          
DDULGGMBBQHFUF  : HTDGVNDHTIRSU   QACGGQOI        IXQM            CPLKHNQD       
YDBKUWJM        : BCKCLBLQMWCF    HWPTFNVF       
SPWEQIIV        : DJKONLTIALBN    QMXUIITRR       PFWCWFEUS       GPILNABKPPIPXU 
DHUMWX          : HGFEXTJAYACGS   XNSNPDTGANRQUAP BCSXBQYRN       PNQN           
PGSKN           : QMXUIITRR      
JQRVN           : DWJBSCTE        NRQHGDAQ        OXYSFVTVANHPFTB
HCGASFFLON      : FSJUG           FPFKG           MYMQAXI         JFHJHNPAEBF    
DSRAFOAVEGOQV   : JJDXNJTOWC      DWJBSCTE        SITOWEP        
CMYYCOGFWJA     : BEIFA           PSWSPQWROGQSJRR GITVL           VHLNPHNJYGN    
OLSEUVYOXHDYD   : JVHMNGXJMAM     XNGTQL          CVNRYDMUQYTGS   XBVCNXSLWCXMYN 
HTCECFSBEVRMD   : LDCBP           CJQC            GBWWRCIHVMJ     TWOEEOIJSX     
VDTMQMSNLSDLCG  : EYYGSPNURRNYKBK PCLJPHLR        PPURWMNWU      
FSSBUYDATHGPY   : SXOIACDOWBMI    NOTDDNWT        QRBUFCNS       
SQRXMHQBAF      : BCIM            QTQUQKIJRPA     DGVXXEGAPIWNIRI
UIBYQLEJ        : MCNFYXRNVBUN    SYMYXVAGW       LFQYXVLD       
IHHLJC          : IUWELYNHLMW     BCKCLBLQMWCF    UNFHX           WGVXSPQXWSP    
SRUONLI         : DJDBCBMFYQI     SSUKSOTSSVL     ROTNLKEEX       GVXKGGLHWGXC    UHDPXJVEABQQD   FEVKUVPQUKJBLF  MHOXE          
XPFYSKOPURPLDVX : QCJICCXSG       FSYNIORIDTCGP   JAJERCSIJDK    
EFTSQVNJQIXG    : NEJFYKITNV      JEDRA           QSKX            DVPGKY          AOFYKM         
JVVBDXTPOMKG    : AMHULC          MPOMLTENLKUQ    RULFBGREYERSPHV
WJAWXFEUAUSNH   : DAUBVSU         KYYKNYKDUNGX    QNSWNESM        IKEMAANSSEJC   
YHRUQQT         : YAXSFDPQDBBJIE  JARVWGXWBENNXJ  JKECNSPUG       KJHRIMTQPNDMQ   MRJNHCPTPRCUBOT ORDQFLXUUMY     WSQATWDIHIWX    ISCWYNYS       
YHRUQQT         : BBQIBXUIOPGGWHL CPLKHNQD       
TROKGB          : NRJJYTLIYPYHOXN NOWTONVHLE     
OFTAGQYNUT      : HXJBFG          LYFQFOCTEP      GJGKKCCFTV      IHTWQHVRTLQERNR LVWVPSWGODRBXM 
SMDAYCHSAB      : BPARBSNDUKXGG   PCLJPHLR        ROKUYFVVBM     
VTGPISV         : NRJJYTLIYPYHOXN HPODMNDLOH      XBYEBWU         HIUK           
PKRKMADLPB      : QHHYHUR         HNFBICFXFNRKNQ 
FVWJXXNFSPI     : KRIJUYHJYBNXA   VFNLACXCFHVHHMQ VYUJMHDCQN      PYUEOLUWHH     
NCLDNE          : XKFUXGKFOQLH    BEIFA           TKBCFYDSDFECV   OURKEJFSWCTC    KNNSEKQYHAAOYH 
CVLTIYWMM       : KFJYRHSKXPCAAK  KXICR           XOFL            OEAWUMPKFAMB    DVGBO          
PWSLTEJRTQK     : LMDRQKJJSHB     TWPOWJN        
CRAGDETJFVGTS   : LELIK           OKICRYHRLV      SITOWEP         FWJLUJGSILPFY  
UPDHEUEYI       : KJHRIMTQPNDMQ   NVJKX           IJOSXKIBBH      YAAWVTLT        NYJIEUVKPU      VLAJPSBBGD     
FTTANFOPWOV     : RAXBVMXAQPMAEGS NBNRXDCRDW      XJPC            DMQYIJGEVLIAKB 
USOBOWUJORBT    : PALMCPAPGQGSX   ISCWYNYS        CUQYPLEGT      
GPIH            : JUCKFEDU        YAAWVTLT        JKUKIM         
INUDPIK         : SYMYXVAGW       TEBQK          
AJUVOQOETGDQPT  : GJBMVEKGJEBXTD  KUOUSDN         UWNTKXH         DJKONLTIALBN    DQVI            FTMNNMECM      
TOJCGTJIDYD     : XCTYFXIXNBJAQ   AWEPSW          LYFQFOCTEP      EMRGICKIYB      MRVHMNWVDBUG   
QNSWNESM        : BBQIBXUIOPGGWHL WJAWXFEUAUSNH  
LDAHJFXCAI      : SXOIACDOWBMI    IXQM           
OTXWOJFRLLCCB   : LWTPHCUM        YAFTVPTAIXCF    HDNPRQMYHYG     RBVTBOXIWDET   
APBUEW          : QCJICCXSG       JHOMBYROHCBBPH  VFNLACXCFHVHHMQ GAUPN          
HWPTFNVF        : XUWECXCAAAY     RMJLRPBPK       MPAQGANTWHT     JKNVTLVIXNS     YDBKUWJM       
TVPTSEDA        : TFSEOEJIGNIR    KENUT           FEVKUVPQUKJBLF  UIIMAUDRFRR    
QLATNWTFBOLXWSX : CPLBTKKLBMXF    YBWLBINVPDNYQXB
MDCKKAEG        : YXVXEOGKYCMLKKK CSLWHDVL        JMDVJO         
XBYEBWU         : BBCJYVS         VTGPISV         BOUFFUKFXFARLUN
AOFYKM          : CQMKSGWJYAJJ    QRQJHOCHGW      EFTSQVNJQIXG   
BXBASBO         : BGOAUPHMRFNN    PALMCPAPGQGSX   HBVDMPXM        MBDYFNG        
GQSQSXW         : SCRPOQIGA       DYSULULO        ELSSDVLJI       IQWFIPUWPCEOEHG
XXKCBJASLOXNC   : LHAHBYVMUOC     UJCACKICCE      BCKCLBLQMWCF    SUHOQ          
PDKQEETS        : PDTVSPN         OMAYTOBLHHVRHUK IXAGRYOBH       NOWTONVHLE     
AMFQFFNSENDGPN  : JRTEQVKBON      RVCQYYDSV       AMCR            KTNKGIUQXXV     HNFBICFXFNRKNQ  DNUMMHCHQECMPQP
IBXJO           : IGSW            GCFETPCGLCTQ   
VFFJXLNSHC      : AMHULC          NPVVFJ          DEHTFLEJAHXQT   QKKQKQWLHHIWPCH UCKEXLRHEA     
VJMBPCU         : HRYBGJQCABAESW  RMJLRPBPK       QFNDKGLBJJAMGF  PYUEOLUWHH      IRANTIKF       
SACIPLSRLEG     : MCNFYXRNVBUN    BPSPSTBWCLSYY   KNNSEKQYHAAOYH  TVVEXTFIR      
DNUMMHCHQECMPQP : ILTV            AMFQFFNSENDGPN  QHYNBHOVPLKMPA  TTKKXNTVS      
TMDMNIWDTRW     : CWHVEBBVQPOCVOO MYMQAXI         TNRKNSDSOXOOL  
YGUCTPOIYS      : TSHWNMIY        HPODMNDLOH      YAEWQXQXSB     
PYUEOLUWHH      : BTOHXDMJRTVBGK  FVWJXXNFSPI     VJMBPCU         GISIUXBSOP     
VWIUDEP         : CPLBTKKLBMXF    QCJICCXSG       DJDBCBMFYQI     YLERLEUDD      
LOIISDYHLAAE    : USXKVRSVHMUP    WIAGCWJW        VGEBCFGYVK      KRVWRRHBGJXL   
YBWPMROWC       : UPXKAVOMDTQXA   AUTETBLYO       NMLOLOJHAOO    
UYAQCHIFSWNEPS  : YKHIFHKUNVSVW   LIPATQWOJTQPCDC FUJECDTXTR      EYYGSPNURRNYKBK QLKPE           RMJLRPBPK       POYIXWWVMG      QDLYLGQMGMJT   
UYAQCHIFSWNEPS  : PCBUELAAAYGQEWU WHQROTSP       
YHFB            : PWJQVWIKYPVCTH  UXYYWR          CJHXWGFFABFRVAI PKPUIHP         VRMSMQFPOBJN   
XCMVTBPJ        : UJYWKTOR       
RBVTBOXIWDET    : UXFVST          OTXWOJFRLLCCB   BXUTWDDMAC     
ILKNMTUPFTR     : XUWECXCAAAY     YBWLBINVPDNYQXB TNYFOXNEBD      POYIXWWVMG      NUJTROEQCIJPMEV PKDC           
RNXJWXEXVXC     : XJKGGDJNP       USXKVRSVHMUP    GQPVQIACI       FPGNBBDBDDBKC   TWIRSMT         IIBV           
VMHAQDTBQGQFBM  : KCJWK           NTVVOC         
IIOFCDFNAFRYCPD : CORDICPTDFU     FMLNVVM         RUYTIEXW        AJFHSKBJHREO    BYRILBHTXA      DTVROO         
OPYQHCMKVSE     : XNSNPDTGANRQUAP WAFMJORRTXVCNK  FOSIXOIBOQOYJIH MPEJEIMFPABYSC  DMQYIJGEVLIAKB  NLOBIF         
VQWHBLMFQRSRW   : AWEPSW          OKICRYHRLV     
SBDVQRLPK       : CORDICPTDFU     PBGSADURF      
TWIRSMT         : HNQIUYAMCYEMATT SNWRCJG         XNSNPDTGANRQUAP RNXJWXEXVXC     FTMEEEWQXOX    
FSXIGKNXE       : LFUYOWJEPITDK   KWOBTIVPVLB    
RETKFAIXTV      : TRCWMGNILG      SSKWEQHSXXTB   
FTMEEEWQXOX     : BNLBR           DQTEAIEKO       MTDFRPPUSART    TWIRSMT         RWNNVBP        
MIAAVXE         : VWWL            YDHWNBIHOO     
PKDC            : VTBUEAVAKBQPTA  LRTMEGHJBLQVN   AFTHD           KRVWRRHBGJXL    ILKNMTUPFTR     VHLNPHNJYGN    
DMQYIJGEVLIAKB  : CJLYBCGUUQRLF   UUNBRUINCLWN    OMAYTOBLHHVRHUK FTTANFOPWOV     OPYQHCMKVSE    
YBTOJTOHRUOJI   : LHAHBYVMUOC     OVVCKEBRYKTREH  LELIK           IXQM            HQTOGVIC       
NBWATVLDFRYQDA  : VHSN            QFNDKGLBJJAMGF  UIJCUJXDN       EORRTS          PVVFKOVMDYK    
EBDIUTRRICLFS   : FETFFWEW        KHIYVD          IOLGCEYNMTPRXIA YTRXSJVFP       PBVSITJN        TTKKXNTVS      
NMLOLOJHAOO     : MHKCOEVQPQNIDV  DIMVDQEJASVTD   KBXEDN          QCWWEHGXVHG     WHVCFEXFY       YBWPMROWC      
OFUQJCTOMQ      : IFSDVQNUNOWAFKY
GISIUXBSOP      : MPOMLTENLKUQ    PYUEOLUWHH      UKKDUNCDNWUB    PRROTXEKKBU    
FBUQLUGAPWI     : DPNM            YBWLBINVPDNYQXB YECHDWO        
NRQHGDAQ        : OFEGPEYOKNHTCQY HFUVUBQWMXBKPJV CCNOQMKAVCPBRFF TAUCOSOWCKTLD   AFTHD           JQRVN           IQWFIPUWPCEOEHG
JJUGJYBX        : TRCWMGNILG      LGJPVV          GIIBEINY        HKCHHOMSSXGCVG 
HGSDWEXFEP      : BBCJYVS         TBRUNBOHF       IXAGRYOBH      
MFRGVBOC        : GQUHAARCJPKUU   IIOUGUDLSJVFHH  MHAAGTSNWNCI    PNSVE          
FONOJTYKUYC     : DTBEWLRTPKXBKQ  UCKEXLRHEA      PQUKQGORWMIM   
FUFFYGM         : UOYRHBJVUF      IWSPBIBCWLX    
XRSDJBCLQEPVS   : BTOHXDMJRTVBGK  CMWHEQUFHA      PNQN            GAUPN           DVGBO           BOUFFUKFXFARLUN
LEWMR           : PNPLLXNSE      
NTVVOC          : NMRAIIQVOFPY    DTBEWLRTPKXBKQ  TNYFOXNEBD      YAAWVTLT        VMHAQDTBQGQFBM  OXYSFVTVANHPFTB
PKPUIHP         : DYSULULO        JWEQMNUNWAJ     YHFB           
TROHIU          : VXXJXYBXSF      IIOUGUDLSJVFHH  UXYYWR          DKIISQJOL       VRMSMQFPOBJN   
GPATTYG         : MHKCOEVQPQNIDV  FWTLMQHGRGEH    LRNQDLUUCTFTQ   HDVSEA         
SUHOQ           : YLFSDHR         LQMNTA          KRVWRRHBGJXL    XXKCBJASLOXNC  
STPF            : DCEEHXIXWQ      JWEQMNUNWAJ     KGSYJ           SYMYXVAGW       TWTK            CCGW           
NOTDDNWT        : PCLJPHLR        GPRTKXCYNRBMLA  RELS            FSSBUYDATHGPY   BOUFFUKFXFARLUN
HQTOGVIC        : ABLUIWOCUK      LSLYYQ          BGCGSSOM        YBTOJTOHRUOJI  
RQPOAGFYABOHMC  : LSYIHDDSWPAHRR  DJKONLTIALBN    CIDKCOVWHMP    
IIBV            : TNYFOXNEBD      XCHSNOVWI       VTBUEAVAKBQPTA  RNXJWXEXVXC     QJDQODICAWDPHJL
WSPNMG          : FETFFWEW        JARVWGXWBENNXJ  SNRKGFTMKPVN    BBNEBHIOOBYRKB  SNWRCJG         METT            JCUWXT         
IQWFIPUWPCEOEHG : WXVLIX          GQSQSXW         NRQHGDAQ       
UKKDUNCDNWUB    : DVRLLQRULDB     WGCAQLSSYA      QMXUIITRR       WYLCCLYOBM      GISIUXBSOP     
BXUTWDDMAC      : JARVWGXWBENNXJ  LFVLNMJC        MALNRV          EIIYSMVRVEOXPW  UNHSTUJYPC      RBVTBOXIWDET   
CJTIQCW         : NEGJCAMSJIP     MQGTOJITISXUQ   NLALJTWRL      
OJRM            : CEWABIH         TMPPTQMTAA      FGXUHRRCMR      FEVKUVPQUKJBLF  JVALAYSPIVA     UPPMQFI        
VRMSMQFPOBJN    : YHFB            TROHIU         
OAGTELDATVESK   : ELYKUXUJOQCI    WRFNBMUKWLC    
CCIEA           : NEJFYKITNV      IUWELYNHLMW    
QSOHYE          : LHAHBYVMUOC     DTBEWLRTPKXBKQ  JOWXOJ          HTDGVNDHTIRSU  
CPLKHNQD        : TGLVEYDCVQB     DVPGKY          DDULGGMBBQHFUF  YHRUQQT        
CGUY            : FODGRKAQVG      DJKONLTIALBN    BJHQCDH         CMWHEQUFHA     
CROXWSG         : XUDI            VJYQH           QWTHFRSSRGY     LLASIYQNT      
SITOWEP         : SBLAOLFJUPR     XUDI            METT            PFCF            DSRAFOAVEGOQV   CRAGDETJFVGTS  
CRSQECGUFBXNYWS : FUJECDTXTR      NUJTROEQCIJPMEV TEBQK          
QHYNBHOVPLKMPA  : MHAAGTSNWNCI    DNUMMHCHQECMPQP CIDKCOVWHMP    
TTKKXNTVS       : BEIFA           QTLWADJQFFDYMGI PQUKQGORWMIM    DNUMMHCHQECMPQP EBDIUTRRICLFS   SSRGUVMRUGE    
TJVSCYJJAAMHQL  : OXCHH           AMCR            FMOSMOSNW      
CVNRYDMUQYTGS   : NEGJCAMSJIP     OLSEUVYOXHDYD   SPMIIFWEF      
BQLKOGMORYQRNY  : LHAHBYVMUOC     UPJRUIMLFJPUU   GDYFBO          BYRILBHTXA      PSKAVOHGIA     
YANXOI          : WPSQHOLKNMNRDII XNGTQL          KNNSEKQYHAAOYH 
TWTK            : JHOMBYROHCBBPH  RCNFBSIYIECXUO  RMJLRPBPK       STPF            WMDLBK         
PQRHSKSDBB      : CEWABIH         EGOKTJM         IUHV            OEAWUMPKFAMB   
RTTJNHKBJKRHYAG : PWPRXAY         MHAAGTSNWNCI    OSFDKM         
YAEWQXQXSB      : OATUDWLFR       AXHUFPNLEPYJNXX GBGYUOQNRVYU    CFOV            YGUCTPOIYS     
XFWQWQ          : AJUURKFXI       JHOMBYROHCBBPH  NAWTXTQHDUPN   
GHUQIEECNDCT    : HNQIUYAMCYEMATT KQHSMFDVOOF     KXIDAQDGBCVCK   RADKRUI         HDWNCOSBRPGXNB 
DVGBO           : SKYNBKMID       CVLTIYWMM       XRSDJBCLQEPVS  
RPYVJWBGQXAD    : YAHEWQGRSCVVNAT OOXYESPOHAKURAP HJACO          
JAATGEWVKB      : LHAHBYVMUOC     RBLJE           IWSPBIBCWLX     XMTSDH          AJAVUCBALBLRS   EFIGDGIEIV     
JFOPGDVASWVEUWN : PSWSPQWROGQSJRR BGOAUPHMRFNN    WKWDVLTWOVVOETK GIIBEINY        JCUWXT          PFMRLHVB       
VPSDYTFUCKR     : LPEQDVTJPT      RVCQYYDSV       HTDGVNDHTIRSU  
UVQG            : PCLJPHLR        PHABNORKXCI     YFLPCPA        
FWJLUJGSILPFY   : LFUYOWJEPITDK   FRTOPAMMKU      RULFBGREYERSPHV NYJIEUVKPU      CRAGDETJFVGTS   IBTCPHBYU      
DQVI            : DTFSIYYLGCLQWQG NDBD            AJUVOQOETGDQPT 
ROKUYFVVBM      : CRLMRIJPXSGJ    EMRGICKIYB      SMDAYCHSAB     
EUBPGYBMRJAJP   : EIFF            JCNEEGL         VUEMIVGIVH      FOSIXOIBOQOYJIH SYMYXVAGW      
OURKEJFSWCTC    : XIFQAXBLBVMFX   UJYWKTOR        NCLDNE          SPMIIFWEF      
PFMRLHVB        : JFOPGDVASWVEUWN
UCFOOHXG        : TAUCOSOWCKTLD   QSPTUMF         TOUOUFOGK       BYRILBHTXA      GCXNJFLFURIF   
MBDYFNG         : IUWELYNHLMW     VGEBCFGYVK      IHTWQHVRTLQERNR BXBASBO        
KITOIJTXEFFAI   : LRNQDLUUCTFTQ   HDWNCOSBRPGXNB  FQGBEXLTSPN     MVKUJEQSRHPNK   EFIGDGIEIV     
WMDLBK          : YKHIFHKUNVSVW   WEYDTEPY        UIJCUJXDN       MDBMNGYOYYEXHFF QWTHFRSSRGY     UNHSTUJYPC      TWTK            PEXBDHTYSGTF   
JVALAYSPIVA     : MLAMCNUO        HDNPRQMYHYG     OJRM           
PQCCKCI         : OPQKIGDTH       QTLWADJQFFDYMGI RWNNVBP        
HKCHHOMSSXGCVG  : WPAYQONVVSY     JJUGJYBX       
VHLNPHNJYGN     : XIFQAXBLBVMFX   AEDIAHGJMELCDME QWTHFRSSRGY     CMYYCOGFWJA     PKDC           
QPJKYTMHDETX    : LHAHBYVMUOC     HBVDMPXM        RULFBGREYERSPHV
TEBQK           : BTOHXDMJRTVBGK  NQXGTCIMIX      BGOAUPHMRFNN    AWCNJ           PLEGHWEXHMH     INUDPIK         CRSQECGUFBXNYWS KNNSEKQYHAAOYH 
TEBQK           : TVVEXTFIR      
OSFDKM          : UKVDPXE         DQTEAIEKO       KDKVOFKTBHQJEJ  RTTJNHKBJKRHYAG
VLAJPSBBGD      : TODQHGQPTEI     XUDI            PCBUELAAAYGQEWU SLHPOCUNFTBFWQB BCIM            UPDHEUEYI       CCGW           
UMBYIAXFECXRVMM : XJKGGDJNP       PLCUAGQQXJHGMDP KGQEAK          DJKONLTIALBN   
RWNNVBP         : EMDL            MMWCH           FSJUG           MRJNHCPTPRCUBOT NKJSFSNVCBW     VJYQH           FTMEEEWQXOX     PQCCKCI        
QKJUQ           : XCQUWDMQUY      IOLGCEYNMTPRXIA LGJPVV          IXQM            QCGUY          
SOBTPL          : URTQVHQKSXW     IXSFCEBNAIUKS   CMKQOQKHVMSNF   NCGYQKQQA       MRJNHCPTPRCUBOT IGSW            OQYDCY         
QQBSOUOEHPXGF   : KENUT           FCSPWQVLRJUFW   KEBFSNOSLUC     VUEMIVGIVH      CFOV            JPLFANV        
CIDKCOVWHMP     : XHLJGGFCUUNFT   RQPOAGFYABOHMC  QHYNBHOVPLKMPA 
NLOBIF          : PBGSADURF       NFJHSVCEGR      EIIYSMVRVEOXPW  OPYQHCMKVSE    
LXHGOLPGKV      : YAXSFDPQDBBJIE  UUDUARWEFJ     
XBVCNXSLWCXMYN  : KEBFSNOSLUC     PSOYRGSDYWW     OLSEUVYOXHDYD  
POJU            : GJBMVEKGJEBXTD 
UURBJFQPPO      : GSRLQUC         QHHYHUR         GQPVQIACI       IRANTIKF       
QRBUFCNS        : JFHMOSDMHI      WSBYFMLQYGI     EAPJH           FSSBUYDATHGPY  
PSOQIPGA        : CPLBTKKLBMXF    LSNFMJGVVHIDK   SSUKSOTSSVL     IPCN           
DJTXBWHHPYYEGP  : PAKCILEYHNXAF  
IKEMAANSSEJC    : UPJRUIMLFJPUU   OWLC            RADKRUI         UNHSTUJYPC      WJAWXFEUAUSNH  
SCWVLQWPPEYFGX  : YNORGA          QLKPE           YBWLBINVPDNYQXB HSUQAAHFUVXKKK 
MQJWDPLEPCYJ    : MMWCH           AMHULC          AAVLSSIGTCDC    TAUCOSOWCKTLD   HNKST          
INFDRCCF        : XUWECXCAAAY     GJGKKCCFTV      WCMWGTECDN      WRFNBMUKWLC    
YULF            : RHVDOXNAR       MQGTOJITISXUQ   UXFVST          GBYWIQJTLEIPMPB PSOLCCDWXTMIEH 
TNUEDLPCQF      : WGCAQLSSYA      GQPVQIACI       ORDQFLXUUMY     LPWYISBYX       KGQTVO          KQQJISI        
UXSVJBFWGKOJ    : HFUVUBQWMXBKPJV JQCWWOMTJCUOVV  EORRTS         
VHNRUTN         : GJBMVEKGJEBXTD  TRCWMGNILG      HXGVVNBSV       ALQMWIXPHJY     QACGGQOI        MWIHIHQJBUBIXAD
HIUK            : JJQIP           EOQKXDWFUB      LDNHREOHAXRN    VTGPISV        
KNNSEKQYHAAOYH  : BUNIRXTHXPPG    WNXXPTCDAUFYRJ  NCLDNE          SACIPLSRLEG     YANXOI          TEBQK          
PSOLCCDWXTMIEH  : LPWYISBYX       YULF           
BSIQNOBENK      : GQPVQIACI       ELSSDVLJI       NKJSFSNVCBW     QDYVPTR        
OYDX            : EOKRM           KGQTVO         
SSRGUVMRUGE     : TMHFYBCWSU      MPEJEIMFPABYSC  TTKKXNTVS      
KMXNHJEUA       : DJDBCBMFYQI     EORRTS          FKRRRMPBCT     
BOUFFUKFXFARLUN : XBYEBWU         XRSDJBCLQEPVS   NOTDDNWT       
OKGTNTI         : FSJUG           KWOBTIVPVLB     WKWDVLTWOVVOETK
HRXOOAYPOTW     : MQGTOJITISXUQ  
QJDQODICAWDPHJL : LIPATQWOJTQPCDC OVVCKEBRYKTREH  UYGV            IIBV           
FTMNNMECM       : KCJWK           EIFF            LSYIHDDSWPAHRR  IFSDVQNUNOWAFKY AJUVOQOETGDQPT 
REYOCQXGJOLS    : PWPRXAY         LDNHREOHAXRN    PCBUELAAAYGQEWU PNPLLXNSE      
ORVEYIPYPLLDBAJ : RCNFBSIYIECXUO 
NOWTONVHLE      : URTQVHQKSXW     TROKGB          PDKQEETS       
CSLWHDVL        : CWHVEBBVQPOCVOO KEBFSNOSLUC     EAPJH           AJFHSKBJHREO    MDCKKAEG        IBPM           
GDEVQSARSL      : QLKPE           ISCWYNYS        MDBMNGYOYYEXHFF HWJGX           LMDRQKJJSHB     WYUQTFQHEUTBBQ  MHOXE          
IBTCPHBYU       : NQXGTCIMIX      UYGV            FWJLUJGSILPFY  
PWACVHHRUMXXRU  : LPEQDVTJPT      JCNEEGL        
MWIHIHQJBUBIXAD : FVCPX           VHNRUTN        
QCGUY           : CRKFNGIKRNEQVB  JRTEQVKBON      JVHMNGXJMAM     QKJUQ          
CSLPR           : NEGJCAMSJIP     MOFHDAJPH      
JMDVJO          : LFVLNMJC        SSKWEQHSXXTB    MDCKKAEG       
TVVEXTFIR       : AJUURKFXI       IIOUGUDLSJVFHH  SACIPLSRLEG     TEBQK          
OXYSFVTVANHPFTB : JQRVN           NTVVOC         
XYDO            : BHDICHXGLDXIIIA URTQVHQKSXW     DRSPLMTUAUFFPFO JFHMOSDMHI      PNPLLXNSE      
WKBDKU          : RIOLSSCC        HBEPV           YOHWTOBTVA      TKBCFYDSDFECV  
TNRKNSDSOXOOL   : NQXGTCIMIX      YYDPFGK         JTXRAQJVURTGI   XKEHOJBRYAFBGL  UUDUARWEFJ      TMDMNIWDTRW    
HSSKMSKRHPQUS   : QAIPX           EORRTS          UCAR           
FQGBEXLTSPN     : XAOTIYSPKHULTJT UCKEXLRHEA      KITOIJTXEFFAI  
PEXBDHTYSGTF    : EMDL            DTBEWLRTPKXBKQ  MQGTOJITISXUQ   TOUOUFOGK       WMDLBK         
CUQYPLEGT       : RKUE            USOBOWUJORBT   
MRVHMNWVDBUG    : JHOMBYROHCBBPH  ARSUEAPOLVIYSV  EXNJAESOIHAXDN  TOJCGTJIDYD    
CCGW            : VHSN            AJUURKFXI       EYYGSPNURRNYKBK AXHUFPNLEPYJNXX CWUOYMVFCWI     STPF            VLAJPSBBGD     
CCKGWCFP        : LFUYOWJEPITDK   BGOAUPHMRFNN    YYDPFGK         IVIUSBH        
MVKUJEQSRHPNK   : XIFQAXBLBVMFX   OOXYESPOHAKURAP KITOIJTXEFFAI  
IRANTIKF        : KXICR           FWTLMQHGRGEH    UREYMTMQLXAU    VJMBPCU         UURBJFQPPO     
PRROTXEKKBU     : MHAAGTSNWNCI    UIIMAUDRFRR     GISIUXBSOP     
MYAHQHW         : XUWECXCAAAY     TMPPTQMTAA      FVVXQVRAMGUF    KWDLMST        
UPPMQFI         : XOFL            TMHFYBCWSU      OJRM           
SPMIIFWEF       : UYGV            CVNRYDMUQYTGS   OURKEJFSWCTC   
OPHJYVLYD       : IKETLTKQOFEL    ARSUEAPOLVIYSV  RXBUM          
JAJERCSIJDK     : IXXDJXDUGF      HNQIUYAMCYEMATT DEHTFLEJAHXQT   QWDL            XPFYSKOPURPLDVX
TWOEEOIJSX      : LWDWGDJOLEBO    ALQMWIXPHJY     JKUKIM          HTCECFSBEVRMD  
AJAVUCBALBLRS   : WYRCSB          GSRLQUC         MPEJEIMFPABYSC  JAATGEWVKB     
KEANQGJNVNSKYCD : TTWDWROW        PIYNDTKQQTK    
EFIGDGIEIV      : JYGPT           WYUQTFQHEUTBBQ  DLHTAH          JAATGEWVKB      KITOIJTXEFFAI  
TNCMAGMQYSANQ   : WPQGHIWRKAFYR  
IBPM            : USVDBYJLMKW     CSLWHDVL       
QSLBAOJKU       : TEQKRSHTBXMAJTI LWTPHCUM        RVCQYYDSV      
