JQEXBWNIFGPAV   : MDLVBBUDYIVM    NTNRBXDX       
CDXUIIJA        : MWNDS           HYSLPYOTYQNLLQ  GIHUOPYSCP      CJDAIYLHJL      JWEJYWRJHPX     XLHNQ          
YSSROCDNNTTNWSB : IECVJP          IFVUWGTGASNHC   IJVTSJRGVYTLYJX VMVOHBAFQH     
XHWYGCDLAYUI    : BMTFJNKD        FUWHWGTF        BMDDMQGHJQTD    XRSYRX          JGEJTDAYXVN     HJVHYMFCL      
UYJQRCHV        : EVLGVSGHJ       WKDRMF         
WJDQYAJBHK      : OTGPXKLKU       POGACYW         PAMFCLVPAIVISP  LUIBURQR        OVXRSK         
HJQJMD          : XKQKFUCPPRWB    EIBPR           GGGK           
NXTYUSIL        : BBIIWGLCBTBPAH  FXOC            VWHMEXXSJIQ     QKDVIGILAIKAAL  ESLYLPDQCFXKP  
MVKTSVWKVYV     : WKMVLPCBFX      VHOCFJBM        XMHAIGQKJ      
HGHQRYC         : UBQWCJKEYSBPAB  FIUVUEL         PSWCKSLVAXHUYMT
CNUC            : XWTMIV          VTWWJPHAQBX     FBONYIRCIICAW   MVCDYWEXYCQJUMQ
TWDFLRRHDMABLM  : TLXQWN          QNPSASOR        IQVCJEVLATP     GWTHGEOSFT      VTWGBOPXXTAVYQ 
NJTWRENKDPRH    : PAMFCLVPAIVISP  ANLYQEHGI       BRNVQ          
MJOHGRMT        : GBDEPTARDEDHD   TNVBLRVKURBOGKU BGGKEGDB        BDNRBRUJGJFGN  
GBRSESHSQUEM    : LCBDHFIOK       YIFIQVGFADN     ESLYLPDQCFXKP  
WQHJVY          : JTGASROPUG      NADCUDB        
DENMSWVNLRCSV   : FDFGVTHCU       LVCETYFFNXLLY   ISNJBYQ        
NCOWUHTCWNB     : EWYVIXUL        QCHETQBDQMW     KPPYSBAVX      
WKMVLPCBFX      : MVKTSVWKVYV     TQNMQISSYIVJLMS DMNFXIWCR       RYXYPBGE       
DLMUPF          : EONHPTCPGQWV    GUIOUYRT       
LTUAS           : QQWFFASPN       YJJEGUIMJDVIH   PSWCKSLVAXHUYMT CWWDCTOKJ      
KNUHBVWYGJW     : FKAOGLEHAQ      JWJHXMKLGOD     TPYMDKWK        QYRPXIOPAUNGIOK
CAUJXVMLLJBQF   : IQBKCLELCAVSTPQ UPCJMN          YPLCPHUOH       PSGMPXCBF       MEEDF          
MAOGSYTP        : NMSJRSM        
WNGVVRTPVVN     : JAHXQX          TDIEMSLQOFXJD   MEEDF          
TLTFWGGO        : OITUUAFFVG      XXLTSKBYL       RSIUSICBU       DRNCI          
UDNJLJJHYRFNABJ : CHMNSCIBOE     
WCQSPWOBSVYYE   : WXJYUAVQHQJWF   FDFGVTHCU       YOUYGUS         IHWW            HJTO            KYKOSSUPISIS   
KYUBJHKUOJOTYPX : BWHDVQQ         PUSB           
MWNDS           : CDXUIIJA        UTUWBSORM      
AHIVGJUKYIMWJV  : XELIFTUCFS      AANBRSKMQSR     AEVSAXGEP      
TSSFHPFY        : VUOIXSXMWD      YMQYDEIEIHBFVNW
QLMGRHLTRT      : NOMILYLDX       UTUWBSORM       NMSJRSM         KKTLQUMXM       BLIE            JWADXR          OIRNCCOHVHXYMMR
XELIFTUCFS      : AHIVGJUKYIMWJV  CKCXGAUNPA      JNGJNMMRCO      YYTDLNOVRWQMVAU
YLEEVTLWLELAK   : OOFLLKWPBUXAP   ITLURDIPYUI     KOXUFP          JNWW           
IXWAUN          : WNSHISTTV       ABVHXMAIG      
BBIIWGLCBTBPAH  : NXTYUSIL        IPSE           
VTKHXVILB       : HVYHRLEJTJAWA   DKSNY           CRYD           
LYSGOUHPDQOLEQP : TEJNHMVREQHPPP  IKTLFQU         MDNUNWS         DKYYVPCGVDSGFV  EWHTNGIJAFXSW   YVRAPAHMOVL    
TFBBSWUDHVCPJD  : DBKC            VSVKKQKXJR      URJRNNFCKDB     TDBVTDFBTMBPJ   ADNGNXQWL       ONNWAGWCIJ     
UEFESALKFEYRKRH : OBRFRDPJCAK     RBGMWFSEDRVBGK  VVAAF           HSOJDXWWP      
LOONHNKMU       : DYRGCSKT        NFUSTJT         EOTWIOXVPJHTRJ  BKUUM          
OMRUYPYETUEHF   : XAPIJK          ABFHJHNFY       NUOKM          
OHEYYNMLCDB     : RQWFCCYVGI      HYSLPYOTYQNLLQ 
TLXQWN          : TWDFLRRHDMABLM  CIPSPKY         FIRHEIYRR       INLEMBKGMMS    
OIFGJMAESIMD    : VJTUK           OITUUAFFVG      QGEB            BWHDVQQ         ONNWAGWCIJ      PWCQFKX        
TJXU            : ELHYYNBVNXCVAA  TNUYVY          ABDPUJRWYOKDIJN
NIBSJMMXLGUBO   : XHXDRWBPOFQH    RTEHVFKDEUQPJ  
LVSU            : DKSNY           LTLHAGTBDUJGMO  OTJNNHCJYMK     DJMHMWK         AOCNCMBO       
SCCDOHAKTY      : HKFXIJXUYKTR    DSSUIURH        EPFBJGLNPVHI    GXCMSYWKUBAAME 
SOOWHAJWAWF     : EMATAGBXCLP     AXIMG           IQWEHSAA        IPFNHADMLSFYQB  IONKCOLER      
ATJNPELBY       : FSSALESXPCX    
FDEOFOIGTEU     : OPMOW           WCIMRRJTWR      UJDJDBCL       
BFLMCL          : UVYJTXEIGRWE    SOTMBWT         IJVTSJRGVYTLYJX PSNNXP         
HLMDUBSBO       : BFHR            MUSUTKSLGITN    HTGMVSIOTSXILRX
CCBFGQNUBVQ     : BXTCJAHFJYFG    BVINVEIWAGF     GEMDFIU         GRSQRMHVLKVX    QBTOLMNPVJRV    CJDAIYLHJL     
TCGYPTBDG       : PEJVNW          BRGBAVBYNKIHFR  UWIVXNVGBLN     HJTO           
OUNLXIOMFRQIW   : HKSRWETPOQ      XRRKIL          NLXI            TOYHVUFLSGCPX   YMQYDEIEIHBFVNW
BMTFJNKD        : XHWYGCDLAYUI    XJWPCSVXFGVWP   DGPNOHXCJWMNN  
TEJNHMVREQHPPP  : LYSGOUHPDQOLEQP UIIBCQDOYO      PSGERLCTNCMWI   PRILXSFQHPCD    VVGHLGJUHMJI    SGSKSYINK       DSSUIURH        TAAIUIOP       
TEJNHMVREQHPPP  : QYRPXIOPAUNGIOK
EWYVIXUL        : NCOWUHTCWNB     IILUKHK         KDVTDECFCBRWH   TBQEEFKV       
RQWFCCYVGI      : OHEYYNMLCDB     YUUDWHRNX       JAWDHJ          XLHNQ           VUOIXSXMWD      XRSYRX         
NUJHB           : FAKKHN          SRJMDPQMD       LMCX           
OTTGBYGAUOXP    : JAQPFBMBEF      JCCFNMDNJK      EAVWUJFWPV      HIEMHKLMF       GPCLJQD         HSOJDXWWP      
JJRIOVKPTQXFGT  : DYKLEXFEQXSOXJC POCHIBFLSMO     WAMFHUBWSRMAB  
NWSEQNLRMRR     : RXNNQORWAFYHP   PRILXSFQHPCD    IUPMKKUVG       XEAVYIESUHBWXQ  RQCCE           UHRNJHJMSBEYT  
IQBKCLELCAVSTPQ : CAUJXVMLLJBQF   GMILOQNTYNNL   
XMRMKNSBBGTPAN  : MBERHGJRSVLGMJ  QWFMCKALHLKYR   SFXOTWEAGAKSIT 
IECVJP          : YSSROCDNNTTNWSB XRRKIL          FKJFJACGQ       WMCJRTJKFXRCHFL
UUBSNW          : JNWW           
GYJVSXGGQJJX    : HBWCLLVXR       QGPDSXLTKWOYSTY AANBRSKMQSR     RSIUSICBU       UJWPGSQMUVMW    MPHHNTCPQJYE   
BXTCJAHFJYFG    : CCBFGQNUBVQ     VVGHLGJUHMJI    TYAMJUIDN       AVDFKVQVVVDT    LRWOTMGXLNLAD  
IAJGKQ          : CIPSPKY         YPKEXTLWCH      YUXNWRV         MLHX            KILISFDD        YNUMVGBF       
TMARUJ          : ASYJIK          FOAVVT          METO            NJXUEGQ         ITCMFNYIHDA     WPBURQY        
ESJMW           : UUUIQCSXWCCSTF  RURUWMDAGWR     TOYHVUFLSGCPX   OVAEUUWMPV      FQYHKFEKAVSBBG  ULHGBXTFVOEU   
GYSII           : JUHSUMBRVPHQ    NXCXKNMXSGQM    EDIFKDOSOGMKS   OEQUDIVPFSCLAO  TBKJE          
UIIBCQDOYO      : TEJNHMVREQHPPP  FQEGSXJNEQH     IONKCOLER      
IKTLFQU         : LYSGOUHPDQOLEQP TVJWUCRK        KBFHMVW         ESLYLPDQCFXKP   SCFKIDYNPQFDS  
UPCJMN          : CAUJXVMLLJBQF   OOFLLKWPBUXAP   OVDYKHUITO      BASIDQTOK       IRAPUSUGYDEX   
OJBWJVHRYMLDBM  : NTSFN           HRHPKK          KPUFUAGNA      
IVECHJSECPTE    : YFTE            DRNCI           AKKRCNMJSM      DRSBQFYNJQJIJ   PMTWUUGWFVFMLF 
JSTXC           : FAUFKQ          WERFGAUFWSXSCPN BASIDQTOK       RFBHMIQEAHOLPH  VQGCUF          GFMJFXHS       
WNSHISTTV       : IXWAUN          OJEG            JXETK           XVDVMOYIKRNRO   PLCNHISJN      
GPFETJLGEPI     : SOTMBWT         EQQDE           JGYJF           WJSK           
MPXVISVMNUC     : QOJPLGB         LYKQFPSONYLKFWX LKCGSUXJFIEF    HJTO            DTAQYJIOKNMD   
CKCXGAUNPA      : XELIFTUCFS      UGQPEMU         PRCRKJQ         BFMMEXTDKHQTXW 
JJGRPXBMKQ      : DKFDSLYY        XMJJQEAAYQ      SSETIFRKNYXJCON
GBDEPTARDEDHD   : MJOHGRMT        LXLTESEFYVGCIJY KTVNQFHGGLLSQR  BKQD           
HXYWBTIMC       : SODJICMDF       QXBQTBH         AEEAVJFOYOSN    HSDXLCEXB      
DACPLUCTVI      : RDWSGFNE        QAQDGLAHKUIETMP WFIYVTDBNKSUVSF DJBF           
LCBDHFIOK       : GBRSESHSQUEM    OTGPXKLKU       BBFOX           PROJIPSEKBRFHU 
VJTUK           : OIFGJMAESIMD    NBCNUYIKUQI     APVUGYFIJJD     AHFR            TXUGPVC        
DYRGCSKT        : LOONHNKMU       XPYN            FEPS            TIIOC           EHNODROJR       EMMUOLKSELRIDYY
FWABFBOJE       : EJSJ            TAHLAKOB       
QMDFW           : UUQTWRE         OHSSIPCLBFNVPJ  TOOAOCIK       
BIUVUKBUDKWXU   : GQCXT           IMGAAAGB        CSKSKJON        QSVKIAATQ       FIRHEIYRR       PROJIPSEKBRFHU  VQMW            EGAQBXPTITLV   
EBQEEXITHMOX    : BRGBAVBYNKIHFR 
RDWSGFNE        : DACPLUCTVI      TEIUAEVOVC      EJSJ           
XHXDRWBPOFQH    : NIBSJMMXLGUBO   RHVBVQLPQJL    
WFWSMJHMJCPI    : YDRUPUTLNXJ     SNGLOJP         IRAPUSUGYDEX   
XPIESIOSMGQPVH  : CFXXIIQWUV      MBERHGJRSVLGMJ  NTBLRRESCSGT   
OPMOW           : FDEOFOIGTEU     MHKVOODDHX      HQFQKJSUM       EIBPR           HJKC            UMBQBUKIXMV     EOBJOPB        
HKSRWETPOQ      : OUNLXIOMFRQIW   EPNMHIWNJPJ     LUUMQUAPPV     
HBWCLLVXR       : GYJVSXGGQJJX    HIEMHKLMF       ULHGBXTFVOEU   
QQVOFLBTJMEV    : XCRGKGR         MGRJ            BEBECUBAA       OYYPCRYYERH    
VUMRMBK         : BGPUFYMHFYBEBVM AKPPQBBS        MDFAR          
INCLY           : FPXWXQ          OMAIOONF       
JAHXQX          : WNGVVRTPVVN     BSNGFPCFWASVHMY DVDJDFORVHO     RPUKPHUG        NKMSPCYO        XIIDFJMEA      
HGGKCRWGPCEMQ   : NMPOTAADEFSHTN  CKBFNMLJDGUEBV  GKJUXDY         GOJRUOOAFCHXC  
CSIHDVJQV       : HRIRJJMRFMRTH  
CVGAOFUV        : QJATOXW         NSUK            PDPR            ETMKWOGXPWL     SDIJTLFJR      
BGPUFYMHFYBEBVM : VUMRMBK         IJVTSJRGVYTLYJX BLIE           
BJTSH           : BIBQJ           INEYYJY         KSALIOSNNLJV    DMLSUJ          DAOPL           YKHNRSNN       
UFAVTHSRUVAMQFN : XPYN            UCUDGAO         CKBFNMLJDGUEBV  NQNFTVPXYOWQFO 
OTGPXKLKU       : WJDQYAJBHK      LCBDHFIOK       HFEQIALYVLXUXW  KPUFUAGNA      
VRIDKFK         : DEVVXSRXIKDVPS  KILISFDD        CBKAXHAIPD     
DEVVXSRXIKDVPS  : VRIDKFK         USLQKJHAFJULPW  KQSGGISQDOYHCWE VXCIBPLSSHXMBKC SFOTPHAVSCM    
WKPHWBEMYV      : FAJDKWW         LJHBRESKSSQ     NQVBWEIBST     
FJCPVIWUEUN     : BHIAL           OHSSIPCLBFNVPJ  XNQKPAQVBAW     QMYXXR         
TVJWUCRK        : IKTLFQU         URJRNNFCKDB     EHIFJMNAKC     
DBKC            : TFBBSWUDHVCPJD  YLWLSI          IFVUWGTGASNHC   OFKOQSHMIORW    QGPDSXLTKWOYSTY
OOFLLKWPBUXAP   : YLEEVTLWLELAK   UPCJMN          WAAJS           KIYEKBL         XAPIJK          CVOXHRHQS      
UGEO            : TCCLKEN         SPHLADGUN       SPLW           
POYRGM          : AXJLKXWOHIM    
LPFNTUEYIRMFI   : GQAYEKE         NKMJTFOYR      
CIPSPKY         : TLXQWN          IAJGKQ          OAFURCXYFE      OXXPENJMYHHGB   LALQOFO        
CFMQF           : OITUUAFFVG      SKMWKITWNH      PXMHSRIQNLVGUR 
YRCL            : BFHR            ILNVPSUT        RFBHMIQEAHOLPH 
HBDEGEOASVK     : USIODKGAKKACPUF
YTXTJJUGL       : CIUJXJFWKNH     UVYJTXEIGRWE    JBTA            MEEDF           NONCAN         
UEHBD           : WASGLFIVVFHRI   NMEY            OFPGQDIAFQ      FUWHWGTF       
FQKPSNVBUNBNJM  : TNHLNEHLKLPQJI  EXCEOWDH        UNKEGXVIRGECRSR JGST            BPCDHTIIAABPOB 
KIWGTG          : USLQKJHAFJULPW  DGLGFDJ         QVDYAQJXFIPLWNT
CTEWXLBENIUAXPO : XSIDKNGOUCU    
SLKWBVLAJVXPP   : RUEKM           EGPPS           UKOVRAAUCFL     NONCAN         
TUDAT           : FDGIBKKQG       FBNEAWQJAUKEX   PPQX            ISNJBYQ         WJSK           
LWHBG           : NGBPHTQ         VOTWM           WPUUHRAREAO     BICKNHEPXFAJ   
CGWSDQGPPJMBKVW : GQCXT           LWOSJD          NCPQLNX         VTWWJPHAQBX     BEFILGXBNYBACLH
NOSJJVJEAXBJBJO : BBHJSUTV        WPTHGJGWKU      KRJT           
QOAVHGMWQBADWY  : KSBNI           OIRNCCOHVHXYMMR
MPGWAFGGHGJQI   : HJLYXKIFLRYSR   DKFDSLYY        DGLGFDJ         XDNDA          
INMWOKEWWDPXD   : RWVDRFBBM       MDNUNWS         GNSNIPPFJDTBV   PJCRPGUO       
WCIMRRJTWR      : FDEOFOIGTEU     COSBMPSXAUQNVR  BEBECUBAA      
EYOWJKF         : CYXOTJDHMFYUNRT WJJAHT          RWMYGNTVRY      PCSVTW         
YCLJIJJLYJQU    : QOJPLGB         RTGFTYRKC       BDIGTQUJYSBLMNL LMTDBTWYJMKF   
SDVNW           : BXJEK           CYXOTJDHMFYUNRT YFWBSVM        
JTBOACDXLPFJQ   : QOJPLGB         MHMMXO          NVFX            AFGATMRGCQ     
WASGLFIVVFHRI   : UEHBD           YFTSOCCMQXQU   
HGKSCNHFQMFC    : PKWD            FSSALESXPCX     JYCHXTDTOVQ    
KLSWLVQTJX      : HJLYXKIFLRYSR   COSBMPSXAUQNVR  PAMFCLVPAIVISP  HQFQKJSUM       LUUMQUAPPV      NOTERCRA        QXBQTBH        
FVHOPSRYBES     : YRBMUUJSHHA     MUQVGPRVOOG     HQFQKJSUM       JENAM           JRYETFAIBERD    RXWQEBI         XMHAIGQKJ      
SAMLP           : WPUUHRAREAO     TVFNITNIPOJ     QQWFFASPN      
NRFCNC          : SVPWNIXABSXDOO  PAEGSJMORCIOM   EOTWIOXVPJHTRJ  DMLSUJ          UELL            KPYJHPORSPDFDHC
JUHSUMBRVPHQ    : GYSII           EHUQCWOPQICIHN 
JROCAJEMU       : APNA            NKKBVWTWSAWOWT  JVMSFXOMPCBAH   OCXC           
HLOONCS         : BASIDQTOK       FDGIBKKQG       WPSYEKWSGLBEYO 
NOMILYLDX       : QLMGRHLTRT      QSVKIAATQ       ANLYQEHGI       LAEXFMQMH      
NOOWJFBJ        : EVFIJFUNHYO     BKUUM          
FXOC            : NXTYUSIL        LDWIDJCUGN      CJRCPTYQCFLYOM  PHDDN           OMAIOONF       
AQVPSPU         : KKILQPUPKCVQSOX NJSDDOGYBKBL    RSIUSICBU      
GIQRJF          : OQRQ            LVPQ            HNAXMOQRWV      XQVPNIVTOBTJ   
HJLYXKIFLRYSR   : MPGWAFGGHGJQI   KLSWLVQTJX      BIBQJ           MAQVKBG         KMVDAFGYXUOD    JQILUWURFVS    
UAOLVHGLCQTKIO  : HDDGDA          CRYD           
NMEY            : UEHBD          
DYKLEXFEQXSOXJC : JJRIOVKPTQXFGT  HBQR            UXBEFCQHFHHUGGC
QJKTCEGKSDA     : HVYHRLEJTJAWA   VMVOHBAFQH      VVAAF           PJUFFSAEOPU    
IYFNXRCFP       : ANOJOCS         QYMCKGIB       
LJHEXHPAEJ      : HYSLPYOTYQNLLQ  CFQUM           JUGDYTJNLQ     
OFOU            : CGKJASLU        CTGAMMJUTA      CDPEPXP         UYSRGBCNKOB     JUGDYTJNLQ      SVALBRHTBHP    
BORCVADEPEV     : DJBF            YNEE            TAHLAKOB       
JOCUXJBXTSXACM  : WXJYUAVQHQJWF   UOXKOUDQKIHT    TQEVFRCPWO      APVUGYFIJJD     HIEMHKLMF      
HBLVECNIYPM     : NTSFN           SFXOTWEAGAKSIT 
FQDACR          : DRITJ           HBQR            EQGTNARTBU      JGEJTDAYXVN     IDHDALV         ODQBVCVKKH     
YPLCPHUOH       : CAUJXVMLLJBQF   TGPLIYTGHUNLWHY BYHJD           HSDXLCEXB      
BXJEK           : SDVNW           HYGSV           PKVMBHYM       
IMURN           : DRITJ           LUUMQUAPPV      XBILWH          INTPTNXROJA    
GUUY            : WGEB            RNLSMWUQHGBJ    IPSE            PLCNHISJN      
UBQWCJKEYSBPAB  : HGHQRYC         SUURENQQUMILUKR PRCRKJQ         CHMNSCIBOE     
YLWLSI          : DBKC            LFRNQIO         BGGKEGDB        NADCUDB        
QAQDGLAHKUIETMP : DACPLUCTVI     
QQXRHAT         : ANOJOCS         NHWRQMXGWXMJ   
BHAOCIPSKGYS    : FBHKOQYQ        SROECUCBV       VIKTYBCSGIA     BYPOOSLBVNX     GXTIB          
YAFWILQUBVN     : PEWTYFRRDMYM    PPQX            DIDPXLG        
VHBYBCA         : KGIIRYA         YFTE            XXLTSKBYL       BUYIJHLNM       FODUB           CDNAKJHWWO     
EPNMHIWNJPJ     : HKSRWETPOQ      TAAIUIOP        HFVMQSXPWTC     XBILWH          BURBNJEFKA     
POGACYW         : WJDQYAJBHK      LOUFBBGEPGRUYDW EUKWROK        
VKATRB          : FODUB          
VFVIJNXVUJUKS   : XXACV           AVLJQSXCDVFWBYA EONHPTCPGQWV    BIMNRTVY       
TCCLKEN         : UGEO            QQRQFTA         GTCRIFUN        KDOXEUF        
BVINVEIWAGF     : CCBFGQNUBVQ    
QOJPLGB         : MPXVISVMNUC     YCLJIJJLYJQU    JTBOACDXLPFJQ   FUWHWGTF        DGYPXYUUJC      PSNNXP         
QTVMYXXL        : BBORISCWBF      QGPDSXLTKWOYSTY WFIYVTDBNKSUVSF PRYYKO          SCFKIDYNPQFDS  
OVIMGYILHHN     : DJNIYGN         PFQARLGO        QWFMCKALHLKYR  
MJICUAPDBXV     : UUQTWRE         VTWWJPHAQBX    
VIUW            : MXDTCAV        
GCAFKM          : PSYLQHXU        GRIRMEBAO       NJISQEOAIMVTI   JWJHXMKLGOD     MUJIKKXPUU      ABDPUJRWYOKDIJN KRXYSIDPNKFBYPA
JUBSCOIPART     : ERVD            PMKUPEVORSEOYNE SFOTPHAVSCM    
RJXVJTRGFODOWH  : QJATOXW         ROOXKOO         AXJLKXWOHIM     CKBFNMLJDGUEBV  BYHJD           EOBJOPB        
CRBSEXTWCLITLC  : HYKC            SONOBDK         CRQGTC          LCNJPSRBKTQCN   AEVSAXGEP      
HVYHRLEJTJAWA   : VTKHXVILB       QJKTCEGKSDA     TDBVTDFBTMBPJ   HXQMFHBAG       HEEWNDNEIBFY    HRHPKK         
GQCXT           : BIUVUKBUDKWXU   CGWSDQGPPJMBKVW KFPQFXRXJHS     UELL            BFMMEXTDKHQTXW 
CRRATDKQOME     : UBWKVKVRUDUWT   FUPVKSGFWPU     HBFRABKDUUXE    VVGHLGJUHMJI    ESMUWFPTR       MUJIKKXPUU     
IGGBRMMLVN      : JENAM           ADNGNXQWL       IGXN            HJVHYMFCL      
XLQOPQKL        : DYTLOTXM        FRDFM           OUKUPUDY       
CFXXIIQWUV      : XPIESIOSMGQPVH  BFHR            DQJMGFWVCJEX    NXHJCJGCVCQL   
DEEGVQ          : ELHYYNBVNXCVAA  XXACV           ENIRXPBATIS     KTVNQFHGGLLSQR  YRRC           
JOJVOUMFKFPXBTD : BWHDVQQ         FKJFJACGQ       XLHNQ          
TNHLNEHLKLPQJI  : FQKPSNVBUNBNJM  LDPOEDNXGDJA    UWIVXNVGBLN    
SYVONSDSGKI     : UGUUELL         JYCHXTDTOVQ     DNOSLWQOPRM     AEVSAXGEP       UHRNJHJMSBEYT  
MCKNVXXHNCQYME  : COSBMPSXAUQNVR  SRJMDPQMD      
ENYS            : YFOMVYBFIYR     HFBBITIILDGRFOR
XPYN            : DYRGCSKT        UFAVTHSRUVAMQFN DJNIYGN         IWUR            PRSIVID         XOWOEOXHV       LRWOTMGXLNLAD   TTGFHOVCQ      
EGOPQTE         : ETWQSLS         XEHGNYYXHSAJWEU
GRRGP           : QKFISFTV        PPVIYLMMPT      HILCCL         
USSTHYLNNMHXNWA : NQRKRWLYOY      AOMS           
FEKUVBQAWYU     : LDPOEDNXGDJA   
FKRCFMYPMKDAYKA : XKRICKUPE       LKCGSUXJFIEF    TOOAOCIK        HIEMHKLMF       WUBAOOEWFKM    
JAQPFBMBEF      : OTTGBYGAUOXP    WGGHVFWA       
BEYRLLK         : XUTI            GSUPDHAHCSUEWHF OQLCXUYYRTRGT  
TWPJJAO         : KFJUQQIRDEGXK   WGMAKYWHQKET    EGEEMJSPH      
BCOQL           : CJPPLPVKN       PSGERLCTNCMWI   FNNMECSIYFLMMSH UIHRMDGYOPX     NUTKIFJVXPUF    RNKFMLNJPYUQ   
HDVKRAOWESD     : QYBXREEQLMASKNA JDUTLMAAVYYJ    PSNNXP          YOBLAKLXYDHFJS 
MRSWIMWXXIANWB  : NCHCKIMOD       VVQESAUICELB    GSUPDHAHCSUEWHF WQMS            RHVBVQLPQJL     BVQKPTFN       
LRDABHYN        : KFJUQQIRDEGXK   DMLSUJ          VTWWJPHAQBX     QKYEPFDQF      
YFYFXEMKVFKE    : LSNPSOHJBVC     EHIFJMNAKC      NTBLRRESCSGT   
HCUP            : QBTOLMNPVJRV    APVUGYFIJJD     JENAM           UHIIKAAVPAXQWVF MDFAR          
IMGAAAGB        : BIUVUKBUDKWXU   CGKJASLU        MVCDYWEXYCQJUMQ
PCPOBWP         : TWXWQCIL        SNJYWOFETFPDA   WJSK           
UUUIQCSXWCCSTF  : ESJMW           AJJNAWBRXT      GRSQRMHVLKVX    USIODKGAKKACPUF GXCMSYWKUBAAME 
JNGJNMMRCO      : XELIFTUCFS      LXYVV           RDVWSHTT        NGNPPSJIUJ      XINA           
SPHLADGUN       : UGEO            TAAIUIOP        NTSFN           EAVWUJFWPV      XINA            DTAQYJIOKNMD   
XGYWI           : XJWPCSVXFGVWP   TOYHVUFLSGCPX   ADNGNXQWL      
PEJVNW          : TCGYPTBDG       ABPJDJGQVMBVIN  QXBQTBH        
XKQKFUCPPRWB    : HJQJMD          OEOJQL          UOXKOUDQKIHT   
CJPPLPVKN       : BCOQL           BSNGFPCFWASVHMY ETWQSLS         HRDI           
MDLVBBUDYIVM    : JQEXBWNIFGPAV   AFWIFTPEPNYRFMO SSRP            PXPRIJKMAH      XMJJQEAAYQ      JQILUWURFVS    
SODJICMDF       : HXYWBTIMC       MBEQPBPXLM      QJTR            MWIK            UDNESTRRMWEY    BEQITAWJMBAAF   CQOMKIXWNW     
VUMLTW          : TQKAULI         JGEJTDAYXVN    
CMFPK           : BKBLBSECUXKVLO  JWJHXMKLGOD    
RGMSOKHEEXJ     : JUUVLTY         QOVYNDFD        RBGMWFSEDRVBGK  PKVMBHYM       
JLEMSDKOPWKPV   : MGRJ            TDYQALJ        
CBFMKWUWRL      : QGEB            PAEGSJMORCIOM   XPPIKHOIVHC     LOMXNWQDRUOS   
APNA            : JROCAJEMU       NQRKRWLYOY      KBFHMVW         LNEI            VMVOHBAFQH     
DJNIYGN         : OVIMGYILHHN     XPYN            JGST            YUUDWHRNX       EDRGRELAIBRPJV  DIDPXLG        
WGGHVFWA        : JAQPFBMBEF      IWFDTY         
COSBMPSXAUQNVR  : WCIMRRJTWR      KLSWLVQTJX      MCKNVXXHNCQYME  NCPQLNX         NADCUDB        
HFCGOR          : HEEWNDNEIBFY    FQYHKFEKAVSBBG 
LXYVV           : JNGJNMMRCO      ANOJOCS         UMBQBUKIXMV     DYMNKTRWUQPX    KPYJHPORSPDFDHC
SVPWNIXABSXDOO  : NRFCNC          IJVTSJRGVYTLYJX UHIIKAAVPAXQWVF WQMS            ONINLBGTPE     
MHKVOODDHX      : OPMOW           MUQVGPRVOOG     NWIRQNGNF       JRSHGSACECJPFN  ESMUWFPTR       JVYXLYHL        YFTSOCCMQXQU    UCBTAVWOAGJ    
FWNCGGAV        : TEIUAEVOVC      FQGUWVAEED      YGMUP          
NGBPHTQ         : LWHBG           RUEKM           CTETAP          ABVHXMAIG       XMHAIGQKJ       WRECAWHOOAYRNXB
KFEYOQVEGBJNYBU : ADQDY           IUKAOJODPS      PWVLEDOEEKXRLJ  JVYXLYHL       
OYEUAAAPH       : PSYLQHXU        IQWEHSAA       
GQAYEKE         : LPFNTUEYIRMFI   QYOUYRBXIINQ    WPUUHRAREAO     STUPTE          GYCKMXAOGYX    
KVBI            : WCATVLDNKHVH    WGGVXMT         UQUQLSHKFQCP    GQVMPNNJG      
HJLW            : BBORISCWBF      AGGNHXVVOMNF    GHFN            CQOMKIXWNW     
PSGERLCTNCMWI   : TEJNHMVREQHPPP  BCOQL           BUYIJHLNM       HBLYHNIOUDYO   
OITUUAFFVG      : TLTFWGGO        OIFGJMAESIMD    CFMQF           PPVIYLMMPT     
XQWM            : QHDOMJMB        TBQEEFKV       
HCIOIDAMYNRLLAG : YDRUPUTLNXJ     KBFHMVW         GWTHGEOSFT      KKIKRMRPPDJ     YXBGNSJ         JOKYPI         
IAWDDELYKB      : RKSHYX          CRQGTC          PKVMBHYM        BHSCALETXYNTH   OIRNCCOHVHXYMMR
BBORISCWBF      : QTVMYXXL        HJLW            PROJIPSEKBRFHU  QHCNWXJYDXFRX  
OFPGQDIAFQ      : UEHBD           TNVBLRVKURBOGKU RFJQQKLQLM      PYGXQRKJ       
EVFIJFUNHYO     : NOOWJFBJ        IICPUXCKRAMKQJ  TPSUF           NWIRQNGNF      
QYOUYRBXIINQ    : GQAYEKE         LTODK           XIAAELVXV       GGBIXDSVNWHS   
QYBXREEQLMASKNA : HDVKRAOWESD     OCJWCVHH        UGQPEMU         TYAMJUIDN       NOOOFSTQR      
EXCEOWDH        : FQKPSNVBUNBNJM  DYCIM           TRMXMQLAQB     
DRITJ           : FQDACR          IMURN           LOBNKDCMHAL     HJKC           
MKLLD           : VFBTXFSMUJUY    XXPWDKLA        GKJUXDY         PWFHN          
RTGFTYRKC       : YCLJIJJLYJQU    ADQDY           XXLTSKBYL      
OAFURCXYFE      : CIPSPKY         BIBQJ           VXUYRDLXXQN     IQWEHSAA        PKWD            VNYMWINTNGT    
NXCXKNMXSGQM    : GYSII           WDRCSEKTSMKKVKE DCBONNTXHJY     GRSQRMHVLKVX    BUVM            IILUKHK         XPPIKHOIVHC     BVBQW          
XIOPUQSKSXFKCG  : NLBAHJDU        KMUGVDP         ADRQVI          MPHHNTCPQJYE   
HKFXIJXUYKTR    : SCCDOHAKTY      CHCMNTEUIAGXO   HTGMVSIOTSXILRX
KGIIRYA         : VHBYBCA         QCHETQBDQMW     GGGK           
PSYLQHXU        : GCAFKM          OYEUAAAPH      
KFARDIDBFDOY    : NSUK            XEAVYIESUHBWXQ  ERVD            IGXN           
KLES            : BHHW            KYHPOUEJBHDX   
VSVKKQKXJR      : TFBBSWUDHVCPJD  DFEIKJSKY       FBGQCFA        
FHJKHBPR        : LAEXFMQMH       AYXTYCKQYDAPKI 
QWJHYH          : IEOSHXD         KRXYSIDPNKFBYPA
KNNJ            : LSGOWMXOPJJNK   LJDQHMNGX       TEIUAEVOVC      YKCRRCB         CDNAKJHWWO     
IFVUWGTGASNHC   : YSSROCDNNTTNWSB DBKC            YJJEGUIMJDVIH   BVQKPTFN        CDNAKJHWWO     
QFPILJIXQ       : THNIWJORWXFVMSF LDPOEDNXGDJA    AANBRSKMQSR    
FLTSBDEJ        : DKFDSLYY        LSNPSOHJBVC     ECKRHQY         UDOGEJLKDRE     HFBBITIILDGRFOR
CGKJASLU        : OFOU            IMGAAAGB        BRGBAVBYNKIHFR 
VWHMEXXSJIQ     : NXTYUSIL        KTVNQFHGGLLSQR  PAMFCLVPAIVISP 
RXNNQORWAFYHP   : NWSEQNLRMRR     ERVD            UDOGEJLKDRE    
HIYFR           : IILUKHK        
ECJJAHELRULJUC  : YUUDWHRNX       HDVAFGNKYEO    
NQRKRWLYOY      : USSTHYLNNMHXNWA APNA            LAEXFMQMH       HADNBJS         HBLYHNIOUDYO    KDVTDECFCBRWH  
YXNTSSVCEXMK    : POCHIBFLSMO     DSCHLUKPTUCPO   TPSUF           ABFHJHNFY      
EHUQCWOPQICIHN  : JUHSUMBRVPHQ    YIFIQVGFADN     JGCJLJWSOGML    OTXQ            UMBYUEQI       
VOTWM           : LWHBG           KKTLQUMXM      
QHDOMJMB        : XQWM            LMLLDJJVCTF     ERPLCE          DRNCI           EGAQBXPTITLV   
VFBTXFSMUJUY    : MKLLD           VIKTYBCSGIA     QETXXWEKSCXGAY  NPFIF          
EOFAEAA         : EMATAGBXCLP     PRDGHGYHTLYSJ   IPFNHADMLSFYQB  CXPEKREAROXKWV 
KSBNI           : QOAVHGMWQBADWY  ABPJDJGQVMBVIN  XBILWH          NKMJTFOYR      
YWQU            : SMEIDHJSHFVJ    ETMKWOGXPWL     UXBEFCQHFHHUGGC
XXPWDKLA        : MKLLD           KQSGGISQDOYHCWE FFASBO          RRHDCLDGAWEGHHH QRKPQVOTTULRRC  CVVSFEU        
HYSLPYOTYQNLLQ  : CDXUIIJA        OHEYYNMLCDB     LJHEXHPAEJ      BPCDHTIIAABPOB  UHVBK           BVQKPTFN       
VGAT            : XKRICKUPE       IGLVNLFKNYNJ    NUTKIFJVXPUF    XINA            MPHHNTCPQJYE   
WPUUHRAREAO     : LWHBG           SAMLP           GQAYEKE         NGNPPSJIUJ      UWIVXNVGBLN    
BIBQJ           : BJTSH           HJLYXKIFLRYSR   OAFURCXYFE      FUWHWGTF        QJTR            CRQGTC          TIIOC           XVDVMOYIKRNRO  
NKKBVWTWSAWOWT  : JROCAJEMU       VSBMREUEDRIGPR  WCDGUQJCDVGDSJ  NTBLRRESCSGT   
TQNMQISSYIVJLMS : WKMVLPCBFX      MBERHGJRSVLGMJ  DHQEKPEWEWYFC   FQUKJCVN        PHDDN          
ADQDY           : KFEYOQVEGBJNYBU RTGFTYRKC       JAWDHJ          ESLYLPDQCFXKP  
WXJYUAVQHQJWF   : WCQSPWOBSVYYE   JOCUXJBXTSXACM  BKRVYPATNSM     RYHCSEJIO       YFTSOCCMQXQU   
FAUFKQ          : JSTXC           EVLGVSGHJ       AFIJTKVKUUAG   
VGKCI           : PRDGHGYHTLYSJ   EAVWUJFWPV      GRIRMEBAO       OMAIOONF       
TMPJLNULLVJEDC  : QJTR            PYIMIDTRGD      IHRDEM          MPHHNTCPQJYE   
AHQIJ           : IEOSHXD         TRMXMQLAQB     
NTHEQNOUWFO     : XDNDA           YGMUP           PRYYKO          PXMHSRIQNLVGUR  GXTIB          
UBWKVKVRUDUWT   : CRRATDKQOME     QOVYNDFD        LDPOEDNXGDJA    LYXQRGLVOTOSTEN MRIEHTPXO      
HMISBVPJCG      : UJDJDBCL        NDYWGFKTLDJIB   QXFE            BVQKPTFN       
RDVWSHTT        : JNGJNMMRCO      KMQNLRYSJOJRDOM SMEIDHJSHFVJ    JRYETFAIBERD    PRYYKO          WKDRMF         
EPTDKOIHO       : SGSKSYINK      
HXOPQSLGEQO     : VAFLNQXBEA      AHQPIGDSYYESH   OFNW            AHFR           
ISCHNLBJUHBPML  : FGOMSYHOA       CDPEPXP         UHRNJHJMSBEYT  
UTUWBSORM       : MWNDS           QLMGRHLTRT      SKBEBYFPTPNL    MOBCOLMSAFBAK   VVAAF           PWCQFKX         KOXUFP          XEQMCWI        
FUPVKSGFWPU     : CRRATDKQOME     XCRGKGR         LAVGKOOXKLVCS  
QGEB            : OIFGJMAESIMD    CBFMKWUWRL      VIKTYBCSGIA     DJMHMWK         AKPPQBBS        PDKXRFKYPGY     DNRFCBN        
TNVBLRVKURBOGKU : MJOHGRMT        OFPGQDIAFQ      GSUPDHAHCSUEWHF
CSNXCSURPGLV    : FAKKHN          ALBCRKUEW       IEOSHXD         TBUVBVBVVW     
OGHCCKPTJBOBEGJ : YJJEGUIMJDVIH  
BKRVYPATNSM     : WXJYUAVQHQJWF   MTENIT          NUTKIFJVXPUF    XOWOEOXHV      
GIHUOPYSCP      : CDXUIIJA        VAFLNQXBEA      KSALIOSNNLJV   
LSGOWMXOPJJNK   : KNNJ            DKSNY          
OEOJQL          : XKQKFUCPPRWB    NMPOTAADEFSHTN  WJJAHT          ESMUWFPTR       XPDFPPICM      
CSKSKJON        : BIUVUKBUDKWXU  
DYTLOTXM        : XLQOPQKL        JGYKXXG         QXBQTBH         EJSJ            SSETIFRKNYXJCON
PXREI           : URJRNNFCKDB     WAMFHUBWSRMAB  
UNKEGXVIRGECRSR : FQKPSNVBUNBNJM  MGRJ            CBKAXHAIPD      WPSYEKWSGLBEYO 
XRRKIL          : OUNLXIOMFRQIW   IECVJP          EIBPR           KRXYSIDPNKFBYPA
UWYVQ           : BPCDHTIIAABPOB 
EMATAGBXCLP     : SOOWHAJWAWF     EOFAEAA         QYEDLKPC        SGXAIKJVX      
RUEKM           : SLKWBVLAJVXPP   NGBPHTQ         GXMI            VSBMREUEDRIGPR  SFIM            AQSXQJUYK       HFBBITIILDGRFOR BYPOOSLBVNX    
JGST            : FQKPSNVBUNBNJM  DJNIYGN         GGSEGEAGLL      TXUGPVC        
GEMDFIU         : CCBFGQNUBVQ     SLMNDARGIQXG    UGYARSHVBJ      BGGKEGDB       
OHOJJUM         : CTGAMMJUTA      FHJRC           UIHRMDGYOPX     PFQARLGO       
WAAJS           : OOFLLKWPBUXAP   XCRGKGR         YONMJGIIRQKTK   CSHXSVSHHIB     RRHDCLDGAWEGHHH
OFKOQSHMIORW    : DBKC            XUTI            QQWFFASPN       FFASBO          VTWGBOPXXTAVYQ  PMOPMFLAVYCXO  
YFOMVYBFIYR     : ENYS            YPKEXTLWCH      BFMMEXTDKHQTXW  CDPEPXP         YAMGJBEN       
XUTI            : BEYRLLK         OFKOQSHMIORW    BTOCDWUPHYF     UHVBK          
QWUBNMUXYFM     : VCXIVFMGWFFNFE 
CIUJXJFWKNH     : YTXTJJUGL       OUNINTXOEHS     HJRTPJYFXES    
HYKC            : CRBSEXTWCLITLC  OIHNSWBBOV      AVDFKVQVVVDT    UJWPGSQMUVMW    DNRFCBN         SCFKIDYNPQFDS  
URJRNNFCKDB     : TFBBSWUDHVCPJD  TVJWUCRK        PXREI           PSWCKSLVAXHUYMT JWADXR         
RWVDRFBBM       : INMWOKEWWDPXD   OHSSIPCLBFNVPJ  JXETK           ENMNFQXGIEQJVY  ULESGHYNNGBX   
NCHCKIMOD       : MRSWIMWXXIANWB  BICKNHEPXFAJ   
HPBWDI          : ROOXKOO         QBTOLMNPVJRV    PDPR            NBMUUOFLEPTHIVH MTENIT          JVYXLYHL       
POCHIBFLSMO     : JJRIOVKPTQXFGT  YXNTSSVCEXMK    DAMQABOXUBCO    AKVATXO         HBQR            PWCQFKX        
YQMEYOOJDFN     : RDPLRO          GIUWA          
MDPLIXMAORJ     : PAMFCLVPAIVISP  VCXIVFMGWFFNFE  ERUUKKGS        LTBBE           HNAXMOQRWV     
SONOBDK         : CRBSEXTWCLITLC  AOTXEVYCJV      RPUKPHUG        BEBECUBAA      
VYGWNWHQ        : LYKQFPSONYLKFWX VQGCUF         
WDRCSEKTSMKKVKE : NXCXKNMXSGQM    UGQPEMU         UIHRMDGYOPX     UQUQLSHKFQCP    AFGATMRGCQ     
BSNGFPCFWASVHMY : JAHXQX          CJPPLPVKN       JHCRVKKGKATMQXT MGRJ            AKPPQBBS        DRSBQFYNJQJIJ  
PRILXSFQHPCD    : TEJNHMVREQHPPP  NWSEQNLRMRR     VAPQNLHRVKBOKUD LLWNQGWFMG      FPVRTRFRTLBUDCU
IPGDDMISOPRQ    : NNTALFNF        WGGVXMT         YNUMVGBF        GNSNIPPFJDTBV   OVAEUUWMPV     
OXXPENJMYHHGB   : CIPSPKY         JUIMXQMPJBYO    LUWMRHSSAMDEF  
YFTE            : IVECHJSECPTE    VHBYBCA         TQEVFRCPWO      ERVD            VDVDM          
JKQOWBILRCFD    : NLXI            MHMMXO          FOLGEWJAMHF    
FBHKOQYQ        : BHAOCIPSKGYS    RIXLKPKA        VXCIBPLSSHXMBKC
JYEAXJWCYGMRXJ  : QXCRALBRWWLXFW  JWEJYWRJHPX     BKUUM           YDURHYWKMC      KDVTDECFCBRWH  
GXMI            : RUEKM           DYCIM           YYTDLNOVRWQMVAU PDGGDDXKTEG     EUKWROK        
PCIQLUIE        : SDEGI           GOJRUOOAFCHXC   ONNWAGWCIJ      WUWTEDMQIIYQRN  MPHHNTCPQJYE   
BHIAL           : FJCPVIWUEUN     BRGBAVBYNKIHFR  UQUQLSHKFQCP   
BWHDVQQ         : KYUBJHKUOJOTYPX OIFGJMAESIMD    JOJVOUMFKFPXBTD CVNRPJN         BKBLBSECUXKVLO  GYGFHUHRUS     
OCJWCVHH        : QYBXREEQLMASKNA YFOUCQNEGBFKBVA MFSFK           NQVBWEIBST     
LSHWPRCMULWV    : AJJNAWBRXT      HILCCL          NHRUIK          DIFSDANSJI      EMMUOLKSELRIDYY
IWUR            : XPYN            NVFX            DXRQ            LGBEYWWL        BEFILGXBNYBACLH GXTIB          
RKSHYX          : IAWDDELYKB      NFUSTJT         FNOX            BKUUM          
XCRGKGR         : QQVOFLBTJMEV    FUPVKSGFWPU     WAAJS           JRSHGSACECJPFN  KYHPOUEJBHDX   
PRSIVID         : XPYN            IJVTSJRGVYTLYJX DGLGFDJ         POQHLISKNRQGXSE
HBFRABKDUUXE    : CRRATDKQOME     SLDAWAVE        BUVM            CXPEKREAROXKWV  PYGXQRKJ       
VXUYRDLXXQN     : OAFURCXYFE      TOOAOCIK        EGAQBXPTITLV   
LXLTESEFYVGCIJY : GBDEPTARDEDHD  
HDDGDA          : UAOLVHGLCQTKIO  FIUVUEL         FYNJDVP         DGLGFDJ         LQPAUN         
UGUUELL         : SYVONSDSGKI     LJHFEXK         AKKRCNMJSM      BIMNRTVY       
WLHTPAXVBTEFFP  : LFRNQIO         UOXKOUDQKIHT    TDIEMSLQOFXJD   DIDPXLG        
LYKQFPSONYLKFWX : MPXVISVMNUC     VYGWNWHQ        HXQMFHBAG       FIRHEIYRR       LDRYKLVTY      
UKIQAJOX        : SKBEBYFPTPNL   
KESPTYDTLTBC    : GRSJ            CQANWWHG        CUXJSAWGHNLN    AOCNCMBO        BURBNJEFKA     
SROECUCBV       : BHAOCIPSKGYS    JKCFT           OCXC           
LFRNQIO         : YLWLSI          WLHTPAXVBTEFFP  YXBGNSJ         UMBYUEQI       
SSXLPXQJLLM     : DYCIM           RFBHMIQEAHOLPH  NGNPPSJIUJ      WRECAWHOOAYRNXB
BFHR            : HLMDUBSBO       YRCL            CFXXIIQWUV      GKOPHWUBV       ITDHOQVFHDABTRL
KMQNLRYSJOJRDOM : RDVWSHTT        IGXN            BAXF            SCFKIDYNPQFDS  
NAONRAYFMPIU    : JRYETFAIBERD    PMKUPEVORSEOYNE
AJJNAWBRXT      : UUUIQCSXWCCSTF  LSHWPRCMULWV    BLMQE           IHWW           
NFUSTJT         : LOONHNKMU       RKSHYX          JSXKXQYVVIPGAY  NAHOAF         
KIYEKBL         : OOFLLKWPBUXAP   XKRICKUPE       IGLVNLFKNYNJ    ADNGNXQWL       MDFAR           XOPTKXUEIVAYL  
STUPTE          : GQAYEKE         TQEVFRCPWO      ITKXFTGLSXTPLXD PDKXRFKYPGY    
JGYKXXG         : DYTLOTXM        HRWIBYHX        JTGASROPUG      QBTOLMNPVJRV   
NLXI            : OUNLXIOMFRQIW   JKQOWBILRCFD    BPDA           
HDTTNVXYWLYPFVH : WRBKKPQAQMNLM   SSRP           
AJLIJYGJFJW     : UOXKOUDQKIHT    TAAIUIOP        FOAVVT          DJBF           
HFEQIALYVLXUXW  : OTGPXKLKU       UGQPEMU         XEQMCWI        
FUWHWGTF        : XHWYGCDLAYUI    UEHBD           QOJPLGB         BIBQJ           METO            IPSE           
SLDAWAVE        : HBFRABKDUUXE    POQHLISKNRQGXSE IHWW            NQVBWEIBST     
CWSDIRY         : MGRJ            ASCFHAGFYUYKU   EUKWROK        
PWWOJCJGKG      : MDNUNWS         IGLVNLFKNYNJ   
ELHYYNBVNXCVAA  : TJXU            DEEGVQ          OHSSIPCLBFNVPJ  PXPRIJKMAH      KILISFDD       
FKJFJACGQ       : IECVJP          JOJVOUMFKFPXBTD DKSNY           SDEGI           FOLGEWJAMHF     XFMDLNBGFE     
JDUTLMAAVYYJ    : HDVKRAOWESD     BIIMMWPYDDL     SUQNHNFXXXHO   
XXACV           : VFVIJNXVUJUKS   DEEGVQ          HILCCL          FBNEAWQJAUKEX   HBLYHNIOUDYO   
ENIRXPBATIS     : DEEGVQ          LOXXMUIXRFTDYT  UDRFVOBAJR      FODUB           JFDGFX         
TVFNITNIPOJ     : SAMLP           FEPS            LLOBXQI         BICKNHEPXFAJ   
QJATOXW         : CVGAOFUV        RJXVJTRGFODOWH  ITCMFNYIHDA     TTGFHOVCQ      
MHMMXO          : JTBOACDXLPFJQ   JKQOWBILRCFD    ADNGNXQWL      
RYHCSEJIO       : WXJYUAVQHQJWF   QCHETQBDQMW     REDPSTBTMCAJLL  WMCJRTJKFXRCHFL
XWTMIV          : CNUC            QQWFFASPN       AKKRCNMJSM     
UVYJTXEIGRWE    : BFLMCL          YTXTJJUGL       VAFLNQXBEA      WVEPVVQLE      
LXJVBEAMMQQKPKY : LTODK           RDPLRO          SFIM           
GGSEGEAGLL      : JGST            VUOIXSXMWD      LTBBE           EVOFMPQNACLB   
DKSNY           : VTKHXVILB       LVSU            LSGOWMXOPJJNK   FKJFJACGQ       UNHHOJD         MWUEOETDVJWY    KKILQPUPKCVQSOX UMBQBUKIXMV    
DKSNY           : FBGQCFA        
YUUDWHRNX       : RQWFCCYVGI      DJNIYGN         ECJJAHELRULJUC  BKQD           
DKFDSLYY        : JJGRPXBMKQ      MPGWAFGGHGJQI   FLTSBDEJ       
DCBONNTXHJY     : NXCXKNMXSGQM    CSYONYEAQNOSD   MSFDKRQWP       IRAPUSUGYDEX   
KTVNQFHGGLLSQR  : GBDEPTARDEDHD   DEEGVQ          VWHMEXXSJIQ     LCNJPSRBKTQCN   LQPAUN         
DQNYVPANFQJGXV  : LLVGXEOTTMYMH   RQCCE           GXTIB          
BGAYWSEECMSNGJ  : LOBNKDCMHAL     OTJNNHCJYMK     PJCRPGUO       
UOXKOUDQKIHT    : JOCUXJBXTSXACM  XKQKFUCPPRWB    WLHTPAXVBTEFFP  AJLIJYGJFJW     XIIDFJMEA       YOBLAKLXYDHFJS  IDHDALV        
HRWIBYHX        : JGYKXXG         UUQTWRE         VDXEYDTSKNRUJ   JBSGSTDNMC     
OEVBWM          : SWAJMHIJKECTT   IQVCJEVLATP     CHMNSCIBOE     
JTGASROPUG      : WQHJVY          JGYKXXG         SRJMDPQMD      
FPXWXQ          : INCLY           GKJUXDY         ILVHPLLKCV      DMXAVYORIXEU    PMTWUUGWFVFMLF 
GRSQRMHVLKVX    : CCBFGQNUBVQ     UUUIQCSXWCCSTF  NXCXKNMXSGQM    EHNODROJR      
FRDFM           : XLQOPQKL        TWXWQCIL        GRIRMEBAO       PSNNXP         
WERFGAUFWSXSCPN : JSTXC           YRBMUUJSHHA     MEEDF          
JCCFNMDNJK      : OTTGBYGAUOXP    OVAWKRVEMWX    
NSUK            : CVGAOFUV        KFARDIDBFDOY    BICKNHEPXFAJ    TTGFHOVCQ      
AFWIFTPEPNYRFMO : MDLVBBUDYIVM    MDNUNWS         CJDAIYLHJL      JGCJLJWSOGML    BLIE            VVAAF           UXBEFCQHFHHUGGC EUKWROK        
QQWFFASPN       : LTUAS           SAMLP           OFKOQSHMIORW    XWTMIV          SFOTPHAVSCM    
DGYPXYUUJC      : QOJPLGB         APVUGYFIJJD     YUXNWRV         JOFHWGKDTICP   
AGGNHXVVOMNF    : HJLW           
SLMNDARGIQXG    : GEMDFIU         DYMNKTRWUQPX    YXBGNSJ        
TDBVTDFBTMBPJ   : TFBBSWUDHVCPJD  HVYHRLEJTJAWA  
CYXOTJDHMFYUNRT : EYOWJKF         SDVNW           YONMJGIIRQKTK   YRRC            RNKFMLNJPYUQ    IHRDEM          BHHW            HTGMVSIOTSXILRX
JPYNL           : FYNJDVP         TSAO            YNEE           
QSVKIAATQ       : BIUVUKBUDKWXU   NOMILYLDX       OFNW            FLFSDYDOQ       IRAPUSUGYDEX    REWENBDWBJ     
SOTMBWT         : BFLMCL          GPFETJLGEPI     IKEOASJOFVHLHY  PMTWUUGWFVFMLF 
CVNRPJN         : BWHDVQQ         DIXHOLTVL       WUWTEDMQIIYQRN  LJHFEXK         WVEPVVQLE      
YONMJGIIRQKTK   : WAAJS           CYXOTJDHMFYUNRT UJWPGSQMUVMW    ASCFHAGFYUYKU   MVCDYWEXYCQJUMQ
YDRUPUTLNXJ     : WFWSMJHMJCPI    HCIOIDAMYNRLLAG INEYYJY         QJTR            OVAWKRVEMWX    
PAMFCLVPAIVISP  : WJDQYAJBHK      NJTWRENKDPRH    KLSWLVQTJX      VWHMEXXSJIQ     MDPLIXMAORJ     FYNJDVP         OLWITSTUX       DGLGFDJ        
DKLGL           : WWPQTSTJQPULX   SRDDXVPFHISVB  
AJGVDUJCGM      : NKMSPCYO        PMTWUUGWFVFMLF 
GYCKMXAOGYX     : GQAYEKE         LWOSJD          JUGDYTJNLQ     
QYEDLKPC        : EMATAGBXCLP     QVDYAQJXFIPLWNT
YJJEGUIMJDVIH   : LTUAS           IFVUWGTGASNHC   OGHCCKPTJBOBEGJ UDNESTRRMWEY    EDILDKW         IILUKHK         QHCNWXJYDXFRX   AYXTYCKQYDAPKI 
WFJLOKLPBNU     : XEAVYIESUHBWXQ  UMBYUEQI        XSIDKNGOUCU     QMYXXR         
YFWBSVM         : SDVNW           RTEHVFKDEUQPJ   GOIVQOFKYNMYQ   TTBECDACQQJDDA  NTYBGQDUFMPSCBX
ASYJIK          : TMARUJ          KKTLQUMXM       TOOAOCIK        XRSYRX         
EUXKRDTGTET     : EJSJ           
GHFN            : HJLW            QBTOLMNPVJRV    MUSUTKSLGITN   
MKKGIYMK        : YEMOANUA       
OVDYKHUITO      : UPCJMN          AHQPIGDSYYESH   BGGKEGDB       
OUKUPUDY        : XLQOPQKL        SWAJMHIJKECTT   FBONYIRCIICAW  
QGPDSXLTKWOYSTY : GYJVSXGGQJJX    DBKC            QTVMYXXL       
BVQXKFMIS       : DLAGPPBG        GHJSQQ          HJVHYMFCL      
ANLYQEHGI       : NJTWRENKDPRH    NOMILYLDX       LOUFBBGEPGRUYDW LOSAYEQMFQTOVQC BUYIJHLNM       FJLBUBWACG     
ETWQSLS         : EGOPQTE         CJPPLPVKN       ALBCRKUEW       YNEE            XINA            PYGXQRKJ       
GRSJ            : KESPTYDTLTBC    PHDDN           RNKFMLNJPYUQ   
JHCRVKKGKATMQXT : BSNGFPCFWASVHMY BLIE            XJWPCSVXFGVWP   MFTPQGYDDLC     AANBRSKMQSR    
IWFDTY          : WGGHVFWA        TTBECDACQQJDDA 
FRKNL           : UIRROIJS        TWXWQCIL        BRGBAVBYNKIHFR  QXBQTBH         CQOMKIXWNW     
ABPJDJGQVMBVIN  : PEJVNW          KSBNI           RUNGAG          LDPOEDNXGDJA    OEQUDIVPFSCLAO 
GKOPHWUBV       : BFHR            JGCJLJWSOGML   
INEYYJY         : BJTSH           YDRUPUTLNXJ     FIUVUEL         VNYMWINTNGT     JOFHWGKDTICP    BAXF           
YIFIQVGFADN     : GBRSESHSQUEM    EHUQCWOPQICIHN  UIHRMDGYOPX     XEKHOU          IDHDALV        
SWAJMHIJKECTT   : OEVBWM          OUKUPUDY        LBJWGR         
UUQTWRE         : QMDFW           MJICUAPDBXV     HRWIBYHX        VAFLNQXBEA      TYAMJUIDN       TWXGCX          AEEAVJFOYOSN   
DVDJDFORVHO     : JAHXQX          BASIDQTOK       WVQHOEFQFPNECJ 
TDIEMSLQOFXJD   : WNGVVRTPVVN     WLHTPAXVBTEFFP  JOKYPI         
FAKKHN          : NUJHB           CSNXCSURPGLV    ABFHJHNFY       LVPQ           
LALQOFO         : CIPSPKY         WRBKKPQAQMNLM  
TNUYVY          : TJXU            RIXLKPKA        ERUUKKGS       
QKFISFTV        : GRRGP           IONKCOLER      
AXIMG           : SOOWHAJWAWF     TSAO            MKKWFDPAGPQ     IGXN            HJTO           
WRBKKPQAQMNLM   : HDTTNVXYWLYPFVH LALQOFO         FGOMSYHOA       OVXRSK          CFQUM           JFDGFX         
LAEXFMQMH       : NOMILYLDX       FHJKHBPR        NQRKRWLYOY      ESSVBEHLPPSP    KILISFDD        HBLYHNIOUDYO   
KJNTXTU         : HRIRJJMRFMRTH   LCNJPSRBKTQCN   BXMQAFROO      
NVFX            : JTBOACDXLPFJQ   IWUR            ATNYWUS         EYBBYGJDHLQNUTR
VAFLNQXBEA      : HXOPQSLGEQO     GIHUOPYSCP      UVYJTXEIGRWE    UUQTWRE         TIIOC          
FIUVUEL         : HGHQRYC         HDDGDA          INEYYJY         OTJNNHCJYMK     USIODKGAKKACPUF BHSCALETXYNTH  
NBCNUYIKUQI     : VJTUK           WCDGUQJCDVGDSJ  KQGQNSFOCQGRKVE
OJNA            : MHXYXEQ         EJSJ            PMOPMFLAVYCXO  
HADNBJS         : NQRKRWLYOY      YYTDLNOVRWQMVAU CDPEPXP        
GPGL            : SGSKSYINK       AVDFKVQVVVDT    NJISQEOAIMVTI   ASCFHAGFYUYKU  
MBEQPBPXLM      : SODJICMDF       LJHBRESKSSQ    
VVGHLGJUHMJI    : TEJNHMVREQHPPP  BXTCJAHFJYFG    CRRATDKQOME     XIAAELVXV      
CTETAP          : NGBPHTQ        
PRDGHGYHTLYSJ   : EOFAEAA         VGKCI           LUUMQUAPPV      DAMQABOXUBCO    IKEOASJOFVHLHY 
AVLJQSXCDVFWBYA : VFVIJNXVUJUKS   JAWDHJ          VVAAF          
YPKEXTLWCH      : IAJGKQ          YFOMVYBFIYR     BBFOX           AJNW           
BASIDQTOK       : UPCJMN          JSTXC           HLOONCS         DVDJDFORVHO     NBNKJR         
NMSJRSM         : MAOGSYTP        QLMGRHLTRT      CXPEKREAROXKWV 
SGSKSYINK       : TEJNHMVREQHPPP  EPTDKOIHO       GPGL           
RURUWMDAGWR     : ESJMW           HRIRJJMRFMRTH   GQVMPNNJG       NTYBGQDUFMPSCBX
OHFISADGTX      : AOMS           
OIHNSWBBOV      : HYKC            XQYRMUN         VQMW            RQDIBYJLKEU    
JUIMXQMPJBYO    : OXXPENJMYHHGB   REDPSTBTMCAJLL  KMVDAFGYXUOD    DRSBQFYNJQJIJ  
ROOXKOO         : RJXVJTRGFODOWH  HPBWDI          OBRFRDPJCAK    
WWPQTSTJQPULX   : DKLGL           VHOCFJBM        DEVEV           WKDRMF         
JOWBX           : VVDN           
AOMS            : USSTHYLNNMHXNWA OHFISADGTX      SJIMBE          BYHJD           MRIEHTPXO      
DSSUIURH        : SCCDOHAKTY      TEJNHMVREQHPPP  XLHNQ          
KBFHMVW         : IKTLFQU         APNA            HCIOIDAMYNRLLAG FQMVRMNVEUNJKW  VMVOHBAFQH      DYMNKTRWUQPX    UNLJWVME       
JUUVLTY         : RGMSOKHEEXJ    
TAAIUIOP        : TEJNHMVREQHPPP  EPNMHIWNJPJ     SPHLADGUN       AJLIJYGJFJW     TFPSU           KMUGVDP         VDVDM          
JAWDHJ          : RQWFCCYVGI      ADQDY           AVLJQSXCDVFWBYA VVDN            HSANA           RHVBVQLPQJL     KKIKRMRPPDJ    
LOXXMUIXRFTDYT  : ENIRXPBATIS     AANBRSKMQSR    
VVQESAUICELB    : MRSWIMWXXIANWB  NTNRBXDX        HRDI            HRHPKK          VQMW            CQOMKIXWNW     
SKBEBYFPTPNL    : UTUWBSORM       UKIQAJOX        RPGXRXSEH       AKVATXO         CHMNSCIBOE     
IQWEHSAA        : SOOWHAJWAWF     OYEUAAAPH       OAFURCXYFE      BLMQE          
UCUDGAO         : UFAVTHSRUVAMQFN QKDVIGILAIKAAL  HSOJDXWWP      
KKTLQUMXM       : QLMGRHLTRT      VOTWM           ASYJIK          ILNVPSUT        TXUGPVC        
QBTOLMNPVJRV    : CCBFGQNUBVQ     HCUP            HPBWDI          JGYKXXG         GHFN            DFEIKJSKY       KILISFDD       
MBERHGJRSVLGMJ  : XMRMKNSBBGTPAN  XPIESIOSMGQPVH  TQNMQISSYIVJLMS VVPWIE          TGPLIYTGHUNLWHY GQVMPNNJG      
NVBGWWU         : HRIRJJMRFMRTH   QQRQFTA         TOOAOCIK       
JKCFT           : SROECUCBV       ILNVPSUT        BMDDMQGHJQTD   
EDIFKDOSOGMKS   : GYSII           AEEAVJFOYOSN   
YEMOANUA        : MKKGIYMK        KFJUQQIRDEGXK   SRJMDPQMD       LDRKBWGPROJ     CWJAFVOVT      
PKWD            : HGKSCNHFQMFC    OAFURCXYFE      VBUMPKBPBCNTO   RDPLRO          DIXHOLTVL       BTOCDWUPHYF    
DWJJDUON        : OHSSIPCLBFNVPJ  JGYJF           UJWPGSQMUVMW   
FGOMSYHOA       : ISCHNLBJUHBPML  WRBKKPQAQMNLM   JBHITRBBQ       SRDDXVPFHISVB  
BPLQKL          : OTXQ            VWPLWA          SXTGFHCURRKW   
DYCIM           : EXCEOWDH        GXMI            SSXLPXQJLLM     KFJUQQIRDEGXK  
FXQI            : NBMUUOFLEPTHIVH CWJAFVOVT       SCFKIDYNPQFDS  
HXQMFHBAG       : HVYHRLEJTJAWA   LYKQFPSONYLKFWX MDNUNWS         FAJDKWW        
QJTR            : SODJICMDF       BIBQJ           TMPJLNULLVJEDC  YDRUPUTLNXJ     AHQPIGDSYYESH   LOSAYEQMFQTOVQC BXMQAFROO       PCSVTW         
ILNVPSUT        : YRCL            KKTLQUMXM       JKCFT           EVLGVSGHJ       EGEEMJSPH      
JBHITRBBQ       : FGOMSYHOA       MQMPGDFMWVQBRF  QRKPQVOTTULRRC 
QXCRALBRWWLXFW  : JYEAXJWCYGMRXJ  QOVYNDFD        BHSCALETXYNTH   WPBURQY        
EPFBJGLNPVHI    : SCCDOHAKTY      FNNMECSIYFLMMSH BLJBIBNGHLYFBS  FBGQCFA        
JBTA            : YTXTJJUGL       GKBBM           WUBAOOEWFKM     ONINLBGTPE     
YRBMUUJSHHA     : FVHOPSRYBES     WERFGAUFWSXSCPN UMBYUEQI        MEEDF          
SGXAIKJVX       : EMATAGBXCLP     SSRP           
RFJQQKLQLM      : OFPGQDIAFQ      USLQKJHAFJULPW  CDPEPXP        
PYIMIDTRGD      : TMPJLNULLVJEDC  FJLBUBWACG     
MDNUNWS         : LYSGOUHPDQOLEQP INMWOKEWWDPXD   PWWOJCJGKG      AFWIFTPEPNYRFMO HXQMFHBAG      
XKRICKUPE       : FKRCFMYPMKDAYKA VGAT            KIYEKBL         IHRDEM         
CRYD            : VTKHXVILB       UAOLVHGLCQTKIO  CUXJSAWGHNLN   
LNEI            : APNA            XOWOEOXHV       EHIFJMNAKC     
MNRYQH          : LWOSJD          YBTKQWUEUOHALN 
FEPS            : DYRGCSKT        TVFNITNIPOJ     BLJBIBNGHLYFBS  BKBRBVCSQK     
DMNFXIWCR       : WKMVLPCBFX      TQEVFRCPWO      DRNCI          
TQEVFRCPWO      : JOCUXJBXTSXACM  YFTE            STUPTE          DMNFXIWCR       LBJWGR          JYCHXTDTOVQ     PFQARLGO       
QOVYNDFD        : RGMSOKHEEXJ     UBWKVKVRUDUWT   QXCRALBRWWLXFW  HQFQKJSUM       HNAXMOQRWV     
IGLVNLFKNYNJ    : VGAT            KIYEKBL         PWWOJCJGKG     
RIXLKPKA        : FBHKOQYQ        TNUYVY          YKCRRCB         NXHJCJGCVCQL   
EQQDE           : GPFETJLGEPI     HRHPKK          CHMNSCIBOE     
IJVTSJRGVYTLYJX : YSSROCDNNTTNWSB BFLMCL          BGPUFYMHFYBEBVM SVPWNIXABSXDOO  PRSIVID         YFOUCQNEGBFKBVA
EGPPS           : SLKWBVLAJVXPP   IPFNHADMLSFYQB  VMVOHBAFQH      NJISQEOAIMVTI   LYXQRGLVOTOSTEN
DSCHLUKPTUCPO   : YXNTSSVCEXMK    RBGMWFSEDRVBGK  EMMUOLKSELRIDYY
CJDAIYLHJL      : CDXUIIJA        CCBFGQNUBVQ     AFWIFTPEPNYRFMO THNIWJORWXFVMSF HSOJDXWWP      
NTSFN           : OJBWJVHRYMLDBM  HBLVECNIYPM     SPHLADGUN       BPDA            NTYBGQDUFMPSCBX
IICPUXCKRAMKQJ  : EVFIJFUNHYO     SCFKIDYNPQFDS  
ANOJOCS         : IYFNXRCFP       QQXRHAT         LXYVV           XEAVYIESUHBWXQ 
OUNINTXOEHS     : CIUJXJFWKNH     GEMYPMEDYSVIDBW BVQKPTFN       
CSYONYEAQNOSD   : DCBONNTXHJY     LCNJPSRBKTQCN   PXPRIJKMAH      FDFGVTHCU       KDVTDECFCBRWH  
CSHXSVSHHIB     : WAAJS           KKILQPUPKCVQSOX FLFSDYDOQ       BXYGH           TAHLAKOB        BVBGHD          FJLBUBWACG     
YFOUCQNEGBFKBVA : OCJWCVHH        IJVTSJRGVYTLYJX ABVHXMAIG       MEEDF          
PEWTYFRRDMYM    : YAFWILQUBVN    
CUWKJTMBISJLYTP : JSXKXQYVVIPGAY  PSWCKSLVAXHUYMT WCDGUQJCDVGDSJ  CUXJSAWGHNLN    JNWW           
VHOCFJBM        : MVKTSVWKVYV     WWPQTSTJQPULX   VTWWJPHAQBX     AJNW           
TPSUF           : EVFIJFUNHYO     YXNTSSVCEXMK    IEOSHXD         EQOOQO          LQPAUN         
XAPIJK          : OMRUYPYETUEHF   OOFLLKWPBUXAP   LUUMQUAPPV      PWFHN           QKYEPFDQF      
MUQVGPRVOOG     : FVHOPSRYBES     MHKVOODDHX      XECTKSRI        XLKFTBHWOVRCUJQ
QNPSASOR        : TWDFLRRHDMABLM 
JWEJYWRJHPX     : CDXUIIJA        JYEAXJWCYGMRXJ  TKCSQGISMA      AFGATMRGCQ     
IUKAOJODPS      : KFEYOQVEGBJNYBU DKYYVPCGVDSGFV  IHRDEM          TTGFHOVCQ      
FIRHEIYRR       : TLXQWN          BIUVUKBUDKWXU   LYKQFPSONYLKFWX QXFE           
WCATVLDNKHVH    : KVBI            VVPWIE          FODUB          
VVDN            : JOWBX           JAWDHJ          VOHJNAILV      
UGYARSHVBJ      : GEMDFIU         NKMJTFOYR       NTWHSXVLNSEBJ  
SKMWKITWNH      : CFMQF           ERPLCE          CQANWWHG        EHIFJMNAKC      IRDD           
UGQPEMU         : CKCXGAUNPA      QYBXREEQLMASKNA WDRCSEKTSMKKVKE HFEQIALYVLXUXW  QWFMCKALHLKYR  
OQBPSS          : URLCSKCQ        XOWOEOXHV      
DQJMGFWVCJEX    : CFXXIIQWUV      OQRQ            YBTKQWUEUOHALN 
UIRROIJS        : FRKNL           AKPPQBBS       
FNOX            : RKSHYX          FOLGEWJAMHF     WGMAKYWHQKET   
FQHNTAAIGFHEJ   : IPFNHADMLSFYQB  TRMXMQLAQB     
LKCGSUXJFIEF    : MPXVISVMNUC     FKRCFMYPMKDAYKA
RUNGAG          : ABPJDJGQVMBVIN  EQGTNARTBU      JFDGFX         
PDPR            : CVGAOFUV        HPBWDI          ESMUWFPTR       BRNVQ          
YYTDLNOVRWQMVAU : XELIFTUCFS      GXMI            HADNBJS         NOTERCRA        KILISFDD        PMTWUUGWFVFMLF 
EAVWUJFWPV      : OTTGBYGAUOXP    SPHLADGUN       VGKCI          
UNHHOJD         : DKSNY           DAMQABOXUBCO    SCFKIDYNPQFDS  
USLQKJHAFJULPW  : DEVVXSRXIKDVPS  KIWGTG          RFJQQKLQLM      RYXYPBGE       
MUSUTKSLGITN    : HLMDUBSBO       GHFN            AHQPIGDSYYESH  
FSSALESXPCX     : ATJNPELBY       HGKSCNHFQMFC    WFIYVTDBNKSUVSF QKKBEJHEBROXGB 
LUIBURQR        : WJDQYAJBHK      NHWRQMXGWXMJ   
LLVGXEOTTMYMH   : DQNYVPANFQJGXV  HJRTPJYFXES     YFMPAAC         GNSNIPPFJDTBV  
AOTXEVYCJV      : SONOBDK        
MSFDKRQWP       : DCBONNTXHJY     LDRKBWGPROJ     XQYRMUN         WMCJRTJKFXRCHFL
WTOSNBRCL       : OBRFRDPJCAK     TKCSQGISMA     
ECOFGKE         : RFBHMIQEAHOLPH  EIKGBSALQHMMOHP XMJJQEAAYQ      EYFDXKXNVUA    
VCXIVFMGWFFNFE  : QWUBNMUXYFM     MDPLIXMAORJ     HBLYHNIOUDYO   
TWXWQCIL        : PCPOBWP         FRDFM           FRKNL           HQFQKJSUM       ONNWAGWCIJ      BDNRBRUJGJFGN   BHHW            OYYPCRYYERH    
KAMTMSGIUER     : BQSA            JFDGFX         
JGCJLJWSOGML    : EHUQCWOPQICIHN  AFWIFTPEPNYRFMO GKOPHWUBV       IPSE           
KFJUQQIRDEGXK   : TWPJJAO         LRDABHYN        YEMOANUA        DYCIM           CKBFNMLJDGUEBV  MLHX            PHPCJIVHBH      IDHDALV        
SRJMDPQMD       : NUJHB           MCKNVXXHNCQYME  JTGASROPUG      YEMOANUA        GEMYPMEDYSVIDBW
LWOSJD          : CGWSDQGPPJMBKVW GYCKMXAOGYX     MNRYQH          WJJAHT          QMLSKA          UHSDTQHUIE     
VIKTYBCSGIA     : BHAOCIPSKGYS    VFBTXFSMUJUY    QGEB            EVLGVSGHJ       DYMNKTRWUQPX    JQILUWURFVS     TTGFHOVCQ      
SRAKBOQQF       : KKILQPUPKCVQSOX
TFPSU           : TAAIUIOP        KKILQPUPKCVQSOX RHVBVQLPQJL     OMAIOONF       
FAJDKWW         : WKPHWBEMYV      HXQMFHBAG       FQMVRMNVEUNJKW  MXDTCAV         JRSHGSACECJPFN  PWVLEDOEEKXRLJ  NPFIF           WVEPVVQLE      
ABFHJHNFY       : OMRUYPYETUEHF   YXNTSSVCEXMK    FAKKHN          NXOKISVIRIV     AFIJTKVKUUAG    INTPTNXROJA     NTWHSXVLNSEBJ  
PAEGSJMORCIOM   : NRFCNC          CBFMKWUWRL      WFIYVTDBNKSUVSF UJDJDBCL        DJMHMWK         XDNDA           BDNRBRUJGJFGN  
OXQYUQKXRRFEYU  : AKPPQBBS        NQPWSM         
ALBCRKUEW       : CSNXCSURPGLV    ETWQSLS         UDOGEJLKDRE    
VBUMPKBPBCNTO   : PKWD            QVRMNSEPCQEXEF  GTPJ           
OHSSIPCLBFNVPJ  : QMDFW           FJCPVIWUEUN     RWVDRFBBM       ELHYYNBVNXCVAA  DWJJDUON       
OVXRSK          : WJDQYAJBHK      WRBKKPQAQMNLM   AJNW            AFIJTKVKUUAG   
DLAGPPBG        : BVQXKFMIS       ULHGBXTFVOEU   
PPVIYLMMPT      : GRRGP           OITUUAFFVG      PRCRKJQ        
LMLLDJJVCTF     : QHDOMJMB        EYFDXKXNVUA    
HHMYWNFA        : YOUYGUS         NTBLRRESCSGT   
VVPWIE          : MBERHGJRSVLGMJ  WCATVLDNKHVH    WGEB            TTBECDACQQJDDA 
AXJLKXWOHIM     : POYRGM          RJXVJTRGFODOWH  KKIKRMRPPDJ    
ERPLCE          : QHDOMJMB        SKMWKITWNH      LJDQHMNGX       PROJIPSEKBRFHU  DYMNKTRWUQPX    DRNCI           WPBURQY        
YRRC            : DEEGVQ          CYXOTJDHMFYUNRT BPDA            VTVDMRF         LOMXNWQDRUOS   
NXOKISVIRIV     : ABFHJHNFY       FQGUWVAEED      HRDI            JVYXLYHL       
GSUPDHAHCSUEWHF : BEYRLLK         MRSWIMWXXIANWB  TNVBLRVKURBOGKU
AHQPIGDSYYESH   : HXOPQSLGEQO     OVDYKHUITO      QJTR            MUSUTKSLGITN    MMJNSC         
APVUGYFIJJD     : VJTUK           JOCUXJBXTSXACM  HCUP            DGYPXYUUJC      YBTKQWUEUOHALN 
NBMUUOFLEPTHIVH : HPBWDI          FXQI           
OQRQ            : GIQRJF          DQJMGFWVCJEX    HRDI            ISNJBYQ        
NMPOTAADEFSHTN  : HGGKCRWGPCEMQ   OEOJQL          RTEHVFKDEUQPJ   JWJHXMKLGOD     WUBAOOEWFKM     NTYBGQDUFMPSCBX
IUPMKKUVG       : NWSEQNLRMRR     KYKOSSUPISIS    SUQNHNFXXXHO   
MWUEOETDVJWY    : DKSNY           MWIK            AQSXQJUYK      
CFQUM           : LJHEXHPAEJ      WRBKKPQAQMNLM   XOWOEOXHV      
KQSGGISQDOYHCWE : DEVVXSRXIKDVPS  XXPWDKLA        UWIVXNVGBLN    
LJDQHMNGX       : KNNJ            ERPLCE          NQNFTVPXYOWQFO  YMQYDEIEIHBFVNW
LRMACWQXFAGYSL  : PXPRIJKMAH      NTYBGQDUFMPSCBX
SSRP            : MDLVBBUDYIVM    HDTTNVXYWLYPFVH SGXAIKJVX       BBFOX           ABDPUJRWYOKDIJN BEQITAWJMBAAF  
BDIGTQUJYSBLMNL : YCLJIJJLYJQU    FLFSDYDOQ       UJWPGSQMUVMW   
KFPQFXRXJHS     : GQCXT           HQASO           FJLBUBWACG     
CKBFNMLJDGUEBV  : HGGKCRWGPCEMQ   UFAVTHSRUVAMQFN RJXVJTRGFODOWH  KFJUQQIRDEGXK   LDRKBWGPROJ     GTPJ           
OJEG            : WNSHISTTV       HDVAFGNKYEO     ILVHPLLKCV      MQMPGDFMWVQBRF  XINA           
LVPQ            : GIQRJF          FAKKHN          HQFQKJSUM       CHCMNTEUIAGXO  
HQFQKJSUM       : OPMOW           KLSWLVQTJX      FVHOPSRYBES     QOVYNDFD        TWXWQCIL        LVPQ            BLJBIBNGHLYFBS 
LBJWGR          : SWAJMHIJKECTT   TQEVFRCPWO      BBHJSUTV       
LTODK           : QYOUYRBXIINQ    LXJVBEAMMQQKPKY LOUFBBGEPGRUYDW QKDVIGILAIKAAL 
HQASO           : KFPQFXRXJHS     KWKXWCTBYUDDX   SVALBRHTBHP    
LKBDRRPDLMRLXT  : VOHJNAILV       QVRMNSEPCQEXEF  UXBEFCQHFHHUGGC CXTCLCL        
VAPQNLHRVKBOKUD : PRILXSFQHPCD    GGBIXDSVNWHS   
IPFNHADMLSFYQB  : SOOWHAJWAWF     EOFAEAA         EGPPS           FQHNTAAIGFHEJ   IQVCJEVLATP     GKBBM           MUJIKKXPUU     
OBRFRDPJCAK     : UEFESALKFEYRKRH ROOXKOO         WTOSNBRCL       TEIUAEVOVC     
NHWRQMXGWXMJ    : QQXRHAT         LUIBURQR        NDYWGFKTLDJIB   MQMPGDFMWVQBRF 
FQMVRMNVEUNJKW  : KBFHMVW         FAJDKWW         LAVGKOOXKLVCS  
LJHBRESKSSQ     : WKPHWBEMYV      MBEQPBPXLM      ITKXFTGLSXTPLXD JWJHXMKLGOD    
SDEGI           : PCIQLUIE        FKJFJACGQ       MDDOMED         MTENIT          NBNKJR          UMBYUEQI        KRXYSIDPNKFBYPA SPLW           
THNIWJORWXFVMSF : QFPILJIXQ       CJDAIYLHJL      UHIIKAAVPAXQWVF YNEE            GQFGEBBPN       UCBTAVWOAGJ    
TYAMJUIDN       : BXTCJAHFJYFG    QYBXREEQLMASKNA UUQTWRE         VPAPVWBXD       XECTKSRI        HSDXLCEXB      
GRIRMEBAO       : GCAFKM          VGKCI           FRDFM           ROKXBKSCVDQKBHK JVYXLYHL        HSOJDXWWP      
LDRKBWGPROJ     : YEMOANUA        MSFDKRQWP       CKBFNMLJDGUEBV  YFTSOCCMQXQU   
NLBAHJDU        : XIOPUQSKSXFKCG  OCXC            QYMCKGIB        KPUFUAGNA       GTPJ           
LOUFBBGEPGRUYDW : POGACYW         ANLYQEHGI       LTODK           QCHETQBDQMW     NGNPPSJIUJ      IRAPUSUGYDEX   
LOSAYEQMFQTOVQC : ANLYQEHGI       QJTR            YBTKQWUEUOHALN 
FYNJDVP         : HDDGDA          JPYNL           PAMFCLVPAIVISP  QCHETQBDQMW     METO           
DHQEKPEWEWYFC   : TQNMQISSYIVJLMS TOOAOCIK        WCDGUQJCDVGDSJ 
SJIMBE          : AOMS            WOXNFO         
FOLGEWJAMHF     : JKQOWBILRCFD    FKJFJACGQ       FNOX            TSAO           
XLHNQ           : CDXUIIJA        RQWFCCYVGI      JOJVOUMFKFPXBTD DSSUIURH        BPDA           
RPGXRXSEH       : SKBEBYFPTPNL    BVBQW          
FNNMECSIYFLMMSH : BCOQL           EPFBJGLNPVHI   
FOAVVT          : TMARUJ          AJLIJYGJFJW     QWFMCKALHLKYR  
CTGAMMJUTA      : OFOU            OHOJJUM         YMQYDEIEIHBFVNW HAQNKXDAYXSAL  
GEMYPMEDYSVIDBW : OUNINTXOEHS     SRJMDPQMD      
YUXNWRV         : IAJGKQ          DGYPXYUUJC      GNSNIPPFJDTBV   AJNW           
HILCCL          : GRRGP           LSHWPRCMULWV    XXACV           BLMQE           BXMQAFROO      
KSALIOSNNLJV    : BJTSH           GIHUOPYSCP      GKJUXDY         MPHHNTCPQJYE   
LUUMQUAPPV      : HKSRWETPOQ      KLSWLVQTJX      IMURN           PRDGHGYHTLYSJ   XAPIJK         
WGEB            : GUUY            VVPWIE          YKCRRCB        
RPUKPHUG        : JAHXQX          SONOBDK         NCPQLNX         LSNPSOHJBVC     CVVSFEU         HFVMQSXPWTC     XOPTKXUEIVAYL  
ITLURDIPYUI     : YLEEVTLWLELAK   SRDDXVPFHISVB   DIFSDANSJI      BIMNRTVY       
XXLTSKBYL       : TLTFWGGO        VHBYBCA         RTGFTYRKC       DIXHOLTVL       NHRUIK          CSLRJSXEC      
QCHETQBDQMW     : NCOWUHTCWNB     KGIIRYA         RYHCSEJIO       LOUFBBGEPGRUYDW FYNJDVP         FHJRC          
HRIRJJMRFMRTH   : CSIHDVJQV       KJNTXTU         RURUWMDAGWR     NVBGWWU        
GKJUXDY         : HGGKCRWGPCEMQ   MKLLD           FPXWXQ          KSALIOSNNLJV    DFEIKJSKY       LQPAUN         
JSXKXQYVVIPGAY  : NFUSTJT         CUWKJTMBISJLYTP YUESMXVB        NJISQEOAIMVTI  
PSWCKSLVAXHUYMT : HGHQRYC         LTUAS           URJRNNFCKDB     CUWKJTMBISJLYTP PXPRIJKMAH      CSLRJSXEC      
VOHJNAILV       : VVDN            LKBDRRPDLMRLXT  FHJRC           DXRQ            VTWGBOPXXTAVYQ  ISNJBYQ         UMBYUEQI        SUQNHNFXXXHO   
DEVEV           : WWPQTSTJQPULX   DIXHOLTVL       HFBBITIILDGRFOR NQPWSM         
WVQHOEFQFPNECJ  : DVDJDFORVHO     XEKHOU          XVDVMOYIKRNRO   XBILWH          CMYTDITKFIAO   
YBTKQWUEUOHALN  : MNRYQH          DQJMGFWVCJEX    APVUGYFIJJD     LOSAYEQMFQTOVQC
YKRPTJWC        : NSIX            IPSE           
CRQGTC          : CRBSEXTWCLITLC  IAWDDELYKB      BIBQJ          
UDRFVOBAJR      : ENIRXPBATIS     XRSYRX          INCC            BIMNRTVY       
LDWIDJCUGN      : FXOC            LMTDBTWYJMKF    NKMJTFOYR      
IQVCJEVLATP     : TWDFLRRHDMABLM  OEVBWM          IPFNHADMLSFYQB  PUSB           
BLIE            : QLMGRHLTRT      BGPUFYMHFYBEBVM AFWIFTPEPNYRFMO JHCRVKKGKATMQXT MVBGTEPRFQVKVMT IKEOASJOFVHLHY 
TWXGCX          : UUQTWRE         RYXYPBGE       
HHSFNHYXXXAH    : XMHAIGQKJ       BAXF           
YUESMXVB        : JSXKXQYVVIPGAY  BYHJD          
BPDA            : NLXI            NTSFN           YRRC            XLHNQ           XRSYRX          RNKFMLNJPYUQ   
JENAM           : FVHOPSRYBES     IGGBRMMLVN      HCUP            SRDDXVPFHISVB   TAHLAKOB       
URLCSKCQ        : OQBPSS          GQFGEBBPN       VDQAXKRIIU      NONCAN         
LTLHAGTBDUJGMO  : LVSU           
DAMQABOXUBCO    : POCHIBFLSMO     PRDGHGYHTLYSJ   UNHHOJD        
FFASBO          : XXPWDKLA        OFKOQSHMIORW   
CWWDCTOKJ       : LTUAS           RSEUMUQRWQIGR  
SMEIDHJSHFVJ    : YWQU            RDVWSHTT        VTWGBOPXXTAVYQ  NQVBWEIBST     
LOBNKDCMHAL     : DRITJ           BGAYWSEECMSNGJ  MDFAR          
EIBPR           : HJQJMD          OPMOW           XRRKIL          EDRGRELAIBRPJV  BBFOX           ATLREJGHSFTYN  
IEOSHXD         : QWJHYH          AHQIJ           CSNXCSURPGLV    TPSUF           FKAOGLEHAQ     
FKAOGLEHAQ      : KNUHBVWYGJW     IEOSHXD         SUURENQQUMILUKR
EDRGRELAIBRPJV  : DJNIYGN         EIBPR          
DFEIKJSKY       : VSVKKQKXJR      QBTOLMNPVJRV    GKJUXDY         ERUUKKGS        NQPWSM         
WFIYVTDBNKSUVSF : DACPLUCTVI      QTVMYXXL        FSSALESXPCX     PAEGSJMORCIOM   OVAEUUWMPV      AKKRCNMJSM     
MWIK            : SODJICMDF       MWUEOETDVJWY   
NSIX            : YKRPTJWC        XRSYRX          CVVSFEU         DIFSDANSJI      JBSGSTDNMC     
SQPTROYBNWWT    : MDFAR          
MGRJ            : QQVOFLBTJMEV    JLEMSDKOPWKPV   UNKEGXVIRGECRSR BSNGFPCFWASVHMY CWSDIRY         HRHPKK          DMXAVYORIXEU   
MOBCOLMSAFBAK   : UTUWBSORM      
RDPLRO          : YQMEYOOJDFN     LXJVBEAMMQQKPKY PKWD            AFIJTKVKUUAG   
INLEMBKGMMS     : TLXQWN          ILVHPLLKCV      NJSDDOGYBKBL   
PUSB            : KYUBJHKUOJOTYPX IQVCJEVLATP    
LDPOEDNXGDJA    : TNHLNEHLKLPQJI  FEKUVBQAWYU     QFPILJIXQ       UBWKVKVRUDUWT   ABPJDJGQVMBVIN  SNJYWOFETFPDA  
BIIMMWPYDDL     : JDUTLMAAVYYJ    MFTPQGYDDLC     GPCLJQD         KDVTDECFCBRWH  
HDVAFGNKYEO     : ECJJAHELRULJUC  OJEG            BTOCDWUPHYF     CMYTDITKFIAO   
ROKXBKSCVDQKBHK : GRIRMEBAO      
MXDTCAV         : VIUW            FAJDKWW         QQRQFTA         WCDGUQJCDVGDSJ  KWKXWCTBYUDDX  
ILVHPLLKCV      : FPXWXQ          OJEG            INLEMBKGMMS    
DJBF            : DACPLUCTVI      BORCVADEPEV     AJLIJYGJFJW     MTENIT          VTWWJPHAQBX     PJUFFSAEOPU    
GWTHGEOSFT      : TWDFLRRHDMABLM  HCIOIDAMYNRLLAG JWADXR         
JVMSFXOMPCBAH   : JROCAJEMU       BRNVQ           HAQNKXDAYXSAL  
KKILQPUPKCVQSOX : AQVPSPU         DKSNY           CSHXSVSHHIB     SRAKBOQQF       TFPSU           UJDJDBCL        XNQKPAQVBAW    
FHJRC           : OHOJJUM         QCHETQBDQMW     VOHJNAILV       TEIUAEVOVC     
RTEHVFKDEUQPJ   : NIBSJMMXLGUBO   YFWBSVM         NMPOTAADEFSHTN  NTNRBXDX       
FEYRI           : DNOSLWQOPRM     UYSRGBCNKOB    
LCNJPSRBKTQCN   : CRBSEXTWCLITLC  KTVNQFHGGLLSQR  KJNTXTU         CSYONYEAQNOSD   MKKWFDPAGPQ     NKMJTFOYR      
LMCX            : NUJHB           NJSDDOGYBKBL    LLWNQGWFMG      USIODKGAKKACPUF
ITKXFTGLSXTPLXD : STUPTE          LJHBRESKSSQ     XNQKPAQVBAW     WPSYEKWSGLBEYO  EQOOQO          NTYBGQDUFMPSCBX
PXPRIJKMAH      : MDLVBBUDYIVM    ELHYYNBVNXCVAA  CSYONYEAQNOSD   LRMACWQXFAGYSL  PSWCKSLVAXHUYMT
OLWITSTUX       : PAMFCLVPAIVISP  GQFGEBBPN       BBHJSUTV        AFGATMRGCQ     
BLJBIBNGHLYFBS  : EPFBJGLNPVHI    FEPS            HQFQKJSUM      
MDDOMED         : SDEGI           YFMPAAC        
EOTWIOXVPJHTRJ  : LOONHNKMU       NRFCNC          NAFOGDCFQ      
BQSA            : KAMTMSGIUER     DGMWWEAUHXYCCV 
VUOIXSXMWD      : TSSFHPFY        RQWFCCYVGI      GGSEGEAGLL     
BRGBAVBYNKIHFR  : TCGYPTBDG       EBQEEXITHMOX    CGKJASLU        BHIAL           FRKNL           VMVOHBAFQH      POEQVJXNV       UYSRGBCNKOB    
IKJKJFFXQFSQRS  : ECKRHQY        
ETMKWOGXPWL     : CVGAOFUV        YWQU            BYHJD          
ESSVBEHLPPSP    : LAEXFMQMH       YKHNRSNN       
XJWPCSVXFGVWP   : BMTFJNKD        XGYWI           JHCRVKKGKATMQXT LRWOTMGXLNLAD   VQGCUF         
MMJNSC          : AHQPIGDSYYESH   VWPLWA         
OFNW            : HXOPQSLGEQO     QSVKIAATQ       LSNPSOHJBVC     XEKHOU         
DMLSUJ          : BJTSH           NRFCNC          LRDABHYN        NKMSPCYO        EOBJOPB         UHRNJHJMSBEYT  
RBGMWFSEDRVBGK  : UEFESALKFEYRKRH RGMSOKHEEXJ     DSCHLUKPTUCPO   BVBQW           GXTIB          
UDNESTRRMWEY    : SODJICMDF       YJJEGUIMJDVIH   CVOXHRHQS       YNEE            TIIOC           TPYMDKWK       
BKUUM           : LOONHNKMU       NOOWJFBJ        JYEAXJWCYGMRXJ  RKSHYX          MWHQBHM         XBILWH         
HJKC            : OPMOW           DRITJ           EONHPTCPGQWV    OLXIEDDTAVL     SNJYWOFETFPDA  
NTNRBXDX        : JQEXBWNIFGPAV   VVQESAUICELB    RTEHVFKDEUQPJ   BYPOOSLBVNX    
SCWO            : UHSDTQHUIE      NHRUIK          UHRNJHJMSBEYT  
OEQUDIVPFSCLAO  : GYSII           ABPJDJGQVMBVIN  OTXQ            XIIDFJMEA       XVDVMOYIKRNRO   TTGFHOVCQ      
DGMWWEAUHXYCCV  : BQSA            YNUMVGBF       
VMVOHBAFQH      : YSSROCDNNTTNWSB QJKTCEGKSDA     APNA            KBFHMVW         EGPPS           BRGBAVBYNKIHFR  REWENBDWBJ     
VSBMREUEDRIGPR  : NKKBVWTWSAWOWT  RUEKM           PMOPMFLAVYCXO  
OTJNNHCJYMK     : LVSU            BGAYWSEECMSNGJ  FIUVUEL         PRYYKO          BYPOOSLBVNX    
TEIUAEVOVC      : RDWSGFNE        FWNCGGAV        KNNJ            OBRFRDPJCAK     FHJRC           QMYXXR         
CHCMNTEUIAGXO   : HKFXIJXUYKTR    LVPQ            ITDHOQVFHDABTRL IILUKHK         JGEJTDAYXVN     KOEGKNKFTDCY   
DAOPL           : BJTSH          
JRYETFAIBERD    : FVHOPSRYBES     RDVWSHTT        NAONRAYFMPIU    WKDRMF          VKLVYWF        
VPAPVWBXD       : TYAMJUIDN       FQYHKFEKAVSBBG 
MTENIT          : BKRVYPATNSM     HPBWDI          SDEGI           DJBF            EQGTNARTBU     
YGSAKO          : DGLGFDJ        
NWIRQNGNF       : MHKVOODDHX      EVFIJFUNHYO     UHIIKAAVPAXQWVF HNAXMOQRWV     
FDGIBKKQG       : TUDAT           HLOONCS         XNQKPAQVBAW    
EONHPTCPGQWV    : DLMUPF          VFVIJNXVUJUKS   HJKC           
FQGUWVAEED      : FWNCGGAV        NXOKISVIRIV     ONNWAGWCIJ      OVAEUUWMPV     
MHXYXEQ         : OJNA            XDNDA           KQGQNSFOCQGRKVE UNLJWVME        XOPTKXUEIVAYL  
UELL            : NRFCNC          GQCXT          
PDGGDDXKTEG     : GXMI           
DIXHOLTVL       : CVNRPJN         PKWD            XXLTSKBYL       DEVEV           MKKWFDPAGPQ     ERUUKKGS        ADRQVI         
TRMXMQLAQB      : EXCEOWDH        AHQIJ           FQHNTAAIGFHEJ   AEEAVJFOYOSN   
WJJAHT          : EYOWJKF         OEOJQL          LWOSJD          XIIDFJMEA      
NCPQLNX         : CGWSDQGPPJMBKVW COSBMPSXAUQNVR  RPUKPHUG        PWFHN           WPSYEKWSGLBEYO 
BUVM            : NXCXKNMXSGQM    HBFRABKDUUXE    BDNRBRUJGJFGN  
REDPSTBTMCAJLL  : RYHCSEJIO       JUIMXQMPJBYO   
UHIIKAAVPAXQWVF : HCUP            SVPWNIXABSXDOO  THNIWJORWXFVMSF NWIRQNGNF      
NJSDDOGYBKBL    : AQVPSPU         INLEMBKGMMS     LMCX            SFIM           
MAQVKBG         : HJLYXKIFLRYSR   MVCDYWEXYCQJUMQ YPPPJ          
BEBECUBAA       : QQVOFLBTJMEV    WCIMRRJTWR      SONOBDK         FBNEAWQJAUKEX   YRUBARDFAAYJC   EIKGBSALQHMMOHP
NKMSPCYO        : JAHXQX          AJGVDUJCGM      DMLSUJ          BGQYBRDSGHR    
JRSHGSACECJPFN  : MHKVOODDHX      XCRGKGR         FAJDKWW         HEEWNDNEIBFY    KYKOSSUPISIS   
LSNPSOHJBVC     : YFYFXEMKVFKE    FLTSBDEJ        RPUKPHUG        OFNW            UMBQBUKIXMV    
XEHGNYYXHSAJWEU : EGOPQTE         ITCMFNYIHDA     KYHPOUEJBHDX   
MLHX            : IAJGKQ          KFJUQQIRDEGXK   CHMNSCIBOE     
VNYMWINTNGT     : OAFURCXYFE      INEYYJY         KMVDAFGYXUOD    YOUYGUS         IRAPUSUGYDEX   
NAHOAF          : NFUSTJT         QKKBEJHEBROXGB  JVYXLYHL       
UIHRMDGYOPX     : BCOQL           OHOJJUM         WDRCSEKTSMKKVKE YIFIQVGFADN     LJHFEXK         BHHW           
NNTALFNF        : IPGDDMISOPRQ    EDILDKW         VQMW           
TBKJE           : GYSII           JOFHWGKDTICP    HJTO           
XEAVYIESUHBWXQ  : NWSEQNLRMRR     KFARDIDBFDOY    WFJLOKLPBNU     ANOJOCS         HRHPKK         
SFIM            : RUEKM           LXJVBEAMMQQKPKY NJSDDOGYBKBL    PROJIPSEKBRFHU 
VTVDMRF         : YRRC            BIMNRTVY       
CJRCPTYQCFLYOM  : FXOC            NUOKM           TGUYKIKXWQEIFO  EYBBYGJDHLQNUTR
MFSFK           : OCJWCVHH        TKCSQGISMA      HJRTPJYFXES    
TSAO            : JPYNL           AXIMG           FOLGEWJAMHF     WRKSEQXUUEIVVT  EVLGVSGHJ       DIDPXLG        
EDILDKW         : YJJEGUIMJDVIH   NNTALFNF        BPCDHTIIAABPOB  AQSXQJUYK      
NOOOFSTQR       : QYBXREEQLMASKNA CVOXHRHQS       JWADXR         
FQUKJCVN        : TQNMQISSYIVJLMS ITCMFNYIHDA     HBQR           
QQMHWQ          : PWVLEDOEEKXRLJ 
ITDHOQVFHDABTRL : BFHR            CHCMNTEUIAGXO   PROJIPSEKBRFHU  GTCRIFUN       
IILUKHK         : EWYVIXUL        NXCXKNMXSGQM    HIYFR           YJJEGUIMJDVIH   CHCMNTEUIAGXO   ABVHXMAIG       BYPOOSLBVNX     NPFIF          
ABVHXMAIG       : IXWAUN          NGBPHTQ         YFOUCQNEGBFKBVA IILUKHK         DNOSLWQOPRM    
PWVLEDOEEKXRLJ  : KFEYOQVEGBJNYBU FAJDKWW         QQMHWQ          MVCDYWEXYCQJUMQ
XEKHOU          : YIFIQVGFADN     WVQHOEFQFPNECJ  OFNW           
QQRQFTA         : TCCLKEN         NVBGWWU         MXDTCAV         CDNAKJHWWO     
WRKSEQXUUEIVVT  : TSAO            UJDJDBCL        PWCQFKX         BHSCALETXYNTH   BXMQAFROO      
VTJICAEMS       : XIAAELVXV       BUYIJHLNM       SXTGFHCURRKW   
GKBBM           : JBTA            IPFNHADMLSFYQB  OVAWKRVEMWX    
XECTKSRI        : MUQVGPRVOOG     TYAMJUIDN       WPTHGJGWKU      DYMNKTRWUQPX   
WQMS            : MRSWIMWXXIANWB  SVPWNIXABSXDOO  BUYVRVOYM       DNRFCBN        
RRHDCLDGAWEGHHH : XXPWDKLA        WAAJS           QETXXWEKSCXGAY 
XIAAELVXV       : QYOUYRBXIINQ    VVGHLGJUHMJI    VTJICAEMS       RSIUSICBU       DNRFCBN        
UMBQBUKIXMV     : OPMOW           LXYVV           DKSNY           LSNPSOHJBVC    
VVAAF           : UEFESALKFEYRKRH QJKTCEGKSDA     UTUWBSORM       AFWIFTPEPNYRFMO AVLJQSXCDVFWBYA DNRFCBN        
JOFHWGKDTICP    : DGYPXYUUJC      INEYYJY         TBKJE          
WEXPFSCOSPM     : MQMPGDFMWVQBRF 
LLWNQGWFMG      : PRILXSFQHPCD    LMCX            BEQITAWJMBAAF  
USIODKGAKKACPUF : HBDEGEOASVK     UUUIQCSXWCCSTF  FIUVUEL         LMCX            XNQKPAQVBAW     EQOOQO         
NUTKIFJVXPUF    : BCOQL           VGAT            BKRVYPATNSM     QVDYAQJXFIPLWNT AHFR           
DKYYVPCGVDSGFV  : LYSGOUHPDQOLEQP IUKAOJODPS      MJBDBED         HYGSV           JGEJTDAYXVN    
BBFOX           : LCBDHFIOK       YPKEXTLWCH      SSRP            EIBPR           QMLSKA          WVEPVVQLE      
BGGKEGDB        : MJOHGRMT        YLWLSI          GEMDFIU         OVDYKHUITO      QWFMCKALHLKYR  
JGYJF           : GPFETJLGEPI     DWJJDUON        QMLSKA         
BKCAPWIUSHVVNNT : TGPLIYTGHUNLWHY
OCXC            : JROCAJEMU       SROECUCBV       NLBAHJDU        KDVTDECFCBRWH   IKEOASJOFVHLHY 
GHJSQQ          : BVQXKFMIS       RYXYPBGE       
CXPEKREAROXKWV  : EOFAEAA         HBFRABKDUUXE    NMSJRSM         UDOGEJLKDRE    
MJBDBED         : DKYYVPCGVDSGFV  AANBRSKMQSR    
MKKWFDPAGPQ     : AXIMG           LCNJPSRBKTQCN   DIXHOLTVL       HEEWNDNEIBFY    BMDDMQGHJQTD   
BKQD            : GBDEPTARDEDHD   YUUDWHRNX       HJTO           
FBNEAWQJAUKEX   : TUDAT           XXACV           BEBECUBAA       PSGMPXCBF      
TKCSQGISMA      : JWEJYWRJHPX     WTOSNBRCL       MFSFK           UHSDTQHUIE      GXCMSYWKUBAAME 
YDURHYWKMC      : JYEAXJWCYGMRXJ  KPPYSBAVX      
LUWMRHSSAMDEF   : OXXPENJMYHHGB   EQGTNARTBU     
KPPYSBAVX       : NCOWUHTCWNB     YDURHYWKMC      NGNPPSJIUJ     
DXRQ            : IWUR            VOHJNAILV       PMKUPEVORSEOYNE SDIJTLFJR       OQLCXUYYRTRGT  
TDYQALJ         : JLEMSDKOPWKPV   HRHPKK         
ECKRHQY         : FLTSBDEJ        IKJKJFFXQFSQRS  RYXYPBGE       
ERVD            : JUBSCOIPART     KFARDIDBFDOY    RXNNQORWAFYHP   YFTE           
WGGVXMT         : KVBI            IPGDDMISOPRQ    TBUVBVBVVW     
DGLGFDJ         : KIWGTG          MPGWAFGGHGJQI   PRSIVID         HDDGDA          PAMFCLVPAIVISP  YGSAKO          BYPOOSLBVNX     BURBNJEFKA     
DGLGFDJ         : JNWW           
OTXQ            : EHUQCWOPQICIHN  BPLQKL          OEQUDIVPFSCLAO 
RXWQEBI         : FVHOPSRYBES    
HSANA           : JAWDHJ         
NOTERCRA        : KLSWLVQTJX      YYTDLNOVRWQMVAU YKCRRCB        
UJDJDBCL        : FDEOFOIGTEU     HMISBVPJCG      PAEGSJMORCIOM   KKILQPUPKCVQSOX WRKSEQXUUEIVVT  KYKOSSUPISIS    NTBLRRESCSGT   
DJMHMWK         : LVSU            QGEB            PAEGSJMORCIOM   XDNDA           MPHHNTCPQJYE   
QMLSKA          : LWOSJD          BBFOX           JGYJF          
GGBIXDSVNWHS    : QYOUYRBXIINQ    VAPQNLHRVKBOKUD FQEGSXJNEQH    
MFTPQGYDDLC     : JHCRVKKGKATMQXT BIIMMWPYDDL     MWHQBHM         UKOVRAAUCFL     PMTWUUGWFVFMLF  GTPJ           
XNQKPAQVBAW     : FJCPVIWUEUN     KKILQPUPKCVQSOX ITKXFTGLSXTPLXD FDGIBKKQG       USIODKGAKKACPUF
SUURENQQUMILUKR : UBQWCJKEYSBPAB  FKAOGLEHAQ      XBILWH         
VTWWJPHAQBX     : CNUC            CGWSDQGPPJMBKVW MJICUAPDBXV     LRDABHYN        VHOCFJBM        DJBF            GOIVQOFKYNMYQ  
BUYVRVOYM       : WQMS           
RHVBVQLPQJL     : XHXDRWBPOFQH    MRSWIMWXXIANWB  JAWDHJ          TFPSU           AVDFKVQVVVDT   
GUIOUYRT        : DLMUPF          YWIBAWGFMWLTJDP
UQUQLSHKFQCP    : KVBI            WDRCSEKTSMKKVKE BHIAL           XRSYRX         
FLFSDYDOQ       : QSVKIAATQ       CSHXSVSHHIB     BDIGTQUJYSBLMNL
JYCHXTDTOVQ     : HGKSCNHFQMFC    SYVONSDSGKI     TQEVFRCPWO      ERUUKKGS       
HJRTPJYFXES     : CIUJXJFWKNH     LLVGXEOTTMYMH   MFSFK           HJTO           
AVDFKVQVVVDT    : BXTCJAHFJYFG    HYKC            GPGL            RHVBVQLPQJL     FQEGSXJNEQH    
IPHF            : VAUTMOPQB       PLCNHISJN      
POQHLISKNRQGXSE : PRSIVID         SLDAWAVE        IRDD           
XQYRMUN         : OIHNSWBBOV      MSFDKRQWP       VQGCUF          OQLCXUYYRTRGT  
RFBHMIQEAHOLPH  : JSTXC           YRCL            SSXLPXQJLLM     ECOFGKE         CXTCLCL        
FBONYIRCIICAW   : CNUC            OUKUPUDY        MPHHNTCPQJYE   
PPQX            : TUDAT           YAFWILQUBVN     YAMGJBEN       
YKCRRCB         : KNNJ            RIXLKPKA        WGEB            NOTERCRA        DKPOBSHDAFPPY  
PSNNXP          : BFLMCL          QOJPLGB         HDVKRAOWESD     FRDFM          
NQNFTVPXYOWQFO  : UFAVTHSRUVAMQFN LJDQHMNGX       QXFE            SHRMOLGB       
BPCDHTIIAABPOB  : FQKPSNVBUNBNJM  HYSLPYOTYQNLLQ  UWYVQ           EDILDKW        
TOYHVUFLSGCPX   : OUNLXIOMFRQIW   ESJMW           XGYWI           BFMMEXTDKHQTXW 
GOIVQOFKYNMYQ   : YFWBSVM         VTWWJPHAQBX    
PROJIPSEKBRFHU  : LCBDHFIOK       BIUVUKBUDKWXU   BBORISCWBF      ERPLCE          SFIM            ITDHOQVFHDABTRL
HEEWNDNEIBFY    : HVYHRLEJTJAWA   HFCGOR          JRSHGSACECJPFN  MKKWFDPAGPQ     KRXYSIDPNKFBYPA
ERUUKKGS        : MDPLIXMAORJ     TNUYVY          DFEIKJSKY       DIXHOLTVL       JYCHXTDTOVQ     YMQYDEIEIHBFVNW EQOOQO         
AANBRSKMQSR     : AHIVGJUKYIMWJV  GYJVSXGGQJJX    QFPILJIXQ       JHCRVKKGKATMQXT LOXXMUIXRFTDYT  MJBDBED         YNEE            JGEJTDAYXVN    
PHDDN           : FXOC            TQNMQISSYIVJLMS GRSJ            UHRNJHJMSBEYT  
ESMUWFPTR       : CRRATDKQOME     MHKVOODDHX      OEOJQL          PDPR            HSDXLCEXB       BHHW           
BMDDMQGHJQTD    : XHWYGCDLAYUI    JKCFT           MKKWFDPAGPQ    
NDYWGFKTLDJIB   : HMISBVPJCG      NHWRQMXGWXMJ   
YWIBAWGFMWLTJDP : GUIOUYRT        PHPCJIVHBH     
METO            : TMARUJ          FUWHWGTF        FYNJDVP         LBLUUIO         NQPWSM         
CVOXHRHQS       : OOFLLKWPBUXAP   UDNESTRRMWEY    NOOOFSTQR      
RSIUSICBU       : TLTFWGGO        GYJVSXGGQJJX    AQVPSPU         XIAAELVXV       KOXUFP         
MQMPGDFMWVQBRF  : JBHITRBBQ       OJEG            NHWRQMXGWXMJ    WEXPFSCOSPM     OIRNCCOHVHXYMMR
BWHRSILNSJIBL   : EQOOQO          CQOMKIXWNW      BICKNHEPXFAJ   
XOWOEOXHV       : XPYN            BKRVYPATNSM     LNEI            OQBPSS          CFQUM          
HRDI            : CJPPLPVKN       VVQESAUICELB    NXOKISVIRIV     OQRQ            QKKBEJHEBROXGB  BHHW           
KILISFDD        : IAJGKQ          VRIDKFK         ELHYYNBVNXCVAA  LAEXFMQMH       QBTOLMNPVJRV    YYTDLNOVRWQMVAU BDAGKNF         RQCCE          
QVDYAQJXFIPLWNT : KIWGTG          QYEDLKPC        NUTKIFJVXPUF    NJXUEGQ         SRDDXVPFHISVB  
ADNGNXQWL       : TFBBSWUDHVCPJD  IGGBRMMLVN      XGYWI           KIYEKBL         MHMMXO          YVRAPAHMOVL    
RSEUMUQRWQIGR   : CWWDCTOKJ       YNEE           
QHCNWXJYDXFRX   : BBORISCWBF      YJJEGUIMJDVIH  
OLXIEDDTAVL     : HJKC            BYPOOSLBVNX    
PWFHN           : MKLLD           XAPIJK          NCPQLNX        
QRKPQVOTTULRRC  : XXPWDKLA        JBHITRBBQ      
PMKUPEVORSEOYNE : JUBSCOIPART     NAONRAYFMPIU    DXRQ            CQANWWHG       
EWHTNGIJAFXSW   : LYSGOUHPDQOLEQP PSGMPXCBF      
XPPIKHOIVHC     : CBFMKWUWRL      NXCXKNMXSGQM   
XDNDA           : MPGWAFGGHGJQI   NTHEQNOUWFO     PAEGSJMORCIOM   MHXYXEQ         DJMHMWK         GIUWA          
AKPPQBBS        : VUMRMBK         QGEB            BSNGFPCFWASVHMY UIRROIJS        OXQYUQKXRRFEYU  HSOJDXWWP      
YNEE            : BORCVADEPEV     JPYNL           ETWQSLS         THNIWJORWXFVMSF UDNESTRRMWEY    AANBRSKMQSR     RSEUMUQRWQIGR   KQGQNSFOCQGRKVE
VTWGBOPXXTAVYQ  : TWDFLRRHDMABLM  OFKOQSHMIORW    VOHJNAILV       SMEIDHJSHFVJ    YKHNRSNN       
BKBLBSECUXKVLO  : CMFPK           BWHDVQQ         NHRUIK         
AKVATXO         : POCHIBFLSMO     SKBEBYFPTPNL   
XMHAIGQKJ       : MVKTSVWKVYV     FVHOPSRYBES     NGBPHTQ         HHSFNHYXXXAH    RWMYGNTVRY     
NXHJCJGCVCQL    : CFXXIIQWUV      RIXLKPKA       
QXBQTBH         : HXYWBTIMC       KLSWLVQTJX      PEJVNW          DYTLOTXM        FRKNL           ITCMFNYIHDA     DNRFCBN        
BTOCDWUPHYF     : XUTI            PKWD            HDVAFGNKYEO     YRUBARDFAAYJC   PJCRPGUO        UHRNJHJMSBEYT  
GOJRUOOAFCHXC   : HGGKCRWGPCEMQ   PCIQLUIE       
RWMYGNTVRY      : EYOWJKF         XMHAIGQKJ      
POEQVJXNV       : BRGBAVBYNKIHFR 
KKIKRMRPPDJ     : HCIOIDAMYNRLLAG JAWDHJ          AXJLKXWOHIM     OVAWKRVEMWX     VKLVYWF        
PJUFFSAEOPU     : QJKTCEGKSDA     DJBF           
GQFGEBBPN       : THNIWJORWXFVMSF URLCSKCQ        OLWITSTUX      
CFYWW           : XMJJQEAAYQ     
AHFR            : VJTUK           HXOPQSLGEQO     NUTKIFJVXPUF    PFQARLGO        XRSYRX         
AYXTYCKQYDAPKI  : FHJKHBPR        YJJEGUIMJDVIH   DIDPXLG        
LLOBXQI         : TVFNITNIPOJ    
NGNPPSJIUJ      : JNGJNMMRCO      WPUUHRAREAO     SSXLPXQJLLM     LOUFBBGEPGRUYDW KPPYSBAVX      
QKKBEJHEBROXGB  : FSSALESXPCX     NAHOAF          HRDI            LMTDBTWYJMKF   
HYGSV           : BXJEK           DKYYVPCGVDSGFV  NJISQEOAIMVTI  
BLMQE           : AJJNAWBRXT      IQWEHSAA        HILCCL          YOUYGUS         LJHFEXK        
BBHJSUTV        : NOSJJVJEAXBJBJO LBJWGR          OLWITSTUX       VAUTMOPQB       HJVHYMFCL      
FDFGVTHCU       : DENMSWVNLRCSV   WCQSPWOBSVYYE   CSYONYEAQNOSD  
LVCETYFFNXLLY   : DENMSWVNLRCSV   IRAPUSUGYDEX    YOBLAKLXYDHFJS  NTBLRRESCSGT   
TIIOC           : DYRGCSKT        BIBQJ           VAFLNQXBEA      UDNESTRRMWEY    JQILUWURFVS    
NJISQEOAIMVTI   : GCAFKM          GPGL            EGPPS           JSXKXQYVVIPGAY  HYGSV          
BDAGKNF         : KILISFDD        TGUYKIKXWQEIFO 
YGMUP           : FWNCGGAV        NTHEQNOUWFO     BKBRBVCSQK     
LTBBE           : MDPLIXMAORJ     GGSEGEAGLL      VDQAXKRIIU      AFIJTKVKUUAG   
VWPLWA          : BPLQKL          MMJNSC          ATNYWUS        
UWIVXNVGBLN     : TCGYPTBDG       TNHLNEHLKLPQJI  WPUUHRAREAO     KQSGGISQDOYHCWE XPDFPPICM      
NUOKM           : OMRUYPYETUEHF   CJRCPTYQCFLYOM  LGBEYWWL       
WGMAKYWHQKET    : TWPJJAO         FNOX           
AQSXQJUYK       : RUEKM           MWUEOETDVJWY    EDILDKW        
PKVMBHYM        : BXJEK           RGMSOKHEEXJ     IAWDDELYKB     
FBGQCFA         : VSVKKQKXJR      DKSNY           EPFBJGLNPVHI    ODQBVCVKKH      BURBNJEFKA     
PHPCJIVHBH      : KFJUQQIRDEGXK   YWIBAWGFMWLTJDP XPDFPPICM      
ATLREJGHSFTYN   : EIBPR           WRECAWHOOAYRNXB IKEOASJOFVHLHY  JFDGFX         
IGXN            : IGGBRMMLVN      KFARDIDBFDOY    KMQNLRYSJOJRDOM AXIMG           UHSDTQHUIE      UNLJWVME       
TGPLIYTGHUNLWHY : YPLCPHUOH       MBERHGJRSVLGMJ  BKCAPWIUSHVVNNT SNJYWOFETFPDA  
NJXUEGQ         : TMARUJ          QVDYAQJXFIPLWNT QYMCKGIB        ODQBVCVKKH     
TOOAOCIK        : QMDFW           FKRCFMYPMKDAYKA VXUYRDLXXQN     ASYJIK          NVBGWWU         DHQEKPEWEWYFC   KMVDAFGYXUOD   
YVRAPAHMOVL     : LYSGOUHPDQOLEQP ADNGNXQWL       YOBLAKLXYDHFJS 
UDOGEJLKDRE     : FLTSBDEJ        RXNNQORWAFYHP   ALBCRKUEW       CXPEKREAROXKWV  CHMNSCIBOE     
GGGK            : HJQJMD          KGIIRYA         WOXNFO          UMBYUEQI       
QVRMNSEPCQEXEF  : VBUMPKBPBCNTO   LKBDRRPDLMRLXT  WOXNFO          WUBAOOEWFKM    
ITCMFNYIHDA     : TMARUJ          QJATOXW         XEHGNYYXHSAJWEU FQUKJCVN        QXBQTBH         VAUTMOPQB       ATNYWUS        
LGBEYWWL        : IWUR            NUOKM           SSETIFRKNYXJCON
PRCRKJQ         : CKCXGAUNPA      UBQWCJKEYSBPAB  PPVIYLMMPT      DNOSLWQOPRM    
OMAIOONF        : INCLY           FXOC            VGKCI           TFPSU           BAXF            ABDPUJRWYOKDIJN
YMQYDEIEIHBFVNW : TSSFHPFY        OUNLXIOMFRQIW   LJDQHMNGX       CTGAMMJUTA      ERUUKKGS       
PRYYKO          : QTVMYXXL        NTHEQNOUWFO     RDVWSHTT        OTJNNHCJYMK     CSLRJSXEC      
WOXNFO          : SJIMBE          GGGK            QVRMNSEPCQEXEF  PWCQFKX        
SNGLOJP         : WFWSMJHMJCPI    CMYTDITKFIAO   
NAFOGDCFQ       : EOTWIOXVPJHTRJ 
WPTHGJGWKU      : NOSJJVJEAXBJBJO XECTKSRI       
YNUMVGBF        : IAJGKQ          IPGDDMISOPRQ    DGMWWEAUHXYCCV  KDOXEUF        
BUYIJHLNM       : VHBYBCA         PSGERLCTNCMWI   ANLYQEHGI       VTJICAEMS       IKEOASJOFVHLHY 
KMUGVDP         : XIOPUQSKSXFKCG  TAAIUIOP       
BAXF            : KMQNLRYSJOJRDOM INEYYJY         HHSFNHYXXXAH    OMAIOONF        HJICU           QWFMCKALHLKYR   SPLW            BVQKPTFN       
NBNKJR          : BASIDQTOK       SDEGI           UNLJWVME       
ISNJBYQ         : DENMSWVNLRCSV   TUDAT           OQRQ            VOHJNAILV      
PFQARLGO        : OVIMGYILHHN     OHOJJUM         TQEVFRCPWO      AHFR            TAHLAKOB       
XRSYRX          : XHWYGCDLAYUI    RQWFCCYVGI      ASYJIK          UDRFVOBAJR      BPDA            NSIX            UQUQLSHKFQCP    AHFR           
XRSYRX          : TTBECDACQQJDDA 
HBQR            : DYKLEXFEQXSOXJC FQDACR          POCHIBFLSMO     FQUKJCVN        NTBLRRESCSGT   
KMVDAFGYXUOD    : HJLYXKIFLRYSR   JUIMXQMPJBYO    VNYMWINTNGT     TOOAOCIK       
OVAWKRVEMWX     : JCCFNMDNJK      YDRUPUTLNXJ     GKBBM           KKIKRMRPPDJ     CSLRJSXEC      
YFMPAAC         : LLVGXEOTTMYMH   MDDOMED         XLKFTBHWOVRCUJQ DKPOBSHDAFPPY   OYYPCRYYERH    
XFMDLNBGFE      : FKJFJACGQ       BTMURUIUU       ONINLBGTPE     
VAUTMOPQB       : IPHF            BBHJSUTV        ITCMFNYIHDA     PWCQFKX        
ONNWAGWCIJ      : TFBBSWUDHVCPJD  OIFGJMAESIMD    PCIQLUIE        TWXWQCIL        FQGUWVAEED      AKKRCNMJSM     
QXFE            : HMISBVPJCG      FIRHEIYRR       NQNFTVPXYOWQFO  IONKCOLER      
GNSNIPPFJDTBV   : INMWOKEWWDPXD   IPGDDMISOPRQ    LLVGXEOTTMYMH   YUXNWRV        
RNKFMLNJPYUQ    : BCOQL           CYXOTJDHMFYUNRT GRSJ            BPDA            SFOTPHAVSCM    
SXTGFHCURRKW    : BPLQKL          VTJICAEMS      
PSGMPXCBF       : CAUJXVMLLJBQF   FBNEAWQJAUKEX   EWHTNGIJAFXSW   XQVPNIVTOBTJ    DTAQYJIOKNMD   
OVAEUUWMPV      : ESJMW           IPGDDMISOPRQ    WFIYVTDBNKSUVSF FQGUWVAEED     
VDQAXKRIIU      : URLCSKCQ        LTBBE           VDXEYDTSKNRUJ  
BDNRBRUJGJFGN   : MJOHGRMT        TWXWQCIL        PAEGSJMORCIOM   BUVM           
DNOSLWQOPRM     : SYVONSDSGKI     FEYRI           ABVHXMAIG       PRCRKJQ        
JWJHXMKLGOD     : KNUHBVWYGJW     GCAFKM          CMFPK           NMPOTAADEFSHTN  LJHBRESKSSQ     EGAQBXPTITLV   
XLKFTBHWOVRCUJQ : MUQVGPRVOOG     YFMPAAC        
BFMMEXTDKHQTXW  : CKCXGAUNPA      GQCXT           YFOMVYBFIYR     TOYHVUFLSGCPX   TTBECDACQQJDDA 
XIIDFJMEA       : JAHXQX          UOXKOUDQKIHT    OEQUDIVPFSCLAO  WJJAHT         
WCDGUQJCDVGDSJ  : NKKBVWTWSAWOWT  NBCNUYIKUQI     CUWKJTMBISJLYTP DHQEKPEWEWYFC   MXDTCAV         LBLUUIO         UCBTAVWOAGJ    
CBKAXHAIPD      : VRIDKFK         UNKEGXVIRGECRSR
YRUBARDFAAYJC   : BEBECUBAA       BTOCDWUPHYF     BHSCALETXYNTH   UNLJWVME       
HJICU           : BAXF           
EVLGVSGHJ       : UYJQRCHV        FAUFKQ          ILNVPSUT        VIKTYBCSGIA     TSAO           
WKDRMF          : UYJQRCHV        RDVWSHTT        WWPQTSTJQPULX   JRYETFAIBERD   
RNLSMWUQHGBJ    : GUUY           
CQANWWHG        : KESPTYDTLTBC    SKMWKITWNH      PMKUPEVORSEOYNE
SRDDXVPFHISVB   : DKLGL           FGOMSYHOA       ITLURDIPYUI     JENAM           QVDYAQJXFIPLWNT
UXBEFCQHFHHUGGC : DYKLEXFEQXSOXJC YWQU            AFWIFTPEPNYRFMO LKBDRRPDLMRLXT  UJWPGSQMUVMW    GXTIB          
MWHQBHM         : BKUUM           MFTPQGYDDLC     EOBJOPB         KPUFUAGNA       UHRNJHJMSBEYT  
MVBGTEPRFQVKVMT : BLIE            SFXOTWEAGAKSIT 
VDVDM           : YFTE            TAAIUIOP       
RYXYPBGE        : WKMVLPCBFX      USLQKJHAFJULPW  TWXGCX          GHJSQQ          ECKRHQY        
VDXEYDTSKNRUJ   : HRWIBYHX        VDQAXKRIIU      NTYBGQDUFMPSCBX
QKDVIGILAIKAAL  : NXTYUSIL        UCUDGAO         LTODK           EGEEMJSPH       INTPTNXROJA    
HIEMHKLMF       : OTTGBYGAUOXP    HBWCLLVXR       JOCUXJBXTSXACM  FKRCFMYPMKDAYKA TQKAULI        
WUWTEDMQIIYQRN  : PCIQLUIE        CVNRPJN        
CXTCLCL         : LKBDRRPDLMRLXT  RFBHMIQEAHOLPH 
JXETK           : WNSHISTTV       RWVDRFBBM       SSETIFRKNYXJCON OIRNCCOHVHXYMMR
BRNVQ           : NJTWRENKDPRH    PDPR            JVMSFXOMPCBAH   AJNW           
CVVSFEU         : XXPWDKLA        RPUKPHUG        NSIX           
XINA            : JNGJNMMRCO      SPHLADGUN       VGAT            ETWQSLS         OJEG            AEVSAXGEP      
HFVMQSXPWTC     : EPNMHIWNJPJ     RPUKPHUG        JSIHBBFGU      
XVDVMOYIKRNRO   : WNSHISTTV       BIBQJ           WVQHOEFQFPNECJ  OEQUDIVPFSCLAO 
PWCQFKX         : OIFGJMAESIMD    UTUWBSORM       POCHIBFLSMO     WRKSEQXUUEIVVT  WOXNFO          VAUTMOPQB       AEVSAXGEP      
YOUYGUS         : WCQSPWOBSVYYE   HHMYWNFA        VNYMWINTNGT     BLMQE          
KQGQNSFOCQGRKVE : NBCNUYIKUQI     MHXYXEQ         YNEE            MDFAR           TBQEEFKV       
UHSDTQHUIE      : LWOSJD          SCWO            TKCSQGISMA      IGXN            YXBGNSJ        
QYMCKGIB        : IYFNXRCFP       NLBAHJDU        NJXUEGQ         UNLJWVME       
EIKGBSALQHMMOHP : ECOFGKE         BEBECUBAA      
BYHJD           : YPLCPHUOH       RJXVJTRGFODOWH  AOMS            YUESMXVB        ETMKWOGXPWL    
CDPEPXP         : OFOU            ISCHNLBJUHBPML  YFOMVYBFIYR     HADNBJS         RFJQQKLQLM     
TTBECDACQQJDDA  : YFWBSVM         IWFDTY          VVPWIE          XRSYRX          BFMMEXTDKHQTXW 
UKOVRAAUCFL     : SLKWBVLAJVXPP   MFTPQGYDDLC    
UJWPGSQMUVMW    : GYJVSXGGQJJX    HYKC            YONMJGIIRQKTK   DWJJDUON        BDIGTQUJYSBLMNL UXBEFCQHFHHUGGC
EJSJ            : FWABFBOJE       RDWSGFNE        DYTLOTXM        EUXKRDTGTET     OJNA            KYHPOUEJBHDX    YAMGJBEN       
IHWW            : WCQSPWOBSVYYE   AJJNAWBRXT      SLDAWAVE        NTYBGQDUFMPSCBX
QWFMCKALHLKYR   : XMRMKNSBBGTPAN  OVIMGYILHHN     UGQPEMU         FOAVVT          BGGKEGDB        BAXF           
SFXOTWEAGAKSIT  : XMRMKNSBBGTPAN  HBLVECNIYPM     MVBGTEPRFQVKVMT
GYGFHUHRUS      : BWHDVQQ         HFBBITIILDGRFOR
HFBBITIILDGRFOR : ENYS            FLTSBDEJ        RUEKM           DEVEV           GYGFHUHRUS      NQVBWEIBST     
HBLYHNIOUDYO    : PSGERLCTNCMWI   NQRKRWLYOY      XXACV           LAEXFMQMH       VCXIVFMGWFFNFE  JNWW           
TQKAULI         : VUMLTW          HIEMHKLMF      
WRECAWHOOAYRNXB : NGBPHTQ         SSXLPXQJLLM     ATLREJGHSFTYN  
GQVMPNNJG       : KVBI            RURUWMDAGWR     MBERHGJRSVLGMJ 
LBLUUIO         : METO            WCDGUQJCDVGDSJ  AKKRCNMJSM     
KOXUFP          : YLEEVTLWLELAK   UTUWBSORM       RSIUSICBU      
EHIFJMNAKC      : TVJWUCRK        YFYFXEMKVFKE    LNEI            SKMWKITWNH      PJCRPGUO       
XPDFPPICM       : OEOJQL          UWIVXNVGBLN     PHPCJIVHBH      SNJYWOFETFPDA  
MDFAR           : VUMRMBK         HCUP            KIYEKBL         LOBNKDCMHAL     SQPTROYBNWWT    KQGQNSFOCQGRKVE TBQEEFKV       
UYSRGBCNKOB     : OFOU            FEYRI           BRGBAVBYNKIHFR  BTMURUIUU      
AEEAVJFOYOSN    : HXYWBTIMC       UUQTWRE         EDIFKDOSOGMKS   TRMXMQLAQB      SVALBRHTBHP    
FQYHKFEKAVSBBG  : ESJMW           HFCGOR          VPAPVWBXD       QVRLDLAOSJE    
PJCRPGUO        : INMWOKEWWDPXD   BGAYWSEECMSNGJ  BTOCDWUPHYF     EHIFJMNAKC      WUBAOOEWFKM    
ADRQVI          : XIOPUQSKSXFKCG  DIXHOLTVL      
DYMNKTRWUQPX    : LXYVV           SLMNDARGIQXG    KBFHMVW         VIKTYBCSGIA     ERPLCE          XECTKSRI        DMXAVYORIXEU   
XMJJQEAAYQ      : JJGRPXBMKQ      MDLVBBUDYIVM    ECOFGKE         CFYWW          
BTMURUIUU       : XFMDLNBGFE      UYSRGBCNKOB    
IHRDEM          : TMPJLNULLVJEDC  CYXOTJDHMFYUNRT XKRICKUPE       IUKAOJODPS      EOBJOPB        
VKLVYWF         : JRYETFAIBERD    KKIKRMRPPDJ     EYBBYGJDHLQNUTR
BHSCALETXYNTH   : IAWDDELYKB      FIUVUEL         QXCRALBRWWLXFW  WRKSEQXUUEIVVT  YRUBARDFAAYJC  
QETXXWEKSCXGAY  : VFBTXFSMUJUY    RRHDCLDGAWEGHHH
HRHPKK          : OJBWJVHRYMLDBM  HVYHRLEJTJAWA   VVQESAUICELB    EQQDE           MGRJ            XEAVYIESUHBWXQ  TDYQALJ        
VQMW            : BIUVUKBUDKWXU   OIHNSWBBOV      VVQESAUICELB    NNTALFNF       
CQYLJFI         : KWKXWCTBYUDDX  
EHNODROJR       : DYRGCSKT        GRSQRMHVLKVX    GTCRIFUN       
PYGXQRKJ        : OFPGQDIAFQ      HBFRABKDUUXE    ETWQSLS        
BXMQAFROO       : KJNTXTU         QJTR            HILCCL          WRKSEQXUUEIVVT 
YXBGNSJ         : HCIOIDAMYNRLLAG LFRNQIO         SLMNDARGIQXG    UHSDTQHUIE     
JVYXLYHL        : MHKVOODDHX      KFEYOQVEGBJNYBU HPBWDI          NXOKISVIRIV     GRIRMEBAO       NAHOAF          WJSK           
BVBQW           : NXCXKNMXSGQM    RPGXRXSEH       RBGMWFSEDRVBGK  RQCCE          
GPCLJQD         : OTTGBYGAUOXP    BIIMMWPYDDL     TXUGPVC        
PDKXRFKYPGY     : QGEB            STUPTE         
TXUGPVC         : VJTUK           JGST            KKTLQUMXM       GPCLJQD        
PCSVTW          : EYOWJKF         QJTR            KOEGKNKFTDCY   
ENMNFQXGIEQJVY  : RWVDRFBBM       NADCUDB         PLCNHISJN      
JSIHBBFGU       : HFVMQSXPWTC     YAMGJBEN       
IPSE            : BBIIWGLCBTBPAH  GUUY            FUWHWGTF        JGCJLJWSOGML    YKRPTJWC        IRDD           
DIDPXLG         : YAFWILQUBVN     DJNIYGN         WLHTPAXVBTEFFP  TSAO            AYXTYCKQYDAPKI 
RQDIBYJLKEU     : OIHNSWBBOV     
GXCMSYWKUBAAME  : SCCDOHAKTY      UUUIQCSXWCCSTF  TKCSQGISMA     
KPYJHPORSPDFDHC : NRFCNC          LXYVV          
NADCUDB         : WQHJVY          YLWLSI          COSBMPSXAUQNVR  ENMNFQXGIEQJVY  BEQITAWJMBAAF  
AFGATMRGCQ      : JTBOACDXLPFJQ   WDRCSEKTSMKKVKE JWEJYWRJHPX     OLWITSTUX      
LJHFEXK         : UGUUELL         CVNRPJN         UIHRMDGYOPX     BLMQE          
DRNCI           : TLTFWGGO        IVECHJSECPTE    QHDOMJMB        DMNFXIWCR       ERPLCE         
GMILOQNTYNNL    : IQBKCLELCAVSTPQ NTWHSXVLNSEBJ  
TPYMDKWK        : KNUHBVWYGJW     UDNESTRRMWEY   
WUBAOOEWFKM     : FKRCFMYPMKDAYKA JBTA            NMPOTAADEFSHTN  QVRMNSEPCQEXEF  PJCRPGUO       
XBILWH          : IMURN           EPNMHIWNJPJ     KSBNI           WVQHOEFQFPNECJ  BKUUM           SUURENQQUMILUKR
MUJIKKXPUU      : GCAFKM          CRRATDKQOME     IPFNHADMLSFYQB  TBQEEFKV       
LRWOTMGXLNLAD   : BXTCJAHFJYFG    XPYN            XJWPCSVXFGVWP  
DMXAVYORIXEU    : FPXWXQ          MGRJ            DYMNKTRWUQPX   
WPSYEKWSGLBEYO  : HLOONCS         UNKEGXVIRGECRSR ITKXFTGLSXTPLXD NCPQLNX         UCBTAVWOAGJ    
ASCFHAGFYUYKU   : CWSDIRY         YONMJGIIRQKTK   GPGL            GTCRIFUN        DKPOBSHDAFPPY  
HSDXLCEXB       : HXYWBTIMC       YPLCPHUOH       TYAMJUIDN       ESMUWFPTR      
EOBJOPB         : OPMOW           RJXVJTRGFODOWH  DMLSUJ          MWHQBHM         IHRDEM          UHVBK           ESLYLPDQCFXKP  
KDVTDECFCBRWH   : EWYVIXUL        NQRKRWLYOY      JYEAXJWCYGMRXJ  CSYONYEAQNOSD   BIIMMWPYDDL     OCXC           
QKYEPFDQF       : LRDABHYN        XAPIJK          BIMNRTVY       
GIUWA           : YQMEYOOJDFN     XDNDA           VQGCUF         
PLCNHISJN       : WNSHISTTV       GUUY            IPHF            ENMNFQXGIEQJVY 
NHRUIK          : LSHWPRCMULWV    XXLTSKBYL       SCWO            BKBLBSECUXKVLO  WMCJRTJKFXRCHFL
IRAPUSUGYDEX    : UPCJMN          WFWSMJHMJCPI    DCBONNTXHJY     QSVKIAATQ       LOUFBBGEPGRUYDW VNYMWINTNGT     LVCETYFFNXLLY  
DNRFCBN         : QGEB            HYKC            WQMS            XIAAELVXV       VVAAF           QXBQTBH        
LDRYKLVTY       : LYKQFPSONYLKFWX
EQGTNARTBU      : FQDACR          RUNGAG          MTENIT          LUWMRHSSAMDEF   IDHDALV        
ABDPUJRWYOKDIJN : TJXU            GCAFKM          SSRP            OMAIOONF        ULESGHYNNGBX   
HJTO            : WCQSPWOBSVYYE   TCGYPTBDG       MPXVISVMNUC     AXIMG           TBKJE           BKQD            HJRTPJYFXES    
KWKXWCTBYUDDX   : HQASO           MXDTCAV         CQYLJFI         PMTWUUGWFVFMLF 
AJNW            : YPKEXTLWCH      VHOCFJBM        OVXRSK          YUXNWRV         BRNVQ           NQPWSM         
CHMNSCIBOE      : UDNJLJJHYRFNABJ UBQWCJKEYSBPAB  OEVBWM          SKBEBYFPTPNL    EQQDE           MLHX            UDOGEJLKDRE    
EQOOQO          : TPSUF           ITKXFTGLSXTPLXD USIODKGAKKACPUF ERUUKKGS        BWHRSILNSJIBL  
KPUFUAGNA       : OJBWJVHRYMLDBM  OTGPXKLKU       NLBAHJDU        MWHQBHM        
BXYGH           : CSHXSVSHHIB     MRIEHTPXO      
TBQEEFKV        : EWYVIXUL        XQWM            KQGQNSFOCQGRKVE MDFAR           MUJIKKXPUU      NQPWSM         
BKBRBVCSQK      : FEPS            YGMUP           BICKNHEPXFAJ   
SSETIFRKNYXJCON : JJGRPXBMKQ      DYTLOTXM        LGBEYWWL        JXETK           TTGFHOVCQ      
VXCIBPLSSHXMBKC : DEVVXSRXIKDVPS  FBHKOQYQ       
DGPNOHXCJWMNN   : BMTFJNKD        KYKOSSUPISIS    TGUYKIKXWQEIFO 
UMBYUEQI        : EHUQCWOPQICIHN  LFRNQIO         WFJLOKLPBNU     YRBMUUJSHHA     SDEGI           VOHJNAILV       GGGK           
KRXYSIDPNKFBYPA : GCAFKM          QWJHYH          XRRKIL          SDEGI           HEEWNDNEIBFY   
BYPOOSLBVNX     : BHAOCIPSKGYS    RUEKM           NTNRBXDX        OTJNNHCJYMK     IILUKHK         DGLGFDJ         OLXIEDDTAVL    
EGAQBXPTITLV    : BIUVUKBUDKWXU   QHDOMJMB        VXUYRDLXXQN     JWJHXMKLGOD     GTCRIFUN       
TAHLAKOB        : FWABFBOJE       BORCVADEPEV     CSHXSVSHHIB     JENAM           PFQARLGO       
FPVRTRFRTLBUDCU : PRILXSFQHPCD    CMYTDITKFIAO   
XEQMCWI         : UTUWBSORM       HFEQIALYVLXUXW 
GTCRIFUN        : TCCLKEN         ITDHOQVFHDABTRL EHNODROJR       ASCFHAGFYUYKU   EGAQBXPTITLV   
SHRMOLGB        : NQNFTVPXYOWQFO 
BGQYBRDSGHR     : NKMSPCYO       
KYKOSSUPISIS    : WCQSPWOBSVYYE   IUPMKKUVG       JRSHGSACECJPFN  UJDJDBCL        DGPNOHXCJWMNN   SDIJTLFJR      
UHVBK           : HYSLPYOTYQNLLQ  XUTI            EOBJOPB         AOCNCMBO       
FQEGSXJNEQH     : UIIBCQDOYO      GGBIXDSVNWHS    AVDFKVQVVVDT   
DIFSDANSJI      : LSHWPRCMULWV    ITLURDIPYUI     NSIX           
CUXJSAWGHNLN    : KESPTYDTLTBC    CRYD            CUWKJTMBISJLYTP
LYXQRGLVOTOSTEN : UBWKVKVRUDUWT   EGPPS          
MPHHNTCPQJYE    : GYJVSXGGQJJX    XIOPUQSKSXFKCG  VGAT            TMPJLNULLVJEDC  PCIQLUIE        KSALIOSNNLJV    DJMHMWK         FBONYIRCIICAW  
ONINLBGTPE      : SVPWNIXABSXDOO  JBTA            XFMDLNBGFE     
JUGDYTJNLQ      : LJHEXHPAEJ      OFOU            GYCKMXAOGYX    
CMYTDITKFIAO    : WVQHOEFQFPNECJ  HDVAFGNKYEO     SNGLOJP         FPVRTRFRTLBUDCU FODUB          
NPFIF           : VFBTXFSMUJUY    FAJDKWW         IILUKHK         WAMFHUBWSRMAB  
VQGCUF          : JSTXC           VYGWNWHQ        XJWPCSVXFGVWP   XQYRMUN         GIUWA           PXMHSRIQNLVGUR 
EUKWROK         : POGACYW         GXMI            CWSDIRY         AFWIFTPEPNYRFMO JFDGFX         
INCC            : UDRFVOBAJR      LAVGKOOXKLVCS  
HNAXMOQRWV      : GIQRJF          MDPLIXMAORJ     QOVYNDFD        NWIRQNGNF      
SPLW            : UGEO            SDEGI           BAXF            PMOPMFLAVYCXO  
SUQNHNFXXXHO    : JDUTLMAAVYYJ    IUPMKKUVG       VOHJNAILV      
JOKYPI          : HCIOIDAMYNRLLAG TDIEMSLQOFXJD  
EYFDXKXNVUA     : ECOFGKE         LMLLDJJVCTF    
RQCCE           : NWSEQNLRMRR     DQNYVPANFQJGXV  KILISFDD        BVBQW          
AFIJTKVKUUAG    : FAUFKQ          ABFHJHNFY       OVXRSK          RDPLRO          LTBBE          
GFMJFXHS        : JSTXC           BIMNRTVY       
ESLYLPDQCFXKP   : NXTYUSIL        GBRSESHSQUEM    IKTLFQU         ADQDY           EOBJOPB        
ULESGHYNNGBX    : RWVDRFBBM       ABDPUJRWYOKDIJN
BHHW            : KLES            CYXOTJDHMFYUNRT TWXWQCIL        UIHRMDGYOPX     ESMUWFPTR       HRDI            BVBGHD         
DKPOBSHDAFPPY   : YKCRRCB         YFMPAAC         ASCFHAGFYUYKU  
BEFILGXBNYBACLH : CGWSDQGPPJMBKVW IWUR           
AKKRCNMJSM      : IVECHJSECPTE    UGUUELL         XWTMIV          WFIYVTDBNKSUVSF ONNWAGWCIJ      LBLUUIO         BURBNJEFKA      YAMGJBEN       
KDOXEUF         : TCCLKEN         YNUMVGBF       
IONKCOLER       : SOOWHAJWAWF     UIIBCQDOYO      QKFISFTV        QXFE           
NTYBGQDUFMPSCBX : YFWBSVM         RURUWMDAGWR     NTSFN           NMPOTAADEFSHTN  LRMACWQXFAGYSL  ITKXFTGLSXTPLXD VDXEYDTSKNRUJ   IHWW           
NTYBGQDUFMPSCBX : BVBGHD         
BEQITAWJMBAAF   : SODJICMDF       SSRP            LLWNQGWFMG      NADCUDB        
ATNYWUS         : NVFX            VWPLWA          ITCMFNYIHDA    
PXMHSRIQNLVGUR  : CFMQF           NTHEQNOUWFO     VQGCUF         
TBUVBVBVVW      : CSNXCSURPGLV    WGGVXMT        
WVEPVVQLE       : UVYJTXEIGRWE    CVNRPJN         FAJDKWW         BBFOX          
FODUB           : VHBYBCA         VKATRB          ENIRXPBATIS     WCATVLDNKHVH    CMYTDITKFIAO   
BVQKPTFN        : MRSWIMWXXIANWB  IFVUWGTGASNHC   HYSLPYOTYQNLLQ  HMISBVPJCG      OUNINTXOEHS     BAXF           
DRSBQFYNJQJIJ   : IVECHJSECPTE    BSNGFPCFWASVHMY JUIMXQMPJBYO   
MVCDYWEXYCQJUMQ : CNUC            IMGAAAGB        YONMJGIIRQKTK   MAQVKBG         PWVLEDOEEKXRLJ 
JWADXR          : QLMGRHLTRT      URJRNNFCKDB     GWTHGEOSFT      NOOOFSTQR      
YFTSOCCMQXQU    : WASGLFIVVFHRI   MHKVOODDHX      WXJYUAVQHQJWF   LDRKBWGPROJ    
OYYPCRYYERH     : QQVOFLBTJMEV    TWXWQCIL        YFMPAAC        
OIRNCCOHVHXYMMR : QLMGRHLTRT      QOAVHGMWQBADWY  IAWDDELYKB      MQMPGDFMWVQBRF  JXETK           GXTIB          
EMMUOLKSELRIDYY : DYRGCSKT        LSHWPRCMULWV    DSCHLUKPTUCPO  
JQILUWURFVS     : HJLYXKIFLRYSR   MDLVBBUDYIVM    VIKTYBCSGIA     TIIOC          
IKEOASJOFVHLHY  : SOTMBWT         PRDGHGYHTLYSJ   BLIE            OCXC            ATLREJGHSFTYN   BUYIJHLNM      
LAVGKOOXKLVCS   : FUPVKSGFWPU     FQMVRMNVEUNJKW  INCC           
WMCJRTJKFXRCHFL : IECVJP          RYHCSEJIO       MSFDKRQWP       NHRUIK         
CWJAFVOVT       : YEMOANUA        FXQI           
IRDD            : SKMWKITWNH      POQHLISKNRQGXSE IPSE            UCBTAVWOAGJ    
CQOMKIXWNW      : SODJICMDF       HJLW            FRKNL           VVQESAUICELB    BWHRSILNSJIBL  
REWENBDWBJ      : QSVKIAATQ       VMVOHBAFQH      INTPTNXROJA    
SFOTPHAVSCM     : DEVVXSRXIKDVPS  JUBSCOIPART     QQWFFASPN       RNKFMLNJPYUQ   
QYRPXIOPAUNGIOK : KNUHBVWYGJW     TEJNHMVREQHPPP 
SVALBRHTBHP     : OFOU            HQASO           AEEAVJFOYOSN   
MEEDF           : CAUJXVMLLJBQF   WNGVVRTPVVN     YTXTJJUGL       WERFGAUFWSXSCPN YRBMUUJSHHA     YFOUCQNEGBFKBVA
SDIJTLFJR       : CVGAOFUV        DXRQ            KYKOSSUPISIS   
AEVSAXGEP       : AHIVGJUKYIMWJV  CRBSEXTWCLITLC  SYVONSDSGKI     XINA            PWCQFKX        
XQVPNIVTOBTJ    : GIQRJF          PSGMPXCBF      
DTAQYJIOKNMD    : MPXVISVMNUC     SPHLADGUN       PSGMPXCBF      
LMTDBTWYJMKF    : YCLJIJJLYJQU    LDWIDJCUGN      QKKBEJHEBROXGB 
BICKNHEPXFAJ    : LWHBG           NCHCKIMOD       TVFNITNIPOJ     NSUK            BWHRSILNSJIBL   BKBRBVCSQK     
KYHPOUEJBHDX    : KLES            XCRGKGR         XEHGNYYXHSAJWEU EJSJ            SNJYWOFETFPDA  
PMTWUUGWFVFMLF  : IVECHJSECPTE    FPXWXQ          SOTMBWT         AJGVDUJCGM      YYTDLNOVRWQMVAU MFTPQGYDDLC     KWKXWCTBYUDDX  
LOMXNWQDRUOS    : CBFMKWUWRL      YRRC           
RSMJHG          : AOCNCMBO       
CDNAKJHWWO      : VHBYBCA         KNNJ            IFVUWGTGASNHC   QQRQFTA        
JGEJTDAYXVN     : XHWYGCDLAYUI    FQDACR          VUMLTW          CHCMNTEUIAGXO   DKYYVPCGVDSGFV  AANBRSKMQSR    
BIMNRTVY        : VFVIJNXVUJUKS   UGUUELL         ITLURDIPYUI     UDRFVOBAJR      VTVDMRF         QKYEPFDQF       GFMJFXHS       
YOBLAKLXYDHFJS  : HDVKRAOWESD     UOXKOUDQKIHT    LVCETYFFNXLLY   YVRAPAHMOVL    
NTBLRRESCSGT    : XPIESIOSMGQPVH  YFYFXEMKVFKE    NKKBVWTWSAWOWT  HHMYWNFA        UJDJDBCL        LVCETYFFNXLLY   HBQR            XSIDKNGOUCU    
EVOFMPQNACLB    : GGSEGEAGLL      NONCAN         
UHRNJHJMSBEYT   : NWSEQNLRMRR     SYVONSDSGKI     ISCHNLBJUHBPML  DMLSUJ          SCWO            PHDDN           BTOCDWUPHYF     MWHQBHM        
SCFKIDYNPQFDS   : IKTLFQU         QTVMYXXL        HYKC            KMQNLRYSJOJRDOM FXQI            IICPUXCKRAMKQJ  UNHHOJD        
QVRLDLAOSJE     : FQYHKFEKAVSBBG 
NKMJTFOYR       : LPFNTUEYIRMFI   KSBNI           UGYARSHVBJ      LDWIDJCUGN      LCNJPSRBKTQCN  
CSLRJSXEC       : XXLTSKBYL       PSWCKSLVAXHUYMT PRYYKO          OVAWKRVEMWX    
BVBGHD          : CSHXSVSHHIB     BHHW            NTYBGQDUFMPSCBX
AOCNCMBO        : LVSU            KESPTYDTLTBC    UHVBK           RSMJHG         
IDHDALV         : FQDACR          UOXKOUDQKIHT    YIFIQVGFADN     KFJUQQIRDEGXK   EQGTNARTBU     
EGEEMJSPH       : TWPJJAO         ILNVPSUT        QKDVIGILAIKAAL 
WPBURQY         : TMARUJ          QXCRALBRWWLXFW  ERPLCE         
UNLJWVME        : KBFHMVW         MHXYXEQ         IGXN            NBNKJR          YRUBARDFAAYJC   QYMCKGIB        GULCTCEAMT     
NQVBWEIBST      : WKPHWBEMYV      OCJWCVHH        SLDAWAVE        SMEIDHJSHFVJ    HFBBITIILDGRFOR
JBSGSTDNMC      : HRWIBYHX        NSIX           
KRJT            : NOSJJVJEAXBJBJO
HJVHYMFCL       : XHWYGCDLAYUI    IGGBRMMLVN      BVQXKFMIS       BBHJSUTV       
KOEGKNKFTDCY    : CHCMNTEUIAGXO   PCSVTW         
ODQBVCVKKH      : FQDACR          FBGQCFA         NJXUEGQ        
TGUYKIKXWQEIFO  : CJRCPTYQCFLYOM  BDAGKNF         DGPNOHXCJWMNN  
BURBNJEFKA      : EPNMHIWNJPJ     KESPTYDTLTBC    DGLGFDJ         FBGQCFA         AKKRCNMJSM     
INTPTNXROJA     : IMURN           ABFHJHNFY       QKDVIGILAIKAAL  REWENBDWBJ     
HAQNKXDAYXSAL   : CTGAMMJUTA      JVMSFXOMPCBAH  
HSOJDXWWP       : UEFESALKFEYRKRH OTTGBYGAUOXP    UCUDGAO         CJDAIYLHJL      GRIRMEBAO       AKPPQBBS       
NONCAN          : YTXTJJUGL       SLKWBVLAJVXPP   URLCSKCQ        EVOFMPQNACLB   
JNWW            : YLEEVTLWLELAK   UUBSNW          CUWKJTMBISJLYTP DGLGFDJ         HBLYHNIOUDYO   
UCBTAVWOAGJ     : MHKVOODDHX      THNIWJORWXFVMSF WCDGUQJCDVGDSJ  WPSYEKWSGLBEYO  IRDD           
PMOPMFLAVYCXO   : OFKOQSHMIORW    OJNA            VSBMREUEDRIGPR  SPLW           
JFDGFX          : ENIRXPBATIS     WRBKKPQAQMNLM   RUNGAG          KAMTMSGIUER     ATLREJGHSFTYN   EUKWROK        
GULCTCEAMT      : UNLJWVME       
YKHNRSNN        : BJTSH           ESSVBEHLPPSP    VTWGBOPXXTAVYQ 
SNJYWOFETFPDA   : PCPOBWP         LDPOEDNXGDJA    HJKC            TGPLIYTGHUNLWHY XPDFPPICM       KYHPOUEJBHDX   
HTGMVSIOTSXILRX : HLMDUBSBO       HKFXIJXUYKTR    CYXOTJDHMFYUNRT
NQPWSM          : OXQYUQKXRRFEYU  DEVEV           DFEIKJSKY       METO            AJNW            TBQEEFKV       
XSIDKNGOUCU     : CTEWXLBENIUAXPO WFJLOKLPBNU     NTBLRRESCSGT   
YPPPJ           : MAQVKBG        
NTWHSXVLNSEBJ   : UGYARSHVBJ      ABFHJHNFY       GMILOQNTYNNL   
TTGFHOVCQ       : XPYN            QJATOXW         NSUK            IUKAOJODPS      VIKTYBCSGIA     OEQUDIVPFSCLAO  SSETIFRKNYXJCON
MRIEHTPXO       : UBWKVKVRUDUWT   AOMS            BXYGH          
FJLBUBWACG      : ANLYQEHGI       PYIMIDTRGD      CSHXSVSHHIB     KFPQFXRXJHS    
YAMGJBEN        : YFOMVYBFIYR     PPQX            EJSJ            JSIHBBFGU       AKKRCNMJSM     
WAMFHUBWSRMAB   : JJRIOVKPTQXFGT  PXREI           NPFIF          
EYBBYGJDHLQNUTR : NVFX            CJRCPTYQCFLYOM  VKLVYWF        
OQLCXUYYRTRGT   : BEYRLLK         DXRQ            XQYRMUN        
GXTIB           : BHAOCIPSKGYS    NTHEQNOUWFO     IWUR            DQNYVPANFQJGXV  RBGMWFSEDRVBGK  UXBEFCQHFHHUGGC OIRNCCOHVHXYMMR
QMYXXR          : FJCPVIWUEUN     WFJLOKLPBNU     TEIUAEVOVC     
ULHGBXTFVOEU    : ESJMW           HBWCLLVXR       DLAGPPBG       
XOPTKXUEIVAYL   : KIYEKBL         RPUKPHUG        MHXYXEQ        
WJSK            : GPFETJLGEPI     TUDAT           PCPOBWP         JVYXLYHL       
GTPJ            : VBUMPKBPBCNTO   CKBFNMLJDGUEBV  NLBAHJDU        MFTPQGYDDLC    
LQPAUN          : HDDGDA          KTVNQFHGGLLSQR  TPSUF           GKJUXDY        
