FULHYSPTHPT     : ASTOVPQAFR      KXPYKXP         EJYMFMPCKEJI    POVJVFBMN       PPLRM          
OCPITCO         : YJNWKUHLWLUSTWL DYNDOH          VPDHYPYDSYGPWOC WPXOHHPHFC     
WYWXL           : RYVPVGOSBWEUXDF WXREIQ          OUQMKF          VQJERVW         REBHI           YLHODXA         LRHGREMXSD     
QWGTXNOKUOFNK   : QQTJXONF        BXYJCSHUMD      DYJCYALD       
DEVUI           : MIFD            XJKQA           TDSJRM          TAUVBQIOWNVSNP 
DERTYOSWOG      : PMLWEYKQUKAWEF  UKOPYSC         UFGCWX          SEBNIHRT       
IDQCC           : VNYLCGKQLUX     SEOE            PQUNVJAYB       SGFN            ILSJOU         
QOCHTR          : CCDUFERBCO      UOMKIQPWQU      JXCLX          
JWXHRJUW        : SYHNNQJ         NDNQAGR         OMNGBTR         DLHIU           ORIIDNWGYHLN   
OQPDLMURUFX     : XIKQOXXXFKTLSW  DOSOEOPYRM      KPVXYDXPFYR     LBNODLY        
HCSAQWKMOEY     : OHXTIBMBMMLYVO  MXTHWJ          YMJECGA         XPQV            EWWOMQL         AUALGLOGYKCALNQ
FIGQGEE         : GOXBWQ          XKJDA           OFFOOEBUYI      GBGSRUTDSNMQFYY
UTBJIVBG        : RQAEXDKVEHJAMMI JKYVJDN         MIHWGI          PQPSKWSCCPGVLM 
BUKDN           : TBIVK           IGRGHBUKPKIW   
VNYLCGKQLUX     : IDQCC           VXYMNWIWRRJT    BMJXNPQCEE     
BCIWYDXINVMTYN  : SYVV            KYMJLEPHDXRDR   CVQOMVOELSTIAVQ AKYOSTSBHMBEA  
LRFAPSABWGN     : ACPPO           HYNEJGCBQ       JEBJKTKHWHXVVH  GJERPXFRB      
TJOXKQGH        : KUPPUBAI        CMBF            BORRTABSIM      XXOT           
LHDA            : CMBF           
RVEFLRYSSPNUSKB : VTANM           NWATQFBBOU      DQWLJMBIR      
BWQPUBIDLBRS    : LIYTKBWIJDC     DVPJNVUL        FIBMVTFWENNNUF  IQVQEQGERFBBIPQ
RYXPFFDXHVSYLN  : SEOE            INVHYKLO        HYEGKCTW        EKQMQFGLDCDO   
WQYXPRQ         : HWWTLTTC        LPVLXD          OKBYBHTRREYJNYJ SRSNNPCRARFLOV  YHYARVEPHNER    NFNPXFSXUBWPX   GJERPXFRB      
TYPHAH          : BXMYY           FULXLJP         DFRTGCVVPN      EUYDDLDSMV      KPVXYDXPFYR     KVTDN          
GBBETHMWHT      : HWWTLTTC        HWJOFA          UKDUHT          INXBHHPEPOPV    OOFEDLC        
CSHPKEIMFAEVMA  : EDVEOLYRSCAITT  FQPSRY          MXNAJMSAINQMU   USGTQSXWPY      YSNFCSDXNPFJNAE RWYGUN         
EHXOIEPL        : CTLGJKTPOYYET   YJDQWL          IOMJVE          NKIVASA        
JSAJCTDEMKVYR   : LSYUXBVNGYVQJ   BLUN            FOEKR          
NYGSUSSRX       : SLIBWGYJJBXNFGO OJANTFOOK       EUULMMRO        FYEIYMRKLTASNL 
PMLWEYKQUKAWEF  : DERTYOSWOG      LJFJIAFX       
SRAT            : CYYWVGRDE       XJVGOBUIELHTJ   VIXR            BTTDYBGSGGU     OGBMYP         
HIKPBHLVALYRAMO : IBXFAEKODDJJT   UNAXUDATMOHSS   WGYPVEXPBVCL    CFSWBXAIIEMVSYS
MYWHLYEPEI      : CEQFQJRDKB      LRVJ            JTWEQPLUDUTDUKD AYGIXGC         FVMJPLC        
YLFKUNVKQ       : QWGFIDCIN       VWQMXWEJNCEP    OFAATQXLLCEA    VMNTJBPAAGROM  
VMFHOXHBOONQNU  : EHQOIYCKTXVCIVO YWUQNSEACSUEQT  UKDNDEWMLDBJVHL
NCURMFSXMEUC    : CRAJQCAJRUT     PYIUPSI         UXXMYYYUICTR   
GSHEIPOWP       : RNUPPS          CQYIVYAYJD      SQIEIJHJWNXFTHM PAPWPNFMEXNEF   FHLDEKUCQ      
XEMOW           : SCNYNB          JGDVUFD        
LAQNWKDCEDRIY   : DAFOR           GWCWLEA        
KHPTLXJCWBBUIPL : YVHKYT          PTUFYTSG        CIPCNLWKDK      EHOGGRDJVE     
SXHJNEUQJ       : HHJOSTIK        JTWEQPLUDUTDUKD BTTDYBGSGGU     LXWHCCOQUPBNO  
UBJVUVDKRQKCTHF : UOMKIQPWQU      EQNW            ROTNEEVLAI     
FNMQTIQBTFGQV   : WXSAKHUNYBQJB   CVCPWNGEFHPS    TJTJYGH         DYNDOH          BJVVUHEO        SVYBKSPNST     
RSSBOPYTDRLPVHX : XJVGOBUIELHTJ  
EFPSVJDPMX      : QWTKILCEOVJB   
UOSMHMFKD       : SKVWXARLKASFXA  JVLQHWCP        QGOGTYCKPD      RFAIBDNDI      
MADENSAUQ       : MIFD            KKIBSJDN        DXTPUHBNXHX     LXXQYM         
BVSVUCAKRXFMO   : ACPPO           THUF            OYNAIFQINDSWCQ  BCQSPH         
AVMHJSFVSIC     : QUBIFUXTWVYIG   UHTLX           RUNJCW         
CCDUFERBCO      : QOCHTR          NAJBQCNYGMHFW   NKRMY           BSXMAWICHISVS   BOVLP           BDGIJIIP       
CBUAI           : CVCPWNGEFHPS    TQRETMJJCYKUC   EUNLPAWXYBKCFTX
PIKNXRYQX       : RQOBJSDNUMLBRF  QCKYO          
LIYTKBWIJDC     : BWQPUBIDLBRS    UIXYE           EJYMFMPCKEJI    OBQNWB          LBQHIOUPO      
HQPKRNMAXEKISIC : HAICDFNFHOCLU   CJYFCLFLXNXRIGU KFENXUUJIPKM    DYHTLESCMK      LWPGF          
BAROL           : AOIPTHSKMCH     RCRMC           VQAHYSWB        VCFMTEGXAT      EHLMVIKWNMM    
IXUHGGM         : DLUEYAD         YMJECGA         QMLQPTHANVOMJM 
QUBIFUXTWVYIG   : AVMHJSFVSIC     WGPYGVO         CKWPUALV        UKDUHT         
QJLULFJWWSXRCEX : VWQRTMK         XQRH            XJKQA           KRONMOG         RNAFHEYUSXG    
PQMQBTMANJ      : BXMYY           XOAACMXFKLOCGRM AGLKRHMJH       VQBDGXPQEUIWEU 
MRHGLSUGEAREWMC : XWUGGQJBY       IGEUD           MGAMXMDU        QXAACGRQE      
PIQHXHVPJRE     : HMCOKDJNYR      MGMREA          UOKLPWKP        BVKKXBDYT       MDNUKRJCSJU    
FPJUIQB         : RBTAUEGJ        UCKRKKY         DAFOR           UFQEQMCVXFHSLUQ
JXEQYVWXJBRBJ   : JFYDENSRTXS     ELVMLVLTGL      SGJAWQODXPTDYII
IIQGACXGNFV     : DWNK            WPOXRBLO        BGLKVLKB        SIRQQF          RHAOKDHTQ       ENYRGQGGXX     
AGSEC           : RBTAUEGJ        JGYOD          
CGUDFRCOSVPFEA  : WHUOWEQRRBVVJ   FADHEVL         GLMJDDNUNOJHGT  SIDLWKABPJUTBT 
WGPYGVO         : QUBIFUXTWVYIG   VXYMNWIWRRJT    YDONHGXGGF      ARIIGMQGFAUJEN  QDSNV          
RQOBJSDNUMLBRF  : PIKNXRYQX       KMOLNSBWYX      QXANCERTNNIL    PIGRXEVWTASXLI 
IYBXGFATDILEO   : KHDUUAKR        CHPMPQG         BIBH            LRHGREMXSD     
VCDOQEXJINHWBIO : NHFGHP          LTRSMEASWNDQT   FVFN            KONVBDDXGDTY   
PYIQ            : BXTNKGTANWA     QQTJXONF        SKIIHTVF        QFGLCDA         KPVXYDXPFYR     NTPNX          
OVWIBFVIVFE     : XRKKFD          OTASAKCXD      
KUPPUBAI        : TJOXKQGH        TKAWXOFV        QKFNXTATYTQ     GWDQTB          DYJCYALD        FGJNWCCOHGSO    VFDWL           QYMOFHROGO     
WKSNTIOCYLQX    : MAJJTXGPC       BPQDOU          DFMFFGAFRYO    
BYRWJNENNOK     : YVHKYT          WBIMP           COOCWWIXE       AQOUQLQTEBKDRGV
GFFIOPHBJUUTJ   : EYFAXJLASB      KBXBU           TNGRPFCSBY      GLFSTPDL        KKJLKIWUXFK     RXMKIEBY       
VWPTJQUB        : AEWHGLGIXYIFY   OVVXABYLNBRNIX  ERQBOJJ        
FQTUFKGKTLRCCIK : SNPSTPSYH       WIXRVK         
THCN            : BMRQFPXWSCDBJS  BTTDYBGSGGU     EGUFKAXJDWJLF   XRRJGW          TYRLGMAIGL      BXQBFEKMPPXJ   
BJQQFB          : BJRWVB          FQRVPN          IKMXHVMYCSQY    JDLTVCFXOKCGG  
BEYIXUDDGLP     : QWGFIDCIN       FAQKBWNLD      
AICC            : XNVK            EJBJPEAJUWWPAPJ VODYSLQLPFVCPTG
MKMUMCOQOH      : UHQXHBXBVXMUC   THSYJYKIMEUAAUU PYRTION        
TKTWRS          : EHQOIYCKTXVCIVO LMGBJAXEMOUGBT  CMFHGKX         OMSVKRV         SLOLW           WICLYL          EXBQOWE        
POLUWWKWWUBC    : NHFGHP          DWNK            MBSPLVXJPTFCONY LDADNGLBSMO     ORWOXRJMFLHTRNT
QMCNBFER        : EHMHOYUGC       DDROSCMYJSQSCNB FWMBSIX         LGYWNUYWVWFQB  
LCRYVP          : HJFJYVXCJAJNR   XWUGGQJBY       EVWQEDLFNRVOIB  BFWIVSJOFJIYLXH WISVTWXA       
QWGFIDCIN       : YLFKUNVKQ       BEYIXUDDGLP     KAXXRILXVKD     BLECNIVEQIAE    FCGJLWUKM      
HJFJYVXCJAJNR   : LCRYVP          DTPXWUQUIPC     JHHQRGCJWURAG   QQTJXONF        KWAXVBLH        JKAHL          
BVWCROSJMB      : CMAWVVCXMYCWI   OFGTFUHLEDAO    GWGSUUMCIPNK    SHRWRMDLL       PVQLRUOTVB      DYHTLESCMK      DMKQWRLWO      
WEVFUWN         : DRNUQBQ         ELVMLVLTGL      BOOP           
EYFAXJLASB      : GFFIOPHBJUUTJ   NDQXIMITJHRVLF  IAKMJWGCX       WQXNWF          EKLNF           MDDFTYRXVOP    
AFQXHKO         : OCNQALBNSW     
VBENYJLEGITM    : FSKXH           VMLHPQCJP       CCNWCS          AXMDIPXVPOLX   
VTPTEEVWFPAK    : LOWTLOUQMEDIAF  GHQOU           WRQOKVJG       
ASTOVPQAFR      : FULHYSPTHPT     IKAQISB         EUXWBKOKHPOX    VXEPEABHS      
QVRCS           : TQNRE           FMFUI           TTRGCXIRIWBRYIQ DMKQWRLWO      
ROBHKFLGETV     : HFBJRKGQDPJ     GTVFMWLM        HMKAMBDPAHOIVOM PRLCMEPPP       DYHTLESCMK     
GFEY            : OKBYBHTRREYJNYJ CHTPIBCRQGEG   
VWQMXWEJNCEP    : YLFKUNVKQ       FADHEVL         QLOJGJBXMCK     EKJWMSMNEFY     JMSOYHCGWI      IYIQYSL         EGSWXVCAUSCJ    LFJTDD         
KJNNRXUFG       : YMGHBDYIOEA     RXGCSVIDMTJWX   CMOCOGN         XISENOQIP      
BFGIKNHLJFC     : HMKAMBDPAHOIVOM KCGFS           PTVOB          
FYEQPGWHGIRTX   : QLJJBJTYPTUSGO  ACINKPDXDJBW    DSIYOJOE        DGDBCTILNKVE    RXVNKKXDEENPQTT UHHDBSQLWN      XIFCT          
STQBTUGCDQRMCD  : FEMUGAEQJELXVDN IDTIKWYVMENMOO  FGJNWCCOHGSO    UTAYLQHKL       AQOUQLQTEBKDRGV
HDYGHSXQPGW     : QPIBMXCRXT     
XQYJLSCN        : UMDKJPF         IOMJVE          VSXMKGGNAT      CCRGJONWAFLQ    HLNILBNKI      
WTQCNLPROJY     : LEPVGIEJILO     XAHDSUB         OROAUJHRV       LHAQMXFN       
LICEISTOPUOJTXW : IHRMDLUOUYGYTV  RRTAARVDAOYSA   PYIUPSI         FFFFYRGUIL     
DKBCHT          : BCIIVNEOWQG     DFRTGCVVPN      WNUMEIUNF       PPJGW           XALHCYLSJBLD   
WHUOWEQRRBVVJ   : CGUDFRCOSVPFEA  MARKWKJBEVLAS  
SYHNNQJ         : JWXHRJUW        XGAEWXAHH       SMCUIG         
QXTDBV          : GGDVPCNSESFQA   MKQQWAG         YIVGKSQ         XYGMAIOHLUFCXII
UBJDVBCDRVU     : JFYDENSRTXS     NIHSVW          MJKTGKG         KFGLHKM         JVWNVS          JYLJWS          LRIJWLHUY       SJIHBIOM       
RTEJMFRCVKN     : DBXSIJYJMB      GQSWRC          EOKBJPASEQ      MYYIICR         IDUDSYOWBGQKRO  YAAA            TPIAUSCIQQJCMF 
BLGFMCRJEC      : INSRSYYLKLKAATY TKTVGHLIPNY     PAPWPNFMEXNEF   FAGSVCEXTMEL    TQNBSWIMK       UEWODBJAL       BTTDYBGSGGU    
CFSFWQDTJYX     : RIYBL           CJBOKRRWCVNN    LBGHULCVXVD     BIKNU           JJKED           VKWHUQFT        IWOJ           
LGMPC           : HWBTVWABEQTRR   ATUGDD          YJBXHSBHLPXAFFX YRQEDMHIVXITN  
DOBQWGFY        : XVBEBBQ         LBWURDUPTRKRLY  OGBMYP         
OFDGIIYPH       : INXBHHPEPOPV    GMTGGDERB       VIUQSYXHV       SVYBKSPNST     
UBCTB           : MDINUUGXYNY     GWDQTB         
FHKWLKA         : QLJJBJTYPTUSGO  JYFM            VUDCVRDIWXIS    CAEUTOLATL     
LSYUXBVNGYVQJ   : JSAJCTDEMKVYR   AYEJCUWEMGMBCF  WHQKBBPYQWXI   
JSNE            : HUVOFNTVI       IDUDSYOWBGQKRO  SHRWRMDLL       NFNPXFSXUBWPX   IQVQEQGERFBBIPQ
RYWPGHCESOGXCA  : NDEIYHAKSVYKVJR PDUHIWLO        VTANM           DOGFNARHLCHOGDB
WAASPJTLAFJJX   : IUYBQHCUX       KHDUUAKR        MRDQYM          CMAYSNCRIYXHNCI
OTPPTHVBLCVA    : VMNTJBPAAGROM   YBFPKRJQU       IRMPRWTYJ       YGLRAU          LWHMQSCXVSVXIEU
TENTCNVWEFTRGY  : NUIL            LNLYD           PMPIKQYPGF      ECQTCABHB       KPTNVXGXGRC    
RABGT           : YBQEQTXWQB      LTRSMEASWNDQT   IYNMTQS         ULJJKADQMAA     JGQJHOXHRIKNTT 
XNAWQNYNNM      : VLNUJFAWJSLIXM  BTNETROA        KIYIBKMSJLPER   RIMLHMOHQLGMO  
RAFVQCVWHPOP    : LELBPDMIBPLESL  ALAALVDWG       QTTKSIWBOM     
QIQRQ           : OYLDVRGDKPHVPD  UGRGNQJJNGMQMDL HWGERBAFPCCEN   DYJCYALD        PTVOB          
KPDMM           : AKWBMHEYMT      FHFPGVAKHY      MSNRVF          PILVCQ          YGNHSQWOCQAGMKD
ANKPDVJF        : UCDXW           VTMGQDRSVF      MDIWH          
GVGCUPTKGKDOEUH : YPKVAGJN        LJFJIAFX        DGDBCTILNKVE   
HWWTLTTC        : WQYXPRQ         GBBETHMWHT      LRVJ            WLHGU           TDCCCCQ         MUSVKPDMESNUWC  TVUKTANIE      
JFDU            : KWUARMQVUCNHTBF EMIKIRKSDQ     
HBLPFGFB        : OAMRWNWA        SHRWRMDLL       WGYPVEXPBVCL    YADNIJVVCLCLR  
LMVCSQ          : OPBLBSRBUIEIFMR DFUFTUCQ        ENIM            RNAFHEYUSXG     XILHDVAGOYRU   
MAJJTXGPC       : WKSNTIOCYLQX   
BJRWVB          : BJQQFB          YXAYDN          SJADA           KFCMYCMRWFAIW   CFSWBXAIIEMVSYS JNYNCVYAUCA    
HQIQWJJK        : ATMDJMQRH       NGICTYSL        FWCKDLAC       
GPQYCDANPVLV    : AYYAA           AHBM            GWCWLEA        
PKPYDOXEPHXXXU  : RTAXJXX         ENIM            MIIJPHQVYTW     NSWMNGUN        EMNDQFHEP      
IFGQUWP         : SGJAWQODXPTDYII PGGE            CLWLKQABBNGDJ  
DRNUQBQ         : WEVFUWN         SKEMJMY         DOSOEOPYRM      KFDNCIBPYKL     KMMWRNXGQYW    
RDUSIMQNCYNCWIJ : GDAPAHD         RBTAUEGJ        KXBCPA         
PRXNRQMUKA      : DLUEYAD         RMORAWN         EWNSRMNIS      
BCIIVNEOWQG     : DKBCHT          LOENWU          GQSWRC         
UFAWEIIMABMNUF  : DBXSIJYJMB      QWTKILCEOVJB    URFHU           UCRVGG         
RQDJTHRDDH      : APMSAVPXKOFI    XHUXARBFBL     
SECYQWGQVKBEY   : GYVKIU          QKFVHWFS        TODA           
HORCT           : IRFOXLRXAXN    
TMYDHIWKM       : LMPFJOLHNGOGXEP XRYSUDXADI      PFWU           
VFJXGDWMVSYXY   : YMLGJTM         CDUE            MSPMJFF         CAUVW           YDEQHNPWNUPOB  
CHPTLJPGWQLEY   : OLPHX           CJYFCLFLXNXRIGU REBHI           VMYEV          
QNQM            : RVTKBFXQVSFR    LTGERXNRVKUBA   HPYJF           LHDVSFAKJQHPQ   QFTSVTSXXAQQGXX
CMBF            : TJOXKQGH        LHDA            YQOT           
NCCP            : QGNHJMQVQRB     YIGKUCTPBQMXHJ  AIYDMUKJBKQMH   SIRQQF          FAQKBWNLD      
BQEKGAWRRDOKQU  : WXSAKHUNYBQJB   KOPOKN          CYOK            PCPS           
ANXQCTVOUBX     : FWERGXKKUA      QGSPMM          BGLKVLKB        SJIHBIOM       
FADHEVL         : CGUDFRCOSVPFEA  VWQMXWEJNCEP    YJOV            GJHQAOISVAIMA   EJYJBPCBNWA    
CMNVGSNRKKEK    : THUF            QFTSVTSXXAQQGXX UTIMA          
EEDXASV         : KJRBLFIVSVW     KNHXFUSDEECD    RJKJW           FIBMVTFWENNNUF 
QJJTOQAKFQOT    : VJBG            MOQGVM          SHRWRMDLL       EUVGIVOSVG      CYJQVTUBVMDPX   RNTWSY          RXMKIEBY       
KAXXRILXVKD     : QWGFIDCIN       JIHVA          
NDEIYHAKSVYKVJR : RYWPGHCESOGXCA  XDRHADI         PMURAVKWH       OYLDVRGDKPHVPD  OOBFSGLJA       VSQGEYHEO      
ALRL            : INXBHHPEPOPV    QVLSBS          NCSCXIHKDBUFWL  EROMT           UGRGNQJJNGMQMDL YPYELD         
SLIBWGYJJBXNFGO : NYGSUSSRX       NFPFCUF         LMPFJOLHNGOGXEP VSXMKGGNAT      YHGMI          
ICGEBSCNM       : OFLMRXEII       YHFCW          
NAJBQCNYGMHFW   : CCDUFERBCO      VOGYMPHXWNAU    FCDAE           OAVNI          
HWJOFA          : GBBETHMWHT      MDINUUGXYNY     WCSQCCH         RXDYQUQFSPXJD   XRRJGW          MLNMISLFUOEAR  
OCLUGGX         : VIUQSYXHV       YFAYVGTOMNJTT   SQUMPXGUNEEXCXD ILSJOU         
VPJVBNMGDNMPV   : MDTKVOES        IKAQISB         UXLHQDXXLRG     CTIKCSOSGRQGS  
OPBLBSRBUIEIFMR : LMVCSQ          UYJDMSFFSJFE    JTYJXFLGF       TDSJRM          HOVDWRXAKHISVAY
INWTLYHYF       : MRPQNHKTEABPK   UXKEIBG         DAFOR           PQPSKWSCCPGVLM 
MRDKNRCRGDKXFH  : PDUHIWLO        IPNGUTQFDYTFRI  MBUTNNCMUI      LRTYUMESWLFBMDI ENYRGQGGXX      GHBCNOWEBSGEG  
LQPXKVGXSAJTKK  : SMJML           DJPQH           PFUVLYXMLF      AEUMSTDCIBGFS  
WXSAKHUNYBQJB   : FNMQTIQBTFGQV   BQEKGAWRRDOKQU  QIJVMGBLHPTR    PMPIKQYPGF      WOJLJCY        
QLJJBJTYPTUSGO  : FYEQPGWHGIRTX   FHKWLKA         JHTCGIWDUW      YCDVKACHSYBO   
QOCQJFCSARTBI   : URXETJTOMLGV   
EHWPSI          : WIRCFKSG        PNMI            IMOKWHAMCVXILES
DFQUY           : ROIOV           OIEHH           UHOILRBABNTJY   JCYGW           MKQQWAG        
NHASBQXTDDXVDP  : MJKFJWGAYRSPKB  AFDKBVRKBCN     HFAQRAQBPHJRF   UNAXUDATMOHSS   TPNLO          
GYVKIU          : SECYQWGQVKBEY   CAMTBKGARS      TQNRE           BLOFQOEHL       NUYNMDCWG       UELCLYOONPTFP   QNWOAWRGC       EPJIWFMDCLIW   
BESEL           : GAFOJGAXHMMU    KCTVJIIAKGLPXLJ WLHGU           NAJTNJSN       
CKWPUALV        : QUBIFUXTWVYIG   GKEBXWD         KCNCDYAXBJCP    PAOCIEYPOQ      QTWXAYEUYSDOBOF
LPVO            : FEMN            OYUPOLMDIAJSDD 
UTEN            : TNMCULJBDLG    
FJMNHORNJVYVX   : UTAYLQHKL       VFDWL           IBIHPHCBV      
SQGUEEORUMGLJCR : XOOBTVLGNEGXPI 
EAJQNQHFGQEFMEQ : JYSDBRLQB       UELCLYOONPTFP   IYBEAEWKSENWYRR VWEW            VCAMY           SNPSTPSYH      
WXDDC           : BIQMSCI         WHYXJCAEEVEHF   QPRKW           MDTKVOES        LEFKWCMJ        OMNGBTR         FAGSVCEXTMEL    OOSBRTXJLVUDAL 
WXDDC           : RLGJC          
UYJDMSFFSJFE    : OPBLBSRBUIEIFMR MGAMXMDU        LKQURFLDBRXGNFD JYLJWS         
UWJDDDJIRPYAPWG : FULXLJP         QFYSOE          ITJHDGQMPHOFP   RNTWSY         
CCQBLTOHA       : BIQMSCI         OEFUBBOGGPCLH   PMPIKQYPGF      GTYQ            ELSJESSPOMG     XRMGGG         
CLDGOADA        : LPVLXD          ENIM            BVAAMMPWO       LKQURFLDBRXGNFD YWMYUIDFAN     
IDQQXHP         : BFWIVSJOFJIYLXH MQPV           
WPGRTJIWUFNEFJG : XRDLVINMJHFIFQ  GDAPAHD         PTUFYTSG        ABKGNURBGAXDXF  AQAGGU         
OMHRR           : FEMN            EFYAWIHNIPWVO   PWFGLXTAWEU     LQXKYEFQIYDMGI  CWOAIS         
WANOQNXJOWBUO   : KTTBWVDY        KCGFS           TWODPHGXEGXEQGU UTAYLQHKL      
EATCHI          : IJTSN           GSUMH           POHUALX         FPIMQMVDOFODFRK IFAYNYNEGLD     PRTOQQL         SXWCTELHMHP     GVCEDUFUFJKBB  
MTPHJEPDWAAYP   : NUMJEOINMXLXVRO WQSGVUWPUQRKA   UQXDCOEW        PMOVF          
SEOE            : IDQCC           RYXPFFDXHVSYLN  DUMCYEBK        HEGUIGYMQWN     VXYMNWIWRRJT    AYGIXGC         CLWLKQABBNGDJ  
NFPFCUF         : SLIBWGYJJBXNFGO
YMGHBDYIOEA     : KJNNRXUFG       HYKM            GYDWNUXNUWUDV   USGTQSXWPY     
DCRESLWYCB      : RSJJQPXJTVPQVT  GXEF            MJBTFNNPHTBHO  
QIJVMGBLHPTR    : WXSAKHUNYBQJB   IPNGUTQFDYTFRI  HIJHFAVIB       MYCJOS         
WQDLWEFCGA      : IWRSHEURELVPAU  SQPEIRIWJYECYBW XOAACMXFKLOCGRM XHUXARBFBL     
BLECNIVEQIAE    : QWGFIDCIN       GXGDCFB         WWAEUFUDCMTGQU  CKMAPAAMVHB    
DRYULSN         : OIEHH           VOGYMPHXWNAU   
JTYJXFLGF       : OPBLBSRBUIEIFMR WADKXIJJ        DVHCNTPVDACCB   VHGXLFJY        EBMM           
KQAMGI          : LBTNFKRYLOLEFY 
LBTNFKRYLOLEFY  : KQAMGI          MPLL            RICJNRD        
YXAYDN          : BJRWVB          YWIPJQQW        EDCWRXMYPALQQ   BLOFQOEHL       FCNAVQALM       WQSGVUWPUQRKA  
KJRBLFIVSVW     : EEDXASV         CFSVLVHQMAO     TKIFXWPFRNO     MUMTCXJFDIAQX  
JFYDENSRTXS     : JXEQYVWXJBRBJ   UBJDVBCDRVU     YWMYUIDFAN      IGWEMDCJUCXFJPM VMYEV          
YRMXW           : UBBIQ           EUDTEVV         LRKPMXEYUQEHVHL IUVCWDKOQP     
FIOA            : HVEGKIJFMA      GXGDCFB         CTIKCSOSGRQGS  
AHTXARWOC       : DNRSLYSGEOT     UDBTUMILLLMYTLL
PHJDADAAWMYQAYN : LNNCNMSUT       DRWNHCUJ        RFAIBDNDI       SXWCTELHMHP    
FVTHIVOEVOW     : FWERGXKKUA      OFLMRXEII       XNHLDXGMNWNUIF 
DBXSIJYJMB      : RTEJMFRCVKN     UFAWEIIMABMNUF  XGAEWXAHH       WHOXLN          LTRSMEASWNDQT  
LNNCNMSUT       : PHJDADAAWMYQAYN HYTUXDNQ        OVPLFNWHHOJHBE  OTASAKCXD      
OBYMPGIEFC      : TBIVK           FFLQXKQY       
GAFOJGAXHMMU    : BESEL           FWERGXKKUA      CMOCOGN        
QLOJGJBXMCK     : VWQMXWEJNCEP    NGKQWQ          URVJQAX         ONOLCAWNLJOH   
KTJPXTVAB       : KWNOJW          MIII            BGLKVLKB        RICJNRD        
LHNJOAXLCPWTBG  : OVPLFNWHHOJHBE 
CEPHQURMFIKB    : RXBBBCYIFTPLLU  DTMEOPPMIESYK   QTSMIOIQBBQIASE YIVGKSQ         MDAMNYQSOFWROI  GVCEDUFUFJKBB  
KCTVJIIAKGLPXLJ : BESEL           KJGY            UOKSH           KEUGCC          OVPLFNWHHOJHBE 
RMEXENOA        : NDCJHKHVCSDS    SYVV            WFSXEWFXQYEP    VODYSLQLPFVCPTG CYOK           
EHQOIYCKTXVCIVO : VMFHOXHBOONQNU  TKTWRS         
JEPWN           : JSLSCSXLPAMHK   WHOXLN          FFLQXKQY       
OCWOHK          : YTPHNOQUCIYCNW  YAYOYWXAKD      XKDPE          
JQKQJBBJ        : FULXLJP         TKAWXOFV        COOCWWIXE       JCEDVRIYFKJH   
NDCJHKHVCSDS    : RMEXENOA        GWQTHFB        
QKFVHWFS        : SECYQWGQVKBEY   PWFGLXTAWEU    
OLPHX           : CHPTLJPGWQLEY   VMNTJBPAAGROM   THDSQFWHX      
IJUXOYH         : GBOOLFCBR      
LQTOJWJ         : IXUPSAOGLWX     TUAONRV         MKFBEFTVRAV     EOVDXSYTRMCQH  
QVIMGFRBKG      : SHMFKDOBSOBQG   PYPDTQENGOTBQJX WIRCFKSG        RXVNKKXDEENPQTT VUQWCRKJ        EOVDXSYTRMCQH   JHTCGIWDUW     
APMSAVPXKOFI    : RQDJTHRDDH      JVLQHWCP        LNLYD           LJFJIAFX        AJYB            QKUWOGJKQR     
XDRHADI         : NDEIYHAKSVYKVJR VUUIKRAYHR      MGAMXMDU       
YQFFVWGIFV      : EUYDDLDSMV      MNIPML          MXTHWJ          RICJNRD         XSVVWBTTVGPR    RCXCXBRG       
UKDUHT          : GBBETHMWHT      QUBIFUXTWVYIG  
TKCDLAGFII      : BIQMSCI         DHKJRDKVYFAMXKI
QCKHJR          : HAICDFNFHOCLU   OUEHM           UMNRIIKHMNVSMN 
HBNMWXKJBHSW    : VUQWCRKJ        AEUMSTDCIBGFS  
NIFQVIYCQ       : JYFM            XHBHHOILLQMUGPN PPQJHDOYNMQ    
KHNWQXPXHQLTPJ  : DQHOPAWVQT      EUDTEVV         OBQNWB          GWCWLEA        
YMOSM           : OHXTIBMBMMLYVO  FPIMQMVDOFODFRK ORUF           
IUYBQHCUX       : WAASPJTLAFJJX   AHNRCPTTMW      WIXRVK          CVLGMQN        
IHCFACUXJNLFDW  : UIQLIOJNBFCV    JNOFCWGDJUOA    KFGLHKM         WAFLOHT         EAPAYWGTSCJ    
FKBA            : LNIULL          JMSOYHCGWI     
UITVLMGNIGB     : HWWTWPKHVC      KOPOKN          TBIVK           AKYOSTSBHMBEA   FCYSHGPCDYSFYQV
QDVQFTRQHDW     : CQYIVYAYJD      NNUIVAJODMNVHST IKMFKFFXQNUMPWH KIYIBKMSJLPER   CVFL           
BLUN            : JSAJCTDEMKVYR   JCHNIECTKDEIKR  VQBDGXPQEUIWEU 
WMLHGHS         : SRSNNPCRARFLOV  KKJLKIWUXFK     SAQMT          
NGDUHVLN        : MLGBRTPMEL      MVPQ            MIHWGI          VAALIWM        
EUOVMXALNDYKQNH : MISFHPYTO       TDCCCCQ         YLYNR          
YOJIJ           : IJTSN           HSHXROXPBCPFHN  JSCVHPFH        ENYRGQGGXX     
YPKVAGJN        : GVGCUPTKGKDOEUH ACPPO           NUIL            DVPONTPWQOTG   
NKRMY           : CCDUFERBCO      PGJNLGKDUEH     CNNQPRUPLWSGDH  LRIJWLHUY       XGQNAOIHBCBHN  
OKGR            : DPUORVCNFUOO   
RIYBL           : CFSFWQDTJYX     SCNYNB          KDQCUUUUHUS     OXHHCYYPACVN   
SWJCDKUPGUYRK   : TWYEVVUGQRNJI   BNQLUHNA        MUSVKPDMESNUWC 
HWWTWPKHVC      : UITVLMGNIGB     DFUFTUCQ        LJFJIAFX        JNOFCWGDJUOA   
PMURAVKWH       : NDEIYHAKSVYKVJR TYROCGD         OYSSKUGQ       
DRJUAEVTQBBOX   : TGYQEGOOTJTULY  UMKEFP          IPALOLHBNHVTO   HTFQTHPDD      
LNIULL          : FKBA            KXBCPA          WCIYV           GWQTHFB         ICVEWVSMPPEK    TPIAUSCIQQJCMF 
CAMTBKGARS      : GYVKIU          LBGHULCVXVD     GKJMI           PAROQVUHKQRGLFF
LDBNJWHD        : LMPFJOLHNGOGXEP NEJQKQKPNSAYGKY IWNLBDAYH      
ITXGHLREXFVCFKV : YBQEQTXWQB      LQOUGOQWIMLBFDX GWSISHXEVJCBPP  HFGMFBEA        TNMCULJBDLG    
UCHOW           : FIQKOVEX        GQABLNGPE       WCLENELMJPYYL   XHBHHOILLQMUGPN GIGWUYEBMIFQWUI CQOLBDGL       
ACPPO           : LRFAPSABWGN     BVSVUCAKRXFMO   YPKVAGJN        IGEUD           QDDJNCM         TDPGCLQBDAGGK   WDTBEVL        
YTPHNOQUCIYCNW  : OCWOHK          WJVECAMNHERAJOX IHRMDLUOUYGYTV  OXYSK           FIFFED         
UHACCELQEAS     : HYEGKCTW        NMGUXIUFQLMPU   GPXCJBCLJWTQRFB
SKWIJQATGOMBR   : TBNG           
DTKAB           : CUMLTPRV        MDKLJP          BFKYABJVIYQPJ   CMFHGKX         AXHMGJN         CNXFKXRRUQT     DHKJRDKVYFAMXKI
KBJMI           : MIII            PLKQ            KBXEFJ          HEGRMW          YNEBLXKKIBLCOJP
GOXBWQ          : FIGQGEE         RNUPPS          EQNW            GLXIDYIAKGWIL   GNIDCDETWIPB    QMLQPTHANVOMJM  KVKHQNDGKU      THDSQFWHX      
WBVPBPWSE       : CVXE            UWWRJCXULKH     AYYAA           JWFNLACQPTRHHO 
MYFI            : LBMDARPJASCG    OEVRSDVNFJHR    TUAONRV         XHUXARBFBL     
IJTSN           : EATCHI          YOJIJ           GLFSTPDL        FGFCOQBXSWYJVN 
HXDNMDPLVE      : HAICDFNFHOCLU   KVDQ            OOSBRTXJLVUDAL 
YCBCUAUYC       : TQNRE           IAKMJWGCX       FAQQXU         
BIQMSCI         : WXDDC           CCQBLTOHA       TKCDLAGFII      CJBOKRRWCVNN    TDSJRM          XRNKURX        
PQUNVJAYB       : IDQCC           VIXR            LYRRCAM         LHAQMXFN       
WHYXJCAEEVEHF   : WXDDC           YBPYBF          ACINKPDXDJBW    EUFWGAFJUWRNEN 
RVTKBFXQVSFR    : QNQM            TKAWXOFV        ORWGOYYINHDFAJ  BRUCQMBCCFA    
HSHXROXPBCPFHN  : YOJIJ           NDNQAGR         WQBGYJXDMXQVBP  YAARVUNALP      MPYGLN          EEIJFMYBSBT    
QTSIRNUSUU      : KYIHY           EPKKBOHOBKG     RVGMKX          GWQTHFB         KJOHRNVRRVQPFP  JQHTEJMIUGMSV   WCGTRDTGT      
QPRKW           : WXDDC           OFGTFUHLEDAO    LQOUGOQWIMLBFDX MYCJOS          WBGOQPBFA      
FEAWVA          : NFWRRXSBNRU     DFAEQSPNQG      UKDNDEWMLDBJVHL WQJJER         
YCEGLSSC        : KMOLNSBWYX     
LMGBJAXEMOUGBT  : TKTWRS          CFFYXBVMPDXPNE  UVTJCYHXPVJVEQ  IHKYFOVN       
GXHFVHTUMYCATW  : BPMPB           DQHOPAWVQT      MRXNLRLUF       CVLGMQN        
KKRQ            : WAFLOHT        
CSMGHEDNFWV     : RUPKCQDRVQEDX   GLXIDYIAKGWIL   EKQLMSND        RNCHEJFLYM      OBQNWB          IKMXHVMYCSQY   
XFTVPO          : BPMPB           YFAYVGTOMNJTT   YDHFRXEJEJ      KWDJCCTTCFKNML 
EPVELUHVFAOT    : AQXWEPOPOXDDLE  MPYGLN         
KJKRNQI         : WJCOQAS        
PGJNLGKDUEH     : NKRMY           YJPYLQL         ITMWJGLLC      
CMAWVVCXMYCWI   : BVWCROSJMB      PSMW           
RXGCSVIDMTJWX   : KJNNRXUFG       DEOYP           DYNDOH          UTIMA           PRTOQQL         PILVCQ         
DFUFTUCQ        : LMVCSQ          HWWTWPKHVC      KYIHY           FUHFMWVG        QXAACGRQE       GPXCJBCLJWTQRFB
GOFHRFPHYN      : XNBQTRSU        FNCUMQMY        PCDYSSDXNIWNQ   VWEW            RATJVMCECPM     IYMWMBLUTWAOLHO
BJLJMXFXWF      : GKEBXWD         XECMVSSEOV      EUDTEVV        
ANYHHVJA        : KCNCDYAXBJCP    MISFHPYTO       KFCMYCMRWFAIW   AYGIXGC         WJCOQAS         OGVH            ITSWNSDXCWVX   
SPVAJDSSCIIFRT  : ACANCTXYCOWLR   PLKQ            OEVRSDVNFJHR   
GUWERCKSRLAAHM  : CFFYXBVMPDXPNE  UVTDMFPOGLKYWM  QJJVJXWCGXBKU   ISRFY          
XHRUJDXEVD      : BIBH            NECTINFOAM      YDHFRXEJEJ     
GIHBAOXW        : MXTHWJ         
PBIKTT          : MBQVLYUMR       LBMDARPJASCG    AXHMGJN         MUMTCXJFDIAQX   BXYJCSHUMD      VUSNSF          MARKWKJBEVLAS  
VECXCLSYUVXAUB  : KFHVSELFJP      RRTAARVDAOYSA  
BLYELPCILUKVF   : FXGHWGHPJP      MNRNYUCKPJSBCF  YDEQHNPWNUPOB   PDDEHFEN       
PUCV            : YBQEQTXWQB      NTUSJLBBALOGAHG NRBE            NEJQKQKPNSAYGKY ONOLCAWNLJOH   
CBKUAGTAIODARP  : GLMJDDNUNOJHGT  ICVEWVSMPPEK   
WBRBKFVWBEF     : MNRNYUCKPJSBCF  OOFEDLC         RXXBSLUHJD      VJIVSE         
YJPYLQL         : PGJNLGKDUEH     UHOILRBABNTJY   UXLHQDXXLRG     TFAYLRW         JHTCGIWDUW     
SRDTCRY         : EHMHOYUGC       JBTHIRSKUIA     CASHNXYCGLNGICF UHTLX          
JOEISXKDDG      : VLNUJFAWJSLIXM  JCFKLYINFJHS    QTSMIOIQBBQIASE RGJKUHPIF      
EKJWMSMNEFY     : VWQMXWEJNCEP    ROIOV           POVJVFBMN       LBWURDUPTRKRLY 
BTQWVKVB        : FULXLJP         DTMEOPPMIESYK   ORWGOYYINHDFAJ  YMHHGNWXXHNETER DTUJAAJHDS      DAIXKIGIAJAFXFW
NHFGHP          : VCDOQEXJINHWBIO POLUWWKWWUBC    IBERXLDAJNKIJWD EQNW            VAUHXLH         NEICWMTTNAGFCDQ
KWNOJW          : KTJPXTVAB       QEUPKKFPJYADL   RACOFMISCFN     QDKQG           WICLYL         
XRDLVINMJHFIFQ  : WPGRTJIWUFNEFJG TXYGFJL         KNHXFUSDEECD    ALAALVDWG       WDPNMIGKIITFDR 
INSRSYYLKLKAATY : BLGFMCRJEC      YJJDWVBGV       GHQOU           GNEVCND        
UQRIOCVB        : FUUOUXUWFSHX    MNOY            VUSNSF          YSNFCSDXNPFJNAE
FJWNCCVR        : MJKFJWGAYRSPKB  UHKFSPRNVDKXX   KEMVEP          HMKAMBDPAHOIVOM
QKVRXIEIIEFHU   : MDKLJP          CASHNXYCGLNGICF AYXMABH        
AOIPTHSKMCH     : BAROL           RICJNRD        
GMYXLPLI        : LTGERXNRVKUBA   TYLPQTWU        WBIMP           YDEQHNPWNUPOB   RIMLHMOHQLGMO  
JSLSCSXLPAMHK   : JEPWN           HWLTJOPVDQ      EPCPWGXYYVGFUM  TEUMAHPBKKUISA  ORIIDNWGYHLN    GECOKNHJAGYR   
DRWNHCUJ        : PHJDADAAWMYQAYN LRVJ            QPIBMXCRXT      RJKJW          
JIHVA           : KAXXRILXVKD     QPONMQICHEYLTIF NGICTYSL       
GKEBXWD         : CKWPUALV        BJLJMXFXWF      OKBYBHTRREYJNYJ PVKQWIK         CTKQXNP         DVWY           
WRLYGSKKXEJLLN  : LRVJ            ENPKRYNYGMJNB   VCAMY           YHFCW          
XWUGGQJBY       : MRHGLSUGEAREWMC LCRYVP          FGJNWCCOHGSO    ONOLCAWNLJOH    VHAV           
FATFGPEABGG     : WIILRONAP       VMLHPQCJP      
SSTWCFLSPJR     : REOFKWWOKRWGQOY LRIJWLHUY       EYMOMCBAGESVVNP
RXBBBCYIFTPLLU  : CEPHQURMFIKB    CASHNXYCGLNGICF YPYELD          YWHGICOMCWXBXA  SJIHBIOM       
MDTKVOES        : VPJVBNMGDNMPV   WXDDC           QICJNMMMVSTPHQ  GTAGJQAUAHDIRK 
LELBPDMIBPLESL  : RAFVQCVWHPOP    RJGLAFNIGRVAB   OQLK           
XHDLSAYHDURYJV  : MXSRM           SIKEA           KCVMUHM        
CJBOKRRWCVNN    : CFSFWQDTJYX     BIQMSCI         AXHMGJN         AGKBFIKKEE     
IBPGIVTDV       : VBNOEPXV        OSUCOLCJP       VFDWL          
KCNCDYAXBJCP    : CKWPUALV        ANYHHVJA        LDADNGLBSMO    
TKTVGHLIPNY     : BLGFMCRJEC      UHHDBSQLWN      YDWAKGUXCLJ    
XURCSMMUC       : MTUGDBXBQRYBOD  KBKALXRMUCYW    HHJOSTIK        UXKEIBG         NFNPXFSXUBWPX  
BBTBFGDWDYHWW   : XJKQA           YLHODXA         XALHCYLSJBLD   
HJYYY           : MUUGUQGQIO      VODYSLQLPFVCPTG QDCYSHIGMN      OTASAKCXD      
AWWTYRHONLGQ    : HEGRMW          INSM            FHEELLKW        VRVCU          
ARUGVR          : RGNUIWLFO       VXYMNWIWRRJT    RXWXJN          UWSJLYJDJMYYAH 
WAJURQESRF      : THTIM           XIKQOXXXFKTLSW  RFULBSEUMEQD    WXGFTSEIDNRQLPO DYNDOH          FSLMKOW         LWKJAAYJV      
RCRMC           : BAROL           RGMDJA          DAFOR          
VQAHYSWB        : BAROL           QRMBDBADF       YCUH            YGCFCWKLOO     
RKIKVGMFBGXHAQ  : JCEDVRIYFKJH   
UKOPYSC         : DERTYOSWOG      NUYNMDCWG       QJQYI           YHFKSVYPF       UQXDCOEW        FFFFYRGUIL     
LEFKWCMJ        : WXDDC           MRKSUJIYWEDQ    GTAGJQAUAHDIRK  RHHNSBSV       
WSJSYVBAEYJG    : VJBG            PREXEFAIUNA     RVDLBY         
VCFMTEGXAT      : BAROL           EDVEOLYRSCAITT  CASHNXYCGLNGICF NIIEAWUNPD      OGBMYP         
HFBJRKGQDPJ     : ROBHKFLGETV     XGAEWXAHH      
NMESMPYGLDLBYQ  : UOMLBT          UDUICCBT        SQAGWXXAJI     
WSDBAICLCNSUSKH : NDNQAGR         ELNES           CQYIVYAYJD      PPGUURWHTKHLWDQ LTQIFCLRVYA     LEDXCWC        
YTCTGSUNGBYJAR  : EDCWRXMYPALQQ   TNMCULJBDLG     WJYL            FJRLDOKIQBW    
AKWBMHEYMT      : KPDMM          
HMCOKDJNYR      : PIQHXHVPJRE     AYGIXGC         URFHU          
UHQXHBXBVXMUC   : MKMUMCOQOH      THQLJHR         CHHPLCDIYFBNDRP REBHI           VFDWL          
DGARARYMW       : SCNYNB          AXHMGJN        
ACANCTXYCOWLR   : SPVAJDSSCIIFRT  YYYB            KYIHY           KAAED           BHIFWVCHYOOKBG 
MOXYJAB         : KTSOIQPFB       KKRWSCSONJNJU   ODKICBVJI      
IDGKVIY         : TYROCGD         KLSBPYRTKS      GWGSUUMCIPNK    ODWH            FIBMVTFWENNNUF  YXUJWXE        
YYYB            : ACANCTXYCOWLR   MISFHPYTO       NUMJEOINMXLXVRO
DUMCYEBK        : SEOE            MSPMJFF        
BXMYY           : TYPHAH          PQMQBTMANJ      VRVJ            AASB           
YCNJG           : REOFKWWOKRWGQOY JCYWTUCWYEHYRPF HTFQTHPDD      
TEHSYGSA        : SKIIHTVF        XCXTJYRIG       UHHDBSQLWN     
HEGUIGYMQWN     : SEOE            VMLHPQCJP      
KMOLNSBWYX      : RQOBJSDNUMLBRF  YCEGLSSC        NDQXIMITJHRVLF  MTUGDBXBQRYBOD  ENPKRYNYGMJNB   BRUCQMBCCFA    
DFLENE          : QQTJXONF        YQOT            JOQGGR          BRUCQMBCCFA    
YMLGJTM         : VFJXGDWMVSYXY   PVKQWIK         GJHQAOISVAIMA   WCTGKHIQ        RYMPBQQWNLGYKRE
IFHVWTK         : OTTL            IYBEAEWKSENWYRR PNMI           
FXGHWGHPJP      : BLYELPCILUKVF  
OFGTFUHLEDAO    : BVWCROSJMB      QPRKW           IDNNUOS        
HYIEUTRDTBKR    : UIQLIOJNBFCV    JVWNVS          MHQKRXNLG      
THQLJHR         : UHQXHBXBVXMUC   CYQCROF         EKQLMSND        EDWAUVI        
DWNK            : IIQGACXGNFV     POLUWWKWWUBC    MIII            EUYDDLDSMV      LKSDRFBBONCWQS 
UOMLBT          : NMESMPYGLDLBYQ  OGJSARUASNYASKN JKAHL           QKFNXTATYTQ     OLIM            VHAV           
LBGHULCVXVD     : CFSFWQDTJYX     CAMTBKGARS      YKFL            AURTVHEUU       WOJLJCY        
FWERGXKKUA      : ANXQCTVOUBX     FVTHIVOEVOW     GAFOJGAXHMMU    JNWNMDEBMNUMHP 
HWLTJOPVDQ      : JSLSCSXLPAMHK  
KOPOKN          : BQEKGAWRRDOKQU  UITVLMGNIGB     NQBXLJQWVGUY   
QGSPMM          : ANXQCTVOUBX     MMEWGHMFOYI     BELKQ           DXRD           
KYIHY           : QTSIRNUSUU      DFUFTUCQ        ACANCTXYCOWLR   YIGKUCTPBQMXHJ  IQESSHNPKU      CGFEPAGWHKU     CCTFHIQV       
QWTKILCEOVJB    : EFPSVJDPMX      UFAWEIIMABMNUF  XPQV            BMBBINVTFMOCI  
YSWNFPVAFKME    : INVHYKLO        LGJRGINUMUA     XLIB            COBVIKAGUSM     WHQKBBPYQWXI   
LOENWU          : BCIIVNEOWQG     TKAWXOFV        YAYOYWXAKD     
THUF            : BVSVUCAKRXFMO   CMNVGSNRKKEK    YJJDWVBGV       VYIESRD        
YVHKYT          : KHPTLXJCWBBUIPL BYRWJNENNOK     KXTG            KAKUDYFLQ       ICVEWVSMPPEK    YLYNR           PROWXSV        
RTAXJXX         : PKPYDOXEPHXXXU  RLUV            OFARFGAJ        XJVGOBUIELHTJ   XJKQA          
INVHYKLO        : RYXPFFDXHVSYLN  YSWNFPVAFKME   
IBERXLDAJNKIJWD : NHFGHP          EHVJBJV         UQXDCOEW        XRQKFRD        
YBPYBF          : WHYXJCAEEVEHF   SYVV            RVDLBY         
QDQSPEHA        : XQRH            BDGIJIIP        ELSJESSPOMG     UVRWGNRDB      
JGGJRMJ         : LNLYD           ORWGOYYINHDFAJ 
CUMLTPRV        : DTKAB           JBTHIRSKUIA     BMRQFPXWSCDBJS  SIDLWKABPJUTBT  HOAYK          
HUVOFNTVI       : JSNE            QARRLXSHSGCRVW  AYGIXGC         SLOLW           XQFLN          
BPMPB           : GXHFVHTUMYCATW  XFTVPO          NUIL            PQHRD           TDCCCCQ         IUYGLXYKKTAYEIE
YLNLUQNRF       : YKFL            MVPQ            ADRIBMJHPWP     XGQNAOIHBCBHN  
OUUKPEF         : KKRWSCSONJNJU   PSSXRKRY        PMOVF          
SKEMJMY         : DRNUQBQ         BBVBODGPNTHEIA 
CLCGEBRR        : LWOCGN         
OJEJOIXMDK      : VUUIKRAYHR      XUNDJGG         WJYL            WOJLJCY        
IPUDDYQONR      : BOVLP           LGYWNUYWVWFQB   IWOJ           
QDDYHHSCXH      : BIKNU           DYJCYALD       
DSELSSQ         : LPVLXD          ERYDSC          JCEDVRIYFKJH   
XYVSFBUXPIPQB   : VOWPPOEILJ      PUYRYTAGQP     
VACF            : HSVRTOX         OLIM           
EEDTJXYW        : TQRETMJJCYKUC   YFAYVGTOMNJTT  
RNUPPS          : GSHEIPOWP       GOXBWQ          MNRNYUCKPJSBCF  VAUHXLH         SMCUIG         
UTISLQIEUBB     : WKGOXAH         VUSNSF          UWRNWXILEMLGKO  XYGMAIOHLUFCXII BSKWQPIVB      
FIQKOVEX        : UCHOW           KFGLHKM         VSCBAYMXE      
FULXLJP         : TYPHAH          UWJDDDJIRPYAPWG JQKQJBBJ        BTQWVKVB        WCLENELMJPYYL   JJKED          
CDVYLOKFWPAASU  : GSUMH           JCEDVRIYFKJH   
DNRSLYSGEOT     : AHTXARWOC       JNWNMDEBMNUMHP  KKIBSJDN        FVFN            PPJGW           MYKSXIGNTRV     UHTLX          
AFUDKXYJKNVPM   : QGHYXTLXMAICOYJ RTPUAJQQWMXYNTN GGXGWKGUGPOWDIT DXRD           
ROIOV           : DFQUY           EKJWMSMNEFY     MIAF            BHIFWVCHYOOKBG  LRGPPHRATEBFHV  JCFKLYINFJHS   
DQHOPAWVQT      : KHNWQXPXHQLTPJ  GXHFVHTUMYCATW  XPQV            FMACTRDIWVWES   EKLNF          
SYVV            : BCIWYDXINVMTYN  RMEXENOA        YBPYBF          KYCLBR          SRSNNPCRARFLOV  IJOKEF         
VUUIKRAYHR      : XDRHADI         OJEJOIXMDK      TKIFXWPFRNO     VISIRLK         DOLJHR         
SHMFKDOBSOBQG   : QVIMGFRBKG      FORVHYLBCVIB   
RYVPVGOSBWEUXDF : WYWXL           OGJSARUASNYASKN HOOPQ           RGMDJA         
TXYGFJL         : XRDLVINMJHFIFQ  NUIL            HJCT            DQQRSMJSG       WYDKYWTMYC     
NGKQWQ          : QLOJGJBXMCK     OYUPOLMDIAJSDD  POCJBRKVKWAHHHD YCDVKACHSYBO   
RSJJQPXJTVPQVT  : DCRESLWYCB      XALHCYLSJBLD   
LPVLXD          : WQYXPRQ         CLDGOADA        DSELSSQ         XGAEWXAHH       EUDTEVV         AQAGGU          XIFCT          
JWMPIFOBSGTDQ   : NTUSJLBBALOGAHG WJVECAMNHERAJOX BTNETROA        KJOHRNVRRVQPFP 
SOWO            : NNUIVAJODMNVHST IQVQEQGERFBBIPQ EGPNCTRHRWC     AXMDIPXVPOLX   
MIII            : KTJPXTVAB       KBJMI           DWNK            BFACCQ          KBVCDNWAAVILTB  XHOF           
WADKXIJJ        : JTYJXFLGF       EHOWKGALCM      UQXDCOEW       
YBQEQTXWQB      : RABGT           ITXGHLREXFVCFKV PUCV            KTTBWVDY       
DVHCNTPVDACCB   : JTYJXFLGF       PTUFYTSG        CGJE            FHLYECTB       
MBQVLYUMR       : PBIKTT          MXSRM           RUNJCW         
DLADEDUIYCMMWCK : LCRYXUJXUWET    QOULCIBECB      THSYJYKIMEUAAUU SQAGWXXAJI     
FNEGWSJP        : OOQAPAE         JDLTVCFXOKCGG  
UOMKIQPWQU      : QOCHTR          UBJVUVDKRQKCTHF VOWPPOEILJ      WNJMICPBTBBPI  
TQLUSYKRDU      : UIXYE           KOGEXTOOIGHH    MXSRM          
IKAQISB         : ASTOVPQAFR      VPJVBNMGDNMPV   ATMDJMQRH       JMJBJDRAYXFWRMV IIQCMXCF        CLWLKQABBNGDJ  
KXPYKXP         : FULHYSPTHPT     OWSNRG          IUVCWDKOQP     
UIXYE           : LIYTKBWIJDC     TQLUSYKRDU      PROWXSV        
KYMJLEPHDXRDR   : BCIWYDXINVMTYN  UDUICCBT        EHMHOYUGC       FUUOUXUWFSHX    PFUVLYXMLF      WJIDFVLX        BFBRCPENJSNOVP 
YUBLUSMGQEJOOJN : QGNHJMQVQRB     FSVMCIDVCOGNYS  OGMKSEUGRDCTY   LESVXPPSSOHVG  
BXTNKGTANWA     : PYIQ            PIGRXEVWTASXLI  JCFKLYINFJHS   
DTMEOPPMIESYK   : CEPHQURMFIKB    BTQWVKVB        HFDUEIRHFSTWRO  LRVSNCAONKUI   
PYPDTQENGOTBQJX : QVIMGFRBKG      TYROCGD         WCTGKHIQ       
TBNG            : SKWIJQATGOMBR   BCQSPH          KRONMOG        
EVWQEDLFNRVOIB  : LCRYVP          TNMCULJBDLG     IGWEMDCJUCXFJPM
BFWIVSJOFJIYLXH : LCRYVP          IDQQXHP         QJQYI           UXKEIBG         VRVCU          
CFSVLVHQMAO     : KJRBLFIVSVW     TBIVK           MSSW            AEWHGLGIXYIFY   NFPOWPLNI       CGFEPAGWHKU    
KSKLXJTWCFLHPT  : BELKQ          
DTPXWUQUIPC     : HJFJYVXCJAJNR   MUMTCXJFDIAQX  
CEQFQJRDKB      : MYWHLYEPEI      FCNAVQALM       KBKALXRMUCYW    BVAAMMPWO       EEIJFMYBSBT     FHEELLKW       
HEFSNWPWAJOXI   : AIYDMUKJBKQMH   FFLQXKQY       
PDUHIWLO        : RYWPGHCESOGXCA  MRDKNRCRGDKXFH  MGBBMLLOOHX     FHEELLKW        EGPNCTRHRWC    
QICJNMMMVSTPHQ  : MDTKVOES        CVCPWNGEFHPS    WQYET           LFDSUKEPIIOYFH  OOSBRTXJLVUDAL  DHKJRDKVYFAMXKI
GQSWRC          : RTEJMFRCVKN     BCIIVNEOWQG     IGRGHBUKPKIW    EUDTEVV         RJKJW          
JHHQRGCJWURAG   : HJFJYVXCJAJNR   MBUTNNCMUI     
OTTL            : IFHVWTK         CASHNXYCGLNGICF BMJXNPQCEE     
QDVHKEBFCUHN    : WIILRONAP       OSUCOLCJP       GLFSTPDL       
RUULCYUBVODDTS  : OYNAIFQINDSWCQ  OALTLSXYVTBUUL  XIFCT           SQYJJFEL        YSGCQYEHBMOCC  
QGNHJMQVQRB     : NCCP            YUBLUSMGQEJOOJN GTVFMWLM        NWFLDUYCO       IRFOXLRXAXN     JAFB            WQOQTEEXSHXLW   MIIJPHQVYTW    
QGNHJMQVQRB     : FNQDLQTJF       CTIKCSOSGRQGS  
MLHSFEPQGOO     : GEXHNA          WTXRKKRKLITWYRW
NDNQAGR         : JWXHRJUW        HSHXROXPBCPFHN  WSDBAICLCNSUSKH
OFAATQXLLCEA    : YLFKUNVKQ       FJFAEM          HSVRTOX        
NTUSJLBBALOGAHG : PUCV            JWMPIFOBSGTDQ   VRVJ           
YYAGYABPY       : FMFUI           PHXHSS          SLOLW           INYOREMVH      
DBUEQJAL        : LRIJWLHUY       XXOT           
JYFM            : FHKWLKA         NIFQVIYCQ       CYQCROF         ELVMLVLTGL      YRGWYGJAUAGIYX  DVSE           
TBIVK           : BUKDN           OBYMPGIEFC      UITVLMGNIGB     CFSVLVHQMAO     IOMJVE          OOQAPAE         YDONHGXGGF      VSPDBPLH       
ELNES           : WSDBAICLCNSUSKH JNOFCWGDJUOA    JCEDVRIYFKJH    JPWHVMIN       
HVEGKIJFMA      : FIOA            ODKICBVJI       TABBVVNGGTAKO   BVKKXBDYT       LVWTPYUKR       GWQTHFB         YTQRXJPCQMR     TODPNIYUAWAMEL 
ONUXMDNOWQ      : YQOT            LJWRD           VIXR           
SCNYNB          : XEMOW           RIYBL           DGARARYMW       JQUY            MXSRM           MHQKRXNLG       XRQKFRD        
IPNGUTQFDYTFRI  : MRDKNRCRGDKXFH  QIJVMGBLHPTR    MHILDXPVXAIG    BGQTSJUYUJ      UNEAA           ECQTCABHB       WMGYWYAXQGWXJT 
NIHSVW          : UBJDVBCDRVU     YRXASUSHLPGFS   TJTPLR         
NVKPKJFN        : NCSCXIHKDBUFWL  MXNAJMSAINQMU   FCDAE           WOJLJCY        
OEFUBBOGGPCLH   : CCQBLTOHA       MYINWMDC        QAPEEO         
GWSOPPNHFLT     : HYTNOHLCCVKSAGO FHLDEKUCQ      
XECMVSSEOV      : BJLJMXFXWF      YHFKSVYPF       NFPOWPLNI       RXUJYYGK        QMLQPTHANVOMJM  GJHQAOISVAIMA   UOXA            VQBDGXPQEUIWEU 
FEMUGAEQJELXVDN : STQBTUGCDQRMCD  LGYWNUYWVWFQB   WNGLVWGWRIWOK   TWODPHGXEGXEQGU
IBXFAEKODDJJT   : HIKPBHLVALYRAMO KJPGRDSAO       EPJIWFMDCLIW    IWOJ            KONVBDDXGDTY   
OYLDVRGDKPHVPD  : QIQRQ           NDEIYHAKSVYKVJR QSOMRAAXYEI     VBAHQRAXPOHFA   VJIVSE          OAEVLDLCUFD    
FJKGKSGQDUTIE   : LUJXYLSVYWOUEWE QDOKBORPJS      QJJVJXWCGXBKU   NSWMNGUN        ENQHCSEJXMUKBE 
DLUEYAD         : IXUHGGM         PRXNRQMUKA      CDUE            OATHNFLMLJ      OGVH           
GGDVPCNSESFQA   : QXTDBV          LOWTLOUQMEDIAF  EFUYWIMOFX      UCIXQJNFDOXAPGW ERLWRLO        
JGGOEDXKIDYDHX  : WIAV            FAQKBWNLD       WHQKBBPYQWXI    UWRNWXILEMLGKO  RNAFHEYUSXG    
MRKSUJIYWEDQ    : LEFKWCMJ        PEKUBIFBVSKU    GHQOU          
WQBGYJXDMXQVBP  : HSHXROXPBCPFHN  LJFJIAFX        PQHRD           YSGCQYEHBMOCC  
KNHXFUSDEECD    : EEDXASV         XRDLVINMJHFIFQ  RGMDJA          WCQLX          
GTVFMWLM        : ROBHKFLGETV     QGNHJMQVQRB     VIUQSYXHV       KKJLKIWUXFK     EUVGIVOSVG      UFDFVRSE       
LRVJ            : MYWHLYEPEI      HWWTLTTC        DRWNHCUJ        WRLYGSKKXEJLLN  NMJEBBVVJKGWEJW SNPSTPSYH      
TKAWXOFV        : KUPPUBAI        JQKQJBBJ        RVTKBFXQVSFR    LOENWU          THTIM           CASHNXYCGLNGICF SRAAPIWSU       ERYDSC         
AQYGUCLFKGDP    : FGDIDGLQFOSBYEU CQOLBDGL        FFLQXKQY       
CDJL            : OGJSARUASNYASKN TWTICSCURUXFMUB PUWEAUB         RYSQDPFFJC     
EJYMFMPCKEJI    : FULHYSPTHPT     LIYTKBWIJDC     OTPVKV         
LYATWCGEOM      : JKAHL           XRRJGW         
EJKHVVYAFB      : YSBLQ          
KNEPAIYILNJLHGP : BLOFQOEHL       RNWGYKWOXD      PDDEHFEN        TJXIJGFHK      
LECTKME         : XCIWOKMBEOCIJRS SQPEIRIWJYECYBW SHOCMFLRNSAU    FSLMKOW        
IDTIKWYVMENMOO  : STQBTUGCDQRMCD  RMETXUTKUYPNJQ  WDPNMIGKIITFDR  IYNUFPTGRS     
ACINKPDXDJBW    : FYEQPGWHGIRTX   WHYXJCAEEVEHF   YQOT            VSXMKGGNAT      XRVFMSWCSXKEC   UGTHTDCGUTUTR  
NDQXIMITJHRVLF  : EYFAXJLASB      KMOLNSBWYX      PEKUBIFBVSKU    FIBMVTFWENNNUF 
BTJDWRRJHU      : WJPQGLYXE       KEGTAHWHAOJXEXI POCJBRKVKWAHHHD EGPNCTRHRWC     MHVEUDG        
MHILDXPVXAIG    : IPNGUTQFDYTFRI  PGWRYGCPVBR     UEWODBJAL      
TQNRE           : QVRCS           GYVKIU          YCBCUAUYC       LNVO            UWRNWXILEMLGKO  KRONMOG        
CHRNL           : UKAUKJQVUQI     AFDKBVRKBCN     FVNRPIYGNLNBG   VSPDBPLH        LVKYXUEFCMGVS  
GDAPAHD         : RDUSIMQNCYNCWIJ WPGRTJIWUFNEFJG VEDNMEDJJ       FFFFYRGUIL      FLHDVBQMYHYMQ  
SONSGLRHUA      : RMORAWN         AIYDMUKJBKQMH   AJYB            EJYJBPCBNWA     CVFL           
QQTJXONF        : QWGTXNOKUOFNK   PYIQ            HJFJYVXCJAJNR   DFLENE          KBKALXRMUCYW   
CQYIVYAYJD      : GSHEIPOWP       QDVQFTRQHDW     WSDBAICLCNSUSKH GXABXCP         NSEHGKLDVON     MGBBMLLOOHX     KKHNCBGESD      WYDKYWTMYC     
EUXWBKOKHPOX    : ASTOVPQAFR      IMABTTQIBWNOYO  QGHYXTLXMAICOYJ OOSBRTXJLVUDAL 
KJGY            : KCTVJIIAKGLPXLJ NWFLDUYCO       PUCQSMISOSGFW   VIUQSYXHV       UXLHQDXXLRG     FUEEYQJHR      
MIAF            : ROIOV           MYKSXIGNTRV     FWXIIGXFYAN    
KELMDUQNYNO     : YCDAYLEFMTY     TDPGCLQBDAGGK   BXQBFEKMPPXJ   
OYNAIFQINDSWCQ  : BVSVUCAKRXFMO   RUULCYUBVODDTS 
MSSW            : CFSVLVHQMAO     HMNPAMSJTIOJA  
WIRCFKSG        : EHWPSI          QVIMGFRBKG      NFWRRXSBNRU     BNQLUHNA        ADRIBMJHPWP    
HENG            : LLRIHBBBKTNFAB  BELKQ           QTWXAYEUYSDOBOF WCGTRDTGT      
PQYIYPLR        : UCKRKKY         XNHLDXGMNWNUIF  PAOCIEYPOQ      CCNWCS         
PKAFDSEI        : HYEGKCTW        UTIMA          
MBUTNNCMUI      : MRDKNRCRGDKXFH  JHHQRGCJWURAG   VYENJ          
DFRTGCVVPN      : TYPHAH          DKBCHT          COBVIKAGUSM     PHYR            EGCAHBJVJUJMDJH
HYKM            : YMGHBDYIOEA     BSUDAJNWOJWTI   OFARFGAJ        EFYAWIHNIPWVO  
EQNW            : UBJVUVDKRQKCTHF GOXBWQ          NHFGHP         
QRBEIDQDOU      : XNBQTRSU        MEVABLABMXS     AEWHGLGIXYIFY   RTMDCUVWOWMFYD 
TODA            : SECYQWGQVKBEY   VOAF            PSMW           
YWIPJQQW        : YXAYDN          PHCKPKLQNXKBDLE RNWGYKWOXD      RKJVFVMTWEDQFTF QQEDY           PWLOXKYB       
UDUICCBT        : NMESMPYGLDLBYQ  KYMJLEPHDXRDR   WQSGVUWPUQRKA   YGLRAU          XRRJGW          XPWKLJMHTYKPQDX
GEHYKVUT        : KYCLBR          FWXIIGXFYAN     JGDVUFD        
JYSDBRLQB       : EAJQNQHFGQEFMEQ FQRVPN         
HAICDFNFHOCLU   : HQPKRNMAXEKISIC QCKHJR          HXDNMDPLVE      QCSDJE          FYEIYMRKLTASNL  HFDUEIRHFSTWRO 
VWQRTMK         : QJLULFJWWSXRCEX HJNUDTF         TGYQEGOOTJTULY  EQWPFTGUIR     
MDINUUGXYNY     : UBCTB           HWJOFA          GPWVVUSPR       WQOQTEEXSHXLW   QTTKSIWBOM      WIXRVK         
REOFKWWOKRWGQOY : SSTWCFLSPJR     YCNJG           DTFOCTEKSQM     OGVH           
DLQPQYDNTJNVYMF : OOBFSGLJA       WQYET           MFSETQY         IFAMVX          IYNWPRDYPOAJPTA CNXFKXRRUQT    
TWYEVVUGQRNJI   : SWJCDKUPGUYRK   BVIPACIKNENFF   XJVGOBUIELHTJ   VYENJ           YXUJWXE        
UMCL            : UHOILRBABNTJY   RXDYQUQFSPXJD  
SKIIHTVF        : PYIQ            TEHSYGSA        QPIBMXCRXT     
LMPFJOLHNGOGXEP : TMYDHIWKM       SLIBWGYJJBXNFGO LDBNJWHD        FVFN            OOQAPAE         CWOAIS         
SKVWXARLKASFXA  : UOSMHMFKD       FGFCOQBXSWYJVN 
JMSOYHCGWI      : VWQMXWEJNCEP    FKBA            QGOFAQ         
DJBVUVIQSHSKU   : YUMCHFNHASYJM   MYINWMDC        QGHYXTLXMAICOYJ
MPLL            : LBTNFKRYLOLEFY  KWAXVBLH       
OUEHM           : QCKHJR         
QQKQCH          : GREPTWQDP       ULJJKADQMAA    
LLRIHBBBKTNFAB  : HENG            GTAGJQAUAHDIRK  WJIDFVLX        HDTDXYCENPTKW  
LOMCLQJAUDRHTT  : ATGVYFEGTL      GHQOU           NSOXB          
PHCKPKLQNXKBDLE : YWIPJQQW        VTANM           IKLYLOCONQSUDOW
YUMCHFNHASYJM   : DJBVUVIQSHSKU   ILRPWE          GJERPXFRB      
DFAH            : VDUDOMCXCAV     RCIHWMHYHEFXAP  RVDLBY         
RRDIHB          : IQESSHNPKU      LQXKYEFQIYDMGI 
LGJRGINUMUA     : YSWNFPVAFKME    GJHQAOISVAIMA   KIYIBKMSJLPER   JNJDDURYES      AYXMABH        
EDVEOLYRSCAITT  : CSHPKEIMFAEVMA  VCFMTEGXAT      KDQCUUUUHUS    
DEOYP           : RXGCSVIDMTJWX   CJYFCLFLXNXRIGU RBTAUEGJ        DGDBCTILNKVE    LFJTDD         
KHDUUAKR        : IYBXGFATDILEO   WAASPJTLAFJJX   XHBHHOILLQMUGPN WJCOQAS        
NWFLDUYCO       : QGNHJMQVQRB     KJGY            CVBYIOAE        RICJNRD         XRNKURX        
GQABLNGPE       : UCHOW           KAAED           VMSXGLUAXHRUWS  VWEW           
HYRO            : HWGERBAFPCCEN   YDEQHNPWNUPOB   WJYL            YSBLQ          
MMEWGHMFOYI     : QGSPMM          IOSJCMALKFMY    NGICTYSL        BXNHPSDKQWDOU   WMGYWYAXQGWXJT 
XNBQTRSU        : GOFHRFPHYN      QRBEIDQDOU     
JDUNKCPCTVRGBOO : MLGBRTPMEL      AGLKRHMJH      
EUYDDLDSMV      : TYPHAH          YQFFVWGIFV      DWNK            YJOV           
EPKKBOHOBKG     : QTSIRNUSUU      OFFOOEBUYI      CTIKCSOSGRQGS  
GDXOEODQSXR     : BNITL           EJMS            JYLJWS          GSOCHPE        
EDCWRXMYPALQQ   : YXAYDN          YTCTGSUNGBYJAR  KEUGCC          LKJFQTEMQKFL    SNPSTPSYH       DQWLJMBIR      
IRFOXLRXAXN     : HORCT           QGNHJMQVQRB     KKRWSCSONJNJU   LFRBAIUMJXQQ    MDIWH          
OIEHH           : DFQUY           DRYULSN         PPLRM           CYYWVGRDE       KONVBDDXGDTY   
MJKFJWGAYRSPKB  : NHASBQXTDDXVDP  FJWNCCVR        HJNUDTF        
SQIEIJHJWNXFTHM : GSHEIPOWP       GPWVVUSPR       HLCCETD         KVTDN          
WXREIQ          : WYWXL           MPYGLN          BMJXNPQCEE     
KQCFIOHSHAE     : HCPQNA          PWFGLXTAWEU    
KNXTKNURJCH     : LOHGLPBDVRLNFM  NFNPXFSXUBWPX   FFLQXKQY       
BHKFRERCUVI     : THCNPHTJCI      RPNYKAXAPKIEY   RYMPBQQWNLGYKRE KYIGW          
NRYW            : QFTSVTSXXAQQGXX
DLCSLWDY        : DQWLJMBIR       MARKWKJBEVLAS  
WJVECAMNHERAJOX : YTPHNOQUCIYCNW  JWMPIFOBSGTDQ   PQHRD           EUDTEVV         NRBE           
VLNUJFAWJSLIXM  : XNAWQNYNNM      JOEISXKDDG      OHXTIBMBMMLYVO  ANETLLHPNDBC   
XVBEBBQ         : DOBQWGFY        BMBBINVTFMOCI   PAROQVUHKQRGLFF
KXKKJBLFWY      : GLXIDYIAKGWIL   YCUH            QJJVJXWCGXBKU   MDDFTYRXVOP    
UKAUKJQVUQI     : CHRNL           YJJDWVBGV       CVXE            REJDCI          PYWJBLDPBCSVM  
OHXTIBMBMMLYVO  : HCSAQWKMOEY     YMOSM           VLNUJFAWJSLIXM  FMFUI           RMPQ            QLCK           
DLMVIWXEHIW     : NMJEBBVVJKGWEJW OSCOIMIWC       UKDNDEWMLDBJVHL NPXHTKQITG      LKSDRFBBONCWQS 
FNOCFVDYGGNHUBU : WYDKYWTMYC      KONVBDDXGDTY   
YJJDWVBGV       : INSRSYYLKLKAATY THUF            UKAUKJQVUQI     FSVMCIDVCOGNYS 
MDKLJP          : DTKAB           QKVRXIEIIEFHU   SVYBKSPNST     
ATGVYFEGTL      : LOMCLQJAUDRHTT  VFBVYHTYNXHJLKG LXXQYM          CYJQVTUBVMDPX  
WIAV            : JGGOEDXKIDYDHX  FSLMKOW         EAPAYWGTSCJ     LHAQMXFN        CWUPJGBHLBVNJ  
KYQIDYEDNKN     : KXBCPA          MXSRM           UXKEIBG        
VFBVYHTYNXHJLKG : ATGVYFEGTL      WKRHRDYNLFPKG   HLNILBNKI       PWLOXKYB       
LEPVGIEJILO     : WTQCNLPROJY     PUWEAUB         PFWU            GECOKNHJAGYR   
XCXTJYRIG       : TEHSYGSA        PWLOXKYB       
JVLQHWCP        : UOSMHMFKD       APMSAVPXKOFI    OXYSK           RMPQ           
NUIL            : TENTCNVWEFTRGY  YPKVAGJN        BPMPB           TXYGFJL         NRBE            BVKKXBDYT      
QRMBDBADF       : VQAHYSWB        WCLENELMJPYYL   BRLBWXFD        WYOIRRMLR       LWHMQSCXVSVXIEU
YOWQWDE         : QDDJNCM         XREFEJF        
CRAJQCAJRUT     : NCURMFSXMEUC    PPJOMQPRHSLJR   BWTRMUCLJSMXONS
XNVK            : AICC            WWCTLEGBD       DAFOR          
BLOFQOEHL       : GYVKIU          YXAYDN          KNEPAIYILNJLHGP YAARVUNALP     
GREPTWQDP       : QQKQCH          WJPQGLYXE       KFENXUUJIPKM    NSWMNGUN        GBGSRUTDSNMQFYY HQHORJNV        ERCORTDKETLA   
FCNAVQALM       : YXAYDN          CEQFQJRDKB      QOULCIBECB      VBAHQRAXPOHFA   MVPQ            BRIHWNOFTDORR   DMKQWRLWO      
BQXRVOHAXU      : BNQLUHNA        OVPLFNWHHOJHBE  VEDNMEDJJ      
FMFUI           : QVRCS           YYAGYABPY       OHXTIBMBMMLYVO  YADNIJVVCLCLR   XQWJDGHPYO      ORUF           
LMTHRXWUUNUID   : FNKLOXUKMYBAQ   FQRVPN          SUTJL          
LTGERXNRVKUBA   : QNQM            GMYXLPLI        MTUGDBXBQRYBOD  EOKBJPASEQ      RTMDCUVWOWMFYD 
YIGKUCTPBQMXHJ  : NCCP            KYIHY           EHMHOYUGC       RKJVFVMTWEDQFTF DYNDOH          HFDUEIRHFSTWRO  XRMGGG         
MTUGDBXBQRYBOD  : XURCSMMUC       KMOLNSBWYX      LTGERXNRVKUBA   AYNIGHRNIOA    
QCKYO           : PIKNXRYQX       OEFPMR         
CJYFCLFLXNXRIGU : HQPKRNMAXEKISIC CHPTLJPGWQLEY   DEOYP           RTPUAJQQWMXYNTN WPXOHHPHFC     
GXABXCP         : CQYIVYAYJD      KAAED           REKPBCVSCN     
FHFPGVAKHY      : KPDMM           KFHVSELFJP     
MLWXLLWDVFY     : SIKEA          
MYINWMDC        : OEFUBBOGGPCLH   DJBVUVIQSHSKU   XCIWOKMBEOCIJRS YJOV            YFAYVGTOMNJTT   TVUKTANIE       BFBRCPENJSNOVP  YSBLQ          
MYINWMDC        : ENYRGQGGXX     
MJKTGKG         : UBJDVBCDRVU     OMNGBTR         KEIKHENJSCBQ   
KWAXVBLH        : HJFJYVXCJAJNR   MPLL            BMRQFPXWSCDBJS  EXKYCCQNFG     
OEFPMR          : QCKYO           UERVT           QWCUMHMP       
UHOILRBABNTJY   : DFQUY           YJPYLQL         UMCL            BNAJOHRBJLAQ    JKYVJDN         YMJECGA         GNEVCND        
ALAALVDWG       : RAFVQCVWHPOP    XRDLVINMJHFIFQ  EUVGIVOSVG      PPQJHDOYNMQ    
NMJEBBVVJKGWEJW : LRVJ            DLMVIWXEHIW     QDOKBORPJS      MRPQNHKTEABPK  
XTRYWRMWUXUX    : DOMGKPMCQHWVXU 
DCKR            : YMHHGNWXXHNETER HBJWNU          HMYYISHWFPJ    
QSOMRAAXYEI     : OYLDVRGDKPHVPD  OOBFSGLJA       TGYQEGOOTJTULY  SQYJJFEL       
MISFHPYTO       : EUOVMXALNDYKQNH ANYHHVJA        YYYB            CTLGJKTPOYYET   FAQQXU          DDARABUFN       WTXRKKRKLITWYRW
TLSSRUF         : FEMN            ELSJESSPOMG     PQPSKWSCCPGVLM 
GYDWNUXNUWUDV   : YMGHBDYIOEA     YAARVUNALP      CNXFKXRRUQT     XOOBTVLGNEGXPI  DDFAGESYGJ     
LQOUGOQWIMLBFDX : ITXGHLREXFVCFKV QPRKW           NXGOJFFP        MBJBKDKJW       JURPKA          VMYEV          
MGMREA          : PIQHXHVPJRE     NUYNMDCWG       PHXHSS          JCYWTUCWYEHYRPF KVKHQNDGKU      JHTCGIWDUW     
EOKBJPASEQ      : RTEJMFRCVKN     LTGERXNRVKUBA   SLFBVFHGT       EJBJPEAJUWWPAPJ GEXHNA          ENQHCSEJXMUKBE  PWLOXKYB       
YAYSWHFK        : WQYET           EPJIWFMDCLIW    HJNUDTF         WTXRKKRKLITWYRW NWATQFBBOU      PTQOF          
LNLYD           : TENTCNVWEFTRGY  APMSAVPXKOFI    JGGJRMJ         TTRGCXIRIWBRYIQ
NUYNMDCWG       : GYVKIU          UKOPYSC         MGMREA         
OGJSARUASNYASKN : UOMLBT          RYVPVGOSBWEUXDF CDJL            KCCUJKBRCIURYFV COOCWWIXE      
XAHDSUB         : WTQCNLPROJY     QCSDJE          LNIUXUUGRHFVDX  UHTLX          
JNWNMDEBMNUMHP  : FWERGXKKUA      DNRSLYSGEOT     NNOPFILXJVLKC   QMLQPTHANVOMJM  AXHMGJN         RMETXUTKUYPNJQ 
ADNCX           : FHYQ            PSSXRKRY        DVWY            IYNUFPTGRS     
QFYSOE          : UWJDDDJIRPYAPWG KCGFS          
KFHVSELFJP      : VECXCLSYUVXAUB  FHFPGVAKHY      EPJIWFMDCLIW    YNEBLXKKIBLCOJP
XFCKMTBOW       : MXPBBXVK        NLRCBCUMKM      REQQPOVYQQKQ    FGJNWCCOHGSO   
RUPKCQDRVQEDX   : CSMGHEDNFWV     OAEVLDLCUFD    
WCLENELMJPYYL   : UCHOW           FULXLJP         QRMBDBADF       KBXBU           UOKLPWKP        AEUMSTDCIBGFS  
NISFGKRKC       : DLHIU          
EALIDLKCNYHEDU  : TSKS            FGJNWCCOHGSO   
MNRNYUCKPJSBCF  : BLYELPCILUKVF   WBRBKFVWBEF     RNUPPS          LOHGLPBDVRLNFM  EAPAYWGTSCJ    
YKFL            : LBGHULCVXVD     YLNLUQNRF       PBOELFP         YIJNUBBRINK    
KYGPNFW         : EGKPGNF        
ITMWJGLLC       : PGJNLGKDUEH     FSVMCIDVCOGNYS  KLSBPYRTKS     
XRYSUDXADI      : TMYDHIWKM       WHOXLN          VYIESRD         FHEELLKW        ERVINW         
QEUPKKFPJYADL   : KWNOJW          EHOGGRDJVE      INSM           
PUKB            : GBNIAKTWSPL     FHLDEKUCQ      
CYQCROF         : THQLJHR         JYFM            OBQNWB         
OKBYBHTRREYJNYJ : WQYXPRQ         GFEY            GKEBXWD         TXBFEECYKFENBH  VMYEV          
MIIHVJGXKACEO   : AKYOSTSBHMBEA   YAYOYWXAKD      WTCKQQSVN       YHGMI          
WFSXEWFXQYEP    : RMEXENOA        COBVIKAGUSM     MGFB           
ROTNEEVLAI      : UBJVUVDKRQKCTHF BORRTABSIM      WISVTWXA        QYPHEPVPJISLNC 
BSUDAJNWOJWTI   : HYKM            ALPQ            CYJQVTUBVMDPX  
TYDY            : SLFBVFHGT       YRGWYGJAUAGIYX  MLJMNQXNN       ETDUUFBKISFG    NWATQFBBOU     
NSEHGKLDVON     : CQYIVYAYJD      ODWH            WBGOQPBFA       SJIHBIOM       
RGNUIWLFO       : ARUGVR          SRSNNPCRARFLOV  BLSQ            OFFOOEBUYI     
CIFIEENDSBW     : ALDKAPKHWODJIS  BTAHKKPELMBVRWL
KFJY            : UTMCXVELAOOPCX  TPNLO          
INXBHHPEPOPV    : GBBETHMWHT      OFDGIIYPH       ALRL            MIIJPHQVYTW    
OALTLSXYVTBUUL  : RUULCYUBVODDTS  VXYMNWIWRRJT    GPXCJBCLJWTQRFB
HMNPAMSJTIOJA   : MSSW            VCAMY           LKLGAJXD        YGNHSQWOCQAGMKD
HDTK            : PCPS           
PVKQWIK         : GKEBXWD         YMLGJTM         VAUHXLH         FFLQXKQY       
EHMHOYUGC       : QMCNBFER        SRDTCRY         KYMJLEPHDXRDR   YIGKUCTPBQMXHJ  LEBFSOVKKDM     LPXKGPDIPCHHVTR ITSWNSDXCWVX   
ALDKAPKHWODJIS  : CIFIEENDSBW     WNUMEIUNF       YGCFCWKLOO      YRQEDMHIVXITN  
SLFBVFHGT       : EOKBJPASEQ      TYDY           
UTMCXVELAOOPCX  : KFJY            QQEDY          
SDYBVGVINWGT    : VOAF           
ONVKJKOJHUXHLMY : VBNOEPXV        KFENXUUJIPKM    FLHDVBQMYHYMQ  
MNIPML          : YQFFVWGIFV      ICANVH          RXXBSLUHJD      IUVCWDKOQP      GXUMDHKKLL     
VHXJHHFO        : FNKLOXUKMYBAQ  
TKIFXWPFRNO     : KJRBLFIVSVW     VUUIKRAYHR     
CNTOBFGQQTMY    : PNMI            MUSVKPDMESNUWC  JGXVKLIJWJ      ORUF           
XGAEWXAHH       : SYHNNQJ         DBXSIJYJMB      HFBJRKGQDPJ     LPVLXD          GACIKEKACRS     BOVLP           PYIUPSI         EXBQOWE        
HEWMYMB         : LBWURDUPTRKRLY  CVFL            WCGTRDTGT      
OOBFSGLJA       : NDEIYHAKSVYKVJR DLQPQYDNTJNVYMF QSOMRAAXYEI     WXJUQ           CNNQPRUPLWSGDH 
XYBVHDCE        : LNVO           
ENIM            : LMVCSQ          PKPYDOXEPHXXXU  CLDGOADA        QFTSVTSXXAQQGXX
PLKQ            : KBJMI           SPVAJDSSCIIFRT  RCXCXBRG        VWBJUSU        
MXPBBXVK        : XFCKMTBOW       RXDYQUQFSPXJD   ATAWWQKJAFN     WICLYL         
FKTDLUCSAG      : KJPGRDSAO       VOWPPOEILJ      EHOGGRDJVE      BFBRCPENJSNOVP  WBGOQPBFA      
CNOMAKCN        : KTTBWVDY        JQUY            NXTPAKVYVKB    
UOKSH           : KCTVJIIAKGLPXLJ RBTAUEGJ        GJHQAOISVAIMA   XHUXARBFBL     
UHKFSPRNVDKXX   : FJWNCCVR        VIUQSYXHV       MHQKRXNLG      
GYNTNC          : FFBYLMMVJLTERNM UCIXQJNFDOXAPGW ILRPWE          BSKWQPIVB      
BFKYABJVIYQPJ   : DTKAB           KQOHGEKXDTQNXRF MLJMNQXNN       PRTOQQL        
LCRYXUJXUWET    : DLADEDUIYCMMWCK
YJNWKUHLWLUSTWL : OCPITCO         EXKYCCQNFG      FMACTRDIWVWES   DQXJJUTQKC      BFBRCPENJSNOVP  DQWLJMBIR      
GLXIDYIAKGWIL   : GOXBWQ          CSMGHEDNFWV     KXKKJBLFWY      MOQGVM          CQIARRHB        TPIAUSCIQQJCMF 
UMDKJPF         : XQYJLSCN        EGKPGNF         XQLDEVKGIFU     EJARAGURPI     
CFFYXBVMPDXPNE  : LMGBJAXEMOUGBT  GUWERCKSRLAAHM  RGMDJA          LBNODLY         QDSNV          
WEAFEISWDFAO    : DNAN            MNOY            LNIUXUUGRHFVDX 
QVLSBS          : ALRL            QTCOEY          HCWELMGUUNFTV   BTWQ            ORUF           
CVQOMVOELSTIAVQ : BCIWYDXINVMTYN  EHJWEPL         YIVGKSQ        
EJBJPEAJUWWPAPJ : AICC            EOKBJPASEQ      WQBLLYJNHIFT   
NCSCXIHKDBUFWL  : ALRL            NVKPKJFN        WKGOXAH         XEQUUMBR        KQOHGEKXDTQNXRF AAJRPJO        
DVPONTPWQOTG    : YPKVAGJN        LPBRTWLWHJWQCU  DDFAGESYGJ     
LRTYUMESWLFBMDI : MRDKNRCRGDKXFH  BVAAMMPWO       KRONMOG         XREFEJF        
OUQMKF          : WYWXL           NNOPFILXJVLKC   IGRGHBUKPKIW    OLIM           
GWYWLUDDIUWKRJO : YSAOPPP         DYHTLESCMK      TODPNIYUAWAMEL 
JASMMVUA        : WWCTLEGBD       YMHHGNWXXHNETER BGQTSJUYUJ      XKEEBKL         KWUARMQVUCNHTBF YRGWYGJAUAGIYX  YXUJWXE        
RQAEXDKVEHJAMMI : UTBJIVBG        RDLWBWPSCQ     
JSCVHPFH        : YOJIJ           UIQLIOJNBFCV    REJDCI          JQUY            SUBHLUQMKSM    
RVHM            : RXUJYYGK        WQXNWF         
WHOXLN          : DBXSIJYJMB      JEPWN           XRYSUDXADI      TGYQEGOOTJTULY  NNPEJXHJLYGBQ  
WLHGU           : HWWTLTTC        BESEL           IAKMJWGCX       BOVLP           EAGHR           IDNNUOS        
VISIRLK         : VUUIKRAYHR      BMJXNPQCEE      SAQMT          
VDUDOMCXCAV     : DFAH            IKEVA           JCEDVRIYFKJH   
PTUFYTSG        : KHPTLXJCWBBUIPL WPGRTJIWUFNEFJG DVHCNTPVDACCB   JCJUAU          PGGE           
NQBXLJQWVGUY    : KOPOKN         
BPQDOU          : WKSNTIOCYLQX    KTSOIQPFB       RVDLBY          MDDFTYRXVOP    
KEUGCC          : KCTVJIIAKGLPXLJ EDCWRXMYPALQQ   UWSJLYJDJMYYAH  BJVVUHEO        OYSSKUGQ       
XUNDJGG         : OJEJOIXMDK      FWXIIGXFYAN     DQXJJUTQKC      OGBMYP         
RPAPO           : ERLRIRHGNMV     REJDCI          QDDJNCM         IYNWPRDYPOAJPTA KMMWRNXGQYW    
KPNNGGQUEWFKR   : BTNETROA        KVKHQNDGKU      LWPGF          
OWSNRG          : KXPYKXP         FFRHXAPL        XISENOQIP       LDADNGLBSMO     JYLJWS          QWGUTTWMIWSUYBD FCGJLWUKM      
DNAN            : WEAFEISWDFAO    SMJML           PYRTION        
RNWGYKWOXD      : KNEPAIYILNJLHGP YWIPJQQW        YQOT            DGDBCTILNKVE    PTLRFDD         LKSDRFBBONCWQS 
RACOFMISCFN     : KWNOJW          RRTAARVDAOYSA  
ATMDJMQRH       : HQIQWJJK        IKAQISB         IKEVA           OXWTLRVMXCDC    GXEF           
QPIBMXCRXT      : HDYGHSXQPGW     DRWNHCUJ        SKIIHTVF       
AKYOSTSBHMBEA   : BCIWYDXINVMTYN  UITVLMGNIGB     MIIHVJGXKACEO   BVIPACIKNENFF   TJTPLR         
POVJVFBMN       : FULHYSPTHPT     EKJWMSMNEFY     XHBHHOILLQMUGPN UFGCWX          VYENJ          
BNITL           : GDXOEODQSXR     CASHNXYCGLNGICF RAOWFFAFOHEOMNU AURTVHEUU       OYSSKUGQ        ERCORTDKETLA   
NNOPFILXJVLKC   : JNWNMDEBMNUMHP  OUQMKF          QPONMQICHEYLTIF
QTCOEY          : QVLSBS          UBBIQ           JGOW           
FNKLOXUKMYBAQ   : LMTHRXWUUNUID   VHXJHHFO        CASHNXYCGLNGICF ODKICBVJI      
HYEGKCTW        : RYXPFFDXHVSYLN  UHACCELQEAS     PKAFDSEI        ASJAJLGQI       XXOT           
HPYJF           : QNQM            XKJDA           MRXNLRLUF       DVSE            JHTCGIWDUW     
KBKALXRMUCYW    : XURCSMMUC       CEQFQJRDKB      QQTJXONF        KTTBWVDY        COOCWWIXE      
BNAJOHRBJLAQ    : UHOILRBABNTJY   TENBGPLT        GTNE            ENVOUVOJWCPF   
PPGUURWHTKHLWDQ : WSDBAICLCNSUSKH WTCKQQSVN      
CVCPWNGEFHPS    : FNMQTIQBTFGQV   CBUAI           QICJNMMMVSTPHQ  BRIHWNOFTDORR   IBDXR          
GPWVVUSPR       : MDINUUGXYNY     SQIEIJHJWNXFTHM TYLPQTWU        FCYSHGPCDYSFYQV MSPMJFF         CYOK           
KEMVEP          : FJWNCCVR        GTAGJQAUAHDIRK  EJARAGURPI     
CTLGJKTPOYYET   : EHXOIEPL        MISFHPYTO       WGYPVEXPBVCL    IRYWSH          ECQTCABHB      
LJFJIAFX        : PMLWEYKQUKAWEF  GVGCUPTKGKDOEUH APMSAVPXKOFI    HWWTWPKHVC      WQBGYJXDMXQVBP  LWOCGN          PBOELFP         NFNPXFSXUBWPX  
JKYVJDN         : UTBJIVBG        UHOILRBABNTJY   UERVT           HKCMWSHIAKSIMBL WFYXQIO         CIGFO          
HHJOSTIK        : SXHJNEUQJ       XURCSMMUC       SUBHLUQMKSM    
KJPGRDSAO       : IBXFAEKODDJJT   FKTDLUCSAG      RVMROYMWYC      OOSBRTXJLVUDAL 
CVBYIOAE        : NWFLDUYCO       EWWOMQL         XALHCYLSJBLD   
FSVMCIDVCOGNYS  : YUBLUSMGQEJOOJN YJJDWVBGV       ITMWJGLLC       WBDMKAIMUMKHJ   WYDKYWTMYC      SAQMT          
HMKAMBDPAHOIVOM : ROBHKFLGETV     BFGIKNHLJFC     FJWNCCVR        KTSOIQPFB       XHVWAEQ        
THTIM           : WAJURQESRF      TKAWXOFV        PPLRM           IJOKEF          BXYJCSHUMD      IBSPSRKMV      
MIFD            : DEVUI           MADENSAUQ       JMJBJDRAYXFWRMV MYKSXIGNTRV     FYEIYMRKLTASNL  AUALGLOGYKCALNQ
UELCLYOONPTFP   : GYVKIU          EAJQNQHFGQEFMEQ KTSOIQPFB      
VXYMNWIWRRJT    : VNYLCGKQLUX     WGPYGVO         SEOE            ARUGVR          OALTLSXYVTBUUL  KTTBWVDY        QKUWOGJKQR     
RBJLVNWABXOPMFM : OMNGBTR         BXQBFEKMPPXJ   
WPOXRBLO        : IIQGACXGNFV     OMNGBTR         QFGLCDA         HEGRMW         
IGEUD           : MRHGLSUGEAREWMC ACPPO           KBXBU           YWMYUIDFAN      PMOVF           AQLT           
MEVABLABMXS     : QRBEIDQDOU      JNOFCWGDJUOA    EFUYWIMOFX      WQOQTEEXSHXLW   FDKQTCFQV      
MXTHWJ          : HCSAQWKMOEY     YQFFVWGIFV      GIHBAOXW        AGKBFIKKEE     
UBBIQ           : YRMXW           QTCOEY          YAAA            WFYXQIO        
TYROCGD         : PMURAVKWH       IDGKVIY         PYPDTQENGOTBQJX NUMJEOINMXLXVRO KEIKHENJSCBQ    ALPQ            BELKQ          
EGKPGNF         : KYGPNFW         UMDKJPF         YJBXHSBHLPXAFFX WEFEIEBEEHO    
GMTGGDERB       : OFDGIIYPH       HCPQNA          CQIARRHB       
TCKMQGLKWQTA    : TTHAJDN         ULSBPTCV        JEBJKTKHWHXVVH  YIVGKSQ        
XIKQOXXXFKTLSW  : OQPDLMURUFX     WAJURQESRF      XLIB            EUDTEVV        
KXTG            : YVHKYT          TXBFEECYKFENBH  QKUWOGJKQR     
GSUMH           : EATCHI          CDVYLOKFWPAASU  MYYIICR         VMUXX           IWOJ           
JXCLX           : QOCHTR          MHQKRXNLG      
UIQLIOJNBFCV    : IHCFACUXJNLFDW  HYIEUTRDTBKR    JSCVHPFH        EAGHR           DVSE            GBNIAKTWSPL    
THCNPHTJCI      : BHKFRERCUVI     XOAACMXFKLOCGRM YMOCGYHMHU      PBUQUOYKEFV    
KTSOIQPFB       : MOXYJAB         BPQDOU          HMKAMBDPAHOIVOM UELCLYOONPTFP   VQHMWC          HFCYTO          XRQKFRD        
SJADA           : BJRWVB          UOKLPWKP        YBFPKRJQU       QTSMIOIQBBQIASE SAQMT          
ICANVH          : MNIPML          LRJDK           URVJQAX         HEGRMW         
MYYIICR         : RTEJMFRCVKN     GSUMH           TDPGCLQBDAGGK  
ONVEVOVBPEU     : PEKUBIFBVSKU    OBQNWB          UGQRKFWSVMMFQ   JFTLTKOBNGDGL  
GACIKEKACRS     : XGAEWXAHH       TGXO           
SRAEVRHLHERESNH : CDUE            WDTBEVL         DTFOCTEKSQM    
TENBGPLT        : BNAJOHRBJLAQ    HMND            WKRHRDYNLFPKG  
VTANM           : RVEFLRYSSPNUSKB RYWPGHCESOGXCA  PHCKPKLQNXKBDLE NSJHRCOTM       JYLJWS          RGJKUHPIF      
IHRMDLUOUYGYTV  : LICEISTOPUOJTXW YTPHNOQUCIYCNW  OTPVKV          MVFEYLQLOVJBRE 
FQPSRY          : CSHPKEIMFAEVMA  MGFB            QPONMQICHEYLTIF
DSIYOJOE        : FYEQPGWHGIRTX   MGBBMLLOOHX     WMUBCCRJ        OOQAPAE         NEICWMTTNAGFCDQ ENYRGQGGXX      QWGUTTWMIWSUYBD
WLWKQIHIFGOFCN  : DGDBCTILNKVE    EJYJBPCBNWA    
KEIDXHQBC       : QGOFAQ          WNJMICPBTBBPI  
CTKQXNP         : GKEBXWD         CLODPJKMOOBLWR 
KCCUJKBRCIURYFV : OGJSARUASNYASKN QHBTPLFXV      
KTTBWVDY        : WANOQNXJOWBUO   YBQEQTXWQB      CNOMAKCN        KBKALXRMUCYW    VXYMNWIWRRJT   
NRPCJDMMGKV     : JJKED           HWBTVWABEQTRR   UIVQMELUOO      VEDNMEDJJ      
LOWTLOUQMEDIAF  : VTPTEEVWFPAK    GGDVPCNSESFQA   PIGRXEVWTASXLI  ERVINW         
WKGOXAH         : UTISLQIEUBB     NCSCXIHKDBUFWL  LOHGLPBDVRLNFM  KVDQ            FHLDEKUCQ      
KKRWSCSONJNJU   : MOXYJAB         OUUKPEF         IRFOXLRXAXN     WEWTCTXCQSGCFL 
ENPKRYNYGMJNB   : WRLYGSKKXEJLLN  KMOLNSBWYX     
PKMA            : REJDCI          RVDLBY         
GWSISHXEVJCBPP  : ITXGHLREXFVCFKV JTWEQPLUDUTDUKD WAFLOHT        
CHTPIBCRQGEG    : GFEY            JBTHIRSKUIA     RPNYKAXAPKIEY   BBVBODGPNTHEIA  SQYJJFEL        DVWY            PRUJY          
QJQYI           : UKOPYSC         BFWIVSJOFJIYLXH YPYELD         
JBTHIRSKUIA     : SRDTCRY         CUMLTPRV        CHTPIBCRQGEG   
KKIBSJDN        : MADENSAUQ       DNRSLYSGEOT     TTHAJDN         DDROSCMYJSQSCNB EUVGIVOSVG     
LRJDK           : ICANVH          CASHNXYCGLNGICF SEBNIHRT       
VJBG            : QJJTOQAKFQOT    WSJSYVBAEYJG    BIBH           
FDCPWUAS        : RLUV            PTQOF           WEEJHVQ        
CHPMPQG         : IYBXGFATDILEO   VGWCWCHIPCJ    
WTEINPN         : DOSOEOPYRM      RXXBSLUHJD      TDSJRM          JDYHPKKEVCBNPYC
KMHO            : PSSXRKRY        WQOQTEEXSHXLW   DCGJQJVRM      
CVXE            : WBVPBPWSE       UKAUKJQVUQI     SQUMPXGUNEEXCXD EAGHR           XXOT           
VBNOEPXV        : IBPGIVTDV       ONVKJKOJHUXHLMY BRUCQMBCCFA    
PPLRM           : FULHYSPTHPT     OIEHH           THTIM           QXANCERTNNIL    ENVOUVOJWCPF   
YWUQNSEACSUEQT  : VMFHOXHBOONQNU  BXNHPSDKQWDOU   MIHWGI          NBLSPMXHROFFBT 
ERLRIRHGNMV     : RPAPO           SJIHBIOM       
XQRH            : QJLULFJWWSXRCEX QDQSPEHA        IRMPRWTYJ       XLIGUACJNK      DXRD           
RCIHWMHYHEFXAP  : DFAH            YRGWYGJAUAGIYX 
RBTAUEGJ        : FPJUIQB         AGSEC           RDUSIMQNCYNCWIJ DEOYP           UOKSH           GEXHNA         
FORVHYLBCVIB    : SHMFKDOBSOBQG   FFWCGPPEFSDWYG  EHOWKGALCM      JGDVUFD        
PDQTIRUYVOC     : AYNIGHRNIOA     LTQIFCLRVYA     DJPQH           RVGMKX          BODYPFUWSAKVRW 
RXWXJN          : ARUGVR          AUALGLOGYKCALNQ LHAQMXFN       
XHBHHOILLQMUGPN : NIFQVIYCQ       UCHOW           KHDUUAKR        POVJVFBMN      
BFACCQ          : MIII            UFGCWX          HWGERBAFPCCEN   VYENJ          
UIERJ           : ATAWWQKJAFN    
HOOPQ           : RYVPVGOSBWEUXDF VWEW           
YHFKSVYPF       : UKOPYSC         XECMVSSEOV      WJIDFVLX        QHBTPLFXV      
EKQLMSND        : CSMGHEDNFWV     THQLJHR         GNQHVCCS        BIBH            VNLUHA         
KOGEXTOOIGHH    : TQLUSYKRDU      PYWJBLDPBCSVM   EFYAWIHNIPWVO   EUVGIVOSVG     
PMPIKQYPGF      : TENTCNVWEFTRGY  WXSAKHUNYBQJB   CCQBLTOHA       DYNDOH          PPJGW           TODPNIYUAWAMEL 
YQOT            : CMBF            DFLENE          ONUXMDNOWQ      ACINKPDXDJBW    RNWGYKWOXD      HYTUXDNQ       
UVTJCYHXPVJVEQ  : LMGBJAXEMOUGBT 
TFSEPJFGSMKTGA  : HFAQRAQBPHJRF   RFULBSEUMEQD    AAJRPJO         RYSQDPFFJC     
NUMJEOINMXLXVRO : MTPHJEPDWAAYP   YYYB            TYROCGD         LNIUXUUGRHFVDX 
LTRSMEASWNDQT   : VCDOQEXJINHWBIO RABGT           DBXSIJYJMB      PQHRD           QXAACGRQE      
HJCT            : TXYGFJL         EGCAHBJVJUJMDJH
IKEVA           : VDUDOMCXCAV     ATMDJMQRH       KXBCPA          IGRGHBUKPKIW    NRLVTJUQBEVB    FCGJLWUKM      
KXBCPA          : RDUSIMQNCYNCWIJ LNIULL          KYQIDYEDNKN     IKEVA           NRBE            PGWRYGCPVBR    
LUJXYLSVYWOUEWE : FJKGKSGQDUTIE   DQQRSMJSG      
QAPEEO          : OEFUBBOGGPCLH   USGTQSXWPY      VJIVSE          DJYTJXSOJUN     COMR           
KYCLBR          : SYVV            GEHYKVUT        TNXFPJA        
REJDCI          : UKAUKJQVUQI     JSCVHPFH        RPAPO           PKMA            IXUPSAOGLWX    
XEQUUMBR        : NCSCXIHKDBUFWL 
KLSBPYRTKS      : IDGKVIY         ITMWJGLLC       VUDCVRDIWXIS    CKUH            FUEEYQJHR      
XTQMOW          : OMSVKRV         TEUMAHPBKKUISA  QDSNV          
RBGJY           : YGLRAU          XQFLN          
BVIPACIKNENFF   : TWYEVVUGQRNJI   AKYOSTSBHMBEA   LTQIFCLRVYA     BXNHPSDKQWDOU   YAAA           
YRXASUSHLPGFS   : NIHSVW          REBHI          
PUCQSMISOSGFW   : KJGY            EATG            IYIQYSL         UXXMYYYUICTR    IBSPSRKMV      
KFCMYCMRWFAIW   : BJRWVB          ANYHHVJA        HODDJR          YFYNOVO        
ORWGOYYINHDFAJ  : RVTKBFXQVSFR    BTQWVKVB        JGGJRMJ         OAEVLDLCUFD     KPIWLHLQY      
AEWHGLGIXYIFY   : VWPTJQUB        CFSVLVHQMAO     QRBEIDQDOU      DJYTJXSOJUN     ORUF            EIGQXVUODULDPMX TGXO           
EHJWEPL         : CVQOMVOELSTIAVQ GJHQAOISVAIMA   BJVVUHEO       
OVVXABYLNBRNIX  : VWPTJQUB        JJKED           JPWHVMIN       
OJANTFOOK       : NYGSUSSRX       QGHYXTLXMAICOYJ ELVMLVLTGL     
YJDQWL          : EHXOIEPL        KQOHGEKXDTQNXRF TJTPLR          CCNWCS         
VHGXLFJY        : JTYJXFLGF       REBHI           MHVEUDG        
CMOCOGN         : KJNNRXUFG       GAFOJGAXHMMU    EGUFKAXJDWJLF   UCIXQJNFDOXAPGW
TJTJYGH         : FNMQTIQBTFGQV   WCQLX          
RMORAWN         : PRXNRQMUKA      SONSGLRHUA      WXJUQ           JGIFK          
ENVLWWU         : FUHFMWVG        TXBFEECYKFENBH 
MLGBRTPMEL      : NGDUHVLN        JDUNKCPCTVRGBOO UQXDCOEW        PGFAAANLOED    
FUHFMWVG        : DFUFTUCQ        ENVLWWU         XHUXARBFBL      TGXO           
TTHAJDN         : TCKMQGLKWQTA    KKIBSJDN        MKFBEFTVRAV    
BIKNU           : CFSFWQDTJYX     QDDYHHSCXH      IMABTTQIBWNOYO  AASB           
OMNGBTR         : JWXHRJUW        WXDDC           MJKTGKG         RBJLVNWABXOPMFM WPOXRBLO        YUCYUAFBBEO    
YMJECGA         : HCSAQWKMOEY     IXUHGGM         UHOILRBABNTJY   LWKJAAYJV      
FVFN            : VCDOQEXJINHWBIO DNRSLYSGEOT     LMPFJOLHNGOGXEP AHNRCPTTMW     
OQMVTUJHPAXFPEG : KDQCUUUUHUS     IRMPRWTYJ       VWBJUSU         KCRMPXN         EWNSRMNIS      
WIILRONAP       : FATFGPEABGG     QDVHKEBFCUHN    TNGRPFCSBY      BFBRCPENJSNOVP 
FNCUMQMY        : GOFHRFPHYN      HYNEJGCBQ       IRYWSH          ITSWNSDXCWVX   
GTYQ            : CCQBLTOHA       XHOF            VPDHYPYDSYGPWOC SIKEA          
BORRTABSIM      : TJOXKQGH        ROTNEEVLAI      DDGTXS          VSTKCYG         RGMDJA         
CDUE            : VFJXGDWMVSYXY   DLUEYAD         SRAEVRHLHERESNH SRSNNPCRARFLOV  ICVEWVSMPPEK    YGCFCWKLOO      FFLQXKQY       
RKJVFVMTWEDQFTF : YWIPJQQW        YIGKUCTPBQMXHJ  PEKUBIFBVSKU    VQBDGXPQEUIWEU  VKVU           
IYBEAEWKSENWYRR : EAJQNQHFGQEFMEQ IFHVWTK         DPUORVCNFUOO    YRGWYGJAUAGIYX 
EBMM            : JTYJXFLGF       YGCFCWKLOO     
BIVGLP          : GHUAJOEKU      
FUUOUXUWFSHX    : UQRIOCVB        KYMJLEPHDXRDR   DJYTJXSOJUN    
UUXPNQ          : FWXIIGXFYAN     FHEELLKW       
QDKQG           : KWNOJW         
OOFEDLC         : GBBETHMWHT      WBRBKFVWBEF     POHUALX         FVMJPLC         HFDUEIRHFSTWRO  XNHLDXGMNWNUIF 
CYYWVGRDE       : SRAT            OIEHH          
BCQSPH          : BVSVUCAKRXFMO   TBNG            OTLQ            LDHEUPFHOX      QDCYSHIGMN     
IMABTTQIBWNOYO  : EUXWBKOKHPOX    BIKNU           IERAWUPGHUH    
XPQV            : HCSAQWKMOEY     QWTKILCEOVJB    DQHOPAWVQT     
KAAED           : ACANCTXYCOWLR   GQABLNGPE       GXABXCP         PVQLRUOTVB      JCEDVRIYFKJH   
UVTDMFPOGLKYWM  : GUWERCKSRLAAHM  FMACTRDIWVWES  
KBXBU           : GFFIOPHBJUUTJ   WCLENELMJPYYL   IGEUD           XOAACMXFKLOCGRM OTASAKCXD      
QNWOAWRGC       : GYVKIU          MOQGVM          MUSVKPDMESNUWC  RXXBSLUHJD     
CASHNXYCGLNGICF : SRDTCRY         QKVRXIEIIEFHU   RXBBBCYIFTPLLU  VCFMTEGXAT      OTTL            TKAWXOFV        BNITL           FNKLOXUKMYBAQ  
CASHNXYCGLNGICF : LRJDK          
FFWCGPPEFSDWYG  : FORVHYLBCVIB    JGDVUFD         SQYJJFEL        VQBDGXPQEUIWEU 
BGLKVLKB        : IIQGACXGNFV     ANXQCTVOUBX     KTJPXTVAB       RRTAARVDAOYSA   KCRMPXN         QWGUTTWMIWSUYBD
XQBISID         : PGWRYGCPVBR    
PCDYSSDXNIWNQ   : GOFHRFPHYN      XQLDEVKGIFU     ILRPWE         
QAECVROWK       : QPONMQICHEYLTIF DAFOR           LRHGREMXSD     
NNUIVAJODMNVHST : QDVQFTRQHDW     SOWO            MUUGUQGQIO      DMKQWRLWO      
BQLSICUOGQHUQTJ : MUSVKPDMESNUWC  QXAACGRQE       JLUA           
IGRGHBUKPKIW    : BUKDN           GQSWRC          OUQMKF          IKEVA           WTXRKKRKLITWYRW
EUFWGAFJUWRNEN  : WHYXJCAEEVEHF   YSAOPPP        
AYNIGHRNIOA     : MTUGDBXBQRYBOD  PDQTIRUYVOC     KEIKHENJSCBQ    AHNRCPTTMW      PMND            WWAEUFUDCMTGQU 
AIYDMUKJBKQMH   : NCCP            HEFSNWPWAJOXI   SONSGLRHUA      REKPBCVSCN     
HVTWEWVTHCBYR   : FCYSHGPCDYSFYQV IJOKEF          AWVXJ           PMOVF          
OTLQ            : BCQSPH          TPNLO           THSYJYKIMEUAAUU
LTQIFCLRVYA     : WSDBAICLCNSUSKH PDQTIRUYVOC     BVIPACIKNENFF   PVQLRUOTVB      QHBTPLFXV      
GXGDCFB         : BLECNIVEQIAE    FIOA            TNGRPFCSBY      UTIMA           XPWKLJMHTYKPQDX TJXIJGFHK      
MGAMXMDU        : MRHGLSUGEAREWMC UYJDMSFFSJFE    XDRHADI         NLRCBCUMKM      YAYOYWXAKD      LFDSUKEPIIOYFH 
TYLPQTWU        : GMYXLPLI        GPWVVUSPR       VRHCL           OGBMYP         
PQHRD           : BPMPB           WQBGYJXDMXQVBP  WJVECAMNHERAJOX LTRSMEASWNDQT  
RLUV            : RTAXJXX         FDCPWUAS        SIDLWKABPJUTBT  AQXWEPOPOXDDLE 
VUDCVRDIWXIS    : FHKWLKA         KLSBPYRTKS      YWHGICOMCWXBXA 
WJPQGLYXE       : BTJDWRRJHU      GREPTWQDP       EGCAHBJVJUJMDJH TDPGCLQBDAGGK   CYJQVTUBVMDPX  
PHXHSS          : YYAGYABPY       MGMREA          JNOFCWGDJUOA    CNNQPRUPLWSGDH  MKFBEFTVRAV    
LPBRTWLWHJWQCU  : DVPONTPWQOTG    QTSMIOIQBBQIASE JEBJKTKHWHXVVH 
NMGUXIUFQLMPU   : UHACCELQEAS     NSJHRCOTM       LDADNGLBSMO    
KBVCDNWAAVILTB  : MIII            UFDSMQSSI       LXXQYM         
QQEDY           : YWIPJQQW        UTMCXVELAOOPCX  EHOGGRDJVE      ATAWWQKJAFN     BFBRCPENJSNOVP  KIBFUXNMW       SXWCTELHMHP     PDDEHFEN       
EHVJBJV         : IBERXLDAJNKIJWD WXGFTSEIDNRQLPO QKFNXTATYTQ     TSKS            HPJVYAC         MWSYVGVEEJ     
FGDIDGLQFOSBYEU : AQYGUCLFKGDP    RFAIBDNDI       YSAOPPP         FUEEYQJHR      
ULSBPTCV        : TCKMQGLKWQTA    BVAAMMPWO       YDEQHNPWNUPOB   NGICTYSL        XFWBUY         
AFDKBVRKBCN     : NHASBQXTDDXVDP  CHRNL           XOAACMXFKLOCGRM WEFEIEBEEHO     MDMAIEMGIJNLPMF
QGOFAQ          : JMSOYHCGWI      KEIDXHQBC       OSQLAXYO       
GNIDCDETWIPB    : GOXBWQ          AYYAA           VSQGEYHEO       TQNBSWIMK       PBFAY           LWPGF           LFJTDD         
UGXXERIGTXP     : LEBFSOVKKDM     OYUPOLMDIAJSDD  ETDUUFBKISFG   
FFRHXAPL        : OWSNRG          TODPNIYUAWAMEL  HOVDWRXAKHISVAY
TNNAHNLWQWTXWS  : FWMBSIX         NMSXHP         
ODKICBVJI       : MOXYJAB         HVEGKIJFMA      FNKLOXUKMYBAQ   VRHCL          
QGOGTYCKPD      : UOSMHMFKD       ELPKLYUQE       YJBXHSBHLPXAFFX GCIVRMIOVJYDOUV
FQRVPN          : BJQQFB          JYSDBRLQB       LMTHRXWUUNUID   IOMJVE          BMRQFPXWSCDBJS  XFVINSFYCFWM   
MGBBMLLOOHX     : PDUHIWLO        CQYIVYAYJD      DSIYOJOE        PERGSAMYKMCH   
VQHMWC          : KTSOIQPFB       VIUQSYXHV       KAKUDYFLQ       OXWTLRVMXCDC    GXKFFTPOTSURMOY BXQBFEKMPPXJ    LXWHCCOQUPBNO  
CMFHGKX         : TKTWRS          DTKAB           UIPOUWUI        DXTPUHBNXHX     FAQKBWNLD       XKDPE          
JNOFCWGDJUOA    : IHCFACUXJNLFDW  HWWTWPKHVC      ELNES           MEVABLABMXS     PHXHSS          WKWUQCWUFBC    
WXJUQ           : OOBFSGLJA       RMORAWN         HODDJR         
JQUY            : SCNYNB          CNOMAKCN        JSCVHPFH        LWOCGN         
HFAQRAQBPHJRF   : NHASBQXTDDXVDP  TFSEPJFGSMKTGA  SIDLWKABPJUTBT  LRVSNCAONKUI   
UOKLPWKP        : PIQHXHVPJRE     WCLENELMJPYYL   SJADA           KPTPXKC         YFYNOVO         YMOCGYHMHU     
FHYQ            : ADNCX           ORIIDNWGYHLN    DOSOEOPYRM      WKWUQCWUFBC     GCIVRMIOVJYDOUV NKROE          
WQSGVUWPUQRKA   : MTPHJEPDWAAYP   YXAYDN          UDUICCBT        QDSNV          
EFUYWIMOFX      : GGDVPCNSESFQA   MEVABLABMXS     VODYSLQLPFVCPTG VJIVSE          HOHLWNQRTYLDGE 
NFPOWPLNI       : CFSVLVHQMAO     XECMVSSEOV      UGQRKFWSVMMFQ  
LFRBAIUMJXQQ    : IRFOXLRXAXN     DOSOEOPYRM     
RNCHEJFLYM      : CSMGHEDNFWV     WMGYWYAXQGWXJT 
NLRCBCUMKM      : XFCKMTBOW       MGAMXMDU        POHUALX         VXEPEABHS       EHOWKGALCM      FJFAEM         
MXNAJMSAINQMU   : CSHPKEIMFAEVMA  NVKPKJFN       
XCIWOKMBEOCIJRS : LECTKME         MYINWMDC        BIBH           
KGYXIIMB        : MRXNLRLUF       FSLMKOW         WNGLVWGWRIWOK  
WQBLLYJNHIFT    : EJBJPEAJUWWPAPJ JCYGW           BXUSQHAJMDR     MVFEYLQLOVJBRE 
IAKMJWGCX       : EYFAXJLASB      YCBCUAUYC       WLHGU           VMLHPQCJP       MKFBEFTVRAV    
IWRSHEURELVPAU  : WQDLWEFCGA     
PEKUBIFBVSKU    : MRKSUJIYWEDQ    NDQXIMITJHRVLF  ONVEVOVBPEU     RKJVFVMTWEDQFTF VGWCWCHIPCJ    
PSSXRKRY        : OUUKPEF         ADNCX           KMHO            VMLHPQCJP      
OSUCOLCJP       : IBPGIVTDV       QDVHKEBFCUHN    BIBH           
QARRLXSHSGCRVW  : HUVOFNTVI       FPIMQMVDOFODFRK TSVKCYDSTVFDOOV MSNRVF         
VOWPPOEILJ      : XYVSFBUXPIPQB   UOMKIQPWQU      FKTDLUCSAG     
WNJMICPBTBBPI   : UOMKIQPWQU      KEIDXHQBC       FNPSGFNQL       GTAGJQAUAHDIRK 
VMNTJBPAAGROM   : YLFKUNVKQ       OTPPTHVBLCVA    OLPHX          
BVAAMMPWO       : CLDGOADA        CEQFQJRDKB      LRTYUMESWLFBMDI ULSBPTCV        NKIVASA         WISVTWXA       
XLIB            : YSWNFPVAFKME    XIKQOXXXFKTLSW  FFFFYRGUIL      UCRVGG         
SUBHLUQMKSM     : JSCVHPFH        HHJOSTIK        XISENOQIP       USGTQSXWPY      GHUAJOEKU       GBNIAKTWSPL     FJRLDOKIQBW    
KEIKHENJSCBQ    : MJKTGKG         TYROCGD         AYNIGHRNIOA     NXGOJFFP       
IQESSHNPKU      : KYIHY           RRDIHB          PRUJY           CIGFO          
FNPSGFNQL       : WNJMICPBTBBPI   DDARABUFN       BTAHKKPELMBVRWL
EUDTEVV         : YRMXW           KHNWQXPXHQLTPJ  BJLJMXFXWF      LPVLXD          GQSWRC          WJVECAMNHERAJOX XIKQOXXXFKTLSW  MJBTFNNPHTBHO  
EUDTEVV         : GBNIAKTWSPL    
MOQGVM          : QJJTOQAKFQOT    GLXIDYIAKGWIL   QNWOAWRGC       CFSWBXAIIEMVSYS JDYHPKKEVCBNPYC
FAQQXU          : YCBCUAUYC       MISFHPYTO       PWFGLXTAWEU    
LKQURFLDBRXGNFD : UYJDMSFFSJFE    CLDGOADA        WCQLX          
NRBE            : PUCV            WJVECAMNHERAJOX NUIL            KXBCPA          WMUBCCRJ       
WQYET           : QICJNMMMVSTPHQ  DLQPQYDNTJNVYMF YAYSWHFK        KIYIBKMSJLPER  
URNTD           : FQOFVTDGQXXH    XOAACMXFKLOCGRM WTXRKKRKLITWYRW
MXSRM           : XHDLSAYHDURYJV  MBQVLYUMR       TQLUSYKRDU      SCNYNB          KYQIDYEDNKN    
VGWCWCHIPCJ     : CHPMPQG         PEKUBIFBVSKU    SGJAWQODXPTDYII WIXRVK         
CIPCNLWKDK      : KHPTLXJCWBBUIPL WRQOKVJG        FHEELLKW        GBGSRUTDSNMQFYY PWLOXKYB       
IKRJDLX         : UKRJFSAUM       MBSPLVXJPTFCONY UXKEIBG        
JGYOD           : AGSEC           VMSXGLUAXHRUWS  NGICTYSL        GXUMDHKKLL     
VMUXX           : GSUMH          
BHIFWVCHYOOKBG  : ACANCTXYCOWLR   ROIOV           QGHYXTLXMAICOYJ SJEQUAYKD      
FRRJ            : SHOCMFLRNSAU   
XISENOQIP       : KJNNRXUFG       OWSNRG          SUBHLUQMKSM     GSOCHPE         CCRGJONWAFLQ    GWQTHFB         JURPKA          TYRLGMAIGL     
BSXMAWICHISVS   : CCDUFERBCO      DGDBCTILNKVE    PAPWPNFMEXNEF   KEGTAHWHAOJXEXI YSBLQ          
COBVIKAGUSM     : YSWNFPVAFKME    DFRTGCVVPN      WFSXEWFXQYEP    QHRBDDCWQM     
KDQCUUUUHUS     : RIYBL           EDVEOLYRSCAITT  OQMVTUJHPAXFPEG INYOREMVH      
YAARVUNALP      : HSHXROXPBCPFHN  BLOFQOEHL       GYDWNUXNUWUDV   CFSWBXAIIEMVSYS
TABBVVNGGTAKO   : HVEGKIJFMA      QYGYC           CQIARRHB        RMPQ            HQHORJNV        ISRFY          
HLCCETD         : SQIEIJHJWNXFTHM
WWCTLEGBD       : XNVK            JASMMVUA        VSXMKGGNAT     
DGDBCTILNKVE    : FYEQPGWHGIRTX   GVGCUPTKGKDOEUH DEOYP           RNWGYKWOXD      WLWKQIHIFGOFCN  BSXMAWICHISVS   DJYTJXSOJUN     IERAWUPGHUH    
EPJIWFMDCLIW    : GYVKIU          IBXFAEKODDJJT   YAYSWHFK        KFHVSELFJP      QWNUVKARICJEJ   GJERPXFRB      
OFARFGAJ        : RTAXJXX         HYKM            UFQEQMCVXFHSLUQ YGCFCWKLOO     
DDROSCMYJSQSCNB : QMCNBFER        KKIBSJDN       
TDCCCCQ         : HWWTLTTC        EUOVMXALNDYKQNH BPMPB           UIVQMELUOO     
ELPKLYUQE       : QGOGTYCKPD      SQUMPXGUNEEXCXD XALHCYLSJBLD    LVKYXUEFCMGVS  
HYTUXDNQ        : LNNCNMSUT       YQOT            QHBTPLFXV       QXAACGRQE       DFAEQSPNQG      ORWOXRJMFLHTRNT
RFAIBDNDI       : UOSMHMFKD       PHJDADAAWMYQAYN FGDIDGLQFOSBYEU ECQTCABHB      
VRVJ            : BXMYY           NTUSJLBBALOGAHG XRRJGW          GBNIAKTWSPL    
JXIGOOUYNO      : DXTPUHBNXHX     KWDJCCTTCFKNML 
NSJHRCOTM       : VTANM           NMGUXIUFQLMPU  
YCUH            : VQAHYSWB        KXKKJBLFWY      QHRBDDCWQM      QTWXAYEUYSDOBOF
QCSDJE          : HAICDFNFHOCLU   XAHDSUB         TNGRPFCSBY      HODDJR          VWBJUSU        
UKRJFSAUM       : IKRJDLX         KPIWLHLQY       ILRPWE         
PYWJBLDPBCSVM   : UKAUKJQVUQI     KOGEXTOOIGHH    RHHNSBSV        KPIWLHLQY      
POHUALX         : EATCHI          OOFEDLC         NLRCBCUMKM      ATTRLA         
VRHCL           : TYLPQTWU        ODKICBVJI       THSYJYKIMEUAAUU
YAYOYWXAKD      : OCWOHK          LOENWU          MIIHVJGXKACEO   MGAMXMDU        UHHDBSQLWN      MBJBKDKJW       RUNJCW         
OFLMRXEII       : ICGEBSCNM       FVTHIVOEVOW     JCYWTUCWYEHYRPF
JTWEQPLUDUTDUKD : MYWHLYEPEI      SXHJNEUQJ       GWSISHXEVJCBPP 
KFENXUUJIPKM    : HQPKRNMAXEKISIC GREPTWQDP       ONVKJKOJHUXHLMY HBJWNU          DFAEQSPNQG      GECOKNHJAGYR    VWMGTWVDCONDH  
SMJML           : LQPXKVGXSAJTKK  DNAN            RYSQDPFFJC     
FDCAGXV         : QYMOFHROGO     
UIPOUWUI        : CMFHGKX        
QGHYXTLXMAICOYJ : AFUDKXYJKNVPM   EUXWBKOKHPOX    DJBVUVIQSHSKU   OJANTFOOK       BHIFWVCHYOOKBG 
BMBBINVTFMOCI   : QWTKILCEOVJB    XVBEBBQ         HWBTVWABEQTRR  
AYGIXGC         : MYWHLYEPEI      SEOE            ANYHHVJA        HMCOKDJNYR      HUVOFNTVI       FMACTRDIWVWES  
EROMT           : ALRL            URVJQAX         UWRNWXILEMLGKO  CTIKCSOSGRQGS  
NFWRRXSBNRU     : FEAWVA          WIRCFKSG        CWUPJGBHLBVNJ  
ELVMLVLTGL      : JXEQYVWXJBRBJ   WEVFUWN         JYFM            OJANTFOOK       UFDSMQSSI       LIKFDOEETN     
JAFB            : QGNHJMQVQRB     JDLTVCFXOKCGG  
TWTICSCURUXFMUB : CDJL            VSXMKGGNAT      ESSE           
GWGSUUMCIPNK    : BVWCROSJMB      IDGKVIY         WJCOQAS         QWGUTTWMIWSUYBD
OBQNWB          : LIYTKBWIJDC     KHNWQXPXHQLTPJ  CSMGHEDNFWV     CYQCROF         ONVEVOVBPEU     VCAMY           SLOLW           FHEELLKW       
QDOKBORPJS      : FJKGKSGQDUTIE   NMJEBBVVJKGWEJW URXETJTOMLGV    GTNE           
SRSNNPCRARFLOV  : WQYXPRQ         WMLHGHS         SYVV            RGNUIWLFO       CDUE           
GLMJDDNUNOJHGT  : CGUDFRCOSVPFEA  CBKUAGTAIODARP  RATJVMCECPM    
QOULCIBECB      : DLADEDUIYCMMWCK FCNAVQALM      
HMND            : TENBGPLT        UNEAA          
TOOGUTTPJKY     : VHAV           
SUTJL           : LMTHRXWUUNUID   PIGRXEVWTASXLI  BBVBODGPNTHEIA  LRKPMXEYUQEHVHL GCIVRMIOVJYDOUV
UNAXUDATMOHSS   : HIKPBHLVALYRAMO NHASBQXTDDXVDP  IWOJ            HCPQNA         
JJKED           : CFSFWQDTJYX     FULXLJP         NRPCJDMMGKV     OVVXABYLNBRNIX  UOXA           
VMSXGLUAXHRUWS  : GQABLNGPE       JGYOD           DWATSMFXA       NAJTNJSN        XROJUNYGCKH    
RXVNKKXDEENPQTT : FYEQPGWHGIRTX   QVIMGFRBKG      FVNRPIYGNLNBG  
SIRQQF          : IIQGACXGNFV     NCCP           
RFULBSEUMEQD    : WAJURQESRF      TFSEPJFGSMKTGA  TXBFEECYKFENBH 
DBUJHK          : ABKGNURBGAXDXF  EAGHR          
XHVWAEQ         : HMKAMBDPAHOIVOM LXWHCCOQUPBNO  
VXEPEABHS       : ASTOVPQAFR      NLRCBCUMKM      THSYJYKIMEUAAUU AQXWEPOPOXDDLE  WBFHKYBYFVDLXV 
EHOWKGALCM      : WADKXIJJ        FORVHYLBCVIB    NLRCBCUMKM      MKQQWAG         WKWUQCWUFBC     TDSJRM          HQHORJNV       
OMSVKRV         : TKTWRS          XTQMOW          BGQTSJUYUJ      RDLWBWPSCQ     
IOMJVE          : EHXOIEPL        XQYJLSCN        TBIVK           FQRVPN          VSQGEYHEO       NBLSPMXHROFFBT 
VIUQSYXHV       : OFDGIIYPH       OCLUGGX         GTVFMWLM        KJGY            UHKFSPRNVDKXX   VQHMWC         
OXYSK           : YTPHNOQUCIYCNW  JVLQHWCP        NIIEAWUNPD      EQWPFTGUIR     
HYNEJGCBQ       : LRFAPSABWGN     FNCUMQMY        WPXOHHPHFC      VWBJUSU         TODPNIYUAWAMEL 
PAPWPNFMEXNEF   : GSHEIPOWP       BLGFMCRJEC      BSXMAWICHISVS  
RVMROYMWYC      : KJPGRDSAO       JURPKA          XQLDEVKGIFU     CIGFO          
KKHNCBGESD      : CQYIVYAYJD      RHHNSBSV        CKMAPAAMVHB     EJARAGURPI     
GKJMI           : CAMTBKGARS      TQRETMJJCYKUC   QYPHEPVPJISLNC 
TPNLO           : NHASBQXTDDXVDP  KFJY            OTLQ            GLFSTPDL       
DDARABUFN       : MISFHPYTO       FNPSGFNQL       GWDQTB          OAVNI          
NEJQKQKPNSAYGKY : LDBNJWHD        PUCV            URXETJTOMLGV    DYNDOH         
CNNQPRUPLWSGDH  : NKRMY           OOBFSGLJA       PHXHSS          SNXJXOVP        QKUWOGJKQR      KVKHQNDGKU     
SNXJXOVP        : CNNQPRUPLWSGDH  UXLHQDXXLRG     THSYJYKIMEUAAUU XILHDVAGOYRU   
PREXEFAIUNA     : WSJSYVBAEYJG    ALPQ            AEHMRYWJJUUQIN 
HWBTVWABEQTRR   : LGMPC           NRPCJDMMGKV     BMBBINVTFMOCI   WEFEIEBEEHO    
RICJNRD         : LBTNFKRYLOLEFY  KTJPXTVAB       YQFFVWGIFV      AOIPTHSKMCH     NWFLDUYCO       PGGE           
PHYR            : DFRTGCVVPN      SJEQUAYKD       OAMRWNWA        YDONHGXGGF      VVYVWCCW       
UGRGNQJJNGMQMDL : QIQRQ           ALRL           
URXETJTOMLGV    : QOCQJFCSARTBI   QDOKBORPJS      NEJQKQKPNSAYGKY MWSYVGVEEJ     
YMHHGNWXXHNETER : BTQWVKVB        DCKR            JASMMVUA        MVPQ            PILVCQ         
RXUJYYGK        : XECMVSSEOV      RVHM            DVPJNVUL        MWSYVGVEEJ      TAUVBQIOWNVSNP 
WXGFTSEIDNRQLPO : WAJURQESRF      EHVJBJV         PDDEHFEN       
FVMJPLC         : MYWHLYEPEI      OOFEDLC         KPTPXKC         IQVQEQGERFBBIPQ
GNQHVCCS        : EKQLMSND        LDHEUPFHOX      PTQOF          
KBXEFJ          : KBJMI           YXKFSLGQ        OYUPOLMDIAJSDD  NKKYOMSKOX     
VBAHQRAXPOHFA   : OYLDVRGDKPHVPD  FCNAVQALM       ORUF           
WJCOQAS         : KJKRNQI         ANYHHVJA        KHDUUAKR        GWGSUUMCIPNK   
VWEW            : EAJQNQHFGQEFMEQ GOFHRFPHYN      GQABLNGPE       HOOPQ           YHGMI          
KEGTAHWHAOJXEXI : BTJDWRRJHU      BSXMAWICHISVS  
BVKKXBDYT       : PIQHXHVPJRE     HVEGKIJFMA      NUIL            SQPEIRIWJYECYBW OAVNI          
USGTQSXWPY      : CSHPKEIMFAEVMA  YMGHBDYIOEA     QAPEEO          SUBHLUQMKSM     JURPKA          VKVU           
MGFB            : WFSXEWFXQYEP    FQPSRY          LDADNGLBSMO    
GHQOU           : VTPTEEVWFPAK    INSRSYYLKLKAATY MRKSUJIYWEDQ    LOMCLQJAUDRHTT  YGCFCWKLOO     
KFGLHKM         : UBJDVBCDRVU     IHCFACUXJNLFDW  FIQKOVEX        COOCWWIXE      
LJWRD           : ONUXMDNOWQ      TTRGCXIRIWBRYIQ KPTNVXGXGRC    
LBMDARPJASCG    : MYFI            PBIKTT          ADRIBMJHPWP    
UWWRJCXULKH     : WBVPBPWSE       CWOAIS         
WQOQTEEXSHXLW   : QGNHJMQVQRB     MDINUUGXYNY     MEVABLABMXS     KMHO            AQLT           
NRLVTJUQBEVB    : IKEVA           OTPVKV          KVTDN          
JMJBJDRAYXFWRMV : IKAQISB         MIFD           
MFSETQY         : DLQPQYDNTJNVYMF QPONMQICHEYLTIF KPVXYDXPFYR     QDCYSHIGMN      GVCEDUFUFJKBB   NKKYOMSKOX     
LRGPPHRATEBFHV  : ROIOV           UDCNPYEIKHX     UTAYLQHKL       TGXO           
GTNE            : BNAJOHRBJLAQ    QDOKBORPJS      MIHWGI          BUARKYS         EKLNF          
CAQQHLXBCWGPQ   : WNUMEIUNF       AXHMGJN        
GHUAJOEKU       : BIVGLP          SUBHLUQMKSM     QHRBDDCWQM      RKDDXNXOUQWM    GXUMDHKKLL     
IDUDSYOWBGQKRO  : RTEJMFRCVKN     JSNE            XHOF            TYRLGMAIGL     
WNUMEIUNF       : DKBCHT          ALDKAPKHWODJIS  CAQQHLXBCWGPQ   FJFAEM          VTMGQDRSVF     
WTCKQQSVN       : MIIHVJGXKACEO   PPGUURWHTKHLWDQ BXYJCSHUMD      RXMKIEBY       
QMLQPTHANVOMJM  : IXUHGGM         GOXBWQ          XECMVSSEOV      JNWNMDEBMNUMHP  RVDLBY          UHTLX          
PUWEAUB         : CDJL            LEPVGIEJILO    
ALPQ            : BSUDAJNWOJWTI   TYROCGD         PREXEFAIUNA     IWOJ           
LEBFSOVKKDM     : EHMHOYUGC       UGXXERIGTXP     PAROQVUHKQRGLFF TQNBSWIMK       GWQTHFB         PBUQUOYKEFV     WMGYWYAXQGWXJT 
BELKQ           : QGSPMM          KSKLXJTWCFLHPT  HENG            TYROCGD        
ANLEPIGLITDBYR  : YRGWYGJAUAGIYX 
DWATSMFXA       : VMSXGLUAXHRUWS  BEVDWTQ        
YERLWILKV       : ABKGNURBGAXDXF  UXXMYYYUICTR   
AEBNNUTOW       : LBQHIOUPO       WPXOHHPHFC      QYMOFHROGO     
WCIYV           : LNIULL         
MBBOHCUCNRKBEG  : RGCHRLTHCR      DFMFFGAFRYO    
GKWVAUPR        : HPJVYAC         VODYSLQLPFVCPTG
BOVLP           : CCDUFERBCO      IPUDDYQONR      XGAEWXAHH       WLHGU           ROSSRFYBGNPKVQS LRHGREMXSD     
OEVRSDVNFJHR    : MYFI            SPVAJDSSCIIFRT  NEICWMTTNAGFCDQ QWNUVKARICJEJ  
NAJTNJSN        : BESEL           VMSXGLUAXHRUWS  XKEEBKL         HLNILBNKI       FSKXH           DFAEQSPNQG      CQOLBDGL       
IFAMVX          : DLQPQYDNTJNVYMF
MRPQNHKTEABPK   : INWTLYHYF       NMJEBBVVJKGWEJW ESSE            WCQLX          
DXTPUHBNXHX     : MADENSAUQ       CMFHGKX         JXIGOOUYNO      LFDSUKEPIIOYFH  LNVO           
JKAHL           : HJFJYVXCJAJNR   UOMLBT          LYATWCGEOM     
YBFPKRJQU       : OTPPTHVBLCVA    SJADA           KRONMOG        
HFGMFBEA        : ITXGHLREXFVCFKV KWUARMQVUCNHTBF UEWODBJAL       COMR           
FPIMQMVDOFODFRK : EATCHI          YMOSM           QARRLXSHSGCRVW  TNXFPJA        
DDGTXS          : BORRTABSIM      YUCYUAFBBEO     WEFEIEBEEHO     FHLDEKUCQ       WBFHKYBYFVDLXV 
FAQKBWNLD       : BEYIXUDDGLP     NCCP            JGGOEDXKIDYDHX  CMFHGKX         UWSJLYJDJMYYAH  AURTVHEUU      
URVJQAX         : QLOJGJBXMCK     ICANVH          EROMT           BWTRMUCLJSMXONS
QDDJNCM         : ACPPO           YOWQWDE         RPAPO           SJEQUAYKD      
IIQCMXCF        : IKAQISB         LDADNGLBSMO     VYENJ          
FCYSHGPCDYSFYQV : UITVLMGNIGB     GPWVVUSPR       HVTWEWVTHCBYR   TNMCULJBDLG    
WHSYTLIF        : EHOGGRDJVE     
MRDQYM          : WAASPJTLAFJJX  
BNQLUHNA        : SWJCDKUPGUYRK   WIRCFKSG        BQXRVOHAXU     
IHKYFOVN        : LMGBJAXEMOUGBT  RNAFHEYUSXG     KWDJCCTTCFKNML 
XJVGOBUIELHTJ   : SRAT            RSSBOPYTDRLPVHX RTAXJXX         TWYEVVUGQRNJI   YNEBLXKKIBLCOJP PROWXSV        
HCWELMGUUNFTV   : QVLSBS          RPNYKAXAPKIEY   AQAGGU          YFYNOVO        
SJEQUAYKD       : BHIFWVCHYOOKBG  PHYR            QDDJNCM         LGYWNUYWVWFQB  
UHHDBSQLWN      : FYEQPGWHGIRTX   TKTVGHLIPNY     TEHSYGSA        YAYOYWXAKD     
JCYGW           : DFQUY           WQBLLYJNHIFT    ADRIBMJHPWP     JYLJWS          GIAYYLM        
LSKH            : KIBFUXNMW      
TNGRPFCSBY      : GFFIOPHBJUUTJ   WIILRONAP       GXGDCFB         QCSDJE         
KCGFS           : BFGIKNHLJFC     WANOQNXJOWBUO   QFYSOE          YWHGICOMCWXBXA  IDNNUOS        
FIKOMJULXIFJ    : REQQPOVYQQKQ   
UFGCWX          : DERTYOSWOG      POVJVFBMN       BFACCQ          PDDEHFEN       
BRLBWXFD        : QRMBDBADF       TBJUHEBC        UNEAA           MJBTFNNPHTBHO  
BVLLICY         : XRVFMSWCSXKEC  
WKRHRDYNLFPKG   : VFBVYHTYNXHJLKG TENBGPLT        FDKQTCFQV       OOQAPAE        
OAMRWNWA        : HBLPFGFB        PHYR            OROAUJHRV      
AXHMGJN         : DTKAB           PBIKTT          CJBOKRRWCVNN    DGARARYMW       JNWNMDEBMNUMHP  CAQQHLXBCWGPQ   JFTLTKOBNGDGL  
IXUPSAOGLWX     : LQTOJWJ         REJDCI          VKUUR           HWGERBAFPCCEN   NEICWMTTNAGFCDQ
DYNDOH          : OCPITCO         FNMQTIQBTFGQV   RXGCSVIDMTJWX   WAJURQESRF      YIGKUCTPBQMXHJ  PMPIKQYPGF      NEJQKQKPNSAYGKY FEMN           
DYNDOH          : CYOK            VWBJUSU        
EGCAHBJVJUJMDJH : DFRTGCVVPN      HJCT            WJPQGLYXE       AEHMRYWJJUUQIN 
EHLMVIKWNMM     : BAROL           PIGRXEVWTASXLI 
DTUJAAJHDS      : BTQWVKVB        OSCOIMIWC       NECTINFOAM      UGCO            JNYNCVYAUCA    
MNOY            : UQRIOCVB        WEAFEISWDFAO   
BINFSY          : AAJRPJO        
QKFNXTATYTQ     : KUPPUBAI        UOMLBT          EHVJBJV         GWDQTB          ANETLLHPNDBC    PYIUPSI         MSNRVF          CVFL           
TQRETMJJCYKUC   : CBUAI           EEDTJXYW        GKJMI           OROAUJHRV       ALVDLNOSHMQY    AASB            RDLWBWPSCQ     
IJOKEF          : SYVV            THTIM           HVTWEWVTHCBYR   JQLA            DYJCYALD       
MUUGUQGQIO      : HJYYY           NNUIVAJODMNVHST XIFCT           ISRFY          
YJOV            : FADHEVL         EUYDDLDSMV      MYINWMDC        PILOEEMDP      
YHYARVEPHNER    : WQYXPRQ         PWFGLXTAWEU     OAEVLDLCUFD    
LOHGLPBDVRLNFM  : KNXTKNURJCH     MNRNYUCKPJSBCF  WKGOXAH        
VKUUR           : IXUPSAOGLWX     JGQJHOXHRIKNTT  PDDEHFEN       
WMUBCCRJ        : DSIYOJOE        NRBE           
MUMTCXJFDIAQX   : KJRBLFIVSVW     PBIKTT          DTPXWUQUIPC     BMJXNPQCEE      FWCKDLAC        EQWPFTGUIR     
GWDQTB          : KUPPUBAI        UBCTB           DDARABUFN       QKFNXTATYTQ     UVRWGNRDB       QTWXAYEUYSDOBOF
QXANCERTNNIL    : RQOBJSDNUMLBRF  PPLRM           GIGWUYEBMIFQWUI MLJMNQXNN       CLODPJKMOOBLWR 
EPCPWGXYYVGFUM  : JSLSCSXLPAMHK   PPJOMQPRHSLJR  
PNMI            : EHWPSI          IFHVWTK         CNTOBFGQQTMY    OQLK           
MVPQ            : NGDUHVLN        YLNLUQNRF       FCNAVQALM       YMHHGNWXXHNETER BDGIJIIP       
LHDVSFAKJQHPQ   : QNQM            JGXVKLIJWJ      BMJXNPQCEE      EAGHR           MKFBEFTVRAV     DPAVVD         
RPNYKAXAPKIEY   : BHKFRERCUVI     CHTPIBCRQGEG    HCWELMGUUNFTV   WBDMKAIMUMKHJ   LRKPMXEYUQEHVHL QFTSVTSXXAQQGXX
VSTKCYG         : BORRTABSIM      KPTPXKC         FDKQTCFQV       YAAA           
GJHQAOISVAIMA   : FADHEVL         YMLGJTM         XECMVSSEOV      LGJRGINUMUA     UOKSH           EHJWEPL        
OATHNFLMLJ      : DLUEYAD         SRAAPIWSU       UGTHTDCGUTUTR  
ITJHDGQMPHOFP   : UWJDDDJIRPYAPWG DVOESI          WCQLX           ERCORTDKETLA   
DQQRSMJSG       : TXYGFJL         LUJXYLSVYWOUEWE
GNEVCND         : INSRSYYLKLKAATY UHOILRBABNTJY   BXUSQHAJMDR    
KPTPXKC         : UOKLPWKP        FVMJPLC         VSTKCYG         FYEIYMRKLTASNL  IYNMTQS         WBGOQPBFA      
TSVKCYDSTVFDOOV : QARRLXSHSGCRVW  EATG            DVOESI          HLNILBNKI      
EATG            : PUCQSMISOSGFW   TSVKCYDSTVFDOOV
YSAOPPP         : GWYWLUDDIUWKRJO EUFWGAFJUWRNEN  FGDIDGLQFOSBYEU WBDMKAIMUMKHJ   KWUARMQVUCNHTBF
TEUMAHPBKKUISA  : JSLSCSXLPAMHK   XTQMOW          NPXHTKQITG     
JVWNVS          : UBJDVBCDRVU     HYIEUTRDTBKR    MUSVKPDMESNUWC  CVLGMQN        
MSPMJFF         : VFJXGDWMVSYXY   DUMCYEBK        GPWVVUSPR       MYCJOS          CKMAPAAMVHB    
IYDFOFOGHYQCJL  : HOAYK           ITSWNSDXCWVX    VKVU           
IUYGLXYKKTAYEIE : BPMPB           GIAYYLM        
SGJAWQODXPTDYII : JXEQYVWXJBRBJ   IFGQUWP         VGWCWCHIPCJ     DLHIU           OGBMYP         
DJPQH           : LQPXKVGXSAJTKK  PDQTIRUYVOC     EGUFKAXJDWJLF  
BTNETROA        : XNAWQNYNNM      JWMPIFOBSGTDQ   KPNNGGQUEWFKR   TBJUHEBC        SAQMT           XOOBTVLGNEGXPI 
HIJHFAVIB       : QIJVMGBLHPTR    QHBTPLFXV       GECOKNHJAGYR   
FEMN            : LPVO            OMHRR           TLSSRUF         DYNDOH          CHHPLCDIYFBNDRP VAUHXLH         PPJOMQPRHSLJR   AQOUQLQTEBKDRGV
VSXMKGGNAT      : XQYJLSCN        SLIBWGYJJBXNFGO ACINKPDXDJBW    WWCTLEGBD       TWTICSCURUXFMUB YCDAYLEFMTY    
VOGYMPHXWNAU    : NAJBQCNYGMHFW   DRYULSN         SHOCMFLRNSAU   
BIBH            : IYBXGFATDILEO   XHRUJDXEVD      VJBG            EKQLMSND        XCIWOKMBEOCIJRS OSUCOLCJP      
QTTKSIWBOM      : RAFVQCVWHPOP    MDINUUGXYNY     VSQGEYHEO       DAIXKIGIAJAFXFW ERQBOJJ        
IFAYNYNEGLD     : EATCHI         
MBSPLVXJPTFCONY : POLUWWKWWUBC    IKRJDLX         XFVINSFYCFWM    WQXNWF          EGPNCTRHRWC    
ENVOUVOJWCPF    : BNAJOHRBJLAQ    PPLRM           SAQMT           ECQTCABHB      
UCDXW           : ANKPDVJF        UMNRIIKHMNVSMN  YXKFSLGQ        PGWRYGCPVBR     RLGJC           MDNUKRJCSJU    
MUSVKPDMESNUWC  : HWWTLTTC        SWJCDKUPGUYRK   CNTOBFGQQTMY    QNWOAWRGC       BQLSICUOGQHUQTJ JVWNVS          HPJVYAC         LXXQYM         
MUSVKPDMESNUWC  : UEWODBJAL       UMKEFP          LKLGAJXD       
LWOCGN          : CLCGEBRR        LJFJIAFX        JQUY            CLWLKQABBNGDJ   ENYRGQGGXX     
XSVVWBTTVGPR    : YQFFVWGIFV      CMAYSNCRIYXHNCI ISRFY          
CHHPLCDIYFBNDRP : UHQXHBXBVXMUC   FEMN            VSCBAYMXE       HLNILBNKI       KCRMPXN        
FWMBSIX         : QMCNBFER        TNNAHNLWQWTXWS 
EUULMMRO        : NYGSUSSRX       IDNNUOS        
CGJE            : DVHCNTPVDACCB   YLYNR          
UERVT           : OEFPMR          JKYVJDN         WBFHKYBYFVDLXV 
QJJVJXWCGXBKU   : GUWERCKSRLAAHM  FJKGKSGQDUTIE   KXKKJBLFWY      DOLJHR          PBOELFP        
XJKQA           : DEVUI           QJLULFJWWSXRCEX BBTBFGDWDYHWW   RTAXJXX         TNXFPJA         KJOHRNVRRVQPFP  IBIHPHCBV      
SHRWRMDLL       : BVWCROSJMB      JSNE            HBLPFGFB        QJJTOQAKFQOT    FFBYLMMVJLTERNM
JCJUAU          : PTUFYTSG        YLYNR           UGCO           
AYYAA           : GPQYCDANPVLV    WBVPBPWSE       GNIDCDETWIPB   
UXKEIBG         : INWTLYHYF       XURCSMMUC       BFWIVSJOFJIYLXH KYQIDYEDNKN     IKRJDLX         EMNDQFHEP      
VNLUHA          : EKQLMSND       
TNXFPJA         : KYCLBR          FPIMQMVDOFODFRK XJKQA           TYRLGMAIGL     
ESSE            : TWTICSCURUXFMUB MRPQNHKTEABPK   YDONHGXGGF      IYIQYSL         XILHDVAGOYRU   
SGFN            : IDQCC           SIDLWKABPJUTBT  WWAEUFUDCMTGQU  GBGSRUTDSNMQFYY
RTPUAJQQWMXYNTN : AFUDKXYJKNVPM   CJYFCLFLXNXRIGU LRKPMXEYUQEHVHL
YFAYVGTOMNJTT   : OCLUGGX         XFTVPO          EEDTJXYW        MYINWMDC        LHAQMXFN       
BLSQ            : RGNUIWLFO       CQIARRHB        VWBJUSU        
VCAMY           : EAJQNQHFGQEFMEQ WRLYGSKKXEJLLN  HMNPAMSJTIOJA   OBQNWB          JGDVUFD        
MYCJOS          : QIJVMGBLHPTR    QPRKW           MSPMJFF         WBIMP           IGWEMDCJUCXFJPM
TSKS            : EALIDLKCNYHEDU  EHVJBJV         JOQGGR         
EJMS            : GDXOEODQSXR     XHOF           
IOSJCMALKFMY    : MMEWGHMFOYI     XFVINSFYCFWM    EOCXHHYAFI      TJXIJGFHK      
DLHIU           : JWXHRJUW        NISFGKRKC       SGJAWQODXPTDYII FDKQTCFQV       MLJMNQXNN      
BGQTSJUYUJ      : IPNGUTQFDYTFRI  JASMMVUA        OMSVKRV         MLJMNQXNN      
ORIIDNWGYHLN    : JWXHRJUW        JSLSCSXLPAMHK   FHYQ           
RRTAARVDAOYSA   : LICEISTOPUOJTXW VECXCLSYUVXAUB  RACOFMISCFN     BGLKVLKB       
RVGMKX          : QTSIRNUSUU      PDQTIRUYVOC     IYNMTQS        
UCKRKKY         : FPJUIQB         PQYIYPLR       
AHNRCPTTMW      : IUYBQHCUX       FVFN            AYNIGHRNIOA    
DVOESI          : ITJHDGQMPHOFP   TSVKCYDSTVFDOOV POCJBRKVKWAHHHD RATJVMCECPM     DXRD           
YWMYUIDFAN      : CLDGOADA        JFYDENSRTXS     IGEUD          
CJUJAMNR        : YHFCW           FQOFVTDGQXXH    ELSJESSPOMG     OOSBRTXJLVUDAL 
JGIFK           : RMORAWN         UHTLX           IYIQYSL         IMOKWHAMCVXILES
VOAF            : TODA            SDYBVGVINWGT    AQLT           
YCDAYLEFMTY     : KELMDUQNYNO     VSXMKGGNAT      PVQLRUOTVB     
GTAGJQAUAHDIRK  : MDTKVOES        LEFKWCMJ        LLRIHBBBKTNFAB  KEMVEP          WNJMICPBTBBPI   AJYB            KWUARMQVUCNHTBF PFWU           
IKLYLOCONQSUDOW : PHCKPKLQNXKBDLE YDWAKGUXCLJ     OVPLFNWHHOJHBE  SJIHBIOM       
UQXDCOEW        : MTPHJEPDWAAYP   UKOPYSC         IBERXLDAJNKIJWD WADKXIJJ        MLGBRTPMEL     
LDADNGLBSMO     : POLUWWKWWUBC    KCNCDYAXBJCP    OWSNRG          NMGUXIUFQLMPU   MGFB            IIQCMXCF       
ODWH            : IDGKVIY         NSEHGKLDVON    
UMNRIIKHMNVSMN  : QCKHJR          UCDXW           BMJXNPQCEE      UHTLX           OTASAKCXD      
PPJGW           : DKBCHT          DNRSLYSGEOT     PMPIKQYPGF      RXDYQUQFSPXJD   FIFFED          BEVDWTQ         BODYPFUWSAKVRW 
HPJVYAC         : EHVJBJV         GKWVAUPR        MUSVKPDMESNUWC  ABJYWW          HQHORJNV        FOEKR          
IASUNKEYVNNLJGX : CGFEPAGWHKU     PYIUPSI         AGKBFIKKEE     
MQPV            : IDQQXHP         PFUVLYXMLF      OGVH            FJRLDOKIQBW     BSKWQPIVB      
OUGEEEFEGEOJ    : XKDPE           CCTFHIQV        OQLK            BRUCQMBCCFA    
MYKSXIGNTRV     : DNRSLYSGEOT     MIAF            MIFD            MPDRXWGGLO      YGNHSQWOCQAGMKD
RIKKGJ          : GLFSTPDL        KJOHRNVRRVQPFP  MDIWH          
BRIHWNOFTDORR   : FCNAVQALM       CVCPWNGEFHPS   
EKQMQFGLDCDO    : RYXPFFDXHVSYLN 
PUYRYTAGQP      : XYVSFBUXPIPQB   VKWHUQFT       
XKDPE           : OCWOHK          CMFHGKX         OUGEEEFEGEOJ    JWFNLACQPTRHHO  REBHI          
GIGWUYEBMIFQWUI : UCHOW           QXANCERTNNIL   
WCSQCCH         : HWJOFA         
YHFCW           : ICGEBSCNM       WRLYGSKKXEJLLN  CJUJAMNR        WGYPVEXPBVCL    MRXNLRLUF      
ADRIBMJHPWP     : YLNLUQNRF       WIRCFKSG        LBMDARPJASCG    JCYGW           ONOLCAWNLJOH   
NMSXHP          : TNNAHNLWQWTXWS  UOXA            LWPGF          
CGFEPAGWHKU     : KYIHY           CFSVLVHQMAO     IASUNKEYVNNLJGX EHOGGRDJVE      EJYJBPCBNWA     PSMW           
KAKUDYFLQ       : YVHKYT          VQHMWC          LBNODLY        
BMRQFPXWSCDBJS  : THCN            CUMLTPRV        KWAXVBLH        FQRVPN          GXKFFTPOTSURMOY IXYDXGXRVILLDA  OCNQALBNSW     
PRLCMEPPP       : ROBHKFLGETV     KPTNVXGXGRC    
SQPEIRIWJYECYBW : WQDLWEFCGA      LECTKME         BVKKXBDYT       YIJNUBBRINK    
EXKYCCQNFG      : KWAXVBLH        YJNWKUHLWLUSTWL DYHTLESCMK     
UXLHQDXXLRG     : VPJVBNMGDNMPV   YJPYLQL         KJGY            SNXJXOVP        WEEJHVQ        
EHOGGRDJVE      : KHPTLXJCWBBUIPL QEUPKKFPJYADL   FKTDLUCSAG      QQEDY           WHSYTLIF        CGFEPAGWHKU    
WGYPVEXPBVCL    : HIKPBHLVALYRAMO HBLPFGFB        CTLGJKTPOYYET   YHFCW          
HJNUDTF         : VWQRTMK         MJKFJWGAYRSPKB  YAYSWHFK       
DVPJNVUL        : BWQPUBIDLBRS    RXUJYYGK        FWXIIGXFYAN     WOJLJCY        
PIGRXEVWTASXLI  : RQOBJSDNUMLBRF  BXTNKGTANWA     LOWTLOUQMEDIAF  SUTJL           EHLMVIKWNMM     JNJDDURYES     
WVCARHK         : OXWTLRVMXCDC    IBIHPHCBV      
FAGSVCEXTMEL    : BLGFMCRJEC      WXDDC           GEXHNA         
IKMFKFFXQNUMPWH : QDVQFTRQHDW     JQHTEJMIUGMSV   SQAGWXXAJI      WMGYWYAXQGWXJT 
JCFKLYINFJHS    : JOEISXKDDG      ROIOV           BXTNKGTANWA     UWSJLYJDJMYYAH  VJIVSE          FGJNWCCOHGSO    VEDNMEDJJ      
VIYG            : GSCLQSY         KVTDN          
GSCLQSY         : VIYG            UVRWGNRDB      
IRMPRWTYJ       : OTPPTHVBLCVA    XQRH            OQMVTUJHPAXFPEG XOYDLRYXEG     
ATUGDD          : LGMPC           BXQBFEKMPPXJ   
TBJUHEBC        : BRLBWXFD        BTNETROA       
OSCOIMIWC       : DLMVIWXEHIW     DTUJAAJHDS      LWPGF          
TXBFEECYKFENBH  : OKBYBHTRREYJNYJ KXTG            ENVLWWU         RFULBSEUMEQD   
VODYSLQLPFVCPTG : AICC            RMEXENOA        HJYYY           EFUYWIMOFX      GKWVAUPR        IYNWPRDYPOAJPTA
PFUVLYXMLF      : LQPXKVGXSAJTKK  KYMJLEPHDXRDR   MQPV           
YJBXHSBHLPXAFFX : LGMPC           EGKPGNF         QGOGTYCKPD      ENYRGQGGXX      FGFCOQBXSWYJVN 
WRQOKVJG        : VTPTEEVWFPAK    CIPCNLWKDK      LBWURDUPTRKRLY 
LGYWNUYWVWFQB   : QMCNBFER        IPUDDYQONR      FEMUGAEQJELXVDN SJEQUAYKD       REQQPOVYQQKQ   
FQOFVTDGQXXH    : URNTD           CJUJAMNR        LRKPMXEYUQEHVHL
VSQGEYHEO       : NDEIYHAKSVYKVJR GNIDCDETWIPB    IOMJVE          QTTKSIWBOM      GBGSRUTDSNMQFYY
FMACTRDIWVWES   : DQHOPAWVQT      YJNWKUHLWLUSTWL UVTDMFPOGLKYWM  AYGIXGC         GHBCNOWEBSGEG   ILRPWE         
JYLJWS          : UBJDVBCDRVU     UYJDMSFFSJFE    GDXOEODQSXR     OWSNRG          VTANM           JCYGW          
TNMCULJBDLG     : UTEN            ITXGHLREXFVCFKV YTCTGSUNGBYJAR  EVWQEDLFNRVOIB  FCYSHGPCDYSFYQV RNTWSY         
LKJFQTEMQKFL    : EDCWRXMYPALQQ   EAPAYWGTSCJ    
HWGERBAFPCCEN   : QIQRQ           HYRO            BFACCQ          IXUPSAOGLWX     FGJNWCCOHGSO   
HBJWNU          : DCKR            KFENXUUJIPKM    UMKEFP         
UNEAA           : IPNGUTQFDYTFRI  HMND            BRLBWXFD        NXGOJFFP       
MIIJPHQVYTW     : PKPYDOXEPHXXXU  QGNHJMQVQRB     INXBHHPEPOPV   
JBJP            : GCIVRMIOVJYDOUV RATJVMCECPM    
MWSYVGVEEJ      : EHVJBJV         URXETJTOMLGV    RXUJYYGK        THSYJYKIMEUAAUU
GLFSTPDL        : GFFIOPHBJUUTJ   IJTSN           QDVHKEBFCUHN    TPNLO           RIKKGJ         
VIXR            : SRAT            PQUNVJAYB       ONUXMDNOWQ      JGDVUFD         HFCYTO          XOAACMXFKLOCGRM XNHLDXGMNWNUIF  LFJTDD         
FDKQTCFQV       : MEVABLABMXS     WKRHRDYNLFPKG   VSTKCYG         DLHIU          
NECTINFOAM      : XHRUJDXEVD      DTUJAAJHDS      RGCHRLTHCR     
TDPGCLQBDAGGK   : ACPPO           KELMDUQNYNO     MYYIICR         WJPQGLYXE       SLOLW          
ANETLLHPNDBC    : VLNUJFAWJSLIXM  QKFNXTATYTQ     OTASAKCXD      
RCXCXBRG        : YQFFVWGIFV      PLKQ            BODYPFUWSAKVRW 
FYEIYMRKLTASNL  : NYGSUSSRX       HAICDFNFHOCLU   MIFD            KPTPXKC         YTQRXJPCQMR    
WDTBEVL         : ACPPO           SRAEVRHLHERESNH PSAVUXDLLDBW    MDMAIEMGIJNLPMF
AJYB            : APMSAVPXKOFI    SONSGLRHUA      GTAGJQAUAHDIRK  IYIQYSL         WQJJER         
THSYJYKIMEUAAUU : MKMUMCOQOH      DLADEDUIYCMMWCK OTLQ            VRHCL           VXEPEABHS       SNXJXOVP        MWSYVGVEEJ     
IYNMTQS         : RABGT           KPTPXKC         RVGMKX          XOOBTVLGNEGXPI 
DPUORVCNFUOO    : OKGR            IYBEAEWKSENWYRR FWXIIGXFYAN     HSVRTOX         WKCXU          
YXKFSLGQ        : KBXEFJ          UCDXW           YDWAKGUXCLJ    
WBIMP           : BYRWJNENNOK     GMYXLPLI        MYCJOS          COOCWWIXE       XFWBUY          EEGCY           MDAMNYQSOFWROI 
EJVJYSA         : OYUPOLMDIAJSDD  MIHWGI         
OEGUBVL         : KVDQ           
WJIDFVLX        : KYMJLEPHDXRDR   LLRIHBBBKTNFAB  YHFKSVYPF       AYEJCUWEMGMBCF 
IYNWPRDYPOAJPTA : DLQPQYDNTJNVYMF RPAPO           VODYSLQLPFVCPTG
AWVXJ           : HVTWEWVTHCBYR   IWNLBDAYH      
VSCBAYMXE       : FIQKOVEX        CHHPLCDIYFBNDRP JURPKA          DTFOCTEKSQM     ILRPWE         
ATTRLA          : POHUALX         LRHGREMXSD      CAEUTOLATL     
DOSOEOPYRM      : OQPDLMURUFX     DRNUQBQ         WTEINPN         FHYQ            LFRBAIUMJXQQ    CLODPJKMOOBLWR  IWNLBDAYH      
PVQLRUOTVB      : BVWCROSJMB      KAAED           LTQIFCLRVYA     YCDAYLEFMTY    
CAUVW           : VFJXGDWMVSYXY   YFYNOVO        
JWFNLACQPTRHHO  : WBVPBPWSE       XKDPE          
FHLYECTB        : DVHCNTPVDACCB  
QFGLCDA         : PYIQ            WPOXRBLO        FJFAEM         
AHBM            : GPQYCDANPVLV    PGWRYGCPVBR    
EFYAWIHNIPWVO   : OMHRR           HYKM            KOGEXTOOIGHH    HCPQNA          POCJBRKVKWAHHHD
XKEEBKL         : JASMMVUA        NAJTNJSN       
OOQAPAE         : FNEGWSJP        TBIVK           LMPFJOLHNGOGXEP DSIYOJOE        WKRHRDYNLFPKG   EWWOMQL         QDSNV          
KKJLKIWUXFK     : GFFIOPHBJUUTJ   WMLHGHS         GTVFMWLM        WOJLJCY        
BBVBODGPNTHEIA  : SKEMJMY         CHTPIBCRQGEG    SUTJL          
ABKGNURBGAXDXF  : WPGRTJIWUFNEFJG DBUJHK          YERLWILKV       GECOKNHJAGYR    IYMWMBLUTWAOLHO
UGQRKFWSVMMFQ   : ONVEVOVBPEU     NFPOWPLNI       SQUMPXGUNEEXCXD WKCXU           UXXMYYYUICTR   
FWXIIGXFYAN     : MIAF            GEHYKVUT        XUNDJGG         UUXPNQ          DVPJNVUL        DPUORVCNFUOO    LNIUXUUGRHFVDX 
AQAGGU          : WPGRTJIWUFNEFJG LPVLXD          HCWELMGUUNFTV  
XOYDLRYXEG      : IRMPRWTYJ      
COOCWWIXE       : BYRWJNENNOK     JQKQJBBJ        OGJSARUASNYASKN KBKALXRMUCYW    KFGLHKM         WBIMP           IEWSCEIRHYWO   
ASJAJLGQI       : HYEGKCTW        DFAEQSPNQG     
OXWTLRVMXCDC    : ATMDJMQRH       VQHMWC          WVCARHK        
REQQPOVYQQKQ    : XFCKMTBOW       FIKOMJULXIFJ    LGYWNUYWVWFQB   PCPS           
VAUHXLH         : NHFGHP          RNUPPS          PVKQWIK         FEMN           
GSOCHPE         : GDXOEODQSXR     XISENOQIP       UGCO            AEHJSGXUEYWABY 
RXDYQUQFSPXJD   : HWJOFA          UMCL            MXPBBXVK        PPJGW          
LBQHIOUPO       : LIYTKBWIJDC     AEBNNUTOW       HFCYTO          UTAYLQHKL      
LFDSUKEPIIOYFH  : QICJNMMMVSTPHQ  MGAMXMDU        DXTPUHBNXHX    
AYEJCUWEMGMBCF  : LSYUXBVNGYVQJ   WJIDFVLX        CKMAPAAMVHB     RKDDXNXOUQWM   
DQXJJUTQKC      : YJNWKUHLWLUSTWL XUNDJGG        
BDGIJIIP        : CCDUFERBCO      QDQSPEHA        MVPQ           
MKQQWAG         : QXTDBV          DFQUY           EHOWKGALCM      YTQRXJPCQMR    
ELSJESSPOMG     : CCQBLTOHA       QDQSPEHA        TLSSRUF         CJUJAMNR        NSOXB          
QHBTPLFXV       : KCCUJKBRCIURYFV YHFKSVYPF       LTQIFCLRVYA     HYTUXDNQ        HIJHFAVIB       LRKPMXEYUQEHVHL
RJGLAFNIGRVAB   : LELBPDMIBPLESL 
UWSJLYJDJMYYAH  : ARUGVR          KEUGCC          FAQKBWNLD       JCFKLYINFJHS    VQJERVW        
WCTGKHIQ        : YMLGJTM         PYPDTQENGOTBQJX WAFLOHT        
RYMPBQQWNLGYKRE : YMLGJTM         BHKFRERCUVI    
GEXHNA          : MLHSFEPQGOO     EOKBJPASEQ      RBTAUEGJ        FAGSVCEXTMEL   
RTMDCUVWOWMFYD  : QRBEIDQDOU      LTGERXNRVKUBA   PRUJY           XQLDEVKGIFU    
VQJERVW         : WYWXL           UWSJLYJDJMYYAH 
UFDSMQSSI       : KBVCDNWAAVILTB  ELVMLVLTGL      UFQEQMCVXFHSLUQ DFAEQSPNQG      RLGJC          
FNQDLQTJF       : QGNHJMQVQRB     FGJNWCCOHGSO   
KIYIBKMSJLPER   : XNAWQNYNNM      QDVQFTRQHDW     LGJRGINUMUA     WQYET           UDCNPYEIKHX     SNPSTPSYH      
YGLRAU          : OTPPTHVBLCVA    UDUICCBT        RBGJY           IKMXHVMYCSQY    VRVCU          
HKCMWSHIAKSIMBL : JKYVJDN        
NEICWMTTNAGFCDQ : NHFGHP          DSIYOJOE        OEVRSDVNFJHR    IXUPSAOGLWX    
NSWMNGUN        : PKPYDOXEPHXXXU  FJKGKSGQDUTIE   GREPTWQDP       PMOVF           ABJYWW         
NXGOJFFP        : LQOUGOQWIMLBFDX KEIKHENJSCBQ    UNEAA          
HODDJR          : KFCMYCMRWFAIW   WXJUQ           QCSDJE         
PYIUPSI         : NCURMFSXMEUC    LICEISTOPUOJTXW XGAEWXAHH       QKFNXTATYTQ     IASUNKEYVNNLJGX
RXXBSLUHJD      : WBRBKFVWBEF     MNIPML          WTEINPN         QNWOAWRGC      
SIDLWKABPJUTBT  : CGUDFRCOSVPFEA  CUMLTPRV        RLUV            HFAQRAQBPHJRF   SGFN           
VKWHUQFT        : CFSFWQDTJYX     PUYRYTAGQP      PFWU           
XHOF            : MIII            GTYQ            IDUDSYOWBGQKRO  EJMS            CQIARRHB       
RGMDJA          : RCRMC           RYVPVGOSBWEUXDF KNHXFUSDEECD    CFFYXBVMPDXPNE  BORRTABSIM      SMWYQNPXP      
WBDMKAIMUMKHJ   : FSVMCIDVCOGNYS  RPNYKAXAPKIEY   YSAOPPP         TSNJOPPABJIP   
EDWAUVI         : THQLJHR         TFAYLRW         RGJKUHPIF      
DCGJQJVRM       : KMHO            ATAWWQKJAFN     UFDFVRSE       
URFHU           : UFAWEIIMABMNUF  HMCOKDJNYR      XQFLN           QXAACGRQE       TUAONRV         DDFAGESYGJ     
VPDHYPYDSYGPWOC : OCPITCO         GTYQ           
SLOLW           : TKTWRS          HUVOFNTVI       YYAGYABPY       OBQNWB          TDPGCLQBDAGGK  
FJFAEM          : OFAATQXLLCEA    NLRCBCUMKM      WNUMEIUNF       QFGLCDA         MPDRXWGGLO     
YDEQHNPWNUPOB   : VFJXGDWMVSYXY   BLYELPCILUKVF   GMYXLPLI        HYRO            ULSBPTCV       
LRKPMXEYUQEHVHL : YRMXW           SUTJL           RPNYKAXAPKIEY   RTPUAJQQWMXYNTN FQOFVTDGQXXH    QHBTPLFXV      
PMOVF           : MTPHJEPDWAAYP   OUUKPEF         IGEUD           HVTWEWVTHCBYR   NSWMNGUN        EOVDXSYTRMCQH  
KWUARMQVUCNHTBF : JFDU            JASMMVUA        HFGMFBEA        YSAOPPP         GTAGJQAUAHDIRK 
CCRGJONWAFLQ    : XQYJLSCN        XISENOQIP       PSAVUXDLLDBW   
QPONMQICHEYLTIF : JIHVA           NNOPFILXJVLKC   FQPSRY          QAECVROWK       MFSETQY         GBOOLFCBR      
PGWRYGCPVBR     : MHILDXPVXAIG    KXBCPA          XQBISID         UCDXW           AHBM            UDBTUMILLLMYTLL
NIIEAWUNPD      : VCFMTEGXAT      OXYSK          
WHQKBBPYQWXI    : LSYUXBVNGYVQJ   YSWNFPVAFKME    JGGOEDXKIDYDHX  LESVXPPSSOHVG   CKMAPAAMVHB    
EMNDQFHEP       : PKPYDOXEPHXXXU  UXKEIBG         DOGFNARHLCHOGDB WFYXQIO        
KQOHGEKXDTQNXRF : BFKYABJVIYQPJ   NCSCXIHKDBUFWL  YJDQWL          INSM            AQGFRUFEF      
IEWSCEIRHYWO    : COOCWWIXE       QYGYC          
PERGSAMYKMCH    : MGBBMLLOOHX     PQPSKWSCCPGVLM 
PFWU            : TMYDHIWKM       LEPVGIEJILO     GTAGJQAUAHDIRK  VKWHUQFT        LYRRCAM        
FCDAE           : NAJBQCNYGMHFW   NVKPKJFN       
IWOJ            : CFSFWQDTJYX     IPUDDYQONR      IBXFAEKODDJJT   GSUMH           UNAXUDATMOHSS   ALPQ            JLUA           
DOLJHR          : VUUIKRAYHR      QJJVJXWCGXBKU  
JGDVUFD         : XEMOW           GEHYKVUT        FORVHYLBCVIB    FFWCGPPEFSDWYG  VCAMY           VIXR            VAALIWM        
WKWUQCWUFBC     : JNOFCWGDJUOA    FHYQ            EHOWKGALCM     
ATAWWQKJAFN     : MXPBBXVK        UIERJ           QQEDY           DCGJQJVRM       HQHORJNV       
LRIJWLHUY       : UBJDVBCDRVU     NKRMY           SSTWCFLSPJR     DBUEQJAL        XBOHTB         
PPJOMQPRHSLJR   : CRAJQCAJRUT     EPCPWGXYYVGFUM  FEMN            YAAA            NPXHTKQITG     
CCTFHIQV        : KYIHY           OUGEEEFEGEOJ   
YFYNOVO         : KFCMYCMRWFAIW   UOKLPWKP        HCWELMGUUNFTV   CAUVW          
NGICTYSL        : HQIQWJJK        JIHVA           MMEWGHMFOYI     ULSBPTCV        JGYOD           WICLYL         
NWTFH           : VUPDVKV         LXXQYM          EOVDXSYTRMCQH  
HEGRMW          : KBJMI           AWWTYRHONLGQ    WPOXRBLO        ICANVH         
OYUPOLMDIAJSDD  : LPVO            NGKQWQ          UGXXERIGTXP     KBXEFJ          EJVJYSA         JNYNCVYAUCA     BWTRMUCLJSMXONS
XQFLN           : HUVOFNTVI       RBGJY           URFHU           MSNRVF          UIVQMELUOO      MDIWH          
QXAACGRQE       : MRHGLSUGEAREWMC DFUFTUCQ        LTRSMEASWNDQT   BQLSICUOGQHUQTJ HYTUXDNQ        URFHU           DFMFFGAFRYO     TXBVBNPITHPIF  
HFCYTO          : KTSOIQPFB       VIXR            LBQHIOUPO       BSKWQPIVB      
WYOIRRMLR       : QRMBDBADF      
QFTSVTSXXAQQGXX : QNQM            CMNVGSNRKKEK    NRYW            ENIM            RPNYKAXAPKIEY  
DYHTLESCMK      : HQPKRNMAXEKISIC BVWCROSJMB      ROBHKFLGETV     GWYWLUDDIUWKRJO EXKYCCQNFG      RMPQ           
BXNHPSDKQWDOU   : MMEWGHMFOYI     YWUQNSEACSUEQT  BVIPACIKNENFF   FSKXH          
HLNILBNKI       : XQYJLSCN        VFBVYHTYNXHJLKG NAJTNJSN        TSVKCYDSTVFDOOV CHHPLCDIYFBNDRP
XOAACMXFKLOCGRM : PQMQBTMANJ      WQDLWEFCGA      THCNPHTJCI      KBXBU           AFDKBVRKBCN     URNTD           VIXR            CCNWCS         
XOAACMXFKLOCGRM : MDMAIEMGIJNLPMF LRHGREMXSD     
OSQLAXYO        : QGOFAQ          NSOXB           TAUVBQIOWNVSNP 
KPVXYDXPFYR     : OQPDLMURUFX     TYPHAH          PYIQ            MFSETQY        
WAFLOHT         : IHCFACUXJNLFDW  KKRQ            GWSISHXEVJCBPP  WCTGKHIQ        QYPHEPVPJISLNC 
WTXRKKRKLITWYRW : MLHSFEPQGOO     MISFHPYTO       YAYSWHFK        IGRGHBUKPKIW    URNTD           WWAEUFUDCMTGQU 
VUPDVKV         : NWTFH           YAAA            AASB            IUVCWDKOQP     
MBJBKDKJW       : LQOUGOQWIMLBFDX YAYOYWXAKD      EUVGIVOSVG      LPXKGPDIPCHHVTR
BJVVUHEO        : FNMQTIQBTFGQV   KEUGCC          EHJWEPL         OXHHCYYPACVN   
FIFFED          : YTPHNOQUCIYCNW  PPJGW           IRYWSH         
KYIGW           : BHKFRERCUVI     GPXCJBCLJWTQRFB WQJJER         
JGXVKLIJWJ      : CNTOBFGQQTMY    LHDVSFAKJQHPQ  
SHOCMFLRNSAU    : LECTKME         FRRJ            VOGYMPHXWNAU    YPYELD          GHBCNOWEBSGEG   UFDFVRSE       
XFVINSFYCFWM    : FQRVPN          MBSPLVXJPTFCONY IOSJCMALKFMY   
FVNRPIYGNLNBG   : CHRNL           RXVNKKXDEENPQTT
TGYQEGOOTJTULY  : DRJUAEVTQBBOX   VWQRTMK         QSOMRAAXYEI     WHOXLN          VUSNSF         
AQXWEPOPOXDDLE  : EPVELUHVFAOT    RLUV            VXEPEABHS       INSM            RWYGUN         
PAROQVUHKQRGLFF : CAMTBKGARS      XVBEBBQ         LEBFSOVKKDM     LVKYXUEFCMGVS  
GXEF            : DCRESLWYCB      ATMDJMQRH      
TVUKTANIE       : HWWTLTTC        MYINWMDC        UDBTUMILLLMYTLL
XGQNAOIHBCBHN   : NKRMY           YLNLUQNRF       PBXYWQ          ILRPWE         
NTPNX           : PYIQ            YMOCGYHMHU      JNJDDURYES     
SRUPF           : DAIXKIGIAJAFXFW GWCWLEA        
PSAVUXDLLDBW    : WDTBEVL         CCRGJONWAFLQ    KMMWRNXGQYW     THDSQFWHX      
CYOK            : BQEKGAWRRDOKQU  RMEXENOA        GPWVVUSPR       DYNDOH          KFDNCIBPYKL     EWNSRMNIS      
AAJRPJO         : NCSCXIHKDBUFWL  TFSEPJFGSMKTGA  BINFSY          KJOHRNVRRVQPFP 
EJYJBPCBNWA     : FADHEVL         SONSGLRHUA      WLWKQIHIFGOFCN  CGFEPAGWHKU     WPXOHHPHFC      YGCFCWKLOO     
LNVO            : TQNRE           XYBVHDCE        DXTPUHBNXHX    
JQLA            : IJOKEF          ITSWNSDXCWVX   
DAFOR           : LAQNWKDCEDRIY   FPJUIQB         INWTLYHYF       RCRMC           XNVK            QAECVROWK      
XIFCT           : FYEQPGWHGIRTX   LPVLXD          RUULCYUBVODDTS  MUUGUQGQIO      CVFL           
LXXQYM          : MADENSAUQ       ATGVYFEGTL      KBVCDNWAAVILTB  MUSVKPDMESNUWC  NWTFH          
BFBRCPENJSNOVP  : KYMJLEPHDXRDR   MYINWMDC        FKTDLUCSAG      YJNWKUHLWLUSTWL WIILRONAP       QQEDY          
MHQKRXNLG       : HYIEUTRDTBKR    SCNYNB          UHKFSPRNVDKXX   JXCLX          
JFTLTKOBNGDGL   : ONVEVOVBPEU     AXHMGJN         KCVMUHM        
PGGE            : IFGQUWP         PTUFYTSG        RICJNRD         HOVDWRXAKHISVAY
XBOHTB          : LRIJWLHUY       VVYVWCCW        BRUCQMBCCFA    
TQNBSWIMK       : BLGFMCRJEC      GNIDCDETWIPB    LEBFSOVKKDM    
YADNIJVVCLCLR   : HBLPFGFB        FMFUI           TTRGCXIRIWBRYIQ
LVWTPYUKR       : HVEGKIJFMA      CLWLKQABBNGDJ   GECOKNHJAGYR    EGUFKAXJDWJLF   XOOBTVLGNEGXPI 
NKIVASA         : EHXOIEPL        BVAAMMPWO      
UFQEQMCVXFHSLUQ : FPJUIQB         OFARFGAJ        UFDSMQSSI       VJIVSE          OTPVKV         
OGMKSEUGRDCTY   : YUBLUSMGQEJOOJN MPDRXWGGLO     
UTIMA           : CMNVGSNRKKEK    RXGCSVIDMTJWX   PKAFDSEI        GXGDCFB        
YDWAKGUXCLJ     : TKTVGHLIPNY     IKLYLOCONQSUDOW YXKFSLGQ        SRAAPIWSU       LQXKYEFQIYDMGI 
RVDLBY          : WSJSYVBAEYJG    YBPYBF          DFAH            BPQDOU          PKMA            QMLQPTHANVOMJM 
UEWODBJAL       : BLGFMCRJEC      MHILDXPVXAIG    HFGMFBEA        MUSVKPDMESNUWC 
CNXFKXRRUQT     : DTKAB           DLQPQYDNTJNVYMF GYDWNUXNUWUDV   HQHORJNV       
CMAYSNCRIYXHNCI : WAASPJTLAFJJX   XSVVWBTTVGPR    UVRWGNRDB      
EUVGIVOSVG      : QJJTOQAKFQOT    GTVFMWLM        ALAALVDWG       KKIBSJDN        KOGEXTOOIGHH    MBJBKDKJW       EAGHR           PWLOXKYB       
QYGYC           : TABBVVNGGTAKO   IEWSCEIRHYWO    PTVOB           FGFCOQBXSWYJVN 
YDONHGXGGF      : WGPYGVO         TBIVK           PHYR            ESSE            BTTDYBGSGGU     VMYEV           DOMGKPMCQHWVXU 
INSM            : AWWTYRHONLGQ    QEUPKKFPJYADL   KQOHGEKXDTQNXRF AQXWEPOPOXDDLE  JOQGGR          BOOP            KONVBDDXGDTY    HTFQTHPDD      
QTSMIOIQBBQIASE : CEPHQURMFIKB    JOEISXKDDG      SJADA           LPBRTWLWHJWQCU 
VSPDBPLH        : TBIVK           CHRNL           LWHMQSCXVSVXIEU
FSKXH           : VBENYJLEGITM    NAJTNJSN        BXNHPSDKQWDOU   LESVXPPSSOHVG  
PBOELFP         : YKFL            LJFJIAFX        QJJVJXWCGXBKU   ROSSRFYBGNPKVQS
HSVRTOX         : VACF            OFAATQXLLCEA    DPUORVCNFUOO   
MSNRVF          : KPDMM           QARRLXSHSGCRVW  QKFNXTATYTQ     XQFLN           CQOLBDGL       
DAIXKIGIAJAFXFW : BTQWVKVB        QTTKSIWBOM      SRUPF          
MPYGLN          : HSHXROXPBCPFHN  EPVELUHVFAOT    WXREIQ          KIBFUXNMW      
JCYWTUCWYEHYRPF : YCNJG           MGMREA          OFLMRXEII       YHGMI           PTVOB          
SRAAPIWSU       : TKAWXOFV        OATHNFLMLJ      YDWAKGUXCLJ     FYLXCXYXJWSBIP 
REBHI           : WYWXL           CHPTLJPGWQLEY   UHQXHBXBVXMUC   YRXASUSHLPGFS   VHGXLFJY        XKDPE           LRVSNCAONKUI   
LIKFDOEETN      : ELVMLVLTGL      EEGCY          
NFNPXFSXUBWPX   : WQYXPRQ         JSNE            XURCSMMUC       KNXTKNURJCH     LJFJIAFX       
HCPQNA          : KQCFIOHSHAE     GMTGGDERB       UNAXUDATMOHSS   EFYAWIHNIPWVO   UDCNPYEIKHX    
XKJDA           : FIGQGEE         HPYJF           BEVDWTQ         TPIAUSCIQQJCMF 
KVDQ            : HXDNMDPLVE      WKGOXAH         OEGUBVL        
JEBJKTKHWHXVVH  : LRFAPSABWGN     TCKMQGLKWQTA    LPBRTWLWHJWQCU  YNEBLXKKIBLCOJP
LBNODLY         : OQPDLMURUFX     CFFYXBVMPDXPNE  KAKUDYFLQ       GBOOLFCBR      
PBFAY           : GNIDCDETWIPB    OAEVLDLCUFD    
QKUWOGJKQR      : APMSAVPXKOFI    VXYMNWIWRRJT    KXTG            CNNQPRUPLWSGDH 
YRGWYGJAUAGIYX  : JYFM            TYDY            JASMMVUA        RCIHWMHYHEFXAP  IYBEAEWKSENWYRR ANLEPIGLITDBYR  IMOKWHAMCVXILES
DFAEQSPNQG      : FEAWVA          HYTUXDNQ        KFENXUUJIPKM    NAJTNJSN        ASJAJLGQI       UFDSMQSSI       GIAYYLM        
AQLT            : IGEUD           WQOQTEEXSHXLW   VOAF           
MLJMNQXNN       : TYDY            BFKYABJVIYQPJ   QXANCERTNNIL    DLHIU           BGQTSJUYUJ      PYRTION        
VVYVWCCW        : PHYR            XBOHTB          BEVDWTQ         XRKKFD          TSNJOPPABJIP    GJERPXFRB      
SQYJJFEL        : RUULCYUBVODDTS  QSOMRAAXYEI     CHTPIBCRQGEG    FFWCGPPEFSDWYG  XROJUNYGCKH    
RGCHRLTHCR      : MBBOHCUCNRKBEG  NECTINFOAM      EOVDXSYTRMCQH   MHVEUDG        
PRTOQQL         : EATCHI          RXGCSVIDMTJWX   BFKYABJVIYQPJ   KMMWRNXGQYW    
UKDNDEWMLDBJVHL : VMFHOXHBOONQNU  FEAWVA          DLMVIWXEHIW     MDDFTYRXVOP    
BXYJCSHUMD      : QWGTXNOKUOFNK   PBIKTT          THTIM           WTCKQQSVN      
DVWY            : GKEBXWD         ADNCX           CHTPIBCRQGEG    OGVH           
JCHNIECTKDEIKR  : BLUN           
OROAUJHRV       : WTQCNLPROJY     OAMRWNWA        TQRETMJJCYKUC   FGFCOQBXSWYJVN 
DYJCYALD        : QWGTXNOKUOFNK   KUPPUBAI        QIQRQ           QDDYHHSCXH      IJOKEF          PILOEEMDP       FJRLDOKIQBW     MDNUKRJCSJU    
YMOCGYHMHU      : THCNPHTJCI      UOKLPWKP        NTPNX           ROSSRFYBGNPKVQS OQLK           
WJYL            : YTCTGSUNGBYJAR  OJEJOIXMDK      HYRO            CLWLKQABBNGDJ  
VUSNSF          : PBIKTT          UQRIOCVB        UTISLQIEUBB     TGYQEGOOTJTULY 
ROSSRFYBGNPKVQS : BOVLP           PBOELFP         YMOCGYHMHU     
ANQWYPKIMHDAA   : VQBDGXPQEUIWEU 
TUAONRV         : LQTOJWJ         MYFI            URFHU           GGXGWKGUGPOWDIT SEBNIHRT       
UDCNPYEIKHX     : LRGPPHRATEBFHV  KIYIBKMSJLPER   HCPQNA         
GWQTHFB         : NDCJHKHVCSDS    LNIULL          QTSIRNUSUU      HVEGKIJFMA      XISENOQIP       LEBFSOVKKDM     VYIESRD        
ICVEWVSMPPEK    : LNIULL          CBKUAGTAIODARP  YVHKYT          CDUE            MDNUKRJCSJU    
GXKFFTPOTSURMOY : VQHMWC          BMRQFPXWSCDBJS 
SMCUIG          : SYHNNQJ         RNUPPS          LQXKYEFQIYDMGI 
GCIVRMIOVJYDOUV : QGOGTYCKPD      FHYQ            SUTJL           JBJP            RXMKIEBY       
POCJBRKVKWAHHHD : NGKQWQ          BTJDWRRJHU      DVOESI          EFYAWIHNIPWVO   RNTWSY          IYNUFPTGRS      XROJUNYGCKH    
JNJDDURYES      : LGJRGINUMUA     PIGRXEVWTASXLI  NTPNX           KWDJCCTTCFKNML 
UOXA            : XECMVSSEOV      JJKED           NMSXHP          XHUXARBFBL     
PCPS            : BQEKGAWRRDOKQU  HDTK            REQQPOVYQQKQ    HOHLWNQRTYLDGE 
CQIARRHB        : GLXIDYIAKGWIL   GMTGGDERB       TABBVVNGGTAKO   BLSQ            XHOF            SXWCTELHMHP    
VMLHPQCJP       : VBENYJLEGITM    FATFGPEABGG     HEGUIGYMQWN     IAKMJWGCX       PSSXRKRY       
ETDUUFBKISFG    : TYDY            UGXXERIGTXP    
WPXOHHPHFC      : OCPITCO         CJYFCLFLXNXRIGU HYNEJGCBQ       AEBNNUTOW       EJYJBPCBNWA    
PTLRFDD         : RNWGYKWOXD     
WGFT            : CKUH            WWAEUFUDCMTGQU 
IGWEMDCJUCXFJPM : JFYDENSRTXS     EVWQEDLFNRVOIB  MYCJOS          KPIWLHLQY      
RHHNSBSV        : LEFKWCMJ        PYWJBLDPBCSVM   KKHNCBGESD     
EUNLPAWXYBKCFTX : CBUAI           YXUJWXE         VRVCU          
TDSJRM          : DEVUI           OPBLBSRBUIEIFMR BIQMSCI         WTEINPN         EHOWKGALCM      WBFHKYBYFVDLXV 
YTQRXJPCQMR     : HVEGKIJFMA      FYEIYMRKLTASNL  MKQQWAG        
ERYDSC          : DSELSSQ         TKAWXOFV       
VJIVSE          : WBRBKFVWBEF     OYLDVRGDKPHVPD  QAPEEO          EFUYWIMOFX      JCFKLYINFJHS    UFQEQMCVXFHSLUQ
OOSBRTXJLVUDAL  : WXDDC           HXDNMDPLVE      QICJNMMMVSTPHQ  EUXWBKOKHPOX    KJPGRDSAO       CJUJAMNR       
SQUMPXGUNEEXCXD : OCLUGGX         CVXE            ELPKLYUQE       UGQRKFWSVMMFQ   XLIGUACJNK     
MRXNLRLUF       : GXHFVHTUMYCATW  HPYJF           KGYXIIMB        YHFCW           IBDXR          
SIKEA           : XHDLSAYHDURYJV  MLWXLLWDVFY     GTYQ           
UWRNWXILEMLGKO  : UTISLQIEUBB     JGGOEDXKIDYDHX  TQNRE           EROMT          
YIJNUBBRINK     : YKFL            SQPEIRIWJYECYBW
XRVFMSWCSXKEC   : ACINKPDXDJBW    BVLLICY         RAOWFFAFOHEOMNU
RJKJW           : EEDXASV         DRWNHCUJ        GQSWRC         
RHAOKDHTQ       : IIQGACXGNFV     BTWQ           
OQLK            : LELBPDMIBPLESL  PNMI            OUGEEEFEGEOJ    YMOCGYHMHU     
BEVDWTQ         : DWATSMFXA       PPJGW           XKJDA           VVYVWCCW        HOVDWRXAKHISVAY
XQWJDGHPYO      : FMFUI          
PBXYWQ          : XGQNAOIHBCBHN   YSGCQYEHBMOCC  
MIHWGI          : UTBJIVBG        NGDUHVLN        YWUQNSEACSUEQT  GTNE            EJVJYSA         NPXHTKQITG     
EOCXHHYAFI      : IOSJCMALKFMY    EMIKIRKSDQ     
LPXKGPDIPCHHVTR : EHMHOYUGC       MBJBKDKJW       HFDUEIRHFSTWRO 
RAOWFFAFOHEOMNU : BNITL           XRVFMSWCSXKEC  
FSLMKOW         : WAJURQESRF      LECTKME         WIAV            KGYXIIMB        CVLGMQN         ORUF           
REKPBCVSCN      : GXABXCP         AIYDMUKJBKQMH   VWBJUSU        
JURPKA          : LQOUGOQWIMLBFDX XISENOQIP       RVMROYMWYC      USGTQSXWPY      VSCBAYMXE      
BMJXNPQCEE      : VNYLCGKQLUX     OTTL            WXREIQ          VISIRLK         MUMTCXJFDIAQX   LHDVSFAKJQHPQ   UMNRIIKHMNVSMN  JKXBCVMEUBJCPAH
BMJXNPQCEE      : UHTLX           YGNHSQWOCQAGMKD
DHKJRDKVYFAMXKI : TKCDLAGFII      DTKAB           QICJNMMMVSTPHQ 
AURTVHEUU       : LBGHULCVXVD     BNITL           FAQKBWNLD      
NWATQFBBOU      : RVEFLRYSSPNUSKB YAYSWHFK        TYDY            CWUPJGBHLBVNJ  
AQGFRUFEF       : KQOHGEKXDTQNXRF DQWLJMBIR       BWTRMUCLJSMXONS
EAPAYWGTSCJ     : IHCFACUXJNLFDW  WIAV            MNRNYUCKPJSBCF  LKJFQTEMQKFL    EAGHR           DQVBUSYUMLXCM  
EEIJFMYBSBT     : HSHXROXPBCPFHN  CEQFQJRDKB      KVKHQNDGKU      HOVDWRXAKHISVAY
INYOREMVH       : YYAGYABPY       KDQCUUUUHUS    
YGCFCWKLOO      : VQAHYSWB        ALDKAPKHWODJIS  CDUE            EBMM            OFARFGAJ        GHQOU           EJYJBPCBNWA    
AYXMABH         : QKVRXIEIIEFHU   LGJRGINUMUA    
ULJJKADQMAA     : RABGT           QQKQCH         
YIVGKSQ         : QXTDBV          CEPHQURMFIKB    CVQOMVOELSTIAVQ TCKMQGLKWQTA    YDHFRXEJEJ      QWNUVKARICJEJ  
JGQJHOXHRIKNTT  : RABGT           VKUUR           PTQOF          
GWCWLEA         : LAQNWKDCEDRIY   GPQYCDANPVLV    KHNWQXPXHQLTPJ  SRUPF           IBDXR          
FIBMVTFWENNNUF  : BWQPUBIDLBRS    EEDXASV         IDGKVIY         NDQXIMITJHRVLF 
EWWOMQL         : HCSAQWKMOEY     CVBYIOAE        OOQAPAE        
WISVTWXA        : LCRYVP          ROTNEEVLAI      BVAAMMPWO      
HDTDXYCENPTKW   : LLRIHBBBKTNFAB 
PWFGLXTAWEU     : OMHRR           QKFVHWFS        KQCFIOHSHAE     FAQQXU          YHYARVEPHNER   
BTTDYBGSGGU     : SRAT            SXHJNEUQJ       THCN            BLGFMCRJEC      YDONHGXGGF     
KIBFUXNMW       : QQEDY           LSKH            MPYGLN          JLUA           
TJTPLR          : NIHSVW          AKYOSTSBHMBEA   YJDQWL          MDAMNYQSOFWROI 
GPXCJBCLJWTQRFB : UHACCELQEAS     DFUFTUCQ        OALTLSXYVTBUUL  KYIGW           ABJYWW          XHUXARBFBL      JGOW            AXMDIPXVPOLX   
GGXGWKGUGPOWDIT : AFUDKXYJKNVPM   TUAONRV         ILSJOU         
XRNKURX         : BIQMSCI         NWFLDUYCO      
PRUJY           : CHTPIBCRQGEG    IQESSHNPKU      RTMDCUVWOWMFYD 
OFFOOEBUYI      : FIGQGEE         EPKKBOHOBKG     RGNUIWLFO      
QHRBDDCWQM      : COBVIKAGUSM     YCUH            GHUAJOEKU       IWNLBDAYH      
JKXBCVMEUBJCPAH : BMJXNPQCEE      FFBYLMMVJLTERNM CWUPJGBHLBVNJ  
WICLYL          : TKTWRS          KWNOJW          MXPBBXVK        NGICTYSL        QWNUVKARICJEJ  
DOGFNARHLCHOGDB : RYWPGHCESOGXCA  EMNDQFHEP      
XFWBUY          : ULSBPTCV        WBIMP          
OYSSKUGQ        : PMURAVKWH       KEUGCC          BNITL           UGTHTDCGUTUTR   KVTDN          
WYDKYWTMYC      : TXYGFJL         CQYIVYAYJD      FNOCFVDYGGNHUBU FSVMCIDVCOGNYS 
HFDUEIRHFSTWRO  : DTMEOPPMIESYK   HAICDFNFHOCLU   YIGKUCTPBQMXHJ  OOFEDLC         LPXKGPDIPCHHVTR EXBQOWE        
DJYTJXSOJUN     : QAPEEO          AEWHGLGIXYIFY   FUUOUXUWFSHX    DGDBCTILNKVE   
HOHLWNQRTYLDGE  : EFUYWIMOFX      PCPS           
FYLXCXYXJWSBIP  : SRAAPIWSU       YAAA            VMYEV           GXUMDHKKLL     
OAEVLDLCUFD     : OYLDVRGDKPHVPD  RUPKCQDRVQEDX   ORWGOYYINHDFAJ  YHYARVEPHNER    PBFAY          
KJOHRNVRRVQPFP  : QTSIRNUSUU      JWMPIFOBSGTDQ   XJKQA           RIKKGJ          AAJRPJO        
IBDXR           : CVCPWNGEFHPS    MRXNLRLUF       GWCWLEA        
ENQHCSEJXMUKBE  : FJKGKSGQDUTIE   EOKBJPASEQ      FOEKR           EGSWXVCAUSCJ   
RATJVMCECPM     : GOFHRFPHYN      GLMJDDNUNOJHGT  DVOESI          JBJP           
SMWYQNPXP       : RGMDJA         
CYJQVTUBVMDPX   : QJJTOQAKFQOT    ATGVYFEGTL      BSUDAJNWOJWTI   WJPQGLYXE      
EAGHR           : WLHGU           UIQLIOJNBFCV    CVXE            DBUJHK          LHDVSFAKJQHPQ   EUVGIVOSVG      EAPAYWGTSCJ     UGCO           
OLIM            : UOMLBT          VACF            OUQMKF         
YAAA            : RTEJMFRCVKN     UBBIQ           BVIPACIKNENFF   VSTKCYG         PPJOMQPRHSLJR   VUPDVKV         FYLXCXYXJWSBIP 
LESVXPPSSOHVG   : YUBLUSMGQEJOOJN WHQKBBPYQWXI    FSKXH          
XLIGUACJNK      : XQRH            SQUMPXGUNEEXCXD YSNFCSDXNPFJNAE KVTDN          
ALVDLNOSHMQY    : TQRETMJJCYKUC  
LRVSNCAONKUI    : DTMEOPPMIESYK   HFAQRAQBPHJRF   REBHI           RXMKIEBY       
YSBLQ           : EJKHVVYAFB      HYRO            MYINWMDC        BSXMAWICHISVS  
XNHLDXGMNWNUIF  : FVTHIVOEVOW     PQYIYPLR        OOFEDLC         VIXR            IBSPSRKMV      
DVSE            : JYFM            HPYJF           UIQLIOJNBFCV   
JQHTEJMIUGMSV   : QTSIRNUSUU      IKMFKFFXQNUMPWH AQOUQLQTEBKDRGV
HYTNOHLCCVKSAGO : GWSOPPNHFLT     YLYNR           LFJTDD         
SXWCTELHMHP     : EATCHI          PHJDADAAWMYQAYN QQEDY           CQIARRHB       
CLWLKQABBNGDJ   : IFGQUWP         SEOE            IKAQISB         LWOCGN          LVWTPYUKR       WJYL            RWYGUN         
YLYNR           : EUOVMXALNDYKQNH YVHKYT          CGJE            JCJUAU          HYTNOHLCCVKSAGO
NPXHTKQITG      : DLMVIWXEHIW     TEUMAHPBKKUISA  PPJOMQPRHSLJR   MIHWGI         
XRKKFD          : OVWIBFVIVFE     VVYVWCCW       
GECOKNHJAGYR    : JSLSCSXLPAMHK   LEPVGIEJILO     KFENXUUJIPKM    HIJHFAVIB       ABKGNURBGAXDXF  LVWTPYUKR       NJTKBYEJW      
MJBTFNNPHTBHO   : DCRESLWYCB      EUDTEVV         BRLBWXFD        RLGJC          
TTRGCXIRIWBRYIQ : QVRCS           LNLYD           LJWRD           YADNIJVVCLCLR  
KFDNCIBPYKL     : DRNUQBQ         CYOK           
SAQMT           : WMLHGHS         VISIRLK         FSVMCIDVCOGNYS  SJADA           BTNETROA        ENVOUVOJWCPF    NBLSPMXHROFFBT 
VYIESRD         : THUF            XRYSUDXADI      GWQTHFB        
JCEDVRIYFKJH    : JQKQJBBJ        RKIKVGMFBGXHAQ  DSELSSQ         CDVYLOKFWPAASU  ELNES           VDUDOMCXCAV     KAAED           OAVNI          
KRONMOG         : QJLULFJWWSXRCEX TBNG            TQNRE           LRTYUMESWLFBMDI YBFPKRJQU       CVLGMQN        
LQXKYEFQIYDMGI  : OMHRR           RRDIHB          YDWAKGUXCLJ     SMCUIG         
XQLDEVKGIFU     : UMDKJPF         PCDYSSDXNIWNQ   RVMROYMWYC      RTMDCUVWOWMFYD  ERQBOJJ        
RMETXUTKUYPNJQ  : IDTIKWYVMENMOO  JNWNMDEBMNUMHP 
VWBJUSU         : PLKQ            OQMVTUJHPAXFPEG QCSDJE          HYNEJGCBQ       DYNDOH          BLSQ            REKPBCVSCN      UVRWGNRDB      
YSNFCSDXNPFJNAE : CSHPKEIMFAEVMA  UQRIOCVB        XLIGUACJNK      RNAFHEYUSXG     RUNJCW          VAALIWM         QYMOFHROGO     
WDPNMIGKIITFDR  : XRDLVINMJHFIFQ  IDTIKWYVMENMOO 
CKUH            : KLSBPYRTKS      WGFT            XALHCYLSJBLD   
PMND            : AYNIGHRNIOA     JPWHVMIN       
SNPSTPSYH       : FQTUFKGKTLRCCIK EAJQNQHFGQEFMEQ LRVJ            EDCWRXMYPALQQ   KIYIBKMSJLPER  
NSOXB           : LOMCLQJAUDRHTT  ELSJESSPOMG     OSQLAXYO        YRQEDMHIVXITN  
UGCO            : DTUJAAJHDS      JCJUAU          GSOCHPE         EAGHR          
EYMOMCBAGESVVNP : SSTWCFLSPJR    
IQVQEQGERFBBIPQ : BWQPUBIDLBRS    JSNE            SOWO            FVMJPLC        
PDDEHFEN        : BLYELPCILUKVF   KNEPAIYILNJLHGP QQEDY           WXGFTSEIDNRQLPO UFGCWX          VKUUR          
YLHODXA         : WYWXL           BBTBFGDWDYHWW  
WQXNWF          : EYFAXJLASB      RVHM            MBSPLVXJPTFCONY TFAYLRW        
FGJNWCCOHGSO    : KUPPUBAI        STQBTUGCDQRMCD  XWUGGQJBY       XFCKMTBOW       EALIDLKCNYHEDU  JCFKLYINFJHS    HWGERBAFPCCEN   FNQDLQTJF      
FGJNWCCOHGSO    : FHEELLKW        AEHMRYWJJUUQIN 
WFYXQIO         : JKYVJDN         UBBIQ           EMNDQFHEP       CLODPJKMOOBLWR 
JOQGGR          : DFLENE          TSKS            INSM            WEEJHVQ        
FWCKDLAC        : HQIQWJJK        MUMTCXJFDIAQX  
DQWLJMBIR       : RVEFLRYSSPNUSKB EDCWRXMYPALQQ   DLCSLWDY        YJNWKUHLWLUSTWL AQGFRUFEF      
IKMXHVMYCSQY    : BJQQFB          CSMGHEDNFWV     YGLRAU          EMIKIRKSDQ     
NBLSPMXHROFFBT  : YWUQNSEACSUEQT  IOMJVE          SAQMT          
LNIUXUUGRHFVDX  : XAHDSUB         WEAFEISWDFAO    NUMJEOINMXLXVRO FWXIIGXFYAN     EGPNCTRHRWC     FGFCOQBXSWYJVN 
ENYRGQGGXX      : IIQGACXGNFV     MRDKNRCRGDKXFH  YOJIJ           MYINWMDC        DSIYOJOE        LWOCGN          YJBXHSBHLPXAFFX
FFBYLMMVJLTERNM : GYNTNC          SHRWRMDLL       JKXBCVMEUBJCPAH BTWQ           
JPWHVMIN        : ELNES           OVVXABYLNBRNIX  PMND            PYRTION         YWHGICOMCWXBXA 
YUCYUAFBBEO     : OMNGBTR         DDGTXS         
RNAFHEYUSXG     : QJLULFJWWSXRCEX LMVCSQ          JGGOEDXKIDYDHX  IHKYFOVN        YSNFCSDXNPFJNAE
WNGLVWGWRIWOK   : FEMUGAEQJELXVDN KGYXIIMB       
RLGJC           : WXDDC           UCDXW           UFDSMQSSI       MJBTFNNPHTBHO   SEBNIHRT        JLUA           
WEFEIEBEEHO     : EGKPGNF         AFDKBVRKBCN     HWBTVWABEQTRR   DDGTXS         
XXOT            : TJOXKQGH        DBUEQJAL        HYEGKCTW        CVXE           
VTMGQDRSVF      : ANKPDVJF        WNUMEIUNF      
FHEELLKW        : AWWTYRHONLGQ    CEQFQJRDKB      PDUHIWLO        XRYSUDXADI      UUXPNQ          CIPCNLWKDK      OBQNWB          FGJNWCCOHGSO   
LBWURDUPTRKRLY  : DOBQWGFY        EKJWMSMNEFY     HEWMYMB         WRQOKVJG       
CFSWBXAIIEMVSYS : HIKPBHLVALYRAMO BJRWVB          MOQGVM          YAARVUNALP     
KVKHQNDGKU      : GOXBWQ          MGMREA          KPNNGGQUEWFKR   CNNQPRUPLWSGDH  EEIJFMYBSBT    
EGUFKAXJDWJLF   : THCN            CMOCOGN         DJPQH           LVWTPYUKR      
ABJYWW          : HPJVYAC         NSWMNGUN        GPXCJBCLJWTQRFB
UHTLX           : AVMHJSFVSIC     SRDTCRY         DNRSLYSGEOT     XAHDSUB         QMLQPTHANVOMJM  JGIFK           UMNRIIKHMNVSMN  BMJXNPQCEE     
UHTLX           : EGPNCTRHRWC    
UIVQMELUOO      : NRPCJDMMGKV     TDCCCCQ         XQFLN          
XRRJGW          : THCN            HWJOFA          LYATWCGEOM      UDUICCBT        VRVJ           
GBNIAKTWSPL     : PUKB            UIQLIOJNBFCV    SUBHLUQMKSM     EUDTEVV         VRVJ           
OGBMYP          : SRAT            DOBQWGFY        VCFMTEGXAT      XUNDJGG         TYLPQTWU        SGJAWQODXPTDYII
MKFBEFTVRAV     : LQTOJWJ         TTHAJDN         PHXHSS          IAKMJWGCX       LHDVSFAKJQHPQ   NXTPAKVYVKB    
IYIQYSL         : VWQMXWEJNCEP    PUCQSMISOSGFW   ESSE            JGIFK           AJYB           
LDHEUPFHOX      : BCQSPH          GNQHVCCS        RMPQ           
CIGFO           : JKYVJDN         IQESSHNPKU      RVMROYMWYC      RYSQDPFFJC     
YNEBLXKKIBLCOJP : KBJMI           KFHVSELFJP      XJVGOBUIELHTJ   JEBJKTKHWHXVVH 
RUNJCW          : AVMHJSFVSIC     MBQVLYUMR       YAYOYWXAKD      YSNFCSDXNPFJNAE
CVFL            : QDVQFTRQHDW     SONSGLRHUA      HEWMYMB         QKFNXTATYTQ     XIFCT           XYGMAIOHLUFCXII
KCRMPXN         : OQMVTUJHPAXFPEG BGLKVLKB        CHHPLCDIYFBNDRP
XALHCYLSJBLD    : DKBCHT          BBTBFGDWDYHWW   RSJJQPXJTVPQVT  CVBYIOAE        ELPKLYUQE       CKUH           
BODYPFUWSAKVRW  : PDQTIRUYVOC     PPJGW           RCXCXBRG        BTAHKKPELMBVRWL DOMGKPMCQHWVXU 
RMPQ            : OHXTIBMBMMLYVO  JVLQHWCP        TABBVVNGGTAKO   DYHTLESCMK      LDHEUPFHOX     
DXRD            : QGSPMM          AFUDKXYJKNVPM   XQRH            DVOESI          ERQBOJJ        
KMMWRNXGQYW     : DRNUQBQ         RPAPO           PSAVUXDLLDBW    PRTOQQL         PQPSKWSCCPGVLM 
UVRWGNRDB       : QDQSPEHA        GWDQTB          GSCLQSY         CMAYSNCRIYXHNCI VWBJUSU         WOJLJCY        
SQAGWXXAJI      : NMESMPYGLDLBYQ  DLADEDUIYCMMWCK IKMFKFFXQNUMPWH MARKWKJBEVLAS  
YHGMI           : SLIBWGYJJBXNFGO MIIHVJGXKACEO   VWEW            JCYWTUCWYEHYRPF TPIAUSCIQQJCMF 
FHLDEKUCQ       : GSHEIPOWP       GWSOPPNHFLT     PUKB            WKGOXAH         DDGTXS          UMKEFP          ONOLCAWNLJOH   
TWODPHGXEGXEQGU : WANOQNXJOWBUO   FEMUGAEQJELXVDN OVPLFNWHHOJHBE 
QDCYSHIGMN      : HJYYY           BCQSPH          MFSETQY        
KPIWLHLQY       : ORWGOYYINHDFAJ  UKRJFSAUM       PYWJBLDPBCSVM   IGWEMDCJUCXFJPM MPDRXWGGLO     
WWAEUFUDCMTGQU  : BLECNIVEQIAE    AYNIGHRNIOA     SGFN            WTXRKKRKLITWYRW WGFT           
AEHMRYWJJUUQIN  : PREXEFAIUNA     EGCAHBJVJUJMDJH FGJNWCCOHGSO    RGJKUHPIF      
CLODPJKMOOBLWR  : CTKQXNP         QXANCERTNNIL    DOSOEOPYRM      WFYXQIO         ILSJOU         
XRMGGG          : CCQBLTOHA       YIGKUCTPBQMXHJ 
ERQBOJJ         : VWPTJQUB        QTTKSIWBOM      XQLDEVKGIFU     DXRD           
BOOP            : WEVFUWN         INSM           
GBGSRUTDSNMQFYY : FIGQGEE         GREPTWQDP       CIPCNLWKDK      SGFN            VSQGEYHEO      
IERAWUPGHUH     : IMABTTQIBWNOYO  DGDBCTILNKVE   
LYRRCAM         : PQUNVJAYB       PFWU            PAOCIEYPOQ     
WIXRVK          : FQTUFKGKTLRCCIK IUYBQHCUX       MDINUUGXYNY     VGWCWCHIPCJ     GJERPXFRB      
DMKQWRLWO       : BVWCROSJMB      QVRCS           FCNAVQALM       NNUIVAJODMNVHST
OVPLFNWHHOJHBE  : LNNCNMSUT       LHNJOAXLCPWTBG  KCTVJIIAKGLPXLJ BQXRVOHAXU      IKLYLOCONQSUDOW TWODPHGXEGXEQGU PPQJHDOYNMQ    
JDYHPKKEVCBNPYC : WTEINPN         MOQGVM         
PAOCIEYPOQ      : CKWPUALV        PQYIYPLR        LYRRCAM        
XREFEJF         : YOWQWDE         LRTYUMESWLFBMDI WBGOQPBFA      
YPYELD          : ALRL            RXBBBCYIFTPLLU  QJQYI           SHOCMFLRNSAU    FLHDVBQMYHYMQ  
YSGCQYEHBMOCC   : RUULCYUBVODDTS  WQBGYJXDMXQVBP  PBXYWQ          IDNNUOS        
SEBNIHRT        : DERTYOSWOG      LRJDK           TUAONRV         RLGJC           UXXMYYYUICTR    XYGMAIOHLUFCXII QYMOFHROGO      OAVNI          
FUEEYQJHR       : KJGY            KLSBPYRTKS      FGDIDGLQFOSBYEU
PTVOB           : BFGIKNHLJFC     QIQRQ           QYGYC           JCYWTUCWYEHYRPF
RNTWSY          : QJJTOQAKFQOT    UWJDDDJIRPYAPWG TNMCULJBDLG     POCJBRKVKWAHHHD
WBFHKYBYFVDLXV  : VXEPEABHS       DDGTXS          UERVT           TDSJRM         
HOAYK           : CUMLTPRV        IYDFOFOGHYQCJL  DFMFFGAFRYO    
QLCK            : OHXTIBMBMMLYVO 
XHUXARBFBL      : RQDJTHRDDH      WQDLWEFCGA      MYFI            UOKSH           FUHFMWVG        UOXA            GPXCJBCLJWTQRFB
CKMAPAAMVHB     : BLECNIVEQIAE    KKHNCBGESD      MSPMJFF         AYEJCUWEMGMBCF  WHQKBBPYQWXI   
JLUA            : BQLSICUOGQHUQTJ IWOJ            KIBFUXNMW       RLGJC          
WKCXU           : DPUORVCNFUOO    UGQRKFWSVMMFQ  
VUQWCRKJ        : QVIMGFRBKG      HBNMWXKJBHSW    WOJLJCY        
UXXMYYYUICTR    : NCURMFSXMEUC    PUCQSMISOSGFW   YERLWILKV       UGQRKFWSVMMFQ   SEBNIHRT       
PTQOF           : YAYSWHFK        FDCPWUAS        GNQHVCCS        JGQJHOXHRIKNTT  GHBCNOWEBSGEG  
MARKWKJBEVLAS   : WHUOWEQRRBVVJ   PBIKTT          DLCSLWDY        SQAGWXXAJI      EMIKIRKSDQ     
AGKBFIKKEE      : CJBOKRRWCVNN    MXTHWJ          IASUNKEYVNNLJGX
TYRLGMAIGL      : THCN            XISENOQIP       IDUDSYOWBGQKRO  TNXFPJA         RGJKUHPIF      
QWGUTTWMIWSUYBD : OWSNRG          DSIYOJOE        BGLKVLKB        GWGSUUMCIPNK   
NKROE           : FHYQ            WBGOQPBFA      
IRYWSH          : CTLGJKTPOYYET   FNCUMQMY        FIFFED         
EOVDXSYTRMCQH   : LQTOJWJ         QVIMGFRBKG      PMOVF           NWTFH           RGCHRLTHCR      AQOUQLQTEBKDRGV
RKDDXNXOUQWM    : GHUAJOEKU       AYEJCUWEMGMBCF 
TFAYLRW         : YJPYLQL         EDWAUVI         WQXNWF          AGLKRHMJH      
PPQJHDOYNMQ     : NIFQVIYCQ       ALAALVDWG       OVPLFNWHHOJHBE 
RWYGUN          : CSHPKEIMFAEVMA  AQXWEPOPOXDDLE  CLWLKQABBNGDJ  
NNPEJXHJLYGBQ   : WHOXLN          FCGJLWUKM      
UCIXQJNFDOXAPGW : GGDVPCNSESFQA   GYNTNC          CMOCOGN         ITSWNSDXCWVX   
LKSDRFBBONCWQS  : DWNK            DLMVIWXEHIW     RNWGYKWOXD     
LWHMQSCXVSVXIEU : OTPPTHVBLCVA    QRMBDBADF       VSPDBPLH       
PILVCQ          : KPDMM           RXGCSVIDMTJWX   YMHHGNWXXHNETER JNYNCVYAUCA    
DFMFFGAFRYO     : WKSNTIOCYLQX    MBBOHCUCNRKBEG  QXAACGRQE       HOAYK          
PILOEEMDP       : YJOV            DYJCYALD       
AGLKRHMJH       : PQMQBTMANJ      JDUNKCPCTVRGBOO TFAYLRW         THDSQFWHX      
QTWXAYEUYSDOBOF : CKWPUALV        HENG            YCUH            GWDQTB          PBUQUOYKEFV    
TSNJOPPABJIP    : WBDMKAIMUMKHJ   VVYVWCCW       
RIMLHMOHQLGMO   : XNAWQNYNNM      GMYXLPLI        EEGCY           KWDJCCTTCFKNML 
PGFAAANLOED     : MLGBRTPMEL      IUVCWDKOQP     
HMYYISHWFPJ     : DCKR           
YDHFRXEJEJ      : XFTVPO          XHRUJDXEVD      YIVGKSQ        
EJARAGURPI      : UMDKJPF         KEMVEP          KKHNCBGESD      OCNQALBNSW     
PSMW            : CMAWVVCXMYCWI   TODA            CGFEPAGWHKU    
TODPNIYUAWAMEL  : HVEGKIJFMA      GWYWLUDDIUWKRJO PMPIKQYPGF      FFRHXAPL        HYNEJGCBQ       QWNUVKARICJEJ   MDIWH          
IXYDXGXRVILLDA  : BMRQFPXWSCDBJS 
UTAYLQHKL       : STQBTUGCDQRMCD  FJMNHORNJVYVX   WANOQNXJOWBUO   LRGPPHRATEBFHV  LBQHIOUPO      
JNYNCVYAUCA     : BJRWVB          DTUJAAJHDS      OYUPOLMDIAJSDD  PILVCQ         
AUALGLOGYKCALNQ : HCSAQWKMOEY     MIFD            RXWXJN          LRHGREMXSD      MDDFTYRXVOP    
AEHJSGXUEYWABY  : GSOCHPE        
DTFOCTEKSQM     : REOFKWWOKRWGQOY SRAEVRHLHERESNH VSCBAYMXE      
CCNWCS          : VBENYJLEGITM    PQYIYPLR        YJDQWL          XOAACMXFKLOCGRM
MLNMISLFUOEAR   : HWJOFA         
GHBCNOWEBSGEG   : MRDKNRCRGDKXFH  FMACTRDIWVWES   SHOCMFLRNSAU    PTQOF          
IYMWMBLUTWAOLHO : GOFHRFPHYN      ABKGNURBGAXDXF 
IWNLBDAYH       : LDBNJWHD        AWVXJ           DOSOEOPYRM      QHRBDDCWQM     
TPIAUSCIQQJCMF  : RTEJMFRCVKN     LNIULL          GLXIDYIAKGWIL   XKJDA           YHGMI          
OTPVKV          : EJYMFMPCKEJI    IHRMDLUOUYGYTV  NRLVTJUQBEVB    UFQEQMCVXFHSLUQ
ILSJOU          : IDQCC           OCLUGGX         GGXGWKGUGPOWDIT CLODPJKMOOBLWR 
VYENJ           : MBUTNNCMUI      TWYEVVUGQRNJI   POVJVFBMN       BFACCQ          IIQCMXCF       
JDLTVCFXOKCGG   : BJQQFB          FNEGWSJP        JAFB           
CQOLBDGL        : UCHOW           AQYGUCLFKGDP    NAJTNJSN        MSNRVF         
BXQBFEKMPPXJ    : THCN            KELMDUQNYNO     RBJLVNWABXOPMFM VQHMWC          ATUGDD          ECQTCABHB      
COMR            : QAPEEO          HFGMFBEA        BTWQ            BTAHKKPELMBVRWL DBIQF          
OXHHCYYPACVN    : RIYBL           BJVVUHEO       
XOOBTVLGNEGXPI  : SQGUEEORUMGLJCR GYDWNUXNUWUDV   BTNETROA        IYNMTQS         LVWTPYUKR       BXUSQHAJMDR    
ECQTCABHB       : TENTCNVWEFTRGY  IPNGUTQFDYTFRI  CTLGJKTPOYYET   RFAIBDNDI       ENVOUVOJWCPF    BXQBFEKMPPXJ   
WCGTRDTGT       : QTSIRNUSUU      HENG            HEWMYMB        
ARIIGMQGFAUJEN  : WGPYGVO         EWNSRMNIS      
HQHORJNV        : GREPTWQDP       TABBVVNGGTAKO   EHOWKGALCM      HPJVYAC         ATAWWQKJAFN     CNXFKXRRUQT    
HOVDWRXAKHISVAY : OPBLBSRBUIEIFMR FFRHXAPL        PGGE            BEVDWTQ         EEIJFMYBSBT    
CVLGMQN         : IUYBQHCUX       GXHFVHTUMYCATW  JVWNVS          FSLMKOW         KRONMOG        
AEUMSTDCIBGFS   : LQPXKVGXSAJTKK  HBNMWXKJBHSW    WCLENELMJPYYL  
FFLQXKQY        : OBYMPGIEFC      JEPWN           HEFSNWPWAJOXI   AQYGUCLFKGDP    KNXTKNURJCH     PVKQWIK         CDUE            LXWHCCOQUPBNO  
SVYBKSPNST      : FNMQTIQBTFGQV   OFDGIIYPH       MDKLJP         
FOEKR           : JSAJCTDEMKVYR   HPJVYAC         ENQHCSEJXMUKBE 
LXWHCCOQUPBNO   : SXHJNEUQJ       VQHMWC          XHVWAEQ         FFLQXKQY       
IMOKWHAMCVXILES : EHWPSI          JGIFK           YRGWYGJAUAGIYX  CAEUTOLATL     
THDSQFWHX       : OLPHX           GOXBWQ          PSAVUXDLLDBW    AGLKRHMJH      
WBGOQPBFA       : QPRKW           NSEHGKLDVON     FKTDLUCSAG      KPTPXKC         XREFEJF         NKROE           WQJJER         
OCNQALBNSW      : AFQXHKO         BMRQFPXWSCDBJS  EJARAGURPI     
OGVH            : ANYHHVJA        DLUEYAD         REOFKWWOKRWGQOY MQPV            DVWY           
EEGCY           : WBIMP           LIKFDOEETN      RIMLHMOHQLGMO  
EGSWXVCAUSCJ    : VWQMXWEJNCEP    ENQHCSEJXMUKBE  KONVBDDXGDTY   
EWNSRMNIS       : PRXNRQMUKA      OQMVTUJHPAXFPEG CYOK            ARIIGMQGFAUJEN 
PROWXSV         : YVHKYT          UIXYE           XJVGOBUIELHTJ  
WEWTCTXCQSGCFL  : KKRWSCSONJNJU  
UGTHTDCGUTUTR   : ACINKPDXDJBW    OATHNFLMLJ      OYSSKUGQ       
QWNUVKARICJEJ   : EPJIWFMDCLIW    OEVRSDVNFJHR    YIVGKSQ         WICLYL          TODPNIYUAWAMEL 
LWPGF           : HQPKRNMAXEKISIC KPNNGGQUEWFKR   GNIDCDETWIPB    NMSXHP          OSCOIMIWC      
PYRTION         : MKMUMCOQOH      DNAN            MLJMNQXNN       JPWHVMIN       
JHTCGIWDUW      : QLJJBJTYPTUSGO  QVIMGFRBKG      YJPYLQL         MGMREA          HPYJF          
FCGJLWUKM       : QWGFIDCIN       OWSNRG          IKEVA           NNPEJXHJLYGBQ  
PBUQUOYKEFV     : THCNPHTJCI      LEBFSOVKKDM     QTWXAYEUYSDOBOF
YXUJWXE         : IDGKVIY         TWYEVVUGQRNJI   JASMMVUA        EUNLPAWXYBKCFTX
VMYEV           : CHPTLJPGWQLEY   JFYDENSRTXS     LQOUGOQWIMLBFDX OKBYBHTRREYJNYJ YDONHGXGGF      FYLXCXYXJWSBIP  BRUCQMBCCFA     VAALIWM        
BTWQ            : QVLSBS          RHAOKDHTQ       FFBYLMMVJLTERNM COMR           
ORUF            : YMOSM           FMFUI           CNTOBFGQQTMY    QVLSBS          AEWHGLGIXYIFY   VBAHQRAXPOHFA   FSLMKOW        
LHAQMXFN        : WTQCNLPROJY     PQUNVJAYB       WIAV            RXWXJN          YFAYVGTOMNJTT  
AASB            : BXMYY           BIKNU           TQRETMJJCYKUC   VUPDVKV         KVTDN          
RYSQDPFFJC      : CDJL            TFSEPJFGSMKTGA  SMJML           CIGFO          
ISRFY           : GUWERCKSRLAAHM  TABBVVNGGTAKO   MUUGUQGQIO      XSVVWBTTVGPR   
RGJKUHPIF       : JOEISXKDDG      VTANM           EDWAUVI         AEHMRYWJJUUQIN  TYRLGMAIGL      BXUSQHAJMDR    
IBSPSRKMV       : THTIM           PUCQSMISOSGFW   XNHLDXGMNWNUIF 
RDLWBWPSCQ      : RQAEXDKVEHJAMMI OMSVKRV         TQRETMJJCYKUC  
VWMGTWVDCONDH   : KFENXUUJIPKM   
WCQLX           : KNHXFUSDEECD    TJTJYGH         LKQURFLDBRXGNFD MRPQNHKTEABPK   ITJHDGQMPHOFP  
DDFAGESYGJ      : GYDWNUXNUWUDV   DVPONTPWQOTG    URFHU           QYMOFHROGO     
FJRLDOKIQBW     : YTCTGSUNGBYJAR  SUBHLUQMKSM     MQPV            DYJCYALD       
KCVMUHM         : XHDLSAYHDURYJV  JFTLTKOBNGDGL  
KPTNVXGXGRC     : TENTCNVWEFTRGY  LJWRD           PRLCMEPPP       QDSNV          
BTAHKKPELMBVRWL : CIFIEENDSBW     FNPSGFNQL       BODYPFUWSAKVRW  COMR            IDNNUOS        
EXBQOWE         : TKTWRS          XGAEWXAHH       HFDUEIRHFSTWRO  DPAVVD         
UMKEFP          : DRJUAEVTQBBOX   MUSVKPDMESNUWC  HBJWNU          FHLDEKUCQ      
ILRPWE          : YUMCHFNHASYJM   GYNTNC          PCDYSSDXNIWNQ   UKRJFSAUM       FMACTRDIWVWES   VSCBAYMXE       XGQNAOIHBCBHN  
BRUCQMBCCFA     : RVTKBFXQVSFR    KMOLNSBWYX      DFLENE          VBNOEPXV        OUGEEEFEGEOJ    XBOHTB          VMYEV          
VQBDGXPQEUIWEU  : PQMQBTMANJ      BLUN            XECMVSSEOV      RKJVFVMTWEDQFTF FFWCGPPEFSDWYG  ANQWYPKIMHDAA   IBIHPHCBV      
VRVCU           : AWWTYRHONLGQ    BFWIVSJOFJIYLXH YGLRAU          EUNLPAWXYBKCFTX
XYGMAIOHLUFCXII : QXTDBV          UTISLQIEUBB     CVFL            SEBNIHRT        MVFEYLQLOVJBRE 
YCDVKACHSYBO    : QLJJBJTYPTUSGO  NGKQWQ         
VFDWL           : KUPPUBAI        FJMNHORNJVYVX   IBPGIVTDV       UHQXHBXBVXMUC  
YWHGICOMCWXBXA  : RXBBBCYIFTPLLU  VUDCVRDIWXIS    KCGFS           JPWHVMIN        ERCORTDKETLA   
WMGYWYAXQGWXJT  : IPNGUTQFDYTFRI  MMEWGHMFOYI     RNCHEJFLYM      LEBFSOVKKDM     IKMFKFFXQNUMPWH
CTIKCSOSGRQGS   : VPJVBNMGDNMPV   FIOA            QGNHJMQVQRB     EPKKBOHOBKG     EROMT          
IYNUFPTGRS      : IDTIKWYVMENMOO  ADNCX           POCJBRKVKWAHHHD
XPWKLJMHTYKPQDX : UDUICCBT        GXGDCFB        
VEDNMEDJJ       : GDAPAHD         BQXRVOHAXU      NRPCJDMMGKV     JCFKLYINFJHS   
ERLWRLO         : GGDVPCNSESFQA  
VAALIWM         : NGDUHVLN        JGDVUFD         YSNFCSDXNPFJNAE VMYEV          
MDAMNYQSOFWROI  : CEPHQURMFIKB    WBIMP           TJTPLR         
UDBTUMILLLMYTLL : AHTXARWOC       PGWRYGCPVBR     TVUKTANIE      
XRQKFRD         : IBERXLDAJNKIJWD SCNYNB          KTSOIQPFB      
GIAYYLM         : JCYGW           IUYGLXYKKTAYEIE DFAEQSPNQG     
ONOLCAWNLJOH    : QLOJGJBXMCK     PUCV            XWUGGQJBY       ADRIBMJHPWP     FHLDEKUCQ      
BXUSQHAJMDR     : WQBLLYJNHIFT    GNEVCND         XOOBTVLGNEGXPI  RGJKUHPIF      
EQWPFTGUIR      : VWQRTMK         OXYSK           MUMTCXJFDIAQX  
KONVBDDXGDTY    : VCDOQEXJINHWBIO IBXFAEKODDJJT   OIEHH           FNOCFVDYGGNHUBU INSM            EGSWXVCAUSCJ    LVKYXUEFCMGVS  
DBIQF           : COMR           
NJTKBYEJW       : GECOKNHJAGYR   
BUARKYS         : GTNE           
ERVINW          : XRYSUDXADI      LOWTLOUQMEDIAF 
QYPHEPVPJISLNC  : ROTNEEVLAI      GKJMI           WAFLOHT        
FFFFYRGUIL      : LICEISTOPUOJTXW UKOPYSC         GDAPAHD         XLIB           
GVCEDUFUFJKBB   : EATCHI          CEPHQURMFIKB    MFSETQY        
LVKYXUEFCMGVS   : CHRNL           ELPKLYUQE       PAROQVUHKQRGLFF KONVBDDXGDTY   
EGPNCTRHRWC     : SOWO            PDUHIWLO        BTJDWRRJHU      MBSPLVXJPTFCONY LNIUXUUGRHFVDX  UHTLX          
IPALOLHBNHVTO   : DRJUAEVTQBBOX   MHVEUDG        
IUVCWDKOQP      : YRMXW           KXPYKXP         MNIPML          VUPDVKV         PGFAAANLOED    
KWDJCCTTCFKNML  : XFTVPO          JXIGOOUYNO      IHKYFOVN        JNJDDURYES      RIMLHMOHQLGMO   YGNHSQWOCQAGMKD
TJXIJGFHK       : KNEPAIYILNJLHGP GXGDCFB         IOSJCMALKFMY   
KVTDN           : TYPHAH          SQIEIJHJWNXFTHM NRLVTJUQBEVB    VIYG            OYSSKUGQ        XLIGUACJNK      AASB           
NKKYOMSKOX      : KBXEFJ          MFSETQY        
EMIKIRKSDQ      : JFDU            EOCXHHYAFI      IKMXHVMYCSQY    MARKWKJBEVLAS  
LEDXCWC         : WSDBAICLCNSUSKH
ERCORTDKETLA    : GREPTWQDP       BNITL           ITJHDGQMPHOFP   YWHGICOMCWXBXA 
XILHDVAGOYRU    : LMVCSQ          SNXJXOVP        ESSE           
QWCUMHMP        : OEFPMR         
GJERPXFRB       : LRFAPSABWGN     WQYXPRQ         YUMCHFNHASYJM   EPJIWFMDCLIW    VVYVWCCW        WIXRVK         
DOMGKPMCQHWVXU  : XTRYWRMWUXUX    YDONHGXGGF      BODYPFUWSAKVRW  IBIHPHCBV      
SJIHBIOM        : UBJDVBCDRVU     ANXQCTVOUBX     RXBBBCYIFTPLLU  NSEHGKLDVON     ERLRIRHGNMV     IKLYLOCONQSUDOW
IDNNUOS         : OFGTFUHLEDAO    WLHGU           KCGFS           EUULMMRO        YSGCQYEHBMOCC   BTAHKKPELMBVRWL
EIGQXVUODULDPMX : AEWHGLGIXYIFY  
UFDFVRSE        : GTVFMWLM        DCGJQJVRM       SHOCMFLRNSAU   
ITSWNSDXCWVX    : ANYHHVJA        EHMHOYUGC       FNCUMQMY        IYDFOFOGHYQCJL  JQLA            UCIXQJNFDOXAPGW
MDMAIEMGIJNLPMF : AFDKBVRKBCN     WDTBEVL         XOAACMXFKLOCGRM
QDSNV           : WGPYGVO         CFFYXBVMPDXPNE  XTQMOW          WQSGVUWPUQRKA   OOQAPAE         KPTNVXGXGRC    
DQVBUSYUMLXCM   : EAPAYWGTSCJ    
GBOOLFCBR       : IJUXOYH         QPONMQICHEYLTIF LBNODLY        
LKLGAJXD        : HMNPAMSJTIOJA   MUSVKPDMESNUWC 
TGXO            : GACIKEKACRS     AEWHGLGIXYIFY   FUHFMWVG        LRGPPHRATEBFHV 
UCRVGG          : UFAWEIIMABMNUF  XLIB           
MHVEUDG         : BTJDWRRJHU      VHGXLFJY        RGCHRLTHCR      IPALOLHBNHVTO   WEEJHVQ        
WQJJER          : FEAWVA          AJYB            KYIGW           WBGOQPBFA       MDIWH          
PQPSKWSCCPGVLM  : UTBJIVBG        INWTLYHYF       TLSSRUF         PERGSAMYKMCH    KMMWRNXGQYW    
QYMOFHROGO      : KUPPUBAI        FDCAGXV         AEBNNUTOW       YSNFCSDXNPFJNAE SEBNIHRT        DDFAGESYGJ     
RXMKIEBY        : GFFIOPHBJUUTJ   QJJTOQAKFQOT    WTCKQQSVN       GCIVRMIOVJYDOUV LRVSNCAONKUI   
NXTPAKVYVKB     : CNOMAKCN        MKFBEFTVRAV    
MPDRXWGGLO      : MYKSXIGNTRV     FJFAEM          OGMKSEUGRDCTY   KPIWLHLQY      
MDIWH           : ANKPDVJF        IRFOXLRXAXN     RIKKGJ          XQFLN           TODPNIYUAWAMEL  WQJJER         
VHAV            : XWUGGQJBY       UOMLBT          TOOGUTTPJKY    
PWLOXKYB        : YWIPJQQW        VFBVYHTYNXHJLKG XCXTJYRIG       EOKBJPASEQ      CIPCNLWKDK      EUVGIVOSVG     
LRHGREMXSD      : WYWXL           IYBXGFATDILEO   QAECVROWK       BOVLP           ATTRLA          XOAACMXFKLOCGRM AUALGLOGYKCALNQ
FGFCOQBXSWYJVN  : IJTSN           SKVWXARLKASFXA  YJBXHSBHLPXAFFX QYGYC           OROAUJHRV       LNIUXUUGRHFVDX 
TXBVBNPITHPIF   : QXAACGRQE      
MDNUKRJCSJU     : PIQHXHVPJRE     UCDXW           DYJCYALD        ICVEWVSMPPEK   
JGOW            : QTCOEY          GPXCJBCLJWTQRFB
LWKJAAYJV       : WAJURQESRF      YMJECGA        
YGNHSQWOCQAGMKD : KPDMM           HMNPAMSJTIOJA   MYKSXIGNTRV     BMJXNPQCEE      KWDJCCTTCFKNML 
VKVU            : RKJVFVMTWEDQFTF USGTQSXWPY      IYDFOFOGHYQCJL 
HTFQTHPDD       : DRJUAEVTQBBOX   YCNJG           INSM           
EKLNF           : EYFAXJLASB      DQHOPAWVQT      GTNE           
MVFEYLQLOVJBRE  : IHRMDLUOUYGYTV  WQBLLYJNHIFT    XYGMAIOHLUFCXII
CAEUTOLATL      : FHKWLKA         ATTRLA          IMOKWHAMCVXILES
GXUMDHKKLL      : MNIPML          JGYOD           GHUAJOEKU       FYLXCXYXJWSBIP 
CWOAIS          : OMHRR           LMPFJOLHNGOGXEP UWWRJCXULKH    
ORWOXRJMFLHTRNT : POLUWWKWWUBC    HYTUXDNQ       
CWUPJGBHLBVNJ   : WIAV            NFWRRXSBNRU     NWATQFBBOU      JKXBCVMEUBJCPAH
IBIHPHCBV       : FJMNHORNJVYVX   XJKQA           WVCARHK         VQBDGXPQEUIWEU  DOMGKPMCQHWVXU 
MDDFTYRXVOP     : EYFAXJLASB      KXKKJBLFWY      BPQDOU          UKDNDEWMLDBJVHL AUALGLOGYKCALNQ
XROJUNYGCKH     : VMSXGLUAXHRUWS  SQYJJFEL        POCJBRKVKWAHHHD
TAUVBQIOWNVSNP  : DEVUI           RXUJYYGK        OSQLAXYO       
LFJTDD          : VWQMXWEJNCEP    DEOYP           GNIDCDETWIPB    VIXR            HYTNOHLCCVKSAGO
OAVNI           : NAJBQCNYGMHFW   DDARABUFN       BVKKXBDYT       JCEDVRIYFKJH    SEBNIHRT       
AQOUQLQTEBKDRGV : BYRWJNENNOK     STQBTUGCDQRMCD  FEMN            JQHTEJMIUGMSV   EOVDXSYTRMCQH  
YRQEDMHIVXITN   : LGMPC           ALDKAPKHWODJIS  NSOXB          
WOJLJCY         : WXSAKHUNYBQJB   LBGHULCVXVD     OJEJOIXMDK      NVKPKJFN        DVPJNVUL        KKJLKIWUXFK     UVRWGNRDB       VUQWCRKJ       
WEEJHVQ         : FDCPWUAS        UXLHQDXXLRG     JOQGGR          MHVEUDG        
DPAVVD          : LHDVSFAKJQHPQ   EXBQOWE        
FLHDVBQMYHYMQ   : GDAPAHD         ONVKJKOJHUXHLMY YPYELD         
OTASAKCXD       : OVWIBFVIVFE     LNNCNMSUT       HJYYY           KBXBU           UMNRIIKHMNVSMN  ANETLLHPNDBC   
BSKWQPIVB       : UTISLQIEUBB     GYNTNC          MQPV            HFCYTO         
BWTRMUCLJSMXONS : CRAJQCAJRUT     URVJQAX         OYUPOLMDIAJSDD  AQGFRUFEF      
AXMDIPXVPOLX    : VBENYJLEGITM    SOWO            GPXCJBCLJWTQRFB
