VPTANYRLYRBM    : PUML            LIIEWDTJLOGUKG  NAUKL           RGNUYHVRIOE     ULURBEFROGW     AUGSBLOAJ       NOMUJXN        
UPQWQFCK        : QGBHSYAFDRFHV   GKCSCHUNJ       UNMQMM          PWSRM           JHSKYSNWQVKUMG  JNUN            GIDFKP          OUQJGVCV       
GLNXJYWMXUETU   : TAEFSLAILCOU    DSSOEGW         YRJXOFHJPXX     KSPEGJP         FVYMQLJVNG     
TMGUGJHYEYR     : JSPXI           QWVCBHULGIW     PVLNK           GXIPGW          UCCUMA         
QYFD            : HRCLSVFD        NFKTVWHRXVHNNQX YGRESUEX        LGAXCTGKYG     
NOWMBXLPVG      : PIWCVISQS       GQPAWNXURQ      HLMAU           UHSKJJSRSBJORB 
PBPLPXGVI       : YVLIOHGSXDQE    JTHKPMTNJYQC    JMQYOGLI        KSEWFCEVCGD     YHIUSE          AQQWUKR         SXTNMMYBRSHJ    UWFCAMF        
WOPOUI          : XISHDE          TVCQNAESH       XNETHHUUPBNT    OVQWFCBRMR     
ALXODWDEU       : JDPCC           JFTISJHEBPH     OUFFOTJ         UVDYVVGSAUMHR  
VQWRIAHUPGBNQRK : IORUH           GYTYA           HYEGCFF         MDEYJHLWUGMHHFB BQAU            TGHHQCKSIE     
KBCSPDHPTKMWQH  : WMHA            FOQGRPNB        INQGNRM         VATMTNXAVA      PUGSUKH        
OAMGLMN         : FGTVQXELCMU     ODMEDVK         PLSA            RDFJQ           DAKIFIWVNHU    
ETJTKEESOFUJ    : PGYYXHQWTJBC    OHXNPRAQ        GHVRCYARYXY    
AQNTDDSVMIKPU   : TIFOPUBRNAV     KTOAA           PPBSOQG        
BJFJNBSHM       : QJYUM           ONXPFHT         JBVHJL          EWNBVNNCRV      SQFEXDRCUOX     YFRIQCTVFFN     OXLPQH         
NHNVCXT         : LQSJNR          RBQPVOQOIMMPE   SWCAREUABKVYXP  SBKMUGREW       TKYY            WQXDSB          QWOFAKRRKO     
QJYUM           : BJFJNBSHM       HRIXTGBUBTUKRAA GKGSASHWNTUNRH  GHVRCYARYXY    
SCDERYWSIEEYGY  : NBPTYVWL        RECNAYI         KLHMINWQAO     
UYWCMS          : IORUH           DMATK           KYLX            LMMWBL         
MOLEXNBNI       : TNNE            XRNWIXXNARUYDDO QKQPQLNSXNA     SEEHBCGWNOA     LBVNNE         
PLAJM           : RLQFHOLIGTHK    HEXTUSG         KFSCXFIBAEN     KIXUFCHTMRCYQ  
EVEIUMHDJICLV   : EBBDTQUYKRKOUQA GKGSASHWNTUNRH  QAEKSLV         JPOHXEKREDV     CIAKPFVEJUIDSA  QEBPCHWURDBXPII GYTA           
UKLIQMVRCEO     : TOCSAUOUYGJXTT  SQAUDIBLIWCPT   HIDBNDDQ        LGGUKBMIGUSI    NQHTFITBAOXPW  
SQDFSHBA        : KNLEKFHJGEYWCDX HMYNVOFHD       FLXEYFWQS      
XOYEYKGMGEHSRQ  : VGWUCWCGINJLNRG MGEYYDHFFM     
EOEGTUAMMD      : AVMRXOLXY       KPSMESDCOBC     IAFHJVBUK      
HMXHE           : TQSQU           HMQFXPLGHSJXUII UCDUE           YKFVFQWUVGNSOPG
WECVQLIYRSR     : IORUH           UIBJVMBJFN      WKSFEL          OARDIWJV        UKCPFTXV        HURFDHTTVVIKQHC
LCQAJWVEA       : ERCNLIAGALGCWT  LGGGNXPCLJN     GFJCJLLBTMMQPLH KFTLV           VGRKU          
QFFB            : YXRQPNXD        KGPDEJQ         CARIOQEMGP      XEFK           
DIWYFDED        : STJNOHHMHDA     OAYRYUAUV       WYSWUINXJ      
POSHJLS         : GQGLRNNRLPVSAXH BTJJFIKJYRTV   
PJUYJRELCWQHXJ  : KABO            PFQQC          
JHMQMSU         : WBOBBBPEMSHCMU  PDLQCYIJNNBLWFA WRRCLPFIRKHLYF  SPOMEVXCAY     
IJCRSNMPGWMHIGN : ODBDBVNDNVQY    AAMMQRKTD       YDCUFLIGXIDGIOI OGUNBYLEHVTRH   LHXFAR          RESJERDHQCCMYHR WUMY            LVWJ           
JLKSLWGUGUMS    : CGGPBGBJBN      JREYTU         
JCVUF           : GIODJWYNONC     BWFLJG          AVEKPQQIOVYUSJP KJSXUNKWUSHU    NMMXVPEWONQRABT UENVY          
PUCFBBR         : NYALKAYCBQOO    MVJLMFSV        LCXPKBYNR       KDEFN           VHNDQB         
LYWFKK          : ULRKR           TGJVYNUO        QDKEBAENQ       BJDXSWBRTSV     PWSRM           NWMPVYWXPMY    
FYRLVXGKSTTV    : THYBCDWNBA      RCMIWPVR        CSVCACVTMU     
OBJE            : TWLOT           LHFPMXYBPGQUT   WREEWJBYMGXG    WCMN            VEOGNWVQW       YOEFMHNN        DVXFNEOVNHWX    KTKWIKA        
OLAPGLCHIJRV    : LNSYMPPRHI      MJKJMHON        USQFAJVSIGPY    HMNHYDAUYDX     MTHV            ULSDYBFXFCG    
WUVLQVR         : BHLT            QNUCSPCA        AUGSBLOAJ      
POXNIN          : BPMTTGAFBNYOEWO
STMHIMYOXDVJNP  : VFAJ            VOBOJFVL        NFKTVWHRXVHNNQX OEPDR           QOXVWLBXYXDPR  
TOCSAUOUYGJXTT  : UKLIQMVRCEO     CJIDNUIOGWLPXLP LOPP            VOIDQP          QJAHOVNBTS      KHOEPDGTSFLR   
IMJXVRMVILYEW   : OHODGOWJVIAH    RXCSRAHRUUSAM   SPOMEVXCAY     
TEJLI           : VLHIFE          CRDNSPX        
LDSGFARFT       : QSQYQAQCXWOJQ   RNGEO           BOYQ            UKCPFTXV        OIIXXNMKPPWO   
UFBEFXYRTHFU    : MNWNUUUP        KKGONWLU        KEMWQEQIBRURS   UQDHM          
CMKIVVQA        : SMEYE           MWMFWBNAAGVBGK 
WSSC            : UOHFPLMGHKK     PXKM            QUDKIFNHVFUPJL  QPHLEYJDQNUJLL  QOQVKRRUAWQF    UMXMREPTHHV    
LJPAEWDKCBJTW   : MDMWADIWXLSR    BWFLJG          IFAGXFIEXK      VLMC            BOCMPWAOMFPHQD 
CUKEH           : ITGRSWXQAW      TPRCSANFBWQV    PMJDDF          AATNKEVPYQGIXU  JEDUVMRXIC     
PFTGF           : FCJVDTUBMALND   SNHOIOVOLK      BPGLGNIKQS      ECTJ            XLUIE           PKHNAXFQHJ     
FAWJXKSPKW      : IREUGIIOLHCPWAG KELJXHLJKRT     CBUFFJIIWLOJJ   FEDXANMRIQE     YKFVFQWUVGNSOPG GIRRWMTOCIOTG  
QIQRTMRNOMXTTV  : SUQKHJY         FCAFTUQL        OQOSFBLDMY      JREYTU         
BPRG            : JJWYR           RFFCF           RQCDHVRLRJVR    MTHV           
XISHGEDV        : MWCNYDJOQHPQAH  ECUIRLCQFBP    
AKJKBCFOVUDIVYE : LCTRCBIAHQ      FHBFGGN         SVAEL           NSPTAXRSR       WKEBGLFBQELSD   PWXEIPCHBK     
KFJF            : MWYDDBJFMFVVYH  EXNNONOUSIIYI   UFFVBC          HKIGKOIJVPKDPU 
FFXXOFERD       : DYPNPFQWJECEIGN UARWWWIGGT      JAWSAOCYYTOXNCA AQEVUFXSBMNC   
UOHFPLMGHKK     : WSSC            JAWSAOCYYTOXNCA VAQHWYKPCXBERM  CCAFMSC         EEQYPHMXR      
GLXXY           : RLQFHOLIGTHK    JIKDUQ          WBOACHVRROFRIY 
HEUOJTOABVSETNS : JMQBXLEFSWFOFE  IPHTHYGUKUI     SQDVKKUFJWWHERV YKGBVHAN       
ULRKR           : LYWFKK          IUKV            NJHGSMBHTRX     MAMKTTHKGJPDT   HEXTUSG         YPJWHAM         NCNSALFRMYWSAGU KJXGQHIOQYEFYCR
ULRKR           : LIWHUPJG        MOQODV         
UEVBSTYRCI      : MDMWADIWXLSR   
WYHSNHTJCYF     : NMSUDPKEJDFQDP  TQPXG           VSXHEKKBBAISP   IASMCKOL        BFCQBNKMXAVXP   IKOXHGSVLEWMJQC
TJNHDXCESGATBW  : RPJS            LVTBRQOWLSXRE  
SYFQX           : WBOBBBPEMSHCMU  OWDPSACKADQM    ODMEDVK         UIAUUIVA       
ATRINEMOJDLUS   : CWSAVAPSGNKAS   LVTBRQOWLSXRE   FNDOPALEHJ      ENWPFEUXOXB    
XQUDJEDFFAAB    : PUSDPNKYI      
HRCLSVFD        : QYFD            YVNLYO          HEMHFGQQNCEYD  
JPDVU           : GLLRTGBMPKTRA   XMBFNBX         LUSQV           BKHWGNANRNMG   
QNJPGHS         : FHBFGGN         FGTVQXELCMU     KJSXUNKWUSHU    NUAYNBCXOYCAU  
LXWSBYTEGOGTJE  : FLCXM           OTWSQCRJHWU     PDEDBB         
OSLGVJEM        : EVBGASROROY     FTBPOT         
RXQBFL          : IRWEVITKKHUXF   DWXNN           RLIAORIEP       RMFNOAJAUQWDT  
QJQMMPGRYWASGH  : TXEDQINRHN      TAEFSLAILCOU    SROIXE          MPGBQDQINTSYREK OUQJGVCV        MTHV           
WCJEASIMT       : BJDXSWBRTSV     XABEHY         
KMDQXWJKPVWHFQG : SMEYE           QVKXKPKUHQGLNT  DEKU            OGUNBYLEHVTRH   RXSAXD         
TANBWKDGOFCYRXC : FEPUOUGTAYW     WNVFJBDXRNK     BVTC           
LHWJGJVVHVEMMM  : SOHQNGMAEBTYEHN SWCAREUABKVYXP  NOEDXMCRFSEGS  
IOHJMROUJTWIN   : HWLLPPULNDRW    FWMPS           DSIBTAHHHUPTL   FCVWAEOG        MGEYYDHFFM     
MUJWTSDDRCLNIA  : GNDQYD          NGAU            MPGBQDQINTSYREK
UTLKBWYVMTFITP  : EUBMPTQU        SNXVVVRAB       WIVKEVAVGGUD   
RFVBEPVJTNL     : INMHINRJDUTLCU 
BVHETEPG        : OAYAKMWI        SUPIX          
MFDBBKMWDNOKJ   : FAFYVW          RWHOMYQETBGJ   
OYOXUCMCG       : QQGSRGCFPGIS    WHITFLQHOB      PEBHOFDANFUWBCF IKOXHGSVLEWMJQC
MKEQC           : LIAOFKGW        YPHIBJWYJJCXX   WAFHYEUPEWGQ    KHOEPDGTSFLR    BJGTJESDHBO    
AQRGUVSHSVWIIGA : RDBMB           AWXUXHVMWVJLW   RVYUGPYNRKO    
HOADTMH         : LIIEWDTJLOGUKG  KFSGR           KSPQ           
YTMG            : UKOQRPF         OGVFEGQG        NTQT            JQTMMAT        
QSNHLTEJOLCNK   : HVPO            ITMMJI          RSKCNV          FFYHNGWJG       JNMAFV          GHVRCYARYXY     KWHFW          
VQPVBEVEAKLC    : HCTIVG          DXRR            NOHECN          LHSQUPCKRIHNGCB YCXYJWGVTMY     HICILUYWXTM    
IORUH           : VQWRIAHUPGBNQRK UYWCMS          WECVQLIYRSR     GWRUFTKRTTL     OFJEFOR         CJFAYFCFFOAGXP  FCURIEVKXXQBB   WJMXNFL        
IRWEVITKKHUXF   : RXQBFL          PIWCVISQS       BLYXYHIIBRCIJ  
NBPTYVWL        : SCDERYWSIEEYGY  YVLIOHGSXDQE    MVKNMDEIDE      PMUMMYE        
YXRQPNXD        : QFFB            GLVXEGGXXTSGNI  QTJAPXG         FQAWNVOOVAH     ETNJRIRLQLRTLWA RIGYEBG         SDKQYY         
PCFOKY          : EUBMPTQU       
VITVNI          : NAUKL           IEXHSOEPK       UQJFRGKRKUACEVT RGAUR          
RXHSVEH         : RALXKK          VKBBEWS         ERWDDXPRMF     
EFXUWLUBMNDRC   : BLXEINVF        KOPKIRUHR       AJBQAQXDBVVBAT 
SBMBWKQGVKGDEDK : CCAVOU          OGYCYULMU       LDSMLFTHJGKG    RUPH            UCNJDUPIYC      NEFYJLA         KSMCWXRMUBHGKSB
LQSJNR          : NHNVCXT         IJMAILUC        VENKUQKQRIEM    XFGRSRC        
IUKV            : ULRKR           OASBQCWP        YYBHIGDMNHH     NPEYHIEN       
CAPUD           : WQQPVLQJOTBMQPH RXNC            EEXSXFJJ       
XBOQJMC         : MJYDMY          VCRTPH         
PIWCVISQS       : NOWMBXLPVG      IRWEVITKKHUXF   VTGO            GDAPKKTUEPYS    IGHFIQDNIB      LEVA            TMAYB          
IQPGDNHFQYCTDCU : FFLXEQO         NEICAEKWJQ      KKGONWLU       
SGGWY           : VATMTNXAVA      KEQVFNFTIS      UNUQDRN         WXBJWNQVUMYCQLS
FXYDHTTCBF      : PSRIAXNN        ISVU            GAPCKNVEQFFFG   DYEIBOTJWTLE    UQJFRGKRKUACEVT CXCWRAKURCHHQL 
QLXGUFWTHRWLO   : SBKMUGREW       FQLNEQMWHXCKLJX YIRBJWWAGDBNMA 
EXYCYWJWVNGQJ   : KNLEKFHJGEYWCDX NPGAXORYBEYKC   HDEGT           RDBMB           NQAATDUHYYPEV   NAUKL           BSWRYUTLT       FHSNYT         
EXYCYWJWVNGQJ   : PWXEIPCHBK     
TQFKEDSYIQS     : LDBCSFTRXNEERO 
KRDBKKYJMXHX    : FEDXANMRIQE     SYYCJUAHAVXUQLP TNJGAQHLY      
FNEXXPROUEVB    : FBUJVCVRFRMTX   OMLLLMBWJ       ADBASKOH        GWODR          
ULQQEDIJETVG    : RWHOMYQETBGJ    HHTX           
IGMJEUWLSUBNMX  : LGGGNXPCLJN     TFLXHF          KEDG           
KYRFN           : HHXIOGQTTGBDLVS QARRL           OHAVMM          PGMOGMIBM       XHOFQRVHY       PUGSUKH        
VRNHDUBA        : UKRUBUJVPSKG    XAHMQCUEHVXP    AIPUUPOJMH      YIRBJWWAGDBNMA 
IKJXTOSTA       : WNJDRXJDM       PJYNKXLAKLVLAY  BHMY            GYTA           
ODBDBVNDNVQY    : IJCRSNMPGWMHIGN WQQPVLQJOTBMQPH YMJBKH          VAQHWYKPCXBERM 
KOBPLERMND      : EPFBFRHWB      
LYNESPRKSVPVRG  : EGDEXSPEPHJPE   RJHPYSCWA       WGIXFHCNMWAFP   PXWWRLT         VLKKYM          BTTPDKFAXGRSJS 
HCTIVG          : VQPVBEVEAKLC    CEHGQEGWO       PXRLACBCQV      BPMTTGAFBNYOEWO
AWJEOYRT        : XKYLNGS         FXJLK           LIWHUPJG        LTVFYGXCIYRSIMM
FVLJQDED        : FPQYSW          SBKMUGREW       TFLXHF          PIHS           
CTTTCXBGRKE     : IINPHW          EEBRDOV         QKJKIG          FCURIEVKXXQBB  
KEVVJMUBJ       : XYFGYDTHR       BMDUUK          KRSEOGL         BFVHTQ         
JFIUXLYCHDVEW   : SHHDUKLMBBEGBH  YFTO            VGWUCWCGINJLNRG EIMDGDPFVOLOHVC ENENJGV        
CBGTNKUAPS      : CIPTWAO         XSSUEPCVBBTSYHU MNHDUKJVG       AINSXUD        
BGTERONYXJ      : NOXVIWNIBBKNVLS KWQXLEWT        MDEYJHLWUGMHHFB JVEB            OBUVR          
LKYVOWANWEQFAEQ : KOQROVWCD       DGGRLOMVSFATCM  PMUMMYE         QPDDKFU        
GIODJWYNONC     : JCVUF           MVQHUBTQRBDXG   IULDHGEGPT     
NLNAXOVMMX      : NFKTVWHRXVHNNQX EARCHYXSAOML    CDKYVW          FHSNYT          GIEXNJ         
LCTRCBIAHQ      : AKJKBCFOVUDIVYE DUUNWRVDM       LBVNNE         
KCOLPGATV       : FOQGRPNB        KXDODMTC        REQRXQ          JPJLSYQELS      UEUHQHCCMLKE    MNVXREEPGPYHI   QMUNXVSSUQBAFE 
HJRGBPSNNVYRSS  : GKSDYCUEFSN     JVRQ            SQUIXMPTQPGRG   GPUJKJXKGJREF   VICIFWA        
TBWBTMOXEAOKCK  : CJJAKMAG        JSYQXYYNFVYNFW  KGCMWCRJUFF     FHSNYT          AYPIQPXSYKNCL   YLDCTQFGBEJ    
USUMYVFTJU      : FHBFGGN         MXCGAJTX        VLKKYM          BIECAUTWNNQW   
KNLEKFHJGEYWCDX : SQDFSHBA        EXYCYWJWVNGQJ  
PCEXWWSMXORT    : SULBS          
MMLCXROFYYO     : HLEMSPVH        SARMI           LXLSEGUN        QQTDDHKIEXSCE   DIQD            GBQG           
XLIDL           : UGKLDORGPARAW   EPYRVK          CCAVOU          WNVFJBDXRNK     MCOBVPLVU      
SOHQNGMAEBTYEHN : LHWJGJVVHVEMMM  IJMAILUC        IJUKTUVFKODVCIP NQSDNUGOPLU     HGYIFYUKBXXNRD  MXCGAJTX        JMLYUQAHVGM     TFVNATAKUPQH   
LOJBTKC         : KGPDEJQ         GKBJNYN         MBEAC           DVLB            TGHHQCKSIE     
QCWBFK          : MQKTUBJNSKPWWPK NYEMMWGPXCFLDAY PDEDBB         
XBKQPSDR        : RTNGHT          CTNQITQWMJ      GBJYLCFMYVSJTUL IVCGWTDJEJFJ    YHRDYAVY        BPMTTGAFBNYOEWO
HMYNVOFHD       : SQDFSHBA        KGCTWRE         UJBFBMIUBQYLC   IXMMXJFWPWFXW   PVISNMBKKSNLTFV
KABO            : PJUYJRELCWQHXJ  UMYXGCJVICKSNIT VDHUWFD         MWYDDBJFMFVVYH  YPJWHAM         UQGPCC         
TQHUXUAXVMPN    : CGREHHWQQB      KOQROVWCD       KRXEFMWUXYFJQ   DWWNUBVKHFP    
UGDEUERQTYAYP   : OQJMFTERQEVFW  
YTCKNVTLTQ      : DDFQKJKOFWWN   
SNXKDDFJJMEPGW  : NOSXKAKCO       MFYLQMRKQDISDB  FGLQTLU        
GALXNMRPYIN     : DYEIBOTJWTLE    OKCJQOAA       
TIKHB           : BSUTKADQCQ      NITAFLNHMLNNUU  LEVA           
HLEMSPVH        : MMLCXROFYYO     NJGETWVETQ      VYJMMVPNABU     RLIAORIEP       RGIOAYGERLGYF  
OOTCWTN         : CQBOTNEYKJAVFT  AWBMBYSCLHCV   
JDPCC           : ALXODWDEU       AKTEFVIP        IVXVDMUGOG      SGMYSGUDN       WKCDWOSGM       JRKIYYYQTY     
PXTXLDYNK       : ALCQXQLFX       BSNT            RGAUR           DGYNAJYUTXNEU  
RWIKVPHKEDMBA   : XXOGB           FLLLNSBVDWHHT   ADATCW          RXPRLJVT        RQJLMLCMYC      KJRJHW         
YJIOLMMCLIAYL   : NSPAYDK         XODEVJEWBLURKR  POYVERA         SQHTJDWN        IEWXVT         
MVQHUBTQRBDXG   : GIODJWYNONC     CXGHGNSDQWBR   
CGXB            : ADATCW          HSEMPPJWPGCOBFD KWBATPQI        ANLVTI          DILTGRVHLKYWMJD
IREUGIIOLHCPWAG : FAWJXKSPKW      TFIJEBYSXIQCXA 
UKAOCDTCJOES    : HMQFXPLGHSJXUII KPME            NTCQDNTFLQ      QKQPQLNSXNA     GHAYLF         
HLUYP           : FTVXGPAOV       IPHTHYGUKUI     IIEJ            CARIOQEMGP      HRMG           
HBBVMLXCKXKSV   : XOWUTYPMD       LIIEWDTJLOGUKG  LIIJQJTHPNW     FHLMUCQNO       UKGPBKUTECT     RHKECE         
UMYXGCJVICKSNIT : KABO            LESKXPWTCDWMXF  BKHWGNANRNMG   
DCHEXTRYXCY     : KFSCXFIBAEN     OHAVMM          LYECJWOHREUBO  
WWGRJFPSHCOS    : RXUNXKQCDHJCL   FTIP           
BLSLFBOHI       : HRIXTGBUBTUKRAA YONYTGUHTCQQAOR TQPXG           EHCHNWUKYBXMDGJ DHCQG          
IENJCSIMPISIRY  : JVUVYBEFHGDETO  IXUIWQLKFXOQO   TEKDJLHW        AHPGHIPUHUBICMR AXPHUETYAEEATWO
KICBBJFMEQUF    : HBVSBNNUBBCLNB  RAGPFOGYWQWV    TYIBONX         JWVOKGXIOBQXS  
EPEMTRXXMHMFP   : RJSPCDRDCFXLF   FIVJMFEANOWWCOR
PJHPUPUXREDGKW  : KPLEKMMHD       MHLFW           ORFXMHEN       
PFIFJWBDVBQDNVU : NPCTPRDJE       LIIEWDTJLOGUKG  WMUQ            SDON           
LGBDBTACNGFT    : HAEALDHHCYIVCC  IARYVXCRPVB     OSHO            OTQBLBO        
CXGHGNSDQWBR    : MVQHUBTQRBDXG   LXOTBUHWWV      FQVDJKSK        QMUNXVSSUQBAFE 
EILBEYIGCLCDNPL : NXJITYQK        KPSMESDCOBC     BKDUCINNUHAS   
JDAJLKRADX      : KRXEFMWUXYFJQ   LYRSGUMO        MJYDMY          GHLEMKPQ       
CYNR            : TRNM            MDJR            XRIKSE          BIDTKLXXSLC     PAXJVL          VIGABSJP        UWFCAMF        
VDJACR          : FANKCQJALHJ     AINSXUD         UEUHQHCCMLKE    RGFC           
HGKMVAXTMB      : FLLLNSBVDWHHT   LWFVJLOFCKVVQ   BUDXFMQRGQHCL  
XNHQPKQIPP      : RFPBLDOVFI      WGUKIRCV        WHITFLQHOB      NOLRV          
HXTLI           : GNWOWY          VDXWUA          WNRBVWQAVHTERT  PRAQAWGWSGTC   
PCDWIQJHSI      : IHXFFNGMIJUOL   ETNJRIRLQLRTLWA IDSAV           KDDACGWUDNB    
FLXEYFWQS       : SQDFSHBA        GKGSASHWNTUNRH  ONALIGUUIEGIVO  FNCQTVODYD     
CIFX            : OWDPSACKADQM    DOQUCQBT        GUGMIBDB       
EUBMPTQU        : UTLKBWYVMTFITP  PCFOKY          QQGSRGCFPGIS    LOPP            EPEJTVGGJWY     NQAATDUHYYPEV   FERVGTXICYDT   
ALBJHLKMWJSY    : SSIV            NKAESGDSF       BHJBKKLKGLG     GLDLXBLAM       JYDQFADHNO     
RPHFTRNUI       : KQIUX           NSPTAXRSR       INMHINRJDUTLCU  BIAXOQQOGCXGHGG
PLGFFW          : VRSTAF          PERIRPKVYAQCQ   KPSMESDCOBC     RESJERDHQCCMYHR QSNOAAWHXKYPW   GKKOJ          
WYQAIXNVMK      : UARWWWIGGT      RIGYEBG         BYNLXGHYBMWXSB 
GLVXEGGXXTSGNI  : YXRQPNXD        SMEYE           MQQWWNMSPUXR    UJTNYUGNLNGYU   UKOQRPF         WNRBVWQAVHTERT  OKJM           
VPAUSWW         : SESMYPHBHVUCMS  VQFFDL          HEWOKYD         MPGBQDQINTSYREK JKEUDMXB       
YHJMDVAKENHFR   : RXUNXKQCDHJCL   OTSFWYTABE     
LSNHLUWWPU      : VUOXJEHLA       YJNWQ           OVHH            GTBQMLRVD       FSHQ            JKEUDMXB       
PPHPMSQWEGAB    : JBVHJL          XOPIUP          MDYIUPBHNKU     MAESTSMSNFWIOF 
LHTSMO          : LGPUIJGS        BDLCSMIRDFTCH   JGCV            SAFEOOMAODK     NTQT           
XHVHUS          : TVWBRQEJOWWJ    RBMLDMPHDIMKF   GUGMIBDB        DAHTFVDCJ      
RKBFDR          : MGCHUIFU        UYHFCPY         DQILKYFROARH    BJJLCK          HKIGKOIJVPKDPU 
UGKLDORGPARAW   : XLIDL           OBKKXLUL        MSTTLU          EYTSURPAMBBN    XYNFWESRFO      KWJFC           SSSXSUMLFFG    
MNWNUUUP        : UFBEFXYRTHFU    YERYTPFXTFV     DOGKUWMVTU      GXXUSF          KPWHKNM         YTSURUWSELNTX  
CKBFR           : DTMHOPXKCER     PGMOGMIBM       SHBBHSLHT      
WGBGQNLGHRX     : JEQBVVPENHTK    DYGWQBLQF       FUPWVX          YTSURUWSELNTX  
JAJVNWU         : VBLCMQDASXUN    IBMPWMGPWOPXP  
TQXLHC          : UXJMOTUOPUSRYX  EMOJ            NNRCGA          UDORTHATOKGKN  
IINPHW          : CTTTCXBGRKE     LBAV           
NPGAXORYBEYKC   : EXYCYWJWVNGQJ   UFAITKTVHSH     CHFPRQTQQ       AUGSBLOAJ       NRPKW           QWSLFGKYB      
JXPDOOOVSN      : GHNGWRDCBID     TNJGAQHLY      
DDVLANBST       : ICJRLYUTLDXR    KXDODMTC        OXRIDRW        
QKVPLCPXEEHEU   : TVPBTARDRLY    
SLCQG           : VATMTNXAVA      IJGPDABU        LGPTOTQKYRFYRS  SSSXSUMLFFG     FHGVPSDMRRFFCC 
XKUVVXJ         : UJUAALPJCS      TUBSMUBXHOL     PVCII           NCEFOGL         EMPRNELLYD      ONALIGUUIEGIVO  FNYYV          
QGBHSYAFDRFHV   : UPQWQFCK        SIVH            OPTUKVXOY       BPMTTGAFBNYOEWO
OSAJGEBNXBXT    : GIAMBDV         HFQKFYDJJT      FHLMUCQNO      
TRLSKRVTKW      : VOXWPIMVHRCNKK  NTQT           
RALXKK          : RXHSVEH         CAOXWW          WYWFUJ          DLKAPULCXQFAE  
YDPI            : GIAMBDV        
ULASOXOOTIAO    : PSRIAXNN        KGCMWCRJUFF     ECTJ            BYUSYANTONUQ    UMXMREPTHHV    
TNNE            : MOLEXNBNI       EUILMMXPSCGWJIW QJAHOVNBTS      UCOESDEXMTFSV   IBDNGFE         YEBRSNW        
JYNVWXIKYL      : WCJQPRHMRJ      EKPYBD         
JAWVASK         : MSAVFOXVMDAUJDT QGWKKBKINTUMIG  BJLDHMLUHL     
HBVSBNNUBBCLNB  : KICBBJFMEQUF    JTHKPMTNJYQC    ETNJRIRLQLRTLWA OQJMFTERQEVFW   VENKUQKQRIEM    NLJTUVJAMRN    
JAYR            : ETNJRIRLQLRTLWA CCNHRAVUMVS     MMUWPAKXGOKXU   VRLULNEBMU      GWODR          
AFMKIMIIFULOWJJ : SDFVEWBSPIVDG   ATJBBDPFX       GYCMEB          HBTDXRMAFGNCCGJ JDPOSILYRUSGL  
WXVX            : IPERHECIRTVCQ   JECEFSGSUWR     KEJSXEALVWTTBDR
AKOBLABNTNNCC   : LJKEWXTSFELQKV  HEWOKYD         PPDTLI          ENENJGV         ALKBU          
KQIUX           : RPHFTRNUI       KHBCS           IJUKTUVFKODVCIP XLATRN          GIAMBDV         CIAKPFVEJUIDSA  YPVNPLCKTUC    
GNDQYD          : MUJWTSDDRCLNIA  TQSQU           SIVH            FQLNEQMWHXCKLJX EXIWUTUCYCV     KWJFC           MTHV           
WBOBBBPEMSHCMU  : JHMQMSU         SYFQX           LVUWOHSUHA      DTEFALVQYAQY    PIHS           
OASBQCWP        : IUKV            BBYK            KSPQ           
FFLXEQO         : IQPGDNHFQYCTDCU WJRCXKFAOPBF   
SDFVEWBSPIVDG   : AFMKIMIIFULOWJJ BSUTKADQCQ     
TGJVYNUO        : LYWFKK          ICJRLYUTLDXR    AAPFIEBTYW      NKAESGDSF       WWQM            VLUDGVUUPUTPNSM
ATJBBDPFX       : AFMKIMIIFULOWJJ FAFYVW          KONLVH          ANOSFQQIPSE     KWJFC           LJGYBSQJ       
MTYJ            : MSNLA           CHFPRQTQQ       CNDJSX          UIAUUIVA        OUDPNIDIN       TNCUGCSMGMD     ABAVIY         
RAGPFOGYWQWV    : KICBBJFMEQUF    NBESQGVE        WVAKGEONEIRRPAJ FCAFTUQL        ADBASKOH       
RNFUJQVKT       : RRGEOFQLYQTPXKV LVUWOHSUHA      CCAFMSC        
RRGEOFQLYQTPXKV : RNFUJQVKT       KKGONWLU        UGIGSFARLLUJC  
HOWEXQRDLBTJOQW : VYEXWWROTFFFU   IPFKEMXSCXY     QVVXFT          JMJDPFH        
KDPYKGLKY       : CNQNJPO         NDPVJ           BWYUVWDCDNA     IBDNGFE         TWGAIIDGYWJT    WOEDKM         
CWSAVAPSGNKAS   : ATRINEMOJDLUS   FHRMYQ          QKYAYMOUWUJLMGI BXJVPM          TIHA            RWHOMYQETBGJ   
EMKSFHD         : IHSMTWNSSD      OBRIX           RGGODGMBWT     
NSPAYDK         : YJIOLMMCLIAYL   BPGLGNIKQS      DILTGRVHLKYWMJD
NMWG            : BPFPIM          DEGHMUBHWM     
TIFOPUBRNAV     : AQNTDDSVMIKPU   CJRAKYLOMKWWQNV LHFA            QJAYVMCUEHIOXL  XBOIFXW        
MQKTUBJNSKPWWPK : QCWBFK          XGHTAQBBOLYQJ   HHSYQKOORUEDDI  FOTRBHVOIAC    
NSCJBJXSGALVCJ  : XYFGYDTHR       OVHH            DPKOXUHEULYBQ   OQOSFBLDMY     
OBKKXLUL        : UGKLDORGPARAW   SVWV            LVWJ           
HDEGT           : EXYCYWJWVNGQJ   HURFDHTTVVIKQHC LVNAEGUG       
SJHWSKGS        : GYACDPK         MUWDUCDHO       JREYTU          EIMDGDPFVOLOHVC GGIUJMRIYDE     HEOTNUUWAXS    
MSRIWBJN        : VQFFDL          JADRK          
TYCIVQNFTRLPIHY : GLLRTGBMPKTRA   EPONHODQRYBWP   RLQFHOLIGTHK    FTQR            BGPKCUIGAUGV   
ERCNLIAGALGCWT  : LCQAJWVEA       YQRVSUBP        XCHVQLSXUNVKQ   YGRESUEX        IHOAWYJAUNY     PUGSUKH        
SULBS           : PCEXWWSMXORT    SDKQYY          FBIEELMKNNGK    WWQM            UWBVGJJAK      
QXAKMQ          : RDPDQEYNSXG     JGCV            YPFWQPJ        
TPMXKP          : PVCII           IPAEPPPHI       LCWNH          
XXOGB           : RWIKVPHKEDMBA   VDXWUA          DIXHCNXMIOJW    JPOABIOT       
MFBJ            : GDCPTKMQW      
TGBXAFQAGCMYWG  : UJBFBMIUBQYLC   IPHTHYGUKUI     ERWDDXPRMF      WPTCICDMLSDD    NUAYNBCXOYCAU  
KHBCS           : KQIUX           FOJRQKFEILLK   
CJIDNUIOGWLPXLP : TOCSAUOUYGJXTT  TLEHCJOMBYTLM  
CPMGFNELC       : JVWNXOLXLMSJSJ  BUMINSHVDVQ     BGECCMFVW       ELOAS           RMFNOAJAUQWDT  
SGSOFWANBO      : CHASRQBLFLPRFE 
JFTISJHEBPH     : ALXODWDEU       CGFVDLIERDCW   
EPYRVK          : XLIDL           KNTUPDNOCIARGO  FQVDJKSK       
MGCHUIFU        : RKBFDR          FERVGTXICYDT    YGRESUEX        PGMOGMIBM       YNDCWDYPDDLTJFJ
GLLRTGBMPKTRA   : JPDVU           TYCIVQNFTRLPIHY HRIXTGBUBTUKRAA EHCHNWUKYBXMDGJ KDDACGWUDNB    
LESKXPWTCDWMXF  : UMYXGCJVICKSNIT FHBFGGN         HADLLUQOWJPMTB  WPTCICDMLSDD   
VFAJ            : STMHIMYOXDVJNP  RXGQNLPQYPRESSO KGOYLUI         GKGSASHWNTUNRH 
TDXWSP          : MVAKLFXD        UDMFMCVI        YTQVK           MWCNYDJOQHPQAH 
MJJPW           : CBEABSLT        BUNEFVXBJJOH    QPYLXYVWW       DQGVOLCHIPX     VBLCMQDASXUN    GLDLXBLAM       MVLM           
KJNA            : CAOXWW          TFGORJNXXX      PPDTLI          LGPTOTQKYRFYRS  JYKYJYSOCD      VQNXLIIQEVQ     VCRTPH         
IFKFR           : ORVNOI         
MLJRNSLHYJF     : TQMWL           HSYS           
COGLBXLQIUFLCPQ : PSTL            ORKYLTXUP       ILPCVTCFUOOFHX  DDFQKJKOFWWN   
UIBJVMBJFN      : WECVQLIYRSR     YRPDGELJY       ANLVTI         
GYACDPK         : SJHWSKGS        AVLEWFIVGCKB    OAHIFO          ORFXMHEN       
SIDJTXQF        : CCAFMSC         IKOXHGSVLEWMJQC
IVQFGTOCGSNNIG  : NEGXRNP         BJDXSWBRTSV     DIQD            ECTJ           
JHYNYKFRUI      : TBIRYXRQST      GXXUSF          QLBJIKX         AATNKEVPYQGIXU  BPTVYASRBEQCJR  AUGSBLOAJ      
OGUVJ           : YLUXFYPIWD      UDBYH           TNHIRE         
RCJAXACESRUBYR  : YRKF            HUJQIR          EVLOXXPOP      
IQBHDGB         : DATHJPUSBKNTCO  OFDXIDNUQCBV   
OEPWBMJHGLSHK   : DXON            PPBSOQG         LFJVLPGKF      
LQOE            : RTNGHT          SSFHUYD         JKEUDMXB        HDENHBWTPL     
RFFDNYGWCMXDDET : LYQQJLMRLWH    
GIMNOA          : LNXD            LOJCIUVC        AWAXVSUUIXKFF   PPDTLI          ROJISCRDECTQW  
XKBM            : SOEAMPIOC       GGIUJMRIYDE     MVLM           
PSRIAXNN        : FXYDHTTCBF      ULASOXOOTIAO    VICIFWA         UDBYH           NNFSVFUQKT     
WMBJ            : KJXGQHIOQYEFYCR VIGABSJP        KTKWIKA        
FPQYSW          : FVLJQDED        DWXNN           LYFKEQW         WYWSLLSUAWIJOY  VLHIFE          OQOSFBLDMY      GXKBPWBURW     
FMXFUYSYLYQGQB  : VAQHWYKPCXBERM  TQTHOUXSFKEV    HEPFEL         
ORVNOI          : IFKFR           JIKDUQ          ICTJETLCTPSHRL  XLTDVPT         KIXUFCHTMRCYQ   YKGBVHAN        BFVHTQ         
AUUPLVI         : SEWQXCSYX       JPODPLBHIN      RNRMCKUEBYUKMRF
FPXDXVCSWPR     : LGGGNXPCLJN     ABCWEPTQDWOUD  
XKREAJAP        : YRRTRAAN        DJCDAQGJBQKYD  
IFADA           : PXKM            NLJTUVJAMRN    
PVDBBTB         : HWLLPPULNDRW    BPYYGE          TVAYNV          VBARGM          BJGTJESDHBO     QRQQXFQDHYRXNU 
TWLOT           : OBJE            GPXMSUERHHOC    BPYYGE          GITDU           JTLMFKKGS      
GKCSCHUNJ       : UPQWQFCK        MVAKLFXD        OGYCYULMU       QXLYNJSXWM      YEEACWVSFHWKTM  VGLIF          
NSQPXTIPRM      : PWECIEBWNQWALHJ GVDQDDY        
VIUF            : VRSTAF          NVIEDBXAFQTKL   NANW            CINDWQPLFBKHNX  HIPQGVNICBKT   
TQSQU           : HMXHE           GNDQYD          XWGTE           REOWIJEN        BSWRYUTLT       HKWITMNKSCNHHVT SJQADHLU       
DATHJPUSBKNTCO  : IQBHDGB         USBMDMUAMWUQKK  SIARJDHQHKGQ    GFLKAQYA       
NEICAEKWJQ      : IQPGDNHFQYCTDCU ADATCW         
CJJAKMAG        : TBWBTMOXEAOKCK  DTMXJ           BUNEFVXBJJOH    NIDQOXHP       
LVQEYDUTGJJTPT  : MQQWWNMSPUXR    GUQKADWKCV      VDXWUA          OMLLLMBWJ       ECTJ            GQKWCK         
PXKM            : WSSC            IFADA           PQUQNGDAGQEKQM 
BGMKROWHODDACWG : SNOQL           UNPJDJLV       
ABWI            : VQICBWLTIAQN    JFTSDQ          NBWXBMOXVIVIDHX
JEDDCSEM        : HUKNLBIUWCJ    
NNOCAIQWPHDTJ   : QPJTLS          NABVPKOKM       KFNW            PMUMMYE        
QQGSRGCFPGIS    : OYOXUCMCG       EUBMPTQU        DYYTQX          WAXQHMGFB       PSRCYBCOSEFVGEL
DWXNN           : RXQBFL          FPQYSW          YNTTBTPYQJATLK  JPOHXEKREDV     GIRRWMTOCIOTG  
EPONHODQRYBWP   : TYCIVQNFTRLPIHY ODMEDVK         QCSHKAKQL       UHSKJJSRSBJORB 
FLLLNSBVDWHHT   : RWIKVPHKEDMBA   HGKMVAXTMB      NHUCVLWG        EVFUF          
UJUAALPJCS      : XKUVVXJ         CWSDNXWBMDUP    MLFYVMEPMWK     LOKTTULO       
TUBSMUBXHOL     : XKUVVXJ         KELJXHLJKRT     MXCGAJTX       
SIGPRPLX        : VOBOJFVL       
VUOXJEHLA       : LSNHLUWWPU      NPCTPRDJE       ISJGMKP         VLUDGVUUPUTPNSM
IULDHGEGPT      : GIODJWYNONC     NOAGVAW         BOYQ            BPPRX           TEKDJLHW        FABSDWHFQR     
SMEYE           : CMKIVVQA        KMDQXWJKPVWHFQG GLVXEGGXXTSGNI  IJUKTUVFKODVCIP WRCWWVLSIJQ     SESMYPHBHVUCMS  HROQ           
OPWBNUQLEWURWF  : SRPGQRUDRTF     QVVXFT          EXNQXMYJSDCXVKJ IKCINRA        
RSECBIIREEMSJNW : OWDPSACKADQM    MTHV           
EPFFDAXR        : ETNJRIRLQLRTLWA YDCUFLIGXIDGIOI UYXGU          
XOWUTYPMD       : HBBVMLXCKXKSV   URAWF           IMDXRGLRUKIC    JAWSAOCYYTOXNCA ANOSFQQIPSE    
QOAKUEWOPK      : MWYDDBJFMFVVYH  SKXCCKRXEDJY    AAAXXCPNASC     XFTGPNMDMMEWFBJ
XODEVJEWBLURKR  : YJIOLMMCLIAYL   ICJRLYUTLDXR   
JHBPYTGB        : SEWQXCSYX       VYJMMVPNABU     QFTCBGUGO       YVJIPYPSPO     
BGBPXNEWEHDBSJA : HCUUYMAL        YKFXSGOA        JMLYUQAHVGM     KKPX           
WUOHOBTWELVYRXD : TTLBYLQVG       BSWRYUTLT       HKYHHAITOCIJX   APHIHGPVQR     
GHNGWRDCBID     : JXPDOOOVSN      NKSDCBJTCIB     GQPAWNXURQ      GEBJFBTRAEAJ    FKIPVMEJWOPCOD 
SFQPAHAQ        : EIKXPGTQK       MOQODV         
TNPHKQBKV       : ABFJQ           SQHACDFIDK     
SFJYDDFFFNIC    : BFDLFUCEHN      TYIBONX         BIDTKLXXSLC     LIIJQJTHPNW     HHRMKRUCKF     
NUYPDYGNU       : UGIGSFARLLUJC   KXDODMTC        GUGMIBDB       
FCJVDTUBMALND   : PFTGF           LMHRMHURQTVPE   LPDOICM         KMPWRTCIGNSW   
SIVH            : QGBHSYAFDRFHV   GNDQYD          KMUSRY          XAJDBYNNVITL    OCJFJLQTKV     
APIVOABPJOKGU   : LHFPMXYBPGQUT   LJGYBSQJ       
PSTL            : COGLBXLQIUFLCPQ UIAUUIVA        TPMLQDFHJGRUIO  BTTPDKFAXGRSJS 
VAOJNRA         : DDLOFVGSBGAWHY 
DWQVWGFU        : RJSPCDRDCFXLF   OQJMFTERQEVFW   JLIWWASCNPAKSSD USUTDIKCJI      HFBBYWYJJSRLMML
FVNQNBWIROD     : BBCDAYQNTWULFU  OCQXQDNYXYD     AGHSB           QKQPQLNSXNA     MEJPDOTKWI      RQCDHVRLRJVR   
ARKCITSAT       : JSPXI           LOOQO           CSVCACVTMU      LSGKUFQEOQRE   
DSQC            : RDPDQEYNSXG     BCDNLEJMMVI     VXBTOSOYK       PDQQODEHJO     
YJNWQ           : LSNHLUWWPU      WNVFJBDXRNK     WTIMW          
LIAOFKGW        : MKEQC           BHHLTMW         TWGAIIDGYWJT   
UYHFCPY         : RKBFDR          AKTEFVIP        RUGPQOL         DVLB            WPDEUN          KSMCWXRMUBHGKSB
SVWV            : OBKKXLUL        EPEJTVGGJWY     UYDICVC         GPUJKJXKGJREF  
PAJOJXMBMA      : RXGQNLPQYPRESSO CGGPBGBJBN     
MQQWWNMSPUXR    : GLVXEGGXXTSGNI  LVQEYDUTGJJTPT  QDWGBCVAUNXO    LDSMLFTHJGKG    DFBCRTHEJIT    
AODXNCO         : BBCDAYQNTWULFU  YQKLNRTUMBWEOIY GFYUOOLQPMDDVQ  WPDEUN         
CYTMYIPLKYABRYY : GWRUFTKRTTL     NMSUDPKEJDFQDP  QJAYVMCUEHIOXL  LHXFAR          VTVEPESAGVDP   
LTXGTRTTIW      : GDPWSVHH        YRJXOFHJPXX    
VBJB            : CCJIUNDNWPBI    LDIKIAPVVRVF    MMUWPAKXGOKXU  
IUSJEKUQLW      : KGCTWRE         AQQWUKR        
DVTLHNJQH       : INXONQFF        SVUUAGHUYXTJOJD POBBXFRWV      
KELJXHLJKRT     : FAWJXKSPKW      TUBSMUBXHOL     QWWS            UYLBDRU         YHIUSE          UHTSMLIQSNY     JDPOSILYRUSGL  
MDMWADIWXLSR    : LJPAEWDKCBJTW   UEVBSTYRCI      XWGTE           LIHOOUSSEBOUG   YHIUSE         
BHLT            : WUVLQVR         HQNEUW          BSWRYUTLT       JXGJTLXHXBDN   
PEXBPXLBIV      : KPME            RABKQSCOSQ      MWRIEBCVGH      QSNOAAWHXKYPW   YRTOEA         
CEHGQEGWO       : HCTIVG          BNJKIUDVO       BBYK            KRFUTIMQMVJ     HQDPDWUYQ      
UDYPDCWQVQICO   : NEGXRNP         FGLVXJOVGM      MGGOJYBJAAPHMU  IPAEPPPHI      
SNXVVVRAB       : UTLKBWYVMTFITP  VDPTCPMQMPU     TSKXUOPUSDX    
ITGRSWXQAW      : CUKEH           YTCAANGJX       ODMEDVK         KOPKIRUHR       VRLULNEBMU     
FAFYVW          : MFDBBKMWDNOKJ   ATJBBDPFX       TFIJEBYSXIQCXA 
YNTTBTPYQJATLK  : DWXNN           GWRUFTKRTTL     YGAI            WBOACHVRROFRIY 
TCJQACTXKYAPA   : QDYGAJSQJRJL    NKSDCBJTCIB     AAAXXCPNASC    
OIYDCSG         : EWNBVNNCRV      NPEYHIEN        QKJKIG          WICK            SNFYHFGVX       XBMC           
LGPUIJGS        : LHTSMO          JPJOLMSCQTYQY   HKYHHAITOCIJX   FCVWAEOG       
AVMRXOLXY       : EOEGTUAMMD     
XRNWIXXNARUYDDO : MOLEXNBNI       EHNTYBEJIUYHJ   UWYGUOSPGQSW    IFAGXFIEXK     
LAHGE           : KWJTJDXAQHHK    FJLATHRHYBGTOX  EYTSURPAMBBN    MANAKMOLYAJKCKC ESOEEUR         RHISKYSIWGC    
EQBDGOBHEC      : LIGVFRDHQT      FANQMQJMQEEWH  
TBIRYXRQST      : JHYNYKFRUI      IIDGYDDE        RLWAYLKUJX     
XKYLNGS         : AWJEOYRT        IVXVDMUGOG      DYGWQBLQF       JPCGSKR         KEJSXEALVWTTBDR LPDOICM         DFFOFBLQ       
PWKTCSIEBOI     : FAPHRJW         MQUCBSJLTMOJLY  NKAESGDSF       WNJDRXJDM       JPCGSKR         LVHTG          
IJMAILUC        : LQSJNR          SOHQNGMAEBTYEHN WNDKTNVQ        RTNGHT          BVMTHMPXOCTGAC 
OAFBYQOFLIX     : SEWQXCSYX       LVPN            GDCPTKMQW       XBFUAAPNKFXYDOM LDSMLFTHJGKG    JADRK           LRGCYPTOI      
TRNM            : CYNR            CJRAKYLOMKWWQNV HFXBGTMICGVIMD 
TPRCSANFBWQV    : CUKEH           JOYLQ           QULO            DKDA            GIDFKP         
XMBFNBX         : JPDVU           SULFFPJFKJFXYA  JLIWWASCNPAKSSD EMOJ            UWBVGJJAK      
IKNIXHALWD      : KPLEKMMHD       VMMCVKPWTTN     IAFHJVBUK      
MWMFWBNAAGVBGK  : CMKIVVQA        SULFFPJFKJFXYA  VHQPCEWBLVOPJCP PIKJMIBEKM     
LYFKEQW         : FPQYSW          YUWCBGOJ       
YUCAIBFQNCGVBH  : CUPIHC          YOEFMHNN        GLBPXL         
CJRAKYLOMKWWQNV : TIFOPUBRNAV     TRNM            FNGQJNBMCVWWNVV FWBCKKBCUJSVRVS OEPDR           VYRAEXCPEGIJSY 
MQOOAPVSGAYE    : LUVJILCTEM      IPHTHYGUKUI     QCSHKAKQL      
IPERHECIRTVCQ   : WXVX            NPCTPRDJE       SRPGQRUDRTF     VDPTCPMQMPU     JGKFMYBC        YKFVFQWUVGNSOPG
UERISKWKKNGGVHF : NWTXXWAB        AATNKEVPYQGIXU  UMCABN          VLUDGVUUPUTPNSM
LOPP            : TOCSAUOUYGJXTT  EUBMPTQU        HHSYQKOORUEDDI  RESJERDHQCCMYHR UJFCIFDLLDVE   
YVLIOHGSXDQE    : PBPLPXGVI       NBPTYVWL        NXJITYQK       
YYIVJ           : UCCUMA          QILFYDMF       
LSBHCHH         : SLVBEJNUCOKUSF  EUHUDIRQTLCD    WTIMW           VAQHWYKPCXBERM  GLGKR          
XYFGYDTHR       : KEVVJMUBJ       NSCJBJXSGALVCJ  ORKYLTXUP       DVHMNMOXVXPB   
PNBS            : WFITN           XFTGSPDHYMUTD  
FQFFYBQTPJVW    : MWCNYDJOQHPQAH  WGIXFHCNMWAFP  
FHBFGGN         : AKJKBCFOVUDIVYE QNJPGHS         USUMYVFTJU      LESKXPWTCDWMXF 
KIOELETNXAS     : CAOXWW          RSAPANAXCBNYLRC GKBJNYN         LMMWBL         
FAPHRJW         : PWKTCSIEBOI     WGMBGSUFVYDMQ   XFTGSPDHYMUTD  
HVPO            : QSNHLTEJOLCNK   NRTWG           ENWPFEUXOXB    
QVKXKPKUHQGLNT  : KMDQXWJKPVWHFQG BBYK           
NPCTPRDJE       : PFIFJWBDVBQDNVU VUOXJEHLA       IPERHECIRTVCQ   EIMDGDPFVOLOHVC KGXTM           IPAEPPPHI       KGYJG           NRPKW          
LNXD            : GIMNOA          JWVOKGXIOBQXS   USUTDIKCJI      HDENHBWTPL      XPYSPSGPRFDV    XROQP           VXNJSYOBBDBKC  
ETBO            : EHNTYBEJIUYHJ   TFGORJNXXX      MNGXSWILOEXLQQV GVDQDDY        
LGGGNXPCLJN     : LCQAJWVEA       IGMJEUWLSUBNMX  FPXDXVCSWPR     DFFOFBLQ       
BSUTKADQCQ      : TIKHB           SDFVEWBSPIVDG   FANKCQJALHJ     HEMHFGQQNCEYD   BHMY            QNUCSPCA       
DTMHOPXKCER     : CKBFR           CMXYSRBWLAUQ    PSVBJHJNDGMH    FWBCKKBCUJSVRVS ORFXMHEN        XYKMMPRS       
URAWF           : XOWUTYPMD       RECNAYI         SYYCJUAHAVXUQLP
KGPDEJQ         : QFFB            LOJBTKC         DFFOFBLQ       
NJHGSMBHTRX     : ULRKR           QNHU            TQMWL           LGLELQHY        OKAODVSCNYFUE   DXHTBVNJT       RWMYSMYDP       VDEXEGRDGSNVW  
NJHGSMBHTRX     : SORPJQPITCKTWO 
CCAVOU          : SBMBWKQGVKGDEDK XLIDL           IHXFFNGMIJUOL   YKGBVHAN       
RRUEFCVKGGDM    : XUICLMBXUPTLDU  PMJDDF          YYBHIGDMNHH     ALCQXQLFX       QSWKWNGLAY      ULCHGRT        
PVCII           : XKUVVXJ         TPMXKP          KGCMWCRJUFF     DIXHCNXMIOJW    VSXHEKKBBAISP   WYSEYCYC        SJWSNNIJBL     
SEWQXCSYX       : AUUPLVI         JHBPYTGB        OAFBYQOFLIX    
VOBOJFVL        : STMHIMYOXDVJNP  SIGPRPLX        NEGXRNP         HIRVGLDSMMA     IHOAWYJAUNY    
ITMMJI          : QSNHLTEJOLCNK   IEXHSOEPK      
FMOOUHURX       : OTNSEXLNS       CXCWRAKURCHHQL 
TSUUDQJ         : UUCQMSUQXRS     BQHWJHEKUD      VEOGNWVQW      
HSMFHQODFD      : TFLXHF         
NHUCVLWG        : FLLLNSBVDWHHT   USBMDMUAMWUQKK  AAAQEVW        
RECNAYI         : SCDERYWSIEEYGY  URAWF           ANUEDCA         KWJFC           VHVCP           VLNDAYJWWAWVO  
QTJAPXG         : YXRQPNXD        BVSURQUJYKQTV   GQGLRNNRLPVSAXH OUDPNIDIN      
QUCVAR          : RCMIWPVR        UTKUI          
HMQFXPLGHSJXUII : HMXHE           UKAOCDTCJOES    RCMIWPVR        AXTNNWBASQ      XMDTMATIMTXJM  
BDLCSMIRDFTCH   : LHTSMO          CHASRQBLFLPRFE  FIYKAWQL        COSLR           KSPQ           
NOAGVAW         : IULDHGEGPT      BGJPFIUTTIKA    BUDXFMQRGQHCL   QOXVWLBXYXDPR   UNUQDRN        
HGDQEA          : UARWWWIGGT      WGIXFHCNMWAFP   BMPOBYJTC      
NADQNFLAPDEW    : GEILWK          XCGLVFNCQXAP    KIBDSMQKN       EUWUVWP         UJOASHBXDA     
IENV            : OJIHICBF        GXGLHBL         GHLEMKPQ       
PFQQC           : PJUYJRELCWQHXJ  DROURHSIDN      UQGPCC          ETMHDTOPDQBC    VTVEPESAGVDP   
XIGQNIRBIUTYA   : NVIEDBXAFQTKL   LOOQO          
YRKF            : RCJAXACESRUBYR  BFDLFUCEHN      RESJERDHQCCMYHR TXMBD          
LNSYMPPRHI      : OLAPGLCHIJRV    DYXHM           JOYLQ           LEVA           
KGCTWRE         : HMYNVOFHD       IUSJEKUQLW      XWGTE          
UNMQMM          : UPQWQFCK        MVJLMFSV       
NFKTVWHRXVHNNQX : QYFD            STMHIMYOXDVJNP  NLNAXOVMMX      NKSDCBJTCIB     PSASSEUMMLMUS   DOQUCQBT        HPVFR          
EEOADGEUE       : RXUNXKQCDHJCL   KJXGQHIOQYEFYCR KYETSJUPGMBF    ONALIGUUIEGIVO  MDXWSPODEMCBHLR UJFCIFDLLDVE    YVUOF           VOSGEHI        
HUGVVWDG        : KJKBM          
ADATCW          : RWIKVPHKEDMBA   CGXB            NEICAEKWJQ      OCTEKUFWLDIEMB  XJXLRBQM        IFAGXFIEXK      PXWWRLT         MFYLQMRKQDISDB 
ADATCW          : GFQTBLQIBWB    
RMSQWYWLYDT     : THYBCDWNBA      HCWT           
XAXHVGFTD       : UHSQ            FXKGACPMY       SQXQKUDPYY     
AVLEWFIVGCKB    : GYACDPK         UMCABN          ELOAS           RWMYSMYDP      
HASUBVRHV       : BBJFEWMY        RABKQSCOSQ      IJGPDABU        NRPKW          
FFPNKJTTMPF     : CEKNCGTY        OHODGOWJVIAH   
OMBMTFX         : AQKYTPDDEDOOXQ  FIVJMFEANOWWCOR DBDFEX         
YHATDDPWKN      : DUBGLAFMMMDJWXP OGVFEGQG        PIPBMACTAHLVA   VQNXLIIQEVQ     BMPOBYJTC      
RSJGDSCAHRHAJ   : SLVBEJNUCOKUSF  XUICLMBXUPTLDU  WUMY           
DVQJVP          : QLBJIKX         HXJLETE        
EPEJTVGGJWY     : EUBMPTQU        SVWV            OBDMBAGC       
GFJCJLLBTMMQPLH : LCQAJWVEA       OMLLLMBWJ       RAENAWSVHFM     ARXXNSNXOICS    KNDXQIJ        
HWLLPPULNDRW    : IOHJMROUJTWIN   PVDBBTB         KXRTBJXMYUPBY   JNMAFV          UQDHM          
QDLXNPHBCLUQX   : IVXVDMUGOG      NRPKW          
IJUKTUVFKODVCIP : SOHQNGMAEBTYEHN KQIUX           SMEYE           BWYUVWDCDNA     HDENHBWTPL      SVALA          
LHFA            : TIFOPUBRNAV     OAYAKMWI       
UPPWTBTKYITLFE  : AQQWUKR         LUSQV          
AAMMQRKTD       : IJCRSNMPGWMHIGN RSAPANAXCBNYLRC YGRESUEX       
VOIDQP          : TOCSAUOUYGJXTT  SQHTJDWN       
HFXBGTMICGVIMD  : TRNM            NSEJBQMUEMY     ISVU            NXJITYQK        JADRK           UKKUNJXRIGOBICT
ORXGMICPJXGTDAK : DEKU            CXCWRAKURCHHQL 
HRCKBYY         : UMTCIFVVETEU    SEBOVWXCL       EMOJ            YHRDYAVY       
BHHLTMW         : LIAOFKGW        BBJFEWMY        UCOESDEXMTFSV   WWQM            OAYRYUAUV      
GWRUFTKRTTL     : IORUH           CYTMYIPLKYABRYY YNTTBTPYQJATLK  VYRAEXCPEGIJSY 
TXEDQINRHN      : QJQMMPGRYWASGH  KJSXUNKWUSHU    VGRKU           XFRRIPJHTQIRR   MRJANNPL       
LWMWR           : VVNJOD         
VDHUWFD         : KABO            OQJMFTERQEVFW   DDFQKJKOFWWN   
PUML            : VPTANYRLYRBM    PECOAKJHEO      TXSDQQXO        GFQTBLQIBWB    
LHFPMXYBPGQUT   : OBJE            APIVOABPJOKGU   QAEKSLV        
JTHKPMTNJYQC    : PBPLPXGVI       HBVSBNNUBBCLNB  CMPFHIOIHIN     USBMDMUAMWUQKK 
LOFTBN          : JRTHQQAP        IAMEJHNRKB      ULSDYBFXFCG    
SAYRDQBVLUM     : FTVXGPAOV       DNPV            RWMCRPM        
OVHH            : LSNHLUWWPU      NSCJBJXSGALVCJ  CCJIUNDNWPBI   
CWSDNXWBMDUP    : UJUAALPJCS      MTUWKYWHOTLL    RHYUFAEIIRJT   
YLUXFYPIWD      : OGUVJ           OGYCYULMU       CGGPBGBJBN      KNAEGFCFBCIFP   XNETHHUUPBNT   
LBWIIGR         : UGJLRTDKFH      KLMPXINJ        LCXPKBYNR       MMGLVFNH        WSRHHTM         QILFYDMF       
DMSQMPTCS       : LVUWOHSUHA      GTBQMLRVD       VENKUQKQRIEM   
RLQFHOLIGTHK    : PLAJM           GLXXY           TYCIVQNFTRLPIHY PXWWRLT         DHCQG          
TLACVG          : VNAVFDIRBUV     GIAMBDV        
JKKCDXRXANP     : YWYQXCJIUED     JYQHGIPLNXNLIR  WISCEIBRGRFP    TKSYFQSVFHUJYQ 
YGAI            : YNTTBTPYQJATLK  SVIELNXGPVYMOP  MVRLFVF         BQHWJHEKUD      BXJVPM          VRLULNEBMU     
NSEJBQMUEMY     : HFXBGTMICGVIMD  FKMRUYY         AVEKPQQIOVYUSJP SUPIX          
SULFFPJFKJFXYA  : XMBFNBX         MWMFWBNAAGVBGK  NJGETWVETQ      RTHESRXFFIAH    YRTOEA         
HCKERDKBE       : VXUDUL          UQJFRGKRKUACEVT
NBHCAIVWVBDMMIW : NMLWIMMUWB      DPOKCVCOY      
QWWS            : KELJXHLJKRT     BOYQ            GFMSGEVHSXTKX  
EUILMMXPSCGWJIW : TNNE            CMMLVPQGJQEY    TIHA            IFDYLWIMW      
GUQKADWKCV      : LVQEYDUTGJJTPT  TSKXUOPUSDX     GWFVVOYCIJWJ    SWMYLSPOMUG    
YSTWAQGNF       : IVXVDMUGOG      SJPC            WRPW           
LVPN            : OAFBYQOFLIX     NPMLLXNYKQWHGQU NMLWIMMUWB      TASBJNBMXU      IDHBIMBUIGOGF  
MAMKTTHKGJPDT   : ULRKR           PBYCKU         
BVSURQUJYKQTV   : QTJAPXG         LXLSEGUN        AWAHUFRVYKHM    RTXUBYLLSYGGYEC DDVTLJILSQFQCLN NOMUJXN        
JMQYOGLI        : PBPLPXGVI       FOINN          
SVIELNXGPVYMOP  : YGAI            YERYTPFXTFV     JYDQFADHNO      DNUI            LVNAEGUG        EGTAQRH         FGLQTLU        
AQTQKRGWE       : JBVHJL          GEUTJSY         SBKMUGREW       MNCFRETSYRKITV 
VSHJEJEA        : FHRMYQ         
INIGTAFTMVLVVD  : YPHIBJWYJJCXX   KQMJJIQTOAAMTUH YUWCBGOJ        NCNSALFRMYWSAGU UUFHAVJQMOXXJO  MHVNIJSBFFRBJ   NBFX           
OPJWOOYMJGV     : NBESQGVE        QJQBHHY         LDBCSFTRXNEERO  MAESTSMSNFWIOF 
SARMI           : MMLCXROFYYO     RIQPJSF         CRVDWACXTMV     VAQHWYKPCXBERM  CCAFMSC        
WRCWWVLSIJQ     : SMEYE           WYSWUINXJ      
BFDLFUCEHN      : SFJYDDFFFNIC    YRKF            LQVWREOSVQUJ   
EGDEXSPEPHJPE   : LYNESPRKSVPVRG  MBEAC           SLGDBGIKR       LRGCYPTOI      
DYPNPFQWJECEIGN : FFXXOFERD       KNTUPDNOCIARGO  RNGEO          
RRFWYDPQKIXT    : PTTRVBRHEN      CUPIHC          HCUUYMAL        NPEYHIEN        NIFPCVO         WHRKJWEOQYPKJ  
EBBDTQUYKRKOUQA : EVEIUMHDJICLV   EXNQXMYJSDCXVKJ TEKDJLHW        GHVRCYARYXY     XBMC            PUGSUKH        
FYWY            : IEXHSOEPK       DYPHOTDDHRLXUF  KUMXMSNFVNW     NHSJQMEIE      
UXJMOTUOPUSRYX  : TQXLHC          VMKBCDGVDVNQ    NDVBMPCT       
RSKCNV          : QSNHLTEJOLCNK   IWBODFF         XAYTAGP         BSWRYUTLT       NPQJ            NBHENOCRMGBHLQ 
IMVNTULT        : DROURHSIDN      SIXASTGXOBREWB  XXSKVEJCCUPR   
GTKU            : LSMRQPKSKYT     BAOTRKEFAP      VMMCVKPWTTN     NRPKW          
FQAWNVOOVAH     : YXRQPNXD        IMWA            WRRCLPFIRKHLYF 
NLFJFPXBDSXOOYW : MQUCBSJLTMOJLY  WNVFJBDXRNK     YCNWWSUPQQPU    TKYY            OHLJLCBJRK     
MSTTLU          : UGKLDORGPARAW   SLVBEJNUCOKUSF  XOMMECURYMBVUMW FTVXGPAOV       DYGWQBLQF      
YQGOMIXEVJ      : QJRJOWXSP       LDRFGFICRUOA    OPTUKVXOY       VCRTPH          HTSWIJ         
HPBISFD         : ANUEDCA         GKBJNYN         OARDIWJV        PVISNMBKKSNLTFV QNUCSPCA        APHIHGPVQR     
VRSTAF          : PLGFFW          VIUF            UUJTTFKTTNTMSW  OEPDR           WJRCXKFAOPBF    KGKES          
UYXRQYKYPW      : JUTINEDMXMWOEJA DVUNVXTDNUW    
NEGXRNP         : IVQFGTOCGSNNIG  UDYPDCWQVQICO   VOBOJFVL        HREGSUDSWVPNER  FBIEELMKNNGK    DOBJKTMRPSTFB  
VKBBEWS         : RXHSVEH         JYQHGIPLNXNLIR  OQUOFBY         KJXGQHIOQYEFYCR COMUSGSKE      
STHFQHFIAHSYY   : XTBVGKLM        QRQQXFQDHYRXNU 
INXONQFF        : DVTLHNJQH       YVNLYO          YTBRKOD         BYUSYANTONUQ   
DPNFW           : FEPUOUGTAYW     UHTSMLIQSNY     FVYMQLJVNG     
XWGTE           : TQSQU           MDMWADIWXLSR    KGCTWRE         EARCHYXSAOML   
KNTUPDNOCIARGO  : EPYRVK          DYPNPFQWJECEIGN BHNCIPHKOYXKVVV PFSCRQRCC       IGHFIQDNIB     
WVMJAFWF        : QJRJOWXSP       IMDXRGLRUKIC    SQHACDFIDK     
KFBQCF          : UJFCIFDLLDVE    NRPKW          
MVAKLFXD        : TDXWSP          GKCSCHUNJ       PVLNK          
GDCPTKMQW       : MFBJ            OAFBYQOFLIX     RCMIWPVR        MLCCBSPFDDWLC  
SCVXE           : XGHTAQBBOLYQJ  
FFYHNGWJG       : QSNHLTEJOLCNK   MTUWKYWHOTLL    POBBXFRWV       AXJXK          
WMHA            : KBCSPDHPTKMWQH  NVIEDBXAFQTKL   LJNAJU          NHNCJEO        
QDYGAJSQJRJL    : TCJQACTXKYAPA   OAHIFO          QKAJQTX         DLKAPULCXQFAE  
JSYQXYYNFVYNFW  : TBWBTMOXEAOKCK  IXUIWQLKFXOQO   YUFQIHYJYT      DAHTFVDCJ       DRJBTWV        
MWYDDBJFMFVVYH  : KFJF            KABO            QOAKUEWOPK      REQRXQ         
PSBRJBQ         : FOJRQKFEILLK   
RXGQNLPQYPRESSO : VFAJ            PAJOJXMBMA      WQXDSB          UDBYH           KSPQ           
GTVEU           : EGXRELFGPNRLKRK KCMFLOMXDVAYIMQ
ONXPFHT         : BJFJNBSHM       JQAPMBGSM       PDQQODEHJO     
SLVBEJNUCOKUSF  : LSBHCHH         RSJGDSCAHRHAJ   MSTTLU          EKWUU           OAYRXVETOIDET   NXBPCHKKQYMMO   TJDEBBIMGF     
JFVFBDBIROGK    : YPJWHAM         DOQUCQBT        LTJINUBH        DYYTQX          YMJBKH          HQDPDWUYQ      
PERIRPKVYAQCQ   : PLGFFW          SWEHIHBQPBAIMF  QVVXFT         
YJIOTN          : DKKRXJHOPQHTSO  LQUKMYLOXP      QXYJDCKMUP     
BQQCYISHUMXY    : RWOB            OXLPQH          UVDYVVGSAUMHR   HHRMKRUCKF     
ISVU            : FXYDHTTCBF      HFXBGTMICGVIMD  XOMMECURYMBVUMW HKIGKOIJVPKDPU  DVUNVXTDNUW    
XUICLMBXUPTLDU  : RRUEFCVKGGDM    RSJGDSCAHRHAJ   IXMMXJFWPWFXW   KMEQROPGXIMU   
TAEFSLAILCOU    : GLNXJYWMXUETU   QJQMMPGRYWASGH  OSHO           
NPMLLXNYKQWHGQU : LVPN            KFSGR           OUDPNIDIN       JMFSYDKR        ABAVIY          HDENHBWTPL     
OXGOENHPORESJYN : KCMFLOMXDVAYIMQ ICFNJRYEBMXOTWC UMXMREPTHHV    
QDKEBAENQ       : LYWFKK         
WYWSLLSUAWIJOY  : FPQYSW          IIDGYDDE        TGHHQCKSIE     
URNTIMLL        : WCMN            BUMINSHVDVQ     QKJKIG         
POYVERA         : YJIOLMMCLIAYL   HGYIFYUKBXXNRD  XMNKJKRQ       
QWVFKQAKP       : MUYWOM          CHVRHHORWEKIXP  IPHTHYGUKUI     JAWSAOCYYTOXNCA NEFYJLA         BVMTHMPXOCTGAC  OUQJGVCV       
VHIA            : AALJ            GKBJNYN         IDHBIMBUIGOGF  
CNWKAKX         : YONYTGUHTCQQAOR MVRLFVF         BTVLLXUQKKFDTX 
CMXYSRBWLAUQ    : DTMHOPXKCER     PYEUVXUL       
MQUCBSJLTMOJLY  : PWKTCSIEBOI     NLFJFPXBDSXOOYW KYETSJUPGMBF    VMMCVKPWTTN    
XXLAMMBIGC      : IMASWWXSNWBCXUM KCMFLOMXDVAYIMQ LDBCSFTRXNEERO 
RCAIMMBJRFDB    : KINMTTQCWHDB    CTNQITQWMJ      MLDURDGLU       TGKWXBHPTMOQMV  IHYMBTI        
YPHIBJWYJJCXX   : MKEQC           INIGTAFTMVLVVD  JMLDSTVHPLSPP   WEJDV           WKEBGLFBQELSD   CYULNWPVITH    
GEILWK          : NADQNFLAPDEW    ODTMOE          RTOAYCGSHVRUJ   GKKOJ          
HADLLUQOWJPMTB  : LESKXPWTCDWMXF  UWBTOHRCS       IIEJ           
DXROJTMHXTOIH   : PQWPB          
SVUUAGHUYXTJOJD : DVTLHNJQH       RGNXFOFRYJRDC  
CIPTWAO         : CBGTNKUAPS      FOINN           WGFTOMMDM      
JOFXWNLRLHPNP   : VTAEGVYTNV      JMJDPFH         FLDAQVEWOECHEYL YHRDYAVY        NWXKKSPMTXMAAU 
LPWFBNQE        : GNWOWY          WPDEUN          OIOAFHUAGFGNEA  TMPMLIIPQOEKNWC
SOVNL           : CMPFHIOIHIN    
EUHUDIRQTLCD    : LSBHCHH         GQPAWNXURQ     
SVAEL           : AKJKBCFOVUDIVYE NXJITYQK        FTIP            UXGJHUTQSY      INBLXAJLIRGWAV 
JMLDSTVHPLSPP   : YPHIBJWYJJCXX   KIBDSMQKN       FQVDJKSK        EFERGCXYH      
WKSFEL          : WECVQLIYRSR     IASMCKOL        XEVJLTLQCJYPF  
SQHTJDWN        : YJIOLMMCLIAYL   VOIDQP          JOTLV           NQHFYYNOOG      XLUIE           UVDYVVGSAUMHR   FBIEELMKNNGK   
UYDICVC         : SVWV            YVNLYO          SXNVP          
DTMXJ           : CJJAKMAG        CYOSIHEAGCUXQV  NWISF          
QJRJOWXSP       : YQGOMIXEVJ      WVMJAFWF        KFTLV           KYETSJUPGMBF   
BLXEINVF        : EFXUWLUBMNDRC   PECOAKJHEO      JWVOKGXIOBQXS   TXSDQQXO        UWJXPJWI        IGHFIQDNIB     
YQRVSUBP        : ERCNLIAGALGCWT  WTIMW           GTBQMLRVD       JBVVI           UHSKJJSRSBJORB 
CYOSIHEAGCUXQV  : DTMXJ           DJJNKXPTFYFXVRV
QDWGBCVAUNXO    : MQQWWNMSPUXR    AXJXK          
CGREHHWQQB      : TQHUXUAXVMPN    XRIKSE          YFGBII          MTUWKYWHOTLL    CCBIKW         
YEPWWOKORHUSKQ  : GPXMSUERHHOC    IWGXUFYTBOQ     SQAUDIBLIWCPT   SOCUHOJPINAMBN 
FGTVQXELCMU     : OAMGLMN         QNJPGHS         FXKGACPMY       AVEKPQQIOVYUSJP
FLCXM           : LXWSBYTEGOGTJE  HHSYQKOORUEDDI  MEQAOOCG       
NJGETWVETQ      : HLEMSPVH        SULFFPJFKJFXYA  VOXWPIMVHRCNKK 
NOXVIWNIBBKNVLS : BGTERONYXJ      YKFXSGOA        LPHSMIEFMEGSWSD KWBATPQI       
PSVBJHJNDGMH    : DTMHOPXKCER     YJFYCUPF        UBIISVLLKWTEED  CRVDWACXTMV     DJCDAQGJBQKYD   LBFUWUFCMDTNCB 
DXRR            : VQPVBEVEAKLC    SQDVKKUFJWWHERV BTVLLXUQKKFDTX  IIEJ            PGMOGMIBM      
OCTEKUFWLDIEMB  : ADATCW          QCSHKAKQL      
ICJRLYUTLDXR    : DDVLANBST       TGJVYNUO        XODEVJEWBLURKR  RPBDSKQUSJEFADE VVNJOD          PQWPB          
QJAHOVNBTS      : TOCSAUOUYGJXTT  TNNE            VXUDUL          GQGYABBEXK      KEPOXBGOP      
FXJLK           : AWJEOYRT        MNHDUKJVG      
LUOWMCWH        : UWBTOHRCS       POBBXFRWV       IGFW           
IMWA            : FQAWNVOOVAH     WNDKTNVQ        VVWQSOATPSYHBNH NNHTAIRURMQG    YACDAIBBBDY    
NMSUDPKEJDFQDP  : WYHSNHTJCYF     CYTMYIPLKYABRYY FAYTLNJBRRVFIOS BTKFFVFXRW     
NCQKT           : JIKDUQ          MHLFW           PJUVVQVCMTBK   
WVMG            : OKGY            GWCEE           BRWOJAJPMMY     YEBDQTLTFUHHI  
XTRXKH          : UXEONFUWJG      QOKYU           YEEACWVSFHWKTM  ULCHGRT         FABSDWHFQR     
FEPUOUGTAYW     : TANBWKDGOFCYRXC DPNFW           DCJA            VIGABSJP        VXMFJCA        
EKWUU           : SLVBEJNUCOKUSF  PMJDDF          OFJEFOR         IMDXRGLRUKIC    YACDAIBBBDY    
KTOAA           : AQNTDDSVMIKPU   WWQM           
XTBVGKLM        : STHFQHFIAHSYY   DGPOOPE         CNDJSX          AWAXVSUUIXKFF   KEQVFNFTIS      DNUI            DOBJKTMRPSTFB  
BJDXSWBRTSV     : LYWFKK          WCJEASIMT       IVQFGTOCGSNNIG  MVUGF           SNQOPILMHVUNRC  WPTCICDMLSDD    GANVLRGAJNWHR  
PSBIGWXGXHETL   : XNKJJ           CGFVDLIERDCW   
BVNP            : MHLFW          
RBQPVOQOIMMPE   : NHNVCXT         AAAQEVW        
SNOQL           : BGMKROWHODDACWG CETIUBJOTG      BDRSTILRSEKPEJ  UMCABN          RGNXFOFRYJRDC   KJKBM          
QUDKIFNHVFUPJL  : WSSC            SNHOIOVOLK      TSKXUOPUSDX    
FAYTLNJBRRVFIOS : NMSUDPKEJDFQDP  EARCHYXSAOML    CHISV           LFJVLPGKF       CJYUTNUS       
FOISYPIGNQDDAPL : VTGO            AALJ            VGWUCWCGINJLNRG JBYUQAEC        XAYTAGP         EMOJ            YVNIHSLINLQGNRI
RMCDALGRFFAP    : YLNHO           UJTNYUGNLNGYU   SBCECHAUNWWQ    EHCHNWUKYBXMDGJ
SUCJFW          : WNVFJBDXRNK     EGXRELFGPNRLKRK HOBRJAUXN       OQOSFBLDMY      DVUNVXTDNUW    
UFRLVVO         : CMPFHIOIHIN     TQTHOUXSFKEV   
NCEFOGL         : XKUVVXJ         HBQQSEQ         SQXQKUDPYY      SAAHKAECCG     
TTLBYLQVG       : WUOHOBTWELVYRXD SESPJKLJOX      YEBRSNW         RGAUR          
XSSUEPCVBBTSYHU : CBGTNKUAPS      DEGHMUBHWM      SGPQUQVEAUPTJV 
PMJDDF          : CUKEH           RRUEFCVKGGDM    EKWUU           RABKQSCOSQ      GXXUSF          OTWSQCRJHWU    
OGYCYULMU       : SBMBWKQGVKGDEDK GKCSCHUNJ       YLUXFYPIWD      OQNQL           FGLVXJOVGM      KDDACGWUDNB    
HRIXTGBUBTUKRAA : QJYUM           BLSLFBOHI       GLLRTGBMPKTRA   CAOXWW          DOGKUWMVTU      AJBQAQXDBVVBAT 
MDJR            : CYNR            VUISRA          AUTDNPETBNQUF   EEXSXFJJ        GCMCJLHP        RGFC           
BBCDAYQNTWULFU  : FVNQNBWIROD     AODXNCO         BSSHQDL         PSKPUXLJNGCJ   
OWDPSACKADQM    : SYFQX           CIFX            RSECBIIREEMSJNW UHTODDJDN       VMMCVKPWTTN    
BHNCIPHKOYXKVVV : KNTUPDNOCIARGO  MCTOXUJGAWUD   
SESPJKLJOX      : TTLBYLQVG       FOTRBHVOIAC     GTBQMLRVD      
RPBDSKQUSJEFADE : ICJRLYUTLDXR    EHNTYBEJIUYHJ   XAJDBYNNVITL   
CCJIUNDNWPBI    : VBJB            OVHH            FTVXGPAOV       WUMY            FFAMQYTAB      
YWYQXCJIUED     : JKKCDXRXANP     BIDTKLXXSLC     DPOKCVCOY       LVHTG          
LIHOOUSSEBOUG   : MDMWADIWXLSR    AWAXVSUUIXKFF   VAQHWYKPCXBERM  MWJOLOJAE      
TVFDBECAVAC     : VDXWUA          BTDQCOHTBPMVYE  TXSDQQXO        PRAQAWGWSGTC    XBPEULE        
KYMNGAXNO       : YYBHIGDMNHH     QJAYVMCUEHIOXL 
KKGONWLU        : UFBEFXYRTHFU    IQPGDNHFQYCTDCU RRGEOFQLYQTPXKV GDPWSVHH        JWKQRDBUOLYSNOB
GQGLRNNRLPVSAXH : POSHJLS         QTJAPXG         UUJTTFKTTNTMSW  BDRSTILRSEKPEJ  OIIXXNMKPPWO   
EHNTYBEJIUYHJ   : XRNWIXXNARUYDDO ETBO            RPBDSKQUSJEFADE XAWKRR          QKAJQTX         MSAVFOXVMDAUJDT
JPLRDFHQASGXOIV : HYEGCFF         IHYMBTI         SJWSNNIJBL     
XCGLVFNCQXAP    : NADQNFLAPDEW    OJIHICBF        RXPAHMR         ROJISCRDECTQW   JTLMFKKGS      
JMQBXLEFSWFOFE  : HEUOJTOABVSETNS LGLELQHY        WRRCLPFIRKHLYF  RTHESRXFFIAH    GLYOXN         
NCDLFJYBOOGHOIA : GDPWSVHH        KPME            CMMLVPQGJQEY    TWOKDHDA        YCUBOS         
RMPSKBYRWV      : XBFUAAPNKFXYDOM VMBJCNFWUHSWURB
NBESQGVE        : RAGPFOGYWQWV    OPJWOOYMJGV     DGPOOPE         FOTRBHVOIAC     HTRQEECU        DRJBTWV        
GDPWSVHH        : LTXGTRTTIW      KKGONWLU        NCDLFJYBOOGHOIA
HEXTUSG         : PLAJM           ULRKR           SEEHBCGWNOA     JMJDPFH        
RXUNXKQCDHJCL   : WWGRJFPSHCOS    YHJMDVAKENHFR   EEOADGEUE       IVHWJQIKTCQKHF  BIECAUTWNNQW   
KQMJJIQTOAAMTUH : INIGTAFTMVLVVD  DUBGLAFMMMDJWXP XBJNJ           DSIBTAHHHUPTL   HROQ            HSYS            QNUCSPCA       
VYBSOYEHEJ      : GKSDYCUEFSN     MWRIEBCVGH      COSLR           AUGSBLOAJ      
NNCKXTAKFIBY    : WQQPVLQJOTBMQPH DXON            GITDU           XBJPYQM        
CAOXWW          : RALXKK          KJNA            KIOELETNXAS     HRIXTGBUBTUKRAA SAFEOOMAODK    
UXEONFUWJG      : XTRXKH          BUMINSHVDVQ     BJEF           
YUQMUMMFU       : SQXQKUDPYY      KKPX           
JVWNXOLXLMSJSJ  : CPMGFNELC       OJDTNGEKKMLJ    PDLQCYIJNNBLWFA
YEWI            : RYEWEDJUOKUR    LDBCSFTRXNEERO  SEBOVWXCL       FVYMQLJVNG     
LIIEWDTJLOGUKG  : VPTANYRLYRBM    HOADTMH         HBBVMLXCKXKSV   PFIFJWBDVBQDNVU DVXFNEOVNHWX    DXHTBVNJT      
LUVJILCTEM      : MQOOAPVSGAYE    TVQUOTLTMR      EEBRDOV         KHJAXYWEIFRMSS  QBXEPE         
DSSOEGW         : GLNXJYWMXUETU   AIPUUPOJMH      ICJDI           BMPOBYJTC      
MVUGF           : BJDXSWBRTSV     QGWKKBKINTUMIG  MJILWNKEJDJ    
WNDKTNVQ        : IJMAILUC        IMWA            MPGSKDPFOCH     EXIWUTUCYCV    
FBUJVCVRFRMTX   : FNEXXPROUEVB    XOMMECURYMBVUMW DQGVOLCHIPX     UNPJDJLV       
SNHOIOVOLK      : PFTGF           QUDKIFNHVFUPJL  JKEUDMXB       
XGHTAQBBOLYQJ   : MQKTUBJNSKPWWPK SCVXE           USUTDIKCJI      WHRKJWEOQYPKJ   RNRMCKUEBYUKMRF JPOABIOT       
XBFUAAPNKFXYDOM : OAFBYQOFLIX     RMPSKBYRWV      OMWPYGQPJ       JSISCEVJJOMVY   QEBPCHWURDBXPII UXGJHUTQSY      SNDOXKQBDBRNHO  LVNAEGUG       
INWPHWIJAWW     : QKYAYMOUWUJLMGI UWFCAMF         WJMXNFL        
PGSQIBLKDBAN    : OOYOUUOSUQJW    RDPDQEYNSXG     RIDDGQI         PDQQODEHJO     
XOMMECURYMBVUMW : MSTTLU          ISVU            FBUJVCVRFRMTX   OJDTNGEKKMLJ    HOBRJAUXN       MHVNIJSBFFRBJ  
JWKQRDBUOLYSNOB : KKGONWLU        DPKOXUHEULYBQ   HUKNLBIUWCJ     KTKWIKA        
GPXMSUERHHOC    : TWLOT           YEPWWOKORHUSKQ  HCWT           
NYEMMWGPXCFLDAY : QCWBFK          IJADHTAXNNS     HQNEUW         
DMATK           : UYWCMS          FQLNEQMWHXCKLJX
MHSGODUT        : MHVNIJSBFFRBJ  
KSEWFCEVCGD     : PBPLPXGVI       OHODGOWJVIAH    SRHWEJLUV       USQFAJVSIGPY    NRPKW          
LDRFGFICRUOA    : YQGOMIXEVJ      YPJWHAM         BQHWJHEKUD      YKFXSGOA       
XQVSKTGEADL     : MXCGAJTX        WBOACHVRROFRIY 
JJHPMADRRJBW    : QVVXFT         
DROURHSIDN      : PFQQC           IMVNTULT        AXTNNWBASQ     
YTCAANGJX       : ITGRSWXQAW      QQRCXWUYFTQLR  
CMPFHIOIHIN     : JTHKPMTNJYQC    SOVNL           UFRLVVO         WNBFUDGG        NPEYHIEN        HIXQRMBRC      
XISHDE          : WOPOUI          RGIOAYGERLGYF   GXIPGW          RXPAHMR         UCXJAKR         IWQSBU         
TAMPEOPTV       : SDON           
TLEHCJOMBYTLM   : CJIDNUIOGWLPXLP FTBPOT          NOLRV          
LXOTBUHWWV      : CXGHGNSDQWBR    UUCQMSUQXRS     FWBCKKBCUJSVRVS RQLWTTJPEQB    
BLDVJFPUJ       : GQHQGBAD        LBAV            JREYTU          HCWT            WOEDKM         
YVNLYO          : HRCLSVFD        INXONQFF        UYDICVC         IAMEJHNRKB      MYEHJAO         SSSXSUMLFFG     AYCOAXWLRO     
KCEWASSDQABN    : BPGLGNIKQS      BTTPDKFAXGRSJS 
QPJTLS          : NNOCAIQWPHDTJ   SWEHIHBQPBAIMF  OGVFEGQG       
BQLBPJQCIG      : SAGRVW          GEBJFBTRAEAJ    BFCQBNKMXAVXP   UGBAWEH         PWXEIPCHBK     
TKOSKJLPANSOJ   : TVCQNAESH       NKAESGDSF       MMGLVFNH        NBHENOCRMGBHLQ  YRJXYMLYLW      ESDFMD         
ETGROI          : HAEALDHHCYIVCC  AQQWUKR         YRPDGELJY       DITWDYKYSXTHSSD DOWRWQTEFXYP   
FTVXGPAOV       : HLUYP           SAYRDQBVLUM     MSTTLU          CCJIUNDNWPBI    IKCINRA         XBPEULE        
KIBDSMQKN       : NADQNFLAPDEW    JMLDSTVHPLSPP   MDXWSPODEMCBHLR TTHKYHNRKOF    
GEQPIMVCBE      : USQFAJVSIGPY    PIKRFWOQOO      FTQR           
JBVHJL          : BJFJNBSHM       PPHPMSQWEGAB    AQTQKRGWE       HHSYQKOORUEDDI  NEFYJLA         EEXSXFJJ       
XJXLRBQM        : ADATCW          JSISCEVJJOMVY   IGFW            RNRMCKUEBYUKMRF
IWBODFF         : RSKCNV          ICTJETLCTPSHRL  EXXBFFCJG       RWMYSMYDP      
PTTRVBRHEN      : RRFWYDPQKIXT    NSPISAJE        MRFAYA          GXKBPWBURW     
NYALKAYCBQOO    : PUCFBBR        
NSPTAXRSR       : AKJKBCFOVUDIVYE RPHFTRNUI       HQNEUW          VPBNBR          NLJTUVJAMRN     IGYYHK         
KPME            : UKAOCDTCJOES    PEXBPXLBIV      NCDLFJYBOOGHOIA GDAPKKTUEPYS   
SRPGQRUDRTF     : OPWBNUQLEWURWF  IPERHECIRTVCQ   AATNKEVPYQGIXU  EXIWUTUCYCV     QRQQXFQDHYRXNU 
MVKNMDEIDE      : NBPTYVWL        RFPBLDOVFI      CGFVDLIERDCW    UARWWWIGGT      MLES            AJBQAQXDBVVBAT 
VVNJOD          : LWMWR           ICJRLYUTLDXR    JXGJTLXHXBDN    GHAYLF          KMPWRTCIGNSW    QSIF           
NVIEDBXAFQTKL   : VIUF            XIGQNIRBIUTYA   WMHA            JPJLSYQELS      DAWAFQTMTQ     
JVUVYBEFHGDETO  : IENJCSIMPISIRY  LRTIYOJIF       XAHMQCUEHVXP    KJSXUNKWUSHU    JQTMMAT         SNFYHFGVX      
WFITN           : PNBS            ENENJGV         UCXJAKR        
YONYTGUHTCQQAOR : BLSLFBOHI       CNWKAKX         TVQUOTLTMR      VXNJSYOBBDBKC  
UYLBDRU         : KELJXHLJKRT     RPTGDXNMNMDEYM 
MUYWOM          : QWVFKQAKP       TVWBRQEJOWWJ    QQRCXWUYFTQLR   KYETSJUPGMBF    HHHDOWJHXEP    
PECOAKJHEO      : PUML            BLXEINVF        WNVFJBDXRNK     OKCJQOAA        YKGBVHAN       
WQQPVLQJOTBMQPH : CAPUD           ODBDBVNDNVQY    NNCKXTAKFIBY    JOYLQ           ETNJRIRLQLRTLWA AYYBSGAMCSUUAL  SIARJDHQHKGQ    KMEQROPGXIMU   
PXFENLIELS      : AJJLEOGLWUHTKA  NNHTAIRURMQG    TMAYB          
VYEXWWROTFFFU   : HOWEXQRDLBTJOQW BHJBKKLKGLG    
HHSYQKOORUEDDI  : MQKTUBJNSKPWWPK LOPP            FLCXM           JBVHJL          HAEALDHHCYIVCC 
XXNXFNWC        : BCDNLEJMMVI     IHYMBTI         VCRTPH         
LXLSEGUN        : MMLCXROFYYO     BVSURQUJYKQTV   SNIIHUEWWHODK   CTNQITQWMJ      WQGIXACSRE     
PMGBEWSBBWF     : FGLQTLU        
OFJEFOR         : IORUH           EKWUU           DYYTQX          GPUJKJXKGJREF  
RXPRLJVT        : RWIKVPHKEDMBA   QSQYQAQCXWOJQ   JMJDPFH         OKAODVSCNYFUE   SORPJQPITCKTWO 
JJWYR           : BPRG            YBOGCBPIRMNVDQD LYRSGUMO        BKHWGNANRNMG   
FOQGRPNB        : KBCSPDHPTKMWQH  KCOLPGATV       CTNQITQWMJ      MEJPDOTKWI      PWXEIPCHBK     
VMKBCDGVDVNQ    : UXJMOTUOPUSRYX  JYDQFADHNO      FOJRQKFEILLK   
KKQVTNUNNCCGJ   : UCOESDEXMTFSV   SJPC           
WYWFUJ          : RALXKK          XOPIUP          SOCUHOJPINAMBN  ULURBEFROGW    
WNVFJBDXRNK     : TANBWKDGOFCYRXC XLIDL           YJNWQ           NLFJFPXBDSXOOYW SUCJFW          PECOAKJHEO      XEFK            DSIBTAHHHUPTL  
WNVFJBDXRNK     : IEWXVT         
EGXRELFGPNRLKRK : GTVEU           SUCJFW          SWCAREUABKVYXP  UCXJAKR         MAESTSMSNFWIOF 
MVJLMFSV        : PUCFBBR         UNMQMM          AFJWBONWRFKK    YDCUFLIGXIDGIOI NSWWOX         
WVAKGEONEIRRPAJ : RAGPFOGYWQWV    YFRIQCTVFFN     KLHMINWQAO      CCAFMSC        
SUQKHJY         : QIQRTMRNOMXTTV  RUPH            CHFPRQTQQ       GQGYABBEXK      SWMYLSPOMUG    
SNRAGQIDMKPTQGJ : NWTXXWAB       
ODMEDVK         : OAMGLMN         SYFQX           EPONHODQRYBWP   ITGRSWXQAW      UKKUNJXRIGOBICT GVEOQRSXI       BIAXOQQOGCXGHGG
SBGCKIJFVC      : YHQJE           HDEHPMNOQNCH   
CUPIHC          : YUCAIBFQNCGVBH  RRFWYDPQKIXT    DYXHM           WFWBMYYJAL      VYRAEXCPEGIJSY 
BUHMPVPEDTCNPU  : TFLXHF          INBLXAJLIRGWAV 
YYBHIGDMNHH     : IUKV            RRUEFCVKGGDM    KYMNGAXNO       FUPWVX         
RPJS            : TJNHDXCESGATBW  DYPHOTDDHRLXUF 
EAGTXVABPCQI    : NKSDCBJTCIB     HSEMPPJWPGCOBFD OKGY            LYQQJLMRLWH     YACDAIBBBDY    
HHXIOGQTTGBDLVS : KYRFN           RLIAORIEP       NUAYNBCXOYCAU   OBUVR          
OOYOUUOSUQJW    : PGSQIBLKDBAN    MPGSKDPFOCH     KFTLV           VPBNBR         
TVPBTARDRLY     : QKVPLCPXEEHEU   SQDVKKUFJWWHERV HCWT            ICTJETLCTPSHRL  NEFYJLA        
OCMMXJBMLRH     : DKDA            SNDOXKQBDBRNHO  QPDDKFU         OAYRYUAUV      
HAEALDHHCYIVCC  : LGBDBTACNGFT    ETGROI          HHSYQKOORUEDDI  DOGKUWMVTU      CQBOTNEYKJAVFT  UENVY          
VNAVFDIRBUV     : TLACVG          FXSISWS         UCXJAKR         NQHTFITBAOXPW  
GNWOWY          : HXTLI           LPWFBNQE        BPFPIM          GCMCJLHP       
WNBFUDGG        : CMPFHIOIHIN     LIIYYFJLHWCHNB  NTMQSIO        
IIDGYDDE        : TBIRYXRQST      WYWSLLSUAWIJOY  UHTODDJDN       YFGBII          YYWMKYO         PSRCYBCOSEFVGEL ULSDYBFXFCG    
NXJITYQK        : EILBEYIGCLCDNPL YVLIOHGSXDQE    HFXBGTMICGVIMD  SVAEL           GTRNJJICK       GXGLHBL        
IHXFFNGMIJUOL   : PCDWIQJHSI      CCAVOU         
AQKYTPDDEDOOXQ  : OMBMTFX         DWAC            GQHQGBAD        BOFJQHOLLX      YKDHSV         
KOQROVWCD       : LKYVOWANWEQFAEQ TQHUXUAXVMPN    XAYTAGP         DSIBTAHHHUPTL  
NOHECN          : VQPVBEVEAKLC    LOJCIUVC        VENKUQKQRIEM   
SADNQISUM       : RVYUGPYNRKO     TWOKDHDA        USUTDIKCJI      GWCEE           TEKDJLHW        MLES           
JMARYRIQIHQLM   : JXGGNEWUQYOLBRG YTQVK           RWMYSMYDP      
BBJFEWMY        : HASUBVRHV       BHHLTMW         AWFWVOOBY       GFQTBLQIBWB     XFGRSRC        
ROODJLRTWEVRDP  : NGDTYMEOFGSL    SQXQKUDPYY      WNJDRXJDM       UMCABN         
VYJMMVPNABU     : HLEMSPVH        JHBPYTGB       
YJFYCUPF        : PSVBJHJNDGMH    DJASH           IGYYHK          JINBYEYGUE     
DWAC            : AQKYTPDDEDOOXQ  NXRUFWPPI       NBAVXQCBWLI    
WTIMW           : YJNWQ           LSBHCHH         YQRVSUBP        SAGRVW          WKCJFI         
NITAFLNHMLNNUU  : TIKHB           YYWMKYO         ICTJETLCTPSHRL 
WREEWJBYMGXG    : OBJE            ECJLYAWF        DVXFNEOVNHWX    BKSUAKHBSY     
NDVBMPCT        : UXJMOTUOPUSRYX  NGDTYMEOFGSL    KLHMINWQAO      HIPQGVNICBKT   
RDPDQEYNSXG     : QXAKMQ          DSQC            PGSQIBLKDBAN    IBMPWMGPWOPXP   FIXFCJOHA      
FFHGETPDDEQICT  : RLTANQIFWUKLUFN NGAU           
TVQUOTLTMR      : LUVJILCTEM      YONYTGUHTCQQAOR NIFPCVO         LBVNNE          VHNDQB          EEXSXFJJ       
BKVHKB          : JIKDUQ          TDYKVGECFN      BIECAUTWNNQW    RHKECE         
UHSQ            : XAXHVGFTD       UVPWLJMU        UOHB            WCFLTIMO        SBSGH           GLBPXL         
VTGO            : PIWCVISQS       FOISYPIGNQDDAPL TADNED          TVAYNV          FHSNYT          KEPOXBGOP       YKBOBIGGBWKPUW  FLDAQVEWOECHEYL
IJADHTAXNNS     : NYEMMWGPXCFLDAY EFKSU           EIMDGDPFVOLOHVC BLYXYHIIBRCIJ  
FNGQJNBMCVWWNVV : CJRAKYLOMKWWQNV ACPNTNCCDYRUY   HHHDOWJHXEP    
CMMLVPQGJQEY    : EUILMMXPSCGWJIW NCDLFJYBOOGHOIA LBAV            RPTGDXNMNMDEYM  YKVX            SJWSNNIJBL      TCYLKLP         DAHTFVDCJ      
WCMN            : OBJE            URNTIMLL        KNGSPQSMHGSS   
DYXHM           : LNSYMPPRHI      CUPIHC          RXNC            YHRDYAVY        EVFUF          
DJASH           : YJFYCUPF        LQVWREOSVQUJ    SBCECHAUNWWQ    CGFVDLIERDCW   
DKKRXJHOPQHTSO  : YJIOTN          MQQWKO          WJMXNFL        
UCJG            : OHODGOWJVIAH    GXIPGW          YFHFLJGUXOAWOIQ
KGOYLUI         : VFAJ           
NSLSDVNBF       : UXQQPUXO        VYKHBQDTAYJH   
RWOB            : BQQCYISHUMXY    VRHPYG          AXPHUETYAEEATWO
HQNEUW          : BHLT            NYEMMWGPXCFLDAY NSPTAXRSR       APQWULVARB      BPGLGNIKQS      BBYK           
CHVRHHORWEKIXP  : QWVFKQAKP       YTBRKOD         NWISF           RESJERDHQCCMYHR KVYNXYNJIGD     KSPQ           
NQOIKLYMFIFS    : CAVSW           UKCPFTXV       
ARCEAAVJH       : WISCEIBRGRFP    TVWBRQEJOWWJ    VEOGNWVQW       XFRRIPJHTQIRR  
DGPOOPE         : XTBVGKLM        NBESQGVE        UCNJDUPIYC      QVVXFT          JNUN           
DXON            : OEPWBMJHGLSHK   NNCKXTAKFIBY    FYFSSOJDFW     
APWIXEBNETSJ    : NOTHG           KVRWKFE         HBTDXRMAFGNCCGJ BTTPDKFAXGRSJS 
SHHDUKLMBBEGBH  : JFIUXLYCHDVEW   OFDXIDNUQCBV    YKBOBIGGBWKPUW 
PWSRM           : UPQWQFCK        LYWFKK          AJJLEOGLWUHTKA 
ANUEDCA         : RECNAYI         HPBISFD         YUWCBGOJ        POBBXFRWV      
NXRUFWPPI       : DWAC            ROXLSWYOVBPR    NNFSVFUQKT     
RLIAORIEP       : RXQBFL          HLEMSPVH        HHXIOGQTTGBDLVS SUPIX          
YERYTPFXTFV     : MNWNUUUP        SVIELNXGPVYMOP  EMPRNELLYD      LVTBRQOWLSXRE   YYWMKYO         LKUE            JPCGSKR         WTSWQKQN       
DPEIOWBAB       : UUFHAVJQMOXXJO  RGNUYHVRIOE     MNCFRETSYRKITV  YJNTKOBRXHIUSSU
NKSDCBJTCIB     : GHNGWRDCBID     TCJQACTXKYAPA   NFKTVWHRXVHNNQX EAGTXVABPCQI    UQJFRGKRKUACEVT XBMC           
KUOP            : UARWWWIGGT     
KXRTBJXMYUPBY   : HWLLPPULNDRW    GFYUOOLQPMDDVQ  LCWNH           EEXSXFJJ       
OJDTNGEKKMLJ    : JVWNXOLXLMSJSJ  XOMMECURYMBVUMW GUITWEHIVPGVNK 
GAPCKNVEQFFFG   : FXYDHTTCBF      LBAV            ERVPVNEUOML     QWJHIQLOGUR    
UJBFBMIUBQYLC   : HMYNVOFHD       TGBXAFQAGCMYWG  VRKYRBPNQENQ    RXCSRAHRUUSAM  
YLNHO           : RMCDALGRFFAP    XFTGSPDHYMUTD   MANAKMOLYAJKCKC TMPMLIIPQOEKNWC
JYQHGIPLNXNLIR  : JKKCDXRXANP     VKBBEWS         BTDQCOHTBPMVYE  FQVDJKSK       
JECEFSGSUWR     : WXVX            BPYYGE          IMRKOOWMQO     
KAAOLBFVHP      : BUNEFVXBJJOH    JEQBVVPENHTK    JREYTU         
UGJLRTDKFH      : LBWIIGR         ALBFEIEFFWMQJYX RYEWEDJUOKUR   
MPGSKDPFOCH     : WNDKTNVQ        OOYOUUOSUQJW    DFBCRTHEJIT    
QSQYQAQCXWOJQ   : LDSGFARFT       RXPRLJVT        FSHQ            QPDDKFU        
OCQXQDNYXYD     : FVNQNBWIROD     CNDJSX          IDHBIMBUIGOGF   SIARJDHQHKGQ    BFVHTQ          MVAETXYX       
GTRNJJICK       : NXJITYQK        JLIWWASCNPAKSSD EFNX            HLMAU           FXMMDA         
CBEABSLT        : MJJPW           LYLYGRAQYALJD   JQTMMAT        
AXWBP           : NQSDNUGOPLU     VRYNAQ          UQJFRGKRKUACEVT KSPQ           
OOXPTNVOFLA     : DQGVOLCHIPX     VLMC            LTVFYGXCIYRSIMM
UCDUE           : HMXHE           GQHQGBAD       
YHIUSE          : PBPLPXGVI       KELJXHLJKRT     MDMWADIWXLSR    TVAYNV          OTSFWYTABE      VICIFWA         ENENJGV         WBYPHHWQPR     
YHIUSE          : BICNMMCFOPBI   
VDXWUA          : HXTLI           XXOGB           LVQEYDUTGJJTPT  TVFDBECAVAC     JPOABIOT        HFBEYKL        
JXGGNEWUQYOLBRG : JMARYRIQIHQLM  
YHQJE           : SBGCKIJFVC      APQWULVARB      NWMPVYWXPMY     KIXUFCHTMRCYQ   YACDAIBBBDY     QMUNXVSSUQBAFE 
OHIRHFMHUXHBGWG : DYLKGMLIPCT    
SWEHIHBQPBAIMF  : PERIRPKVYAQCQ   QPJTLS          KEPOXBGOP       GYCMEB          PSLFKBXDR       MTHV           
BMDUUK          : KEVVJMUBJ       IVHWJQIKTCQKHF  GCMCJLHP       
EGKMHQJNWEKDNUL : LOOQO           AJJLEOGLWUHTKA 
LDSMLFTHJGKG    : SBMBWKQGVKGDEDK MQQWWNMSPUXR    OAFBYQOFLIX     XAWKRR         
VQICBWLTIAQN    : ABWI            YVJIPYPSPO     
UBIISVLLKWTEED  : PSVBJHJNDGMH    XAKGEGAOYCTNWIF IMDXRGLRUKIC    LCWNH          
RJSPCDRDCFXLF   : EPEMTRXXMHMFP   DWQVWGFU        JOYLQ           QQRCXWUYFTQLR   QKJHVTC         BCDNLEJMMVI    
BUNEFVXBJJOH    : MJJPW           CJJAKMAG        KAAOLBFVHP      KRAQCGBH        GFQYFYREVJY     SQXQKUDPYY      DOWRWQTEFXYP   
SNIIHUEWWHODK   : LXLSEGUN        JFTSDQ          EEQBGCP        
DVCVYWKDEI      : NOTHG           KEDG            DOWRWQTEFXYP    VMMCVKPWTTN    
GSLWCQRRC       : MNHDUKJVG       ONALIGUUIEGIVO  SROIXE          OCJFJLQTKV      TEKDJLHW       
AWFWVOOBY       : BBJFEWMY        XBJNJ           MRNUIQJ         MRJANNPL       
EWNBVNNCRV      : BJFJNBSHM       OIYDCSG         GDAPKKTUEPYS    IFDYLWIMW       RNRMCKUEBYUKMRF BJGTJESDHBO    
AQQWUKR         : PBPLPXGVI       IUSJEKUQLW      UPPWTBTKYITLFE  ETGROI          WCFLTIMO        MSAVFOXVMDAUJDT NCTLNNGOBTTPJ  
MSNLA           : MTYJ            RXNC            GIDFKP         
JOYLQ           : TPRCSANFBWQV    LNSYMPPRHI      WQQPVLQJOTBMQPH RJSPCDRDCFXLF   OPTUKVXOY       DAWAFQTMTQ     
PPBSOQG         : AQNTDDSVMIKPU   OEPWBMJHGLSHK   RIQPJSF         SAAHKAECCG      DVXFNEOVNHWX    LIIJQJTHPNW     XEDYMHFYTSOJYYT
KFTLV           : LCQAJWVEA       QJRJOWXSP       OOYOUUOSUQJW    REOWIJEN       
KRXEFMWUXYFJQ   : TQHUXUAXVMPN    JDAJLKRADX      QPHLEYJDQNUJLL 
UJTNYUGNLNGYU   : GLVXEGGXXTSGNI  RMCDALGRFFAP    SSIV            VRHPYG          PJYNKXLAKLVLAY  YMCPUUUYDWOFJA  JEHMPHT        
MQQWKO          : DKKRXJHOPQHTSO  OQOSFBLDMY     
RDBMB           : AQRGUVSHSVWIIGA EXYCYWJWVNGQJ   HDPBYW          BLYXYHIIBRCIJ  
UMTCIFVVETEU    : HRCKBYY         YNBJI           JFOIQRULUM      QBXEPE          EGTAQRH         PSLFKBXDR      
TBGOESIWSSL     : TVCQNAESH       FHSNYT          EWEPLFOB       
NQAATDUHYYPEV   : EXYCYWJWVNGQJ   EUBMPTQU        USQFAJVSIGPY   
LRTIYOJIF       : JVUVYBEFHGDETO  UKKUNJXRIGOBICT IYTPMLAHN      
DNPV            : SAYRDQBVLUM     JXGJTLXHXBDN    OSHO           
EUWUVWP         : NADQNFLAPDEW    DOWRWQTEFXYP   
UWBTOHRCS       : HADLLUQOWJPMTB  LUOWMCWH        JYKYJYSOCD     
XDNMPVUGY       : CARIOQEMGP      AXPHUETYAEEATWO KMPWRTCIGNSW   
VXTCSQ          : KYLX           
OQNQL           : OGYCYULMU       XALAGOCBQPN    
THYBCDWNBA      : FYRLVXGKSTTV    RMSQWYWLYDT     STEJBRKVRIIC    KRFUTIMQMVJ    
QPYLXYVWW       : MJJPW           CASBOQVE        DPOKCVCOY      
YPJWHAM         : ULRKR           KABO            JFVFBDBIROGK    LDRFGFICRUOA    SBSGH           RWHOMYQETBGJ   
NWTXXWAB        : UERISKWKKNGGVHF SNRAGQIDMKPTQGJ LQVWREOSVQUJ    BSWRYUTLT       RPCEYUBQJVEW   
PFYTVQ          : VVWQSOATPSYHBNH KEQVFNFTIS     
JRTHQQAP        : LOFTBN          HHYSYRXDNB      UCNJDUPIYC      LYQQJLMRLWH     OBDMBAGC        OUQJGVCV       
KPSMESDCOBC     : EOEGTUAMMD      EILBEYIGCLCDNPL PLGFFW          KWQXLEWT        WIVKEVAVGGUD    UWJXPJWI       
DEKU            : KMDQXWJKPVWHFQG ORXGMICPJXGTDAK TAEE            CRDNSPX        
LOJCIUVC        : GIMNOA          NOHECN          KXDODMTC        BKHWGNANRNMG   
MVDFHNW         : HFQKFYDJJT     
CBUFFJIIWLOJJ   : FAWJXKSPKW      PRAQAWGWSGTC    WHITFLQHOB     
UXLAIGVNIJ      : DIQD           
NQSDNUGOPLU     : SOHQNGMAEBTYEHN AXWBP           OBACDJPCWVFN    RGNUYHVRIOE     YHRDYAVY       
UFAITKTVHSH     : NPGAXORYBEYKC   GEUTJSY         JPODPLBHIN     
DNGQ            : WQXDSB          HOUE           
RCMIWPVR        : FYRLVXGKSTTV    QUCVAR          HMQFXPLGHSJXUII GDCPTKMQW       NWXKKSPMTXMAAU 
MJKJMHON        : OLAPGLCHIJRV    AIPUUPOJMH      FEXALHBQJKHSKH  BGPKCUIGAUGV   
IAMEJHNRKB      : LOFTBN          YVNLYO          EHCHNWUKYBXMDGJ VMBJCNFWUHSWURB
ECRIOAGGX       : GKEBKNNSNKASRV  UDBSNIKQUHKYMG  HEPFEL         
FKMRUYY         : NSEJBQMUEMY     VTAEGVYTNV      UWJXPJWI        FDNUIG         
OQUOFBY         : VKBBEWS         MRGW            IGYYHK         
PSASSEUMMLMUS   : NFKTVWHRXVHNNQX DXHTBVNJT      
XAWKRR          : EHNTYBEJIUYHJ   LDSMLFTHJGKG    YETBITNFAQDTTO 
QEYJYPRAQEPLG   : RWHOMYQETBGJ   
GKGSASHWNTUNRH  : QJYUM           EVEIUMHDJICLV   FLXEYFWQS       VFAJ            RYEWEDJUOKUR    JJAGAOLS        LSQVSK         
LRAPSJQKDREIHP  : BDRSTILRSEKPEJ  LWFVJLOFCKVVQ  
SWCAREUABKVYXP  : NHNVCXT         LHWJGJVVHVEMMM  EGXRELFGPNRLKRK ARXXNSNXOICS   
FCAFTUQL        : QIQRTMRNOMXTTV  RAGPFOGYWQWV    CRDNSPX        
UDMFMCVI        : TDXWSP         
AKTEFVIP        : JDPCC           UYHFCPY        
JPIPWMSEGNWT    : JPOABIOT        YVNIHSLINLQGNRI
TYIBONX         : KICBBJFMEQUF    SFJYDDFFFNIC    GBJYLCFMYVSJTUL
OAHIFO          : GYACDPK         QDYGAJSQJRJL    HIGMVGRS       
PGYYXHQWTJBC    : ETJTKEESOFUJ    RQSGJFESABECXY  JRKIYYYQTY      BYESRAYTKGDRCT  LVWJ           
AWXUXHVMWVJLW   : AQRGUVSHSVWIIGA SRHWEJLUV      
WEJDV           : YPHIBJWYJJCXX   YFTO            FXKGACPMY       WOEDKM         
CWPJN           : MUWDUCDHO       LQUKMYLOXP      WPTCICDMLSDD    KWQN           
FANKCQJALHJ     : VDJACR          BSUTKADQCQ      ACIMTSYJ        UWFCAMF        
UGIGSFARLLUJC   : RRGEOFQLYQTPXKV NUYPDYGNU       FDACGUBSGLJ     TDQVOKQSMBPVI  
GRJVFPV         : RLTANQIFWUKLUFN ESOEEUR        
AALJ            : VHIA            FOISYPIGNQDDAPL JHSJNYIYTSIJPJQ
YQKLNRTUMBWEOIY : AODXNCO         OTQBLBO         YETBITNFAQDTTO 
MYEHJAO         : YVNLYO          OHODGOWJVIAH    EFNX            RWHOMYQETBGJ   
YLBYAKCYDN      : ACPNTNCCDYRUY   KMACTV         
TFGORJNXXX      : KJNA            ETBO            IARYVXCRPVB     JEHMPHT        
VNWCWGF         : KFSGR           MHVNIJSBFFRBJ   DGGRLOMVSFATCM 
HGYIFYUKBXXNRD  : SOHQNGMAEBTYEHN POYVERA         EWFFYKPTKT      NYOQHECTSHI     DAKIFIWVNHU    
IWGXUFYTBOQ     : YEPWWOKORHUSKQ  MEQAOOCG        YGRESUEX       
LYLYGRAQYALJD   : CBEABSLT        VENKUQKQRIEM    LTVFYGXCIYRSIMM
HSEMPPJWPGCOBFD : CGXB            EAGTXVABPCQI    QWASVI          OTSFWYTABE      GQGYABBEXK     
LQVWREOSVQUJ    : BFDLFUCEHN      DJASH           NWTXXWAB        QWDXHXRBGEE     CGGPBGBJBN      ARXXNSNXOICS    JLMFNSLCJXEAD   KVYNXYNJIGD    
LQVWREOSVQUJ    : KFNW           
XVIQDUHSHGKNK   : ONALIGUUIEGIVO  UCCUMA         
QPHLEYJDQNUJLL  : WSSC            KRXEFMWUXYFJQ   SBKMUGREW       CASBOQVE        JLMFNSLCJXEAD   AHBHBGGB       
VLERVV          : QJAYVMCUEHIOXL  MLFYVMEPMWK     UHTSMLIQSNY     NGDTYMEOFGSL   
RFPBLDOVFI      : XNHQPKQIPP      MVKNMDEIDE      JJAGAOLS       
MVRLFVF         : YGAI            CNWKAKX         UJOASHBXDA     
SQFEXDRCUOX     : BJFJNBSHM       ABBSYFEKAOQOXGI MPAPRCXPWBFBVB 
GFKJQNXMSI      : QVKO           
GEUTJSY         : AQTQKRGWE       UFAITKTVHSH    
LSMRQPKSKYT     : GTKU            BGECCMFVW       TPMLQDFHJGRUIO  HNERKTKRKHULHCW
HBQQSEQ         : NCEFOGL         QVVXFT          QLDET           VOSGEHI        
XAKGEGAOYCTNWIF : UBIISVLLKWTEED  SJPC            KJRJHW          GIEXNJ         
XRIKSE          : CYNR            CGREHHWQQB      JIKDUQ          FGLVXJOVGM      HMNHYDAUYDX    
AGHSB           : FVNQNBWIROD     UKRUBUJVPSKG    OXLHLKSQIX     
KINMTTQCWHDB    : RCAIMMBJRFDB    USUTDIKCJI     
QXLYNJSXWM      : GKCSCHUNJ       WICK           
NMLWIMMUWB      : NBHCAIVWVBDMMIW LVPN            EVLOXXPOP       RTXUBYLLSYGGYEC
QWASVI          : HSEMPPJWPGCOBFD LOOQO           UFXDJXN         KHOEPDGTSFLR    RGGODGMBWT     
WNPWCOMNI       : LCXPKBYNR       VVIJFLGRASPORG  JREYTU         
KWQXLEWT        : BGTERONYXJ      KPSMESDCOBC     YKVX            MNCFRETSYRKITV  KSPQ           
KONLVH          : ATJBBDPFX       RMFHLXDQFXV     OPTUKVXOY       DYEIBOTJWTLE    QRQQXFQDHYRXNU 
WAFHYEUPEWGQ    : MKEQC           GQHQGBAD        DWWNUBVKHFP     VFPCCHGXB       YVJIPYPSPO     
QEXNUWAYVTR     : GXXUSF          XCHVQLSXUNVKQ  
LIRHPDGRKNTQLJU : RFFCF           VFPCCHGXB      
ROXLSWYOVBPR    : NXRUFWPPI       RQJLMLCMYC      FERVGTXICYDT   
KBJS            : LKBKWKBUHAMUTN 
SKXCCKRXEDJY    : QOAKUEWOPK      KLHMINWQAO      IWQSBU          GIEXNJ          DHCQG          
CNQNJPO         : KDPYKGLKY       EVBGASROROY     PSKPUXLJNGCJ    YTSURUWSELNTX  
NSPISAJE        : PTTRVBRHEN      STJNOHHMHDA    
EWFFYKPTKT      : HGYIFYUKBXXNRD  MFFLHDWMOJUO    JWEWLDUBHTRX   
UVPWLJMU        : UHSQ            SPIHMHV         KNGSPQSMHGSS    TNJGAQHLY      
DUPXL           : JIKDUQ          QWOFAKRRKO      KWQN           
QNHU            : NJHGSMBHTRX     DVUNVXTDNUW    
LUSQV           : JPDVU           UPPWTBTKYITLFE 
JPODPLBHIN      : AUUPLVI         UFAITKTVHSH     VEOGNWVQW       WXLYTDOYWBJ     YGRESUEX        WJMXNFL        
WISCEIBRGRFP    : JKKCDXRXANP     ARCEAAVJH       CPECHI          ABFJQ          
SBKMUGREW       : NHNVCXT         QLXGUFWTHRWLO   FVLJQDED        AQTQKRGWE       QPHLEYJDQNUJLL  PUGSUKH        
JOTLV           : SQHTJDWN        VYRAEXCPEGIJSY  VBARGM          IKOXHGSVLEWMJQC
YNBJI           : UMTCIFVVETEU    ULURBEFROGW    
NQHFYYNOOG      : SQHTJDWN        WIVKEVAVGGUD   
BUMINSHVDVQ     : CPMGFNELC       URNTIMLL        UXEONFUWJG      DITWDYKYSXTHSSD
RUPH            : SBMBWKQGVKGDEDK SUQKHJY         ERFVYOXTN      
BPFPIM          : NMWG            GNWOWY          DFBCRTHEJIT     MJYDMY         
JNMAFV          : QSNHLTEJOLCNK   HWLLPPULNDRW    SIXASTGXOBREWB  HUKNLBIUWCJ     BFCQBNKMXAVXP  
GQHQGBAD        : BLDVJFPUJ       AQKYTPDDEDOOXQ  UCDUE           WAFHYEUPEWGQ   
VVWQSOATPSYHBNH : IMWA            PFYTVQ         
ETNJRIRLQLRTLWA : YXRQPNXD        PCDWIQJHSI      HBVSBNNUBBCLNB  JAYR            EPFFDAXR        WQQPVLQJOTBMQPH QSMREJYFXQ      MHLFW          
ETNJRIRLQLRTLWA : FQLNEQMWHXCKLJX
SYBO            : PEVOESIONR      SWMYLSPOMUG     AQEKCQULUH      FNDOPALEHJ     
BIDTKLXXSLC     : CYNR            SFJYDDFFFNIC    YWYQXCJIUED     OIRCQILJCSUDW  
BNJKIUDVO       : CEHGQEGWO       SESMYPHBHVUCMS  FDNUIG          NNFSVFUQKT     
HOBRJAUXN       : SUCJFW          XOMMECURYMBVUMW VYRAEXCPEGIJSY 
HQSTESRYGW      : AWVYYNJVVOC     VRYNAQ         
IMASWWXSNWBCXUM : XXLAMMBIGC      EXNNONOUSIIYI   GLDLXBLAM       SEEHBCGWNOA     XPYSPSGPRFDV   
QMNPV           : CTNQITQWMJ      DITWDYKYSXTHSSD WYSEYCYC        KYLX           
KPLEKMMHD       : PJHPUPUXREDGKW  IKNIXHALWD      WUMY           
VDPTCPMQMPU     : SNXVVVRAB       IPERHECIRTVCQ   USLSHUGBRAWXX   UQTD           
LJKEWXTSFELQKV  : AKOBLABNTNNCC   ACIMTSYJ        JIKDUQ          KNGSPQSMHGSS    XQOTIGTAFO      MJOMWMBOSB     
AFJWBONWRFKK    : MVJLMFSV       
CHFPRQTQQ       : NPGAXORYBEYKC   MTYJ            SUQKHJY         DOQUCQBT       
LVUWOHSUHA      : WBOBBBPEMSHCMU  RNFUJQVKT       DMSQMPTCS       DDLOFVGSBGAWHY 
HCUUYMAL        : BGBPXNEWEHDBSJA RRFWYDPQKIXT    YKDHSV          YJNTKOBRXHIUSSU
UOHB            : UHSQ            SIARJDHQHKGQ    VXBKOSOUTRL     YPFWQPJ         AHUCVACF       
YTBRKOD         : INXONQFF        CHVRHHORWEKIXP  XEFK            KIYJGEUAVDO     TWODGSJERC      XXLMQT         
LBAV            : IINPHW          BLDVJFPUJ       CMMLVPQGJQEY    GAPCKNVEQFFFG   KSMCWXRMUBHGKSB
WFWBMYYJAL      : CUPIHC          JPOHXEKREDV    
MNHDUKJVG       : CBGTNKUAPS      FXJLK           GSLWCQRRC       FCVWAEOG       
NTCQDNTFLQ      : UKAOCDTCJOES    JTLMFKKGS      
RNGEO           : LDSGFARFT       DYPNPFQWJECEIGN RUGPQOL         YCXYJWGVTMY     MFYLQMRKQDISDB  IHSMTWNSSD     
QQTDDHKIEXSCE   : MMLCXROFYYO     FABSDWHFQR      XFGRSRC        
RAHKFVFLJXO     : FVYMQLJVNG     
NUIE            : MHLFW           IHSMTWNSSD      HMNHYDAUYDX     VHVCP           KIAI           
YUWCBGOJ        : LYFKEQW         INIGTAFTMVLVVD  ANUEDCA         HHYSYRXDNB      JXGJTLXHXBDN   
MEOTKG          : FXSISWS         VEOGNWVQW       UUJTTFKTTNTMSW  HREGSUDSWVPNER 
RSAPANAXCBNYLRC : KIOELETNXAS     AAMMQRKTD       TQMWL           JSPXI           IIEJ           
NYOQHECTSHI     : HGYIFYUKBXXNRD  OHWLURA         WJMXNFL        
RQJLMLCMYC      : RWIKVPHKEDMBA   ROXLSWYOVBPR    OTFFIESCEKGHCQ  HUJQIR         
DFBCRTHEJIT     : MQQWWNMSPUXR    MPGSKDPFOCH     BPFPIM          ACIMTSYJ        LXSWLLWBNJ      KEJSXEALVWTTBDR
QAEKSLV         : EVEIUMHDJICLV   LHFPMXYBPGQUT  
FOTRBHVOIAC     : MQKTUBJNSKPWWPK SESPJKLJOX      NBESQGVE        HIPQGVNICBKT   
HDPBYW          : RDBMB           GQGYABBEXK      OVQWFCBRMR     
KGCMWCRJUFF     : TBWBTMOXEAOKCK  ULASOXOOTIAO    PVCII          
LUBFVKDM        : ULCHGRT         FGLQTLU         VXNJSYOBBDBKC  
DOGKUWMVTU      : MNWNUUUP        HRIXTGBUBTUKRAA HAEALDHHCYIVCC  DRJBTWV        
AWVYYNJVVOC     : HQSTESRYGW      IDHBIMBUIGOGF   AATNKEVPYQGIXU 
JFOIQRULUM      : UMTCIFVVETEU    QARRL           GYTYA           OEIUAFXLJKYXLC  LXSWLLWBNJ      ECTJ            MRJANNPL       
HJPTFJ          : QILFYDMF        BYESRAYTKGDRCT 
OMLLLMBWJ       : FNEXXPROUEVB    LVQEYDUTGJJTPT  GFJCJLLBTMMQPLH SQUIXMPTQPGRG   YVNIHSLINLQGNRI
MNGXSWILOEXLQQV : ETBO            BFVHTQ         
IPHTHYGUKUI     : HEUOJTOABVSETNS HLUYP           TGBXAFQAGCMYWG  MQOOAPVSGAYE    QWVFKQAKP      
RTNGHT          : XBKQPSDR        LQOE            IJMAILUC        MTUWKYWHOTLL    PIKRFWOQOO     
CTNQITQWMJ      : XBKQPSDR        RCAIMMBJRFDB    LXLSEGUN        FOQGRPNB        QMNPV           BLYXYHIIBRCIJ   VHNDQB         
ORKYLTXUP       : COGLBXLQIUFLCPQ XYFGYDTHR       CJYUTNUS        OUJFTFKWXALWEB 
PAXJVL          : CYNR            PBYCKU          HKYHHAITOCIJX   HBTDXRMAFGNCCGJ YVJIPYPSPO     
DIXHCNXMIOJW    : XXOGB           PVCII           DVXFNEOVNHWX    QCXPHWE         BYESRAYTKGDRCT 
EMPRNELLYD      : XKUVVXJ         YERYTPFXTFV     QJBJXHXCGSFJROC PIKRFWOQOO     
QFTCBGUGO       : JHBPYTGB        OBACDJPCWVFN    FWBCKKBCUJSVRVS YVUOF          
OQJMFTERQEVFW   : UGDEUERQTYAYP   HBVSBNNUBBCLNB  DWQVWGFU        VDHUWFD         IPOG            UDBYH           UENVY          
SBCECHAUNWWQ    : RMCDALGRFFAP    DJASH           EXNNONOUSIIYI   QWVCBHULGIW     TTHKYHNRKOF    
SXTNMMYBRSHJ    : PBPLPXGVI       JADRK          
MIRLXNM         : DUBGLAFMMMDJWXP WSRHHTM         CCAFMSC        
TQMWL           : MLJRNSLHYJF     NJHGSMBHTRX     RSAPANAXCBNYLRC TXSDQQXO       
TKSYFQSVFHUJYQ  : JKKCDXRXANP     UNPJDJLV        PWXEIPCHBK      BYESRAYTKGDRCT 
LDHTWSTKFYH     : BQHWJHEKUD     
LELNXYG         : HBLLSCEW        DVLB           
EARCHYXSAOML    : NLNAXOVMMX      XWGTE           FAYTLNJBRRVFIOS NCNSALFRMYWSAGU WFXNP           QSNOAAWHXKYPW   WRPW           
VHQPCEWBLVOPJCP : MWMFWBNAAGVBGK  PBYCKU          CCAFMSC        
KOPKIRUHR       : EFXUWLUBMNDRC   ITGRSWXQAW      VQFFDL          NANW            MNLFBP          XHOFQRVHY       TMPMLIIPQOEKNWC
JGCV            : LHTSMO          QXAKMQ          PVLNK           XOAEN           YFHFLJGUXOAWOIQ
YFTO            : JFIUXLYCHDVEW   WEJDV           TSKXUOPUSDX     KPWHKNM         OAYRYUAUV       QFOSUEIISMOYDVC
XNKJJ           : PSBIGWXGXHETL   DITWDYKYSXTHSSD LCWNH          
BTDQCOHTBPMVYE  : TVFDBECAVAC     JYQHGIPLNXNLIR  GKKOJ          
INQGNRM         : KBCSPDHPTKMWQH  OUJFTFKWXALWEB  AIPUUPOJMH      IBMPWMGPWOPXP   TNHIRE         
IVHWJQIKTCQKHF  : RXUNXKQCDHJCL   BMDUUK          VLHIFE         
BGJPFIUTTIKA    : NOAGVAW         OGUNBYLEHVTRH   HIRVGLDSMMA    
FOINN           : JMQYOGLI        CIPTWAO         VENKUQKQRIEM    WXBJWNQVUMYCQLS
KWJTJDXAQHHK    : LAHGE           QARRL           SQDVKKUFJWWHERV NXVTSEDM        GKEBKNNSNKASRV  MBYGOXDCIOOL    NOMUJXN        
QWDXHXRBGEE     : LQVWREOSVQUJ    CINDWQPLFBKHNX 
JSPXI           : TMGUGJHYEYR     ARKCITSAT       RSAPANAXCBNYLRC VAQHWYKPCXBERM  WYDHDGI         SHBBHSLHT      
KFSGR           : HOADTMH         NPMLLXNYKQWHGQU VNWCWGF         RXCSRAHRUUSAM  
HTRQEECU        : NBESQGVE        XEDYMHFYTSOJYYT EEXSXFJJ       
ISJGMKP         : VUOXJEHLA       RJHPYSCWA       SLXW           
QWBMOBUXLDT     : IJGPDABU        PUSDPNKYI       WOSAFHY         WTSWQKQN       
UUCQMSUQXRS     : TSUUDQJ         LXOTBUHWWV      OTNSEXLNS      
KEMWQEQIBRURS   : UFBEFXYRTHFU    LYRSGUMO       
SESMYPHBHVUCMS  : VPAUSWW         SMEYE           BNJKIUDVO       EQBHUGNTLJSK    IRJWTQCKTP     
HBHLNH          : FHRMYQ          KDEFN           GDAPKKTUEPYS   
SXNVP           : UYDICVC         IFAGXFIEXK      NPQJ            MAESTSMSNFWIOF 
QKAJQTX         : QDYGAJSQJRJL    EHNTYBEJIUYHJ   PVISNMBKKSNLTFV DKDA            COMUSGSKE       KGYJG          
JFTSDQ          : ABWI            SNIIHUEWWHODK  
PLSA            : OAMGLMN        
CNDJSX          : MTYJ            XTBVGKLM        OCQXQDNYXYD     KLMPXINJ        DUBGLAFMMMDJWXP
GTBQMLRVD       : LSNHLUWWPU      DMSQMPTCS       YQRVSUBP        SESPJKLJOX     
TVWBRQEJOWWJ    : XHVHUS          MUYWOM          ARCEAAVJH       DAKIFIWVNHU     JQTMMAT         MNCFRETSYRKITV 
KLMPXINJ        : LBWIIGR         CNDJSX          COSLR          
JLIWWASCNPAKSSD : DWQVWGFU        XMBFNBX         GTRNJJICK       GKSDYCUEFSN     RESJERDHQCCMYHR KFNW           
ERWDDXPRMF      : RXHSVEH         TGBXAFQAGCMYWG  EEBRDOV         MRJANNPL       
USBMDMUAMWUQKK  : DATHJPUSBKNTCO  NHUCVLWG        JTHKPMTNJYQC   
WGMBGSUFVYDMQ   : FAPHRJW         MLFYVMEPMWK     DAKIFIWVNHU     XEDYMHFYTSOJYYT
TINPLASYWULT    : GLBPXL          SCQELSLRLQVYDQI
CGFVDLIERDCW    : JFTISJHEBPH     PSBIGWXGXHETL   MVKNMDEIDE      DJASH           YKVX            PXNJNAQKQRBYACT HRMG           
BAOTRKEFAP      : GTKU            PFSCRQRCC       TKYY            MHVNIJSBFFRBJ   XEDYMHFYTSOJYYT
UQGPCC          : KABO            PFQQC           LSQVSK         
HIPFOBQUUTW     : OPTUKVXOY       MUFCU          
VATMTNXAVA      : KBCSPDHPTKMWQH  SGGWY           SLCQG           KTUKYAR         NIEQJHOP        VTVEPESAGVDP   
DVHMNMOXVXPB    : XYFGYDTHR       QVKO            VRHPYG          NNHTAIRURMQG   
STJNOHHMHDA     : DIWYFDED        NSPISAJE        ULCHGRT        
RAENAWSVHFM     : GFJCJLLBTMMQPLH UTKUI           QXYJDCKMUP     
UKRUBUJVPSKG    : VRNHDUBA        AGHSB           UCCUMA          UDORTHATOKGKN   WSRHHTM        
TSKXUOPUSDX     : SNXVVVRAB       GUQKADWKCV      QUDKIFNHVFUPJL  YFTO            KWQN           
VTAEGVYTNV      : JOFXWNLRLHPNP   FKMRUYY         QBXEPE          MRGW           
KFSCXFIBAEN     : PLAJM           DCHEXTRYXCY     MGGOJYBJAAPHMU  NXMHPFPHTEXMBPP TMAYB           QWJHIQLOGUR    
YCNWWSUPQQPU    : NLFJFPXBDSXOOYW UXQQPUXO        TSNJVSED        LVHTG          
LVTBRQOWLSXRE   : TJNHDXCESGATBW  ATRINEMOJDLUS   YERYTPFXTFV     RLTANQIFWUKLUFN QCXPHWE        
RIQPJSF         : SARMI           PPBSOQG         FSHQ            PDEDBB         
RABKQSCOSQ      : PEXBPXLBIV      HASUBVRHV       PMJDDF          DRJBTWV         XBMC           
OTFFIESCEKGHCQ  : RQJLMLCMYC      PWECIEBWNQWALHJ EPEMM          
TASBJNBMXU      : LVPN            RHYUFAEIIRJT   
ALCQXQLFX       : PXTXLDYNK       RRUEFCVKGGDM    WOSAFHY        
KRAQCGBH        : BUNEFVXBJJOH    CGGPBGBJBN      OKGY           
YDCUFLIGXIDGIOI : IJCRSNMPGWMHIGN EPFFDAXR        MVJLMFSV       
NCNSALFRMYWSAGU : ULRKR           INIGTAFTMVLVVD  EARCHYXSAOML    PMCBRAVECSQ     DNUI            RHYUFAEIIRJT   
JWVOKGXIOBQXS   : KICBBJFMEQUF    LNXD            BLXEINVF        MEJPDOTKWI      TNJGAQHLY      
CGGPBGBJBN      : JLKSLWGUGUMS    PAJOJXMBMA      YLUXFYPIWD      LQVWREOSVQUJ    KRAQCGBH        NHNCJEO         OMWPYGQPJ       DSIBTAHHHUPTL  
AJIGGJRD        : KSPEGJP         MWRIEBCVGH     
JPOHXEKREDV     : EVEIUMHDJICLV   DWXNN           WFWBMYYJAL      NIDQOXHP        TSTDRXDLESYDTB 
LCXPKBYNR       : PUCFBBR         LBWIIGR         WNPWCOMNI       EEBRDOV         TVAYNV         
NDPVJ           : KDPYKGLKY      
OOJA            : RGIOAYGERLGYF   QJQBHHY         EIKXPGTQK      
BJEF            : UXEONFUWJG      NMMXVPEWONQRABT FANQMQJMQEEWH  
XLATRN          : KQIUX           YLDCTQFGBEJ     GLYOXN          YKGBVHAN       
PDLQCYIJNNBLWFA : JHMQMSU         JVWNXOLXLMSJSJ  PITMICKSMCVKTR  XRYXDDHYYYIILYY UUJTTFKTTNTMSW  GQGYABBEXK      OROBUOKXTKXD   
QARRL           : KYRFN           JFOIQRULUM      KWJTJDXAQHHK    EEXSXFJJ       
WGUKIRCV        : XNHQPKQIPP      KCTDLYOIPIMYV  
TADNED          : VTGO            EIKXPGTQK       GNDLHNQGR       PWXEIPCHBK      RHKECE          NHSJQMEIE      
QSMREJYFXQ      : ETNJRIRLQLRTLWA GWCEE           FDACGUBSGLJ    
PITMICKSMCVKTR  : PDLQCYIJNNBLWFA VVIJFLGRASPORG  OMWPYGQPJ       DKDA           
AFRDEIVQCA      : SJPC            RQSGJFESABECXY  SYYCJUAHAVXUQLP JKEUDMXB       
CHASRQBLFLPRFE  : SGSOFWANBO      BDLCSMIRDFTCH   HHYSYRXDNB     
DOQUCQBT        : CIFX            NFKTVWHRXVHNNQX JFVFBDBIROGK    CHFPRQTQQ       UHTODDJDN       EIKXPGTQK       FDNUIG          DUUQHITXUKPWL  
FERVGTXICYDT    : EUBMPTQU        MGCHUIFU        ROXLSWYOVBPR   
HHYSYRXDNB      : JRTHQQAP        YUWCBGOJ        CHASRQBLFLPRFE  VVIJFLGRASPORG  TDQVOKQSMBPVI   RJRQ           
GYTYA           : VQWRIAHUPGBNQRK JFOIQRULUM      SNQOPILMHVUNRC  MCTOXUJGAWUD    OBUVR          
UHTODDJDN       : OWDPSACKADQM    IIDGYDDE        DOQUCQBT        JWEWLDUBHTRX    YKFVFQWUVGNSOPG
ERFVYOXTN       : RUPH            PIKJMIBEKM      TWGAIIDGYWJT    VGRKU           NBHENOCRMGBHLQ 
SQDVKKUFJWWHERV : HEUOJTOABVSETNS DXRR            TVPBTARDRLY     KWJTJDXAQHHK   
UFNIS           : JKEUDMXB       
CASBOQVE        : QPYLXYVWW       QPHLEYJDQNUJLL 
QULO            : TPRCSANFBWQV    QVKO           
XMNKJKRQ        : POYVERA         KDEFN          
NABVPKOKM       : NNOCAIQWPHDTJ   MJILWNKEJDJ    
DQGVOLCHIPX     : MJJPW           FBUJVCVRFRMTX   OOXPTNVOFLA    
OKGY            : WVMG            EAGTXVABPCQI    KRAQCGBH        OEIUAFXLJKYXLC  WXLYTDOYWBJ     DYEIBOTJWTLE    RBMLDMPHDIMKF  
TQPXG           : WYHSNHTJCYF     BLSLFBOHI       IXBFQYKFM       TCYLKLP        
ACIMTSYJ        : FANKCQJALHJ     LJKEWXTSFELQKV  DFBCRTHEJIT     IQPDRWSQ        GHVRCYARYXY    
RPTGDXNMNMDEYM  : UYLBDRU         CMMLVPQGJQEY   
XGTN            : AAPFIEBTYW      OBDMBAGC        NIEQJHOP        FBIEELMKNNGK    NHSJQMEIE      
DEGHMUBHWM      : NMWG            XSSUEPCVBBTSYHU XEFK            MVLM           
OFDXIDNUQCBV    : IQBHDGB         SHHDUKLMBBEGBH  JQTMMAT         GFMSGEVHSXTKX  
NBAVXQCBWLI     : DWAC            IIEJ            LCWNH           OTQBLBO        
GKSDYCUEFSN     : HJRGBPSNNVYRSS  VYBSOYEHEJ      JLIWWASCNPAKSSD JPCGSKR        
GKBJNYN         : LOJBTKC         KIOELETNXAS     HPBISFD         VHIA           
BPYYGE          : PVDBBTB         TWLOT           JECEFSGSUWR     MPCMBONMLXNIHNX QHNJKUMHELTXG  
DPKOXUHEULYBQ   : NSCJBJXSGALVCJ  JWKQRDBUOLYSNOB RIGYEBG         IJGPDABU       
OBACDJPCWVFN    : NQSDNUGOPLU     QFTCBGUGO       DQILKYFROARH    LVHTG          
EVBGASROROY     : OSLGVJEM        CNQNJPO         NXMHPFPHTEXMBPP NOEDXMCRFSEGS  
LKWNEQEFQGIDYN  : WGFTOMMDM       IQPDRWSQ        SYYCJUAHAVXUQLP ONOFQNPMSSQO    KGKES          
USRRAOVGOOAFG   : USQFAJVSIGPY   
EEBRDOV         : CTTTCXBGRKE     LUVJILCTEM      ERWDDXPRMF      LCXPKBYNR       AATNKEVPYQGIXU  HKWITMNKSCNHHVT
VBLCMQDASXUN    : JAJVNWU         MJJPW           YKVX            JHSKYSNWQVKUMG  UHSKJJSRSBJORB 
UCOESDEXMTFSV   : TNNE            BHHLTMW         KKQVTNUNNCCGJ   YLDCTQFGBEJ     OAYAKMWI        HOUE            YPVNPLCKTUC    
WMUQ            : PFIFJWBDVBQDNVU BWFLJG          EMQFV           KWBATPQI        MVLM            MJYDMY         
VENKUQKQRIEM    : LQSJNR          HBVSBNNUBBCLNB  DMSQMPTCS       NOHECN          LYLYGRAQYALJD   FOINN           XFTGSPDHYMUTD   TWGAIIDGYWJT   
VENKUQKQRIEM    : SJWSNNIJBL     
IDHBIMBUIGOGF   : LVPN            VHIA            OCQXQDNYXYD     AWVYYNJVVOC     ADBASKOH        MMCPLSD        
TAEE            : DEKU            IIEJ            FNPXILATCEIYBX  NEFYJLA         TFVNATAKUPQH    TNHIRE          DGYNAJYUTXNEU  
LTJINUBH        : JFVFBDBIROGK    KMPWRTCIGNSW    TMPMLIIPQOEKNWC
FTIP            : WWGRJFPSHCOS    SVAEL           MCOBVPLVU      
SSFHUDPDT       : LHXFAR          ACPNTNCCDYRUY  
JHSJNYIYTSIJPJQ : AALJ            VBQBCD          XQOTIGTAFO      GALMXIVIVYKA   
RMFHLXDQFXV     : KONLVH          QSNOAAWHXKYPW  
BRUKYNWNMFOIXYR : RHKECE         
JIKDUQ          : GLXXY           ORVNOI          NCQKT           BKVHKB          XRIKSE          DUPXL           LJKEWXTSFELQKV  SVALA          
GQPAWNXURQ      : NOWMBXLPVG      GHNGWRDCBID     EUHUDIRQTLCD    TSTDRXDLESYDTB 
EPFBFRHWB       : KOBPLERMND      QBXEPE          HICILUYWXTM     EBBSYSRVFAIJTKF
VSXHEKKBBAISP   : WYHSNHTJCYF     PVCII           NAUKL          
RGIOAYGERLGYF   : HLEMSPVH        XISHDE          OOJA            IBDNGFE         MVLM            QPDDKFU        
VGWUCWCGINJLNRG : XOYEYKGMGEHSRQ  JFIUXLYCHDVEW   FOISYPIGNQDDAPL VOXWPIMVHRCNKK  MJILWNKEJDJ     MJOMWMBOSB     
EXNNONOUSIIYI   : KFJF            IMASWWXSNWBCXUM SBCECHAUNWWQ    RLWAYLKUJX      GFMSGEVHSXTKX  
OGUNBYLEHVTRH   : IJCRSNMPGWMHIGN KMDQXWJKPVWHFQG BGJPFIUTTIKA    HFBEYKL         AQEVUFXSBMNC   
LOOQO           : ARKCITSAT       XIGQNIRBIUTYA   EGKMHQJNWEKDNUL QWASVI          XJKUVTYJ        DHCQG          
EGSUBLEKMOBB    : VICIFWA         MBYGOXDCIOOL   
XRYXDDHYYYIILYY : PDLQCYIJNNBLWFA DSIBTAHHHUPTL   VICIFWA        
OEIUAFXLJKYXLC  : JFOIQRULUM      OKGY            DJJNKXPTFYFXVRV
KTUKYAR         : VATMTNXAVA      DBDFEX          LIIYYFJLHWCHNB 
BTJJFIKJYRTV    : POSHJLS         RUUAKTXYYXV     CPECHI          NHSJQMEIE      
BWFLJG          : JCVUF           LJPAEWDKCBJTW   WMUQ            KNAEGFCFBCIFP   HNERKTKRKHULHCW VLKKYM         
VLHIFE          : TEJLI           FPQYSW          IVHWJQIKTCQKHF  EPEMM           QFOSUEIISMOYDVC HTSWIJ         
HEMHFGQQNCEYD   : HRCLSVFD        BSUTKADQCQ      KDEFN           RXCSRAHRUUSAM  
UARWWWIGGT      : FFXXOFERD       WYQAIXNVMK      HGDQEA          MVKNMDEIDE      KUOP           
REOWIJEN        : TQSQU           KFTLV          
OUFFOTJ         : ALXODWDEU       UHTSMLIQSNY    
SNQOPILMHVUNRC  : BJDXSWBRTSV     GYTYA           EUCQCSBT        ICFNJRYEBMXOTWC UYXGU          
VQFFDL          : VPAUSWW         MSRIWBJN        KOPKIRUHR       EXNQXMYJSDCXVKJ QJBJXHXCGSFJROC
AAPFIEBTYW      : TGJVYNUO        XGTN            NBWXBMOXVIVIDHX ODTMOE         
RLWAYLKUJX      : TBIRYXRQST      EXNNONOUSIIYI  
LGLELQHY        : NJHGSMBHTRX     JMQBXLEFSWFOFE  LIIJQJTHPNW     HRMG           
JADRK           : MSRIWBJN        OAFBYQOFLIX     HFXBGTMICGVIMD  SXTNMMYBRSHJ    LTVFYGXCIYRSIMM
SEJPOCDLEEAOBJ  : YGRESUEX       
QWVCBHULGIW     : TMGUGJHYEYR     SBCECHAUNWWQ    XOPIUP          INMHINRJDUTLCU 
NOSXKAKCO       : SNXKDDFJJMEPGW  QLBJIKX         BVMTHMPXOCTGAC  XEDYMHFYTSOJYYT AQGMN          
IASMCKOL        : WYHSNHTJCYF     WKSFEL          BKSUAKHBSY     
FIVJMFEANOWWCOR : EPEMTRXXMHMFP   OMBMTFX         DUUNWRVDM       UMCABN         
YRPDGELJY       : UIBJVMBJFN      ETGROI          OAYAKMWI        NMMXVPEWONQRABT FABSDWHFQR      IGYYHK         
LJNAJU          : WMHA            TVAYNV          GQHRQHJBC      
HEWOKYD         : VPAUSWW         AKOBLABNTNNCC   PKHNAXFQHJ     
WCFLTIMO        : UHSQ            AQQWUKR         MTUWKYWHOTLL    GBJYLCFMYVSJTUL NTMQSIO        
PWECIEBWNQWALHJ : NSQPXTIPRM      OTFFIESCEKGHCQ  OSHO           
HYEGCFF         : VQWRIAHUPGBNQRK JPLRDFHQASGXOIV RUGPQOL         WXBJWNQVUMYCQLS USLSHUGBRAWXX  
MSAVFOXVMDAUJDT : JAWVASK         EHNTYBEJIUYHJ   AQQWUKR         MANAKMOLYAJKCKC XQOTIGTAFO     
TQYHBLYIK       : PJYNKXLAKLVLAY 
QOKYU           : XTRXKH          IPOG            RJHPYSCWA       DSXGYYRGLO     
RUUAKTXYYXV     : BTJJFIKJYRTV    SQJDT           KLQWB           QWOFAKRRKO      WCJQPRHMRJ      SUPIX          
BQHWJHEKUD      : TSUUDQJ         YGAI            LDRFGFICRUOA    LDHTWSTKFYH     XRIWK           UWBVGJJAK      
FIOVUNQRHLPHXL  : YVUOF           FUPWVX         
YKFXSGOA        : BGBPXNEWEHDBSJA NOXVIWNIBBKNVLS LDRFGFICRUOA    INMHINRJDUTLCU  BFVHTQ         
AJJLEOGLWUHTKA  : PXFENLIELS      PWSRM           EGKMHQJNWEKDNUL UQJFRGKRKUACEVT
SOEAMPIOC       : XKBM            MGGOJYBJAAPHMU  PIPBMACTAHLVA  
MUWDUCDHO       : SJHWSKGS        CWPJN           FHLMUCQNO      
LDAADWJWIKLDYR  : TNCUGCSMGMD     VXBKOSOUTRL     CCAFMSC        
NHNCJEO         : WMHA            CGGPBGBJBN      MLFYVMEPMWK     OTSFWYTABE      AAAQEVW         ELOAS          
DTEFALVQYAQY    : WBOBBBPEMSHCMU  OTQBLBO         VOSGEHI        
QJAYVMCUEHIOXL  : TIFOPUBRNAV     CYTMYIPLKYABRYY KYMNGAXNO       VLERVV         
CCHFWNMYYJPXJJA : AATNKEVPYQGIXU  SROIXE          KIAI           
ALOBHDDCKMK     : OPTUKVXOY       UKGPBKUTECT    
KXDODMTC        : KCOLPGATV       DDVLANBST       NUYPDYGNU       LOJCIUVC        AXJXK          
JBYUQAEC        : FOISYPIGNQDDAPL VEOGNWVQW       WNRBVWQAVHTERT  LBFUWUFCMDTNCB 
UCNJDUPIYC      : SBMBWKQGVKGDEDK DGPOOPE         JRTHQQAP        FOJRQKFEILLK   
LDIKIAPVVRVF    : VBJB            CXBWYTEKFMKJDML BIUS           
XALAGOCBQPN     : OQNQL           JMRKUHOXXEO     MHLFW           QOXVWLBXYXDPR  
MFFLHDWMOJUO    : EWFFYKPTKT      DYGWQBLQF       HQDPDWUYQ      
QKQPQLNSXNA     : MOLEXNBNI       UKAOCDTCJOES    FVNQNBWIROD    
RDFJQ           : OAMGLMN         UOMGAF          TCYLKLP        
VVIJFLGRASPORG  : WNPWCOMNI       PITMICKSMCVKTR  HHYSYRXDNB      BKDUCINNUHAS    VIGABSJP       
LXSWLLWBNJ      : DFBCRTHEJIT     JFOIQRULUM      COUUNCCAEQRSOA  KBXPORVSQR      FLDAQVEWOECHEYL SHBBHSLHT      
RPEKRAHC        : URCRJCAHBKI     GNDLHNQGR       PMCBRAVECSQ     JQTMMAT        
OOSHQLWIFFK     : DVXFNEOVNHWX    ERVPVNEUOML     EKPYBD         
EFSRSPVHC       : MHLFW           UOMGAF          IRJWTQCKTP      PUABPUIATBSIDMM JBVVI          
BTVLLXUQKKFDTX  : CNWKAKX         DXRR            VLKKYM          DPXWEQCSVT     
SIXASTGXOBREWB  : IMVNTULT        JNMAFV          BHMY            AINSXUD         ADCUDGP        
PCCNN           : FHRMYQ          QGWKKBKINTUMIG  EXXBFFCJG      
MLFYVMEPMWK     : UJUAALPJCS      VLERVV          WGMBGSUFVYDMQ   NHNCJEO         LIGVFRDHQT     
UKOQRPF         : YTMG            GLVXEGGXXTSGNI  AGGAXBWSYPWOQ   FHLMUCQNO      
JMRKUHOXXEO     : XALAGOCBQPN     VOTI            YOEFMHNN        ECUIRLCQFBP     RXSAXD         
PVLNK           : TMGUGJHYEYR     MVAKLFXD        JGCV            DCJA            IGFW            OTWSQCRJHWU    
FWMPS           : IOHJMROUJTWIN   YLDCTQFGBEJ     RGAUR          
BKDUCINNUHAS    : EILBEYIGCLCDNPL VVIJFLGRASPORG 
OQOSFBLDMY      : QIQRTMRNOMXTTV  NSCJBJXSGALVCJ  FPQYSW          SUCJFW          MQQWKO          PJYNKXLAKLVLAY  HREGSUDSWVPNER  NLJTUVJAMRN    
EFKSU           : IJADHTAXNNS     JAWSAOCYYTOXNCA DGGRLOMVSFATCM 
FXSISWS         : VNAVFDIRBUV     MEOTKG          EFNX            MCOBVPLVU      
KQPKJHYCXTJAF   : XABEHY         
OHAVMM          : KYRFN           DCHEXTRYXCY     QMUNXVSSUQBAFE 
JUTINEDMXMWOEJA : UYXRQYKYPW      BWYUVWDCDNA     LSGKUFQEOQRE   
KCMFLOMXDVAYIMQ : GTVEU           OXGOENHPORESJYN XXLAMMBIGC      TNJGAQHLY      
IMDXRGLRUKIC    : XOWUTYPMD       WVMJAFWF        EKWUU           UBIISVLLKWTEED  NPQJ            XQOTIGTAFO     
IPFKEMXSCXY     : HOWEXQRDLBTJOQW QMUNXVSSUQBAFE 
XAHMQCUEHVXP    : VRNHDUBA        JVUVYBEFHGDETO  QERILQ          YCUBOS          MCTOXUJGAWUD   
RLTANQIFWUKLUFN : FFHGETPDDEQICT  GRJVFPV         LVTBRQOWLSXRE   DHCQG          
EMQFV           : WMUQ           
XABEHY          : WCJEASIMT       KQPKJHYCXTJAF   XEDYMHFYTSOJYYT XJKUVTYJ        BVTC           
WIVKEVAVGGUD    : UTLKBWYVMTFITP  KPSMESDCOBC     NQHFYYNOOG      YOEFMHNN        VBARGM          WDOB           
GXXUSF          : MNWNUUUP        JHYNYKFRUI      PMJDDF          QEXNUWAYVTR     VLUDGVUUPUTPNSM
LMHRMHURQTVPE   : FCJVDTUBMALND   FTBPOT          XDIK           
DIQD            : MMLCXROFYYO     IVQFGTOCGSNNIG  UXLAIGVNIJ      PMUMMYE         RJRQ           
ALBFEIEFFWMQJYX : UGJLRTDKFH      QKJHVTC        
LHXFAR          : IJCRSNMPGWMHIGN CYTMYIPLKYABRYY SSFHUDPDT      
RVYUGPYNRKO     : AQRGUVSHSVWIIGA SADNQISUM       CIAKPFVEJUIDSA  JXGJTLXHXBDN   
RYEWEDJUOKUR    : YEWI            UGJLRTDKFH      GKGSASHWNTUNRH  JPCGSKR         KTKWIKA        
CPECHI          : WISCEIBRGRFP    BTJJFIKJYRTV    QPDDKFU         TCYLKLP         GKKOJ          
FHRMYQ          : CWSAVAPSGNKAS   VSHJEJEA        HBHLNH          PCCNN           CEKNCGTY       
REQRXQ          : KCOLPGATV       MWYDDBJFMFVVYH  OIRCQILJCSUDW  
UWYGUOSPGQSW    : XRNWIXXNARUYDDO WQGIXACSRE      QILFYDMF       
WGFTOMMDM       : CIPTWAO         LKWNEQEFQGIDYN  YYWMKYO         WYDHDGI        
FGLVXJOVGM      : UDYPDCWQVQICO   OGYCYULMU       XRIKSE          SNDOXKQBDBRNHO 
MHLFW           : PJHPUPUXREDGKW  NCQKT           BVNP            ETNJRIRLQLRTLWA NUIE            XALAGOCBQPN     EFSRSPVHC       LWFVJLOFCKVVQ  
YRRTRAAN        : XKREAJAP        LGGUKBMIGUSI    DGYNAJYUTXNEU  
OARDIWJV        : WECVQLIYRSR     HPBISFD         UKCPFTXV       
JGKFMYBC        : IPERHECIRTVCQ   DCJA            MRGW           
OJIHICBF        : IENV            XCGLVFNCQXAP    DUUNWRVDM       WAYWFJH         KAVPEVKE       
CHISV           : FAYTLNJBRRVFIOS IBMPWMGPWOPXP  
NAUKL           : VPTANYRLYRBM    VITVNI          EXYCYWJWVNGQJ   VSXHEKKBBAISP  
IVXVDMUGOG      : JDPCC           XKYLNGS         QDLXNPHBCLUQX   YSTWAQGNF      
BOFJQHOLLX      : AQKYTPDDEDOOXQ  PXWWRLT        
GUITWEHIVPGVNK  : OJDTNGEKKMLJ    JVRQ           
JQAPMBGSM       : ONXPFHT         COMUSGSKE       FLDAQVEWOECHEYL MNVXREEPGPYHI  
CEKNCGTY        : FFPNKJTTMPF     FHRMYQ         
QVVXFT          : HOWEXQRDLBTJOQW OPWBNUQLEWURWF  PERIRPKVYAQCQ   JJHPMADRRJBW    DGPOOPE         HBQQSEQ         YETBITNFAQDTTO  MBYGOXDCIOOL   
LREXCP          : KJSXUNKWUSHU    ICTJETLCTPSHRL  SDBLUKVRXMIMMHM
EHCHNWUKYBXMDGJ : BLSLFBOHI       GLLRTGBMPKTRA   RMCDALGRFFAP    IAMEJHNRKB      BJUL            SPIHMHV        
XAYTAGP         : RSKCNV          FOISYPIGNQDDAPL KOQROVWCD       NXVTSEDM        NNRCGA          QMUNXVSSUQBAFE 
UHTSMLIQSNY     : KELJXHLJKRT     DPNFW           VLERVV          OUFFOTJ        
KVVKWTWAAIFY    : ABFJQ           XAJDBYNNVITL    SJWSNNIJBL      HIPQGVNICBKT    ADBASKOH       
HUKNLBIUWCJ     : JEDDCSEM        JWKQRDBUOLYSNOB JNMAFV         
MBEAC           : LOJBTKC         EGDEXSPEPHJPE  
LXJVWD          : YEEACWVSFHWKTM  VHVCP           KWHFW          
WFGFEOMCCA      : OPTUKVXOY       PJYNKXLAKLVLAY  BVTC            AQEVUFXSBMNC   
DLKAPULCXQFAE   : RALXKK          QDYGAJSQJRJL    VFPCCHGXB      
APQWULVARB      : HQNEUW          YHQJE           JSISCEVJJOMVY  
JPJLSYQELS      : KCOLPGATV       NVIEDBXAFQTKL   DBDFEX          DDLOFVGSBGAWHY  XQOTIGTAFO     
IFAGXFIEXK      : LJPAEWDKCBJTW   XRNWIXXNARUYDDO ADATCW          SXNVP           WFXNP          
OHODGOWJVIAH    : IMJXVRMVILYEW   FFPNKJTTMPF     KSEWFCEVCGD     UCJG            MYEHJAO         LKBKWKBUHAMUTN 
SGMYSGUDN       : JDPCC           DOWRWQTEFXYP   
MLDURDGLU       : RCAIMMBJRFDB    NTMQSIO        
CAVSW           : NQOIKLYMFIFS    RIGYEBG         HCWT            COUUNCCAEQRSOA  LJGYBSQJ       
RIGYEBG         : YXRQPNXD        WYQAIXNVMK      DPKOXUHEULYBQ   CAVSW           UGBAWEH        
ABCWEPTQDWOUD   : FPXDXVCSWPR     BFVHTQ         
IXMMXJFWPWFXW   : HMYNVOFHD       XUICLMBXUPTLDU  HKWITMNKSCNHHVT
YFGBII          : CGREHHWQQB      IIDGYDDE        FQVDJKSK        YUFQIHYJYT     
OXRIDRW         : DDVLANBST       RJHPYSCWA       MDEYJHLWUGMHHFB UDBSNIKQUHKYMG 
UTKUI           : QUCVAR          RAENAWSVHFM     OEPDR           HKIGKOIJVPKDPU 
URCRJCAHBKI     : RPEKRAHC        TIHA           
QJQBHHY         : OPJWOOYMJGV     OOJA            RFFCF          
PEVOESIONR      : SYBO            NTQT           
ILPCVTCFUOOFHX  : COGLBXLQIUFLCPQ MMGLVFNH        MPAPRCXPWBFBVB 
IIEJ            : HLUYP           HADLLUQOWJPMTB  DXRR            RSAPANAXCBNYLRC NBAVXQCBWLI     TAEE            KMEQROPGXIMU   
VNILTBVKQPXBC   : OKJM            BYHUWGURAVWQ    BPMTTGAFBNYOEWO
DAKIFIWVNHU     : OAMGLMN         HGYIFYUKBXXNRD  TVWBRQEJOWWJ    WGMBGSUFVYDMQ   XOAEN           QKJHVTC        
PFSCRQRCC       : KNTUPDNOCIARGO  BAOTRKEFAP      RXNC           
DYYTQX          : QQGSRGCFPGIS    JFVFBDBIROGK    OFJEFOR         FLDAQVEWOECHEYL PEBHOFDANFUWBCF OTWSQCRJHWU    
SQAUDIBLIWCPT   : UKLIQMVRCEO     YEPWWOKORHUSKQ  BBYK            XEVJLTLQCJYPF  
HBLLSCEW        : LELNXYG         YOEFMHNN       
SAGRVW          : BQLBPJQCIG      WTIMW           EYTSURPAMBBN   
SSIV            : ALBJHLKMWJSY    UJTNYUGNLNGYU   JREYTU          WRRCLPFIRKHLYF 
MEQAOOCG        : FLCXM           IWGXUFYTBOQ     IWQSBU          BPTVYASRBEQCJR 
UOMGAF          : RDFJQ           EFSRSPVHC       SNDOXKQBDBRNHO 
GFQYFYREVJY     : BUNEFVXBJJOH    HDEHPMNOQNCH    NFHLGSHJQADAYJ  XYNFWESRFO      RTXUBYLLSYGGYEC
UUFHAVJQMOXXJO  : INIGTAFTMVLVVD  DPEIOWBAB       GDAPKKTUEPYS    LPDOICM        
QQRCXWUYFTQLR   : YTCAANGJX       MUYWOM          RJSPCDRDCFXLF  
KJXGQHIOQYEFYCR : ULRKR           WMBJ            EEOADGEUE       VKBBEWS        
OKHIM           : FWBCKKBCUJSVRVS BTTPDKFAXGRSJS  RQLWTTJPEQB    
IJGPDABU        : SLCQG           HASUBVRHV       QWBMOBUXLDT     DPKOXUHEULYBQ   CJYUTNUS       
NGDTYMEOFGSL    : ROODJLRTWEVRDP  NDVBMPCT        VLERVV         
WFXNP           : EARCHYXSAOML    IFAGXFIEXK      ENENJGV        
VEOGNWVQW       : OBJE            TSUUDQJ         ARCEAAVJH       JPODPLBHIN      MEOTKG          JBYUQAEC        PDEDBB         
NANW            : VIUF            KOPKIRUHR      
JVRQ            : HJRGBPSNNVYRSS  GUITWEHIVPGVNK 
XWFLE           : ODTMOE          SRHWEJLUV       DYLKGMLIPCT     FNDOPALEHJ      JVEB           
QERILQ          : XAHMQCUEHVXP   
AWAXVSUUIXKFF   : GIMNOA          XTBVGKLM        LIHOOUSSEBOUG   FNCQTVODYD      PIPBMACTAHLVA   VICIFWA         IHOAWYJAUNY    
EXNQXMYJSDCXVKJ : OPWBNUQLEWURWF  EBBDTQUYKRKOUQA VQFFDL          LIIYYFJLHWCHNB 
YMJBKH          : ODBDBVNDNVQY    JFVFBDBIROGK    LKUE            WQGIXACSRE     
HDEHPMNOQNCH    : SBGCKIJFVC      GFQYFYREVJY     KNDXQIJ        
QGWKKBKINTUMIG  : JAWVASK         MVUGF           PCCNN           LIWHUPJG        JWEWLDUBHTRX   
SQJDT           : RUUAKTXYYXV    
MLCCBSPFDDWLC   : GDCPTKMQW       DBDFEX          NNHTAIRURMQG    TSTDRXDLESYDTB  YEEACWVSFHWKTM 
XFTGSPDHYMUTD   : PNBS            FAPHRJW         YLNHO           VENKUQKQRIEM    FNCQTVODYD      ORFXMHEN        OUQJGVCV       
YYWMKYO         : IIDGYDDE        NITAFLNHMLNNUU  YERYTPFXTFV     WGFTOMMDM       ADBASKOH        ONOFQNPMSSQO   
UHTX            : DCJA           
SJPC            : YSTWAQGNF       KKQVTNUNNCCGJ   XAKGEGAOYCTNWIF AFRDEIVQCA     
UXQQPUXO        : NSLSDVNBF       YCNWWSUPQQPU    QOQVKRRUAWQF    STEJBRKVRIIC   
VLMC            : LJPAEWDKCBJTW   OOXPTNVOFLA     ROJISCRDECTQW   DNUI            MVAETXYX       
NBWXBMOXVIVIDHX : ABWI            AAPFIEBTYW      MDEYJHLWUGMHHFB HFBEYKL        
RVFJMUGKMPIXC   : QEBPCHWURDBXPII FGLQTLU        
IPOG            : OQJMFTERQEVFW   QOKYU           TFLXHF          AHPGHIPUHUBICMR
RUGPQOL         : UYHFCPY         RNGEO           HYEGCFF         TCYLKLP         ULSDYBFXFCG    
TVAYNV          : PVDBBTB         VTGO            YHIUSE          LCXPKBYNR       LJNAJU          ERVPVNEUOML    
WKCDWOSGM       : JDPCC           POBBXFRWV      
TWOKDHDA        : NCDLFJYBOOGHOIA SADNQISUM       DITWDYKYSXTHSSD KLHMINWQAO     
SSFHUYD         : LQOE            KNGSPQSMHGSS   
BSSHQDL         : BBCDAYQNTWULFU  TIWELGM        
CARIOQEMGP      : QFFB            HLUYP           XDNMPVUGY       FEXALHBQJKHSKH 
PUSDPNKYI       : XQUDJEDFFAAB    QWBMOBUXLDT     MWJOLOJAE       FHLMUCQNO      
EFNX            : GTRNJJICK       MYEHJAO         FXSISWS         OGVFEGQG        BUDXFMQRGQHCL   XXLMQT         
UQDHM           : UFBEFXYRTHFU    HWLLPPULNDRW    HIPQGVNICBKT   
JEQBVVPENHTK    : WGBGQNLGHRX     KAAOLBFVHP      JRKIYYYQTY     
YAQMAYWEFME     : HUJQIR          NYGRKB          KNDXQIJ         JHVBVRITINLU   
HUJQIR          : RCJAXACESRUBYR  RQJLMLCMYC      YAQMAYWEFME     VBARGM         
OIEKGTQV        : VXBTOSOYK      
MGGOJYBJAAPHMU  : UDYPDCWQVQICO   KFSCXFIBAEN     SOEAMPIOC       LYECJWOHREUBO  
VRYNAQ          : AXWBP           HQSTESRYGW      LDBCSFTRXNEERO  MFYLQMRKQDISDB  QSNOAAWHXKYPW   DRJBTWV        
PBYCKU          : MAMKTTHKGJPDT   PAXJVL          VHQPCEWBLVOPJCP WXLYTDOYWBJ     WQXDSB          OHXNPRAQ        MCOBVPLVU      
GXIPGW          : TMGUGJHYEYR     XISHDE          UCJG           
FXKGACPMY       : XAXHVGFTD       FGTVQXELCMU     WEJDV           HMNBJEGKHCKYR   OXLHLKSQIX      GHLEMKPQ       
JREYTU          : JLKSLWGUGUMS    QIQRTMRNOMXTTV  SJHWSKGS        BLDVJFPUJ       KAAOLBFVHP      WNPWCOMNI       SSIV           
LYQQJLMRLWH     : RFFDNYGWCMXDDET EAGTXVABPCQI    JRTHQQAP        HIRVGLDSMMA     SPIHMHV         XBPEULE         VTVEPESAGVDP   
UIAUUIVA        : SYFQX           MTYJ            PSTL            ADYLUGDXSBJOERK
KYETSJUPGMBF    : EEOADGEUE       MQUCBSJLTMOJLY  QJRJOWXSP       MUYWOM         
RQSGJFESABECXY  : PGYYXHQWTJBC    AFRDEIVQCA     
VYKHBQDTAYJH    : NSLSDVNBF       AGGAXBWSYPWOQ   GHAYLF         
NOTHG           : APWIXEBNETSJ    DVCVYWKDEI      JUDMEKTQWTJBPEG EVFUF          
OPTUKVXOY       : QGBHSYAFDRFHV   YQGOMIXEVJ      JOYLQ           KONLVH          HIPFOBQUUTW     ALOBHDDCKMK     WFGFEOMCCA     
OMWPYGQPJ       : XBFUAAPNKFXYDOM CGGPBGBJBN      PITMICKSMCVKTR  WTSWQKQN       
QKYAYMOUWUJLMGI : CWSAVAPSGNKAS   INWPHWIJAWW     QWOFAKRRKO      GBQG           
EIMDGDPFVOLOHVC : JFIUXLYCHDVEW   SJHWSKGS        NPCTPRDJE       IJADHTAXNNS     EXAOQKQUWDHB   
IEXHSOEPK       : VITVNI          ITMMJI          FYWY            JQTMMAT        
DWWNUBVKHFP     : TQHUXUAXVMPN    WAFHYEUPEWGQ   
KLQWB           : RUUAKTXYYXV     AYPIQPXSYKNCL   DGGRLOMVSFATCM 
UFXDJXN         : QWASVI          VHNDQB         
MTUWKYWHOTLL    : CWSDNXWBMDUP    FFYHNGWJG       CGREHHWQQB      RTNGHT          WCFLTIMO        DBDFEX          KFNW            MNVXREEPGPYHI  
USUTDIKCJI      : DWQVWGFU        LNXD            XGHTAQBBOLYQJ   SADNQISUM       KINMTTQCWHDB    HICILUYWXTM    
RIDDGQI         : PGSQIBLKDBAN    FYFSSOJDFW      GKEBKNNSNKASRV  MNCFRETSYRKITV 
KEQVFNFTIS      : SGGWY           XTBVGKLM        PFYTVQ          YPFWQPJ         FOJRQKFEILLK   
ONALIGUUIEGIVO  : FLXEYFWQS       XKUVVXJ         EEOADGEUE       GSLWCQRRC       XVIQDUHSHGKNK   FNCQTVODYD     
AVEKPQQIOVYUSJP : JCVUF           NSEJBQMUEMY     FGTVQXELCMU    
XEFK            : QFFB            WNVFJBDXRNK     YTBRKOD         DEGHMUBHWM      FQVDJKSK        XBJPYQM         EBBSYSRVFAIJTKF
LFJVLPGKF       : OEPWBMJHGLSHK   FAYTLNJBRRVFIOS
MDXWSPODEMCBHLR : EEOADGEUE       KIBDSMQKN       ULSDYBFXFCG    
KVRWKFE         : APWIXEBNETSJ    MWYUJQ          FANQMQJMQEEWH  
DPOKCVCOY       : NBHCAIVWVBDMMIW YWYQXCJIUED     QPYLXYVWW       AQEVUFXSBMNC   
OTSFWYTABE      : YHJMDVAKENHFR   YHIUSE          HSEMPPJWPGCOBFD NHNCJEO         COSLR          
SQXQKUDPYY      : XAXHVGFTD       NCEFOGL         YUQMUMMFU       ROODJLRTWEVRDP  BUNEFVXBJJOH    VRHPYG          FHLMUCQNO      
PPDTLI          : AKOBLABNTNNCC   KJNA            GIMNOA          BTKFFVFXRW     
KNAEGFCFBCIFP   : YLUXFYPIWD      BWFLJG          JEDUVMRXIC      AXJXK           YNDCWDYPDDLTJFJ
VOTI            : JMRKUHOXXEO     KKPX            TIWELGM        
WXLYTDOYWBJ     : JPODPLBHIN      OKGY            PBYCKU          XYKMMPRS        ADCUDGP        
NWISF           : DTMXJ           CHVRHHORWEKIXP  IHYMBTI         KMPWRTCIGNSW   
WNRBVWQAVHTERT  : HXTLI           GLVXEGGXXTSGNI  JBYUQAEC        LKUE            OROBUOKXTKXD    VLNDAYJWWAWVO  
DUBGLAFMMMDJWXP : YHATDDPWKN      KQMJJIQTOAAMTUH MIRLXNM         CNDJSX          HOUE            PSLFKBXDR      
UFFVBC          : KFJF            HMNBJEGKHCKYR   SNDOXKQBDBRNHO  EEQYPHMXR       JINBYEYGUE     
DAWAFQTMTQ      : NVIEDBXAFQTKL   JOYLQ           FVYMQLJVNG     
CCNHRAVUMVS     : JAYR           
JPJOLMSCQTYQY   : LGPUIJGS       
MNLFBP          : KOPKIRUHR       TGKWXBHPTMOQMV  SPTBFCSG       
OAYRXVETOIDET   : SLVBEJNUCOKUSF  BTTPDKFAXGRSJS 
RGNUYHVRIOE     : VPTANYRLYRBM    DPEIOWBAB       NQSDNUGOPLU     BLYXYHIIBRCIJ   OBRIX           YVUOF           MJOMWMBOSB      HQDPDWUYQ      
CJYUTNUS        : FAYTLNJBRRVFIOS ORKYLTXUP       IJGPDABU        RXPAHMR         XOPIUP         
URNPGXUNRPFBFCA : KEDG            YRTOEA          KWQN           
BSWRYUTLT       : EXYCYWJWVNGQJ   TQSQU           WUOHOBTWELVYRXD BHLT            RSKCNV          NWTXXWAB        UJFCIFDLLDVE   
FJLATHRHYBGTOX  : LAHGE           UWFCAMF         JBVVI           SNFYHFGVX      
VBQBCD          : JHSJNYIYTSIJPJQ PSKPUXLJNGCJ    FUPWVX         
WCVXYPJUHQHUTB  : YVJIPYPSPO     
NIDQOXHP        : CJJAKMAG        JPOHXEKREDV    
EQBHUGNTLJSK    : SESMYPHBHVUCMS  QEBPCHWURDBXPII ULCHGRT         FIXFCJOHA       JVEB           
EIKXPGTQK       : SFQPAHAQ        OOJA            TADNED          DOQUCQBT        SPTBFCSG       
BOYQ            : LDSGFARFT       IULDHGEGPT      QWWS            IHSMTWNSSD      VXBKOSOUTRL    
GIAMBDV         : OSAJGEBNXBXT    YDPI            KQIUX           TLACVG          SPIHMHV        
KJSXUNKWUSHU    : JCVUF           QNJPGHS         TXEDQINRHN      JVUVYBEFHGDETO  LREXCP          USQFAJVSIGPY   
POBBXFRWV       : DVTLHNJQH       FFYHNGWJG       LUOWMCWH        ANUEDCA         WKCDWOSGM      
GGIUJMRIYDE     : SJHWSKGS        XKBM            VMBJCNFWUHSWURB IXUIWQLKFXOQO  
YRJXOFHJPXX     : GLNXJYWMXUETU   LTXGTRTTIW      QSWKWNGLAY     
BWYUVWDCDNA     : KDPYKGLKY       IJUKTUVFKODVCIP JUTINEDMXMWOEJA DQILKYFROARH   
CRVDWACXTMV     : SARMI           PSVBJHJNDGMH    BVMTHMPXOCTGAC 
RESJERDHQCCMYHR : IJCRSNMPGWMHIGN PLGFFW          LOPP            YRKF            CHVRHHORWEKIXP  JLIWWASCNPAKSSD EBBSYSRVFAIJTKF
WRRCLPFIRKHLYF  : JHMQMSU         FQAWNVOOVAH     JMQBXLEFSWFOFE  SSIV           
SJQCPKGWDI      : PSKPUXLJNGCJ    FUPWVX         
PIKJMIBEKM      : MWMFWBNAAGVBGK  ERFVYOXTN      
RXNC            : CAPUD           DYXHM           MSNLA           PFSCRQRCC      
CDKYVW          : NLNAXOVMMX     
YOEFMHNN        : OBJE            YUCAIBFQNCGVBH  JMRKUHOXXEO     WIVKEVAVGGUD    HBLLSCEW       
XBJNJ           : KQMJJIQTOAAMTUH AWFWVOOBY       NTQT            GBQG            UDORTHATOKGKN   FGLQTLU        
TVCQNAESH       : WOPOUI          TKOSKJLPANSOJ   TBGOESIWSSL     OTNSEXLNS      
VUISRA          : MDJR            HOIOCWRWCKV     LPKN           
GFYUOOLQPMDDVQ  : AODXNCO         KXRTBJXMYUPBY   IARYVXCRPVB     RFFCF           SROIXE          VDEXEGRDGSNVW  
TSNJVSED        : YCNWWSUPQQPU    NYGRKB          YVNIHSLINLQGNRI
BXJVPM          : CWSAVAPSGNKAS   YGAI            JRKIYYYQTY      CXCWRAKURCHHQL 
YTQVK           : TDXWSP          JMARYRIQIHQLM   ICJDI           KSPQ           
HCWT            : RMSQWYWLYDT     GPXMSUERHHOC    BLDVJFPUJ       TVPBTARDRLY     CAVSW           QKJHVTC         QOQVKRRUAWQF    NXBPCHKKQYMMO  
HCWT            : HFBEYKL        
ARXXNSNXOICS    : GFJCJLLBTMMQPLH SWCAREUABKVYXP  LQVWREOSVQUJ   
FQVDJKSK        : CXGHGNSDQWBR    EPYRVK          JMLDSTVHPLSPP   JYQHGIPLNXNLIR  YFGBII          XEFK            ULSDYBFXFCG    
LGPTOTQKYRFYRS  : SLCQG           KJNA            GANVLRGAJNWHR  
FSHQ            : LSNHLUWWPU      QSQYQAQCXWOJQ   RIQPJSF        
ABBSYFEKAOQOXGI : SQFEXDRCUOX    
AYYBSGAMCSUUAL  : WQQPVLQJOTBMQPH SJWSNNIJBL     
COUUNCCAEQRSOA  : LXSWLLWBNJ      CAVSW           GLSPFLLKKWUSJJ  WOEDKM          PSLFKBXDR      
DBDFEX          : OMBMTFX         KTUKYAR         JPJLSYQELS      MLCCBSPFDDWLC   MTUWKYWHOTLL   
FNPXILATCEIYBX  : TAEE            PXNJNAQKQRBYACT EXXBFFCJG      
DYGWQBLQF       : WGBGQNLGHRX     XKYLNGS         MSTTLU          MFFLHDWMOJUO   
TKYY            : NHNVCXT         NLFJFPXBDSXOOYW BAOTRKEFAP      IEWXVT          OTNSEXLNS      
OGVFEGQG        : YTMG            YHATDDPWKN      QPJTLS          EFNX            FABSDWHFQR     
UKKUNJXRIGOBICT : HFXBGTMICGVIMD  ODMEDVK         LRTIYOJIF       TNCUGCSMGMD    
VOXWPIMVHRCNKK  : TRLSKRVTKW      NJGETWVETQ      VGWUCWCGINJLNRG SPTBFCSG       
FWBCKKBCUJSVRVS : CJRAKYLOMKWWQNV DTMHOPXKCER     LXOTBUHWWV      QFTCBGUGO       OKHIM          
RJHPYSCWA       : LYNESPRKSVPVRG  ISJGMKP         QOKYU           OXRIDRW         DYLKGMLIPCT     LBVNNE         
BPGLGNIKQS      : PFTGF           NSPAYDK         KCEWASSDQABN    HQNEUW          FHGVPSDMRRFFCC 
TXSDQQXO        : PUML            BLXEINVF        TVFDBECAVAC     TQMWL          
FHSNYT          : EXYCYWJWVNGQJ   NLNAXOVMMX      TBWBTMOXEAOKCK  VTGO            TBGOESIWSSL     LWFVJLOFCKVVQ   LPKN           
DSIBTAHHHUPTL   : IOHJMROUJTWIN   KQMJJIQTOAAMTUH WNVFJBDXRNK     KOQROVWCD       CGGPBGBJBN      XRYXDDHYYYIILYY LCWNH           XBJPYQM        
DSIBTAHHHUPTL   : AYCOAXWLRO     
OHLJLCBJRK      : NLFJFPXBDSXOOYW IEWXVT          BDRSTILRSEKPEJ  VHNDQB         
BGECCMFVW       : CPMGFNELC       LSMRQPKSKYT    
RXPAHMR         : XCGLVFNCQXAP    XISHDE          CJYUTNUS       
YFRIQCTVFFN     : BJFJNBSHM       WVAKGEONEIRRPAJ KMPWRTCIGNSW   
WQXDSB          : NHNVCXT         RXGQNLPQYPRESSO DNGQ            PBYCKU         
AYPIQPXSYKNCL   : TBWBTMOXEAOKCK  KLQWB           OXLPQH          JUDMEKTQWTJBPEG PSLFKBXDR      
WUMY            : IJCRSNMPGWMHIGN RSJGDSCAHRHAJ   CCJIUNDNWPBI    KPLEKMMHD      
IEWXVT          : YJIOLMMCLIAYL   WNVFJBDXRNK     TKYY            OHLJLCBJRK      RTOAYCGSHVRUJ  
UWJXPJWI        : BLXEINVF        KPSMESDCOBC     FKMRUYY        
PXRLACBCQV      : HCTIVG          WCJQPRHMRJ      YPVNPLCKTUC     XMDTMATIMTXJM  
NKAESGDSF       : ALBJHLKMWJSY    TGJVYNUO        PWKTCSIEBOI     TKOSKJLPANSOJ   GBQG           
JAWSAOCYYTOXNCA : FFXXOFERD       UOHFPLMGHKK     XOWUTYPMD       QWVFKQAKP       EFKSU           FXMMDA         
DCJA            : FEPUOUGTAYW     PVLNK           JGKFMYBC        UHTX            KBXPORVSQR     
WKEBGLFBQELSD   : AKJKBCFOVUDIVYE YPHIBJWYJJCXX   AAAQEVW         HIGMVGRS       
UUJTTFKTTNTMSW  : VRSTAF          GQGLRNNRLPVSAXH MEOTKG          PDLQCYIJNNBLWFA
SBSGH           : UHSQ            YPJWHAM         ICFNJRYEBMXOTWC NNRCGA         
OUDPNIDIN       : MTYJ            QTJAPXG         NPMLLXNYKQWHGQU KDEFN           NMMXVPEWONQRABT
DITWDYKYSXTHSSD : ETGROI          BUMINSHVDVQ     QMNPV           XNKJJ           TWOKDHDA       
VXUDUL          : HCKERDKBE       QJAHOVNBTS     
XBOIFXW         : TIFOPUBRNAV     PIPBMACTAHLVA   NRTWG           XYKMMPRS       
BHJBKKLKGLG     : ALBJHLKMWJSY    VYEXWWROTFFFU   BMPOBYJTC      
EYTSURPAMBBN    : UGKLDORGPARAW   LAHGE           SAGRVW         
QVKO            : GFKJQNXMSI      DVHMNMOXVXPB    QULO            QCXPHWE        
CRDNSPX         : TEJLI           DEKU            FCAFTUQL       
CETIUBJOTG      : SNOQL          
MHVNIJSBFFRBJ   : INIGTAFTMVLVVD  XOMMECURYMBVUMW MHSGODUT        VNWCWGF         BAOTRKEFAP      WYSEYCYC        EEQBGCP         OCJFJLQTKV     
GWFVVOYCIJWJ    : GUQKADWKCV      COSLR          
NGAU            : MUJWTSDDRCLNIA  FFHGETPDDEQICT  KKPX           
JSISCEVJJOMVY   : XBFUAAPNKFXYDOM XJXLRBQM        APQWULVARB      FDNUIG         
SGPQUQVEAUPTJV  : XSSUEPCVBBTSYHU YHRDYAVY        HDENHBWTPL     
GQGYABBEXK      : QJAHOVNBTS      SUQKHJY         HSEMPPJWPGCOBFD HDPBYW          PDLQCYIJNNBLWFA
OXLPQH          : BJFJNBSHM       BQQCYISHUMXY    AYPIQPXSYKNCL  
IARYVXCRPVB     : LGBDBTACNGFT    TFGORJNXXX      GFYUOOLQPMDDVQ  WQGIXACSRE      JLTUTTEULGNLJOH
UJFCIFDLLDVE    : LOPP            EEOADGEUE       KFBQCF          BSWRYUTLT      
VRHPYG          : RWOB            UJTNYUGNLNGYU   DVHMNMOXVXPB    SQXQKUDPYY     
AAAXXCPNASC     : QOAKUEWOPK      TCJQACTXKYAPA  
CIAKPFVEJUIDSA  : EVEIUMHDJICLV   KQIUX           RVYUGPYNRKO     VLKKYM         
ICTJETLCTPSHRL  : ORVNOI          IWBODFF         TVPBTARDRLY     NITAFLNHMLNNUU  LREXCP          FQLNEQMWHXCKLJX EEQBGCP         LEVA           
PQWPB           : DXROJTMHXTOIH   ICJRLYUTLDXR    YPVNPLCKTUC     GFQTBLQIBWB    
VAQHWYKPCXBERM  : UOHFPLMGHKK     ODBDBVNDNVQY    FMXFUYSYLYQGQB  LSBHCHH         SARMI           LIHOOUSSEBOUG   JSPXI           GQHRQHJBC      
NXMHPFPHTEXMBPP : KFSCXFIBAEN     EVBGASROROY     ECJLYAWF        IGYYHK         
LPHSMIEFMEGSWSD : NOXVIWNIBBKNVLS WPDEUN         
SQUIXMPTQPGRG   : HJRGBPSNNVYRSS  OMLLLMBWJ       OSHO            FCVWAEOG       
HROQ            : SMEYE           KQMJJIQTOAAMTUH FNCQTVODYD      KUMXMSNFVNW    
ECTJ            : PFTGF           ULASOXOOTIAO    IVQFGTOCGSNNIG  LVQEYDUTGJJTPT  JFOIQRULUM      NBHENOCRMGBHLQ 
XRIWK           : BQHWJHEKUD      JYDQFADHNO      QLDET           GLYOXN         
KDEFN           : PUCFBBR         HBHLNH          XMNKJKRQ        HEMHFGQQNCEYD   OUDPNIDIN       MMGLVFNH        WYDHDGI        
TDYKVGECFN      : BKVHKB         
TFLXHF          : IGMJEUWLSUBNMX  FVLJQDED        HSMFHQODFD      BUHMPVPEDTCNPU  IPOG           
XGYGFLUPQYWEE   : FBIEELMKNNGK    ELOAS          
KEDG            : IGMJEUWLSUBNMX  DVCVYWKDEI      URNPGXUNRPFBFCA
HIRVGLDSMMA     : VOBOJFVL        BGJPFIUTTIKA    LYQQJLMRLWH     WCJQPRHMRJ     
KGXTM           : NPCTPRDJE       SOCUHOJPINAMBN  MJYDMY         
QEBPCHWURDBXPII : EVEIUMHDJICLV   XBFUAAPNKFXYDOM RVFJMUGKMPIXC   EQBHUGNTLJSK    LYECJWOHREUBO   CYULNWPVITH    
GPUJKJXKGJREF   : HJRGBPSNNVYRSS  SVWV            OFJEFOR         QCXPHWE        
PVISNMBKKSNLTFV : HMYNVOFHD       HPBISFD         QKAJQTX         LOKTTULO       
ODTMOE          : GEILWK          AAPFIEBTYW      XWFLE           OAYRYUAUV      
NPEYHIEN        : IUKV            OIYDCSG         RRFWYDPQKIXT    CMPFHIOIHIN     DOBJKTMRPSTFB  
AXTNNWBASQ      : HMQFXPLGHSJXUII DROURHSIDN      VCRTPH          BKHWGNANRNMG   
MWJOLOJAE       : LIHOOUSSEBOUG   PUSDPNKYI      
WTFDS           : MNVXREEPGPYHI   YRTOEA          SORPJQPITCKTWO  KDONCSMVSYQMBB 
MWCNYDJOQHPQAH  : XISHGEDV        TDXWSP          FQFFYBQTPJVW    FVYMQLJVNG     
OEPDR           : STMHIMYOXDVJNP  CJRAKYLOMKWWQNV VRSTAF          UTKUI          
OUJFTFKWXALWEB  : ORKYLTXUP       INQGNRM         XDIK            NHWFTSDG       
HLMAU           : NOWMBXLPVG      GTRNJJICK       KWJFC           XBJPYQM         MOQODV         
SWMYLSPOMUG     : GUQKADWKCV      SUQKHJY         SYBO            RGAUR           DOBJKTMRPSTFB  
GLDLXBLAM       : ALBJHLKMWJSY    MJJPW           IMASWWXSNWBCXUM WCJQPRHMRJ      GBQG            PWXEIPCHBK     
HOIOCWRWCKV     : VUISRA          AIPUUPOJMH      HEOTNUUWAXS     ICJDI          
KHJAXYWEIFRMSS  : LUVJILCTEM      JRKIYYYQTY      MOQODV          SHBBHSLHT      
EUCQCSBT        : SNQOPILMHVUNRC  NTQT            SAAHKAECCG      ABAVIY          XYKMMPRS       
XLTDVPT         : ORVNOI          GCMCJLHP       
WGIXFHCNMWAFP   : LYNESPRKSVPVRG  FQFFYBQTPJVW    HGDQEA         
LKUE            : YERYTPFXTFV     YMJBKH          WNRBVWQAVHTERT  LJGYBSQJ        SPOMEVXCAY     
NFHLGSHJQADAYJ  : GFQYFYREVJY     DDFQKJKOFWWN   
WOSAFHY         : QWBMOBUXLDT     ALCQXQLFX       IBDNGFE        
POXBBSIQ        : RGNXFOFRYJRDC  
NXVTSEDM        : KWJTJDXAQHHK    XAYTAGP        
JMFSYDKR        : NPMLLXNYKQWHGQU
PAEWPUW         : LMMWBL         
VPBNBR          : NSPTAXRSR       OOYOUUOSUQJW   
WNJDRXJDM       : IKJXTOSTA       PWKTCSIEBOI     ROODJLRTWEVRDP  TEKDJLHW        YHRDYAVY       
XLUIE           : PFTGF           SQHTJDWN        DCPGOXGVNG     
AGGAXBWSYPWOQ   : UKOQRPF         VYKHBQDTAYJH    ORFXMHEN        HHRMKRUCKF     
FNCQTVODYD      : FLXEYFWQS       AWAXVSUUIXKFF   XFTGSPDHYMUTD   ONALIGUUIEGIVO  HROQ            RTHESRXFFIAH    PEBHOFDANFUWBCF XFRRIPJHTQIRR  
XOPIUP          : PPHPMSQWEGAB    WYWFUJ          QWVCBHULGIW     CJYUTNUS        VRKYRBPNQENQ    AQGMN          
DVLB            : LOJBTKC         UYHFCPY         LELNXYG         MANAKMOLYAJKCKC KHOEPDGTSFLR    OSHO            HKIGKOIJVPKDPU 
KWBATPQI        : CGXB            NOXVIWNIBBKNVLS WMUQ            HPVFR          
HMNBJEGKHCKYR   : FXKGACPMY       UFFVBC          XBPEULE        
TIHA            : CWSAVAPSGNKAS   EUILMMXPSCGWJIW URCRJCAHBKI    
SDIDAJETYWE     : HFQKFYDJJT      OUQJGVCV        KDONCSMVSYQMBB 
ETMHDTOPDQBC    : PFQQC           LIGVFRDHQT     
WYSEYCYC        : PVCII           QMNPV           MHVNIJSBFFRBJ   SLXW           
CFTIYUIGTOAJ    : NRTWG           YNDCWDYPDDLTJFJ YFHFLJGUXOAWOIQ
FDNUIG          : FKMRUYY         BNJKIUDVO       DOQUCQBT        JSISCEVJJOMVY  
LQUKMYLOXP      : YJIOTN          CWPJN          
DUUNWRVDM       : LCTRCBIAHQ      FIVJMFEANOWWCOR OJIHICBF        BHMY           
FXMMDA          : GTRNJJICK       JAWSAOCYYTOXNCA MRFAYA         
LIIYYFJLHWCHNB  : WNBFUDGG        KTUKYAR         EXNQXMYJSDCXVKJ RHISKYSIWGC    
IXBFQYKFM       : TQPXG           BFVHTQ         
DYEIBOTJWTLE    : FXYDHTTCBF      GALXNMRPYIN     KONLVH          OKGY            XFTGPNMDMMEWFBJ LEVA            XQUYVTPEFSS    
YLDCTQFGBEJ     : TBWBTMOXEAOKCK  XLATRN          UCOESDEXMTFSV   FWMPS          
WJRCXKFAOPBF    : FFLXEQO         VRSTAF         
NEFYJLA         : SBMBWKQGVKGDEDK QWVFKQAKP       JBVHJL          TVPBTARDRLY     TAEE            QOJDHVJJEG     
QCSHKAKQL       : EPONHODQRYBWP   MQOOAPVSGAYE    OCTEKUFWLDIEMB  BKHWGNANRNMG   
NWMPVYWXPMY     : LYWFKK          YHQJE           FIYKAWQL        MVAETXYX       
XOAEN           : JGCV            DAKIFIWVNHU     VRLULNEBMU      OTWSQCRJHWU    
ROJISCRDECTQW   : GIMNOA          XCGLVFNCQXAP    VLMC            GITDU           EWEPLFOB       
PJYNKXLAKLVLAY  : IKJXTOSTA       UJTNYUGNLNGYU   TQYHBLYIK       OQOSFBLDMY      WFGFEOMCCA      BYUSYANTONUQ   
QKJHVTC         : RJSPCDRDCFXLF   ALBFEIEFFWMQJYX DAKIFIWVNHU     HCWT            GYCMEB          BIAXOQQOGCXGHGG
NIFPCVO         : RRFWYDPQKIXT    TVQUOTLTMR      VXMFJCA         WTSWQKQN       
MANAKMOLYAJKCKC : LAHGE           YLNHO           MSAVFOXVMDAUJDT DVLB            FKTEEYUMKFNPA  
XNETHHUUPBNT    : WOPOUI          YLUXFYPIWD      IHOAWYJAUNY     IMRKOOWMQO      RHISKYSIWGC    
CINDWQPLFBKHNX  : VIUF            QWDXHXRBGEE     FHGVPSDMRRFFCC 
XCHVQLSXUNVKQ   : ERCNLIAGALGCWT  QEXNUWAYVTR    
FQLNEQMWHXCKLJX : QLXGUFWTHRWLO   GNDQYD          DMATK           ETNJRIRLQLRTLWA ICTJETLCTPSHRL  MCTOXUJGAWUD    TFIJEBYSXIQCXA  ADYLUGDXSBJOERK
XYNFWESRFO      : UGKLDORGPARAW   GFQYFYREVJY     TFVNATAKUPQH   
BBYK            : OASBQCWP        CEHGQEGWO       QVKXKPKUHQGLNT  HQNEUW          SQAUDIBLIWCPT  
PXWWRLT         : LYNESPRKSVPVRG  ADATCW          RLQFHOLIGTHK    BOFJQHOLLX      CXBWYTEKFMKJDML
KYLX            : UYWCMS          VXTCSQ          QMNPV           OTQBLBO         AQGMN          
MJILWNKEJDJ     : MVUGF           NABVPKOKM       VGWUCWCGINJLNRG
LKBKWKBUHAMUTN  : KBJS            OHODGOWJVIAH    UKGPBKUTECT    
SAFEOOMAODK     : LHTSMO          CAOXWW          RGFC           
MPCMBONMLXNIHNX : BPYYGE          EPEMM           LPKN           
JLMFNSLCJXEAD   : LQVWREOSVQUJ    QPHLEYJDQNUJLL  HPVFR           IUIEFEV        
SRHWEJLUV       : KSEWFCEVCGD     AWXUXHVMWVJLW   XWFLE          
SLGDBGIKR       : EGDEXSPEPHJPE   BJLDHMLUHL     
PIPBMACTAHLVA   : YHATDDPWKN      SOEAMPIOC       AWAXVSUUIXKFF   XBOIFXW         IBDNGFE        
SEEHBCGWNOA     : MOLEXNBNI       HEXTUSG         IMASWWXSNWBCXUM UCXJAKR         WTSWQKQN       
UKCPFTXV        : WECVQLIYRSR     LDSGFARFT       NQOIKLYMFIFS    OARDIWJV        ECJLYAWF        IKCINRA         ESOEEUR         AQGMN          
MXCGAJTX        : USUMYVFTJU      SOHQNGMAEBTYEHN TUBSMUBXHOL     XQVSKTGEADL     YKBOBIGGBWKPUW  FYFSSOJDFW     
NTQT            : YTMG            LHTSMO          TRLSKRVTKW      PEVOESIONR      XBJNJ           EUCQCSBT       
RWHOMYQETBGJ    : MFDBBKMWDNOKJ   ULQQEDIJETVG    CWSAVAPSGNKAS   YPJWHAM         QEYJYPRAQEPLG   MYEHJAO        
CJFAYFCFFOAGXP  : IORUH          
QLBJIKX         : JHYNYKFRUI      DVQJVP          NOSXKAKCO       BICNMMCFOPBI    LSGKUFQEOQRE    QSIF           
JPCGSKR         : XKYLNGS         PWKTCSIEBOI     YERYTPFXTFV     GKSDYCUEFSN     RYEWEDJUOKUR   
MEJPDOTKWI      : FVNQNBWIROD     FOQGRPNB        JWVOKGXIOBQXS   KTKWIKA        
DJCDAQGJBQKYD   : XKREAJAP        PSVBJHJNDGMH    UGBAWEH        
BJUL            : EHCHNWUKYBXMDGJ MWRIEBCVGH      JJAGAOLS       
ABFJQ           : TNPHKQBKV       WISCEIBRGRFP    KVVKWTWAAIFY   
YKVX            : CMMLVPQGJQEY    KWQXLEWT        CGFVDLIERDCW    VBLCMQDASXUN    BSNT           
IBDNGFE         : TNNE            KDPYKGLKY       RGIOAYGERLGYF   WOSAFHY         PIPBMACTAHLVA  
RFFCF           : BPRG            LIRHPDGRKNTQLJU QJQBHHY         GFYUOOLQPMDDVQ  MRJANNPL       
GITDU           : TWLOT           NNCKXTAKFIBY    ROJISCRDECTQW   YBOGCBPIRMNVDQD BJJLCK          LPKN           
DXFNOQO         : VIGABSJP        AHBHBGGB       
MMUWPAKXGOKXU   : JAYR            VBJB            VRKYRBPNQENQ    ADCUDGP         GLBPXL         
CCBIKW          : CGREHHWQQB      UCCUMA         
HURFDHTTVVIKQHC : WECVQLIYRSR     HDEGT           JWEWLDUBHTRX   
SAAHKAECCG      : NCEFOGL         PPBSOQG         EUCQCSBT       
MRFAYA          : PTTRVBRHEN      FXMMDA          IRJWTQCKTP      FTCHDKNC       
HFBBYWYJJSRLMML : DWQVWGFU       
TXMBD           : YRKF            PMUMMYE        
HIDBNDDQ        : UKLIQMVRCEO     AUGSBLOAJ      
KVYNXYNJIGD     : CHVRHHORWEKIXP  LQVWREOSVQUJ    AQEVUFXSBMNC    RMFNOAJAUQWDT   DOBJKTMRPSTFB  
SPIHMHV         : UVPWLJMU        EHCHNWUKYBXMDGJ LYQQJLMRLWH     GIAMBDV         GKKOJ          
KMUSRY          : SIVH            VPHGYHJX        DXHTBVNJT      
UCCUMA          : TMGUGJHYEYR     YYIVJ           XVIQDUHSHGKNK   UKRUBUJVPSKG    CCBIKW          ICFNJRYEBMXOTWC NBFX           
AATNKEVPYQGIXU  : CUKEH           JHYNYKFRUI      UERISKWKKNGGVHF SRPGQRUDRTF     AWVYYNJVVOC     EEBRDOV         CCHFWNMYYJPXJJA FNDOPALEHJ     
VICIFWA         : HJRGBPSNNVYRSS  PSRIAXNN        YHIUSE          EGSUBLEKMOBB    XRYXDDHYYYIILYY AWAXVSUUIXKFF   KRSEOGL        
IXIKSU          : RSTOWDQKQMEYGUL QOXVWLBXYXDPR  
PXNJNAQKQRBYACT : CGFVDLIERDCW    FNPXILATCEIYBX  BUDXFMQRGQHCL   YFHFLJGUXOAWOIQ
XEVJLTLQCJYPF   : WKSFEL          SQAUDIBLIWCPT   IPAEPPPHI       WOEDKM          EXAOQKQUWDHB   
DUUQHITXUKPWL   : DOQUCQBT        SEBOVWXCL      
BHMY            : IKJXTOSTA       BSUTKADQCQ      SIXASTGXOBREWB  DUUNWRVDM      
LIWHUPJG        : ULRKR           AWJEOYRT        QGWKKBKINTUMIG  QJBJXHXCGSFJROC
BLOEJLXSVRSR    : AWBMBYSCLHCV   
IQPDRWSQ        : ACIMTSYJ        LKWNEQEFQGIDYN  GKEBKNNSNKASRV 
ECJLYAWF        : WREEWJBYMGXG    NXMHPFPHTEXMBPP UKCPFTXV        KHOEPDGTSFLR   
BTKFFVFXRW      : NMSUDPKEJDFQDP  PPDTLI          FCURIEVKXXQBB  
LDBCSFTRXNEERO  : TQFKEDSYIQS     OPJWOOYMJGV     XXLAMMBIGC      YEWI            VRYNAQ          UXGJHUTQSY      KEPOXBGOP       EVLOXXPOP      
LDBCSFTRXNEERO  : YHRDYAVY       
QOQVKRRUAWQF    : WSSC            UXQQPUXO        HCWT            TNCUGCSMGMD    
KFNW            : NNOCAIQWPHDTJ   LQVWREOSVQUJ    JLIWWASCNPAKSSD MTUWKYWHOTLL    TPMLQDFHJGRUIO  ADCUDGP        
PYEUVXUL        : CMXYSRBWLAUQ   
BDRSTILRSEKPEJ  : SNOQL           GQGLRNNRLPVSAXH LRAPSJQKDREIHP  OHLJLCBJRK      FKIPVMEJWOPCOD 
LHSQUPCKRIHNGCB : VQPVBEVEAKLC   
FEDXANMRIQE     : FAWJXKSPKW      KRDBKKYJMXHX   
WQGIXACSRE      : LXLSEGUN        UWYGUOSPGQSW    YMJBKH          IARYVXCRPVB    
JMLYUQAHVGM     : SOHQNGMAEBTYEHN BGBPXNEWEHDBSJA
GBJYLCFMYVSJTUL : XBKQPSDR        TYIBONX         WCFLTIMO        NYGRKB          ESDFMD         
NRTWG           : HVPO            XBOIFXW         CFTIYUIGTOAJ    LVNAEGUG        TNJGAQHLY      
YCXYJWGVTMY     : VQPVBEVEAKLC    RNGEO          
NNHTAIRURMQG    : IMWA            PXFENLIELS      DVHMNMOXVXPB    MLCCBSPFDDWLC   DXHTBVNJT      
EXXBFFCJG       : IWBODFF         PCCNN           FNPXILATCEIYBX  FYFSSOJDFW      HMYRVVURPFLB   
SDKQYY          : YXRQPNXD        SULBS           FNETFPWLLAMR    GKEBKNNSNKASRV 
ENENJGV         : JFIUXLYCHDVEW   AKOBLABNTNNCC   WFITN           YHIUSE          WFXNP           JUDMEKTQWTJBPEG
BPPRX           : IULDHGEGPT      SNDOXKQBDBRNHO  RGGODGMBWT     
VYRAEXCPEGIJSY  : CJRAKYLOMKWWQNV GWRUFTKRTTL     CUPIHC          JOTLV           HOBRJAUXN       VXBTOSOYK      
SROIXE          : QJQMMPGRYWASGH  GSLWCQRRC       CCHFWNMYYJPXJJA GFYUOOLQPMDDVQ 
ECUIRLCQFBP     : XISHGEDV        JMRKUHOXXEO    
DVXFNEOVNHWX    : OBJE            LIIEWDTJLOGUKG  WREEWJBYMGXG    PPBSOQG         DIXHCNXMIOJW    OOSHQLWIFFK    
ROKPSCWUAHO     : TTHKYHNRKOF     BQAU           
JHSKYSNWQVKUMG  : UPQWQFCK        VBLCMQDASXUN    QCXPHWE        
TGKWXBHPTMOQMV  : RCAIMMBJRFDB    MNLFBP         
AIPUUPOJMH      : VRNHDUBA        DSSOEGW         MJKJMHON        INQGNRM         HOIOCWRWCKV     IBMPWMGPWOPXP   QWSLFGKYB       KCTDLYOIPIMYV  
XFTGPNMDMMEWFBJ : QOAKUEWOPK      DYEIBOTJWTLE   
RXSAXD          : KMDQXWJKPVWHFQG JMRKUHOXXEO     HMYRVVURPFLB   
UXGJHUTQSY      : SVAEL           XBFUAAPNKFXYDOM LDBCSFTRXNEERO 
CQBOTNEYKJAVFT  : OOTCWTN         HAEALDHHCYIVCC  UMCABN         
AUTDNPETBNQUF   : MDJR            KMACTV          BVTC           
TPMLQDFHJGRUIO  : PSTL            LSMRQPKSKYT     KFNW           
DKDA            : TPRCSANFBWQV    OCMMXJBMLRH     QKAJQTX         PITMICKSMCVKTR 
JNUN            : UPQWQFCK        DGPOOPE        
VBARGM          : PVDBBTB         JOTLV           WIVKEVAVGGUD    HUJQIR         
WBYPHHWQPR      : YHIUSE          DYLKGMLIPCT     HNERKTKRKHULHCW TDQVOKQSMBPVI  
YGRESUEX        : QYFD            ERCNLIAGALGCWT  MGCHUIFU        AAMMQRKTD       IWGXUFYTBOQ     JPODPLBHIN      SEJPOCDLEEAOBJ 
TSTDRXDLESYDTB  : JPOHXEKREDV     GQPAWNXURQ      MLCCBSPFDDWLC   AQEKCQULUH      WHITFLQHOB     
BKSUAKHBSY      : WREEWJBYMGXG    IASMCKOL       
MVLM            : MJJPW           XKBM            DEGHMUBHWM      WMUQ            RGIOAYGERLGYF  
FIYKAWQL        : BDLCSMIRDFTCH   NWMPVYWXPMY     NBHENOCRMGBHLQ 
JMJDPFH         : HOWEXQRDLBTJOQW JOFXWNLRLHPNP   HEXTUSG         RXPRLJVT        ABAVIY         
BCDNLEJMMVI     : DSQC            XXNXFNWC        RJSPCDRDCFXLF   AINSXUD         KEPOXBGOP       UDBYH          
KNGSPQSMHGSS    : WCMN            UVPWLJMU        LJKEWXTSFELQKV  SSFHUYD        
DYLKGMLIPCT     : OHIRHFMHUXHBGWG XWFLE           RJHPYSCWA       WBYPHHWQPR      KIXUFCHTMRCYQ   VRKYRBPNQENQ   
LIIJQJTHPNW     : HBBVMLXCKXKSV   SFJYDDFFFNIC    PPBSOQG         LGLELQHY        PIHS            UQTD           
GLSPFLLKKWUSJJ  : COUUNCCAEQRSOA  NPQJ            IYTPMLAHN      
BLYXYHIIBRCIJ   : IRWEVITKKHUXF   IJADHTAXNNS     RDBMB           CTNQITQWMJ      RGNUYHVRIOE    
HSYS            : MLJRNSLHYJF     KQMJJIQTOAAMTUH
OAYAKMWI        : BVHETEPG        LHFA            UCOESDEXMTFSV   YRPDGELJY       RNRMCKUEBYUKMRF CSVCACVTMU      UENVY          
JTLMFKKGS       : TWLOT           XCGLVFNCQXAP    NTCQDNTFLQ      ICJDI          
OTNSEXLNS       : FMOOUHURX       UUCQMSUQXRS     TVCQNAESH       TKYY            LYECJWOHREUBO  
GEBJFBTRAEAJ    : GHNGWRDCBID     BQLBPJQCIG      KUMXMSNFVNW    
LWFVJLOFCKVVQ   : HGKMVAXTMB      LRAPSJQKDREIHP  MHLFW           FHSNYT         
HEOTNUUWAXS     : SJHWSKGS        HOIOCWRWCKV    
XXSKVEJCCUPR    : IMVNTULT       
SEBOVWXCL       : HRCKBYY         YEWI            DUUQHITXUKPWL   GXGLHBL        
PGMOGMIBM       : KYRFN           CKBFR           MGCHUIFU        DXRR           
TWGAIIDGYWJT    : KDPYKGLKY       LIAOFKGW        ERFVYOXTN       VENKUQKQRIEM    HIGMVGRS       
KIYJGEUAVDO     : YTBRKOD        
LBVNNE          : MOLEXNBNI       LCTRCBIAHQ      TVQUOTLTMR      RJHPYSCWA      
NMMXVPEWONQRABT : JCVUF           BJEF            YRPDGELJY       OUDPNIDIN      
JXGJTLXHXBDN    : BHLT            VVNJOD          DNPV            YUWCBGOJ        RVYUGPYNRKO     KWHFW          
JWEWLDUBHTRX    : EWFFYKPTKT      UHTODDJDN       QGWKKBKINTUMIG  HURFDHTTVVIKQHC OHXNPRAQ        XEDYMHFYTSOJYYT NRPKW          
KANEKYESIAFIIDL : BRWOJAJPMMY     MAESTSMSNFWIOF 
QCXPHWE         : DIXHCNXMIOJW    LVTBRQOWLSXRE   QVKO            GPUJKJXKGJREF   JHSKYSNWQVKUMG  DOBJKTMRPSTFB  
TFVNATAKUPQH    : SOHQNGMAEBTYEHN TAEE            XYNFWESRFO      FIXFCJOHA      
WAYWFJH         : OJIHICBF        GYTA           
UVDYVVGSAUMHR   : ALXODWDEU       BQQCYISHUMXY    SQHTJDWN        ACPNTNCCDYRUY   VPHGYHJX        XQOTIGTAFO     
HNERKTKRKHULHCW : LSMRQPKSKYT     BWFLJG          WBYPHHWQPR     
NTMQSIO         : WNBFUDGG        WCFLTIMO        MLDURDGLU       YPVNPLCKTUC    
DOWRWQTEFXYP    : ETGROI          BUNEFVXBJJOH    DVCVYWKDEI      EUWUVWP         SGMYSGUDN      
LIGVFRDHQT      : EQBDGOBHEC      MLFYVMEPMWK     ETMHDTOPDQBC    WDOB           
KHOEPDGTSFLR    : TOCSAUOUYGJXTT  MKEQC           QWASVI          DVLB            ECJLYAWF       
IVCGWTDJEJFJ    : XBKQPSDR       
KRSEOGL         : KEVVJMUBJ       VICIFWA        
KEJSXEALVWTTBDR : WXVX            XKYLNGS         DFBCRTHEJIT     FNETFPWLLAMR   
GDAPKKTUEPYS    : PIWCVISQS       KPME            EWNBVNNCRV      HBHLNH          UUFHAVJQMOXXJO 
NYGRKB          : YAQMAYWEFME     TSNJVSED        GBJYLCFMYVSJTUL
OBDMBAGC        : EPEJTVGGJWY     JRTHQQAP        XGTN            DNUI            PUABPUIATBSIDMM YEBDQTLTFUHHI   HRMG            BKHWGNANRNMG   
XAJDBYNNVITL    : SIVH            RPBDSKQUSJEFADE KVVKWTWAAIFY    GIRRWMTOCIOTG  
OHXNPRAQ        : ETJTKEESOFUJ    PBYCKU          JWEWLDUBHTRX   
OROBUOKXTKXD    : PDLQCYIJNNBLWFA WNRBVWQAVHTERT  NOMUJXN        
BFCQBNKMXAVXP   : WYHSNHTJCYF     BQLBPJQCIG      JNMAFV          EWEPLFOB       
RQCDHVRLRJVR    : BPRG            FVNQNBWIROD    
IRJWTQCKTP      : SESMYPHBHVUCMS  EFSRSPVHC       MRFAYA          SLXW           
IPAEPPPHI       : TPMXKP          UDYPDCWQVQICO   NPCTPRDJE       XEVJLTLQCJYPF   NIEQJHOP        SMEWDSWJJJQ    
KSPEGJP         : GLNXJYWMXUETU   AJIGGJRD        NIEQJHOP        MNCFRETSYRKITV 
BVMTHMPXOCTGAC  : IJMAILUC        QWVFKQAKP       NOSXKAKCO       CRVDWACXTMV    
AINSXUD         : CBGTNKUAPS      VDJACR          SIXASTGXOBREWB  BCDNLEJMMVI    
HXJLETE         : DVQJVP          QSWKWNGLAY     
WAXQHMGFB       : QQGSRGCFPGIS    MNVXREEPGPYHI  
BJLDHMLUHL      : JAWVASK         SLGDBGIKR      
MFYLQMRKQDISDB  : SNXKDDFJJMEPGW  ADATCW          RNGEO           VRYNAQ          OIOAFHUAGFGNEA 
PIHS            : FVLJQDED        WBOBBBPEMSHCMU  LIIJQJTHPNW     LYRSGUMO        BYNLXGHYBMWXSB  DGYNAJYUTXNEU  
ICFNJRYEBMXOTWC : OXGOENHPORESJYN SNQOPILMHVUNRC  SBSGH           UCCUMA         
LTVFYGXCIYRSIMM : AWJEOYRT        OOXPTNVOFLA     LYLYGRAQYALJD   JADRK           KDDACGWUDNB    
ORFXMHEN        : PJHPUPUXREDGKW  GYACDPK         DTMHOPXKCER     XFTGSPDHYMUTD   AGGAXBWSYPWOQ   JQTMMAT        
EEQBGCP         : SNIIHUEWWHODK   MHVNIJSBFFRBJ   ICTJETLCTPSHRL  PUGSUKH        
AWAHUFRVYKHM    : BVSURQUJYKQTV   IBMPWMGPWOPXP  
YBOGCBPIRMNVDQD : JJWYR           GITDU           KCTDLYOIPIMYV  
IGHFIQDNIB      : PIWCVISQS       KNTUPDNOCIARGO  BLXEINVF       
SIARJDHQHKGQ    : DATHJPUSBKNTCO  WQQPVLQJOTBMQPH OCQXQDNYXYD     UOHB           
UGBAWEH         : BQLBPJQCIG      RIGYEBG         DJCDAQGJBQKYD   NBFX           
MRNUIQJ         : AWFWVOOBY       OBRIX          
SYODBHNEQGMDOF  : INMHINRJDUTLCU  FKTEEYUMKFNPA  
KLHMINWQAO      : SCDERYWSIEEYGY  WVAKGEONEIRRPAJ NDVBMPCT        SKXCCKRXEDJY    TWOKDHDA        MWRIEBCVGH      IDSAV           WICK           
KLHMINWQAO      : NQHTFITBAOXPW  
UYXGU           : EPFFDAXR        SNQOPILMHVUNRC  KKPX            KGYJG           UNUQDRN        
HKWITMNKSCNHHVT : TQSQU           EEBRDOV         IXMMXJFWPWFXW  
FHBSEUUUCSVA    : OKCJQOAA        QPDDKFU        
RTHESRXFFIAH    : SULFFPJFKJFXYA  JMQBXLEFSWFOFE  FNCQTVODYD      OXLHLKSQIX     
HOUE            : DNGQ            UCOESDEXMTFSV   DUBGLAFMMMDJWXP
ANLVTI          : CGXB            UIBJVMBJFN      GWODR          
OKJM            : GLVXEGGXXTSGNI  VNILTBVKQPXBC  
LGGUKBMIGUSI    : UKLIQMVRCEO     YRRTRAAN        YEBRSNW         VTVEPESAGVDP   
RSTOWDQKQMEYGUL : IXIKSU          MAESTSMSNFWIOF 
JYDQFADHNO      : ALBJHLKMWJSY    SVIELNXGPVYMOP  VMKBCDGVDVNQ    XRIWK          
IHYMBTI         : RCAIMMBJRFDB    JPLRDFHQASGXOIV XXNXFNWC        NWISF           FTQR           
QOJDHVJJEG      : NEFYJLA         LYECJWOHREUBO   SJQADHLU       
WPTCICDMLSDD    : TGBXAFQAGCMYWG  LESKXPWTCDWMXF  BJDXSWBRTSV     CWPJN          
KEPOXBGOP       : QJAHOVNBTS      VTGO            SWEHIHBQPBAIMF  LDBCSFTRXNEERO  BCDNLEJMMVI    
TWODGSJERC      : YTBRKOD         PKHNAXFQHJ      OTWSQCRJHWU    
UMCABN          : UERISKWKKNGGVHF AVLEWFIVGCKB    SNOQL           ROODJLRTWEVRDP  FIVJMFEANOWWCOR CQBOTNEYKJAVFT 
ERVPVNEUOML     : GAPCKNVEQFFFG   OOSHQLWIFFK     TVAYNV          ICJDI          
DGGRLOMVSFATCM  : LKYVOWANWEQFAEQ VNWCWGF         EFKSU           KLQWB          
COMUSGSKE       : VKBBEWS         QKAJQTX         JQAPMBGSM       VRLULNEBMU      UKGPBKUTECT    
QBXEPE          : LUVJILCTEM      UMTCIFVVETEU    VTAEGVYTNV      EPFBFRHWB      
VMBJCNFWUHSWURB : RMPSKBYRWV      IAMEJHNRKB      GGIUJMRIYDE     KCTDLYOIPIMYV  
GVEOQRSXI       : ODMEDVK        
VMMCVKPWTTN     : IKNIXHALWD      GTKU            MQUCBSJLTMOJLY  OWDPSACKADQM    DVCVYWKDEI     
QKJKIG          : CTTTCXBGRKE     OIYDCSG         URNTIMLL        GKKOJ          
JRKIYYYQTY      : JDPCC           PGYYXHQWTJBC    JEQBVVPENHTK    BXJVPM          KHJAXYWEIFRMSS 
QWOFAKRRKO      : NHNVCXT         DUPXL           RUUAKTXYYXV     QKYAYMOUWUJLMGI
AQEKCQULUH      : SYBO            TSTDRXDLESYDTB  QHNJKUMHELTXG  
HREGSUDSWVPNER  : NEGXRNP         MEOTKG          OQOSFBLDMY     
VLKKYM          : LYNESPRKSVPVRG  USUMYVFTJU      BWFLJG          BTVLLXUQKKFDTX  CIAKPFVEJUIDSA  BIAXOQQOGCXGHGG YKFVFQWUVGNSOPG
EXIWUTUCYCV     : GNDQYD          WNDKTNVQ        SRPGQRUDRTF     VQNXLIIQEVQ     XFGRSRC        
LPDOICM         : FCJVDTUBMALND   XKYLNGS         UUFHAVJQMOXXJO 
PQUQNGDAGQEKQM  : PXKM            PDEDBB         
NIEQJHOP        : VATMTNXAVA      XGTN            IPAEPPPHI       KSPEGJP         FNETFPWLLAMR    BIECAUTWNNQW    DVUNVXTDNUW    
EVLOXXPOP       : RCJAXACESRUBYR  NMLWIMMUWB      LDBCSFTRXNEERO 
HFQKFYDJJT      : OSAJGEBNXBXT    MVDFHNW         SDIDAJETYWE    
VIGABSJP        : CYNR            WMBJ            FEPUOUGTAYW     VVIJFLGRASPORG  DXFNOQO        
EWEPLFOB        : TBGOESIWSSL     ROJISCRDECTQW   BFCQBNKMXAVXP   OIIXXNMKPPWO    YFHFLJGUXOAWOIQ
GNDLHNQGR       : TADNED          RPEKRAHC        QJBJXHXCGSFJROC PGCYF          
SNDOXKQBDBRNHO  : XBFUAAPNKFXYDOM OCMMXJBMLRH     FGLVXJOVGM      UOMGAF          UFFVBC          BPPRX          
AAAQEVW         : NHUCVLWG        RBQPVOQOIMMPE   NHNCJEO         WKEBGLFBQELSD  
YKBOBIGGBWKPUW  : VTGO            SHHDUKLMBBEGBH  MXCGAJTX       
WCJQPRHMRJ      : JYNVWXIKYL      RUUAKTXYYXV     PXRLACBCQV      HIRVGLDSMMA     GLDLXBLAM       KBXPORVSQR     
INMHINRJDUTLCU  : RFVBEPVJTNL     RPHFTRNUI       QWVCBHULGIW     YKFXSGOA        SYODBHNEQGMDOF  BQAU           
MMGLVFNH        : LBWIIGR         TKOSKJLPANSOJ   ILPCVTCFUOOFHX  KDEFN          
FYFSSOJDFW      : DXON            RIDDGQI         MXCGAJTX        EXXBFFCJG       BIUS           
PMCBRAVECSQ     : NCNSALFRMYWSAGU RPEKRAHC       
GWCEE           : WVMG            SADNQISUM       QSMREJYFXQ     
LCWNH           : TPMXKP          KXRTBJXMYUPBY   UBIISVLLKWTEED  XNKJJ           NBAVXQCBWLI     DSIBTAHHHUPTL  
GYCMEB          : AFMKIMIIFULOWJJ SWEHIHBQPBAIMF  QKJHVTC         OIRCQILJCSUDW  
TNCUGCSMGMD     : MTYJ            LDAADWJWIKLDYR  UKKUNJXRIGOBICT QOQVKRRUAWQF   
UDBYH           : OGUVJ           PSRIAXNN        RXGQNLPQYPRESSO OQJMFTERQEVFW   BCDNLEJMMVI     HQDPDWUYQ      
KKPX            : BGBPXNEWEHDBSJA YUQMUMMFU       VOTI            NGAU            UYXGU           LVNAEGUG       
IHSMTWNSSD      : EMKSFHD         RNGEO           NUIE            BOYQ           
QJBJXHXCGSFJROC : EMPRNELLYD      VQFFDL          LIWHUPJG        GNDLHNQGR      
BUDXFMQRGQHCL   : HGKMVAXTMB      NOAGVAW         EFNX            PXNJNAQKQRBYACT
YCUBOS          : NCDLFJYBOOGHOIA XAHMQCUEHVXP   
MWRIEBCVGH      : PEXBPXLBIV      VYBSOYEHEJ      AJIGGJRD        BJUL            KLHMINWQAO      NSWWOX          ADYLUGDXSBJOERK FHLMUCQNO      
DNUI            : SVIELNXGPVYMOP  XTBVGKLM        NCNSALFRMYWSAGU VLMC            OBDMBAGC        LVHTG          
OCJFJLQTKV      : SIVH            GSLWCQRRC       MHVNIJSBFFRBJ   MDYIUPBHNKU    
LMMWBL          : UYWCMS          KIOELETNXAS     PAEWPUW        
JQTMMAT         : YTMG            JVUVYBEFHGDETO  CBEABSLT        TVWBRQEJOWWJ    OFDXIDNUQCBV    RPEKRAHC        IEXHSOEPK       ORFXMHEN       
JQTMMAT         : BIUS           
DJJNKXPTFYFXVRV : CYOSIHEAGCUXQV  OEIUAFXLJKYXLC 
GIDFKP          : UPQWQFCK        TPRCSANFBWQV    MSNLA          
VGRKU           : LCQAJWVEA       TXEDQINRHN      ERFVYOXTN       GDNCGUGY       
HIXQRMBRC       : CMPFHIOIHIN     YKGBVHAN        WXBJWNQVUMYCQLS
YEEACWVSFHWKTM  : GKCSCHUNJ       XTRXKH          LXJVWD          MLCCBSPFDDWLC   HJLPMKBRIKCA    NBFX            SVALA          
PUABPUIATBSIDMM : EFSRSPVHC       OBDMBAGC       
OSHO            : LGBDBTACNGFT    TAEFSLAILCOU    DNPV            PWECIEBWNQWALHJ SQUIXMPTQPGRG   DVLB            TIWELGM        
EMOJ            : TQXLHC          XMBFNBX         HRCKBYY         FOISYPIGNQDDAPL BRWOJAJPMMY    
LVNAEGUG        : HDEGT           SVIELNXGPVYMOP  XBFUAAPNKFXYDOM NRTWG           KKPX            UJOASHBXDA      CYULNWPVITH    
MCTOXUJGAWUD    : BHNCIPHKOYXKVVV GYTYA           XAHMQCUEHVXP    FQLNEQMWHXCKLJX
OKCJQOAA        : GALXNMRPYIN     PECOAKJHEO      FHBSEUUUCSVA    YNDCWDYPDDLTJFJ
NXBPCHKKQYMMO   : SLVBEJNUCOKUSF  HCWT            TTHKYHNRKOF     KDONCSMVSYQMBB 
IXUIWQLKFXOQO   : IENJCSIMPISIRY  JSYQXYYNFVYNFW  GGIUJMRIYDE     FNDOPALEHJ     
TQTHOUXSFKEV    : FMXFUYSYLYQGQB  UFRLVVO         RGNXFOFRYJRDC  
QLDET           : HBQQSEQ         XRIWK          
YEBRSNW         : TNNE            TTLBYLQVG       LGGUKBMIGUSI    RTXUBYLLSYGGYEC
DQILKYFROARH    : RKBFDR          OBACDJPCWVFN    BWYUVWDCDNA    
FNETFPWLLAMR    : SDKQYY          KEJSXEALVWTTBDR NIEQJHOP        RHKECE          CXCWRAKURCHHQL 
FKTEEYUMKFNPA   : MANAKMOLYAJKCKC SYODBHNEQGMDOF  EKPYBD          MLES           
RTOAYCGSHVRUJ   : GEILWK          IEWXVT          TIWELGM        
KBXPORVSQR      : LXSWLLWBNJ      DCJA            WCJQPRHMRJ      KWQN           
BYUSYANTONUQ    : ULASOXOOTIAO    INXONQFF        PJYNKXLAKLVLAY  MJYDMY         
OBRIX           : EMKSFHD         RGNUYHVRIOE     MRNUIQJ         OIOAFHUAGFGNEA  VHVCP          
BIECAUTWNNQW    : USUMYVFTJU      RXUNXKQCDHJCL   BKVHKB          NIEQJHOP       
PSKPUXLJNGCJ    : BBCDAYQNTWULFU  CNQNJPO         VBQBCD          SJQCPKGWDI      GLGKR          
FBIEELMKNNGK    : SULBS           NEGXRNP         SQHTJDWN        XGTN            XGYGFLUPQYWEE  
VXBTOSOYK       : DSQC            OIEKGTQV        VYRAEXCPEGIJSY 
YVUOF           : EEOADGEUE       QFTCBGUGO       FIOVUNQRHLPHXL  RGNUYHVRIOE    
XEDYMHFYTSOJYYT : PPBSOQG         HTRQEECU        WGMBGSUFVYDMQ   BAOTRKEFAP      NOSXKAKCO       XABEHY          JWEWLDUBHTRX   
WWQM            : TGJVYNUO        SULBS           BHHLTMW         KTOAA          
FNDOPALEHJ      : ATRINEMOJDLUS   SYBO            XWFLE           AATNKEVPYQGIXU  IXUIWQLKFXOQO   DAHTFVDCJ       STEJBRKVRIIC   
NOEDXMCRFSEGS   : LHWJGJVVHVEMMM  EVBGASROROY     MJOMWMBOSB      AYCOAXWLRO     
DPXWEQCSVT      : BTVLLXUQKKFDTX  EFERGCXYH       JEDUVMRXIC     
XHOFQRVHY       : KYRFN           KOPKIRUHR       MWYUJQ         
FLDAQVEWOECHEYL : JOFXWNLRLHPNP   VTGO            LXSWLLWBNJ      JQAPMBGSM       DYYTQX         
EGTAQRH         : SVIELNXGPVYMOP  UMTCIFVVETEU    ULURBEFROGW     WTSWQKQN       
ABAVIY          : MTYJ            NPMLLXNYKQWHGQU EUCQCSBT        JMJDPFH        
OKAODVSCNYFUE   : NJHGSMBHTRX     RXPRLJVT       
IBMPWMGPWOPXP   : JAJVNWU         RDPDQEYNSXG     INQGNRM         CHISV           AIPUUPOJMH      AWAHUFRVYKHM   
GQKWCK          : LVQEYDUTGJJTPT  MOQODV          AJBQAQXDBVVBAT  GYTA           
HIGMVGRS        : OAHIFO          WKEBGLFBQELSD   TWGAIIDGYWJT   
ACPNTNCCDYRUY   : FNGQJNBMCVWWNVV YLBYAKCYDN      SSFHUDPDT       UVDYVVGSAUMHR  
KIXUFCHTMRCYQ   : PLAJM           ORVNOI          YHQJE           DYLKGMLIPCT    
SJWSNNIJBL      : PVCII           JPLRDFHQASGXOIV CMMLVPQGJQEY    VENKUQKQRIEM    KVVKWTWAAIFY    AYYBSGAMCSUUAL 
GKEBKNNSNKASRV  : ECRIOAGGX       KWJTJDXAQHHK    RIDDGQI         IQPDRWSQ        SDKQYY          AXJXK          
LYECJWOHREUBO   : DCHEXTRYXCY     MGGOJYBJAAPHMU  QEBPCHWURDBXPII OTNSEXLNS       QOJDHVJJEG      BKHWGNANRNMG   
MDEYJHLWUGMHHFB : VQWRIAHUPGBNQRK BGTERONYXJ      OXRIDRW         NBWXBMOXVIVIDHX MUFCU          
KMEQROPGXIMU    : XUICLMBXUPTLDU  WQQPVLQJOTBMQPH IIEJ            APHIHGPVQR      PDEDBB         
DSXGYYRGLO      : QOKYU           DGYNAJYUTXNEU  
TEKDJLHW        : IENJCSIMPISIRY  IULDHGEGPT      EBBDTQUYKRKOUQA SADNQISUM       GSLWCQRRC       WNJDRXJDM      
NNRCGA          : TQXLHC          XAYTAGP         SBSGH          
QNUCSPCA        : WUVLQVR         BSUTKADQCQ      HPBISFD         KQMJJIQTOAAMTUH FOJRQKFEILLK   
BRWOJAJPMMY     : WVMG            KANEKYESIAFIIDL EMOJ           
VXBKOSOUTRL     : UOHB            LDAADWJWIKLDYR  BOYQ           
MNCFRETSYRKITV  : AQTQKRGWE       DPEIOWBAB       KWQXLEWT        TVWBRQEJOWWJ    RIDDGQI         KSPEGJP        
HKYHHAITOCIJX   : WUOHOBTWELVYRXD LGPUIJGS        PAXJVL         
WHRKJWEOQYPKJ   : RRFWYDPQKIXT    XGHTAQBBOLYQJ  
FFAMQYTAB       : CCJIUNDNWPBI    PEBHOFDANFUWBCF ESDFMD         
VPHGYHJX        : KMUSRY          UVDYVVGSAUMHR   MRGW            NWXKKSPMTXMAAU 
BIAXOQQOGCXGHGG : RPHFTRNUI       ODMEDVK         QKJHVTC         VLKKYM          LRGCYPTOI      
YIRBJWWAGDBNMA  : QLXGUFWTHRWLO   VRNHDUBA       
PKHNAXFQHJ      : PFTGF           HEWOKYD         TWODGSJERC     
NSWWOX          : MVJLMFSV        MWRIEBCVGH     
GBQG            : MMLCXROFYYO     QKYAYMOUWUJLMGI XBJNJ           NKAESGDSF       GLDLXBLAM       ADYLUGDXSBJOERK
SMEWDSWJJJQ     : IPAEPPPHI       VGLIF           VLUDGVUUPUTPNSM CYULNWPVITH    
LRGCYPTOI       : OAFBYQOFLIX     EGDEXSPEPHJPE   BIAXOQQOGCXGHGG FTCHDKNC        YRJXYMLYLW     
LYRSGUMO        : JDAJLKRADX      JJWYR           KEMWQEQIBRURS   PIHS            SCQELSLRLQVYDQI
FDACGUBSGLJ     : UGIGSFARLLUJC   QSMREJYFXQ      GANVLRGAJNWHR  
WBOACHVRROFRIY  : GLXXY           YNTTBTPYQJATLK  XQVSKTGEADL    
ELOAS           : CPMGFNELC       AVLEWFIVGCKB    NHNCJEO         XGYGFLUPQYWEE   VQNXLIIQEVQ    
CXBWYTEKFMKJDML : LDIKIAPVVRVF    PXWWRLT        
IFDYLWIMW       : EUILMMXPSCGWJIW EWNBVNNCRV     
ANOSFQQIPSE     : ATJBBDPFX       XOWUTYPMD      
FKIPVMEJWOPCOD  : GHNGWRDCBID     BDRSTILRSEKPEJ 
YPVNPLCKTUC     : KQIUX           UCOESDEXMTFSV   PXRLACBCQV      PQWPB           NTMQSIO        
KWJFC           : UGKLDORGPARAW   GNDQYD          ATJBBDPFX       RECNAYI         HLMAU           VGLIF           AHPGHIPUHUBICMR QHNJKUMHELTXG  
PSRCYBCOSEFVGEL : QQGSRGCFPGIS    IIDGYDDE       
TDQVOKQSMBPVI   : UGIGSFARLLUJC   HHYSYRXDNB      WBYPHHWQPR     
RBMLDMPHDIMKF   : XHVHUS          OKGY           
QSWKWNGLAY      : RRUEFCVKGGDM    YRJXOFHJPXX     HXJLETE         KJKBM          
NCTLNNGOBTTPJ   : AQQWUKR         TMPMLIIPQOEKNWC
USQFAJVSIGPY    : OLAPGLCHIJRV    KSEWFCEVCGD     GEQPIMVCBE      NQAATDUHYYPEV   USRRAOVGOOAFG   KJSXUNKWUSHU    QHNJKUMHELTXG   GQHRQHJBC      
DYPHOTDDHRLXUF  : FYWY            RPJS            YKDHSV         
KPWHKNM         : MNWNUUUP        YFTO           
YKDHSV          : AQKYTPDDEDOOXQ  HCUUYMAL        DYPHOTDDHRLXUF  UDBSNIKQUHKYMG 
JYKYJYSOCD      : KJNA            UWBTOHRCS       BJJLCK          GHAYLF          UHSKJJSRSBJORB  XQOTIGTAFO     
PBDVVPLS        : MBYGOXDCIOOL   
VGLIF           : GKCSCHUNJ       SMEWDSWJJJQ     KWJFC          
NPQJ            : RSKCNV          SXNVP           IMDXRGLRUKIC    GLSPFLLKKWUSJJ 
ALKBU           : AKOBLABNTNNCC   WOEDKM         
UJOASHBXDA      : NADQNFLAPDEW    MVRLFVF         LVNAEGUG       
QSNOAAWHXKYPW   : PLGFFW          PEXBPXLBIV      EARCHYXSAOML    RMFHLXDQFXV     VRYNAQ         
PIKRFWOQOO      : GEQPIMVCBE      RTNGHT          EMPRNELLYD     
VRKYRBPNQENQ    : UJBFBMIUBQYLC   XOPIUP          MMUWPAKXGOKXU   DYLKGMLIPCT    
WRPW            : YSTWAQGNF       EARCHYXSAOML    TCYLKLP         MUFCU          
MWYUJQ          : KVRWKFE         XHOFQRVHY       KJRJHW         
HHTX            : ULQQEDIJETVG    ADCUDGP         GIRRWMTOCIOTG  
FTQR            : TYCIVQNFTRLPIHY GEQPIMVCBE      IHYMBTI        
KUMXMSNFVNW     : FYWY            HROQ            GEBJFBTRAEAJ   
KGYJG           : NPCTPRDJE       QKAJQTX         UYXGU          
SYYCJUAHAVXUQLP : KRDBKKYJMXHX    URAWF           AFRDEIVQCA      LKWNEQEFQGIDYN 
LEVA            : PIWCVISQS       TIKHB           LNSYMPPRHI      ICTJETLCTPSHRL  DYEIBOTJWTLE   
TNJGAQHLY       : KRDBKKYJMXHX    JXPDOOOVSN      UVPWLJMU        JWVOKGXIOBQXS   KCMFLOMXDVAYIMQ NRTWG          
GXGLHBL         : IENV            NXJITYQK        SEBOVWXCL      
EKPYBD          : JYNVWXIKYL      OOSHQLWIFFK     FKTEEYUMKFNPA   FEXALHBQJKHSKH 
HPVFR           : NFKTVWHRXVHNNQX KWBATPQI        JLMFNSLCJXEAD   MPGBQDQINTSYREK
AHPGHIPUHUBICMR : IENJCSIMPISIRY  IPOG            KWJFC           NHSJQMEIE      
BJJLCK          : RKBFDR          GITDU           JYKYJYSOCD     
FCVWAEOG        : IOHJMROUJTWIN   LGPUIJGS        MNHDUKJVG       SQUIXMPTQPGRG  
VXMFJCA         : FEPUOUGTAYW     NIFPCVO         ULCHGRT        
YEBDQTLTFUHHI   : WVMG            OBDMBAGC        BPTVYASRBEQCJR 
PMUMMYE         : NBPTYVWL        LKYVOWANWEQFAEQ NNOCAIQWPHDTJ   DIQD            TXMBD           QOXVWLBXYXDPR   QRQQXFQDHYRXNU 
FCURIEVKXXQBB   : IORUH           CTTTCXBGRKE     BTKFFVFXRW     
WOEDKM          : KDPYKGLKY       BLDVJFPUJ       WEJDV           COUUNCCAEQRSOA  XEVJLTLQCJYPF   ALKBU          
ULCHGRT         : RRUEFCVKGGDM    XTRXKH          LUBFVKDM        STJNOHHMHDA     EQBHUGNTLJSK    VXMFJCA         EFERGCXYH      
VQNXLIIQEVQ     : KJNA            YHATDDPWKN      EXIWUTUCYCV     ELOAS           BJGTJESDHBO    
MRGW            : OQUOFBY         VTAEGVYTNV      JGKFMYBC        VPHGYHJX        EXAOQKQUWDHB    UDBSNIKQUHKYMG 
UEUHQHCCMLKE    : KCOLPGATV       VDJACR         
UCXJAKR         : XISHDE          WFITN           EGXRELFGPNRLKRK VNAVFDIRBUV     SEEHBCGWNOA    
DXHTBVNJT       : NJHGSMBHTRX     LIIEWDTJLOGUKG  PSASSEUMMLMUS   KMUSRY          NNHTAIRURMQG   
EXAOQKQUWDHB    : EIMDGDPFVOLOHVC XEVJLTLQCJYPF   MRGW           
DDLOFVGSBGAWHY  : VAOJNRA         LVUWOHSUHA      JPJLSYQELS     
SSSXSUMLFFG     : UGKLDORGPARAW   SLCQG           YVNLYO          IGFW           
KNDXQIJ         : GFJCJLLBTMMQPLH HDEHPMNOQNCH    YAQMAYWEFME    
QHNJKUMHELTXG   : BPYYGE          AQEKCQULUH      KWJFC           USQFAJVSIGPY   
XYKMMPRS        : DTMHOPXKCER     WXLYTDOYWBJ     XBOIFXW         EUCQCSBT        DRJBTWV        
FIXFCJOHA       : RDPDQEYNSXG     EQBHUGNTLJSK    TFVNATAKUPQH   
XJKUVTYJ        : LOOQO           XABEHY         
YPFWQPJ         : QXAKMQ          UOHB            KEQVFNFTIS      SORPJQPITCKTWO 
FEXALHBQJKHSKH  : MJKJMHON        CARIOQEMGP      EKPYBD          GFMSGEVHSXTKX   SPTBFCSG       
VRLULNEBMU      : JAYR            ITGRSWXQAW      YGAI            XOAEN           COMUSGSKE       NOMUJXN        
MNVXREEPGPYHI   : KCOLPGATV       JQAPMBGSM       MTUWKYWHOTLL    WTFDS           WAXQHMGFB      
RPCEYUBQJVEW    : NWTXXWAB        OVQWFCBRMR     
GLYOXN          : JMQBXLEFSWFOFE  XLATRN          XRIWK          
YHRDYAVY        : XBKQPSDR        HRCKBYY         JOFXWNLRLHPNP   DYXHM           NQSDNUGOPLU     SGPQUQVEAUPTJV  WNJDRXJDM       LDBCSFTRXNEERO 
GHAYLF          : UKAOCDTCJOES    VVNJOD          VYKHBQDTAYJH    JYKYJYSOCD      HDENHBWTPL     
HIPQGVNICBKT    : VIUF            NDVBMPCT        FOTRBHVOIAC     KVVKWTWAAIFY    UQDHM          
AHBHBGGB        : QPHLEYJDQNUJLL  DXFNOQO         TNHIRE         
HJLPMKBRIKCA    : YEEACWVSFHWKTM 
IWQSBU          : XISHDE          SKXCCKRXEDJY    MEQAOOCG       
UWFCAMF         : PBPLPXGVI       CYNR            INWPHWIJAWW     FANKCQJALHJ     FJLATHRHYBGTOX 
VHNDQB          : PUCFBBR         TVQUOTLTMR      CTNQITQWMJ      UFXDJXN         OHLJLCBJRK      RGGODGMBWT     
FNYYV           : XKUVVXJ         BGPKCUIGAUGV   
BYNLXGHYBMWXSB  : WYQAIXNVMK      PIHS            AQEVUFXSBMNC    MBYGOXDCIOOL   
HHHDOWJHXEP     : MUYWOM          FNGQJNBMCVWWNVV
FOJRQKFEILLK    : KHBCS           PSBRJBQ         VMKBCDGVDVNQ    UCNJDUPIYC      KEQVFNFTIS      QNUCSPCA       
YJNTKOBRXHIUSSU : DPEIOWBAB       HCUUYMAL       
IGFW            : LUOWMCWH        XJXLRBQM        PVLNK           SSSXSUMLFFG    
WPDEUN          : UYHFCPY         AODXNCO         LPWFBNQE        LPHSMIEFMEGSWSD LJGYBSQJ        NWXKKSPMTXMAAU 
IAFHJVBUK       : EOEGTUAMMD      IKNIXHALWD     
OIOAFHUAGFGNEA  : LPWFBNQE        MFYLQMRKQDISDB  OBRIX           PDQQODEHJO     
UDORTHATOKGKN   : TQXLHC          UKRUBUJVPSKG    XBJNJ           YVJIPYPSPO      NOMUJXN        
WSRHHTM         : LBWIIGR         MIRLXNM         UKRUBUJVPSKG   
QOXVWLBXYXDPR   : STMHIMYOXDVJNP  NOAGVAW         XALAGOCBQPN     IXIKSU          PMUMMYE         HKIGKOIJVPKDPU 
YRTOEA          : PEXBPXLBIV      SULFFPJFKJFXYA  URNPGXUNRPFBFCA WTFDS           YVNIHSLINLQGNRI
SDBLUKVRXMIMMHM : LREXCP         
IKCINRA         : OPWBNUQLEWURWF  FTVXGPAOV       UKCPFTXV       
TTHKYHNRKOF     : KIBDSMQKN       SBCECHAUNWWQ    ROKPSCWUAHO     NXBPCHKKQYMMO   GXKBPWBURW     
ADBASKOH        : FNEXXPROUEVB    RAGPFOGYWQWV    IDHBIMBUIGOGF   KVVKWTWAAIFY    YYWMKYO        
BICNMMCFOPBI    : YHIUSE          QLBJIKX        
LJGYBSQJ        : ATJBBDPFX       APIVOABPJOKGU   CAVSW           LKUE            WPDEUN         
SOCUHOJPINAMBN  : YEPWWOKORHUSKQ  WYWFUJ          KGXTM          
FUPWVX          : WGBGQNLGHRX     YYBHIGDMNHH     FIOVUNQRHLPHXL  VBQBCD          SJQCPKGWDI      YFHFLJGUXOAWOIQ
HICILUYWXTM     : VQPVBEVEAKLC    EPFBFRHWB       USUTDIKCJI      XMDTMATIMTXJM  
OTQBLBO         : LGBDBTACNGFT    YQKLNRTUMBWEOIY NBAVXQCBWLI     DTEFALVQYAQY    KYLX           
PRAQAWGWSGTC    : HXTLI           TVFDBECAVAC     CBUFFJIIWLOJJ  
XMDTMATIMTXJM   : HMQFXPLGHSJXUII PXRLACBCQV      HICILUYWXTM     HFBEYKL         HDENHBWTPL      HTSWIJ         
UNPJDJLV        : BGMKROWHODDACWG FBUJVCVRFRMTX   TKSYFQSVFHUJYQ  XXLMQT         
ICJDI           : DSSOEGW         YTQVK           HOIOCWRWCKV     JTLMFKKGS       ERVPVNEUOML     HMYRVVURPFLB   
FABSDWHFQR      : IULDHGEGPT      XTRXKH          QQTDDHKIEXSCE   YRPDGELJY       OGVFEGQG        MJOMWMBOSB     
MPGBQDQINTSYREK : QJQMMPGRYWASGH  MUJWTSDDRCLNIA  VPAUSWW         HPVFR           OUQJGVCV       
NNFSVFUQKT      : PSRIAXNN        NXRUFWPPI       BNJKIUDVO      
RNRMCKUEBYUKMRF : AUUPLVI         XGHTAQBBOLYQJ   XJXLRBQM        EWNBVNNCRV      OAYAKMWI        XROQP          
JJAGAOLS        : GKGSASHWNTUNRH  RFPBLDOVFI      BJUL           
QPDDKFU         : LKYVOWANWEQFAEQ OCMMXJBMLRH     QSQYQAQCXWOJQ   RGIOAYGERLGYF   CPECHI          FHBSEUUUCSVA   
WKCJFI          : WTIMW           DOBJKTMRPSTFB  
EEXSXFJJ        : CAPUD           MDJR            JBVHJL          TVQUOTLTMR      KXRTBJXMYUPBY   HTRQEECU        QARRL          
JPOABIOT        : XXOGB           XGHTAQBBOLYQJ   VDXWUA          JPIPWMSEGNWT   
RWMYSMYDP       : NJHGSMBHTRX     AVLEWFIVGCKB    IWBODFF         JMARYRIQIHQLM  
KAVPEVKE        : OJIHICBF        MDYIUPBHNKU    
VOSGEHI         : EEOADGEUE       HBQQSEQ         DTEFALVQYAQY    SQHACDFIDK     
RXCSRAHRUUSAM   : IMJXVRMVILYEW   UJBFBMIUBQYLC   KFSGR           HEMHFGQQNCEYD  
KMACTV          : YLBYAKCYDN      AUTDNPETBNQUF  
XXLMQT          : YTBRKOD         EFNX            UNPJDJLV       
ADCUDGP         : SIXASTGXOBREWB  WXLYTDOYWBJ     MMUWPAKXGOKXU   KFNW            HHTX           
GWODR           : FNEXXPROUEVB    JAYR            ANLVTI         
FGLQTLU         : SNXKDDFJJMEPGW  SVIELNXGPVYMOP  PMGBEWSBBWF     LUBFVKDM        RVFJMUGKMPIXC   XBJNJ          
HMNHYDAUYDX     : OLAPGLCHIJRV    XRIKSE          NUIE            QWEHSCUDXWT     KDONCSMVSYQMBB 
XBJPYQM         : NNCKXTAKFIBY    XEFK            DSIBTAHHHUPTL   HLMAU          
VHVCP           : RECNAYI         NUIE            LXJVWD          OBRIX           WHITFLQHOB     
ULURBEFROGW     : VPTANYRLYRBM    WYWFUJ          YNBJI           EGTAQRH        
BVTC            : TANBWKDGOFCYRXC XABEHY          WFGFEOMCCA      AUTDNPETBNQUF  
TFIJEBYSXIQCXA  : IREUGIIOLHCPWAG FAFYVW          FQLNEQMWHXCKLJX IMRKOOWMQO     
KWQN            : CWPJN           DUPXL           TSKXUOPUSDX     URNPGXUNRPFBFCA KBXPORVSQR     
VFPCCHGXB       : WAFHYEUPEWGQ    LIRHPDGRKNTQLJU DLKAPULCXQFAE  
YVNIHSLINLQGNRI : FOISYPIGNQDDAPL JPIPWMSEGNWT    OMLLLMBWJ       TSNJVSED        YRTOEA          WTSWQKQN        XDIK           
EFERGCXYH       : JMLDSTVHPLSPP   DPXWEQCSVT      ULCHGRT        
INBLXAJLIRGWAV  : SVAEL           BUHMPVPEDTCNPU 
TCYLKLP         : CMMLVPQGJQEY    TQPXG           RDFJQ           CPECHI          RUGPQOL         WRPW            GYTA            DVUNVXTDNUW    
RHYUFAEIIRJT    : CWSDNXWBMDUP    TASBJNBMXU      NCNSALFRMYWSAGU TMAYB          
JEDUVMRXIC      : CUKEH           KNAEGFCFBCIFP   DPXWEQCSVT     
NBFX            : INIGTAFTMVLVVD  UCCUMA          UGBAWEH         YEEACWVSFHWKTM 
UQJFRGKRKUACEVT : VITVNI          FXYDHTTCBF      HCKERDKBE       NKSDCBJTCIB     AXWBP           AJJLEOGLWUHTKA 
AXJXK           : FFYHNGWJG       QDWGBCVAUNXO    KXDODMTC        KNAEGFCFBCIFP   GKEBKNNSNKASRV 
YUFQIHYJYT      : JSYQXYYNFVYNFW  YFGBII         
IYTPMLAHN       : LRTIYOJIF       GLSPFLLKKWUSJJ  OHWLURA        
MJYDMY          : XBOQJMC         JDAJLKRADX      BPFPIM          WMUQ            KGXTM           BYUSYANTONUQ   
KJRJHW          : RWIKVPHKEDMBA   XAKGEGAOYCTNWIF MWYUJQ         
PGCYF           : GNDLHNQGR      
BQAU            : VQWRIAHUPGBNQRK ROKPSCWUAHO     INMHINRJDUTLCU 
OIIXXNMKPPWO    : LDSGFARFT       GQGLRNNRLPVSAXH EWEPLFOB       
JBVVI           : YQRVSUBP        EFSRSPVHC       FJLATHRHYBGTOX  IHOAWYJAUNY    
YACDAIBBBDY     : IMWA            EKWUU           EAGTXVABPCQI    YHQJE          
RJRQ            : HHYSYRXDNB      DIQD            SQHACDFIDK     
IDSAV           : PCDWIQJHSI      KLHMINWQAO     
OAYRYUAUV       : DIWYFDED        BHHLTMW         OCMMXJBMLRH     YFTO            ODTMOE         
WYDHDGI         : JSPXI           WGFTOMMDM       KDEFN           GYTA           
FTBPOT          : OSLGVJEM        TLEHCJOMBYTLM   LMHRMHURQTVPE  
WYSWUINXJ       : DIWYFDED        WRCWWVLSIJQ    
WHITFLQHOB      : OYOXUCMCG       XNHQPKQIPP      CBUFFJIIWLOJJ   TSTDRXDLESYDTB  VHVCP          
VLUDGVUUPUTPNSM : TGJVYNUO        VUOXJEHLA       UERISKWKKNGGVHF GXXUSF          SMEWDSWJJJQ    
GKKOJ           : PLGFFW          GEILWK          BTDQCOHTBPMVYE  CPECHI          SPIHMHV         QKJKIG          YKFVFQWUVGNSOPG
ADYLUGDXSBJOERK : UIAUUIVA        FQLNEQMWHXCKLJX MWRIEBCVGH      GBQG           
MDYIUPBHNKU     : PPHPMSQWEGAB    OCJFJLQTKV      KAVPEVKE       
YETBITNFAQDTTO  : XAWKRR          YQKLNRTUMBWEOIY QVVXFT         
AHUCVACF        : UOHB            IUIEFEV         RQLWTTJPEQB     KTKWIKA        
TGHHQCKSIE      : VQWRIAHUPGBNQRK LOJBTKC         WYWSLLSUAWIJOY 
QXJXBCBWV       : GLGKR          
HWAEB           : RQLWTTJPEQB     GVDQDDY        
HFBEYKL         : VDXWUA          OGUNBYLEHVTRH   NBWXBMOXVIVIDHX HCWT            XMDTMATIMTXJM  
BPTVYASRBEQCJR  : JHYNYKFRUI      MEQAOOCG        YEBDQTLTFUHHI  
HKIGKOIJVPKDPU  : KFJF            RKBFDR          ISVU            UTKUI           DVLB            QOXVWLBXYXDPR  
BYHUWGURAVWQ    : VNILTBVKQPXBC  
GLBPXL          : YUCAIBFQNCGVBH  UHSQ            TINPLASYWULT    MMUWPAKXGOKXU   HEPFEL         
LBFUWUFCMDTNCB  : PSVBJHJNDGMH    JBYUQAEC       
BJGTJESDHBO     : MKEQC           PVDBBTB         EWNBVNNCRV      VQNXLIIQEVQ    
QMUNXVSSUQBAFE  : KCOLPGATV       CXGHGNSDQWBR    YHQJE           OHAVMM          IPFKEMXSCXY     XAYTAGP         MMCPLSD        
TIWELGM         : BSSHQDL         VOTI            OSHO            RTOAYCGSHVRUJ  
RTXUBYLLSYGGYEC : BVSURQUJYKQTV   NMLWIMMUWB      GFQYFYREVJY     YEBRSNW        
CSVCACVTMU      : FYRLVXGKSTTV    ARKCITSAT       OAYAKMWI       
XBPEULE         : TVFDBECAVAC     FTVXGPAOV       LYQQJLMRLWH     HMNBJEGKHCKYR  
MGEYYDHFFM      : XOYEYKGMGEHSRQ  IOHJMROUJTWIN  
AQEVUFXSBMNC    : FFXXOFERD       OGUNBYLEHVTRH   WFGFEOMCCA      DPOKCVCOY       KVYNXYNJIGD     BYNLXGHYBMWXSB 
OUQJGVCV        : UPQWQFCK        QJQMMPGRYWASGH  QWVFKQAKP       JRTHQQAP        XFTGSPDHYMUTD   SDIDAJETYWE     MPGBQDQINTSYREK
JUDMEKTQWTJBPEG : NOTHG           AYPIQPXSYKNCL   ENENJGV        
WICK            : OIYDCSG         QXLYNJSXWM      KLHMINWQAO     
NBHENOCRMGBHLQ  : RSKCNV          TKOSKJLPANSOJ   ERFVYOXTN       ECTJ            FIYKAWQL       
YKFVFQWUVGNSOPG : HMXHE           FAWJXKSPKW      IPERHECIRTVCQ   UHTODDJDN       VLKKYM          GKKOJ          
FHLMUCQNO       : HBBVMLXCKXKSV   OSAJGEBNXBXT    MUWDUCDHO       UKOQRPF         PUSDPNKYI       SQXQKUDPYY      MWRIEBCVGH     
OXLHLKSQIX      : AGHSB           FXKGACPMY       RTHESRXFFIAH   
GUGMIBDB        : CIFX            XHVHUS          NUYPDYGNU      
GIRRWMTOCIOTG   : FAWJXKSPKW      DWXNN           XAJDBYNNVITL    HHTX            COSLR          
BSNT            : PXTXLDYNK       YKVX           
VTVEPESAGVDP    : CYTMYIPLKYABRYY PFQQC           VATMTNXAVA      LYQQJLMRLWH     LGGUKBMIGUSI    CXCWRAKURCHHQL 
OHWLURA         : NYOQHECTSHI     IYTPMLAHN       MUFCU          
COSLR           : BDLCSMIRDFTCH   VYBSOYEHEJ      KLMPXINJ        OTSFWYTABE      GWFVVOYCIJWJ    GIRRWMTOCIOTG  
GFQTBLQIBWB     : ADATCW          PUML            BBJFEWMY        PQWPB           JKEUDMXB       
DAHTFVDCJ       : XHVHUS          JSYQXYYNFVYNFW  CMMLVPQGJQEY    FNDOPALEHJ      MPAPRCXPWBFBVB 
TMAYB           : PIWCVISQS       PXFENLIELS      KFSCXFIBAEN     RHYUFAEIIRJT    EEQYPHMXR      
KSPQ            : HOADTMH         OASBQCWP        BDLCSMIRDFTCH   RXGQNLPQYPRESSO CHVRHHORWEKIXP  AXWBP           KWQXLEWT        YTQVK          
JKEUDMXB        : VPAUSWW         LSNHLUWWPU      LQOE            SNHOIOVOLK      AFRDEIVQCA      UFNIS           GFQTBLQIBWB     BMPOBYJTC      
BGPKCUIGAUGV    : TYCIVQNFTRLPIHY MJKJMHON        FNYYV          
IUIEFEV         : JLMFNSLCJXEAD   AHUCVACF       
GFLKAQYA        : DATHJPUSBKNTCO 
PEBHOFDANFUWBCF : OYOXUCMCG       DYYTQX          FNCQTVODYD      FFAMQYTAB      
MLES            : MVKNMDEIDE      SADNQISUM       FKTEEYUMKFNPA   HDENHBWTPL     
FANQMQJMQEEWH   : EQBDGOBHEC      BJEF            KVRWKFE         FTCHDKNC       
MOQODV          : ULRKR           SFQPAHAQ        HLMAU           KHJAXYWEIFRMSS  GQKWCK         
AXPHUETYAEEATWO : IENJCSIMPISIRY  RWOB            XDNMPVUGY      
HDENHBWTPL      : LQOE            LNXD            IJUKTUVFKODVCIP NPMLLXNYKQWHGQU SGPQUQVEAUPTJV  GHAYLF          XMDTMATIMTXJM   MLES           
HDENHBWTPL      : UQTD           
GQHRQHJBC       : LJNAJU          VAQHWYKPCXBERM  USQFAJVSIGPY    GLGKR          
WDOB            : WIVKEVAVGGUD    LIGVFRDHQT     
QWJHIQLOGUR     : GAPCKNVEQFFFG   KFSCXFIBAEN     UMXMREPTHHV    
OIRCQILJCSUDW   : BIDTKLXXSLC     REQRXQ          GYCMEB         
CCAFMSC         : UOHFPLMGHKK     RNFUJQVKT       SIDJTXQF        SARMI           WVAKGEONEIRRPAJ MIRLXNM         VHQPCEWBLVOPJCP LDAADWJWIKLDYR 
BMPOBYJTC       : HGDQEA          YHATDDPWKN      DSSOEGW         BHJBKKLKGLG     JKEUDMXB        GHLEMKPQ       
EVFUF           : FLLLNSBVDWHHT   DYXHM           NOTHG           GHLEMKPQ       
GHLEMKPQ        : JDAJLKRADX      IENV            FXKGACPMY       BMPOBYJTC       EVFUF          
SVALA           : IJUKTUVFKODVCIP JIKDUQ          YEEACWVSFHWKTM 
ONOFQNPMSSQO    : LKWNEQEFQGIDYN  YYWMKYO        
OVQWFCBRMR      : WOPOUI          HDPBYW          RPCEYUBQJVEW   
YKGBVHAN        : HEUOJTOABVSETNS ORVNOI          CCAVOU          PECOAKJHEO      XLATRN          HIXQRMBRC       YMCPUUUYDWOFJA 
PSLFKBXDR       : SWEHIHBQPBAIMF  UMTCIFVVETEU    DUBGLAFMMMDJWXP COUUNCCAEQRSOA  AYPIQPXSYKNCL   DFFOFBLQ       
DILTGRVHLKYWMJD : CGXB            NSPAYDK         QILFYDMF       
IKOXHGSVLEWMJQC : WYHSNHTJCYF     OYOXUCMCG       SIDJTXQF        JOTLV          
APHIHGPVQR      : WUOHOBTWELVYRXD HPBISFD         KMEQROPGXIMU   
DDVTLJILSQFQCLN : BVSURQUJYKQTV   RGAUR           USLSHUGBRAWXX  
UHSKJJSRSBJORB  : NOWMBXLPVG      EPONHODQRYBWP   YQRVSUBP        VBLCMQDASXUN    JYKYJYSOCD     
XFGRSRC         : LQSJNR          BBJFEWMY        QQTDDHKIEXSCE   EXIWUTUCYCV    
KSMCWXRMUBHGKSB : SBMBWKQGVKGDEDK UYHFCPY         LBAV           
MCOBVPLVU       : XLIDL           FTIP            FXSISWS         PBYCKU         
NOLRV           : XNHQPKQIPP      TLEHCJOMBYTLM  
KIAI            : NUIE            CCHFWNMYYJPXJJA KDDACGWUDNB    
UWBVGJJAK       : SULBS           XMBFNBX         BQHWJHEKUD     
MMCPLSD         : IDHBIMBUIGOGF   QMUNXVSSUQBAFE 
PWXEIPCHBK      : AKJKBCFOVUDIVYE EXYCYWJWVNGQJ   BQLBPJQCIG      FOQGRPNB        TKSYFQSVFHUJYQ  TADNED          GLDLXBLAM      
LSGKUFQEOQRE    : ARKCITSAT       JUTINEDMXMWOEJA QLBJIKX        
GHVRCYARYXY     : ETJTKEESOFUJ    QJYUM           QSNHLTEJOLCNK   EBBDTQUYKRKOUQA ACIMTSYJ       
PDQQODEHJO      : DSQC            ONXPFHT         PGSQIBLKDBAN    OIOAFHUAGFGNEA 
QILFYDMF        : YYIVJ           LBWIIGR         HJPTFJ          UWYGUOSPGQSW    DILTGRVHLKYWMJD
VDEXEGRDGSNVW   : NJHGSMBHTRX     GFYUOOLQPMDDVQ  JEHMPHT        
NLJTUVJAMRN     : HBVSBNNUBBCLNB  IFADA           NSPTAXRSR       OQOSFBLDMY     
SQHACDFIDK      : TNPHKQBKV       WVMJAFWF        VOSGEHI         RJRQ           
UNUQDRN         : SGGWY           NOAGVAW         UYXGU          
HBTDXRMAFGNCCGJ : AFMKIMIIFULOWJJ APWIXEBNETSJ    PAXJVL         
LOKTTULO        : UJUAALPJCS      PVISNMBKKSNLTFV
IHOAWYJAUNY     : ERCNLIAGALGCWT  VOBOJFVL        AWAXVSUUIXKFF   XNETHHUUPBNT    JBVVI          
CYULNWPVITH     : YPHIBJWYJJCXX   QEBPCHWURDBXPII LVNAEGUG        SMEWDSWJJJQ    
EEQYPHMXR       : UOHFPLMGHKK     UFFVBC          TMAYB          
BOCMPWAOMFPHQD  : LJPAEWDKCBJTW  
GCMCJLHP        : MDJR            GNWOWY          BMDUUK          XLTDVPT        
GFMSGEVHSXTKX   : QWWS            OFDXIDNUQCBV    EXNNONOUSIIYI   FEXALHBQJKHSKH 
YMCPUUUYDWOFJA  : UJTNYUGNLNGYU   YKGBVHAN       
BFVHTQ          : KEVVJMUBJ       ORVNOI          OCQXQDNYXYD     MNGXSWILOEXLQQV YKFXSGOA        ABCWEPTQDWOUD   IXBFQYKFM      
XPYSPSGPRFDV    : LNXD            IMASWWXSNWBCXUM
XQUYVTPEFSS     : DYEIBOTJWTLE    RHKECE         
XQOTIGTAFO      : LJKEWXTSFELQKV  JHSJNYIYTSIJPJQ MSAVFOXVMDAUJDT IMDXRGLRUKIC    JPJLSYQELS      UVDYVVGSAUMHR   JYKYJYSOCD     
AUGSBLOAJ       : VPTANYRLYRBM    WUVLQVR         NPGAXORYBEYKC   JHYNYKFRUI      VYBSOYEHEJ      HIDBNDDQ       
UKGPBKUTECT     : HBBVMLXCKXKSV   ALOBHDDCKMK     LKBKWKBUHAMUTN  COMUSGSKE      
SNFYHFGVX       : OIYDCSG         JVUVYBEFHGDETO  FJLATHRHYBGTOX 
RGAUR           : VITVNI          PXTXLDYNK       TTLBYLQVG       FWMPS           SWMYLSPOMUG     DDVTLJILSQFQCLN
UDBSNIKQUHKYMG  : ECRIOAGGX       OXRIDRW         YKDHSV          MRGW           
FTCHDKNC        : MRFAYA          LRGCYPTOI       FANQMQJMQEEWH  
WTSWQKQN        : YERYTPFXTFV     QWBMOBUXLDT     OMWPYGQPJ       NIFPCVO         SEEHBCGWNOA     EGTAQRH         YVNIHSLINLQGNRI
RGFC            : VDJACR          MDJR            SAFEOOMAODK     QRQQXFQDHYRXNU 
WXBJWNQVUMYCQLS : SGGWY           FOINN           HYEGCFF         HIXQRMBRC       HMYRVVURPFLB   
XROQP           : LNXD            RNRMCKUEBYUKMRF
BIUS            : LDIKIAPVVRVF    FYFSSOJDFW      JQTMMAT        
EXDWUBXHAN      : PJUVVQVCMTBK   
WJMXNFL         : IORUH           INWPHWIJAWW     DKKRXJHOPQHTSO  JPODPLBHIN      NYOQHECTSHI    
AJBQAQXDBVVBAT  : EFXUWLUBMNDRC   HRIXTGBUBTUKRAA MVKNMDEIDE      GQKWCK         
YRJXYMLYLW      : TKOSKJLPANSOJ   LRGCYPTOI      
JLTUTTEULGNLJOH : IARYVXCRPVB    
SHBBHSLHT       : CKBFR           JSPXI           LXSWLLWBNJ      KHJAXYWEIFRMSS 
USLSHUGBRAWXX   : VDPTCPMQMPU     HYEGCFF         DDVTLJILSQFQCLN
ENWPFEUXOXB     : ATRINEMOJDLUS   HVPO            SDON           
RMFNOAJAUQWDT   : RXQBFL          CPMGFNELC       KVYNXYNJIGD    
ESOEEUR         : LAHGE           GRJVFPV         UKCPFTXV       
KWHFW           : QSNHLTEJOLCNK   LXJVWD          JXGJTLXHXBDN   
GYTA            : EVEIUMHDJICLV   IKJXTOSTA       WAYWFJH         GQKWCK          TCYLKLP         WYDHDGI        
YNDCWDYPDDLTJFJ : MGCHUIFU        KNAEGFCFBCIFP   CFTIYUIGTOAJ    OKCJQOAA       
JEHMPHT         : UJTNYUGNLNGYU   TFGORJNXXX      VDEXEGRDGSNVW  
ESDFMD          : TKOSKJLPANSOJ   GBJYLCFMYVSJTUL FFAMQYTAB      
OTWSQCRJHWU     : LXWSBYTEGOGTJE  PMJDDF          PVLNK           DYYTQX          XOAEN           TWODGSJERC     
GANVLRGAJNWHR   : BJDXSWBRTSV     LGPTOTQKYRFYRS  FDACGUBSGLJ    
MAESTSMSNFWIOF  : PPHPMSQWEGAB    OPJWOOYMJGV     EGXRELFGPNRLKRK SXNVP           KANEKYESIAFIIDL RSTOWDQKQMEYGUL
MJOMWMBOSB      : LJKEWXTSFELQKV  VGWUCWCGINJLNRG RGNUYHVRIOE     NOEDXMCRFSEGS   FABSDWHFQR      KDDACGWUDNB    
GXKBPWBURW      : FPQYSW          PTTRVBRHEN      TTHKYHNRKOF    
EPEMM           : OTFFIESCEKGHCQ  VLHIFE          MPCMBONMLXNIHNX ULSDYBFXFCG    
BTTPDKFAXGRSJS  : LYNESPRKSVPVRG  PSTL            KCEWASSDQABN    APWIXEBNETSJ    OKHIM           OAYRXVETOIDET  
KDDACGWUDNB     : PCDWIQJHSI      GLLRTGBMPKTRA   OGYCYULMU       LTVFYGXCIYRSIMM KIAI            MJOMWMBOSB     
TNHIRE          : OGUVJ           INQGNRM         TAEE            AHBHBGGB       
HHRMKRUCKF      : SFJYDDFFFNIC    BQQCYISHUMXY    AGGAXBWSYPWOQ  
MPAPRCXPWBFBVB  : SQFEXDRCUOX     ILPCVTCFUOOFHX  DAHTFVDCJ      
GLGKR           : LSBHCHH         PSKPUXLJNGCJ    QXJXBCBWV       GQHRQHJBC      
TJDEBBIMGF      : SLVBEJNUCOKUSF 
XFRRIPJHTQIRR   : TXEDQINRHN      ARCEAAVJH       FNCQTVODYD     
XDIK            : LMHRMHURQTVPE   OUJFTFKWXALWEB  YVNIHSLINLQGNRI
YFHFLJGUXOAWOIQ : UCJG            JGCV            CFTIYUIGTOAJ    PXNJNAQKQRBYACT EWEPLFOB        FUPWVX         
SJQADHLU        : TQSQU           QOJDHVJJEG     
LVHTG           : PWKTCSIEBOI     YWYQXCJIUED     YCNWWSUPQQPU    OBACDJPCWVFN    DNUI           
VLNDAYJWWAWVO   : RECNAYI         WNRBVWQAVHTERT 
NUAYNBCXOYCAU   : QNJPGHS         TGBXAFQAGCMYWG  HHXIOGQTTGBDLVS
VCRTPH          : XBOQJMC         KJNA            YQGOMIXEVJ      XXNXFNWC        AXTNNWBASQ     
RGGODGMBWT      : EMKSFHD         QWASVI          BPPRX           VHNDQB         
SUPIX           : BVHETEPG        NSEJBQMUEMY     RLIAORIEP       RUUAKTXYYXV     UENVY          
IMRKOOWMQO      : JECEFSGSUWR     XNETHHUUPBNT    TFIJEBYSXIQCXA 
JVEB            : BGTERONYXJ      XWFLE           EQBHUGNTLJSK    GDNCGUGY       
NQHTFITBAOXPW   : UKLIQMVRCEO     VNAVFDIRBUV     KLHMINWQAO     
KGKES           : VRSTAF          LKWNEQEFQGIDYN  BPMTTGAFBNYOEWO
SPOMEVXCAY      : JHMQMSU         IMJXVRMVILYEW   LKUE           
NRPKW           : NPGAXORYBEYKC   NPCTPRDJE       HASUBVRHV       QDLXNPHBCLUQX   GTKU            KFBQCF          KSEWFCEVCGD     JWEWLDUBHTRX   
EBBSYSRVFAIJTKF : EPFBFRHWB       XEFK            RESJERDHQCCMYHR XBMC           
YTSURUWSELNTX   : MNWNUUUP        WGBGQNLGHRX     CNQNJPO        
UENVY           : JCVUF           HAEALDHHCYIVCC  OQJMFTERQEVFW   OAYAKMWI        SUPIX          
RQLWTTJPEQB     : LXOTBUHWWV      OKHIM           AHUCVACF        HWAEB          
MVAETXYX        : OCQXQDNYXYD     VLMC            NWMPVYWXPMY    
MRJANNPL        : TXEDQINRHN      AWFWVOOBY       JFOIQRULUM      ERWDDXPRMF      RFFCF           QWSLFGKYB       HQDPDWUYQ      
DFFOFBLQ        : XKYLNGS         LGGGNXPCLJN     KGPDEJQ         PSLFKBXDR       DDFQKJKOFWWN   
PJUVVQVCMTBK    : NCQKT           EXDWUBXHAN      JDPOSILYRUSGL   YVJIPYPSPO     
QFOSUEIISMOYDVC : YFTO            VLHIFE         
MTHV            : OLAPGLCHIJRV    BPRG            QJQMMPGRYWASGH  GNDQYD          RSECBIIREEMSJNW SWEHIHBQPBAIMF 
DRJBTWV         : JSYQXYYNFVYNFW  NBESQGVE        DOGKUWMVTU      RABKQSCOSQ      VRYNAQ          XYKMMPRS       
JDPOSILYRUSGL   : AFMKIMIIFULOWJJ KELJXHLJKRT     PJUVVQVCMTBK    SCQELSLRLQVYDQI
JHVBVRITINLU    : YAQMAYWEFME    
HRMG            : HLUYP           CGFVDLIERDCW    LGLELQHY        OBDMBAGC       
QWSLFGKYB       : NPGAXORYBEYKC   AIPUUPOJMH      MRJANNPL       
HMYRVVURPFLB    : EXXBFFCJG       RXSAXD          ICJDI           WXBJWNQVUMYCQLS
YVJIPYPSPO      : JHBPYTGB        VQICBWLTIAQN    WAFHYEUPEWGQ    PAXJVL          WCVXYPJUHQHUTB  UDORTHATOKGKN   PJUVVQVCMTBK   
DVUNVXTDNUW     : UYXRQYKYPW      ISVU            SUCJFW          QNHU            NIEQJHOP        TCYLKLP        
STEJBRKVRIIC    : THYBCDWNBA      UXQQPUXO        FNDOPALEHJ     
HTSWIJ          : YQGOMIXEVJ      VLHIFE          XMDTMATIMTXJM  
HEPFEL          : FMXFUYSYLYQGQB  ECRIOAGGX       GLBPXL         
RHKECE          : HBBVMLXCKXKSV   BKVHKB          TADNED          BRUKYNWNMFOIXYR FNETFPWLLAMR    XQUYVTPEFSS    
LGAXCTGKYG      : QYFD           
SCQELSLRLQVYDQI : TINPLASYWULT    LYRSGUMO        JDPOSILYRUSGL  
ULSDYBFXFCG     : OLAPGLCHIJRV    LOFTBN          IIDGYDDE        RUGPQOL         MDXWSPODEMCBHLR FQVDJKSK        EPEMM          
BPMTTGAFBNYOEWO : POXNIN          HCTIVG          XBKQPSDR        QGBHSYAFDRFHV   VNILTBVKQPXBC   KGKES          
NWXKKSPMTXMAAU  : JOFXWNLRLHPNP   RCMIWPVR        VPHGYHJX        WPDEUN         
BKHWGNANRNMG    : JPDVU           UMYXGCJVICKSNIT JJWYR           LOJCIUVC        AXTNNWBASQ      QCSHKAKQL       OBDMBAGC        LYECJWOHREUBO  
MUFCU           : HIPFOBQUUTW     MDEYJHLWUGMHHFB WRPW            OHWLURA        
NHWFTSDG        : OUJFTFKWXALWEB  AQGMN          
DCPGOXGVNG      : XLUIE          
FVYMQLJVNG      : GLNXJYWMXUETU   DPNFW           YEWI            RAHKFVFLJXO     DAWAFQTMTQ      MWCNYDJOQHPQAH 
DOBJKTMRPSTFB   : NEGXRNP         XTBVGKLM        NPEYHIEN        SWMYLSPOMUG     KVYNXYNJIGD     QCXPHWE         WKCJFI         
FHGVPSDMRRFFCC  : SLCQG           BPGLGNIKQS      CINDWQPLFBKHNX 
IGYYHK          : NSPTAXRSR       YJFYCUPF        OQUOFBY         YRPDGELJY       NXMHPFPHTEXMBPP
BYESRAYTKGDRCT  : PGYYXHQWTJBC    HJPTFJ          DIXHCNXMIOJW    TKSYFQSVFHUJYQ 
GIEXNJ          : NLNAXOVMMX      XAKGEGAOYCTNWIF SKXCCKRXEDJY   
RGNXFOFRYJRDC   : SVUUAGHUYXTJOJD SNOQL           POXBBSIQ        TQTHOUXSFKEV   
DDFQKJKOFWWN    : YTCKNVTLTQ      COGLBXLQIUFLCPQ VDHUWFD         NFHLGSHJQADAYJ  DFFOFBLQ       
XBMC            : OIYDCSG         EBBDTQUYKRKOUQA NKSDCBJTCIB     RABKQSCOSQ      EBBSYSRVFAIJTKF
SPTBFCSG        : MNLFBP          EIKXPGTQK       VOXWPIMVHRCNKK  FEXALHBQJKHSKH 
KMPWRTCIGNSW    : FCJVDTUBMALND   VVNJOD          XDNMPVUGY       LTJINUBH        NWISF           YFRIQCTVFFN    
PUGSUKH         : KBCSPDHPTKMWQH  KYRFN           ERCNLIAGALGCWT  EBBDTQUYKRKOUQA SBKMUGREW       EEQBGCP        
GDNCGUGY        : VGRKU           JVEB           
TMPMLIIPQOEKNWC : LPWFBNQE        YLNHO           KOPKIRUHR       LTJINUBH        NCTLNNGOBTTPJ  
GVDQDDY         : NSQPXTIPRM      ETBO            HWAEB          
SDON            : PFIFJWBDVBQDNVU TAMPEOPTV       ENWPFEUXOXB    
QSIF            : VVNJOD          QLBJIKX        
UQTD            : VDPTCPMQMPU     LIIJQJTHPNW     HDENHBWTPL     
KTKWIKA         : OBJE            WMBJ            JWKQRDBUOLYSNOB RYEWEDJUOKUR    MEJPDOTKWI      AHUCVACF       
QXYJDCKMUP      : YJIOTN          RAENAWSVHFM    
KCTDLYOIPIMYV   : WGUKIRCV        AIPUUPOJMH      YBOGCBPIRMNVDQD VMBJCNFWUHSWURB
LSQVSK          : GKGSASHWNTUNRH  UQGPCC         
SLXW            : ISJGMKP         WYSEYCYC        IRJWTQCKTP     
KJKBM           : HUGVVWDG        SNOQL           QSWKWNGLAY     
DHCQG           : BLSLFBOHI       RLQFHOLIGTHK    SKXCCKRXEDJY    LOOQO           RLTANQIFWUKLUFN
AYCOAXWLRO      : YVNLYO          DSIBTAHHHUPTL   NOEDXMCRFSEGS   SORPJQPITCKTWO 
MBYGOXDCIOOL    : KWJTJDXAQHHK    EGSUBLEKMOBB    QVVXFT          PBDVVPLS        BYNLXGHYBMWXSB 
LPKN            : VUISRA          FHSNYT          MPCMBONMLXNIHNX GITDU           NHSJQMEIE      
RHISKYSIWGC     : LAHGE           LIIYYFJLHWCHNB  XNETHHUUPBNT   
QRQQXFQDHYRXNU  : PVDBBTB         STHFQHFIAHSYY   SRPGQRUDRTF     KONLVH          PMUMMYE         RGFC           
DGYNAJYUTXNEU   : PXTXLDYNK       TAEE            YRRTRAAN        PIHS            DSXGYYRGLO     
JINBYEYGUE      : YJFYCUPF        UFFVBC         
VXNJSYOBBDBKC   : LNXD            YONYTGUHTCQQAOR LUBFVKDM       
GALMXIVIVYKA    : JHSJNYIYTSIJPJQ
QWEHSCUDXWT     : HMNHYDAUYDX    
AWBMBYSCLHCV    : OOTCWTN         BLOEJLXSVRSR   
KRFUTIMQMVJ     : CEHGQEGWO       THYBCDWNBA     
SORPJQPITCKTWO  : NJHGSMBHTRX     RXPRLJVT        WTFDS           YPFWQPJ         AYCOAXWLRO     
HQDPDWUYQ       : CEHGQEGWO       JFVFBDBIROGK    MFFLHDWMOJUO    RGNUYHVRIOE     UDBYH           MRJANNPL       
NHSJQMEIE       : FYWY            TADNED          XGTN            BTJJFIKJYRTV    AHPGHIPUHUBICMR LPKN           
RWMCRPM         : SAYRDQBVLUM    
OBUVR           : BGTERONYXJ      HHXIOGQTTGBDLVS GYTYA          
LVWJ            : IJCRSNMPGWMHIGN OBKKXLUL        PGYYXHQWTJBC   
NOMUJXN         : VPTANYRLYRBM    BVSURQUJYKQTV   KWJTJDXAQHHK    OROBUOKXTKXD    VRLULNEBMU      UDORTHATOKGKN  
CXCWRAKURCHHQL  : FXYDHTTCBF      FMOOUHURX       ORXGMICPJXGTDAK BXJVPM          FNETFPWLLAMR    VTVEPESAGVDP   
PDEDBB          : LXWSBYTEGOGTJE  QCWBFK          RIQPJSF         VEOGNWVQW       PQUQNGDAGQEKQM  KMEQROPGXIMU   
AQGMN           : NOSXKAKCO       XOPIUP          KYLX            UKCPFTXV        NHWFTSDG       
KDONCSMVSYQMBB  : WTFDS           SDIDAJETYWE     NXBPCHKKQYMMO   HMNHYDAUYDX    
UMXMREPTHHV     : WSSC            ULASOXOOTIAO    OXGOENHPORESJYN QWJHIQLOGUR    
