KMVII           : WBAQVRKQPL      BELR            ASWVPEFPSEUP    IKYITNETICFJ   
YNXJCMAJYW      : MJIENHMTSUAALE  DDKWXAHAYALYV  
LEKPHEOIYHHMPQ  : PCRJGURG        HLPGMCMAE       LDDQXGEGUEJD    BIYKBONGJEWB    YUPBXJRAEYIO    VUUS           
EMFMRGDPQFFSQ   : JIEAH           ILVUYRGBNOPIHTY IOKCRU          XOVHQYVRADWXDJ 
PTSTFIDLYNKIUW  : MYPO            SASXEISYK       FTXWQJWTSEQ     FQNQY          
MVFYCTSIYJ      : NLADLARSKEM     KBUUCUW         THPYKRHHW       VYSASK          ECTRXALFPGUBJ   HMYWVAIFK       FOFIAI         
EQTWWLRRHY      : IJPFYKDJJSXXG   OWMCMHGQR       DASPMSMFULQ     BJPMVGDGAK      MVXDTFJIWY      DCXJDX         
NKEBWPWVPJRWK   : RXRLDFJ         KQFRNEETTKCWTSQ ODTK            WJJNNFAAGJWJ   
TEFUPIAIDWFQ    : WFUBTNGQKPP     WAANGJBLBW      PAQRCPRNJ      
AYPFMCJNBYMWRV  : KPQCPEYJL       UEHUO          
QJLMNSI         : CSVXMIQWGTOUTD  AJRPIODFKDF    
CKNHHUXBUYSANVM : INFA            JMJHGBXQPLEMDPV
WLQWFPOWYC      : XLYKDYFAGVN     YRLGCMKXMQ      MNCOBODU        AOSJDFVXPWJ     KIWV            MJOJUTMUKYOGR   KRLXPKA         CPGIBRXBNSPWJC 
OVTTAE          : IBXCG           CKQUNPVNSCM     TNKVPFNBKE      INFA           
HOEHPCJIEWGQBG  : MAUS            ERNIUSKIWRHOLJU HCMYSBHBSMQEE   GNVFABUNTS     
UDKKRJJV        : JQXORJLO        PCONXRSPOFMP   
ARPVTW          : VNLNWSLNBPAOA   WJJNNFAAGJWJ   
DLJNDLWLQVUJ    : UFSDLIMACG      JIAECI          WFUBTNGQKPP     SKLPAL         
BOUEAFXLQTHQ    : USOSAAGHAXORD   IWIVD           LMNN            YMOHMNBTPXJIFV 
AMIWRMKDANPYBIU : FPAV            IAUGFEUFFGM     HMGIJYLGEU     
RUYJPFJUD       : FPAV            NCPLQTKDB      
LAFEQFSYEKNOO   : ENLDH           SESTNYG        
CGQDQMCKH       : BVHQ            JQXORJLO        TKRPGB          IQWCTEPPLRQG   
TAHFWMDLMIPDPJ  : EMEM            YBXBEYHTSHDLBOO HDPNMFJ         THGPMMIS        LYYIOOBXLF     
TVUKMNMSER      : JNKKLFUIIJYNI   VXYH            SADXIYMJCJ      JKUJ           
STWDVQDDYAR     : OHDAM           CQCEW           VMXCREEVN       HBRQSOQIHHWQY   ORFHBTXC       
LFMEK           : FPAV            YUOWGUEGRJQQ    IGLV           
NRXJPIY         : GXUMNVUFAGYE    KVDJKWDUERSRISU RCPM            MULYB           VTLVNRCJQ       NWGWYYHWTRRRA  
WTJOGDJD        : MDTEVJEMSAAP    KRDITPDDX       DNVCYFQ         VDJIXAYJNQLYEFK
HVLMWNEY        : OUPVBIJMBXNRJ   NXTJGX          JSBWROXRCGNUAX  NRMLISWSJK     
LNGWRT          : RJUNJUIDK       MAHFMRCAOAPGN   UXSUDJHNL       RJPVM          
RFGAELYY        : HRQO            NYAWNEQ        
OHDAM           : STWDVQDDYAR     LHVYUJB         KRPGLSMGBEEW    UTPMPXM        
JKYVIMCJ        : IEUD            YUPBXJRAEYIO    GJXI            WUTCRDFX       
OXUNPQE         : GJXI            DXFWLQ          FOFIAI         
YNKFBME         : GWHACOBU        ICQDHCHGJBEJW   WNDSU           MYIRESKDL      
BNCDANML        : XDQWVWWWUHFR    YHCSDGTOGJO     YDRBAFEXSGYMX  
KVCMFQBDOOV     : YBSFRBGXTM      YTHFBEBTNMUR    YKORTOVYQ       OVAYQSMQKDMXAL 
VGGLS           : NOUNGVXYXOFB    LTSQADTRNBUJTL 
MFSMIHQLHHA     : EERUOQFXOYMWRTA CFKXGINXQUSBNH  NHDUKCJKNSW    
VKQXAWRDCISAPQG : BFHDPNESAFVFCNB MUCQQJLRSDHQLKW QIJBFUUSDTUHJI  YMOHMNBTPXJIFV 
CCJOH           : CIWOELDQK       GDJFAXANJOD     PORQV           GTIHPA         
DQJUETCHOA      : CVHAO           BICDSE          DWLKDFYL       
GYTFS           : TQBRQWEYNM      MJOJUTMUKYOGR   DCXJDX         
JBSKQJSNNUY     : NCRQO           QIYIWEHFP       EXNKOLKBTJY     TNKVPFNBKE      GNVFABUNTS      XUWYKOYNL      
FCIXLF          : CMVK            DOMATGLLKBNAO   AWVE            YENLDK         
FJLWJGDKA       : JCKWQSVICGYQKWG GABQDTLFWHXNKAJ QUUPTGHIJHVPB   ABORFAOOKVYTXU 
DXVGQGXCCNP     : DLPQTBEHKGM     CEFWIQSURBOTR  
NWGPHEDMJLV     : PDCLIQEWBRMBDH  EIJJVOHIS      
IHBNSCXXCV      : GXEP            QRSLVYQVJIO     OCYMSQ         
TFDXHS          : PNLHV           VKVXEFFAYNGSYNV HOGGKQGGSHYRPAK JNKKLFUIIJYNI   PPLXR          
IINPXUTEHFPFBX  : ODTK            SCSLAUNFEK     
ENHGNGLJL       : LRXEOINNLKDF    WUTCMSWWUMU     WOIRNVPENMILY   MVXDTFJIWY      QCNGBFKHLWJNSN  XBNOKWRWIX     
OQFVLVHUJWUE    : BJOUPYGOF       WPSYQSWTYYIL    LDDQXGEGUEJD    FTXWQJWTSEQ    
YNYQUAQK        : WHPWUHVAVEPLRC  VRKRBBT        
ETNRAYCNGQG     : NYNXUMYJNUANBB  OQBADAHA        ATEEVYV        
PSIWPTVKYOM     : OUPVBIJMBXNRJ   CILJBUBAO      
NDKPUUUBOKTRL   : LLWKUOHVY       PQVCPKNHXJXEWM  YGCU           
HRQO            : RFGAELYY        KTWGUVTC        ADUORMWDEJMNLJR REKOUVINSKE    
IJPFYKDJJSXXG   : EQTWWLRRHY      KQXV            BDEHTAGCF       NCTYWTIAV       JLUQULYBVRKCK  
IWYFTCUG        : NLADLARSKEM    
ORVVL           : WDBBCU          GGSOCQIVMUOCCRN JKPLOUP        
KQXV            : IJPFYKDJJSXXG   TTWYVGMSO       OAKGMPTN        SPFW           
GURJHDCFDJ      : BXENTYIQRLAF    EGODTPKGYKFP    LDALOSERG       NRMLISWSJK     
MIIRCNOKLDCIC   : NHAKYBC         PLTRELNTDJ      NHPGGCVD        TRPVIY          IRETGXAXGLIUWL 
XMGXLNE         : CYGGJGFFPCMRTV  YKJAYMAI        ENLDH           XALHAWHD       
HOPMQVQCF       : MTRJCJB         JVDENL         
MQYQEO          : WDWCEO          XCECMMVEWBHB    QCNGBFKHLWJNSN  SQDMHNEUTVB    
RTDAVSALAYWPDF  : KRAUU           YFUOHKWEXJO     OXOINT          JVFJKIICIFOFRE 
TVMNTFRBKFRK    : QBYDMWUJV       XDPQJBSLAEOK    RMOHAQHO        HOBXGQON       
XBAQWFSVYVH     : HGEKRDCPD       RTBQUT          COFYMHR         ROHRNGQENS     
UGSANSULIIFNA   : CWPXGFSBBBIV    YTHFBEBTNMUR    CJEIT           UNQA           
BHBNGCQGSNNNJO  : JQNCXNVSDMTXWUS
SPGBLHPECDO     : HVYSKARLO       DLPQTBEHKGM     LLFATLP         BOJU           
JFOQIWTVDVMLQ   : WDWCEO          VBFQJDS         NMXIDUT         YVKKOA          YNKL            RCPM            MNJMMAJXADL    
YFMOQHGXJRHBYLE : QDMPXQTDEKU     RBEJYWTWRKV     EGHGFLDJR       AWVE           
XPUMIDLDYOYNC   : CWIOHTJIBSIVICK TXNEI           XYHTFVPG        GICMLND         GNSYSDBPGRC     AGHKG           AUMUMNTHNL      JKPLOUP        
XPUMIDLDYOYNC   : MWLTNYAW       
QEADSQ          : KTWGUVTC        XRTJEMKVDPNTR   YUPBXJRAEYIO    RPVYQYGQT       DFPPXACELCAYGB 
BQVTXYSJ        : NYIPEJTEPCD     IDYXVW          RPVYQYGQT       INEXYTDUKUVLWAS QUWLNEKJSK     
IJXGWHJKKLC     : CYHJXYHHUUKRLW  QSGSVYJBIY      WTWTXXAPSOWC    SCSLAUNFEK     
YEEPIEUDXIFOGBP : XISVLYTGUF      NLADLARSKEM    
VYOEJMKIT       : FHGVHMRALK      ALHIM           UFSDLIMACG      PSPFYV          HJJCPVMLOC      QSGSVYJBIY     
SGIUUH          : THGPMMIS        QQPKKJB        
BAKIUQGDVW      : OPVKQFT         XANMTKFDUPCN    IKSVMALNEQO    
YMSUMJBXVMISLB  : WKCND           DBHS           
TYXDBADN        : JIPXOVHMFPIVSG  GQTORTVXKBHPJI 
BEQECNQBBLVPWX  : BEQPUVYI        VOFSNAILBXCSSC  RTDRBRENHMMA    JKAUCCITC       CWETEFSYYGJ    
TMXOAYRTA       : QSAKE           LMNN            IPGYBXHMK       GTTAEYH        
YBSFRBGXTM      : KVCMFQBDOOV     NGVPTJXUBCSURT  EAXRYEPJSIIVCDF TGIJDANMMJMJDQP LHXAN           XGGGNUWQKYR     HBKA           
HGEKRDCPD       : XBAQWFSVYVH     RTWOJHETET      BFYEUL         
LRPCTRVPRM      : NCTYWTIAV      
VFTNICNEPQM     : FMVKPGUO        SKGVEQ          STIQDWM         LKNFDRPPR       MYROQWNDG      
XYRDCHIVUCMY    : UUOXWSARXEOR    GNVFABUNTS     
GVLXKAVSWLDYAI  : AUQAFITCY       OUPVBIJMBXNRJ   DMAYNKEYDY      OSEWULFGPK     
SWOQVHTAQEWOG   : YFUOHKWEXJO     LMBQWAVWTNUN    KWOFUJHQF       FENFJFFB        GQEGAER         BFYEUL         
PCRLNPYQMR      : XDQWVWWWUHFR    UDBWBPC         UXSUDJHNL       DVKTMFOBBNR     XDPQJBSLAEOK   
AUQAFITCY       : GVLXKAVSWLDYAI  IXFDWBGPA       DGJLMGBAXUYSQQ  DJKUQ          
YIJBC           : WDWCEO          AOQAYF          VGFKPVVTXT      RBCTGR          SADXIYMJCJ     
XSUJ            : JHSNVVLEINDVHNQ LRKSCEM         AOSJDFVXPWJ     KIWV           
YBWNTVG         : WADJQFBTO       TKXLAD          SKIGTTHRICF     URYVVNJMJ       NQIIYTID       
PVIKOLSWF       : FHGVHMRALK      TVQLKLAABT      XQFYSIDEH       GUOI            VXHXRUHEO      
YTVJD           : HWBCOKUPKO      LMBQWAVWTNUN    UUOXWSARXEOR   
LRXEOINNLKDF    : ENHGNGLJL       UXSUDJHNL       URLIACGTXR     
JNXHWKWKDVPYW   : GSMIVBQOJETG    CAKJPX          LYHCNFRD        GYCNBPDAHYRDXN 
WHPWUHVAVEPLRC  : YNYQUAQK        MJOJUTMUKYOGR  
XKBLKJKU        : XTRU            OFYQTVMG        AYWWUPO        
WBEOCCBYLQWGA   : RDSWGGBV        VOPNXYJYDUQDKBQ ERQC            CHWAV           TWQJJHWQTXYU    YPGEEXWE        YPDTFXDHQBWFU  
GXYXJ           : LSBRPFPQAXNIBE  UELYY           USIXEJNDHLAQA  
CYQODFYM        : CQCEW           PMSDR           MFMIWIXUUCC     PQYSMVO         QJOVLGQPKCHYO  
WUPXBEADF       : AYIDHSFTFTYTMQO KXABGTNQAEOQQY 
OVAXXUGVTFG     : XISVLYTGUF      EXNKOLKBTJY     KHHUXQKAKE      FATS           
HHGWKLXYEUVTSX  : SMSNAR          FAWCM           XANMTKFDUPCN    NXMEUXKFPFGBH  
UDGYUEYSDUYYQG  : MUAEREDKC       WTWTXXAPSOWC   
GORNNEYL        : NXTJGX          SSCQ           
FHABCACAEIYY    : CSYYF           OFEXRGUSCI      RXTUWFL        
XTRU            : XKBLKJKU        NWAFAXMRVBW     RIHPRUKFWPRHOF  WOLRFKJBKVTU    KOIHHBTBJNON    TEERGPYRFVS    
TMABSQUGEAIP    : QBPQDAIVUEV     FFSAEGNOPEJDFT  LSWVGVSU       
NYIPEJTEPCD     : BQVTXYSJ        UIEQVBO         YENLDK         
QDKLYFFLF       : EAIMDHNLYNTX    WWEOAQG         GDCFWBWKXOB     WKCND           WSTCDOIQHLFUNGA DLPQTBEHKGM     DURRVCKAU      
GXEP            : IHBNSCXXCV      NFGTRKIJJEBWXFK BVHQ           
GXUMNVUFAGYE    : NRXJPIY         ILVUYRGBNOPIHTY VHJA            DRMJESBYA       VBKKJSPTQSLVECF
BJOUPYGOF       : OQFVLVHUJWUE    ANSX            STIQDWM        
CMVK            : FCIXLF          TGDLAPSKOO      YKJAYMAI       
AAPGXMUOJSTJ    : YGCU            OEXDTBG        
TQAWCOTRQA      : NFPNDTCYO       XMQVKMHAN       MYPO           
VNMKKXXMAOV     : GJRJHGCWEBG     UUNRNVVDYIL     PNGSHPKS        VMPLTY          KHHUXQKAKE      RGCCSLXL        MCBBMFR        
BQPKLJ          : BSVJLRSHSPE     MYIRESKDL      
NFPNDTCYO       : TQAWCOTRQA      CWJPLUCV        CIWOELDQK       ICMYBDD         DXFWLQ         
AYQPM           : GEEHLQFWMXMMQCD RJAECCIQSXEB    UXSUDJHNL       MUAEREDKC       PQYSMVO        
CMCPMQNNUED     : RBEJYWTWRKV     PBTIRJVESYYIWAM CRCIJN         
QPGGUVTASXAHT   : GUOYINFQHPMUB   YFDRGUIMW       NVNPFDCUJB     
GMTUQWJ         : INFA            KPQCPEYJL       AKDY            LSXU           
OWMCMHGQR       : EQTWWLRRHY      VRCHLNYBXH      ANSX            ROGBEMKO        EAGCVXVR        VBKKJSPTQSLVECF WTLTMIXFEVUT   
IXFDWBGPA       : AUQAFITCY       FLRNIAAG        QSGSVYJBIY     
YTKHGEDADMTRL   : RPVYQYGQT       VGFKPVVTXT      XDPQJBSLAEOK    SWWWPDYWPIIPKLV SADXIYMJCJ     
TYSDR           : NLSRWLY         BJNOHBXBJAKANBW
EAIMDHNLYNTX    : QDKLYFFLF       EWEWYUITIAQY    KVDJKWDUERSRISU OIYQXCUFSNMVBE  ECWYGU          VUUS            POBOPVK         EISJWM         
EGSLLSOXOJ      : SWENMVXFWK      LRKSCEM         TWQJJHWQTXYU    DWLKDFYL        KWKN           
WDLPGDCNDN      : SMSNAR          IWYDMWNSTIHMVN  UQYBP           EGHGFLDJR       VUEL           
IUNUU           : FWCPXDOARDY     VUISPJP        
OUPVBIJMBXNRJ   : HVLMWNEY        PSIWPTVKYOM     GVLXKAVSWLDYAI  NQIIYTID        GQLLDULNSGJW    GGSOCQIVMUOCCRN
PNLHV           : TFDXHS          XANMTKFDUPCN    AWVE            SQTJTHKES      
MJTAJCWAWR      : GUOI            CRCIJN         
OPVKQFT         : BAKIUQGDVW      JCKWQSVICGYQKWG QQYIKVE         SPFW           
ITVBEXSTLCRCO   : DNQLINPALUIHSFU QWQCAPJLNIUWDQ  EXNKOLKBTJY     EGODTPKGYKFP    VMFF            MJIHFFGWKADLGKC
VONA            : PQPPATRKL       SWRW            VYBVSHQOHEKWPAB
NAGTQVSBPX      : JHSNVVLEINDVHNQ JSUGXPDEXAOBMLK NJBG           
XISVLYTGUF      : YEEPIEUDXIFOGBP OVAXXUGVTFG     ILVUYRGBNOPIHTY AOSJDFVXPWJ     UXTYUJECAIVO   
NHAPF           : EMEM            KLVLYTGOSRCP    TNKVPFNBKE      KUDMODXUX       HLMIIABMBYH    
FHGVHMRALK      : VYOEJMKIT       PVIKOLSWF       JAPYXHLQARA     PJDHSFNQDMNC    QQYIKVE         WKPUYILPTUOGJO 
DKADTVY         : DPRYGYQQST     
USOSAAGHAXORD   : BOUEAFXLQTHQ    EHXCQNBD       
XYGNTGBEKEP     : LYVIAHB         LGGLXUQ         WYKO            HMYWVAIFK       KWKN           
JLIISGDJYD      : UHNRHDSEWOWL    INVASYXLFK      LTYUXJBUXLX    
FMKDBEIYDK      : TGDLAPSKOO      ABMKBST        
SEOTI           : FONTONJSFIRFPP  BILMJLTVTV      IKSVMALNEQO    
XANJ            : WPSYQSWTYYIL    DCXJDX          OEVI           
WTJFW           : QRSLVYQVJIO    
ECFLQRQTVYSBJB  : KRPGLSMGBEEW   
PRNBSNDGWR      : XULNBH          MVBEJ           ATEEVYV        
QDMPXQTDEKU     : YFMOQHGXJRHBYLE XPXKNSITCHYL    KBBJQP          FDRGOLYREGAWISU JVDENL         
GTWAWIDRYUHANXD : JIRDCLHUGDPUVS  FDWKNXBETHKI    WDWIGTXIW       FKGLAUDUJOMGVQD
WWEOAQG         : QDKLYFFLF       AHXJCCIRAOYVS   FCCLKNSJTLJGAM  XOVHQYVRADWXDJ 
KDEQPCMWV       : NHAKYBC         AALBAC          BOJU           
WUTCMSWWUMU     : ENHGNGLJL       FNVM            JVFJKIICIFOFRE  GNSK           
KRXQI           : CYHJXYHHUUKRLW  EXNKOLKBTJY    
KRAUU           : RTDAVSALAYWPDF  DPIPLFBDPFYE    HMGIJYLGEU     
NMGCJENIAIKOD   : OVOLKVTCAP      SCSLAUNFEK     
LYVIAHB         : XYGNTGBEKEP     NGVPTJXUBCSURT  PMSDR           NABRFRGWVCU    
XLYKDYFAGVN     : WLQWFPOWYC      JHSNVVLEINDVHNQ UCOIHYYNYEC     PPLXR          
XWTMIVWSKABYBY  : OELUIIDOCBQQ    QKVDOMAONHQC    NQIIYTID        KAKEURXVCHQ     DURRVCKAU      
DGMEHYFREHAHNVU : LBVL           
VTXICTFVHIYI    : BOOF            KOIHHBTBJNON    KRLXPKA         VRKRBBT         KOLH           
XRRHHVQ         : EHXCQNBD        TKRPGB          WYTSKRSHFUHW    XAEDUNHMTIAWH  
DKMKMTAKQDHLDRN : CSYYF           INFA            YSJNCGHK        IXLJTYTAY      
ALHIM           : VYOEJMKIT       MSWNOQIGENBFRFW NKIQCU         
VNLNWSLNBPAOA   : ARPVTW          NYRDSDJOPVSIWR  SDQBBRVMSNAHEB  FRTTSQCFVUFKJOW
IBXCG           : OVTTAE          TRPVIY          BLHILVESGJ      AIHEBBAKH      
NLADLARSKEM     : MVFYCTSIYJ      IWYFTCUG        YEEPIEUDXIFOGBP THYSP           DATPVRUQYEY     BMQLAHOB        SASXEISYK      
RYUORIETX       : LMYBAEWIDMFMK   TGMMTBRBFR     
KBUUCUW         : MVFYCTSIYJ      OPBJLMIYO      
DKVFQIFIDPOQ    : PBPGFX          RJPVM           PGBRXV         
HPUXJEFDCMPDJ   : VHJA            EKGK            LRCGLVAOOYR    
HEITHVQMMBTW    : MNJIWG          HBRQSOQIHHWQY  
LLWKUOHVY       : NDKPUUUBOKTRL   RAMJNX          EWDKKIR        
BEQPUVYI        : BEQECNQBBLVPWX  UNQA           
DQANOSCDVYADK   : UUNRNVVDYIL     KVGF            AUMUMNTHNL     
CWJTFFSSIYLAVK  : VFWYUDDF        ICMYBDD         VOBDNR          CNYFML         
EQFXSUOOYSKXU   : TXIHVSAPNERSJ   GUJYAFKFCTFPHG  MVBEJ           OWKWKPB         KHCHBWO        
LJUI            : NWAFAXMRVBW     GTIHPA          XBNOKWRWIX     
OPBJLMIYO       : KBUUCUW         ANSX            EXNKOLKBTJY     DPQQAF          SLXRYLDFKEJAUKK
JQNCXNVSDMTXWUS : BHBNGCQGSNNNJO  SWRW            DJKUQ           JGJBL           OWKWKPB        
GDKQY           : MQNSKB          WXMVNFS         HDPNMFJ         NFTUEYTNIDX    
JCKWQSVICGYQKWG : FJLWJGDKA       OPVKQFT         ACYXAMONIPPQV   XCCFITVTGVO     BBQKNSLNWSNKD   ACTFCYF        
RJUNJUIDK       : LNGWRT          KCYACEYNKLU    
IWIJXTNIQFDM    : AYDCKNQ         NXMEUXKFPFGBH  
GUOYINFQHPMUB   : QPGGUVTASXAHT   EMEM            ITBVFME         VOPNXYJYDUQDKBQ AVQL            OGVM            NFTUEYTNIDX    
EERUOQFXOYMWRTA : MFSMIHQLHHA     VURWAVET        MBQHKGNQGHW     EAMCP           CYHJXYHHUUKRLW  SODDSPPRU       DALCBYX        
JIEAH           : EMFMRGDPQFFSQ   RXAEDLQBCN      VXXWHNJBRKUOK  
NNEWF           : LDDQXGEGUEJD    EHLVWUQED       QCYDXOWQXLOG    DNVCYFQ         BBQKNSLNWSNKD  
RGXXNRTCIB      : GGFVBHIBJBQVQDD
YDPVULXCW       : SKGVEQ          LKNFDRPPR       XTGTT           XPNDVC          LBDAJIBXLIGCSTV
JWQVMGAJ        : LQUFOJYNHLXXL   RBRMRNWLVJPO   
SDWSCMKVQUYT    : LDQGSNFFTN      XQFYSIDEH       AIYKIOF         KIWV            YDRBAFEXSGYMX  
CLRAWQEV        : GABQDTLFWHXNKAJ GJYBJLUUIDIHN  
NUSKHCMSRI      : RTLJC           JOPCJW          MUAEREDKC       IKSVMALNEQO    
QBYDMWUJV       : TVMNTFRBKFRK    WNXVSYPXBQN     QSVDYWJDVHUPIOC
EBDVB           : BXMCUCD        
OFYQTVMG        : XKBLKJKU        AHXJCCIRAOYVS   MCLMEIHUTAETGQ  SOCDAMJ        
QUYI            : WJOYFM          SXRQJY         
XAFWFTVCDSTJTY  : PNUUSWD         MNCOBODU        CKLMVPGF       
WDWCEO          : MQYQEO          JFOQIWTVDVMLQ   YIJBC           DGEISJPGFGMFTW  JNMHISIHA      
BDEHTAGCF       : IJPFYKDJJSXXG   KBBJQP          NRRSEHJX        WSBDHYLSGY      LBIIWSNFIENU   
EMEM            : TAHFWMDLMIPDPJ  NHAPF           GUOYINFQHPMUB   KKJUAHJ         RTWOJHETET      MSUFGWSOEFBUEW 
BQMVMXRLGORE    : TNKVPFNBKE     
VURWAVET        : EERUOQFXOYMWRTA ENOAWYFFLLNWMCE
LXESFQWRAAK     : RBRMRNWLVJPO   
VXMNLVEDCXAWPW  : SVKX            DGJLMGBAXUYSQQ  BXMCUCD         XQVPLPETPGCJEW  HCMYSBHBSMQEE  
NESMRQS         : INBKHESKJXJMXT  VIKBV           USXLF           WUEBGOKQBAC    
VLJPNKBC        : LYYIOOBXLF      FUWXQLMRF       SBLWEKPVNJBUSKJ VIOPXNDV       
YRYMNDQRBQQSPPH : WNFTUNLY        TQBRQWEYNM      FKIWNAML        UFLDHPHNLDJT    BOJU           
IVLBQXACIPSU    : XXUMCHMHL      
WDTOCHE         : YPLAOHNQS       REKOUVINSKE     TOHBJD          IAUGFEUFFGM    
XVLQMFIEMDMK    : BXENTYIQRLAF    WRUHABYTR       DBXRSGQYIJTQLYV UTAPMJVYI       PEAUNA         
QBPQDAIVUEV     : TMABSQUGEAIP    EABMTKISR       TXABTSJDTAIIK   NUVRV          
XMFFRPFPB       : BRFCBONGFTP    
FGHJU           : KDGWCLUGGN      LQUFOJYNHLXXL   YSJNCGHK       
YFDRGUIMW       : QPGGUVTASXAHT   QHOVIPAGNAU     SLXRYLDFKEJAUKK
KTWGUVTC        : HRQO            QEADSQ          OXOINT          SWENMVXFWK      TSMFJVHEC      
NRLFUJ          : VIOPXNDV        DCREWQLAMGEML  
CSYYF           : FHABCACAEIYY    DKMKMTAKQDHLDRN XXUMCHMHL       PMSDR           XCCFITVTGVO     APKUEAHNSRRFI  
FLRNIAAG        : IXFDWBGPA       QRSLVYQVJIO     MHRSNHUJN      
LAQTW           : SBUYUKLDKWICS   GXNBGHPOKBTHA  
NYRDSDJOPVSIWR  : VNLNWSLNBPAOA   CHWAV           AUMUMNTHNL      QGJDQB         
WYEO            : XXUMCHMHL       QWQCAPJLNIUWDQ  ICMYBDD         PUJCCSAXQWQ    
MQNSKB          : GDKQY           QCYDXOWQXLOG    QUIYHHFKEIHOQBP LSWTKIIP        TTKJPJC         WEXENI         
DVSRLULP        : UETEIYALYBFU    SBUYUKLDKWICS   DFUU            MVFKDOKGGE      QJOVLGQPKCHYO   DXOJHSMEVQB    
RBEJYWTWRKV     : YFMOQHGXJRHBYLE CMCPMQNNUED     JKWIEU          JKAUCCITC       QJKQSWG         VVRWG           VODVBMA        
QLEECUYOX       : TLRNKHODPUT    
TVQLKLAABT      : PVIKOLSWF       SMSNAR          IRRSCCDEF       DGJLMGBAXUYSQQ  JXGKSUMWL      
GDCFWBWKXOB     : QDKLYFFLF       UOAEAWVL        NJCDPSUU       
UHNRHDSEWOWL    : JLIISGDJYD      TFREJUGJGKJAT  
INBKHESKJXJMXT  : NESMRQS         HUVQGLBEIGU     ENOAWYFFLLNWMCE
MVVJFMEMRWTQLQ  : SMSNAR          MDJUDJILJUADROY VMFF            QDCDARDBWQIKP   ADQNDJPPDKOST  
NCRQO           : JBSKQJSNNUY     YFUOHKWEXJO     WAANGJBLBW     
XJLHHVVHPH      : TLRNKHODPUT     AJRPIODFKDF     UWFFW          
NFGTRKIJJEBWXFK : GXEP            KKJUAHJ         DNQLINPALUIHSFU MDJUDJILJUADROY GWHACOBU       
AEQYC           : JAPYXHLQARA     QOTIY           FKGLAUDUJOMGVQD BUKQC          
NLJJHRBONPWVLOI : QOJOP           JXGKSUMWL       LBDAJIBXLIGCSTV
BRYEPYLCBLGR    : VRCHLNYBXH      FKGLAUDUJOMGVQD SQUUBVUB       
ITBVFME         : GUOYINFQHPMUB   WBAQVRKQPL      OOHYCLLQVXWDBXV NXMEUXKFPFGBH   JNIRPMKCPI     
NUPDRLQJULKO    : EGKHHMQCOJSN    PEAUNA          UMEJGHBHOUCMYCQ
QELCJ           : ULMYXEBMPRFQM   IJXVT           XBPPNPALEYIQ   
ORGC            : QTFCUH          BTMRKHHSDFSDTA  TXNEI           XMRPYRR        
CFYHRDHFBWLS    : SMSNAR          PSMXKEUULRK     NUVRV          
CEFPOUEHBRKMG   : INFA            PORQV           GYCNBPDAHYRDXN 
FMDIOIHYANGF    : BRENO           GQKVUEBX        CILJBUBAO      
FQHPVMXLDUSL    : OOUGLTDCID      HRKIVFGRFCO     KIKLKQNFKOGAELL IVAUQMVHUPWWK   APIGESEBHM     
KVLRWQGAYV      : KXTEQUXKS       UIEQVBO         XXARIKPPQJVU    OQBNNDISVNWE    BGSGQCS        
IWIVD           : BOUEAFXLQTHQ   
KKJUAHJ         : EMEM            NFGTRKIJJEBWXFK SPNYDYJFM      
SMSNAR          : HHGWKLXYEUVTSX  WDLPGDCNDN      TVQLKLAABT      MVVJFMEMRWTQLQ  CFYHRDHFBWLS    VXHXRUHEO      
XDQWVWWWUHFR    : BNCDANML        PCRLNPYQMR      YITYYO          CXARRMCKUDLV    ESJQXJMWIVUCQE 
CWIOHTJIBSIVICK : XPUMIDLDYOYNC   LKAGWCMGKXHRYHS DNVCYFQ        
VJJBCGW         : NGFRJAFXU       PSMXKEUULRK    
GTYNYQID        : EIJJVOHIS       GKSUVVLGIJGLFBV IKSVMALNEQO     IAUGFEUFFGM    
QSAKE           : TMXOAYRTA       VKSTCYJAOYGSB   RKRBSHGONHQDE   ACTFCYF         QKGJI          
NXTJGX          : HVLMWNEY        GORNNEYL        GEVXRNVYNQPUAU  JSTOHIRRNLBO    LMXUUAFBRLUVLWQ JIXUU          
QTFCUH          : ORGC            KSMBONCXTILRI   MCBBMFR        
TLRNKHODPUT     : QLEECUYOX       XJLHHVVHPH      ASOEIC          XQFYSIDEH       FYNHTUGTQTBI    BBAKFDOIO      
PUSTFGTB        : ABORFAOOKVYTXU 
AYMTU           : VIPRGITGR       VHJA            URTTRMRHX       AGHKG           GXNBGHPOKBTHA   PPPGLS          MYIRESKDL      
VRCHLNYBXH      : OWMCMHGQR       BRYEPYLCBLGR    CJWW            XRTJEMKVDPNTR   YSNJMQIVXT      DPIPLFBDPFYE   
CWPXGFSBBBIV    : UGSANSULIIFNA   IXJPTCEPWAIDYN  SWLVFRGXEVHLCT  IKYITNETICFJ    SBLWEKPVNJBUSKJ
BXENTYIQRLAF    : GURJHDCFDJ      XVLQMFIEMDMK    ILVUYRGBNOPIHTY YTDJWXKGNYTIKD  SDCVO           IRBEFUHBGGMB   
AHXJCCIRAOYVS   : WWEOAQG         OFYQTVMG        UFSDLIMACG      TQGLFGXYCK      XPXKNSITCHYL   
YBXBEYHTSHDLBOO : TAHFWMDLMIPDPJ  YWYVNLMTV       RLHNBUOOG      
PQPPATRKL       : VONA            AHTUGKJWUQBITJ  RGCMMCKOE       UYHGJXLOVOB     AYWWUPO        
CKQUNPVNSCM     : OVTTAE          JSBWROXRCGNUAX  NXMEUXKFPFGBH   GXWDKYQADHPPPPF
VIKBV           : NESMRQS         GLILL          
RKTKB           : IRRSCCDEF       NABRFRGWVCU     JFDCJQNS       
ADGSOSPQFILS    : NOMJWW          XCVQFLTPYIA     RURKKFGMLR      EKGK            SIVSL           MYIRESKDL      
JHSNVVLEINDVHNQ : XSUJ            NAGTQVSBPX      XLYKDYFAGVN     HUFYQJFJIGRL    OSEWULFGPK      SESTNYG         XLQXT          
RFSWLN          : ANSX            EGMAYSELMUH     RJPVM          
GDEMLR          : CEFWIQSURBOTR   TKRPGB          MDNDL          
LDQGSNFFTN      : SDWSCMKVQUYT    DEFURM          OCYMSQ          MUAEREDKC      
WKCND           : YMSUMJBXVMISLB  QDKLYFFLF       FIRETFSBKYP     NGFRJAFXU       PPPGLS         
FIRETFSBKYP     : WKCND           YUOWGUEGRJQQ   
TWLWORQEY       : KXTEQUXKS       BVHQ            FFNS            GWKVWE         
ANSX            : BJOUPYGOF       OWMCMHGQR       OPBJLMIYO       RFSWLN          HCUPCFAHNLO     TEERGPYRFVS    
WNFTUNLY        : YRYMNDQRBQQSPPH PQYSMVO        
SRMDRCDLCOKSJD  : LNGBOEVTNY      YUPBXJRAEYIO    WMHNFE          QXLX           
IDYXVW          : BQVTXYSJ        GEAS            VVRWG           LPYA           
VKFPFUEHFW      : UKQA            FDRGOLYREGAWISU EVEQVQFFXUBXPQI YENLDK          ENOAWYFFLLNWMCE
RDSWGGBV        : WBEOCCBYLQWGA   PMSDR           CEFWIQSURBOTR   IDTYORR         XAHXXHKDT       DHYJQFS         VTLVNRCJQ      
THYSP           : NLADLARSKEM     YUPBXJRAEYIO    DHYJQFS         SDMDKIUM        UUKUUGVH        GGFVBHIBJBQVQDD
TQBRQWEYNM      : GYTFS           YRYMNDQRBQQSPPH QJKQSWG         SXRQJY          PXAWDBWJFA      VSBELSPDGDVS   
RTBQUT          : XBAQWFSVYVH     MVXDTFJIWY      UIEWYKXEJN      ATEEVYV        
OSBUTYQPG       : AYUOJDQELGPGEG 
KXTEQUXKS       : KVLRWQGAYV      TWLWORQEY       QIYIWEHFP       JVMETFFMAXGIA  
JIRDCLHUGDPUVS  : GTWAWIDRYUHANXD ORFHBTXC        APIGESEBHM     
RTLJC           : NUSKHCMSRI      KGCBWHVSM       YTDJWXKGNYTIKD  MVYFWCWAFALMFA 
TCXATVYEQ       : SBRQWGYX        GQLLDULNSGJW   
PBVUDJCXPFPNBK  : ROGBEMKO        UECQGYDW       
UETEIYALYBFU    : DVSRLULP        DNVCYFQ         FATS           
LNGBOEVTNY      : SRMDRCDLCOKSJD  FPNPEDTPCJEG    YSNJMQIVXT     
DEMSIXBDEXKNYKY : URLIACGTXR      NRMLISWSJK     
NGVPTJXUBCSURT  : YBSFRBGXTM      LYVIAHB         THPYKRHHW       QQPKKJB        
VBFQJDS         : JFOQIWTVDVMLQ   XCVQFLTPYIA     NOUNGVXYXOFB    FJEBW          
JSBWROXRCGNUAX  : HVLMWNEY        CKQUNPVNSCM     IKSWRCFYSOQYUV  IDLPQFRJK      
WBAQVRKQPL      : KMVII           ITBVFME        
HWBCOKUPKO      : YTVJD           TGDLAPSKOO      NWAFAXMRVBW     XRTJEMKVDPNTR   BYEU            PYYDJCVN        PUJCCSAXQWQ     QUWLNEKJSK     
HWBCOKUPKO      : GHMKCVDCIRYS   
KGJRUGRUDPVDITX : FONTONJSFIRFPP  MNMRPRKRPKAPOSN AXYAVSYODOTS   
MNJIWG          : HEITHVQMMBTW    YGCU            AKDY            KWOFUJHQF       LMYBAEWIDMFMK   WYTSKRSHFUHW   
YWYVNLMTV       : YBXBEYHTSHDLBOO CIWOELDQK       SBRQWGYX        COYNWRFUYUSM    AKDY           
DNQLINPALUIHSFU : ITVBEXSTLCRCO   NFGTRKIJJEBWXFK DMAYNKEYDY      SLTI           
OFEXRGUSCI      : FHABCACAEIYY    TJGDFRNHYAM     UTRQIMNNWQL     XAHXXHKDT       GNSK            FJEBW          
PDCLIQEWBRMBDH  : NWGPHEDMJLV     MBQHKGNQGHW     AYUOJDQELGPGEG  LXVAQYAD        BBAKFDOIO      
MBQHKGNQGHW     : EERUOQFXOYMWRTA PDCLIQEWBRMBDH  MAHFMRCAOAPGN   BNXJPVYWQMYYA  
CCKGTPKFADJWE   : XBLIB           USIXEJNDHLAQA  
LHIVSUWKDJSSAY  : KSFTI           WUEBGOKQBAC     ENOAWYFFLLNWMCE
XCECMMVEWBHB    : MQYQEO          TOHBJD          APIGESEBHM      PGBRXV         
GHPSPAOIUNU     : AWVE            JKUJ            TGMMTBRBFR     
WPSYQSWTYYIL    : OQFVLVHUJWUE    XANJ            VHJA            ABJYBFWOSH      MCGIIJYFBX      EAGCVXVR       
PJXW            : LALCYR          EGHGFLDJR       VTLVNRCJQ       JIXUU          
MDTEVJEMSAAP    : WTJOGDJD        XOCMUN          FAIVF           OWKWKPB         BFFWCSLXUSVYS  
YITYYO          : XDQWVWWWUHFR    EWDKKIR        
UOAEAWVL        : GDCFWBWKXOB     FJQF            OWLJOCRHCKFHU  
SVKX            : VXMNLVEDCXAWPW  BXQGRWGV        GEVXRNVYNQPUAU  TWQJJHWQTXYU    GQTORTVXKBHPJI  FATS           
RWCVJWX         : PVGACCG        
NYNXUMYJNUANBB  : ETNRAYCNGQG     OKQQGJJJL       NTKKTYKB        POSP            IKSVMALNEQO     DURRVCKAU       KNMHBE         
WOIRNVPENMILY   : ENHGNGLJL       TXCX            CUXHWWEMQGMGO   COYNWRFUYUSM    BMDUWRXHQGJE   
KLVLYTGOSRCP    : NHAPF           EAXRYEPJSIIVCDF PCONXRSPOFMP    IHCC            YUDAWRK        
PQVCPKNHXJXEWM  : NDKPUUUBOKTRL   AKDY            HHKMOJPKUPHO   
ILVUYRGBNOPIHTY : EMFMRGDPQFFSQ   GXUMNVUFAGYE    XISVLYTGUF      BXENTYIQRLAF    LGGLXUQ         WKPUYILPTUOGJO 
LRANIMDRNMRTLF  : OXOINT          GHVF            NJBG            SPFW           
WSFRUY          : IPEH            UXSUDJHNL       QHISAQVGBRTTJEF XINWKQBSYJX     VYBVSHQOHEKWPAB
VOPNXYJYDUQDKBQ : WBEOCCBYLQWGA   GUOYINFQHPMUB   NPBYRNWEKISCYQ 
TGDLAPSKOO      : CMVK            FMKDBEIYDK      HWBCOKUPKO      XDPQJBSLAEOK    QTPOFBV         JBRFBLDYNTSC   
GJRJHGCWEBG     : VNMKKXXMAOV     NTKKTYKB        PVGACCG        
FDWKNXBETHKI    : GTWAWIDRYUHANXD OHVYK           UTAPMJVYI       UOFIFKU        
ADUORMWDEJMNLJR : HRQO            SHSMYRSIRX      GNSK            QUUPTGHIJHVPB  
RXTUWFL         : FHABCACAEIYY    EMMIKDFDBSRKXH  UBKHXAFAULYOOI  LTGNFYDGOJLMX  
IRRSCCDEF       : TVQLKLAABT      RKTKB          
UAMSFTESHPEBEWY : NHAKYBC        
TXIHVSAPNERSJ   : EQFXSUOOYSKXU   TQGLFGXYCK      XANMTKFDUPCN   
SEBG            : NJCDPSUU        MGXSTEVNBTX     WFFAT           OKDQHWSDHKCBPOC
HADCJUIKAHKDCK  : XGGGNUWQKYR     EPLXIVMYWKH     LTFSGN          JCTLGJT        
LGGLXUQ         : XYGNTGBEKEP     ILVUYRGBNOPIHTY FAIVF           CDBWQBUEIY     
PCRJGURG        : LEKPHEOIYHHMPQ  XOCMUN          LSWVGVSU        JJAMXQIUP      
TJGDFRNHYAM     : OFEXRGUSCI      BHYSPVWCWOIC    DPQQAF          PWESTUPPLUMM   
LAPTIDS         : FJQF            GEEHLQFWMXMMQCD DOMATGLLKBNAO   RVJNTTP        
VKVXEFFAYNGSYNV : TFDXHS          QSVDYWJDVHUPIOC
HLPGMCMAE       : LEKPHEOIYHHMPQ  VFWYUDDF        GJYBJLUUIDIHN   OEGVRTYBNSQGEA  IMQTMFILVJRMHQA MVYFWCWAFALMFA 
TNHOSGAOEGVL    : SBRQWGYX        JIPXOVHMFPIVSG  HOIBYXSFMX      WRUHABYTR       MDNDL           OGVM           
UBPNBFLH        : BOQF            DYGPJBS         KHPVKLGTTFPRQ   FOFIAI         
XXUMCHMHL       : IVLBQXACIPSU    CSYYF           WYEO            MPKPQASEYATK    PDIL            FNFYMTLMWOQTWV  WRAVKRWRFKY    
WVVPCXHIGFU     : YNKL            JNMHISIHA       GQLLDULNSGJW    OWDUMUTS       
BVHQ            : CGQDQMCKH       GXEP            TWLWORQEY       VXYH            AUKYAREOAIJXLX 
ODHBDHXPJIC     : RXRLDFJ         CUXHWWEMQGMGO   APIGESEBHM     
VIPRGITGR       : AYMTU           MDNDL          
NWAFAXMRVBW     : XTRU            LJUI            HWBCOKUPKO      DEFURM          MNGCFALTWNKRLWB BBAKFDOIO      
EAMCP           : EERUOQFXOYMWRTA JTFD            NYAWNEQ        
MTRJCJB         : HOPMQVQCF       THPYKRHHW       FWVKTFCPMYBMI   SDCVO           SQPYHYWKTPQJ    KOLH           
RXRLDFJ         : NKEBWPWVPJRWK   ODHBDHXPJIC    
KLBYDYA         : QULJNVVPEQKYT  
GEAS            : IDYXVW         
RRVLLFQU        : LHVYUJB         SKGVEQ          URLIACGTXR     
EPHVBKEMPQYQQC  : EJKBVFIAWUCA    VJPIBVOHYHPCU   GTIHPA          FOFIAI         
SFYAHULCM       : EYYKAFMHAYPIT   XXARIKPPQJVU    YYWXBGDECUTYV   ODTK           
NAPGUYKKIHOSN   : AFMU            EABMTKISR      
KGCBWHVSM       : RTLJC           FFSAEGNOPEJDFT  HVQJNGYD        TNSRDLV         WNDSU           WEXENI         
STQEXFN         : XQFYSIDEH       SLXRYLDFKEJAUKK BHTAIUAVEAUM   
FFSAEGNOPEJDFT  : TMABSQUGEAIP    KGCBWHVSM       AKDY            XCCFITVTGVO     YUOWGUEGRJQQ   
IXJPTCEPWAIDYN  : CWPXGFSBBBIV    NMUHMTPJVCSXM   AYIDHSFTFTYTMQO QLFVMEXJE       NPBYRNWEKISCYQ 
NUWIXDOLSE      : AQLSWWADWYH     HJWHV           RWJJOY          VYCMIDBMBEFPIN  SQUUBVUB       
CJWW            : VRCHLNYBXH      HOIBYXSFMX      WAANGJBLBW      LUYEPGKLRHVHIT  SCSLAUNFEK     
HUFYQJFJIGRL    : JHSNVVLEINDVHNQ GEVXRNVYNQPUAU  TXNEI           LTGNFYDGOJLMX   PNSJVESHLFIEJMQ
IEUD            : JKYVIMCJ        MULYB           IRBEFUHBGGMB    BUKQC          
DBHS            : YMSUMJBXVMISLB  SSTF            YDLDVFR         CIFGO          
CYGGJGFFPCMRTV  : XMGXLNE         EDCBLEFXQTAGWRL VYCMIDBMBEFPIN 
DEFURM          : LDQGSNFFTN      NWAFAXMRVBW     PMSDR           HDPNMFJ         SODDSPPRU       XMCAXEGQTJV    
VHJA            : GXUMNVUFAGYE    HPUXJEFDCMPDJ   AYMTU           WPSYQSWTYYIL    IPEH            DRMJESBYA       ACTFCYF         BMFVO          
VHJA            : QKGJI          
MJIENHMTSUAALE  : YNXJCMAJYW      QHISAQVGBRTTJEF TNSRDLV        
FXKC            : VMXCREEVN       IWYDMWNSTIHMVN  CFKXGINXQUSBNH 
QIYIWEHFP       : JBSKQJSNNUY     KXTEQUXKS       BFHDPNESAFVFCNB HLGPGSMPLIPIEM  LLFATLP         IRETGXAXGLIUWL 
UFSDLIMACG      : DLJNDLWLQVUJ    VYOEJMKIT       AHXJCCIRAOYVS   WQHBMUGF       
EIJJVOHIS       : NWGPHEDMJLV     GTYNYQID        DYAX            BFWD            BDGKMRJTQGNLGN  BHYSPVWCWOIC   
ABMKBST         : FMKDBEIYDK      PJMKM           TXABTSJDTAIIK   RYNPNLQSRU     
LDDQXGEGUEJD    : LEKPHEOIYHHMPQ  OQFVLVHUJWUE    NNEWF           UIEQVBO         HMJDKKPBFMT    
PMLYKCJSVWU     : QSVDYWJDVHUPIOC WTLTMIXFEVUT    IKPUSHUJAMBG   
JIAECI          : DLJNDLWLQVUJ    OHVYK           QSVDYWJDVHUPIOC
GLIGTMNPRYUVO   : WYKO           
IORMANIWK       : VOFSNAILBXCSSC 
IUMMX           : JAPYXHLQARA     IDLPQFRJK       VBKKJSPTQSLVECF
DGJLMGBAXUYSQQ  : AUQAFITCY       VXMNLVEDCXAWPW  TVQLKLAABT      DFPPXACELCAYGB  AUKYAREOAIJXLX 
YFUOHKWEXJO     : RTDAVSALAYWPDF  SWOQVHTAQEWOG   NCRQO           EHXCQNBD        LJVXV          
WBQUGYGUMM      : IPWVIESX        CXARRMCKUDLV    SQUUBVUB       
OKQQGJJJL       : NYNXUMYJNUANBB  FTXWQJWTSEQ     XKFWVIDIMOIKYSW
EAXRYEPJSIIVCDF : YBSFRBGXTM      KLVLYTGOSRCP    DJUJHTOBW       MPUAJOEWCBALECD CILJBUBAO      
JAPYXHLQARA     : FHGVHMRALK      AEQYC           IUMMX           WHBT           
BLAINXAN        : UYHGJXLOVOB    
PYWAHUCMAEXC    : LMBSRRRNFUB     EGODTPKGYKFP    YGCU            CILJBUBAO      
WADJQFBTO       : YBWNTVG         QQTA            CTXWXK         
FONTONJSFIRFPP  : SEOTI           KGJRUGRUDPVDITX DKPAMKPQYSW     BXQGRWGV        ROGBEMKO        RTIXEWGRSH     
ERQC            : WBEOCCBYLQWGA   TNMAMHHWSXWS    UMSKKEJWVKEALH 
MAUS            : HOEHPCJIEWGQBG  HOGGKQGGSHYRPAK JTFD            GJYBJLUUIDIHN   QTPOFBV         RVJNTTP        
OXOINT          : RTDAVSALAYWPDF  KTWGUVTC        LRANIMDRNMRTLF  MVLMMYHMXHRW    JNKKLFUIIJYNI  
EHLVWUQED       : NNEWF           UUNRNVVDYIL     MYPO            YSNJMQIVXT     
MUBWYSNCNCELUR  : DJUJHTOBW       LSMFWAEPNGGVTWO HCBQWCBFOWGJH   CILJBUBAO      
TGIJDANMMJMJDQP : YBSFRBGXTM      LQUFOJYNHLXXL   KWOFUJHQF       TLWS           
DKPAMKPQYSW     : FONTONJSFIRFPP  CEFWIQSURBOTR   QTPOFBV         UMSKKEJWVKEALH 
NOMJWW          : ADGSOSPQFILS    NXLGTHCHONQWYV  UTCRRFEWTGJ     WNDSU          
CWJPLUCV        : NFPNDTCYO       FPNPEDTPCJEG   
ULMYXEBMPRFQM   : QELCJ           QKWMS           RDEI            AWVE            YHSSSMSGDIR     ELMYDFCMGER    
DASPMSMFULQ     : EQTWWLRRHY      KOIHHBTBJNON   
XMQVKMHAN       : TQAWCOTRQA      NOUNGVXYXOFB    REKOUVINSKE     UMEJGHBHOUCMYCQ
EQWTKCKWHN      : AWVE           
AFMU            : NAPGUYKKIHOSN   RAMJNX          IBUNRDYVUCVOJH  BHYSPVWCWOIC    WKKJGYXDNQYK    IOADBWQQCRFHJI 
TQGLFGXYCK      : AHXJCCIRAOYVS   TXIHVSAPNERSJ   DJKUQ           SQPYHYWKTPQJ   
LMBSRRRNFUB     : PYWAHUCMAEXC    KRQUEFITVKLCL   JTFD            RXAEDLQBCN      YKJAYMAI        YPDTFXDHQBWFU   MYIRESKDL      
CQCEW           : STWDVQDDYAR     CYQODFYM        IFCKDSRPPKQAME  XPXKNSITCHYL    GKBGB           YPDTFXDHQBWFU   MSUFGWSOEFBUEW 
AQLSWWADWYH     : NUWIXDOLSE      PDIL            XBPPNPALEYIQ    SPNYDYJFM      
MSWNOQIGENBFRFW : ALHIM           FJQF            DJUJHTOBW       CMXTKHXO       
MVLMMYHMXHRW    : OXOINT          MVBEJ           RSDV           
AHTUGKJWUQBITJ  : PQPPATRKL       INFA            IDTYORR         VDJIXAYJNQLYEFK
CIWOELDQK       : CCJOH           NFPNDTCYO       YWYVNLMTV       HKXBTAGKQJLV    KTPT           
FJRAGBAPXUV     : VPIXPSQMJNCWD   DXOJHSMEVQB    
HSFAWNTGPX      : NMUHMTPJVCSXM   DALCBYX         UMSKKEJWVKEALH  DXFWLQ          BBAKFDOIO      
PMSDR           : CYQODFYM        LYVIAHB         CSYYF           RDSWGGBV        DEFURM         
NCTYWTIAV       : IJPFYKDJJSXXG   LRPCTRVPRM      LKAGWCMGKXHRYHS UIEQVBO         DJSOWJVHGCWV   
XQWIARNAQDWWVU  : EGMAYSELMUH     JOPCJW          QQTA           
NKIQCU          : ALHIM           GABQDTLFWHXNKAJ PSPFYV          DPIPLFBDPFYE    HJJCPVMLOC     
HOGGKQGGSHYRPAK : TFDXHS          MAUS            EGKHHMQCOJSN    YNKL            AVLT            DYGPJBS        
ABJYBFWOSH      : WPSYQSWTYYIL    FUWXQLMRF      
JLUQULYBVRKCK   : IJPFYKDJJSXXG   HVYSKARLO       NJCDPSUU        PNGSHPKS        UECJROKUINUORV 
BFHDPNESAFVFCNB : VKQXAWRDCISAPQG QIYIWEHFP       GABQDTLFWHXNKAJ
NMXIDUT         : JFOQIWTVDVMLQ   YRXJTLBWQKBIBH  XYHTFVPG        HBKA            EXDA            NEDGUNXBUAR    
YRXJTLBWQKBIBH  : NMXIDUT         VFWYUDDF        YSJNCGHK       
BMAIPNJDBWD     : WNXVSYPXBQN     TFREJUGJGKJAT  
CYHJXYHHUUKRLW  : IJXGWHJKKLC     KRXQI           EERUOQFXOYMWRTA RTWOJHETET      WHBT           
TXCX            : WOIRNVPENMILY   BSVJLRSHSPE     QKWMS           SKLPAL         
RAMJNX          : LLWKUOHVY       AFMU            WMHNFE         
QWQCAPJLNIUWDQ  : ITVBEXSTLCRCO   WYEO            GXWSPBFLMEEJXQ 
WEGSY           : WXMVNFS         GJYBJLUUIDIHN   QUWLNEKJSK      VNGOXTSLGFHVO   GTTAEYH        
WYKO            : XYGNTGBEKEP     GLIGTMNPRYUVO   BICDSE          LYHCNFRD        VOBDNR          NFHXAXYYIPOGF  
WXMVNFS         : GDKQY           WEGSY           EEDNMQCSVGPI   
HUVQGLBEIGU     : INBKHESKJXJMXT  WDBBCU          LBVL            SASXEISYK      
DYAX            : EIJJVOHIS       JQBKV           GTIHPA         
HVYSKARLO       : SPGBLHPECDO     JLUQULYBVRKCK   DVKTMFOBBNR     JQBKV           YPGEEXWE        NJBG           
YTHFBEBTNMUR    : KVCMFQBDOOV     UGSANSULIIFNA  
BOQF            : UBPNBFLH        TJGKOSAL        LSXU            PQYSMVO        
SDQBBRVMSNAHEB  : VNLNWSLNBPAOA   AGWRJCVNFQ      XOVHQYVRADWXDJ  SXRQJY          GQEGAER         SCSLAUNFEK     
NGFRJAFXU       : VJJBCGW         WKCND           WNDSU          
UWLNEEGJUJL     : UTYEA           HLMIIABMBYH     VJHXQ          
HAJVATCD        : ACNKFJW         DPIPLFBDPFYE    TRPVIY          IRBEFUHBGGMB    EWDKKIR        
PJDHSFNQDMNC    : FHGVHMRALK      POBOPVK         LBIIWSNFIENU    SQTJTHKES       NBJDT          
DGFLRCVDQDD     : BEFNOAKC        ASWVPEFPSEUP    NFHXAXYYIPOGF  
BFWD            : EIJJVOHIS       UUOXWSARXEOR    DNVCYFQ         UWFFW           LBIIWSNFIENU    TEERGPYRFVS    
WSTCDOIQHLFUNGA : QDKLYFFLF       QULJNVVPEQKYT   IKYITNETICFJ   
LMNN            : BOUEAFXLQTHQ    TMXOAYRTA       UTRQIMNNWQL    
THPYKRHHW       : MVFYCTSIYJ      NGVPTJXUBCSURT  MTRJCJB         JQBKV           UIEWYKXEJN      MKBFUERUEGVKDKW KJFMGY         
GSMIVBQOJETG    : JNXHWKWKDVPYW   EWEWYUITIAQY    UHPLOW          KXABGTNQAEOQQY 
BJPMVGDGAK      : EQTWWLRRHY      DGEISJPGFGMFTW  APIGESEBHM      WGOHNECT       
YUPIEPBKINSG    : PIKATUACBLYAE   EXDA           
MUCQQJLRSDHQLKW : VKQXAWRDCISAPQG EVLCTDILPHHWD   GICMLND         KOMUCIYAYKHRYOP
UUNRNVVDYIL     : VNMKKXXMAOV     DQANOSCDVYADK   EHLVWUQED       QOTIY           LALCYR         
BRENO           : FMDIOIHYANGF    DOMATGLLKBNAO  
HFRU            : AOQAYF          IUGNVJF         PCLLSKBTVK     
MAHFMRCAOAPGN   : LNGWRT          MBQHKGNQGHW     VKWHDJIP        FQNQY          
EQNMEBPXHGM     : PYYDJCVN        HMGIJYLGEU     
NTKKTYKB        : NYNXUMYJNUANBB  GJRJHGCWEBG     LKWOOVMOKDDSTSK MKBFUERUEGVKDKW XQVPLPETPGCJEW  LBVL            SJFTPMKYAYY    
YUJALJ          : EKGK            IKYITNETICFJ    VYTBPO          GXWSPBFLMEEJXQ 
TYGXP           : BRFCBONGFTP     JNMHISIHA       QXLX            LBDAJIBXLIGCSTV
MVXDTFJIWY      : EQTWWLRRHY      ENHGNGLJL       RTBQUT          IWLGXIQJLDIWHBL FTXWQJWTSEQ    
HJWHV           : NUWIXDOLSE     
OVVXX           : PBTIRJVESYYIWAM GWHACOBU        STAQQAPVQO     
IPEH            : WSFRUY          VHJA            NMNNLV          YPGEEXWE       
DATPVRUQYEY     : NLADLARSKEM    
FEGOCPNFELBC    : TTVPEA          CFKXGINXQUSBNH  JFDCJQNS        GTTAEYH         ACTFCYF         EBANXSSHF      
LMBQWAVWTNUN    : SWOQVHTAQEWOG   YTVJD           WAHPLQ          NVNPFDCUJB      HOFSTKPJNDTQP   PNSJVESHLFIEJMQ
NMNNLV          : IPEH            QHOVIPAGNAU    
TKXLAD          : YBWNTVG         LHXAN           PNSJVESHLFIEJMQ
LHVYUJB         : OHDAM           RRVLLFQU        RLHNBUOOG       TJGKOSAL        XBPPNPALEYIQ    LCYTRPCXKFDBX  
GDJFAXANJOD     : CCJOH           MNMRPRKRPKAPOSN QENIIXWTTWS     VTLVNRCJQ       YPDTFXDHQBWFU  
EQUAKIYXICPWJ   : CAKJPX          EEDNMQCSVGPI    MDNDL          
VFWYUDDF        : CWJTFFSSIYLAVK  HLPGMCMAE       YRXJTLBWQKBIBH  FCCLKNSJTLJGAM  ICQDHCHGJBEJW  
FFNS            : TWLWORQEY       UECQGYDW        LXOGUWOLTR      PQYSMVO        
EXNKOLKBTJY     : JBSKQJSNNUY     OVAXXUGVTFG     ITVBEXSTLCRCO   KRXQI           OPBJLMIYO       GEEHLQFWMXMMQCD
OQBADAHA        : ETNRAYCNGQG     HOIBYXSFMX      MNMRPRKRPKAPOSN JSUGXPDEXAOBMLK YPDTFXDHQBWFU  
DGEISJPGFGMFTW  : WDWCEO          BJPMVGDGAK      XOCMUN          VGFKPVVTXT      ADQNDJPPDKOST  
HKXBTAGKQJLV    : CIWOELDQK       GICMLND        
SWLVFRGXEVHLCT  : CWPXGFSBBBIV    JDAMRTFSI       IPDTEXJF       
YRLGCMKXMQ      : WLQWFPOWYC      FNVM            JXIRYWYS       
FAWCM           : HHGWKLXYEUVTSX  ADQNDJPPDKOST  
BXQGRWGV        : SVKX            FONTONJSFIRFPP  LSMFWAEPNGGVTWO BMFFJBGGR       APIGESEBHM      ABORFAOOKVYTXU 
NHAKYBC         : MIIRCNOKLDCIC   KDEQPCMWV       UAMSFTESHPEBEWY MJHUKTCWQTLBV   CJEIT           VBKKJSPTQSLVECF
IGBSGPLTVN      : KEQUYYEAMIXPC   MNJMMAJXADL     JIXUU          
AALBAC          : KDEQPCMWV       PWESTUPPLUMM   
SBRQWGYX        : TCXATVYEQ       YWYVNLMTV       TNHOSGAOEGVL    CWETEFSYYGJ     GQEGAER         TGMMTBRBFR     
AYUOJDQELGPGEG  : OSBUTYQPG       PDCLIQEWBRMBDH  XULNBH          ICMYBDD         MWLTNYAW        GGFVBHIBJBQVQDD
EGKHHMQCOJSN    : NUPDRLQJULKO    HOGGKQGGSHYRPAK KDGWCLUGGN      BSVJLRSHSPE     UCOIHYYNYEC     NMUHMTPJVCSXM   IUGNVJF        
TNKVPFNBKE      : OVTTAE          JBSKQJSNNUY     NHAPF           BQMVMXRLGORE    PPPGLS         
VMXCREEVN       : STWDVQDDYAR     FXKC            KXOBYQRTPRVEWDP OJHSQYESKIRE    SSTF           
EWEWYUITIAQY    : EAIMDHNLYNTX    GSMIVBQOJETG   
OORCPEIXBVWFND  : ARNXCBAPYRY     INEXYTDUKUVLWAS
LSBRPFPQAXNIBE  : GXYXJ           DJKUQ           JKUJ           
NUXIXQMGOPC     : JTFD            VYSASK          DJSOWJVHGCWV    ALMB            JPMRCXQWAUU    
XRTJEMKVDPNTR   : QEADSQ          VRCHLNYBXH      HWBCOKUPKO      RTWOJHETET      CDBWQBUEIY     
HDPNMFJ         : TAHFWMDLMIPDPJ  GDKQY           DEFURM          ARNXCBAPYRY     TJGKOSAL       
NJCDPSUU        : GDCFWBWKXOB     SEBG            JLUQULYBVRKCK  
SODDSPPRU       : EERUOQFXOYMWRTA DEFURM          QSCOQDUVJYSEXO  LKNFDRPPR       SQPYHYWKTPQJ   
FPAV            : AMIWRMKDANPYBIU RUYJPFJUD       LFMEK           EVLCTDILPHHWD   TNMAMHHWSXWS    MPKPQASEYATK   
DLPQTBEHKGM     : DXVGQGXCCNP     SPGBLHPECDO     QDKLYFFLF       QTPOFBV         RBRMRNWLVJPO   
BIYKBONGJEWB    : LEKPHEOIYHHMPQ 
FJQF            : UOAEAWVL        LAPTIDS         MSWNOQIGENBFRFW WHQTXWVWFBHXA   IOADBWQQCRFHJI 
SLTICNLGWXOK    : MHRSNHUJN       QTNGFI          MULYB           LYYIOOBXLF     
PSCBVQODCUC     : GLILL           HHKMOJPKUPHO    FOFIAI         
UHPLOW          : GSMIVBQOJETG    MDJUDJILJUADROY INOEOFLQ        GYCNBPDAHYRDXN 
ASOEIC          : TLRNKHODPUT     OGVM            ACTFCYF        
GABQDTLFWHXNKAJ : FJLWJGDKA       CLRAWQEV        NKIQCU          BFHDPNESAFVFCNB SWRW            WHQTXWVWFBHXA   IBUNRDYVUCVOJH 
GEVXRNVYNQPUAU  : NXTJGX          SVKX            HUFYQJFJIGRL    FKIWNAML        IRBEFUHBGGMB   
GUJYAFKFCTFPHG  : EQFXSUOOYSKXU   YQIITUQ         JDJXHDEOP      
VOFSNAILBXCSSC  : BEQECNQBBLVPWX  IORMANIWK       XGGGNUWQKYR     FCCLKNSJTLJGAM  WUTCRDFX       
BILMJLTVTV      : SEOTI           KIKLKQNFKOGAELL INEXYTDUKUVLWAS QQTA            ROHRNGQENS      NJBG           
BNXJPVYWQMYYA   : MBQHKGNQGHW     HRKIVFGRFCO     UCOIHYYNYEC     EGHGFLDJR       XQVPLPETPGCJEW  VYCMIDBMBEFPIN 
XCVQFLTPYIA     : ADGSOSPQFILS    VBFQJDS         VYSASK          YKJAYMAI        NLSRWLY        
CVHAO           : DQJUETCHOA      CMXTKHXO       
OOUGLTDCID      : FQHPVMXLDUSL    JTFD            PLTRELNTDJ      KRPGLSMGBEEW   
IFCKDSRPPKQAME  : CQCEW           VHVISAC         UMEJGHBHOUCMYCQ
INFA            : CKNHHUXBUYSANVM OVTTAE          GMTUQWJ         DKMKMTAKQDHLDRN CEFPOUEHBRKMG   AHTUGKJWUQBITJ  NHPGGCVD        WGOHNECT       
VOTCANGDXLHGQ   : BMFFJBGGR      
SWENMVXFWK      : EGSLLSOXOJ      KTWGUVTC        RJAECCIQSXEB    QKVDOMAONHQC   
CUXHWWEMQGMGO   : WOIRNVPENMILY   ODHBDHXPJIC     IKSWRCFYSOQYUV 
EABMTKISR       : QBPQDAIVUEV     NAPGUYKKIHOSN   QCNGBFKHLWJNSN  VOBDNR          CVNSGOKLXUCDX  
FNVM            : WUTCMSWWUMU     YRLGCMKXMQ      USIXEJNDHLAQA  
IWMFVWD         : QENIIXWTTWS     NFHXAXYYIPOGF   TTLVNEJ        
DRMJESBYA       : GXUMNVUFAGYE    VHJA            MJIHFFGWKADLGKC
COYNWRFUYUSM    : YWYVNLMTV       WOIRNVPENMILY   KSFJCTBVDUNH    UTRQIMNNWQL     ACYXAMONIPPQV   IGCQPCIA        LBDAJIBXLIGCSTV
DJUJHTOBW       : EAXRYEPJSIIVCDF MUBWYSNCNCELUR  MSWNOQIGENBFRFW EGODTPKGYKFP   
PJMKM           : ABMKBST         CSVXMIQWGTOUTD  QUIYHHFKEIHOQBP IGLV           
KPQCPEYJL       : AYPFMCJNBYMWRV  GMTUQWJ        
JIPXOVHMFPIVSG  : TYXDBADN        TNHOSGAOEGVL    RJAECCIQSXEB    DJKQCCTPXLWU   
KRQUEFITVKLCL   : LMBSRRRNFUB     TEXC            GWHACOBU        HCMYSBHBSMQEE   ABORFAOOKVYTXU  NFHXAXYYIPOGF  
PIHXBFPWO       : BYEU            KBBJQP          YCRYYU          EPIXLRLFLBNB   
EGMAYSELMUH     : RFSWLN          XQWIARNAQDWWVU  VMFF            OUHEWDDDF       IDLPQFRJK       GTIHPA          WUTCRDFX        QXLX           
ARNXCBAPYRY     : OORCPEIXBVWFND  HDPNMFJ         XGGGNUWQKYR     UNQA            GWHACOBU        SPNYDYJFM       XALHAWHD       
QCNGBFKHLWJNSN  : ENHGNGLJL       MQYQEO          EABMTKISR      
FKIWNAML        : YRYMNDQRBQQSPPH GEVXRNVYNQPUAU  CSVXMIQWGTOUTD  WHBT           
NOUNGVXYXOFB    : VGGLS           VBFQJDS         XMQVKMHAN       XIJBM           QSCOQDUVJYSEXO  VVRWG           DYGPJBS         VYTBPO         
RIHPRUKFWPRHOF  : XTRU            MVYFWCWAFALMFA 
BTMRKHHSDFSDTA  : ORGC            VRKRBBT         IKPUSHUJAMBG   
PSMXKEUULRK     : CFYHRDHFBWLS    VJJBCGW         RXVQJTHQQFHCBYP MFMIWIXUUCC     HMJDKKPBFMT     BLHILVESGJ     
ACNKFJW         : HAJVATCD        BRFCBONGFTP     LSMFWAEPNGGVTWO
THGPMMIS        : TAHFWMDLMIPDPJ  SGIUUH          MCGIIJYFBX     
IWYDMWNSTIHMVN  : WDLPGDCNDN      FXKC           
ABBFLAFHHN      : IGCQPCIA        XYEQWGDHNBI     CVNSGOKLXUCDX  
WAHPLQ          : LMBQWAVWTNUN    UTYEA           XBNOKWRWIX     
KVDJKWDUERSRISU : NRXJPIY         EAIMDHNLYNTX    EJKBVFIAWUCA   
BGKGQTVN        : UELYY           QUWLNEKJSK      XLQXT          
YVKKOA          : JFOQIWTVDVMLQ   LYYIOOBXLF      FJEBW          
KDGWCLUGGN      : FGHJU           EGKHHMQCOJSN    AKNRLDF         AOSJDFVXPWJ     HVQJNGYD        OSEWULFGPK     
OHVYK           : FDWKNXBETHKI    JIAECI          QHOVIPAGNAU     MJHUKTCWQTLBV   CAKJPX         
LQUFOJYNHLXXL   : JWQVMGAJ        FGHJU           TGIJDANMMJMJDQP BJNOHBXBJAKANBW ROHRNGQENS      MKLESMGGOXL    
KRDITPDDX       : WTJOGDJD        UBKHXAFAULYOOI  BOOF           
DMAYNKEYDY      : GVLXKAVSWLDYAI  DNQLINPALUIHSFU CFQOBDFKXTF     GACUSOKSJXDMC  
SKIGTTHRICF     : YBWNTVG         DBXRSGQYIJTQLYV
INVASYXLFK      : JLIISGDJYD      BSVJLRSHSPE     IRBEFUHBGGMB   
EYYKAFMHAYPIT   : SFYAHULCM       TTWYVGMSO       NUAREYTDHFTKPRE WXMCI           IKPUSHUJAMBG   
PNUUSWD         : XAFWFTVCDSTJTY 
UDBWBPC         : PCRLNPYQMR      WDWIGTXIW       OWLJOCRHCKFHU  
EGODTPKGYKFP    : GURJHDCFDJ      ITVBEXSTLCRCO   PYWAHUCMAEXC    DJUJHTOBW      
BELR            : KMVII           WQHBMUGF        ECTRXALFPGUBJ  
GKXJVSMYPPOR    : KSMBONCXTILRI   KBBJQP          MNCOBODU        VODVBMA        
SBUYUKLDKWICS   : LAQTW           DVSRLULP        XYHTFVPG        TUVIVVROMFH     QUUPTGHIJHVPB   PCLLSKBTVK     
GEEHLQFWMXMMQCD : AYQPM           LAPTIDS         EXNKOLKBTJY     IJXVT           GWHACOBU        YENLDK         
IWLGXIQJLDIWHBL : MVXDTFJIWY      FQOCXUCVKKFFI   JIXUU          
IPWVIESX        : WBQUGYGUMM      FJEBW          
FMVKPGUO        : VFTNICNEPQM     BMDUWRXHQGJE    RCPM            GJXI            XAEDUNHMTIAWH   YVOG           
BMDUWRXHQGJE    : WOIRNVPENMILY   FMVKPGUO        YGCU            FXHOJ           ENOAWYFFLLNWMCE
TTVPEA          : FEGOCPNFELBC    FYNHTUGTQTBI   
CFQOBDFKXTF     : DMAYNKEYDY      PPLXR           DDKWXAHAYALYV  
JKWIEU          : RBEJYWTWRKV     WRUHABYTR       VXXWHNJBRKUOK  
WDBBCU          : ORVVL           HUVQGLBEIGU     TEQEWILHAGE     PDIL            VXXWHNJBRKUOK  
XMCAXEGQTJV     : DEFURM          JQXORJLO       
TTWYVGMSO       : KQXV            EYYKAFMHAYPIT   NSPIJDTO        QQPKKJB         JXIRYWYS        OVKEHW          OWDUMUTS       
QHOVIPAGNAU     : YFDRGUIMW       NMNNLV          OHVYK           QRSLVYQVJIO     JVMETFFMAXGIA   SKLPAL          CDXQMQTQ        EISJWM         
BSVJLRSHSPE     : BQPKLJ          TXCX            EGKHHMQCOJSN    INVASYXLFK      EEDNMQCSVGPI    MSUFGWSOEFBUEW  CIFGO          
QCYDXOWQXLOG    : NNEWF           MQNSKB          GXWSPBFLMEEJXQ 
POSP            : NYNXUMYJNUANBB  PCLLSKBTVK      XIVUFUI         JPMRCXQWAUU    
KSFJCTBVDUNH    : COYNWRFUYUSM    IPGYBXHMK       TRPVIY         
EMMIKDFDBSRKXH  : RXTUWFL         CSVXMIQWGTOUTD  KIKLKQNFKOGAELL MCLMEIHUTAETGQ  WYTSKRSHFUHW   
RALESRNVLR      : AJHW            VGFKPVVTXT      KOIHHBTBJNON    PUJCCSAXQWQ    
OOHYCLLQVXWDBXV : ITBVFME         MVBEJ           EJSBAWFRLVY     WXMFH           BHYSPVWCWOIC   
KUDMODXUX       : NHAPF           NRRSEHJX        KHHUXQKAKE     
JTFD            : EAMCP           MAUS            LMBSRRRNFUB     NUXIXQMGOPC     OOUGLTDCID      AJHW           
URYVVNJMJ       : YBWNTVG         TLAIBCIVM       QJKQSWG        
JNKKLFUIIJYNI   : TVUKMNMSER      TFDXHS          OXOINT          WXMCI          
MCGIIJYFBX      : WPSYQSWTYYIL    THGPMMIS        BCINEIOK        MNJMMAJXADL    
YNKL            : JFOQIWTVDVMLQ   WVVPCXHIGFU     HOGGKQGGSHYRPAK FENFJFFB        JJAMXQIUP      
TXNEI           : XPUMIDLDYOYNC   ORGC            HUFYQJFJIGRL    UTRQIMNNWQL     FDRGOLYREGAWISU XIJBM           GUGJLWFWU       UUKUUGVH       
TXNEI           : VXHXRUHEO      
LFKU            : XKKEG           MCADEHCRIFDTSQR APIGESEBHM     
LKAGWCMGKXHRYHS : CWIOHTJIBSIVICK NCTYWTIAV       WJOYFM          AGHKG           IKSWRCFYSOQYUV  RYNPNLQSRU      WSBDHYLSGY      SOCDAMJ        
VFMT            : XKUINPOVQAOYT  
MJHUKTCWQTLBV   : NHAKYBC         OHVYK           GXNBGHPOKBTHA   NIJSX           KNMHBE         
BYHHLFQE        : EGAATQ          AVLT            LJVXV           IOKCRU          PDIL            HOBXGQON        DCREWQLAMGEML  
XYHTFVPG        : XPUMIDLDYOYNC   NMXIDUT         SBUYUKLDKWICS   SASXEISYK      
BODOKINBEY      : CEFWIQSURBOTR   SKLPAL          FIJAOHRUMPWDRJR VEWHH          
BRFCBONGFTP     : XMFFRPFPB       TYGXP           ACNKFJW         OIYQXCUFSNMVBE  GACUSOKSJXDMC   PXAWDBWJFA     
TXABTSJDTAIIK   : QBPQDAIVUEV     ABMKBST         LALCYR         
WNXVSYPXBQN     : QBYDMWUJV       BMAIPNJDBWD     ACJJLMVJ        UUOXWSARXEOR    BBAKFDOIO      
XULNBH          : PRNBSNDGWR      AYUOJDQELGPGEG  MGXSTEVNBTX     YENLDK          FQNQY          
CKIUTNOWV       : BJNOHBXBJAKANBW
JPUXN           : GGSOCQIVMUOCCRN EEBRFDLYO       HMYWVAIFK      
QOJOP           : NLJJHRBONPWVLOI QUIYHHFKEIHOQBP TJGKOSAL        CVNSGOKLXUCDX  
EGAATQ          : BYHHLFQE        GJYBJLUUIDIHN   NJBG           
BEFNOAKC        : DGFLRCVDQDD     NRRSEHJX       
HBRQSOQIHHWQY   : STWDVQDDYAR     HEITHVQMMBTW    BTKDRS          WQHBMUGF       
TFUTFP          : JOPCJW         
JSTOHIRRNLBO    : NXTJGX          AJHW            KXABGTNQAEOQQY  QQIRFHYOAMRN   
TJRLRYUOSTD     : GJXI            VXXWHNJBRKUOK  
CAKJPX          : JNXHWKWKDVPYW   EQUAKIYXICPWJ   OHVYK           YUOWGUEGRJQQ   
LRKSCEM         : XSUJ            EGSLLSOXOJ      APKUEAHNSRRFI  
PNGSHPKS        : VNMKKXXMAOV     JLUQULYBVRKCK  
LOXGKDUMEIWV    : VKWHDJIP        KBBJQP          WTLTMIXFEVUT    WNDSU          
RJAECCIQSXEB    : AYQPM           SWENMVXFWK      JIPXOVHMFPIVSG 
ORFHBTXC        : STWDVQDDYAR     JIRDCLHUGDPUVS  DBXRSGQYIJTQLYV
LHXAN           : YBSFRBGXTM      TKXLAD         
YKORTOVYQ       : KVCMFQBDOOV     DTOPDG          HRVAS           DJKQCCTPXLWU   
RLHWNBLFGUIC    : FDRGOLYREGAWISU MHRSNHUJN       CPGIBRXBNSPWJC  GTIHPA          PWESTUPPLUMM    TLWS           
MDJUDJILJUADROY : MVVJFMEMRWTQLQ  NFGTRKIJJEBWXFK UHPLOW          AVQL            MLXTNSPDUH     
HIKTQJHTWOA     : LCPWWBG         WMHNFE          MULYB           DNVCYFQ        
YDQMIAJNL       : MNCOBODU        TEXC            MLXTNSPDUH      LTFSGN          WUTCRDFX       
YUPBXJRAEYIO    : LEKPHEOIYHHMPQ  JKYVIMCJ        QEADSQ          SRMDRCDLCOKSJD  THYSP           GXNBGHPOKBTHA   SWWWPDYWPIIPKLV
BYEU            : HWBCOKUPKO      PIHXBFPWO       VEWHH           DCREWQLAMGEML  
UXSUDJHNL       : LNGWRT          PCRLNPYQMR      LRXEOINNLKDF    AYQPM           WSFRUY         
BXMCUCD         : EBDVB           VXMNLVEDCXAWPW  KSFTI           FOTMWYNV        CXPFH          
NUVRV           : QBPQDAIVUEV     CFYHRDHFBWLS    LCPWWBG        
HRKIVFGRFCO     : FQHPVMXLDUSL    BNXJPVYWQMYYA   FDRGOLYREGAWISU RXVQJTHQQFHCBYP ICQDHCHGJBEJW   BGSGQCS        
LXVAQYAD        : PDCLIQEWBRMBDH  QUWLNEKJSK      NPBYRNWEKISCYQ 
UIEQVBO         : NYIPEJTEPCD     KVLRWQGAYV      LDDQXGEGUEJD    NCTYWTIAV       VKWHDJIP        ENLDH           HMYWVAIFK      
XXARIKPPQJVU    : KVLRWQGAYV      SFYAHULCM       UTYEA           LBDAJIBXLIGCSTV
GHVF            : LRANIMDRNMRTLF  HOFSTKPJNDTQP   DMQMIJVXUCNSN   BCEBRSSOLC      NRMLISWSJK     
OELUIIDOCBQQ    : XWTMIVWSKABYBY  GXMMRWQGXJIFKD 
QOTIY           : AEQYC           UUNRNVVDYIL     INMGE           WYTSKRSHFUHW   
XPXKNSITCHYL    : QDMPXQTDEKU     AHXJCCIRAOYVS   CQCEW           WOLRFKJBKVTU    PQYSMVO        
GWSOGVFIA       : MNCOBODU        VMFF            PEAUNA          DXFWLQ         
BTOSOYRSA       : KBBJQP          FKGLAUDUJOMGVQD GNSYSDBPGRC     XNCDKSYF        HMGIJYLGEU     
QKWMS           : ULMYXEBMPRFQM   TXCX            IUDSSENSYRXVOY 
OCSDBYCTPKSVUU  : IAPUAMP         KOMUCIYAYKHRYOP
WOLRFKJBKVTU    : XTRU            XPXKNSITCHYL    NXMEUXKFPFGBH   RDYGEIVVQXT    
GQKVUEBX        : FMDIOIHYANGF    MVBEJ           OVKEHW         
DSXONT          : UIEWYKXEJN      IRETGXAXGLIUWL 
IPGYBXHMK       : TMXOAYRTA       KSFJCTBVDUNH    XTGTT           RGCCSLXL        NFTUEYTNIDX     FQNQY          
YGCU            : NDKPUUUBOKTRL   AAPGXMUOJSTJ    MNJIWG          PYWAHUCMAEXC    BMDUWRXHQGJE    DDKWXAHAYALYV   GGFVBHIBJBQVQDD
JNMHISIHA       : WDWCEO          WVVPCXHIGFU     TYGXP           OVAYQSMQKDMXAL 
CXARRMCKUDLV    : XDQWVWWWUHFR    WBQUGYGUMM      IISRGJHLH      
AGSAOXWP        : AOQAYF          SKEFRKQML       XKFWVIDIMOIKYSW
KEQUYYEAMIXPC   : IGBSGPLTVN      AWRFATPSHKJ     BFYEUL         
CEFWIQSURBOTR   : DXVGQGXCCNP     GDEMLR          RDSWGGBV        DKPAMKPQYSW     BODOKINBEY     
QKVDOMAONHQC    : XWTMIVWSKABYBY  SWENMVXFWK      XCOFGJBEV       LBVL            UTAPMJVYI      
QRSLVYQVJIO     : IHBNSCXXCV      WTJFW           FLRNIAAG        QHOVIPAGNAU     BMFFJBGGR       MDMNRUO        
CSVXMIQWGTOUTD  : QJLMNSI         PJMKM           FKIWNAML        EMMIKDFDBSRKXH  MVBEJ          
DVKTMFOBBNR     : PCRLNPYQMR      HVYSKARLO       ICMYBDD         FCCLKNSJTLJGAM 
XCOFGJBEV       : QKVDOMAONHQC    TOHBJD          BHTAIUAVEAUM   
UTRQIMNNWQL     : OFEXRGUSCI      LMNN            COYNWRFUYUSM    TXNEI           KDCY           
KXOBYQRTPRVEWDP : VMXCREEVN       YPLAOHNQS       GICMLND         LODGCYQRKFEHI  
JMJHGBXQPLEMDPV : CKNHHUXBUYSANVM UOFIFKU        
PLTRELNTDJ      : MIIRCNOKLDCIC   OOUGLTDCID      FENFJFFB       
AOQAYF          : YIJBC           HFRU            AGSAOXWP        STIQDWM         DBMFPDEJD      
INMGE           : QOTIY           RPVYQYGQT       VUUS            EPLXIVMYWKH    
UKQA            : VKFPFUEHFW      PCONXRSPOFMP    CTXWXK          NYAWNEQ         EISJWM         
MPUAJOEWCBALECD : EAXRYEPJSIIVCDF RTDRBRENHMMA    SQPYHYWKTPQJ   
EEDNMQCSVGPI    : WXMVNFS         EQUAKIYXICPWJ   BSVJLRSHSPE     VYSASK         
PLMGIORWVRYWRKD : UCOIHYYNYEC     TGMMTBRBFR     
NABRFRGWVCU     : LYVIAHB         RKTKB           SQDMHNEUTVB     WEXENI         
RDEI            : ULMYXEBMPRFQM  
QQYIKVE         : OPVKQFT         FHGVHMRALK      UELYY           PDIL            VTLVNRCJQ      
WDWIGTXIW       : GTWAWIDRYUHANXD UDBWBPC         RXAEDLQBCN      XKUINPOVQAOYT   AGWRJCVNFQ     
OQBNNDISVNWE    : KVLRWQGAYV      GNSYSDBPGRC     DFUU           
QUIYHHFKEIHOQBP : MQNSKB          PJMKM           QOJOP           CINPB          
AKNRLDF         : KDGWCLUGGN      QQIRFHYOAMRN   
LALCYR          : PJXW            UUNRNVVDYIL     TXABTSJDTAIIK   JDAMRTFSI       IPDTEXJF       
PORQV           : CCJOH           CEFPOUEHBRKMG   YCRYYU          EVEQVQFFXUBXPQI VKTBVJWJUAENMQ 
XGGGNUWQKYR     : YBSFRBGXTM      HADCJUIKAHKDCK  VOFSNAILBXCSSC  ARNXCBAPYRY     XKKEG           AIHEBBAKH      
OJHSQYESKIRE    : VMXCREEVN       CNYFML          VVIYMTPL       
KSMBONCXTILRI   : QTFCUH          GKXJVSMYPPOR    XKUINPOVQAOYT   RBRMRNWLVJPO    GHMKCVDCIRYS    VUISPJP        
CHWAV           : WBEOCCBYLQWGA   NYRDSDJOPVSIWR  JDJXHDEOP       WGAC            HCMYSBHBSMQEE   BLHILVESGJ     
JQBKV           : DYAX            HVYSKARLO       THPYKRHHW       VPIXPSQMJNCWD   FOTMWYNV        WRAVKRWRFKY    
UELYY           : GXYXJ           BGKGQTVN        QQYIKVE         UCOIHYYNYEC     KDCY           
TLAIBCIVM       : URYVVNJMJ       YLNFTXNLFJI     JFTDVOWRMH      CILJBUBAO      
NUAREYTDHFTKPRE : EYYKAFMHAYPIT   CFKXGINXQUSBNH  MKBFUERUEGVKDKW
YPLAOHNQS       : WDTOCHE         KXOBYQRTPRVEWDP KHHUXQKAKE      ENOAWYFFLLNWMCE
UBKHXAFAULYOOI  : RXTUWFL         KRDITPDDX       MJIHFFGWKADLGKC
LSMFWAEPNGGVTWO : MUBWYSNCNCELUR  BXQGRWGV        ACNKFJW         TTKJPJC         WHBT           
RPVYQYGQT       : QEADSQ          BQVTXYSJ        YTKHGEDADMTRL   INMGE          
QIJBFUUSDTUHJI  : VKQXAWRDCISAPQG XALHAWHD       
REKOUVINSKE     : HRQO            WDTOCHE         XMQVKMHAN       VMPLTY          QJKQSWG         LLFATLP        
QULJNVVPEQKYT   : KLBYDYA         WSTCDOIQHLFUNGA JDJXHDEOP       LMXUUAFBRLUVLWQ
TEQEWILHAGE     : WDBBCU          SSTF           
VYSASK          : MVFYCTSIYJ      NUXIXQMGOPC     XCVQFLTPYIA     EEDNMQCSVGPI    GXMMRWQGXJIFKD 
EVLCTDILPHHWD   : MUCQQJLRSDHQLKW FPAV           
PIKATUACBLYAE   : YUPIEPBKINSG    DFUU           
UQYBP           : WDLPGDCNDN      QSCEYSVPAOE     BHYSPVWCWOIC    QSGSVYJBIY     
DJSOWJVHGCWV    : NCTYWTIAV       NUXIXQMGOPC     LCPWWBG         SQPYHYWKTPQJ   
KVGF            : DQANOSCDVYADK   NLSRWLY        
KIKLKQNFKOGAELL : FQHPVMXLDUSL    BILMJLTVTV      EMMIKDFDBSRKXH  IMQTMFILVJRMHQA
AJHW            : RALESRNVLR      JTFD            JSTOHIRRNLBO    KOIHHBTBJNON    LDALOSERG      
PBPLNAJVHKGP    : IKSVMALNEQO     MYIRESKDL      
UCOIHYYNYEC     : XLYKDYFAGVN     EGKHHMQCOJSN    BNXJPVYWQMYYA   PLMGIORWVRYWRKD UELYY           XKFWVIDIMOIKYSW
ECVLBODCFQPHANP : GKBGB           EJKBVFIAWUCA    CDXQMQTQ        YPCEMIEVNXX     BMFVO          
UHIRKYATXBKYFMK : WGAC            FQNQY          
OIYQXCUFSNMVBE  : EAIMDHNLYNTX    BRFCBONGFTP     FCCLKNSJTLJGAM  NVPJ            UXKRUTPY        TWRPFJAQ        OKDQHWSDHKCBPOC
XMRPYRR         : ORGC            PYYDJCVN        DPIPLFBDPFYE    WNDSU          
RTDRBRENHMMA    : BEQECNQBBLVPWX  MPUAJOEWCBALECD IOKCRU          RBCTGR          XUWYKOYNL       VHLXKWWKWR     
RURKKFGMLR      : ADGSOSPQFILS    MNGCFALTWNKRLWB COFYMHR        
AKDY            : GMTUQWJ         MNJIWG          YWYVNLMTV       PQVCPKNHXJXEWM  FFSAEGNOPEJDFT  EGHGFLDJR       WKPUYILPTUOGJO  CRCIJN         
WUXQAPUST       : QSCOQDUVJYSEXO  PEAUNA          OKDQHWSDHKCBPOC
AHWAVQWOC       : LTFSGN         
VKWHDJIP        : MAHFMRCAOAPGN   LOXGKDUMEIWV    UIEQVBO         XTGTT          
JVMETFFMAXGIA   : KXTEQUXKS       QHOVIPAGNAU    
ICMYBDD         : NFPNDTCYO       CWJTFFSSIYLAVK  WYEO            AYUOJDQELGPGEG  DVKTMFOBBNR     LTNKBKLUYRNLI   EVEQVQFFXUBXPQI HRVAS          
ICMYBDD         : FENFJFFB       
YQIITUQ         : GUJYAFKFCTFPHG  BOOF            IUGNVJF        
JDJXHDEOP       : GUJYAFKFCTFPHG  CHWAV           QULJNVVPEQKYT   SJMOYX          JKPLOUP         APIGESEBHM      XALHAWHD       
MYPO            : PTSTFIDLYNKIUW  TQAWCOTRQA      EHLVWUQED       EKGK            XQVPLPETPGCJEW 
XQFYSIDEH       : PVIKOLSWF       SDWSCMKVQUYT    TLRNKHODPUT     STQEXFN         RCPM            IBUNRDYVUCVOJH 
NSPIJDTO        : TTWYVGMSO       XKFWVIDIMOIKYSW LJEANPVPT      
SWRW            : VONA            JQNCXNVSDMTXWUS GABQDTLFWHXNKAJ RTWOJHETET     
KBBJQP          : QDMPXQTDEKU     BDEHTAGCF       PIHXBFPWO       GKXJVSMYPPOR    LOXGKDUMEIWV    BTOSOYRSA       SQPYHYWKTPQJ   
QHISAQVGBRTTJEF : WSFRUY          MJIENHMTSUAALE  GUOI           
YUBRRS          : OWDUMUTS       
FDRGOLYREGAWISU : QDMPXQTDEKU     VKFPFUEHFW      TXNEI           RLHWNBLFGUIC    HRKIVFGRFCO     FQOCXUCVKKFFI  
TOLPARV         : UFLDHPHNLDJT   
QQPKKJB         : SGIUUH          NGVPTJXUBCSURT  TTWYVGMSO       LRCGLVAOOYR    
MVBEJ           : PRNBSNDGWR      EQFXSUOOYSKXU   MVLMMYHMXHRW    OOHYCLLQVXWDBXV GQKVUEBX        CSVXMIQWGTOUTD  SKGVEQ          GUOI           
VPIXPSQMJNCWD   : FJRAGBAPXUV     JQBKV           TWQJJHWQTXYU    RTWOJHETET     
PBTIRJVESYYIWAM : CMCPMQNNUED     OVVXX          
AIYKIOF         : SDWSCMKVQUYT    CPGIBRXBNSPWJC 
BOOF            : VTXICTFVHIYI    KRDITPDDX       YQIITUQ         RMOHAQHO        IAPUAMP        
SKGVEQ          : VFTNICNEPQM     YDPVULXCW       RRVLLFQU        MVBEJ           OAKGMPTN       
NMUHMTPJVCSXM   : IXJPTCEPWAIDYN  HSFAWNTGPX      EGKHHMQCOJSN   
IUGNVJF         : HFRU            EGKHHMQCOJSN    YQIITUQ         PKEHLGWE        UXTYUJECAIVO    IPDTEXJF        DJKQCCTPXLWU   
PVGACCG         : RWCVJWX         GJRJHGCWEBG     YTDJWXKGNYTIKD  QSVDYWJDVHUPIOC
STIQDWM         : VFTNICNEPQM     BJOUPYGOF       AOQAYF          LTFSGN         
GJYBJLUUIDIHN   : CLRAWQEV        HLPGMCMAE       MAUS            WEGSY           EGAATQ          SPNYDYJFM      
UFLDHPHNLDJT    : YRYMNDQRBQQSPPH TOLPARV         IWEBQSGBEFNYRU  XALHAWHD        EBANXSSHF      
NQIIYTID        : YBWNTVG         OUPVBIJMBXNRJ   XWTMIVWSKABYBY  EPLXIVMYWKH     XPNDVC         
VXYH            : TVUKMNMSER      BVHQ            RTIXEWGRSH     
JOPCJW          : NUSKHCMSRI      XQWIARNAQDWWVU  TFUTFP          BMFVO          
OEGVRTYBNSQGEA  : HLPGMCMAE       OSEWULFGPK      SDMDKIUM        HJJCPVMLOC     
XKKEG           : LFKU            XGGGNUWQKYR     GICMLND         RBRMRNWLVJPO    RSDV           
FPNPEDTPCJEG    : LNGBOEVTNY      CWJPLUCV        XIJBM           XUWYKOYNL      
DALCBYX         : EERUOQFXOYMWRTA HSFAWNTGPX      VNGOXTSLGFHVO   PHILFPU        
HCUPCFAHNLO     : ANSX            UILQ            HMYWVAIFK      
YEMEXDGKJMCMMOR : GACUSOKSJXDMC   LRCGLVAOOYR    
PPLXR           : TFDXHS          XLYKDYFAGVN     CFQOBDFKXTF     EJSBAWFRLVY     IBUNRDYVUCVOJH 
NVNPFDCUJB      : QPGGUVTASXAHT   LMBQWAVWTNUN   
WGAC            : CHWAV           UHIRKYATXBKYFMK
MNCOBODU        : WLQWFPOWYC      XAFWFTVCDSTJTY  GKXJVSMYPPOR    YDQMIAJNL       GWSOGVFIA       ROGBEMKO        XQVPLPETPGCJEW  WHBT           
VKSTCYJAOYGSB   : QSAKE           TJGKOSAL        MSGKKRUACIYJKOP
EDCBLEFXQTAGWRL : CYGGJGFFPCMRTV  UYHGJXLOVOB    
YHCSDGTOGJO     : BNCDANML        XTGTT           YPGEEXWE       
ERNIUSKIWRHOLJU : HOEHPCJIEWGQBG  WKPUYILPTUOGJO  MULYB           DXOJHSMEVQB    
BICDSE          : DQJUETCHOA      WYKO            FCCLKNSJTLJGAM  GNSK            DDKWXAHAYALYV  
VMPLTY          : VNMKKXXMAOV     REKOUVINSKE    
IDTYORR         : RDSWGGBV        AHTUGKJWUQBITJ  TGMMTBRBFR     
AOSJDFVXPWJ     : WLQWFPOWYC      XSUJ            XISVLYTGUF      KDGWCLUGGN     
ACYXAMONIPPQV   : JCKWQSVICGYQKWG COYNWRFUYUSM   
PKEHLGWE        : IUGNVJF         UTYEA          
ALMB            : NUXIXQMGOPC     RTIXEWGRSH      WAANGJBLBW      CKLMVPGF        YUOWGUEGRJQQ    DCXJDX         
LKWOOVMOKDDSTSK : NTKKTYKB        VUEL           
FCCLKNSJTLJGAM  : WWEOAQG         VFWYUDDF        VOFSNAILBXCSSC  DVKTMFOBBNR     OIYQXCUFSNMVBE  BICDSE         
LYHCNFRD        : JNXHWKWKDVPYW   WYKO            CFKXGINXQUSBNH  LRCGLVAOOYR     NFHXAXYYIPOGF  
UILQ            : HCUPCFAHNLO     JKAUCCITC       RXAEDLQBCN      RCPM            BMFVO          
XIJBM           : NOUNGVXYXOFB    TXNEI           FPNPEDTPCJEG   
LCPWWBG         : HIKTQJHTWOA     NUVRV           DJSOWJVHGCWV    GICMLND        
BVPPUYRLGJQYHY  : GJXI           
ACJJLMVJ        : WNXVSYPXBQN     AYIDHSFTFTYTMQO SPBCPAEE       
YYWXBGDECUTYV   : SFYAHULCM       XPNDVC          APIGESEBHM      SIVSL          
MCADEHCRIFDTSQR : LFKU            UIEWYKXEJN      IRETGXAXGLIUWL 
QSCOQDUVJYSEXO  : SODDSPPRU       NOUNGVXYXOFB    WUXQAPUST       USIXEJNDHLAQA  
LTSQADTRNBUJTL  : VGGLS           CPGIBRXBNSPWJC 
WFUBTNGQKPP     : TEFUPIAIDWFQ    DLJNDLWLQVUJ    AIBHOBBUKJIE   
TNUOBQKSQNOKDPF : SXRQJY          GYCNBPDAHYRDXN 
LTNKBKLUYRNLI   : ICMYBDD         GXMMRWQGXJIFKD 
SESPTUGEPYTEJY  : GUOI            FFCDQAXAGWBSVGE RDYGEIVVQXT     IXLJTYTAY      
RLHNBUOOG       : YBXBEYHTSHDLBOO LHVYUJB         LRCGLVAOOYR     JKUJ           
PYYDJCVN        : HWBCOKUPKO      EQNMEBPXHGM     XMRPYRR        
MHRSNHUJN       : FLRNIAAG        SLTICNLGWXOK    RLHWNBLFGUIC    DHYJQFS         YDLDVFR        
IJXVT           : QELCJ           GEEHLQFWMXMMQCD
XOCMUN          : MDTEVJEMSAAP    PCRJGURG        DGEISJPGFGMFTW  PCONXRSPOFMP   
VMFF            : ITVBEXSTLCRCO   MVVJFMEMRWTQLQ  EGMAYSELMUH     GWSOGVFIA      
DTOPDG          : YKORTOVYQ       SHSMYRSIRX      IXNUBPTYPFUL    BFYEUL         
ROGBEMKO        : OWMCMHGQR       PBVUDJCXPFPNBK  FONTONJSFIRFPP  MNCOBODU        WULRNUOYWCBD   
GKBGB           : CQCEW           ECVLBODCFQPHANP XAHXXHKDT       MYROQWNDG      
UXTYUJECAIVO    : XISVLYTGUF      IUGNVJF         GKSUVVLGIJGLFBV
AVLT            : HOGGKQGGSHYRPAK BYHHLFQE       
TWQJJHWQTXYU    : WBEOCCBYLQWGA   EGSLLSOXOJ      SVKX            VPIXPSQMJNCWD   UUOXWSARXEOR   
UTYTQI          : MDNDL           MVFKDOKGGE      NFTUEYTNIDX    
SKLPAL          : DLJNDLWLQVUJ    TXCX            QHOVIPAGNAU     BODOKINBEY      RVJNTTP        
XANMTKFDUPCN    : BAKIUQGDVW      HHGWKLXYEUVTSX  PNLHV           TXIHVSAPNERSJ   UTYEA           IUDSSENSYRXVOY  VJHXQ           KWKN           
BMFFJBGGR       : BXQGRWGV        VOTCANGDXLHGQ   QRSLVYQVJIO     XCCFITVTGVO     MGXSTEVNBTX     OAKGMPTN       
JKAUCCITC       : BEQECNQBBLVPWX  RBEJYWTWRKV     UILQ            BBAKFDOIO      
HOFSTKPJNDTQP   : LMBQWAVWTNUN    GHVF            RVJNTTP        
XCCFITVTGVO     : JCKWQSVICGYQKWG CSYYF           FFSAEGNOPEJDFT  BMFFJBGGR       WAYDH          
AYDCKNQ         : IWIJXTNIQFDM    VOBDNR          STBCLYMWFJSMBKD
INEXYTDUKUVLWAS : BQVTXYSJ        OORCPEIXBVWFND  BILMJLTVTV      LQSWNU         
VOBDNR          : CWJTFFSSIYLAVK  WYKO            EABMTKISR       AYDCKNQ         IBUNRDYVUCVOJH  WULRNUOYWCBD   
NRRSEHJX        : BDEHTAGCF       KUDMODXUX       BEFNOAKC        RGCMMCKOE       QGJDQB         
YCRYYU          : PIHXBFPWO       PORQV           KHHUXQKAKE      NLSRWLY         TWRPFJAQ        VVIYMTPL       
LQSWNU          : INEXYTDUKUVLWAS XINWKQBSYJX     OJENTAUP        MGXSTEVNBTX    
XRFBWU          : BJNOHBXBJAKANBW WYTSKRSHFUHW   
LKNFDRPPR       : VFTNICNEPQM     YDPVULXCW       SODDSPPRU       ECWYGU          MUAEREDKC       IUDSSENSYRXVOY 
OVAP            : CXPFH           GKSUVVLGIJGLFBV ROHRNGQENS      MSGKKRUACIYJKOP
WMHNFE          : SRMDRCDLCOKSJD  RAMJNX          HIKTQJHTWOA     GICMLND         NJBG            WGOHNECT       
CWETEFSYYGJ     : BEQECNQBBLVPWX  SBRQWGYX        QSVDYWJDVHUPIOC HBLEWDQ        
MNGCFALTWNKRLWB : NWAFAXMRVBW     RURKKFGMLR      SLKGXB         
EGHGFLDJR       : YFMOQHGXJRHBYLE WDLPGDCNDN      PJXW            BNXJPVYWQMYYA   AKDY            MVYFWCWAFALMFA 
KSFTI           : LHIVSUWKDJSSAY  BXMCUCD         MNMRPRKRPKAPOSN WQHBMUGF        YUDAWRK        
JQXORJLO        : UDKKRJJV        CGQDQMCKH       XMCAXEGQTJV     PAQRCPRNJ       LSXU            MVFKDOKGGE      JKUJ           
XINWKQBSYJX     : WSFRUY          LQSWNU          EKGK            UYHGJXLOVOB     EBANXSSHF      
OJENTAUP        : LQSWNU          EPLXIVMYWKH    
OCYMSQ          : IHBNSCXXCV      LDQGSNFFTN      AYIDHSFTFTYTMQO SAAAR           VBKKJSPTQSLVECF
EHXCQNBD        : USOSAAGHAXORD   XRRHHVQ         YFUOHKWEXJO     XAEDUNHMTIAWH  
EVEQVQFFXUBXPQI : VKFPFUEHFW      PORQV           ICMYBDD        
SHSMYRSIRX      : ADUORMWDEJMNLJR DTOPDG          MVFKDOKGGE     
GYELECRUX       : UQEIOIK        
CFKXGINXQUSBNH  : MFSMIHQLHHA     FXKC            FEGOCPNFELBC    NUAREYTDHFTKPRE LYHCNFRD       
HBKA            : YBSFRBGXTM      NMXIDUT         QQTA            RDYGEIVVQXT     SKEFRKQML       JFTDVOWRMH     
MGXSTEVNBTX     : SEBG            XULNBH          BMFFJBGGR       LQSWNU         
CJEIT           : UGSANSULIIFNA   NHAKYBC         IRETGXAXGLIUWL  NBJDT          
INOEOFLQ        : UHPLOW          FIJAOHRUMPWDRJR
MDMNRUO         : QRSLVYQVJIO     UECQGYDW        HQUBLKHXBVWMJ  
OUHEWDDDF       : EGMAYSELMUH     VEWHH          
HOIBYXSFMX      : TNHOSGAOEGVL    CJWW            OQBADAHA        OVAYQSMQKDMXAL  VBKKJSPTQSLVECF
FKGLAUDUJOMGVQD : GTWAWIDRYUHANXD AEQYC           BRYEPYLCBLGR    BTOSOYRSA       TUVIVVROMFH     KOMUCIYAYKHRYOP
VGFKPVVTXT      : YIJBC           YTKHGEDADMTRL   DGEISJPGFGMFTW  RALESRNVLR     
DJKUQ           : AUQAFITCY       JQNCXNVSDMTXWUS TQGLFGXYCK      LSBRPFPQAXNIBE  MDNDL           ODTK           
ECWYGU          : EAIMDHNLYNTX    LKNFDRPPR       DNVCYFQ         TEERGPYRFVS    
WHQTXWVWFBHXA   : FJQF            GABQDTLFWHXNKAJ PEAUNA          XIVUFUI         BUKQC          
RXAEDLQBCN      : JIEAH           LMBSRRRNFUB     WDWIGTXIW       UILQ            TNSRDLV        
HLGPGSMPLIPIEM  : QIYIWEHFP       JSUGXPDEXAOBMLK PBPGFX          WXMFH          
GUOI            : PVIKOLSWF       MJTAJCWAWR      QHISAQVGBRTTJEF MVBEJ           SESPTUGEPYTEJY  AVQL            HLMIIABMBYH    
GICMLND         : XPUMIDLDYOYNC   MUCQQJLRSDHQLKW HKXBTAGKQJLV    KXOBYQRTPRVEWDP XKKEG           LCPWWBG         WMHNFE          RCPM           
GICMLND         : CPGIBRXBNSPWJC 
QQTA            : WADJQFBTO       XQWIARNAQDWWVU  BILMJLTVTV      HBKA           
APKUEAHNSRRFI   : CSYYF           LRKSCEM         VNGOXTSLGFHVO  
AYIDHSFTFTYTMQO : WUPXBEADF       IXJPTCEPWAIDYN  ACJJLMVJ        OCYMSQ         
UQEIOIK         : GYELECRUX       XNCDKSYF        WOJNALHJ        VSBELSPDGDVS   
XDPQJBSLAEOK    : TVMNTFRBKFRK    PCRLNPYQMR      YTKHGEDADMTRL   TGDLAPSKOO      MFMIWIXUUCC     UOFIFKU        
UECQGYDW        : PBVUDJCXPFPNBK  FFNS            MDMNRUO         KCYACEYNKLU     BCINEIOK       
RTIXEWGRSH      : FONTONJSFIRFPP  VXYH            ALMB           
JXGKSUMWL       : TVQLKLAABT      NLJJHRBONPWVLOI
UIEWYKXEJN      : RTBQUT          THPYKRHHW       DSXONT          MCADEHCRIFDTSQR NPBYRNWEKISCYQ  SLXRYLDFKEJAUKK IXNUBPTYPFUL   
FWVKTFCPMYBMI   : MTRJCJB         QJOVLGQPKCHYO  
FFCDQAXAGWBSVGE : SESPTUGEPYTEJY  YENLDK         
EJKBVFIAWUCA    : EPHVBKEMPQYQQC  KVDJKWDUERSRISU ECVLBODCFQPHANP VJPIBVOHYHPCU   FQNQY          
MNMRPRKRPKAPOSN : KGJRUGRUDPVDITX GDJFAXANJOD     OQBADAHA        KSFTI           SYJWURPLBIIDC  
WYDJMGFTO       : DHYJQFS         FLGPPN         
QJKQSWG         : RBEJYWTWRKV     TQBRQWEYNM      URYVVNJMJ       REKOUVINSKE     KXABGTNQAEOQQY 
OVAYQSMQKDMXAL  : KVCMFQBDOOV     JNMHISIHA       HOIBYXSFMX      FWCPXDOARDY     XAEDUNHMTIAWH  
DWLKDFYL        : DQJUETCHOA      EGSLLSOXOJ      IDLPQFRJK       ECTRXALFPGUBJ  
LXOGUWOLTR      : FFNS            IQWCTEPPLRQG   
MKBFUERUEGVKDKW : THPYKRHHW       NTKKTYKB        NUAREYTDHFTKPRE
RXVQJTHQQFHCBYP : PSMXKEUULRK     HRKIVFGRFCO     TCGEF           QSVDYWJDVHUPIOC
JSUGXPDEXAOBMLK : NAGTQVSBPX      OQBADAHA        HLGPGSMPLIPIEM  TSMFJVHEC      
KIWV            : WLQWFPOWYC      XSUJ            SDWSCMKVQUYT    JVFJKIICIFOFRE  FCUFCOHF       
FOTMWYNV        : BXMCUCD         JQBKV           VUEL            FJEBW          
FIJAOHRUMPWDRJR : BODOKINBEY      INOEOFLQ        WXMFH          
PCONXRSPOFMP    : UDKKRJJV        KLVLYTGOSRCP    UKQA            XOCMUN          SOCDAMJ        
IGCQPCIA        : COYNWRFUYUSM    ABBFLAFHHN      DXFWLQ         
DOMATGLLKBNAO   : FCIXLF          LAPTIDS         BRENO          
TJGKOSAL        : BOQF            LHVYUJB         HDPNMFJ         QOJOP           VKSTCYJAOYGSB  
GNSYSDBPGRC     : XPUMIDLDYOYNC   BTOSOYRSA       OQBNNDISVNWE   
LJVXV           : YFUOHKWEXJO     BYHHLFQE        KTPT           
NXMEUXKFPFGBH   : HHGWKLXYEUVTSX  IWIJXTNIQFDM    ITBVFME         CKQUNPVNSCM     WOLRFKJBKVTU    MSUFGWSOEFBUEW  TEERGPYRFVS    
RCPM            : NRXJPIY         JFOQIWTVDVMLQ   FMVKPGUO        XQFYSIDEH       UILQ            GICMLND        
QENIIXWTTWS     : GDJFAXANJOD     IWMFVWD        
KQFRNEETTKCWTSQ : NKEBWPWVPJRWK  
JFDCJQNS        : RKTKB           FEGOCPNFELBC    IVAUQMVHUPWWK   ABORFAOOKVYTXU  RVJNTTP        
KOIHHBTBJNON    : XTRU            VTXICTFVHIYI    DASPMSMFULQ     RALESRNVLR      AJHW           
KJFMGY          : THPYKRHHW      
AWRFATPSHKJ     : KEQUYYEAMIXPC   CMXTKHXO       
YTDJWXKGNYTIKD  : BXENTYIQRLAF    RTLJC           PVGACCG        
YMOHMNBTPXJIFV  : BOUEAFXLQTHQ    VKQXAWRDCISAPQG
CXPFH           : BXMCUCD         OVAP           
FRTTSQCFVUFKJOW : VNLNWSLNBPAOA   AUMUMNTHNL     
QTPOFBV         : TGDLAPSKOO      MAUS            DKPAMKPQYSW     DLPQTBEHKGM     NCPLQTKDB       YLNFTXNLFJI    
WAANGJBLBW      : TEFUPIAIDWFQ    NCRQO           CJWW            ALMB           
TNMAMHHWSXWS    : ERQC            FPAV           
QLFVMEXJE       : IXJPTCEPWAIDYN  BBQKNSLNWSNKD  
YKJAYMAI        : XMGXLNE         CMVK            LMBSRRRNFUB     XCVQFLTPYIA    
PUJCCSAXQWQ     : WYEO            HWBCOKUPKO      RALESRNVLR      SXRQJY         
NCPLQTKDB       : RUYJPFJUD       QTPOFBV         FXHOJ          
CNYFML          : CWJTFFSSIYLAVK  OJHSQYESKIRE    WGCEQKBXKDO     WTLTMIXFEVUT   
VUUS            : LEKPHEOIYHHMPQ  EAIMDHNLYNTX    INMGE           LPYA           
AXYAVSYODOTS    : KGJRUGRUDPVDITX QKGJI          
MPKPQASEYATK    : XXUMCHMHL       FPAV           
RGCMMCKOE       : PQPPATRKL       NRRSEHJX        IVAUQMVHUPWWK   LYYIOOBXLF      WEXENI         
JDAMRTFSI       : SWLVFRGXEVHLCT  LALCYR          PHILFPU        
FYNHTUGTQTBI    : TLRNKHODPUT     TTVPEA          FWCPXDOARDY    
FUOKIFOSOUSDOO  : GACUSOKSJXDMC  
JXIRYWYS        : YRLGCMKXMQ      TTWYVGMSO       SDMDKIUM       
IOKCRU          : EMFMRGDPQFFSQ   BYHHLFQE        RTDRBRENHMMA    HCMYSBHBSMQEE   TEERGPYRFVS    
WRUHABYTR       : XVLQMFIEMDMK    TNHOSGAOEGVL    JKWIEU         
OVKEHW          : TTWYVGMSO       GQKVUEBX        YSNJMQIVXT     
POBOPVK         : EAIMDHNLYNTX    PJDHSFNQDMNC   
MUAEREDKC       : UDGYUEYSDUYYQG  AYQPM           NUSKHCMSRI      LDQGSNFFTN      LKNFDRPPR      
MFMIWIXUUCC     : CYQODFYM        PSMXKEUULRK     XDPQJBSLAEOK    IPDTEXJF       
GUGJLWFWU       : TXNEI           ASWVPEFPSEUP    GHMKCVDCIRYS   
TXAMED          : SASXEISYK       FNFYMTLMWOQTWV  IXNUBPTYPFUL   
GQLLDULNSGJW    : OUPVBIJMBXNRJ   TCXATVYEQ       WVVPCXHIGFU     TFJSQTH        
BDGKMRJTQGNLGN  : EIJJVOHIS      
LSWTKIIP        : MQNSKB          RWJJOY         
TEXC            : KRQUEFITVKLCL   YDQMIAJNL       CDXQMQTQ        LMXUUAFBRLUVLWQ
UNQA            : UGSANSULIIFNA   BEQPUVYI        ARNXCBAPYRY    
DMQMIJVXUCNSN   : GHVF            GTTAEYH         UTYEA           UTPMPXM        
RKRBSHGONHQDE   : QSAKE           MNJMMAJXADL    
WFFAT           : SEBG            AJRPIODFKDF     JNIRPMKCPI      KHCHBWO         WRAVKRWRFKY     KNMHBE         
PDIL            : XXUMCHMHL       AQLSWWADWYH     WDBBCU          BYHHLFQE        QQYIKVE        
DPRYGYQQST      : DKADTVY         IGLV           
CDXQMQTQ        : QHOVIPAGNAU     ECVLBODCFQPHANP TEXC            BGSGQCS         KOMUCIYAYKHRYOP
QXGTUGJ         : IOADBWQQCRFHJI  EWDKKIR        
OWDUMUTS        : WVVPCXHIGFU     TTWYVGMSO       YUBRRS          RTWOJHETET     
MJOJUTMUKYOGR   : WLQWFPOWYC      GYTFS           WHPWUHVAVEPLRC  BGSGQCS        
ASWVPEFPSEUP    : KMVII           DGFLRCVDQDD     GUGJLWFWU       XPNDVC         
SJMOYX          : JDJXHDEOP       OEVI           
IVAUQMVHUPWWK   : FQHPVMXLDUSL    JFDCJQNS        RGCMMCKOE       JFTDVOWRMH      LMYBAEWIDMFMK  
SAAAR           : OCYMSQ          TWRPFJAQ        ADQNDJPPDKOST   VYCMIDBMBEFPIN 
EPLXIVMYWKH     : HADCJUIKAHKDCK  INMGE           NQIIYTID        OJENTAUP       
IHCC            : KLVLYTGOSRCP    DXFWLQ         
AJRPIODFKDF     : QJLMNSI         XJLHHVVHPH      WFFAT           WTWTXXAPSOWC   
XBPPNPALEYIQ    : QELCJ           AQLSWWADWYH     LHVYUJB         UJCQVP          BHTAIUAVEAUM    OKDQHWSDHKCBPOC
PAQRCPRNJ       : TEFUPIAIDWFQ    JQXORJLO        FWCPXDOARDY    
WXMCI           : EYYKAFMHAYPIT   JNKKLFUIIJYNI   URTTRMRHX       NWGWYYHWTRRRA   BOJU           
HVQJNGYD        : KGCBWHVSM       KDGWCLUGGN      DDKWXAHAYALYV  
KHHUXQKAKE      : OVAXXUGVTFG     VNMKKXXMAOV     KUDMODXUX       YPLAOHNQS       YCRYYU         
AVQL            : GUOYINFQHPMUB   MDJUDJILJUADROY GUOI           
NLSRWLY         : TYSDR           XCVQFLTPYIA     KVGF            YCRYYU          HJJCPVMLOC     
EKGK            : HPUXJEFDCMPDJ   ADGSOSPQFILS    YUJALJ          MYPO            XINWKQBSYJX     SBLWEKPVNJBUSKJ
LSXU            : GMTUQWJ         BOQF            JQXORJLO       
SSTF            : DBHS            VMXCREEVN       TEQEWILHAGE     VBKKJSPTQSLVECF LMYBAEWIDMFMK   GHMKCVDCIRYS    XAEDUNHMTIAWH  
GJXI            : JKYVIMCJ        OXUNPQE         FMVKPGUO        TJRLRYUOSTD     BVPPUYRLGJQYHY 
QTNGFI          : SLTICNLGWXOK    IDLPQFRJK       XBNOKWRWIX     
CTXWXK          : WADJQFBTO       UKQA            VDJIXAYJNQLYEFK WEXENI          GGFVBHIBJBQVQDD
KWOFUJHQF       : SWOQVHTAQEWOG   MNJIWG          TGIJDANMMJMJDQP URLIACGTXR      CINPB           QSGSVYJBIY     
XBLIB           : CCKGTPKFADJWE   TSMFJVHEC      
PSPFYV          : VYOEJMKIT       NKIQCU          PWESTUPPLUMM   
XAHXXHKDT       : RDSWGGBV        OFEXRGUSCI      GKBGB          
UYHGJXLOVOB     : PQPPATRKL       BLAINXAN        EDCBLEFXQTAGWRL XINWKQBSYJX    
QUWLNEKJSK      : BQVTXYSJ        HWBCOKUPKO      WEGSY           BGKGQTVN        LXVAQYAD        VTLVNRCJQ      
CKLMVPGF        : XAFWFTVCDSTJTY  ALMB            DCREWQLAMGEML  
IMQTMFILVJRMHQA : HLPGMCMAE       KIKLKQNFKOGAELL VUEL           
VNGOXTSLGFHVO   : WEGSY           DALCBYX         APKUEAHNSRRFI   DXFWLQ         
IWEBQSGBEFNYRU  : UFLDHPHNLDJT    XTGTT           LTGNFYDGOJLMX   EVVBEDQHHDJLE  
URLIACGTXR      : LRXEOINNLKDF    DEMSIXBDEXKNYKY RRVLLFQU        KWOFUJHQF       RGCCSLXL        EPIXLRLFLBNB   
DBXRSGQYIJTQLYV : XVLQMFIEMDMK    SKIGTTHRICF     ORFHBTXC       
XQVPLPETPGCJEW  : VXMNLVEDCXAWPW  NTKKTYKB        BNXJPVYWQMYYA   MYPO            MNCOBODU       
KAKEURXVCHQ     : XWTMIVWSKABYBY  WGCEQKBXKDO     CDBWQBUEIY     
URTTRMRHX       : AYMTU           WXMCI          
LTYUXJBUXLX     : JLIISGDJYD      NJBG            UMEJGHBHOUCMYCQ
SSCQ            : GORNNEYL        JVDENL          SESTNYG         IXLJTYTAY      
EAGCVXVR        : OWMCMHGQR       WPSYQSWTYYIL    TOPDJBYFOWRHTA 
IKYITNETICFJ    : KMVII           CWPXGFSBBBIV    WSTCDOIQHLFUNGA YUJALJ          SIVSL          
DXVLSQQJ        : GXMMRWQGXJIFKD  UPJYXQL        
WJOYFM          : QUYI            LKAGWCMGKXHRYHS WQHBMUGF        NWGWYYHWTRRRA   PGBRXV         
AGHKG           : XPUMIDLDYOYNC   AYMTU           LKAGWCMGKXHRYHS LBIIWSNFIENU    XLQXT          
GTTAEYH         : TMXOAYRTA       WEGSY           FEGOCPNFELBC    DMQMIJVXUCNSN   DPIPLFBDPFYE    XUWYKOYNL       QHWSJ          
WKPUYILPTUOGJO  : FHGVHMRALK      ILVUYRGBNOPIHTY AKDY            ERNIUSKIWRHOLJU DDKWXAHAYALYV  
YLNFTXNLFJI     : TLAIBCIVM       QTPOFBV        
NHPGGCVD        : MIIRCNOKLDCIC   INFA           
HQUBLKHXBVWMJ   : MDMNRUO         YHSSSMSGDIR     GQTORTVXKBHPJI  KCYACEYNKLU    
IKSWRCFYSOQYUV  : JSBWROXRCGNUAX  CUXHWWEMQGMGO   LKAGWCMGKXHRYHS SLXRYLDFKEJAUKK IAPUAMP        
XYEQWGDHNBI     : ABBFLAFHHN      CVNSGOKLXUCDX   WJJNNFAAGJWJ   
AWVE            : FCIXLF          YFMOQHGXJRHBYLE PNLHV           GHPSPAOIUNU     ULMYXEBMPRFQM   EQWTKCKWHN     
GWHACOBU        : YNKFBME         NFGTRKIJJEBWXFK OVVXX           KRQUEFITVKLCL   ARNXCBAPYRY     GEEHLQFWMXMMQCD
STAQQAPVQO      : OVVXX           VSBELSPDGDVS   
VVRWG           : RBEJYWTWRKV     IDYXVW          NOUNGVXYXOFB    SJFTPMKYAYY     HMJDKKPBFMT    
WGCEQKBXKDO     : CNYFML          KAKEURXVCHQ     IXLJTYTAY      
XTGTT           : YDPVULXCW       IPGYBXHMK       VKWHDJIP        YHCSDGTOGJO     IWEBQSGBEFNYRU 
NVPJ            : OIYQXCUFSNMVBE  VUEL           
ENLDH           : LAFEQFSYEKNOO   XMGXLNE         UIEQVBO         RMOHAQHO        JVDENL          BOJU           
JNIRPMKCPI      : ITBVFME         WFFAT           CVNSGOKLXUCDX  
VYBVSHQOHEKWPAB : VONA            WSFRUY          GXNBGHPOKBTHA   PCLLSKBTVK     
LEMVQ           : FTXWQJWTSEQ     JKPLOUP        
GKSUVVLGIJGLFBV : GTYNYQID        UXTYUJECAIVO    OVAP           
QDCDARDBWQIKP   : MVVJFMEMRWTQLQ  ELMYDFCMGER     GHMKCVDCIRYS   
NXLGTHCHONQWYV  : NOMJWW          DFPPXACELCAYGB 
UUOXWSARXEOR    : XYRDCHIVUCMY    YTVJD           BFWD            WNXVSYPXBQN     TWQJJHWQTXYU    UEHUO           TOPDJBYFOWRHTA 
BJNOHBXBJAKANBW : TYSDR           LQUFOJYNHLXXL   CKIUTNOWV       XRFBWU          YPCEMIEVNXX    
AUMUMNTHNL      : XPUMIDLDYOYNC   DQANOSCDVYADK   NYRDSDJOPVSIWR  FRTTSQCFVUFKJOW
RDYGEIVVQXT     : WOLRFKJBKVTU    SESPTUGEPYTEJY  HBKA            TCGEF          
JVFJKIICIFOFRE  : RTDAVSALAYWPDF  WUTCMSWWUMU     KIWV            PXAWDBWJFA      WUEBGOKQBAC    
YSNJMQIVXT      : VRCHLNYBXH      LNGBOEVTNY      EHLVWUQED       OVKEHW          XIVUFUI        
TKRPGB          : CGQDQMCKH       XRRHHVQ         GDEMLR          EINXYLHBBXHA    GGFVBHIBJBQVQDD
LMXUUAFBRLUVLWQ : NXTJGX          QULJNVVPEQKYT   TEXC           
GGSOCQIVMUOCCRN : ORVVL           OUPVBIJMBXNRJ   JPUXN           YSJNCGHK        WWUMEEGTNLO     ELMYDFCMGER    
FOMCOSDIE       : HRVAS           GXWDKYQADHPPPPF
HRVAS           : YKORTOVYQ       ICMYBDD         FOMCOSDIE       JJAMXQIUP      
GNSK            : WUTCMSWWUMU     OFEXRGUSCI      ADUORMWDEJMNLJR BICDSE          WSBDHYLSGY      GXWSPBFLMEEJXQ 
EJSBAWFRLVY     : OOHYCLLQVXWDBXV PPLXR           YDRBAFEXSGYMX  
ICQDHCHGJBEJW   : YNKFBME         VFWYUDDF        HRKIVFGRFCO     NEDGUNXBUAR     GHMKCVDCIRYS   
SKEFRKQML       : AGSAOXWP        HBKA           
KRLXPKA         : WLQWFPOWYC      VTXICTFVHIYI    VYTBPO         
OSEWULFGPK      : GVLXKAVSWLDYAI  JHSNVVLEINDVHNQ KDGWCLUGGN      OEGVRTYBNSQGEA 
MULYB           : NRXJPIY         IEUD            SLTICNLGWXOK    HIKTQJHTWOA     ERNIUSKIWRHOLJU
SLKGXB          : MNGCFALTWNKRLWB VJHXQ           JCTLGJT        
RMOHAQHO        : TVMNTFRBKFRK    BOOF            ENLDH          
LLFATLP         : SPGBLHPECDO     QIYIWEHFP       REKOUVINSKE     GYCNBPDAHYRDXN 
EEBRFDLYO       : JPUXN          
HOBXGQON        : TVMNTFRBKFRK    BYHHLFQE        VDJIXAYJNQLYEFK
FXHOJ           : BMDUWRXHQGJE    NCPLQTKDB      
VJPIBVOHYHPCU   : EPHVBKEMPQYQQC  EJKBVFIAWUCA    RYNPNLQSRU      BBQKNSLNWSNKD  
TUVIVVROMFH     : SBUYUKLDKWICS   FKGLAUDUJOMGVQD
DPIPLFBDPFYE    : KRAUU           VRCHLNYBXH      NKIQCU          HAJVATCD        XMRPYRR         GTTAEYH         SQPYHYWKTPQJ    TTLVNEJ        
XNCDKSYF        : BTOSOYRSA       UQEIOIK        
HCMYSBHBSMQEE   : HOEHPCJIEWGQBG  VXMNLVEDCXAWPW  KRQUEFITVKLCL   CHWAV           IOKCRU          STBCLYMWFJSMBKD
JGJBL           : JQNCXNVSDMTXWUS GWKVWE          IDLPQFRJK      
FAIVF           : MDTEVJEMSAAP    LGGLXUQ         AIHEBBAKH      
GXMMRWQGXJIFKD  : OELUIIDOCBQQ    VYSASK          LTNKBKLUYRNLI   DXVLSQQJ        RYNPNLQSRU     
DHYJQFS         : RDSWGGBV        THYSP           MHRSNHUJN       WYDJMGFTO       UPJYXQL         WUTCRDFX       
SDCVO           : BXENTYIQRLAF    MTRJCJB         LYYIOOBXLF      SBLWEKPVNJBUSKJ
BCEBRSSOLC      : GHVF            WUTCRDFX       
XKUINPOVQAOYT   : VFMT            WDWIGTXIW       KSMBONCXTILRI  
RYNPNLQSRU      : ABMKBST         LKAGWCMGKXHRYHS VJPIBVOHYHPCU   GXMMRWQGXJIFKD  IGLV           
NPBYRNWEKISCYQ  : VOPNXYJYDUQDKBQ IXJPTCEPWAIDYN  LXVAQYAD        UIEWYKXEJN      SPFW           
YHSSSMSGDIR     : ULMYXEBMPRFQM   HQUBLKHXBVWMJ   TFJSQTH         JPMRCXQWAUU     QHWSJ          
BMQLAHOB        : NLADLARSKEM     COFYMHR        
DYGPJBS         : UBPNBFLH        HOGGKQGGSHYRPAK NOUNGVXYXOFB    TOHBJD          TOPDJBYFOWRHTA 
TOHBJD          : WDTOCHE         XCECMMVEWBHB    XCOFGJBEV       DYGPJBS         OAKGMPTN       
XVDBGX          : GGUKOCQEVIL     UMEJGHBHOUCMYCQ
IKSVMALNEQO     : BAKIUQGDVW      SEOTI           NUSKHCMSRI      GTYNYQID        NYNXUMYJNUANBB  PBPLNAJVHKGP   
GXNBGHPOKBTHA   : LAQTW           AYMTU           MJHUKTCWQTLBV   YUPBXJRAEYIO    VYBVSHQOHEKWPAB
LBVL            : DGMEHYFREHAHNVU HUVQGLBEIGU     NTKKTYKB        QKVDOMAONHQC   
GXWDKYQADHPPPPF : CKQUNPVNSCM     FOMCOSDIE       YPCEMIEVNXX    
WOJNALHJ        : UQEIOIK         WWOWKAR         WULRNUOYWCBD   
YUOWGUEGRJQQ    : LFMEK           FIRETFSBKYP     FFSAEGNOPEJDFT  CAKJPX          ALMB            EINXYLHBBXHA    SXRQJY         
RWJJOY          : NUWIXDOLSE      LSWTKIIP        SOCDAMJ        
USXLF           : NESMRQS        
LSWVGVSU        : TMABSQUGEAIP    PCRJGURG        PQYSMVO         RSDV           
CRCIJN          : CMCPMQNNUED     MJTAJCWAWR      AKDY           
DNVCYFQ         : WTJOGDJD        NNEWF           CWIOHTJIBSIVICK UETEIYALYBFU    BFWD            HIKTQJHTWOA     ECWYGU         
GNVFABUNTS      : HOEHPCJIEWGQBG  JBSKQJSNNUY     XYRDCHIVUCMY    COFYMHR        
COFYMHR         : XBAQWFSVYVH     RURKKFGMLR      BMQLAHOB        GNVFABUNTS      VHLXKWWKWR      HBLEWDQ        
RBCTGR          : YIJBC           RTDRBRENHMMA    FJEBW          
IQWCTEPPLRQG    : CGQDQMCKH       LXOGUWOLTR      VODVBMA        
MYROQWNDG       : VFTNICNEPQM     GKBGB           JPHOJWSHTU     
SYJWURPLBIIDC   : MNMRPRKRPKAPOSN
UTAPMJVYI       : XVLQMFIEMDMK    FDWKNXBETHKI    QKVDOMAONHQC    FJEBW          
PBPGFX          : DKVFQIFIDPOQ    HLGPGSMPLIPIEM 
AYWWUPO         : XKBLKJKU        PQPPATRKL       PFLPHKAU        TTLVNEJ        
SASXEISYK       : PTSTFIDLYNKIUW  NLADLARSKEM     HUVQGLBEIGU     XYHTFVPG        TXAMED          BLHILVESGJ     
LTGNFYDGOJLMX   : RXTUWFL         HUFYQJFJIGRL    IWEBQSGBEFNYRU 
OWLJOCRHCKFHU   : UOAEAWVL        UDBWBPC         HCBQWCBFOWGJH   SOCDAMJ        
IGLV            : LFMEK           PJMKM           DPRYGYQQST      RYNPNLQSRU      VUEL           
SJFTPMKYAYY     : NTKKTYKB        VVRWG          
NYAWNEQ         : RFGAELYY        EAMCP           UKQA            WQHBMUGF       
HCBQWCBFOWGJH   : MUBWYSNCNCELUR  OWLJOCRHCKFHU   IXLJTYTAY      
FWCPXDOARDY     : IUNUU           OVAYQSMQKDMXAL  FYNHTUGTQTBI    PAQRCPRNJ      
CMXTKHXO        : MSWNOQIGENBFRFW CVHAO           AWRFATPSHKJ    
WSBDHYLSGY      : BDEHTAGCF       LKAGWCMGKXHRYHS GNSK           
FENFJFFB        : SWOQVHTAQEWOG   YNKL            PLTRELNTDJ      ICMYBDD         SQDMHNEUTVB     MCLMEIHUTAETGQ 
GWKVWE          : TWLWORQEY       JGJBL          
FCUFCOHF        : KIWV            BLHILVESGJ      VODVBMA        
GQTORTVXKBHPJI  : TYXDBADN        SVKX            HQUBLKHXBVWMJ  
PHILFPU         : DALCBYX         JDAMRTFSI      
TRPVIY          : MIIRCNOKLDCIC   IBXCG           HAJVATCD        KSFJCTBVDUNH    APIGESEBHM      VDJIXAYJNQLYEFK LCYTRPCXKFDBX  
JFTDVOWRMH      : TLAIBCIVM       HBKA            IVAUQMVHUPWWK  
UWFFW           : XJLHHVVHPH      BFWD            UEHUO          
NIJSX           : MJHUKTCWQTLBV  
FTXWQJWTSEQ     : PTSTFIDLYNKIUW  OQFVLVHUJWUE    OKQQGJJJL       MVXDTFJIWY      LEMVQ          
DFUU            : DVSRLULP        OQBNNDISVNWE    PIKATUACBLYAE   MDNDL          
FQOCXUCVKKFFI   : IWLGXIQJLDIWHBL FDRGOLYREGAWISU
MCNJUW          : UOFIFKU         VUISPJP        
PPPGLS          : AYMTU           WKCND           TNKVPFNBKE     
JPHOJWSHTU      : MYROQWNDG       LTFSGN          JCTLGJT        
EFKJNXVSMHNJQ   : YPDTFXDHQBWFU  
CINPB           : QUIYHHFKEIHOQBP KWOFUJHQF       SESTNYG        
YSJNCGHK        : DKMKMTAKQDHLDRN FGHJU           YRXJTLBWQKBIBH  GGSOCQIVMUOCCRN
CPGIBRXBNSPWJC  : WLQWFPOWYC      RLHWNBLFGUIC    AIYKIOF         LTSQADTRNBUJTL  GICMLND         DXFWLQ         
OEXDTBG         : AAPGXMUOJSTJ    VKTBVJWJUAENMQ 
UPJYXQL         : DXVLSQQJ        DHYJQFS         LCYTRPCXKFDBX   VHLXKWWKWR      KVNRONLSL      
TCGEF           : RXVQJTHQQFHCBYP RDYGEIVVQXT    
EINXYLHBBXHA    : TKRPGB          YUOWGUEGRJQQ    QUUPTGHIJHVPB   ELMYDFCMGER    
DDKWXAHAYALYV   : YNXJCMAJYW      CFQOBDFKXTF     YGCU            BICDSE          HVQJNGYD        WKPUYILPTUOGJO  NJBG           
IAUGFEUFFGM     : AMIWRMKDANPYBIU WDTOCHE         GTYNYQID       
JKPLOUP         : ORVVL           XPUMIDLDYOYNC   JDJXHDEOP       LEMVQ           UXKRUTPY       
SPBCPAEE        : ACJJLMVJ        WQHBMUGF       
BTKDRS          : HBRQSOQIHHWQY  
XPNDVC          : YDPVULXCW       NQIIYTID        YYWXBGDECUTYV   ASWVPEFPSEUP    QGJDQB          DJKQCCTPXLWU    TTKJPJC        
IPDTEXJF        : SWLVFRGXEVHLCT  LALCYR          IUGNVJF         MFMIWIXUUCC    
AGWRJCVNFQ      : SDQBBRVMSNAHEB  WDWIGTXIW      
IISRGJHLH       : CXARRMCKUDLV    WTLTMIXFEVUT   
YPCEMIEVNXX     : ECVLBODCFQPHANP BJNOHBXBJAKANBW GXWDKYQADHPPPPF WQHBMUGF       
WQHBMUGF        : UFSDLIMACG      BELR            HBRQSOQIHHWQY   KSFTI           WJOYFM          NYAWNEQ         SPBCPAEE        YPCEMIEVNXX    
PNSJVESHLFIEJMQ : HUFYQJFJIGRL    LMBQWAVWTNUN    TKXLAD          XLQXT          
ROHRNGQENS      : XBAQWFSVYVH     BILMJLTVTV      LQUFOJYNHLXXL   OVAP            PCLLSKBTVK     
LYYIOOBXLF      : TAHFWMDLMIPDPJ  VLJPNKBC        SLTICNLGWXOK    YVKKOA          RGCMMCKOE       SDCVO          
UTYEA           : UWLNEEGJUJL     WAHPLQ          XXARIKPPQJVU    PKEHLGWE        XANMTKFDUPCN    DMQMIJVXUCNSN  
SQDMHNEUTVB     : MQYQEO          NABRFRGWVCU     FENFJFFB        EVVBEDQHHDJLE  
QUUPTGHIJHVPB   : FJLWJGDKA       ADUORMWDEJMNLJR SBUYUKLDKWICS   EINXYLHBBXHA    TWRPFJAQ        MWLTNYAW        YVOG           
LDALOSERG       : GURJHDCFDJ      AJHW            HJJCPVMLOC     
HMJDKKPBFMT     : LDDQXGEGUEJD    PSMXKEUULRK     VVRWG          
SDMDKIUM        : THYSP           OEGVRTYBNSQGEA  JXIRYWYS        EVVBEDQHHDJLE  
IRETGXAXGLIUWL  : MIIRCNOKLDCIC   QIYIWEHFP       DSXONT          MCADEHCRIFDTSQR CJEIT          
IDLPQFRJK       : JSBWROXRCGNUAX  IUMMX           EGMAYSELMUH     DWLKDFYL        QTNGFI          JGJBL          
OVOLKVTCAP      : NMGCJENIAIKOD   EBANXSSHF      
APIGESEBHM      : FQHPVMXLDUSL    JIRDCLHUGDPUVS  XCECMMVEWBHB    ODHBDHXPJIC     BJPMVGDGAK      BXQGRWGV        LFKU            JDJXHDEOP      
APIGESEBHM      : YYWXBGDECUTYV   TRPVIY         
KXABGTNQAEOQQY  : WUPXBEADF       GSMIVBQOJETG    JSTOHIRRNLBO    QJKQSWG         WYTSKRSHFUHW    WJJNNFAAGJWJ    PGBRXV         
MDNDL           : GDEMLR          TNHOSGAOEGVL    VIPRGITGR       EQUAKIYXICPWJ   UTYTQI          DJKUQ           DFUU            PGBRXV         
SWWWPDYWPIIPKLV : YTKHGEDADMTRL   YUPBXJRAEYIO    YPDTFXDHQBWFU   HMGIJYLGEU     
YPGEEXWE        : WBEOCCBYLQWGA   HVYSKARLO       IPEH            YHCSDGTOGJO    
JJAMXQIUP       : PCRJGURG        YNKL            HRVAS           XLQXT          
MSGKKRUACIYJKOP : VKSTCYJAOYGSB   OVAP           
SPNYDYJFM       : KKJUAHJ         AQLSWWADWYH     ARNXCBAPYRY     GJYBJLUUIDIHN   GJFAIPX         XKFWVIDIMOIKYSW
VUEL            : WDLPGDCNDN      LKWOOVMOKDDSTSK FOTMWYNV        IMQTMFILVJRMHQA NVPJ            IGLV           
QGJDQB          : NYRDSDJOPVSIWR  NRRSEHJX        XPNDVC          MWLTNYAW       
TFJSQTH         : GQLLDULNSGJW    YHSSSMSGDIR     KOLH           
KCYACEYNKLU     : RJUNJUIDK       UECQGYDW        HQUBLKHXBVWMJ  
IBUNRDYVUCVOJH  : AFMU            GABQDTLFWHXNKAJ XQFYSIDEH       PPLXR           VOBDNR          NEDGUNXBUAR    
BBQKNSLNWSNKD   : JCKWQSVICGYQKWG NNEWF           QLFVMEXJE       VJPIBVOHYHPCU   DBMFPDEJD      
HLMIIABMBYH     : NHAPF           UWLNEEGJUJL     GUOI           
WXMFH           : OOHYCLLQVXWDBXV HLGPGSMPLIPIEM  FIJAOHRUMPWDRJR PCLLSKBTVK      OEVI           
GACUSOKSJXDMC   : DMAYNKEYDY      BRFCBONGFTP     YEMEXDGKJMCMMOR FUOKIFOSOUSDOO  CDBWQBUEIY     
XOVHQYVRADWXDJ  : EMFMRGDPQFFSQ   WWEOAQG         SDQBBRVMSNAHEB 
MCLMEIHUTAETGQ  : OFYQTVMG        EMMIKDFDBSRKXH  FENFJFFB       
VRKRBBT         : YNYQUAQK        VTXICTFVHIYI    BTMRKHHSDFSDTA 
UTCRRFEWTGJ     : NOMJWW          TLWS           
KRPGLSMGBEEW    : OHDAM           ECFLQRQTVYSBJB  OOUGLTDCID     
PQYSMVO         : CYQODFYM        AYQPM           WNFTUNLY        BOQF            FFNS            XPXKNSITCHYL    LSWVGVSU       
AIBHOBBUKJIE    : WFUBTNGQKPP    
QSVDYWJDVHUPIOC : QBYDMWUJV       VKVXEFFAYNGSYNV PMLYKCJSVWU     JIAECI          PVGACCG         CWETEFSYYGJ     RXVQJTHQQFHCBYP
FLGPPN          : WYDJMGFTO       TWRPFJAQ       
SOCDAMJ         : OFYQTVMG        LKAGWCMGKXHRYHS PCONXRSPOFMP    RWJJOY          OWLJOCRHCKFHU  
DCXJDX          : EQTWWLRRHY      GYTFS           XANJ            ALMB            WHBT           
JVDENL          : HOPMQVQCF       QDMPXQTDEKU     SSCQ            ENLDH          
QSCEYSVPAOE     : UQYBP          
TFREJUGJGKJAT   : UHNRHDSEWOWL    BMAIPNJDBWD     OKDQHWSDHKCBPOC
FATS            : OVAXXUGVTFG     UETEIYALYBFU    SVKX            BLHILVESGJ     
MLXTNSPDUH      : MDJUDJILJUADROY YDQMIAJNL      
ABORFAOOKVYTXU  : FJLWJGDKA       PUSTFGTB        BXQGRWGV        KRQUEFITVKLCL   JFDCJQNS       
FUWXQLMRF       : VLJPNKBC        ABJYBFWOSH      KDCY            XALHAWHD       
MVFKDOKGGE      : DVSRLULP        UTYTQI          JQXORJLO        SHSMYRSIRX      HBLEWDQ        
IUDSSENSYRXVOY  : QKWMS           XANMTKFDUPCN    LKNFDRPPR       NHDUKCJKNSW     NBJDT          
BLHILVESGJ      : IBXCG           PSMXKEUULRK     CHWAV           SASXEISYK       FCUFCOHF        FATS            KDCY            LODGCYQRKFEHI  
SQPYHYWKTPQJ    : MTRJCJB         TQGLFGXYCK      SODDSPPRU       MPUAJOEWCBALECD DJSOWJVHGCWV    KBBJQP          DPIPLFBDPFYE    FOFIAI         
PCLLSKBTVK      : HFRU            SBUYUKLDKWICS   POSP            VYBVSHQOHEKWPAB ROHRNGQENS      WXMFH          
HJJCPVMLOC      : VYOEJMKIT       NKIQCU          OEGVRTYBNSQGEA  NLSRWLY         LDALOSERG      
VDJIXAYJNQLYEFK : WTJOGDJD        AHTUGKJWUQBITJ  CTXWXK          HOBXGQON        TRPVIY         
BGSGQCS         : KVLRWQGAYV      HRKIVFGRFCO     CDXQMQTQ        MJOJUTMUKYOGR  
UOFIFKU         : FDWKNXBETHKI    JMJHGBXQPLEMDPV XDPQJBSLAEOK    MCNJUW          DURRVCKAU      
PFLPHKAU        : AYWWUPO        
LTFSGN          : HADCJUIKAHKDCK  YDQMIAJNL       AHWAVQWOC       STIQDWM         JPHOJWSHTU     
NJBG            : NAGTQVSBPX      LRANIMDRNMRTLF  HVYSKARLO       BILMJLTVTV      EGAATQ          WMHNFE          LTYUXJBUXLX     DDKWXAHAYALYV  
VBKKJSPTQSLVECF : GXUMNVUFAGYE    OWMCMHGQR       IUMMX           NHAKYBC         OCYMSQ          HOIBYXSFMX      SSTF           
ECTRXALFPGUBJ   : MVFYCTSIYJ      BELR            DWLKDFYL       
RGCCSLXL        : VNMKKXXMAOV     IPGYBXHMK       URLIACGTXR      NFHXAXYYIPOGF   KHCHBWO         ENOAWYFFLLNWMCE
OGVM            : GUOYINFQHPMUB   TNHOSGAOEGVL    ASOEIC          BMFVO           VXHXRUHEO      
ATEEVYV         : ETNRAYCNGQG     PRNBSNDGWR      RTBQUT          GGUKOCQEVIL    
BHYSPVWCWOIC    : TJGDFRNHYAM     EIJJVOHIS       AFMU            OOHYCLLQVXWDBXV UQYBP          
DPQQAF          : OPBJLMIYO       TJGDFRNHYAM     USIXEJNDHLAQA  
VTLVNRCJQ       : NRXJPIY         RDSWGGBV        PJXW            GDJFAXANJOD     QQYIKVE         QUWLNEKJSK     
GTIHPA          : CCJOH           LJUI            EPHVBKEMPQYQQC  DYAX            EGMAYSELMUH     RLHWNBLFGUIC   
MCBBMFR         : VNMKKXXMAOV     QTFCUH         
VJHXQ           : UWLNEEGJUJL     XANMTKFDUPCN    SLKGXB          UXKRUTPY       
TNSRDLV         : KGCBWHVSM       MJIENHMTSUAALE  RXAEDLQBCN     
EVVBEDQHHDJLE   : IWEBQSGBEFNYRU  SQDMHNEUTVB     SDMDKIUM       
SXRQJY          : QUYI            TQBRQWEYNM      SDQBBRVMSNAHEB  TNUOBQKSQNOKDPF PUJCCSAXQWQ     YUOWGUEGRJQQ   
DJKQCCTPXLWU    : JIPXOVHMFPIVSG  YKORTOVYQ       IUGNVJF         XPNDVC          WKKJGYXDNQYK   
XBNOKWRWIX      : ENHGNGLJL       LJUI            WAHPLQ          QTNGFI          EWDKKIR        
CVNSGOKLXUCDX   : EABMTKISR       ABBFLAFHHN      QOJOP           XYEQWGDHNBI     JNIRPMKCPI     
UXKRUTPY        : OIYQXCUFSNMVBE  JKPLOUP         VJHXQ          
GJFAIPX         : SPNYDYJFM       VSBELSPDGDVS   
TWRPFJAQ        : OIYQXCUFSNMVBE  YCRYYU          SAAAR           QUUPTGHIJHVPB   FLGPPN         
UUKUUGVH        : THYSP           TXNEI           MNJMMAJXADL    
SESTNYG         : LAFEQFSYEKNOO   JHSNVVLEINDVHNQ SSCQ            CINPB           ENOAWYFFLLNWMCE
COLCTH          : SLXRYLDFKEJAUKK KHPVKLGTTFPRQ  
NWGWYYHWTRRRA   : NRXJPIY         WXMCI           WJOYFM          XAEDUNHMTIAWH  
YDLDVFR         : DBHS            MHRSNHUJN      
LMYBAEWIDMFMK   : RYUORIETX       MNJIWG          IVAUQMVHUPWWK   SSTF           
LRCGLVAOOYR     : HPUXJEFDCMPDJ   QQPKKJB         YEMEXDGKJMCMMOR LYHCNFRD        RLHNBUOOG      
FNFYMTLMWOQTWV  : XXUMCHMHL       TXAMED         
EISJWM          : EAIMDHNLYNTX    QHOVIPAGNAU     UKQA           
DBMFPDEJD       : AOQAYF          BBQKNSLNWSNKD   PXAWDBWJFA     
WKKJGYXDNQYK    : AFMU            DJKQCCTPXLWU   
IOADBWQQCRFHJI  : AFMU            FJQF            QXGTUGJ         RVJNTTP        
SLXRYLDFKEJAUKK : OPBJLMIYO       YFDRGUIMW       STQEXFN         UIEWYKXEJN      IKSWRCFYSOQYUV  COLCTH         
SBLWEKPVNJBUSKJ : VLJPNKBC        CWPXGFSBBBIV    EKGK            SDCVO          
XKFWVIDIMOIKYSW : OKQQGJJJL       AGSAOXWP        UCOIHYYNYEC     NSPIJDTO        SPNYDYJFM      
VKTBVJWJUAENMQ  : PORQV           OEXDTBG        
LBIIWSNFIENU    : BDEHTAGCF       PJDHSFNQDMNC    BFWD            AGHKG          
IRBEFUHBGGMB    : BXENTYIQRLAF    IEUD            HAJVATCD        GEVXRNVYNQPUAU  INVASYXLFK      TSMFJVHEC       GGUKOCQEVIL    
SQTJTHKES       : PNLHV           PJDHSFNQDMNC   
WGOHNECT        : BJPMVGDGAK      INFA            WMHNFE         
WUTCRDFX        : JKYVIMCJ        VOFSNAILBXCSSC  EGMAYSELMUH     YDQMIAJNL       DHYJQFS         BCEBRSSOLC     
RBRMRNWLVJPO    : JWQVMGAJ        LXESFQWRAAK     DLPQTBEHKGM     KSMBONCXTILRI   XKKEG          
OWKWKPB         : EQFXSUOOYSKXU   JQNCXNVSDMTXWUS MDTEVJEMSAAP   
EXDA            : NMXIDUT         YUPIEPBKINSG   
UEHUO           : AYPFMCJNBYMWRV  UUOXWSARXEOR    UWFFW           FOFIAI         
VIOPXNDV        : VLJPNKBC        NRLFUJ         
UMSKKEJWVKEALH  : ERQC            DKPAMKPQYSW     HSFAWNTGPX     
NFHXAXYYIPOGF   : WYKO            DGFLRCVDQDD     IWMFVWD         KRQUEFITVKLCL   LYHCNFRD        RGCCSLXL       
DFPPXACELCAYGB  : QEADSQ          DGJLMGBAXUYSQQ  NXLGTHCHONQWYV  DURRVCKAU      
PEAUNA          : XVLQMFIEMDMK    NUPDRLQJULKO    GWSOGVFIA       WUXQAPUST       WHQTXWVWFBHXA   VHSAREVYAHUCJB 
LCYTRPCXKFDBX   : LHVYUJB         TRPVIY          UPJYXQL        
BCINEIOK        : MCGIIJYFBX      UECQGYDW       
YDRBAFEXSGYMX   : BNCDANML        SDWSCMKVQUYT    EJSBAWFRLVY    
PXAWDBWJFA      : TQBRQWEYNM      BRFCBONGFTP     JVFJKIICIFOFRE  DBMFPDEJD      
UECJROKUINUORV  : JLUQULYBVRKCK  
XUWYKOYNL       : JBSKQJSNNUY     RTDRBRENHMMA    FPNPEDTPCJEG    GTTAEYH        
QJOVLGQPKCHYO   : CYQODFYM        DVSRLULP        FWVKTFCPMYBMI   WAYDH          
KDCY            : UTRQIMNNWQL     UELYY           FUWXQLMRF       BLHILVESGJ     
XIVUFUI         : POSP            WHQTXWVWFBHXA   YSNJMQIVXT     
VVIYMTPL        : OJHSQYESKIRE    YCRYYU          KHPVKLGTTFPRQ  
VEWHH           : BODOKINBEY      BYEU            OUHEWDDDF      
IXNUBPTYPFUL    : DTOPDG          UIEWYKXEJN      TXAMED          HMGIJYLGEU     
RVJNTTP         : LAPTIDS         MAUS            SKLPAL          HOFSTKPJNDTQP   JFDCJQNS        IOADBWQQCRFHJI 
NFTUEYTNIDX     : GDKQY           GUOYINFQHPMUB   IPGYBXHMK       UTYTQI         
TTKJPJC         : MQNSKB          LSMFWAEPNGGVTWO XPNDVC          VSBELSPDGDVS   
EPIXLRLFLBNB    : PIHXBFPWO       URLIACGTXR     
IXLJTYTAY       : DKMKMTAKQDHLDRN SESPTUGEPYTEJY  SSCQ            WGCEQKBXKDO     HCBQWCBFOWGJH   WJJNNFAAGJWJ   
TSMFJVHEC       : KTWGUVTC        JSUGXPDEXAOBMLK XBLIB           IRBEFUHBGGMB   
OAKGMPTN        : KQXV            SKGVEQ          BMFFJBGGR       TOHBJD          VXXWHNJBRKUOK  
WWOWKAR         : WOJNALHJ       
TTLVNEJ         : IWMFVWD         DPIPLFBDPFYE    AYWWUPO         DCREWQLAMGEML  
NHDUKCJKNSW     : MFSMIHQLHHA     IUDSSENSYRXVOY 
MNJMMAJXADL     : JFOQIWTVDVMLQ   IGBSGPLTVN      MCGIIJYFBX      RKRBSHGONHQDE   UUKUUGVH        SPFW           
WWUMEEGTNLO     : GGSOCQIVMUOCCRN TGMMTBRBFR     
NBJDT           : PJDHSFNQDMNC    CJEIT           IUDSSENSYRXVOY 
JIXUU           : NXTJGX          PJXW            IGBSGPLTVN      IWLGXIQJLDIWHBL
VHLXKWWKWR      : RTDRBRENHMMA    COFYMHR         UPJYXQL         YVOG           
DXFWLQ          : OXUNPQE         NFPNDTCYO       HSFAWNTGPX      GWSOGVFIA       IGCQPCIA        IHCC            VNGOXTSLGFHVO   CPGIBRXBNSPWJC 
KHPVKLGTTFPRQ   : UBPNBFLH        COLCTH          VVIYMTPL       
YENLDK          : FCIXLF          NYIPEJTEPCD     VKFPFUEHFW      GEEHLQFWMXMMQCD XULNBH          FFCDQAXAGWBSVGE QQIRFHYOAMRN   
ACTFCYF         : JCKWQSVICGYQKWG QSAKE           VHJA            FEGOCPNFELBC    ASOEIC         
STBCLYMWFJSMBKD : AYDCKNQ         HCMYSBHBSMQEE   ESJQXJMWIVUCQE 
LJEANPVPT       : NSPIJDTO       
VYTBPO          : YUJALJ          NOUNGVXYXOFB    KRLXPKA        
QQIRFHYOAMRN    : JSTOHIRRNLBO    AKNRLDF         YENLDK         
GYCNBPDAHYRDXN  : JNXHWKWKDVPYW   CEFPOUEHBRKMG   UHPLOW          TNUOBQKSQNOKDPF LLFATLP        
NEDGUNXBUAR     : NMXIDUT         ICQDHCHGJBEJW   IBUNRDYVUCVOJH 
MKLESMGGOXL     : LQUFOJYNHLXXL   WAYDH          
GLILL           : VIKBV           PSCBVQODCUC    
SADXIYMJCJ      : TVUKMNMSER      YIJBC           YTKHGEDADMTRL  
VHVISAC         : IFCKDSRPPKQAME 
JKUJ            : TVUKMNMSER      GHPSPAOIUNU     LSBRPFPQAXNIBE  RLHNBUOOG       JQXORJLO       
JPMRCXQWAUU     : NUXIXQMGOPC     POSP            YHSSSMSGDIR    
VHSAREVYAHUCJB  : PEAUNA         
VXXWHNJBRKUOK   : JIEAH           JKWIEU          WDBBCU          TJRLRYUOSTD     OAKGMPTN       
KVNRONLSL       : UPJYXQL         GGFVBHIBJBQVQDD
USIXEJNDHLAQA   : GXYXJ           CCKGTPKFADJWE   FNVM            QSCOQDUVJYSEXO  DPQQAF          MVYFWCWAFALMFA 
RTWOJHETET      : HGEKRDCPD       EMEM            CYHJXYHHUUKRLW  XRTJEMKVDPNTR   SWRW            VPIXPSQMJNCWD   OWDUMUTS       
UJCQVP          : XBPPNPALEYIQ    WULRNUOYWCBD   
QXLX            : SRMDRCDLCOKSJD  TYGXP           EGMAYSELMUH    
ADQNDJPPDKOST   : MVVJFMEMRWTQLQ  DGEISJPGFGMFTW  FAWCM           SAAAR          
YPDTFXDHQBWFU   : WBEOCCBYLQWGA   LMBSRRRNFUB     CQCEW           GDJFAXANJOD     OQBADAHA        EFKJNXVSMHNJQ   SWWWPDYWPIIPKLV
QSGSVYJBIY      : IJXGWHJKKLC     VYOEJMKIT       IXFDWBGPA       UQYBP           KWOFUJHQF      
MJIHFFGWKADLGKC : ITVBEXSTLCRCO   DRMJESBYA       UBKHXAFAULYOOI  BHTAIUAVEAUM   
KHCHBWO         : EQFXSUOOYSKXU   WFFAT           RGCCSLXL       
SPFW            : KQXV            OPVKQFT         LRANIMDRNMRTLF  NPBYRNWEKISCYQ  MNJMMAJXADL    
FQNQY           : PTSTFIDLYNKIUW  MAHFMRCAOAPGN   XULNBH          IPGYBXHMK       UHIRKYATXBKYFMK EJKBVFIAWUCA   
WHBT            : JAPYXHLQARA     CYHJXYHHUUKRLW  FKIWNAML        LSMFWAEPNGGVTWO MNCOBODU        DCXJDX         
EWDKKIR         : LLWKUOHVY       YITYYO          HAJVATCD        QXGTUGJ         XBNOKWRWIX     
PWESTUPPLUMM    : TJGDFRNHYAM     AALBAC          RLHWNBLFGUIC    PSPFYV         
DCREWQLAMGEML   : NRLFUJ          BYHHLFQE        BYEU            CKLMVPGF        TTLVNEJ        
WTLTMIXFEVUT    : OWMCMHGQR       PMLYKCJSVWU     LOXGKDUMEIWV    CNYFML          IISRGJHLH       NHYLJIE        
SIVSL           : ADGSOSPQFILS    YYWXBGDECUTYV   IKYITNETICFJ   
MSUFGWSOEFBUEW  : EMEM            CQCEW           BSVJLRSHSPE     NXMEUXKFPFGBH  
XLQXT           : JHSNVVLEINDVHNQ BGKGQTVN        AGHKG           PNSJVESHLFIEJMQ JJAMXQIUP      
TOPDJBYFOWRHTA  : EAGCVXVR        UUOXWSARXEOR    DYGPJBS        
RSDV            : MVLMMYHMXHRW    XKKEG           LSWVGVSU       
GQEGAER         : SWOQVHTAQEWOG   SDQBBRVMSNAHEB  SBRQWGYX        RJPVM          
ELMYDFCMGER     : ULMYXEBMPRFQM   QDCDARDBWQIKP   GGSOCQIVMUOCCRN EINXYLHBBXHA   
BMFVO           : VHJA            ECVLBODCFQPHANP JOPCJW          UILQ            OGVM           
NHYLJIE         : WTLTMIXFEVUT   
OEVI            : XANJ            SJMOYX          WXMFH          
AUKYAREOAIJXLX  : BVHQ            DGJLMGBAXUYSQQ 
HMYWVAIFK       : MVFYCTSIYJ      XYGNTGBEKEP     JPUXN           UIEQVBO         HCUPCFAHNLO    
WYTSKRSHFUHW    : XRRHHVQ         MNJIWG          EMMIKDFDBSRKXH  QOTIY           XRFBWU          KXABGTNQAEOQQY  TGMMTBRBFR     
XALHAWHD        : XMGXLNE         ARNXCBAPYRY     QIJBFUUSDTUHJI  JDJXHDEOP       UFLDHPHNLDJT    FUWXQLMRF       LBDAJIBXLIGCSTV
TEERGPYRFVS     : XTRU            ANSX            BFWD            ECWYGU          NXMEUXKFPFGBH   IOKCRU         
ODTK            : NKEBWPWVPJRWK   IINPXUTEHFPFBX  SFYAHULCM       DJKUQ          
BHTAIUAVEAUM    : STQEXFN         XCOFGJBEV       XBPPNPALEYIQ    MJIHFFGWKADLGKC
CILJBUBAO       : PSIWPTVKYOM     FMDIOIHYANGF    EAXRYEPJSIIVCDF PYWAHUCMAEXC    MUBWYSNCNCELUR  TLAIBCIVM       NRMLISWSJK     
WJJNNFAAGJWJ    : NKEBWPWVPJRWK   ARPVTW          XYEQWGDHNBI     KXABGTNQAEOQQY  IXLJTYTAY      
RJPVM           : LNGWRT          DKVFQIFIDPOQ    RFSWLN          GQEGAER        
KTPT            : CIWOELDQK       LJVXV           IKPUSHUJAMBG   
YUDAWRK         : KLVLYTGOSRCP    KSFTI          
BUKQC           : AEQYC           IEUD            WHQTXWVWFBHXA  
TLWS            : TGIJDANMMJMJDQP RLHWNBLFGUIC    UTCRRFEWTGJ    
QKGJI           : QSAKE           VHJA            AXYAVSYODOTS   
UTPMPXM         : OHDAM           DMQMIJVXUCNSN  
BOJU            : SPGBLHPECDO     KDEQPCMWV       YRYMNDQRBQQSPPH WXMCI           ENLDH           FJEBW          
GXWSPBFLMEEJXQ  : QWQCAPJLNIUWDQ  YUJALJ          QCYDXOWQXLOG    GNSK           
HBLEWDQ         : CWETEFSYYGJ     COFYMHR         MVFKDOKGGE      KNMHBE         
BFYEUL          : HGEKRDCPD       SWOQVHTAQEWOG   KEQUYYEAMIXPC   DTOPDG         
WRAVKRWRFKY     : XXUMCHMHL       JQBKV           WFFAT           LUYEPGKLRHVHIT 
VYCMIDBMBEFPIN  : NUWIXDOLSE      CYGGJGFFPCMRTV  BNXJPVYWQMYYA   SAAAR          
OKDQHWSDHKCBPOC : SEBG            OIYQXCUFSNMVBE  WUXQAPUST       XBPPNPALEYIQ    TFREJUGJGKJAT  
LBDAJIBXLIGCSTV : YDPVULXCW       NLJJHRBONPWVLOI TYGXP           COYNWRFUYUSM    XXARIKPPQJVU    XALHAWHD       
EBANXSSHF       : FEGOCPNFELBC    UFLDHPHNLDJT    XINWKQBSYJX     OVOLKVTCAP     
KWKN            : EGSLLSOXOJ      XYGNTGBEKEP     XANMTKFDUPCN   
VODVBMA         : RBEJYWTWRKV     GKXJVSMYPPOR    IQWCTEPPLRQG    FCUFCOHF       
AIHEBBAKH       : IBXCG           XGGGNUWQKYR     FAIVF          
LUYEPGKLRHVHIT  : CJWW            WRAVKRWRFKY    
LPYA            : IDYXVW          VUUS            MWLTNYAW       
BBAKFDOIO       : TLRNKHODPUT     PDCLIQEWBRMBDH  NWAFAXMRVBW     HSFAWNTGPX      WNXVSYPXBQN     JKAUCCITC      
JCTLGJT         : HADCJUIKAHKDCK  SLKGXB          JPHOJWSHTU     
WNDSU           : YNKFBME         KGCBWHVSM       NOMJWW          NGFRJAFXU       LOXGKDUMEIWV    XMRPYRR        
MVYFWCWAFALMFA  : RTLJC           HLPGMCMAE       RIHPRUKFWPRHOF  EGHGFLDJR       USIXEJNDHLAQA  
VXHXRUHEO       : PVIKOLSWF       SMSNAR          TXNEI           OGVM           
BFFWCSLXUSVYS   : MDTEVJEMSAAP   
ESJQXJMWIVUCQE  : XDQWVWWWUHFR    STBCLYMWFJSMBKD
HHKMOJPKUPHO    : PQVCPKNHXJXEWM  PSCBVQODCUC    
GHMKCVDCIRYS    : HWBCOKUPKO      KSMBONCXTILRI   GUGJLWFWU       SSTF            QDCDARDBWQIKP   ICQDHCHGJBEJW  
WUEBGOKQBAC     : NESMRQS         LHIVSUWKDJSSAY  JVFJKIICIFOFRE 
MWLTNYAW        : XPUMIDLDYOYNC   AYUOJDQELGPGEG  QUUPTGHIJHVPB   QGJDQB          LPYA           
MYIRESKDL       : YNKFBME         BQPKLJ          AYMTU           ADGSOSPQFILS    LMBSRRRNFUB     PBPLNAJVHKGP   
CIFGO           : DBHS            BSVJLRSHSPE    
QHWSJ           : GTTAEYH         YHSSSMSGDIR    
FJEBW           : VBFQJDS         OFEXRGUSCI      YVKKOA          IPWVIESX        FOTMWYNV        RBCTGR          UTAPMJVYI       BOJU           
DURRVCKAU       : QDKLYFFLF       XWTMIVWSKABYBY  NYNXUMYJNUANBB  UOFIFKU         DFPPXACELCAYGB 
GGUKOCQEVIL     : XVDBGX          ATEEVYV         IRBEFUHBGGMB   
DXOJHSMEVQB     : DVSRLULP        FJRAGBAPXUV     ERNIUSKIWRHOLJU
IAPUAMP         : OCSDBYCTPKSVUU  BOOF            IKSWRCFYSOQYUV 
SLTI            : DNQLINPALUIHSFU
KOMUCIYAYKHRYOP : MUCQQJLRSDHQLKW OCSDBYCTPKSVUU  FKGLAUDUJOMGVQD CDXQMQTQ       
PGBRXV          : DKVFQIFIDPOQ    XCECMMVEWBHB    WJOYFM          KXABGTNQAEOQQY  MDNDL          
LODGCYQRKFEHI   : KXOBYQRTPRVEWDP BLHILVESGJ     
IKPUSHUJAMBG    : PMLYKCJSVWU     BTMRKHHSDFSDTA  EYYKAFMHAYPIT   KTPT           
TGMMTBRBFR      : RYUORIETX       GHPSPAOIUNU     SBRQWGYX        PLMGIORWVRYWRKD IDTYORR         WWUMEEGTNLO     WYTSKRSHFUHW   
WEXENI          : MQNSKB          KGCBWHVSM       NABRFRGWVCU     RGCMMCKOE       CTXWXK          WAYDH          
WULRNUOYWCBD    : ROGBEMKO        VOBDNR          WOJNALHJ        UJCQVP         
UMEJGHBHOUCMYCQ : NUPDRLQJULKO    XMQVKMHAN       IFCKDSRPPKQAME  LTYUXJBUXLX     XVDBGX         
KNMHBE          : NYNXUMYJNUANBB  MJHUKTCWQTLBV   WFFAT           HBLEWDQ        
WTWTXXAPSOWC    : IJXGWHJKKLC     UDGYUEYSDUYYQG  AJRPIODFKDF    
GGFVBHIBJBQVQDD : RGXXNRTCIB      THYSP           AYUOJDQELGPGEG  YGCU            CTXWXK          TKRPGB          KVNRONLSL      
JBRFBLDYNTSC    : TGDLAPSKOO     
WAYDH           : XCCFITVTGVO     QJOVLGQPKCHYO   MKLESMGGOXL     WEXENI         
FOFIAI          : MVFYCTSIYJ      OXUNPQE         UBPNBFLH        EPHVBKEMPQYQQC  PSCBVQODCUC     SQPYHYWKTPQJ    UEHUO          
XAEDUNHMTIAWH   : XRRHHVQ         FMVKPGUO        EHXCQNBD        OVAYQSMQKDMXAL  SSTF            NWGWYYHWTRRRA  
SCSLAUNFEK      : IINPXUTEHFPFBX  IJXGWHJKKLC     NMGCJENIAIKOD   CJWW            SDQBBRVMSNAHEB 
SQUUBVUB        : BRYEPYLCBLGR    NUWIXDOLSE      WBQUGYGUMM     
YVOG            : FMVKPGUO        QUUPTGHIJHVPB   VHLXKWWKWR     
KOLH            : VTXICTFVHIYI    MTRJCJB         TFJSQTH        
CDBWQBUEIY      : LGGLXUQ         XRTJEMKVDPNTR   KAKEURXVCHQ     GACUSOKSJXDMC  
VUISPJP         : IUNUU           KSMBONCXTILRI   MCNJUW         
NRMLISWSJK      : HVLMWNEY        GURJHDCFDJ      DEMSIXBDEXKNYKY GHVF            CILJBUBAO      
HMGIJYLGEU      : AMIWRMKDANPYBIU KRAUU           EQNMEBPXHGM     BTOSOYRSA       SWWWPDYWPIIPKLV IXNUBPTYPFUL   
VSBELSPDGDVS    : TQBRQWEYNM      UQEIOIK         STAQQAPVQO      GJFAIPX         TTKJPJC        
ENOAWYFFLLNWMCE : VURWAVET        INBKHESKJXJMXT  VKFPFUEHFW      LHIVSUWKDJSSAY  BMDUWRXHQGJE    YPLAOHNQS       RGCCSLXL        SESTNYG        
