SMSRYLBPWMTG    : RGKHEVCTHYU     DXCUJHE         SOTYQBGHXEVUSV  JFEJQBOMVNLAF   YIOGDBBVLNDC   
MJKBIPUWENHLROC : NRCVVFAWVVDSFG  RQLC            RIIWCD          CRRVVUXSQQOEKV  MRJNHJFSKOVFRX  PUMGUEB        
QSAFMSE         : NBULUBHOB       VDFWVGXBDB      FCCHDSHELQ     
VVUKPB          : UVUONEDQDBXM   
CKCFVRA         : COMWPQMNWE      CXMGUAITL       NCCK           
VQDJKTORMHUR    : PJWVCCLE        KSFAGVSIBVF    
PXTLTRX         : VEFTAFMUW       LSDAIHMOLVUVQY  OBDOTYMIQFWVWV  YXYKRSCIX       HDRBSYR         PCGU           
SNNG            : LFWTGCQOUSKPU   VIUBVKCYJJELDD  PRQVSXLMHRPDSR  SNEMXTACQUCBK   DTHSIRMBYQ     
UEJVYHOE        : SDMTAOJRRBVA    WPRGWPDR        DNYHCROXPMORLR  VXSA            CSTWUMATIM      LWUHWUPRGRNLBW 
YXHRMPMEL       : YKOOCXHCIQOYT   ATACEHBSP       PXGMFB         
CGRXXPJSFYBWUFI : PEANAPN         LFCDTICYQB     
HRHNKGMSABKOG   : GWSVNH          OCKTBI          SYXJYTJYNEGHLT  HUJXAYDPHIKB    QIQNYYNWKEK    
SKEKLCA         : JLXNN           TJGTKMR        
XHUYGRHOKOGT    : NFUELWT         MSASCY          YLWKGFILFQJ     SFNBXCOMTFLTU   PUFGLDN        
RAQMDSWRBULNA   : WLHQS           GDLPTBTY        TYCLMEFI       
BEYWCITCPNJEX   : XCDNOARTSVAAC  
NREHTXT         : HRQU            UBXOTDKUTBUINWW BALBCQWYKHFVFC  KVDLHJFBEPMSK  
SSPVP           : IMNOMTTP        YJNGUUKBRVEAK   PRQVSXLMHRPDSR  DDHPSDIPL       ITFUEKQJORAO    IRBHPV          PVDE           
JRBLWCKYLGDBT   : UHTYPTIPCEHDBJ  IYCEAWHPCQQDDO  AVFLGXX         GQAIVCUGIAUAI   OGUAJJ         
HRQU            : NREHTXT         LNDRJFLTEHJSN  
VEFTAFMUW       : PXTLTRX         AWWDCNMXSUBEWH  SWPMGEAVKCYBM   INQSTGG        
LATDDHCGRE      : QCPQCLOXGQKKV   CHEDXNTTP       MJUJG           KISOCFDWTSV     GHFUIVTLEKSJ    NAICSOCNRIYCJ  
AHUTYCNP        : JTSFSYYR        ULAWVAYJSS     
YLGHHHOVCLGN    : JDSYRKJBQT      LEYVU          
BTQKXWFCQFKNA   : UBCHCFFCM       PGHXNATXJCAGE   GOBVUNVONXHKCJ  TJFNSPSLLXKWDJ 
SPBURPBYWINVLBC : WXUHR           XMBXOHF         IWFPEGCRNVFOC  
OFWFQVF         : NCJKLFYHIVB     PWJB            MTCHOKYND       OWGIIFNRAIBIDHM GXPKMEDASBLFHG 
XXBKO           : RVMTJQPRPFOXUE  QJIN            ERGNAORYJAE     OXHNFXARG      
VHTA            : DOORXMENNPJQ    QXSFNTOI        YHXLTF          CAWDHRXHEPX     RAKASDXFWWST   
LPFMOOCKC       : IAUANRDRC       ADJWYVFKSOCHY   OIUVWSWVAABNGL  AYDOG           DPMWGJMAIDNGSW 
PFRUDYLBGHYH    : YGIQNMEWJLA     YTIRKDLOG      
MXQKF           : RYGKQ           NDTMTD          CCKFSX          NTPQJRVS       
KLXCQKRHME      : SWCBDQQBM       KEQIWMYGWWKU    FTKDA           ICPRN           TJGTKMR         PACJUXM        
RTRLPWLBXTL     : GEKXGQ          KISOCFDWTSV    
DYLBPWIBJ       : LTDUDYCAFSENY   DCRE            XTSDHJR         FQXNXLCABHH     PCNTIIQB       
BMNMEUBIHV      : AGFTWULUPLTIX   QLQMUKG         KQPXFRRELTBVP   LSGKRXTYUN      CQEA           
YHUV            : QQEKJFGACCAGGN  HCKNGDTWPLXHAQ  EUSGSFLSHXHSJNG BBRDSLNRAMHJAI  SKABU          
XVRJ            : BOMVVXUSORWR    FVTMVGQ         FSLFHJPLR       RMKI            ICQXVQO         ODOIJDHNRWYVMOX
UKHYBGJEPEFE    : WJNCYTOF        OABYPNNW        NFUFOKOXSHKJDRC SRTJ           
TIOXTXTYWBTUW   : CHDLCDMXLVG     QUECMLJBBTBP   
SOEOLQXKREUV    : ICFVUBMTMMMB    VMJIWQOS        ITMGWI          WAGOLUYTFQQN    YTNMGBWYP       GEEFVSO        
BCBUVLLTF       : WPRGWPDR        WLJHEEKVLA      HWTEHHEYWCQ     RWBURWQTUPNVQ   CNVHPMGIAOIHOQR BQDIV          
PGJRCFQWAHDOST  : XLISK           IGQQVMEW        XRHU            OSNPD          
GMSDIRGMSBLEMH  : CQGGUQ          YJNGUUKBRVEAK   DBIUUIDF        DTHSIRMBYQ     
WXUHR           : SPBURPBYWINVLBC EOWKO           CACA            LICDGUI        
OIUOPAGKTSQIOVT : KPGKSWQOWBLXPX  TCPRIYNXN       NYXWUAININKDQ   IRBHPV         
CGBDTHSCTRCRBTP : OXHFKADFEUQM    YQXWMDHUWFXXC   QJIN            FIJLYO          GYAOILPAFGST    IUQL           
CMHTMNEIIXRW    : LFCDTICYQB      TITLMOLLGHMGRFV
LFWTGCQOUSKPU   : SNNG            XWBKWINQORV     DJSKDEIYLRXJLP  JGFRY          
QQRJSGQ         : OJUBGVFLOJU    
UGSEQSXONJVMFD  : VTMQECNJUEDEY   EOPYLGEQD       UCQBGPCMSU      HXQUHOFK       
VTMQECNJUEDEY   : UGSEQSXONJVMFD  CXMGUAITL       SHWJUOVXAOVUV   XNXQCYEVYXS     KSCWLOWTG       UDGXUFAPXYITTYJ
WNFDJJUCJLR     : YAPHAKCE        UGOXNOSDQHQEA   QJCXHTYKGAT     KWWGILQSFE      GFAHNRCFJ      
HEBM            : OGFIJHXXVN      GRIRERXIBNQPWXN BEASHFHTBU     
YGIQNMEWJLA     : PFRUDYLBGHYH    BSVKALYAPP      BJCKN          
KMLBSRKEOOOA    : QNJKNYJ         AVBTHM          GPPTUM         
JJNMYJ          : PULHKKCGIGL     WJNCYTOF        RSRF           
FTFUIL          : GRHFPMHO        CGWXIMASTQP     XGTQ            SRHUJ           LUSPLOIJE       RBDMMUMGUQU     XRHU            TPSWGDJJNWEK   
SWUHKH          : AXJWPPDXLTD     SONCSALGUOIFYVT PSISPBIA        ASLSUIDMAUSVRWH UDGXUFAPXYITTYJ
LAMVHDMVDVHPKUO : ANCTTTN         DUDLUWH         TJFNSPSLLXKWDJ  MPMBY          
JVQORYALRAGB    : LYSVP           XTJUSQOAIA      JCUL            XWFXFLJF        EOWPD          
OYVQNTXRIVWFEMP : WVUYAKKXDRKF    ABOHLI          GSVUIH          XIFGOHGULGNW   
BLKAEBRGDDADMC  : TEXPDESSNOULN   HWTEHHEYWCQ    
BBLRQHSIQQGXWS  : UHTYPTIPCEHDBJ  WADATF          QJQLPKDI        HXOTKXISD       LOKJCKXWXEUR    WCSPE           SIAVFTDLWYGHAN  ISOFBIILXEV    
BBLRQHSIQQGXWS  : LWNQYRILK      
XWBKWINQORV     : LFWTGCQOUSKPU   KJLJNPYLSRTMCA  CTPJMD          QHCMLIAF        AYRKG           UFANSHDUGBOF    XKATUTWYKLNTXT 
WISNLVBGNJYV    : YVYPUSO         KDCPFAC         LCNWGGJHGXWYVO 
PEANAPN         : CGRXXPJSFYBWUFI ILYRIUOCF       YJPBWXHBRR      PTQPFOCPBQVF   
SBVDO           : LPYBWHFBQXDIOH  OFBJNQPMEHG     XCDNOARTSVAAC   UEJWMIFAMF     
RGKHEVCTHYU     : SMSRYLBPWMTG    OIUVWSWVAABNGL  VPUPC           IIQOAK          NQNFWVXNIXVOOWN SQRF            YIOGDBBVLNDC   
MGOIIHNK        : OSKPPXC         VCLGIQGDSOWV    UWVTFKLTMAS     DTFWD          
PCKMXNKBDB      : PLDMDJMXJKHA    IFLPROXOQRPWJTM
LNDRJFLTEHJSN   : HRQU            IMTMWPFIRANB    RTDHRCSVUENKY  
CYIRJFHO        : MIXINSDULSCVQNP
VMGINLL         : VWEQ            WLHQS          
WYOPLWBHDKQYY   : RSTSCPBBXF      IVDDNHOJIMYJL   AKDLRBXBQFVXI  
DXCUJHE         : SMSRYLBPWMTG    NIMTC          
CCKIMBVXM       : UYWLXWBUJ       UPRTTCRVCHWGNC  EOILPUYGPNXX   
WEKKD           : ELGQQBVSGHNNW   CULHOGAIPOO     KDBRVC          SQUU            BYCQWVERTFQNFJV
RIYLHXFKXI      : WTJOKIIGOQMW    CIXQ            OGUAJJ          YYSSVSAOAIR     GPUV           
IPNG            : MTJMKITNFELMESV GOJULKCANCMKQW  XHHJOCHFAGX     JEKAUFQ         YYAEXXFNGFJXTI  GEBKJH         
PTCEU           : JCQICTO         TBXR            HIFWOATYDMU     XLKDQWHQYAP     GOTNJLNQAJV     CQEA            MPYYN          
CJTCPGMS        : USJLHURXHE      RUECIENSMOFCS   GRHFPMHO        OUHNPYDD        IAJTAFORRRWP   
HEWUN           : ADJWYVFKSOCHY   RAVJUWCT        ODIUXNGQ        TFKMYEIAGONAR   POTLOJW        
AYVII           : UGQOQQDQHWMBQ   XBVBFL          DJYRGAGOQLNOKL  PBSUWH          AEMU            GPPTUM         
YWKS            : IJGMNQMG        DPNLHLEHL       TXPYGKHMWRFOT   TJFNSPSLLXKWDJ 
GXTDXXNT        : QOGXPTGOHL      XCDNOARTSVAAC  
FDPBXYFWTS      : YSVPTSDQMOG     SAOBN          
TTQDFUEEHYSOYOR : IKMPHDFJLUVQMS  NYJLTPU         NHMAYXTVGW     
PHTRNWJOXIV     : PKSDRDQQKI      WYJUMJDD        OUEVNPLIXE      PCGU           
EOPYLGEQD       : UGSEQSXONJVMFD  NPKEYKB         DCYFYSBQPKOKGK 
WLLPCLHVJYEFQTD : RJNKUYRT        HAGJSIUPSDUDPC  PYQFHK         
IDJEXOUOPGWVY   : DOORXMENNPJQ    ITNUMQ          SMHJUT          JEDNU          
IVOTOQFXMQWS    : SPYEAVV         RTUDVQIMEP      WCSPE           WBRQPQXQB      
NMCQUHBB        : HIRNIDXGNYOYR   VPCQG           DFNSRRIDRHCNQ   QKHPWTCT        JWRFXEUCGNTVBG  SCVDGYMDW      
RWVJFVHHW       : HTIJWNJVAQD     YYRGFLXYLE      RUOVJMFIXXCKYR 
FLLVERVSK       : SLCMJOWCXRMT    TOISLNVNRKSYJIT JMFKJ           SYTE            TMNMSRQPGCSXCGG
MJJY            : QJWLPYENSHKU    BDIEN           SRGLAI          SAOPLSYFSX     
AWUDAB          : NRCVVFAWVVDSFG  DEKOFTPJHIYUV   LUHKL          
WYIFUPORHTFVS   : GPGLQ           LOBHIIJRYUF     PFFKOVSYYMK     QNHDMRQCVCBHFYL
POFAKRKTSAV     : AGKBKGGWCHLLB   FVNJLKI         TGPGDEIXPRPYS   HGIQ            SQRF           
VCSYBRXKWTCN    : MVHISWCA        OWPO            MYHOKJIDRLKSEYV PYAJRVTBIM      MPYYN          
MKVIDH          : LQSHYVNSAS      VODWQKOCBBXC    DFWDCQUL        OJYARQBXW       SEDAIQRIDLUP   
RMACGMX         : DTFWD           WDMMJDNPA       NQAB           
NWTJBO          : IJUKWNVORH      XSFMAHPKMIRVQA  YEEBFOQIINQVIJ 
CHIOGERUSGFQQ   : DRJBKCVGYMVFP   TYFDAHNNWLYFPF  SIAVFTDLWYGHAN 
AQCPQHVGHATG    : MTOOJEOM        XUTD            ETVEKIVGACDTVF  IBDVJXCPIIGIDA  KGKIGN         
FHLPMSXB        : MYULM           UWCEOFG         RGLXLNGEHOIS   
DUWXDEO         : YRWMDEFMK       MRJNHJFSKOVFRX  RTDHRCSVUENKY   DCJOUD         
OOKSGECDKM      : XJKP            GSVUIH          BHGYNLWEWLR    
EUALDOBRHY      : FRVJJGCWBRQTX   FGOFMSTPDB      XMBDEPXJWEDGRQ 
JCQICTO         : PTCEU           JELBLBFBJTWGUY  SPYEAVV         YEMEHRK         MOTUIRGE       
QFKDBQHDVRR     : UVUONEDQDBXM    BDIEN           PXLMNYAPEXVXE  
XNEJSSKKBKFMO   : ELGQQBVSGHNNW   RSTSCPBBXF      GETDK           OWKBNCFYVXMGS  
VTUMMNSW        : DJSKDEIYLRXJLP  ICPRN           YAPANCMTMVYJLW  GGWRIOKNPW      OSPVGLL        
TOYYKQRORHTB    : GUNBJXVUNUI     XKATUTWYKLNTXT  XDUBUXUQSI     
MMMPYTDPU       : KXUAPFS         BVIEVIAMJAQOA   UPRTTCRVCHWGNC  PNSDAOXP       
JPNYFIVVCMUCAO  : MGPBPBLATJSGPGV QTEGNRKOWUNODCV QNJKNYJ         FQDAEJ         
OGFIJHXXVN      : HEBM            YJPBWXHBRR      XPQRMHGYQD      IHSUVAIEGYUHW   KSFAGVSIBVF    
PQPMTBEKCJSBGVN : YUGJXAIK        KISOCFDWTSV     SOSDWAUWHHMH    EEJHHDDMW      
APRXFA          : UOGRFTUIQVTMKDY JVLPGUUNDWQOI   WHNWWUG         YRHMFKFQEOUMLTO QJTVWXTAOI      RTDHRCSVUENKY   YQEXE          
PKMNII          : OVXN            YJLHXMHMFUFAACE FSLFHJPLR      
IAUANRDRC       : LPFMOOCKC       AJYKTTGY       
CUHI            : VTUTO           HJGTUCBWKK      MNWQWITFBQUJHV  CQEA           
WLSNGSSGXKQKY   : CPDELESLAJGUKX  PACJUXM        
SDMTAOJRRBVA    : UEJVYHOE        PGOKVXD         WJEWHGI         MJYHBWOYX       LDERS           UUMDVKLSOC     
RHNKHAGUGBPM    : QTHODKAEMEQ     FCOPQHKRDN      OPTLDJMAFWISWS  YKSXOSPPEYPG    YTNMGBWYP      
AGKBKGGWCHLLB   : POFAKRKTSAV     WHMKDTVMV       PAUVYCSSIDAMC   ERMSDHERGNN    
MXGSRPGEW       : BJCKSCIDUJPTIYR
MTOOJEOM        : AQCPQHVGHATG    QCPQCLOXGQKKV   OSKPPXC         VCLGIQGDSOWV    YLFGETKOXHSBJ  
BPWHWVLGJWJOMJ  : NXJEAY          EVDHPXVRW       FHPWGMBRJVT    
FBPLG           : TUJUGDGLP       NKSFTHJ         VJBLHTHKHS      XJFKHV          HGPSNFKAA       DCYFYSBQPKOKGK  NKURHIQKQGVLHPS
USJLHURXHE      : CJTCPGMS        GUNBJXVUNUI     GBGUGKBT        PWGQNECGCHJPGGP EKTDHBFB        IRXJVHOGBV     
ADJWYVFKSOCHY   : LPFMOOCKC       HEWUN           YQXWMDHUWFXXC  
MCQBIG          : JRLXLSKHFGFA    BAVEYEEMAKGFQW 
EPLN            : RGUESWSIOMNKASW SOTYQBGHXEVUSV  MKBKGYOHGEIUENW
EOWKO           : WXUHR           CACA            OSKPPXC         BKEYETFP        JOONVDOKLM     
OXVPVBBRRDYQE   : JJOVYBPQABSPVY  TEHHNBHXRBQJY   RTDHRCSVUENKY  
TVPECP          : CQFOD           JKOQMWNLVBY     QUECMLJBBTBP    GTOVRAT         RUOVJMFIXXCKYR 
TBBG            : VDWBMCUHVRFUWIN ICYSIDPYEICII   SEDAIQRIDLUP   
PDQGCHGXWD      : HWFCIWWW        OJMADLFHY       VOOXB           MYHOKJIDRLKSEYV
XUTD            : AQCPQHVGHATG    RQLC            IKWFTWFBCSCVC   SHWJUOVXAOVUV   YAYIXYHDQPN     LFLVDWTFE      
KIKGEANIPXERBK  : BRWO            NCJKLFYHIVB     GGDGERBL        OFBJNQPMEHG     XERCULPADMQP    BFBETXNJKV     
QQRYSYGTWLU     : HNHLU           YJNGUUKBRVEAK  
IOBEA           : PSMCBCIASYTTD   TBWGLOGHO       AVNQIVFF        DJYRGAGOQLNOKL  YBKUGKVGLHA    
PIRPVCIWGCXQB   : QSFGBUQDIP      ADQVUPR         YRWMDEFMK       UBCHCFFCM       EKTDHBFB       
JTSFSYYR        : AHUTYCNP        JRHY            TJHGQ           TPIKOALY        NXNLXER        
TRUJSALGP       : OJUBGVFLOJU    
XFSAPPIRPY      : NMNGLRSXTLVPETL OICXFUUHULD     XIBRVSDTUJLKDG 
JLPDQKERDRLUMW  : LUHKL           NYVCL           CHKXRVDQSMPBE  
OIXEFXMXACPIUH  : OEHGVU          GCDYTYFSUOHP    QHIWFVFS       
QTUGYNSDFVW     : GWLPYJS         UHPOERSB        FRFSSMJXYCHTN  
SMQK            : DADXWQHY        KEQIWMYGWWKU    MLKEQWDQTAH     MHKEHIWWBV      SSCIRWQGLLUAF   QPLA           
AKIFIUF         : RSQVLEIPUQNJ    GRFLYW          FUEUATDN        OWPO            ELHTUVHTYVWKI   OGRKQRK         GHFUIVTLEKSJ    YOGVIBYPUDK    
WWQTEDMXXSWOM   : QCPETS          YWGKCRQN        ANSXFXSUSAJWI   BSPAOQCE        YLFGETKOXHSBJ   BFLVCEYVWNYQD  
TKCNGOFSSH      : NDMHTG          YSRMMCNQOKQN    KISOCFDWTSV    
BOMVVXUSORWR    : XVRJ            RJQWXL          UFTCXBTT        TJGTKMR         IBDVJXCPIIGIDA 
XSAUHOADBDT     : JDKJDAXJ        WBXCCGDOBFSGI   LFLVDWTFE       XNXQCYEVYXS     YFXTWWQNPEDHM  
TBDMKHPYTNUT    : WJEWHGI        
PLDMDJMXJKHA    : PCKMXNKBDB      LSQBURIY        IFNTWJEML       FNABIQPDXFLV   
NCPHLKI         : OQJWHEDUXFMFKB  AXJWPPDXLTD     GDLPTBTY        KODVGRYWA      
YSVPTSDQMOG     : FDPBXYFWTS      HHAAAKEPO       YYAEXXFNGFJXTI  VUHP           
RUECIENSMOFCS   : CJTCPGMS        TKVWBF          JJOVYBPQABSPVY  DXPTK           FLQFYXUNXE      AEMU            OQPK           
JEIT            : KEOLXWWV        BNCOSITJC       VJOCUN         
HORWIK          : OPXHSADSEVKN    VJOCUN          ROQEVSDBMK      XMGIL           GUPMMXXCSYJLM  
YAPHAKCE        : WNFDJJUCJLR     VDISDQ          JIRPQGOX        HJGTUCBWKK      DBOSGWSDGJIBU  
MLCHASPC        : MKDJMMSGL       UGGKRAK         FIODG           GQAIVCUGIAUAI   NQNFWVXNIXVOOWN ERGNAORYJAE    
LLSVHODVGBET    : QHODO           WYJUMJDD        WGJRUFMYAOSLQS  YSBKAXQQXYU    
FVTMVGQ         : XVRJ            RJYAH           JDKJDAXJ        IBDVJXCPIIGIDA 
UGOXNOSDQHQEA   : WNFDJJUCJLR     RBLUNHELSV      NAOBFTLPAR      BUFMV           QKKEPQPDONBK   
LQSHYVNSAS      : MKVIDH          KIJCCSU         NHBNELGFITHC    LSGKRXTYUN      UROQVXALBHMTIDD ICQXVQO         TPSWGDJJNWEK   
VHNDAQAGHAW     : NDMHTG          DMMUEDSCGFENRAY JMPYIXQTBSR     WFLIRYWG       
TCOBVSDKGVDPUY  : NHNPDBXM       
OBXFA           : SLAGPTU         SFCPSPRPPAOSSH  OXHNFXARG      
UFHNFQUGNQCPH   : RRQTYPWJB       MYULM           TYFDAHNNWLYFPF  ODIUXNGQ       
NAIYIEEXBGB     : UCQPDCY         NRAVHBNK        OIUVWSWVAABNGL  AVFLGXX         FCCHDSHELQ      GTYWCO          RTPYYF         
HYXJG           : WLHQS           HHAAAKEPO       SSCIRWQGLLUAF  
OQJWHEDUXFMFKB  : NCPHLKI         JKCCVSFUYGYGYEP VKCRPYTCYBE     ABHKVBCGLBKOAT 
UCQBGPCMSU      : UGSEQSXONJVMFD  NTBSMYXOYFCUK   UDYDDVGYWDTQU   ODOIJDHNRWYVMOX
SUGBRXRBUYIX    : MLTMTOYKT       OMXWCEVI       
IFLPROXOQRPWJTM : PCKMXNKBDB      BUCJIJTSRTAC    CAWDHRXHEPX     YKOXESTGCILURMA
QJWLPYENSHKU    : MJJY            DRDKXNAKIOEY    RMPM           
KQAPESJS        : QSGDDWRMMLA     XJBQCLHVKB      FIODG           QPAUUKRPQMJBEAH RDRVSKFD       
XJKP            : OOKSGECDKM      YVYPUSO         IJUKWNVORH      VCTYFONXHTH     YJNGUUKBRVEAK   JTQFAPB         POTLOJW        
TKVWBF          : RUECIENSMOFCS   UROQVXALBHMTIDD
PWUVNQF         : INNADAT         HCPBMCVCYU     
NXJEAY          : BPWHWVLGJWJOMJ  HTAAV           UTVMKAWGMLEQJ   VOOXB           HWUURWXQBW     
SLCMJOWCXRMT    : FLLVERVSK       LTDUDYCAFSENY   MGPIAWOMDSKD    JBBTXNLAIN      FEVWKAPBJ      
PBMHX           : HAVMYPKRQM     
DLBJKO          : VAOG            RCUUUMTTTOOLTI  TPIKOALY        NYJLTPU        
TUJUGDGLP       : FBPLG           TJVAUQPVN       WLJHEEKVLA      DJTPMTMLAFSM   
AOUAGJTYYUMHUW  : TDIE            WPXIMQLH        HHYSTYYQJ       KDWIHBJDBWETDJ 
HAXRQHNNRKWWRI  : DAUDPMPGIYL     FYMJEIR         RTUDVQIMEP     
MKDJMMSGL       : MLCHASPC        GEGUJCHMDWOTU   BFLVCEYVWNYQD   RNWDKACUEHM     HCQNXLXCJFK    
DADXWQHY        : SMQK            TJCTBFGEJCGHWIR WTIFMYI         OCUW            XNHNVNHSRP     
BRWO            : KIKGEANIPXERBK  GNAVXUYG        NKURHIQKQGVLHPS ODOIJDHNRWYVMOX PXFWXLSRHMQQ   
QADNTNEIX       : JNDYGBCHQEHJK   HTAAV           OSWOEPH        
RKVKSIEXKIX     : WXUJKOOF        XPNPCSBDBDOH    CHKXRVDQSMPBE   ECVTAMEWVRMCOOU
BGJRHCOY        : HUDNFHVAH       YNRTLIPADSMQP   BBRDSLNRAMHJAI 
HBNWWDBFBLWN    : UOGRFTUIQVTMKDY TYCLMEFI        DUCVNLEOAQUKA  
HIRNIDXGNYOYR   : NMCQUHBB        KNRNDMNGAJ      AXXMIY          AHOQGYJLIAMMMOG GPUV           
BIXNSBBPXERD    : HAVMYPKRQM      SLMHBKQ         GCAKDFH         CRRVVUXSQQOEKV  MNBMJ           HFWDUDGR       
DAWKJHFYPI      : WTIFMYI         MRJNHJFSKOVFRX  YSBKAXQQXYU    
YVYPUSO         : WISNLVBGNJYV    XJKP            XVOBAECWMDUJDJ 
COMWPQMNWE      : CKCFVRA         DHYH            FRIQOWLLT      
HJUGWEOCGGKE    : RGUESWSIOMNKASW SOTYQBGHXEVUSV  FYMJEIR         AKDLRBXBQFVXI  
IFXFYMGDEVATOM  : XCFGSPCQTTXPCBK ILFKHHWHIUYJ    QTHODKAEMEQ     KQPXFRRELTBVP   PGHXNATXJCAGE   UVEJVOXPEBE     CHKXRVDQSMPBE   JMPYIXQTBSR    
IFXFYMGDEVATOM  : XQGKPXA         JLPEWBQDHP      VRNFTFM        
LTDUDYCAFSENY   : DYLBPWIBJ       SLCMJOWCXRMT    PNLKWSBWGHAPQG  JWRFXEUCGNTVBG  RDYDY           CCTQFQOOUHSKJ   UUMDVKLSOC     
RJYAH           : FVTMVGQ         WAGOLUYTFQQN    UUMDVKLSOC      XGCYPLRD        RSKILSPSX      
BVLECJ          : QDDQCI          PCGJESLYXMM    
WXUJKOOF        : RKVKSIEXKIX     EQECMUYRXLFJOG  PJPFRDHJLAVO    XERCULPADMQP    CFXANPGRREFR    EGFBAK         
PJWVCCLE        : VQDJKTORMHUR    EAJBLKJ         HAGVCBPSQP      DRCSWKTRGUTKI   CPDELESLAJGUKX  AYWKCCO         FIODG          
GNSGWXHULN      : VNSUTCHOOKO     CVIFMHLLNVHXBN  RBLUNHELSV      FBUGJHB         PGEQNEU        
VTUTO           : CUHI            MNBMJ          
GGUODLXC        : AVFLGXX         XEIBOYATKUQBBV  QOBTELHC       
DEUHXBUSHTQOOEE : EBQGOMPAOMQKK   PYAJRVTBIM      XEPP           
AXJWPPDXLTD     : SWUHKH          NCPHLKI         VDPYE           JMXU            NCACFGTOBAJBSSR LUSPLOIJE       BAFLTQBJ       
UFGXKB          : SUGERLLSXEJK    ERATLBYQC       UWCEOFG         NYXWUAININKDQ   NJWLHVLUJB     
KDEDKXVCMAI     : BUHCJIFGSCYVDUE MFBLGBWGK       EDJS           
DHLAYCFYNAC     : RRNUJO          KQJNOAC         HYAF            GCAKDFH         SOEM            SYTE           
WHQUTTCGWGJKG   : AKFBVWYLPUF     POXKTNDHHPFTWQ  YHVIEBTW        PRCITXFSFT      WPWMUICIKFSPO  
OSIWUN          : BDAGF           XQETDPVDVIQAC   DYACXFAKKOYJI   YHVIEBTW        WFLIRYWG       
HNHLU           : QQRYSYGTWLU     TEUIBP          LTJFTNAMD       NPMKXPPGPOWD    NIMTC           PUFGLDN        
YWIJ            : AKUJGRRETOGICC  NRCUDUAJY       SONCSALGUOIFYVT HAGVCBPSQP      TXCPEBGWRDIR   
SCQMXUTVDF      : AKUJGRRETOGICC  XDUHOGGBHNTH    SRQGNMAE        YHVCBNSSNJVQ   
JNWFXVCLD       : HFMGCUXCWDRMPJ 
BKWVTVTC        : QOGXPTGOHL      UECRTFBTDXK     FVRXOIKMYAYQG  
PULHKKCGIGL     : JJNMYJ          DJJENP          HMWSTUV         OMXWCEVI       
PBPWBLAMQLPEJO  : HKCRAADHK       YFGUOPCMEEGGHSB RTNBWXCVXGQR    MQJJIQAEGTYQ    UPCCLBROKWFL   
HKCRAADHK       : PBPWBLAMQLPEJO  EBQGOMPAOMQKK   TIAYH           YFXTWWQNPEDHM  
MQXSEQKG        : VODWQKOCBBXC    SLAGPTU         FNRYPLT        
IJUKWNVORH      : NWTJBO          XJKP            QBNELMTSHGOXN   KQPFS           PYXKVMNNDRWMPVX RBLUNHELSV      JQUTAFTRAYRDCP  UFANSHDUGBOF   
RRNUJO          : DHLAYCFYNAC     RMQH            QBMLDQMI        CNVHPMGIAOIHOQR
OXHFKADFEUQM    : CGBDTHSCTRCRBTP WWEVX           XCFGSPCQTTXPCBK VFJPCEVGVRLYLP  NFUELWT         MKSVPWKPPXYBWO 
BWXLVMHKGRQYJ   : AVFLGXX         DGCLNNRNIMY     JINQHJLV       
VUUS            : DAUDPMPGIYL     DKADUOQQU       HVKVRXUHDDBD   
VAOG            : DLBJKO          QVSEMIMXRBJHQLS EOUOU           IJGMNQMG        YJLHXMHMFUFAACE LKSSEEIGWMNEMT 
UOGRFTUIQVTMKDY : APRXFA          HBNWWDBFBLWN    QOGXPTGOHL      BUCJIJTSRTAC    ITMGWI          SHGUEEUFN      
WPRGWPDR        : UEJVYHOE        BCBUVLLTF       NDVKDF          TEXPDESSNOULN   PYWXEHXOBEPBGPS SRGLAI          LHTXHACLNBXC   
NPKEYKB         : EOPYLGEQD       XHJQOKD         LDJRQIEMERRYOTT LJHT            TAJNEPHB       
RSUNQDEMWSYCRPA : FVNJLKI         ETQCGQVPLQGDTR  KEQIWMYGWWKU    HUWEPX          NALVQMHFPXIWD  
KIHAMBJCRTGQH   : FJAFTKODKDFVFY  UHTYPTIPCEHDBJ  FCQM            TCLJ            HSGEKMYHKRB     JCSIQOUCCN      CQPCYKKYFT     
EBDY            : LTJFTNAMD       PNLKWSBWGHAPQG  DMMXUYWP        RUOVJMFIXXCKYR  GQAYH          
TEUIBP          : HNHLU           AXXMIY         
FJAFTKODKDFVFY  : KIHAMBJCRTGQH   CTODFLKVIB     
NRCVVFAWVVDSFG  : MJKBIPUWENHLROC AWUDAB          OABQJKLVIS      LAODFFDOT       HCQNXLXCJFK    
MLTMTOYKT       : SUGBRXRBUYIX    KDCPFAC        
NYKSA           : CVIFMHLLNVHXBN  TSJMOWEUGDDGW   KNRNDMNGAJ     
GRHFPMHO        : FTFUIL          CJTCPGMS        KDMIUSDUBQLRC   AXXMIY          NCJOIBISJVJF    RXBVFJ          KSFAGVSIBVF    
DRDKXNAKIOEY    : QJWLPYENSHKU    YEGIQEMOKQINE   ILHNBSQKB      
QSBEUNY         : GWLPYJS         NNQGL           NYODAQDPEV      FNRYPLT         GCDYTYFSUOHP    EARR           
RHPBMFOVWYCOF   : VJLMAN          RVPGDFGAYRWAP   VFPFVAOBJFOWDOL
PSMCBCIASYTTD   : IOBEA           IFNTWJEML       AXPJYVXFEQ      TCLJ            GETDK           LTLAHV         
JELBLBFBJTWGUY  : JCQICTO         PSISPBIA        NLWRNJWRS      
AMMVBO          : JPDAXQQAVQUVYEC RHVF            IGDJOJKEUIKRVCA HDKAYKPCQTGNUSM
DWAVVTRBKCFXF   : DJSKDEIYLRXJLP  CEWPWYPJWCXK   
AKUJGRRETOGICC  : YWIJ            SCQMXUTVDF      DFNSRRIDRHCNQ   HBCACXYDVCICHW  NPUFPLBYUSWOVFC BGMSUUCTTINACOM RBDMMUMGUQU    
QCPQCLOXGQKKV   : LATDDHCGRE      MTOOJEOM        DPHIMKMFHBNFMX  UFLJWNHTKTQEPFV HVOGODYHS       LHTXHACLNBXC   
PPIDKTL         : DHYH            QPXLRWNWAOWE   
LPYBWHFBQXDIOH  : SBVDO           EFDWRNSBFLL     QLGCEFUV        XQPVP           XIBRVSDTUJLKDG 
EFDWRNSBFLL     : LPYBWHFBQXDIOH  SMLUXYQDOS      COUVYLIOBFR    
VIUBVKCYJJELDD  : SNNG            LIYNCEPQLYY     GBGUGKBT        KNQUMRFVB       YKYKG          
LTYIAGLWBBSCHEP : HUDNFHVAH       WNXIPPJCEEFF    UBYLXABHWEHIL   SVVI            IROHXT         
CXMGUAITL       : CKCFVRA         VTMQECNJUEDEY   YEJYDWWYJCIWUQ  HHPKFANSJJATQVV ICSCN           XCDVURKD       
BYAEQNARWBAKXBO : WCEYLLS         YHIJGD          FHSKSLKQPE     
FVWXN           : ATXURSIPUO      SONCSALGUOIFYVT XKHEBKKYP      
VDISDQ          : YAPHAKCE        FLWSJPLIWNHSU  
QNQQNWJCWDB     : FIODG          
DNYHCROXPMORLR  : UEJVYHOE        HHIAPQQD        YOIGMRRSIDYSB   DQUV            LUIUALWFFCLA   
GWSVNH          : HRHNKGMSABKOG   EGYLMHL        
GWLPYJS         : QTUGYNSDFVW     QSBEUNY         GWEIUJQOBDNYW   SJUUJLWNTVFKMN 
JYQKIS          : PCQSOLDT        GOBVUNVONXHKCJ  YSBKAXQQXYU     HDKAYKPCQTGNUSM PCNTIIQB        NALVQMHFPXIWD  
WTUMIMXCOGB     : IWFPEGCRNVFOC   MKSVPWKPPXYBWO  JBGCLM         
DOORXMENNPJQ    : VHTA            IDJEXOUOPGWVY   PXXKIC         
IHKQCPP         : NHFJG           SYTE            VLVJFBRHNGRGE  
KCGWCILJLUOBMG  : OJUBGVFLOJU     FTPDTBQOXMLYOVL TXCPEBGWRDIR    WAGOLUYTFQQN    ISOFBIILXEV    
YKOOCXHCIQOYT   : YXHRMPMEL       PMNGSF          VKPYAHACK       QKSFGDNIQMDQ    VGMDEUGFMDIAVHQ
RRQTYPWJB       : UFHNFQUGNQCPH   HFMGCUXCWDRMPJ  MSASCY          LOKJCKXWXEUR   
VXWYKF          : DKMELPASP       XTPPTFTKALA     SOASTXLQS       RUNK            HXMOOGKIXBQ     GHFUIVTLEKSJ    YAIPPPWQXH     
LSQBURIY        : PLDMDJMXJKHA    HCAF            NMNGLRSXTLVPETL EAJBLKJ        
ANCTTTN         : LAMVHDMVDVHPKUO TBWSXSKUS       KEISXXLSXXRETRA ADQVUPR         FBNDYMSFABAXGN 
POCOY           : EDCCOPFBLO      EUSGSFLSHXHSJNG ORMYM           TAPMMNXQH      
WWEVX           : OXHFKADFEUQM    NELFWDTBAHTSYM  WAWRFUPYGOV     ITMGWI          YSBKAXQQXYU     SVVI           
CABUQEP         : JKOQMWNLVBY     BIGKM           EFNNAOGKXEPTJ  
MPLOFPICLYQ     : FVIBSMTAC       TFKMYEIAGONAR   TAPMMNXQH      
NTQO            : FDHQOBWM        GCMJ            KDCPFAC        
PNFMLWONXJHEB   : BHQLBUEBF       JLACQXSGNE     
QSFGBUQDIP      : PIRPVCIWGCXQB   HDQBTCUSDYYSV   KDBRVC          JVHBSJRTN       SFNBXCOMTFLTU   RDHKSNFTHDWDI  
KGPDURSLWFYTVNT : EERMKGGXFNGLD   YKOXESTGCILURMA RPVXXLBJGPIC   
UXJMRCUAFR      : CEMSRVUIG       OOUKDTQE        YJHWBTKKPQ     
IBJFLRWQOO      : MLDLDLWEFF      CLLLXGF         HYVRLSXGUYLJHE  WBXCCGDOBFSGI  
AMPAI           : SQUU            CEMSRVUIG       FMTMWQCEEGV    
NDVKDF          : WPRGWPDR        VOYDMXJLHJ      LJFSGYKOQJN     CINKD          
UJTUPMOANA      : SWXXWHCO        JDUIWMENGQRRXS  DUCVNLEOAQUKA  
BRFRGTDJI       : VODWQKOCBBXC    RGUESWSIOMNKASW
JRHY            : JTSFSYYR        AWWDCNMXSUBEWH 
FJAMIV          : MSOKBBCN        IFKXIRFB        BLAS            RRVNMMJW        SAOPLSYFSX     
DSNP            : GDORWHRTSNJXJ   IFNTWJEML       VKTXRMA        
QFJA            : QWKMKVMWS       HVKVRXUHDDBD   
DFAMCDVMYHEIIBN : TFPH            FTKDA           HQCQ           
CACA            : WXUHR           EOWKO           FVIBSMTAC       RJNKUYRT        TBMDIH          MNKSLGPJWDBD   
FUOW            : KKPPMEWUXL      LFLVDWTFE       WBRQPQXQB      
HCQHKWPMJTSH    : VHPEORVFACN     NELFWDTBAHTSYM  LCNXR           XHRJIVYYWK     
RQLC            : MJKBIPUWENHLROC XUTD           
ORSST           : NPBHJFHB        NYVCL           YBQVWT          DXEVWFC         FINGFUKYQYUHY  
SRDQICXP        : GEGUJCHMDWOTU   PEVXEFSJC       EJIAJPTST       GYSGHCSJKW     
QARNRHYLA       : GGDGERBL        VDBVEQHISJLG    HAVMYPKRQM      QTHODKAEMEQ     SAGBFWVBS       ICYSIDPYEICII  
RRYFVAUNUNHSJBV : JDUIWMENGQRRXS  EKTDHBFB        FBQJTBJRGDUUDT 
KAACHQE         : BQOHOGVNUNM     CQUOPH          VMJIWQOS        EUKNSW          ISVXNBGCETYJW  
FVHGHJPCBQHYTEM : HUDNFHVAH      
STHEWF          : VYEHRA          XNXFCRGJYWNXE   TNWOGPPTKF     
JIEOPWSPCRYJY   : RSQVLEIPUQNJ    OTMYMRAYKNM     AEXLFDNOMCNB    ISOFBIILXEV     WBRQPQXQB      
YDLRNKLRYBMUKQ  : UECRTFBTDXK    
SWCBDQQBM       : KLXCQKRHME      IWFPEGCRNVFOC   DPMWGJMAIDNGSW 
DEKOFTPJHIYUV   : AWUDAB         
TYERMUMFUOIX    : NXRGIYVIUYEDASB MJYHBWOYX       PSSOLAOXSRUFIR 
BYWMFDXVIT      : XBVBFL         
TBWSXSKUS       : ANCTTTN         FRIQOWLLT       RAKASDXFWWST    YSBKAXQQXYU     OBAQJLW        
MFNYMIPUHAXIY   : UTRIPWVQBAHXUH  WUGUSIPQGBK     YUOCOQJKLIB    
NCJKLFYHIVB     : OFWFQVF         KIKGEANIPXERBK  AWLVNJQJYXD     XEVQVRYHF      
ONEJEQOTRDDJA   : QHODO           XTSDHJR         CSTWUMATIM      MKBKGYOHGEIUENW
MYULM           : FHLPMSXB        UFHNFQUGNQCPH   JUMKN           WQNHI           ATACEHBSP      
QXVCDULLSMUJ    : VFLCKLULXBTGIR  RUOVJMFIXXCKYR 
YTIRKDLOG       : PFRUDYLBGHYH    OFBJNQPMEHG     PKCVTEPTCJ     
OSKPPXC         : MGOIIHNK        MTOOJEOM        EOWKO          
OAWSDTFROTM     : GRFLYW          EDCCOPFBLO      FHUWRTBBYONJ   
YOSHGDMSTS      : FBQJTBJRGDUUDT  DBOSGWSDGJIBU   WVTSLSR        
JNDYGBCHQEHJK   : QADNTNEIX       BQVSVNXVTJROY  
QCSLQRKFKTOP    : XMGIL           XYTSTVBEFFIUPG  FINGFUKYQYUHY  
JKCCVSFUYGYGYEP : OQJWHEDUXFMFKB  JMXU            HMWSTUV         AKDLRBXBQFVXI   DDHPSDIPL       JBGCLM         
OTCSMNJEARQ     : VYEHRA          YYAEXXFNGFJXTI  KKDPKDWX       
IGETS           : TDIE            QKSFGDNIQMDQ    ERBUCE          AHOQGYJLIAMMMOG
VOYDMXJLHJ      : NDVKDF          VGHSQHNSYTN     YUWYOF         
WUIQYB          : MBGBD           KDCPFAC         RWOLXPHH        LEYVU          
NNJPFAMP        : WBFRGQWVQOQOCYH PHLTPJBNR       BEASHFHTBU      YIOGDBBVLNDC   
QJCXHTYKGAT     : WNFDJJUCJLR     NBULUBHOB       RMPM            AGTQNKWOGPCETYJ
HFMGCUXCWDRMPJ  : JNWFXVCLD       RRQTYPWJB       BPRBBBNORALL    DTIXMCRI        UNUWMNFELNX    
PWJB            : OFWFQVF         XTPPTFTKALA     VKCRPYTCYBE     XNHNVNHSRP     
UENCA           : JWVHHYUT        YEJYDWWYJCIWUQ  WGJRUFMYAOSLQS  AJUCEEBCCWTUR   GGWRIOKNPW     
MGPIAWOMDSKD    : SLCMJOWCXRMT    YJLHXMHMFUFAACE CYGGJWAINGXV    NUHAENYUSG      GCMJ            HASYQRWK        QKFO            THKYP          
JJOVYBPQABSPVY  : OXVPVBBRRDYQE   RUECIENSMOFCS   QTMSTONJ        QDDQCI          XCAYMSQ         PCGJESLYXMM    
AYVM            : RJNKUYRT        VMKPOHPRLDFL    UTDGOCNL        REBQQHXQQLITQTP CFJEWCPYFAJED   IKMPHDFJLUVQMS  KNRNDMNGAJ      PUFGLDN        
AYVM            : ISVXNBGCETYJW  
LUHKL           : AWUDAB          JLPDQKERDRLUMW  TJHGQ           OUEVNPLIXE      JFEJQBOMVNLAF   FJXMGBHIAVISXJ  XCAYMSQ         XNHNVNHSRP     
PFHVESFVQ       : WHBS            FRIQOWLLT      
WGYWJRMHQSHRQV  : JFMK            KODVGRYWA       THKYP           VLVJFBRHNGRGE   TLFKMQLK       
CQFOD           : TVPECP          VNSUTCHOOKO     HSQTBWRHNA      EARR            CWNAED         
FKLBOGIKWQJ     : TKEBYBNWTQBY   
PGOKVXD         : SDMTAOJRRBVA    EERMKGGXFNGLD   PYDJSSNF        RVPGDFGAYRWAP  
FVIBSMTAC       : MPLOFPICLYQ     CACA            EKMVQUTVNFSHA   YJHWBTKKPQ     
EJJRMBXUNW      : STRQYHHMKFIOW   GLJLJ           TDMJFVTKE       RHVF            ICSCN           DMMXUYWP        SRTJ           
XCFGSPCQTTXPCBK : IFXFYMGDEVATOM  OXHFKADFEUQM    UBCHCFFCM      
VNSUTCHOOKO     : GNSGWXHULN      CQFOD           HCPBMCVCYU      HXQUHOFK        OOSHMIXJFYHMMB  XBRRHKMA       
XMBXOHF         : SPBURPBYWINVLBC CHDLCDMXLVG     XKHEBKKYP      
WHBS            : PFHVESFVQ      
AKFBVWYLPUF     : WHQUTTCGWGJKG   HQCQ            LOBHIIJRYUF    
ETJOLXO         : HPQCNV         
YNOGUWGCBYGBML  : KCGBPHOIVPAWF  
IIEVBYBTFXF     : ERATLBYQC       HJRRTPLRVDKI   
JDKJDAXJ        : XSAUHOADBDT     FVTMVGQ        
XRAYTGCGTG      : HUJXAYDPHIKB    FHPWGMBRJVT    
DKMELPASP       : VXWYKF          TJCTBFGEJCGHWIR UOAX            VOOXB          
OYLAKOCJAXHSXI  : SNEMXTACQUCBK   NWSIOOR        
GKUASLFEXL      : VJLMAN          QCPETS         
PNLGVAFHCQXF    : AWWDCNMXSUBEWH  BPRBBBNORALL    GCAKDFH         RAVJUWCT        WYCSHRSG        RTUDVQIMEP     
AFLSFVHLGENB    : TANIEQJESFAF    NJWLHVLUJB     
TFPH            : DFAMCDVMYHEIIBN YWGKCRQN        QPAUUKRPQMJBEAH VWFIVAOVB       GVLQMJVSPW     
GVNM            : HCAF            NCBFWWKHEDCKJXX XDHTEMLRRFRI    UPCCLBROKWFL    MRJNHJFSKOVFRX 
NTBSMYXOYFCUK   : UCQBGPCMSU      IJGMNQMG        KPRGSGNM        AJYKTTGY        LCNWGGJHGXWYVO 
EXGJL           : UFLJWNHTKTQEPFV GWOJLGJWUWYU    CRRVVUXSQQOEKV 
BHPRRP          : RHVF            HRKPUGQMKNXV    GQAYH           IRXJVHOGBV     
NDMHTG          : TKCNGOFSSH      VHNDAQAGHAW     YRWMDEFMK       LCPGMRYHGQEWFOI IHXOH           JEDNU           BALBCQWYKHFVFC  HWNWBVDCKSMI   
MTJMKITNFELMESV : IPNG            RCUUUMTTTOOLTI  JWRFXEUCGNTVBG  TIAYH          
BYASQR          : PCQSOLDT        JRLXTKUTT      
QHODO           : LLSVHODVGBET    ONEJEQOTRDDJA   PPANEQ          IJQBUFUUTCHVK   KGKIGN         
KWWGILQSFE      : WNFDJJUCJLR     QISJOD          ETVEKIVGACDTVF 
LSLPNJI         : CCKFSX          JSUFBLWVY       RYEDDMCYSLBOUO  BTCCOXDSSVCVY  
KIJCCSU         : LQSHYVNSAS      HCAF            GCMJ            CLNTCNBUKSTSBJ  DJTAVUOA       
KBXSLWSTFGKXO   : FSIXSNCOKQLSPTQ SRTJ            SRGLAI          JXNJDYGWA      
YAKMSXXB        : SWXXWHCO        SIFL            VOOXB          
JLXNN           : SKEKLCA         GOJULKCANCMKQW  VLIMUG          HJRRTPLRVDKI   
KYELWWYVRSD     : YEGIQEMOKQINE   TCLJ            NPUFPLBYUSWOVFC
EBNVDPGRIGQLU   : TJFNSPSLLXKWDJ 
YSRMMCNQOKQN    : TKCNGOFSSH      TRSPDKIVCNMA    GWOJLGJWUWYU    LSDAIHMOLVUVQY  SQNNS           PUFNEBVNGQ      KGKIGN         
KJLJNPYLSRTMCA  : XWBKWINQORV     SRTJ            EOILPUYGPNXX   
OUHNPYDD        : CJTCPGMS        DJJENP          WVKJGTHYUWG     ARLFGYWGR      
QVSEMIMXRBJHQLS : VAOG            ROQEVSDBMK      SRQGNMAE        CNJIRN         
DMXHO           : OFBJNQPMEHG     UESDIHHFIFQ    
VJLMAN          : RHPBMFOVWYCOF   GKUASLFEXL      LJFSGYKOQJN     OKKHOIFSQBE     WDCSRQVB       
FRIBKM          : YQXWMDHUWFXXC   SYTE            NJWLHVLUJB     
UCQPDCY         : NAIYIEEXBGB     NLUDEYMQ        EQECMUYRXLFJOG  MCWNRPRQOAHCRF  KDWIHBJDBWETDJ  TQOKRT         
NUHSJHBYL       : NCCK            EKIUDLSF        EDJS           
IALKNDPHMRRBIOD : GVRAWCRBD       CGNWY           QGUUUPRLGRNRT   UDGXUFAPXYITTYJ
GGDGERBL        : KIKGEANIPXERBK  QARNRHYLA       OABYPNNW        RJFTPJYKXCLSRS 
MVPLJPW         : EYLYYX          YAPANCMTMVYJLW  GOTNJLNQAJV     ICYSIDPYEICII   CNJIRN         
DHYH            : COMWPQMNWE      PPIDKTL         XUIKW           JMPYIXQTBSR    
GVRAWCRBD       : IALKNDPHMRRBIOD GDMLCGBOSBHL    XSFMAHPKMIRVQA  JLMXTNGJELYMHDL BYCQWVERTFQNFJV
JGGOAJCNWXDK    : DPHIMKMFHBNFMX  UWVTFKLTMAS    
UHTYPTIPCEHDBJ  : JRBLWCKYLGDBT   BBLRQHSIQQGXWS  KIHAMBJCRTGQH   VDPYE           JMPYIXQTBSR     RIGD            HWTEHHEYWCQ    
EOUOU           : VAOG            DCRE            XCDNOARTSVAAC   CWNAED         
FVNJLKI         : POFAKRKTSAV     RSUNQDEMWSYCRPA CVIFMHLLNVHXBN  HSQTBWRHNA      GRIRERXIBNQPWXN
VSMDMNUGVM      : IYCEAWHPCQQDDO  XPQRMHGYQD      OOUKDTQE       
CTODFLKVIB      : FJAFTKODKDFVFY  WNHM            WBFRGQWVQOQOCYH TXCPEBGWRDIR    TYCLMEFI       
MGPBPBLATJSGPGV : JPNYFIVVCMUCAO  HAGJSIUPSDUDPC  YJSTQODDMSM     DCJOUD          NALVQMHFPXIWD   ESWUOAAY       
OTAAVTQCCEMX    : QIVPXOB         CHEDXNTTP       AVBTHM         
NRAVHBNK        : NAIYIEEXBGB     KQPXFRRELTBVP   LUNV            FHPWGMBRJVT    
OFBJNQPMEHG     : SBVDO           KIKGEANIPXERBK  YTIRKDLOG       DMXHO           VYEHRA          WBXCCGDOBFSGI  
HFAYHEDTF       : STRQYHHMKFIOW  
JWVHHYUT        : UENCA           CVIFMHLLNVHXBN  IFKXIRFB        XDUBUXUQSI     
LYSVP           : JVQORYALRAGB    VDNBBEQUSWC     TTIBFW         
NEPU            : JPGMHHXKAAVHVJK TJGTKMR         KVQRUGWTIMTFKHU AOABYLOULID    
VDPYE           : AXJWPPDXLTD     UHTYPTIPCEHDBJ  NHFJG           QPQVVHOIHFHPKNV FRLUAGQOGHFXGJC OKKHOIFSQBE     ITRKYUTTXXMXRI 
DJSKDEIYLRXJLP  : LFWTGCQOUSKPU   VTUMMNSW        DWAVVTRBKCFXF   QLQQBV          FTLH            DWQPPLNURU     
NKSFTHJ         : FBPLG           JBXJVHJKCB      OOAVYNQUFGPISYF XFEEBORTE      
CVIFMHLLNVHXBN  : GNSGWXHULN      NYKSA           FVNJLKI         JWVHHYUT        BJCKSCIDUJPTIYR KCGBPHOIVPAWF  
CCACLORI        : VCLGIQGDSOWV    BLAS            CKMAXWXJTJKTHS 
ECJBJSNLOXTDIH  : VYEHRA          TBWGLOGHO       OPXHSADSEVKN    TSBMX           XXXLLPCNHGGE   
VDBVEQHISJLG    : QARNRHYLA       RCKVAVUOVX      RTUDVQIMEP     
DPCIRLJD        : CHDLCDMXLVG     FCOPQHKRDN      FRLUAGQOGHFXGJC FPYV            MKBKGYOHGEIUENW
YQXWMDHUWFXXC   : CGBDTHSCTRCRBTP ADJWYVFKSOCHY   FRIBKM          HSQTBWRHNA     
RJNKUYRT        : WLLPCLHVJYEFQTD CACA            AYVM            CCKFSX          YIIB           
HXPBMBEUCUSBIYJ : VODWQKOCBBXC    JLMXTNGJELYMHDL TNWOGPPTKF      LEYVU          
VODWQKOCBBXC    : MKVIDH          MQXSEQKG        BRFRGTDJI       HXPBMBEUCUSBIYJ AVNQIVFF       
TJCTBFGEJCGHWIR : DADXWQHY        DKMELPASP       DJYRGAGOQLNOKL  TJGTKMR        
RWUG            : ILYRIUOCF       KRUFTJ          RCEPMLHLGO      XDUBUXUQSI      XNHNVNHSRP     
TANIEQJESFAF    : AFLSFVHLGENB    VXWRQVH         BOJRECSPMYBN    XCDNOARTSVAAC   HWQWMVARTAIKI  
UGPDLYHR        : XERCULPADMQP    OWKBNCFYVXMGS  
HCAF            : LSQBURIY        GVNM            KIJCCSU         BOJRECSPMYBN    NAOBFTLPAR      IGDJOJKEUIKRVCA
WADATF          : BBLRQHSIQQGXWS  MWJCAHFBKNFQL   YDBCKGGWMNVBFM  RUQW            PGEQNEU         HXRUPO         
ELGQQBVSGHNNW   : WEKKD           XNEJSSKKBKFMO   GQAIVCUGIAUAI   YSBKAXQQXYU     FWVWDDMSGCAQC  
YYBSHIVKORH     : MLDLDLWEFF      XJBQCLHVKB      UIOJY           LOBHIIJRYUF     RUKT            QQNKRK         
WJNCYTOF        : UKHYBGJEPEFE    JJNMYJ          AKDLRBXBQFVXI   XQPVP           PNSDAOXP       
HHIAPQQD        : DNYHCROXPMORLR  HMWSTUV         DUFIPFPBHGY    
KEOLXWWV        : JEIT            FLPPC           IAGWFKHNVIUTDMY
NNQGL           : QSBEUNY         HXMOOGKIXBQ     GMQLAJEJHPAMDTR YQPQKDMKYCIXOEH
VPCQG           : NMCQUHBB        TDMJFVTKE       IQAJHSHM        IJQBUFUUTCHVK   NQAB           
BNRMO           : RSTRQFWHAWTIORS ANAEH           OOSHMIXJFYHMMB  XTLGFFRMAXNNPOA
DFNSRRIDRHCNQ   : NMCQUHBB        AKUJGRRETOGICC  VLIMUG          PXFWXLSRHMQQ   
EHWRKSJPLQAPETC : XLKDQWHQYAP    
DHCQCTLMAD      : SMLUXYQDOS     
CTMUAWTRH       : YEJYDWWYJCIWUQ  KNKMG           XUIKW           INQSTGG         SNEMXTACQUCBK   HJRRTPLRVDKI   
BWBTYSYSUVWE    : ICIFQLX         JBXJVHJKCB      IUCICBTWYCKXHSV AJUCEEBCCWTUR   YEPW            MKPGDGRUBRN    
PIUBVWHR        : UWCEOFG         UDYDDVGYWDTQU   PYAJRVTBIM      HYGDTTGGTCGRU  
DFWDCQUL        : MKVIDH          FWTORHNO        RWTRYLVDTS      QIQNYYNWKEK     XKATUTWYKLNTXT 
XLISK           : PGJRCFQWAHDOST  PJPFRDHJLAVO    ORLAVQ          MYNTXQTWJVHHKCE SJUUJLWNTVFKMN 
TEXPDESSNOULN   : BLKAEBRGDDADMC  WPRGWPDR        WHNWWUG         ODIUXNGQ       
DPHIMKMFHBNFMX  : QCPQCLOXGQKKV   JGGOAJCNWXDK    HRKPUGQMKNXV    JANWPHX         PXGMFB          LJLYPNVVCD      HWTEHHEYWCQ    
WCTDCMG         : DSRFQVHYH       HWJDQ          
FAWVWIKB        : DUCVNLEOAQUKA  
AIWPSLUAMKH     : NATQN           HXMOOGKIXBQ    
LIYNCEPQLYY     : VIUBVKCYJJELDD  OWURLVBVCCQXH   HGPSNFKAA      
VUKEH           : PNLKWSBWGHAPQG  CRRVVUXSQQOEKV  ISMHOYQXVXYSUHR RXNLOIMNGIGRB  
QIVPXOB         : OTAAVTQCCEMX    ERMSDHERGNN    
QOGXPTGOHL      : GXTDXXNT        BKWVTVTC        UOGRFTUIQVTMKDY DRJBKCVGYMVFP   LJHT           
YEJYDWWYJCIWUQ  : CXMGUAITL       UENCA           CTMUAWTRH       PKSDRDQQKI      XPQVXYYMUYWB    AJUCEEBCCWTUR  
KQJNOAC         : DHLAYCFYNAC     UVWLHLWQLRKDLSU RCKVAVUOVX     
XUQHLXUHYYQADPX : ILHNBSQKB       GTIF            AXQELTTINRPKOVB NYXWUAININKDQ   YJHWBTKKPQ     
YAMVWGQJYC      : ICQXVQO         QTXG           
NCCK            : CKCFVRA         NUHSJHBYL       NLUDEYMQ        NXRGIYVIUYEDASB HWFCIWWW        GYSGHCSJKW     
WBMIB           : UHPOERSB        JEKAUFQ         PELNCPWBGU      CUWQDRSMDQNCJAK
QBIJBNAYTYBJXA  : UVUONEDQDBXM    UFLJWNHTKTQEPFV BTCCOXDSSVCVY   DUCVNLEOAQUKA  
QJOTHFVLPBI     : XDCLGEDWQS      QKFO            HVKVRXUHDDBD   
NQUWJVGVATVBQ   : FBLETSSRNMOL    IXUOSXCIQYF     YHXLTF         
DAUDPMPGIYL     : HAXRQHNNRKWWRI  VUUS            NMNGLRSXTLVPETL NUHAENYUSG      FYLRKLOCJXQUJ  
KEISXXLSXXRETRA : ANCTTTN         SFVUTBQ        
UQMAQKGIYV      : OJUBGVFLOJU     GRIRERXIBNQPWXN XGTQ            MPMBY          
HUDNFHVAH       : BGJRHCOY        LTYIAGLWBBSCHEP FVHGHJPCBQHYTEM VDWBMCUHVRFUWIN SYFUVST        
NBULUBHOB       : QSAFMSE         QJCXHTYKGAT     YUGJXAIK        VOOXB           QBAKWGU        
JUMKN           : MYULM           IGQQVMEW       
QYXOQFJVSQERSN  : SUGERLLSXEJK    FCOPQHKRDN      KUUINYCFUB      HCPBMCVCYU     
GOJULKCANCMKQW  : IPNG            JLXNN           SWPMGEAVKCYBM  
PPANEQ          : QHODO           BFLDVHBIXFVGLK  DBOSGWSDGJIBU   XEVQVRYHF      
PMNGSF          : YKOOCXHCIQOYT   MVHISWCA        QJOV            NTMUDJNURPNEB   MCONQTDVKE      OTMYMRAYKNM    
HTHXFCKRFMGHYS  : INQSTGG         IHGGPQ         
XTPPTFTKALA     : VXWYKF          PWJB            XDUHOGGBHNTH    CLNTCNBUKSTSBJ 
RSTSCPBBXF      : WYOPLWBHDKQYY   XNEJSSKKBKFMO   YEPW            EUKNSW         
PKCVTEPTCJ      : YTIRKDLOG       PKSDRDQQKI      YOIGMRRSIDYSB   FUYJGIPDUGBVL   WXPIHWRRACE    
UGQOQQDQHWMBQ   : AYVII           WLHQS          
STRQYHHMKFIOW   : EJJRMBXUNW      HFAYHEDTF       MNRVSJILBTI     CCTQFQOOUHSKJ   IAKHIW          XYTSTVBEFFIUPG 
QJQLPKDI        : BBLRQHSIQQGXWS  IYRUX           PUMGUEB        
ICIFQLX         : BWBTYSYSUVWE    AWLVNJQJYXD     YSBKAXQQXYU    
HTAAV           : NXJEAY          QADNTNEIX       DRCSWKTRGUTKI   RVJQVRKLGSFND  
JIRPQGOX        : YAPHAKCE       
XPNPCSBDBDOH    : RKVKSIEXKIX     YXYKRSCIX       RUOVJMFIXXCKYR 
CHDLCDMXLVG     : TIOXTXTYWBTUW   XMBXOHF         DPCIRLJD        VCTYFONXHTH     ERATLBYQC       PCNTIIQB       
NYODAQDPEV      : QSBEUNY         LUNV            QDDQCI          UPDWDA          DUAENJRLMY     
AWWDCNMXSUBEWH  : VEFTAFMUW       JRHY            PNLGVAFHCQXF    WFLIRYWG       
UUPDADEOIEF     : HAGJSIUPSDUDPC  FBQJTBJRGDUUDT 
VMKPOHPRLDFL    : AYVM            ILWMAHQXOEKT    WJDRKSQJUFSKEK  TYCLMEFI        PGQUKSYUNLAWA   NYPBCAJKSFHEO   PELXLBVBOFV     MOTUIRGE       
AMFWVXTQNW      : XVOBAECWMDUJDJ  CGNPW          
TDIE            : AOUAGJTYYUMHUW  IGETS           KEQIWMYGWWKU    OVDBDSMKPAT     QNHDMRQCVCBHFYL
QSGDDWRMMLA     : KQAPESJS        IKWFTWFBCSCVC   DKADUOQQU       UAKQQCRHYGV    
QLQQBV          : DJSKDEIYLRXJLP  JBXJVHJKCB      QFSJAFDJUACQ    BJBAKVUGRUXT   
WTJOKIIGOQMW    : RIYLHXFKXI      NDPHMHE         XDCLGEDWQS      MIPSYWYDDBY    
GDMLCGBOSBHL    : GVRAWCRBD       LSGKRXTYUN     
ADQVUPR         : PIRPVCIWGCXQB   ANCTTTN        
EERMKGGXFNGLD   : KGPDURSLWFYTVNT PGOKVXD         VCTYFONXHTH     OVXN            OMXWCEVI        JVLPGUUNDWQOI   VEKNENGX       
NLUDEYMQ        : UCQPDCY         NCCK            CAWDHRXHEPX     GPUV           
MVHISWCA        : VCSYBRXKWTCN    PMNGSF          EQHG            XQETDPVDVIQAC  
HSQTBWRHNA      : CQFOD           FVNJLKI         YQXWMDHUWFXXC   PRQVSXLMHRPDSR  DCJOUD         
SUGERLLSXEJK    : UFGXKB          QYXOQFJVSQERSN  DCYFYSBQPKOKGK  CVHCKLGRBI      DUFIPFPBHGY    
SUSQXVWHQPBRPVY : CQGGUQ          HIFWOATYDMU     GSVUIH          HQEOCIVRJA      RDHKSNFTHDWDI  
VRXSB           : CIUVOJPJRF      IAJTAFORRRWP    UCQRYRRHHTJ    
NMNGLRSXTLVPETL : XFSAPPIRPY      LSQBURIY        DAUDPMPGIYL     WPXIMQLH        WBXCCGDOBFSGI   YYAEXXFNGFJXTI 
DCRE            : DYLBPWIBJ       EOUOU           RSQVLEIPUQNJ    HUWEPX          TVTYQF         
HAVMYPKRQM      : PBMHX           BIXNSBBPXERD    QARNRHYLA       VKPYAHACK       GAHSBYYCHPU    
GDORWHRTSNJXJ   : DSNP            HBIYWCDAELF     LHQAICSRGF      FTKDA           QNQR            USBO           
BMBSRWCTSOS     : TSJMOWEUGDDGW   HUHJFSMMWACN    MYLPXQE        
BNCOSITJC       : JEIT            XBVBFL          PEVXEFSJC       FWBQIYC         NFEBFIGMGPHWYKJ
QWKMKVMWS       : QFJA            KEQIWMYGWWKU    EKIUDLSF        TCPRIYNXN       CBHNYMAEARVFTWO
LTJFTNAMD       : HNHLU           EBDY            JJFLJQMGC       NUEWFWHVDFJLUF 
XGIDWCNQ        : OPXHSADSEVKN   
QKHPWTCT        : NMCQUHBB        BBRDSLNRAMHJAI 
YOVNL           : CTPJMD          FKFQSGGSLIL     PGHWHATSHP      JEDNU           BJBAKVUGRUXT    DUFIPFPBHGY    
SFVUTBQ         : KEISXXLSXXRETRA QJIN           
HYAF            : DHLAYCFYNAC     DYRBRY          GTYWCO          LJHT            YAIPPPWQXH      RDRVSKFD       
NXRGIYVIUYEDASB : TYERMUMFUOIX    NCCK            OJUBGVFLOJU    
GLJLJ           : EJJRMBXUNW      UFWFEEUILA      AYRKG           SSCIRWQGLLUAF   GGWRIOKNPW      ISOFBIILXEV    
IKWFTWFBCSCVC   : XUTD            QSGDDWRMMLA     HDFKEH          QLQMUKG         QOBTELHC        EGFBAK         
WXURYYWCUBTBM   : HQEOCIVRJA      RUVFO          
PVKAIJFEI       : OPXHSADSEVKN    HJGTUCBWKK      OSNPD           BREQDGTMW       EOWPD          
ILFKHHWHIUYJ    : IFXFYMGDEVATOM  EBQGOMPAOMQKK   LAUQEERLIC      GMQLAJEJHPAMDTR
YNQAISONKKAKUK  : ORSKVHYNBEH     NABFVESBABYM    PAUVYCSSIDAMC  
BUCJIJTSRTAC    : IFLPROXOQRPWJTM UOGRFTUIQVTMKDY SAIRYCCJOBDBR  
YNKACCAMWO      : LPRUU           VLAOPUWSS       TDCB           
JBBTXNLAIN      : SLCMJOWCXRMT    RBLUNHELSV      MYLPXQE         BJCKN          
RYGKQ           : MXQKF           TYFDAHNNWLYFPF  QSMGSC          VAAIP           DAQWKSEJNBBMA  
MUQLJDMNHOCEG   : JYIYGOJOLGWRTR  HIFWOATYDMU     IIEVVWYYTKIJ   
NHFJG           : IHKQCPP         VDPYE           RYJBXYCEHL     
UGGKRAK         : MLCHASPC        OPXHSADSEVKN    RUNK            NYVCL           XPQVXYYMUYWB    UNDXICPY        EJIAJPTST      
MDAYBQMMUBCCQ   : CNXUOMC         HHPKFANSJJATQVV IIQOAK          NFUFOKOXSHKJDRC RNWDKACUEHM     BJBAKVUGRUXT   
JYIYGOJOLGWRTR  : MUQLJDMNHOCEG   DCORQR          LSTPXIXQOACUVWN MPEWQMTHXFNHF   UFTCXBTT        LAODFFDOT       GXPQQIMOGBSQJIY
GPGLQ           : WYIFUPORHTFVS   BQVSVNXVTJROY   YWGXBABMVK      XEIAMKJRTVP    
OJUBGVFLOJU     : QQRJSGQ         TRUJSALGP       KCGWCILJLUOBMG  UQMAQKGIYV      NXRGIYVIUYEDASB RSRF            BKEYETFP        RMQH           
UVWLHLWQLRKDLSU : KQJNOAC         RSQVLEIPUQNJ    KTSIOQT         AXIUNFGC        ECVTAMEWVRMCOOU FYQGUVIHQWRF   
GNAVXUYG        : BRWO            OJYARQBXW      
FRIQOWLLT       : COMWPQMNWE      TBWSXSKUS       PFHVESFVQ       FRVJJGCWBRQTX   IAGWFKHNVIUTDMY
SHWJUOVXAOVUV   : VTMQECNJUEDEY   XUTD            XFEEBORTE      
XTJUSQOAIA      : JVQORYALRAGB   
AWFLSFECCQXSMX  : NYVCL           UDCFITMTPFGQS   PUSBSEQ        
ETQCGQVPLQGDTR  : RSUNQDEMWSYCRPA HXLIYQGC        IGRJEW         
NRCUDUAJY       : YWIJ            JINQHJLV        TPSWGDJJNWEK   
CYWPXUVTNXAEV   : UTDGOCNL        QPQVVHOIHFHPKNV MXOGDRQVLXO     UOAX            CLNTCNBUKSTSBJ  MYHOKJIDRLKSEYV LTLAHV          CKMAXWXJTJKTHS 
RMYUIQ          : EAJBLKJ         LSGKRXTYUN     
VKCRPYTCYBE     : OQJWHEDUXFMFKB  PWJB            KNQUMRFVB      
ATXURSIPUO      : FVWXN           VSUELMXNNMJYGQN INQSTGG         FGOFMSTPDB      FKAPR           UOID           
NHBNELGFITHC    : LQSHYVNSAS     
HXLIYQGC        : ETQCGQVPLQGDTR  RUNK            UEUNM           IROLANMRVRETQRA
HWFCIWWW        : PDQGCHGXWD      NCCK           
NGODLAJSKDCMP   : FBNDYMSFABAXGN  QBAKWGU        
NDTMTD          : MXQKF           PYAMVC          OROHEJ          BKHDSSQOYJRHQB  GVLQMJVSPW     
JKOQMWNLVBY     : TVPECP          CABUQEP         EYLYYX          PYAJRVTBIM     
PCQSOLDT        : JYQKIS          BYASQR          RGLABIUG        JGFRY          
SLAGPTU         : OBXFA           MQXSEQKG        RVMTJQPRPFOXUE  PELXLBVBOFV     GVLQMJVSPW     
WMUJBL          : NPHGUQQXLVCCQR 
ACMXFN          : QTHODKAEMEQ     BPRBBBNORALL    RSTRQFWHAWTIORS AVBTHM          JDSYRKJBQT      OOSHMIXJFYHMMB 
VSVQHHVDXOPXWFT : XEPP           
QTHODKAEMEQ     : RHNKHAGUGBPM    IFXFYMGDEVATOM  QARNRHYLA       ACMXFN          GWOJLGJWUWYU    GAIUKKUUMBQQEJ 
KEQIWMYGWWKU    : KLXCQKRHME      SMQK            RSUNQDEMWSYCRPA TDIE            QWKMKVMWS       KPTJLBMK        UMMKLLGRYWKMU   HHTELD         
CULHOGAIPOO     : WEKKD           ENOSNMUJME     
RSQVLEIPUQNJ    : AKIFIUF         JIEOPWSPCRYJY   DCRE            UVWLHLWQLRKDLSU NAICSOCNRIYCJ  
TGPGDEIXPRPYS   : POFAKRKTSAV     WVUYAKKXDRKF    CNSOA           HASYQRWK        DWQPPLNURU     
QJOV            : PMNGSF          JBXJVHJKCB     
JMXU            : AXJWPPDXLTD     JKCCVSFUYGYGYEP PXGMFB          CGNPW          
INNADAT         : PWUVNQF         TJVAUQPVN      
IJGMNQMG        : YWKS            VAOG            NTBSMYXOYFCUK   JBDAKKEDOQHKUH  DUCVNLEOAQUKA  
CHEDXNTTP       : LATDDHCGRE      OTAAVTQCCEMX    MLKEQWDQTAH     FSIXSNCOKQLSPTQ AXMVLTGMTROTQ  
JPDAXQQAVQUVYEC : AMMVBO          EKMVQUTVNFSHA   AUKJ            HASMEYR        
UUBDEDKII       : WNXIPPJCEEFF    GIRGWP         
YFFOLQ          : BVKRX           GOTNJLNQAJV     SQRF            LJHT            XEIAMKJRTVP     UNUWMNFELNX    
QQEKJFGACCAGGN  : YHUV            IKVAFPHENTBQRRR TPSWGDJJNWEK   
CQGGUQ          : GMSDIRGMSBLEMH  SUSQXVWHQPBRPVY DMMUEDSCGFENRAY HUHJFSMMWACN   
FCQM            : KIHAMBJCRTGQH   QLQMUKG         KMMAC           SYTE           
HAANR           : PKSDRDQQKI      FKAPR          
RCDYIFBLHKR     : JWRFXEUCGNTVBG  QPSXLHGJBWDJK   RCBAUSSSNTHDBY 
NTMUDJNURPNEB   : PMNGSF          DJJENP          XRHU            NHMAYXTVGW     
HBIYWCDAELF     : GDORWHRTSNJXJ   KPGKSWQOWBLXPX  SHGUEEUFN       TJJJSL         
YNRTLIPADSMQP   : BGJRHCOY        DIERGJ          HPMDJCVKIHGGWHD YEEBFOQIINQVIJ  COHQQIX         CVVYDGQAME     
JFMK            : WGYWJRMHQSHRQV  FIODG           DBOSGWSDGJIBU  
TOISLNVNRKSYJIT : FLLVERVSK       UIOJY           WKDY            MKPGDGRUBRN    
VCTYFONXHTH     : XJKP            CHDLCDMXLVG     EERMKGGXFNGLD   GAIUKKUUMBQQEJ 
GUNBJXVUNUI     : TOYYKQRORHTB    USJLHURXHE      WCEYLLS         FURHRKL         JVKKLOD        
FDHQOBWM        : NTQO            IFNTWJEML       YAPANCMTMVYJLW  PYQFHK          IHSUVAIEGYUHW  
SLMHBKQ         : BIXNSBBPXERD    OYUIEEUWRASYDPE
UECRTFBTDXK     : BKWVTVTC        YDLRNKLRYBMUKQ  CFTNBYSOH      
GRFLYW          : AKIFIUF         OAWSDTFROTM     MJBCKIMMTJIALI  EEJHHDDMW      
CTPJMD          : XWBKWINQORV     YOVNL           UPRTTCRVCHWGNC 
VFJPCEVGVRLYLP  : OXHFKADFEUQM    DUDLUWH         TIAYH          
XPFQVS          : EKIUDLSF        HASMEYR        
UVUONEDQDBXM    : VVUKPB          QFKDBQHDVRR     QBIJBNAYTYBJXA  PXLMNYAPEXVXE   BSPAOQCE        TIAYH          
BQOHOGVNUNM     : KAACHQE         DRJBKCVGYMVFP   KDBRVC          AXMVLTGMTROTQ   RGTE           
DRJBKCVGYMVFP   : CHIOGERUSGFQQ   QOGXPTGOHL      BQOHOGVNUNM     MNDKTEVSET      LFCDTICYQB      BEASHFHTBU     
ITNUMQ          : IDJEXOUOPGWVY   AVFLGXX         FHSKSLKQPE     
CBCKYRFME       : GTYLHU         
RVMTJQPRPFOXUE  : XXBKO           SLAGPTU         JBXJVHJKCB      GFAHNRCFJ       HAGVCBPSQP      DIPKCBIDJYRQIYQ DDHPSDIPL      
QTEGNRKOWUNODCV : JPNYFIVVCMUCAO  GYRTWIEPU      
TRSPDKIVCNMA    : YSRMMCNQOKQN    JPGMHHXKAAVHVJK VLAOPUWSS       MVVIICOVX      
QHCMLIAF        : XWBKWINQORV     PWGQNECGCHJPGGP TXPYGKHMWRFOT   FHPWGMBRJVT    
QCPETS          : WWQTEDMXXSWOM   GKUASLFEXL      UVEJVOXPEBE     IHGGPQ         
PYDJSSNF        : PGOKVXD         FCEU            UTDGOCNL       
LHQAICSRGF      : GDORWHRTSNJXJ   NPBHJFHB        FQAUR          
OGKJWPYEJUMBTRK : YOKB            RPVXXLBJGPIC   
NATQN           : AIWPSLUAMKH     SWXXWHCO        JFEJQBOMVNLAF  
KNKMG           : CTMUAWTRH       XBVBFL          VGCW            HWTEHHEYWCQ    
SMHJUT          : IDJEXOUOPGWVY   CPSFYLCYD       LAODFFDOT      
TJVAUQPVN       : TUJUGDGLP       INNADAT         HMWSTUV         AXPJYVXFEQ      YWGXBABMVK     
JCUL            : JVQORYALRAGB    KFCLYRYRAKLXGMU NXNLXER        
OABYPNNW        : UKHYBGJEPEFE    GGDGERBL        DJTPMTMLAFSM    UGXYWHSTSQR    
ILYRIUOCF       : PEANAPN         RWUG            OABQJKLVIS      EKTDHBFB        SWATYKSFIA     
FCEU            : PYDJSSNF        QKSFGDNIQMDQ    UNDXICPY        BFLDVHBIXFVGLK  NTRPVOPBQUOL    YQPQKDMKYCIXOEH
RCKVAVUOVX      : VDBVEQHISJLG    KQJNOAC         VHUD            TUWXGULYTFHHQCW
MLDLDLWEFF      : IBJFLRWQOO      YYBSHIVKORH     MSOKBBCN        SOASTXLQS       SQNNS           EFNNAOGKXEPTJ  
TJHGQ           : JTSFSYYR        LUHKL           SHDYPSCWVINN    XHJQOKD         JEKAUFQ         UOID           
MLKEQWDQTAH     : SMQK            CHEDXNTTP       CGNWY          
YWGKCRQN        : WWQTEDMXXSWOM   TFPH            HDFKEH          GCAKDFH         RBJCD           SAOPLSYFSX      DJTAVUOA       
UUXWQKGWBSKNFQE : FWUGYFRNSLWDOJL
VWYWEQV         : OIUVWSWVAABNGL  RAKASDXFWWST   
AGFTWULUPLTIX   : BMNMEUBIHV      TFKMYEIAGONAR   PYQFHK          JQUTAFTRAYRDCP  RTPYYF          EOILPUYGPNXX    UAFSE           XHRJIVYYWK     
FATRPBLVEHUDE   : HSGEKMYHKRB     IAKHIW          RJFTPJYKXCLSRS  TAPMMNXQH      
WCEYLLS         : BYAEQNARWBAKXBO GUNBJXVUNUI     AVFLGXX         IYRUX           XEIAMKJRTVP     GEEFVSO        
IGFASAISBPSWKK  : QPXLRWNWAOWE    VTVWQI          EGFBAK         
VIFFDKMEHOKI    : RCUUUMTTTOOLTI  HHPKFANSJJATQVV XQGKPXA         GEEFVSO        
VCLGIQGDSOWV    : MGOIIHNK        MTOOJEOM        CCACLORI        WVUYAKKXDRKF    NFUELWT         MFGSMNCSO       PRCITXFSFT      VUROWAPSJYVIIHR
RSRF            : JJNMYJ          OJUBGVFLOJU     BLTUOGQUMM     
NNYUTLHX        : GSDHOXY         XBVBFL          UWCEOFG         HASYQRWK        OMBDNJVDENFD    CPJVQLKQNLC    
WJEWHGI         : SDMTAOJRRBVA    TBDMKHPYTNUT    FSIRULOJC       UALITX          DGCLNNRNIMY     OWKBNCFYVXMGS  
RCUUUMTTTOOLTI  : DLBJKO          MTJMKITNFELMESV VIFFDKMEHOKI    WBFRGQWVQOQOCYH GWEIUJQOBDNYW   TJJJSL          PXFWXLSRHMQQ   
JJVDVGCRDNX     : AYWKCCO         SXFQPESAVP      XFEEBORTE       GXPQQIMOGBSQJIY
UFLJWNHTKTQEPFV : QCPQCLOXGQKKV   EXGJL           QBIJBNAYTYBJXA  KAOYGFE         WBXCCGDOBFSGI   FJXMGBHIAVISXJ  CNJIRN          JVKKLOD        
UFLJWNHTKTQEPFV : OGMWEBENYMODI  
YEGIQEMOKQINE   : DRDKXNAKIOEY    KYELWWYVRSD     QLGCEFUV       
QBNELMTSHGOXN   : IJUKWNVORH      CNVHPMGIAOIHOQR KGKIGN         
DJJENP          : PULHKKCGIGL     OUHNPYDD        NTMUDJNURPNEB   VLAOPUWSS      
GTDUFTFUAMNCA   : VMJIWQOS        LFCDTICYQB     
PNLKWSBWGHAPQG  : LTDUDYCAFSENY   EBDY            VUKEH           JVLPGUUNDWQOI   SRHUJ           FHSMPNPIYKEWK  
GUOCB           : SOTYQBGHXEVUSV  EKIUDLSF       
JWRFXEUCGNTVBG  : NMCQUHBB        LTDUDYCAFSENY   MTJMKITNFELMESV RCDYIFBLHKR     TVKBPIUQWABGV  
VHPEORVFACN     : HCQHKWPMJTSH    PYXKVMNNDRWMPVX CAPRXHI         CHKXRVDQSMPBE  
SPYEAVV         : IVOTOQFXMQWS    JCQICTO         TRFYIQLLBXQSJW 
VCCAJRTFTA      : KQPFS           NTRPVOPBQUOL    YAYIXYHDQPN     RUVFO           BQDIV          
RJQWXL          : BOMVVXUSORWR    HHPKFANSJJATQVV CKUKEHNDAALQ    ITFUEKQJORAO   
FLWSJPLIWNHSU   : VDISDQ          QISJOD          YAIPPPWQXH     
VYEHRA          : STHEWF          OTCSMNJEARQ     OFBJNQPMEHG     ECJBJSNLOXTDIH  AKDLRBXBQFVXI   FKFQSGGSLIL     TJFNSPSLLXKWDJ 
NDPHMHE         : WTJOKIIGOQMW   
UASGW           : TBXR            OPTLDJMAFWISWS 
SPADOPKHKOFLU   : OABQJKLVIS      VSUELMXNNMJYGQN MYNTXQTWJVHHKCE VWENJRWLXVXD    HWTEHHEYWCQ    
FUEUATDN        : AKIFIUF         UTRIPWVQBAHXUH  PEVXEFSJC       MYLPXQE        
JBXJVHJKCB      : NKSFTHJ         BWBTYSYSUVWE    QLQQBV          QJOV            RVMTJQPRPFOXUE 
FPCQYOHHBC      : LSGKRXTYUN      PACJUXM         XTGDAFXIHPG    
IYCEAWHPCQQDDO  : JRBLWCKYLGDBT   VSMDMNUGVM      TKVXTAAPWYRK    AXQELTTINRPKOVB UFTCXBTT       
MCONQTDVKE      : PMNGSF          THNNHOGYVQNXCU  GPUV           
RLNVIWVKDXJKNOD : BOJRECSPMYBN    ANSFQTDDKGHQEOM
RGUESWSIOMNKASW : EPLN            HJUGWEOCGGKE    BRFRGTDJI       JBGCLM          JXNJDYGWA      
ENQOMOCP        : CPJVQLKQNLC    
NCACFGTOBAJBSSR : AXJWPPDXLTD     IIQOAK          XBRRHKMA       
ICIDBCKOSYDHDST : NANEDBD         IVDDNHOJIMYJL   GDLPTBTY        FHPWGMBRJVT     RUOVJMFIXXCKYR 
UVVDCS          : XJBQCLHVKB      IKMPHDFJLUVQMS  GYSGHCSJKW      FVRXOIKMYAYQG  
GSDHOXY         : NNYUTLHX        FTPDTBQOXMLYOVL SUTFFBRU       
HDFKEH          : IKWFTWFBCSCVC   YWGKCRQN        IKMPHDFJLUVQMS 
VDWBMCUHVRFUWIN : TBBG            HUDNFHVAH       SOEM            PWGQNECGCHJPGGP ORMYM          
OIUVWSWVAABNGL  : LPFMOOCKC       RGKHEVCTHYU     NAIYIEEXBGB     VWYWEQV         FBLETSSRNMOL    LOKJCKXWXEUR    LCIBTWOGWUK     LKNBYXFBWPGDS  
EQHG            : MVHISWCA        CINKD           VOVHOILCP       JTHPUSVXPCKHR   FGOFMSTPDB      BGMSUUCTTINACOM FHUWRTBBYONJ   
KDMIUSDUBQLRC   : GRHFPMHO        HMWSTUV         WQKIY           VEKNENGX        NWSIOOR        
PYAMVC          : NDTMTD          NPMKXPPGPOWD   
YRWMDEFMK       : DUWXDEO         PIRPVCIWGCXQB   NDMHTG          BJCKN          
WPXIMQLH        : AOUAGJTYYUMHUW  NMNGLRSXTLVPETL
FTLH            : DJSKDEIYLRXJLP  ABOHLI          CDNVLXQKR      
DIERGJ          : YNRTLIPADSMQP   PBSUWH          YRHMFKFQEOUMLTO WSQRTYCBTYYTHD  VERRBLDRYVUDB  
GBGUGKBT        : USJLHURXHE      VIUBVKCYJJELDD  PRCITXFSFT      BJBUBA         
MSOKBBCN        : FJAMIV          MLDLDLWEFF      OJYARQBXW       OYUIEEUWRASYDPE
XSFMAHPKMIRVQA  : NWTJBO          GVRAWCRBD       LFLVDWTFE       ODOIJDHNRWYVMOX
YUGJXAIK        : PQPMTBEKCJSBGVN NBULUBHOB       OVXN            SBGLSXNB        EVHSPCPTXJ      NNDUC           OSPVGLL        
WVUYAKKXDRKF    : OYVQNTXRIVWFEMP TGPGDEIXPRPYS   VCLGIQGDSOWV    BOJRECSPMYBN    CPSFYLCYD       GPPTUM         
DPNLHLEHL       : YWKS            KODVGRYWA       KVJULEAWDOHLQ  
FTPDTBQOXMLYOVL : KCGWCILJLUOBMG  GSDHOXY         IAJTAFORRRWP    BQDIV          
BDAGF           : OSIWUN          QXSFNTOI        OHSNIXIOQFNIVE  DCJOUD          IRXJVHOGBV     
YUQGHU          : AFDLEHPWYMGLI   COHQQIX         GEHWYCUMDA     
UBXOTDKUTBUINWW : NREHTXT         VOVHOILCP       WBXCCGDOBFSGI   IJQBUFUUTCHVK   KVJULEAWDOHLQ  
IMNOMTTP        : SSPVP           NAOBFTLPAR      BALBCQWYKHFVFC  CQPCYKKYFT     
OICXFUUHULD     : XFSAPPIRPY      NHNPDBXM        QNHDMRQCVCBHFYL BQDIV           YIIB           
VXSA            : UEJVYHOE        MXQP            TLFKMQLK       
BPRBBBNORALL    : HFMGCUXCWDRMPJ  PNLGVAFHCQXF    ACMXFN          JDSYRKJBQT     
GCAKDFH         : BIXNSBBPXERD    DHLAYCFYNAC     PNLGVAFHCQXF    YWGKCRQN        DRCSWKTRGUTKI  
OCKTBI          : HRHNKGMSABKOG   ROWWP          
VKPYAHACK       : YKOOCXHCIQOYT   HAVMYPKRQM     
SCRGPJNSLAXTIXK : WHNWWUG         BKHDSSQOYJRHQB  BHGYNLWEWLR     LAODFFDOT       HVHYIQ          ETVLVOXAPSJOYA 
IFNTWJEML       : PLDMDJMXJKHA    PSMCBCIASYTTD   DSNP            FDHQOBWM        PJPFRDHJLAVO    JGJFENYKT       AEXLFDNOMCNB    SQRF           
IFNTWJEML       : GOLMKUJB       
WLJHEEKVLA      : BCBUVLLTF       TUJUGDGLP       DMDVJERRKPA     IAKHIW          KSCWLOWTG      
BUTBSNLRYYC     : RGLABIUG        ORLAVQ          YNFYAPXVUNN    
OVDBDSMKPAT     : TDIE            AWLVNJQJYXD     KHQHYTSFXY     
EAJBLKJ         : PJWVCCLE        LSQBURIY        RMYUIQ          JPGMHHXKAAVHVJK GYAOILPAFGST    XULROOKOCMKHM   RJFTPJYKXCLSRS 
HDQBTCUSDYYSV   : QSFGBUQDIP      CKUKEHNDAALQ    VCTWPUY        
TBWGLOGHO       : IOBEA           ECJBJSNLOXTDIH 
HXOTKXISD       : BBLRQHSIQQGXWS  DCWVYUTVEXMYD   UOAX            VDFWVGXBDB      ALEWUBRNS      
VWEQ            : VMGINLL         MJYHBWOYX       XWFXFLJF        BFBETXNJKV     
HPQCNV          : ETJOLXO         OBDOTYMIQFWVWV  SVIY            BFLVCEYVWNYQD  
QUECMLJBBTBP    : TIOXTXTYWBTUW   TVPECP          WQKIY           FNRYPLT         XULROOKOCMKHM  
OPXHSADSEVKN    : HORWIK          ECJBJSNLOXTDIH  XGIDWCNQ        PVKAIJFEI       UGGKRAK         QRVINXXESFE     QQNKRK         
EQECMUYRXLFJOG  : WXUJKOOF        UCQPDCY         LGEPQBVL        AWNJSYFSI       SEDAIQRIDLUP   
QXSFNTOI        : VHTA            BDAGF          
TBXR            : PTCEU           UASGW           BSVKALYAPP     
NFUELWT         : XHUYGRHOKOGT    OXHFKADFEUQM    VCLGIQGDSOWV    XQETDPVDVIQAC   XDJM            RYEDDMCYSLBOUO  SKABU          
VNHKUS          : CLNTCNBUKSTSBJ 
DYRBRY          : HYAF            IUQL           
NPBHJFHB        : ORSST           LHQAICSRGF      LTLAHV          HUHJFSMMWACN    BAFLTQBJ       
VJOCUN          : JEIT            HORWIK          NHNPDBXM        GPQVYVIQOL     
CLLLXGF         : IBJFLRWQOO      VPUPC           QKSFGDNIQMDQ    XIBRVSDTUJLKDG  EOWPD          
JERK            : SYXJYTJYNEGHLT  GQAYH          
TDMJFVTKE       : EJJRMBXUNW      VPCQG           DBIUUIDF       
ECGUECKDEX      : CIUVOJPJRF      JJFLJQMGC      
SWXXWHCO        : UJTUPMOANA      YAKMSXXB        NATQN           QISJOD          MNDKTEVSET      ALEWUBRNS      
CIXQ            : RIYLHXFKXI     
DNONRLTVSQCWB   : SQNNS          
DCWVYUTVEXMYD   : HXOTKXISD       CAPRXHI         GWEIUJQOBDNYW   WKDY           
XTSDHJR         : DYLBPWIBJ       ONEJEQOTRDDJA   CCKFSX         
WNWRFAOIHSKGQ   : AYDOG           NPMKXPPGPOWD    RIXTHN          GPGDLJSKTMF    
DLHILWHOUHLP    : LFLVDWTFE       UYWLXWBUJ       GLMKSOVXXC      VWENJRWLXVXD   
SYFUVST         : HUDNFHVAH       SWATYKSFIA     
AVFLGXX         : JRBLWCKYLGDBT   NAIYIEEXBGB     GGUODLXC        BWXLVMHKGRQYJ   ITNUMQ          WCEYLLS         OOWT            WSQRTYCBTYYTHD 
AVFLGXX         : EARR            COHQQIX         PXFWXLSRHMQQ   
PKSDRDQQKI      : PHTRNWJOXIV     YEJYDWWYJCIWUQ  PKCVTEPTCJ      HAANR           TPQRTWHC        UOID           
UTDGOCNL        : AYVM            CYWPXUVTNXAEV   PYDJSSNF        UPRTTCRVCHWGNC 
IGRJEW          : ETQCGQVPLQGDTR  NWSIOOR         NYJLTPU        
KXUAPFS         : MMMPYTDPU       OJMADLFHY       LAODFFDOT       VFLCKLULXBTGIR 
AVNQIVFF        : IOBEA           VODWQKOCBBXC   
ILHNBSQKB       : DRDKXNAKIOEY    XUQHLXUHYYQADPX NYJLTPU         RDFFTSRC        HSNYFC         
VGHSQHNSYTN     : VOYDMXJLHJ      ABHKVBCGLBKOAT  OEHGVU          IKMPHDFJLUVQMS  ORNXVWFLWTPSO   RXBVFJ         
VLIMUG          : JLXNN           DFNSRRIDRHCNQ   WNHM           
AYDOG           : LPFMOOCKC       WNWRFAOIHSKGQ   DQWFEVUNUIWH    GYOPOW         
RBJCD           : YWGKCRQN        JYVWN           TSJMOWEUGDDGW   WVTSLSR         NNKTJBJTAX      JRLXTKUTT      
XJBQCLHVKB      : KQAPESJS        YYBSHIVKORH     UVVDCS          WHMKDTVMV       VPJNLICQNCW    
HYVRLSXGUYLJHE  : IBJFLRWQOO      FWTORHNO        IPCDUX         
JPGMHHXKAAVHVJK : NEPU            TRSPDKIVCNMA    EAJBLKJ         KRUFTJ          DAQWKSEJNBBMA   GSSX           
QJEIXW          : VOOXB           VJMLOLDWHERUW  
GRIRERXIBNQPWXN : HEBM            FVNJLKI         UQMAQKGIYV      VNOTOGFIRFTLPB 
YOIGMRRSIDYSB   : DNYHCROXPMORLR  PKCVTEPTCJ      GMJJYWRCSOU     XKTBXOX        
BHQLBUEBF       : PNFMLWONXJHEB   YFRFJHKI        BJBAKVUGRUXT   
OVXN            : PKMNII          EERMKGGXFNGLD   YUGJXAIK        VUUSBKOJD       RBDMMUMGUQU    
LXVCG           : YCBHLTYJIFIK    JDSYRKJBQT      OTQRVAU         LCIBTWOGWUK     VJMLOLDWHERUW   BHGYNLWEWLR    
PXXKIC          : DOORXMENNPJQ    HHTELD          TFKMYEIAGONAR  
BDIEN           : MJJY            QFKDBQHDVRR     IHXOH           SSUCFFJK        BBJNMB         
SOTYQBGHXEVUSV  : SMSRYLBPWMTG    EPLN            HJUGWEOCGGKE    GUOCB           TNWOGPPTKF      QKSFGDNIQMDQ   
UEWMCVXMAIPFQTS : SVIY            LOQM            IRBHPV          LCNWGGJHGXWYVO  BIUPMNRC       
OKONDQUKQBILV   : HUWEPX          WQKIY           INQSTGG         ITFUEKQJORAO   
GTIF            : XUQHLXUHYYQADPX RSTRQFWHAWTIORS YEEBFOQIINQVIJ 
MBGBD           : WUIQYB          PYWXEHXOBEPBGPS JANWPHX         PEVXEFSJC       PUMGUEB        
QJIN            : XXBKO           CGBDTHSCTRCRBTP SFVUTBQ         KPGKSWQOWBLXPX  USKBPSO         JGJFENYKT       YFXTWWQNPEDHM  
DCORQR          : JYIYGOJOLGWRTR  EDCCOPFBLO     
NDYQNMN         : RCBAUSSSNTHDBY  PNSDAOXP        QHIWFVFS       
SHDYPSCWVINN    : TJHGQ           BIGKM           FLPPC          
XBVBFL          : AYVII           BYWMFDXVIT      BNCOSITJC       KNKMG           NNYUTLHX        WNXIPPJCEEFF    FHJYBKXTURK     HXRUPO         
XDCLGEDWQS      : QJOTHFVLPBI     WTJOKIIGOQMW    RNWDKACUEHM     NXNLXER         CQEA            JLPEWBQDHP     
MCWNRPRQOAHCRF  : UCQPDCY         KTSIOQT         PWGQNECGCHJPGGP
OJMADLFHY       : PDQGCHGXWD      KXUAPFS         UBKOJDHV       
NELFWDTBAHTSYM  : WWEVX           HCQHKWPMJTSH    KODVGRYWA      
ATLTAQKLF       : RAVJUWCT        XDJM            MPYYN          
OQSX            : BNCLMDNQGML     NPUFPLBYUSWOVFC TVTYQF         
HMWSTUV         : PULHKKCGIGL     JKCCVSFUYGYGYEP HHIAPQQD        TJVAUQPVN       KDMIUSDUBQLRC   ILWMAHQXOEKT    YPCHVMUWDWY     QJTVWXTAOI     
HMWSTUV         : GOLMKUJB       
VXWRQVH         : TANIEQJESFAF    CCKFSX          GQAIVCUGIAUAI  
XBJSDCFOI       : SRHUJ           DFVCGNGUXA     
FBLETSSRNMOL    : NQUWJVGVATVBQ   OIUVWSWVAABNGL  EKMVQUTVNFSHA   TEHHNBHXRBQJY  
MJYHBWOYX       : SDMTAOJRRBVA    TYERMUMFUOIX    VWEQ            PELXLBVBOFV     LJHT           
LSTPXIXQOACUVWN : JYIYGOJOLGWRTR  NXDDBEDGFBW    
KCCVERGFYHE     : QIQNYYNWKEK     LJSUF           SWIB           
ICFVUBMTMMMB    : SOEOLQXKREUV    DTFWD           MNKSLGPJWDBD    SAOPLSYFSX      CGNPW          
PXLMNYAPEXVXE   : QFKDBQHDVRR     UVUONEDQDBXM    POXKTNDHHPFTWQ  LDJRQIEMERRYOTT BAVEYEEMAKGFQW  ARLFGYWGR      
WNHM            : CTODFLKVIB      VLIMUG          UHPOERSB        WDMMJDNPA      
KRUFTJ          : RWUG            JPGMHHXKAAVHVJK BWDVRHG         PAKRMJMYNG     
GWOJLGJWUWYU    : EXGJL           YSRMMCNQOKQN    QTHODKAEMEQ    
FTKDA           : KLXCQKRHME      DFAMCDVMYHEIIBN GDORWHRTSNJXJ   TYCLMEFI       
CQUOPH          : KAACHQE         YFGUOPCMEEGGHSB IFKXIRFB        FSIXSNCOKQLSPTQ ROQEVSDBMK      WTIFMYI        
MPEWQMTHXFNHF   : JYIYGOJOLGWRTR  HAGJSIUPSDUDPC  RAVJUWCT        XCDVURKD       
GEGUJCHMDWOTU   : MKDJMMSGL       SRDQICXP        FDUOHFJJQNGAFD  ULAWVAYJSS     
LCNXR           : HCQHKWPMJTSH    CINKD          
WLHQS           : RAQMDSWRBULNA   VMGINLL         HYXJG           UGQOQQDQHWMBQ   SAPXP           MKPGDGRUBRN    
YJNGUUKBRVEAK   : SSPVP           GMSDIRGMSBLEMH  QQRYSYGTWLU     XJKP            UBYLXABHWEHIL   GTYLHU         
WBFRGQWVQOQOCYH : NNJPFAMP        CTODFLKVIB      RCUUUMTTTOOLTI 
HIFWOATYDMU     : PTCEU           SUSQXVWHQPBRPVY MUQLJDMNHOCEG   MSASCY          MCUUCSXWHQ     
OHSNIXIOQFNIVE  : BDAGF           TCPRIYNXN       BWDVRHG         DCYFYSBQPKOKGK 
YFGUOPCMEEGGHSB : PBPWBLAMQLPEJO  CQUOPH         
JLMXTNGJELYMHDL : GVRAWCRBD       HXPBMBEUCUSBIYJ SIAVFTDLWYGHAN 
LSDAIHMOLVUVQY  : PXTLTRX         YSRMMCNQOKQN    ATACEHBSP       FRVJJGCWBRQTX   JMPYIXQTBSR    
BKEYETFP        : EOWKO           OJUBGVFLOJU     BMNJUVTBWDFOEBS
SONCSALGUOIFYVT : SWUHKH          YWIJ            FVWXN           KKPPMEWUXL     
TPIKOALY        : JTSFSYYR        DLBJKO          ETVLVOXAPSJOYA 
KDBRVC          : WEKKD           QSFGBUQDIP      BQOHOGVNUNM     GTYLHU          CLNTCNBUKSTSBJ 
KQPFS           : IJUKWNVORH      VCCAJRTFTA      PAUVYCSSIDAMC   IAGWFKHNVIUTDMY
LPRUU           : YNKACCAMWO      YFUJ            WJDRKSQJUFSKEK 
SOEM            : DHLAYCFYNAC     VDWBMCUHVRFUWIN PELNCPWBGU     
OWURLVBVCCQXH   : LIYNCEPQLYY     FYMJEIR         DQWFEVUNUIWH    ORLAVQ          WKDY            NVICWNM        
IXUOSXCIQYF     : NQUWJVGVATVBQ   QPSXLHGJBWDJK   VNOTOGFIRFTLPB  PELXLBVBOFV    
RVPGDFGAYRWAP   : RHPBMFOVWYCOF   PGOKVXD         XNXFCRGJYWNXE   KPRGSGNM        RNWDKACUEHM     CPJVQLKQNLC    
EGYLMHL         : GWSVNH          OOWT            NPHGUQQXLVCCQR  LTLAHV         
XEIBOYATKUQBBV  : GGUODLXC       
JVHBSJRTN       : QSFGBUQDIP      CYGGJWAINGXV    WXPIHWRRACE     YERFMSD         ITFUEKQJORAO    CQPCYKKYFT     
SAOBN           : FDPBXYFWTS      MHKEHIWWBV     
BUHCJIFGSCYVDUE : KDEDKXVCMAI     IVDDNHOJIMYJL   KISOCFDWTSV     AEWINYRHYXXSP  
QLQMUKG         : BMNMEUBIHV      IKWFTWFBCSCVC   FCQM            JSUFBLWVY       ECVTAMEWVRMCOOU
NANEDBD         : ICIDBCKOSYDHDST CFJEWCPYFAJED   BCIMPXJGEEGBBF  AJYKTTGY        NALVQMHFPXIWD   ETVLVOXAPSJOYA 
VMJIWQOS        : SOEOLQXKREUV    KAACHQE         GTDUFTFUAMNCA  
POXKTNDHHPFTWQ  : WHQUTTCGWGJKG   PXLMNYAPEXVXE   JMQEG          
YEMEHRK         : JCQICTO         HHYSTYYQJ       UPYXSVOEAHRGXU 
HVOGODYHS       : QCPQCLOXGQKKV  
IFKXIRFB        : FJAMIV          JWVHHYUT        CQUOPH          EBQGOMPAOMQKK   AYRKG          
AXPJYVXFEQ      : PSMCBCIASYTTD   TJVAUQPVN       XQPVP          
KAOYGFE         : UFLJWNHTKTQEPFV GOBVUNVONXHKCJ 
PYWXEHXOBEPBGPS : WPRGWPDR        MBGBD           XYSODNFN       
QPQVVHOIHFHPKNV : VDPYE           CYWPXUVTNXAEV   QNJKNYJ         FVRXOIKMYAYQG  
MSASCY          : XHUYGRHOKOGT    RRQTYPWJB       HIFWOATYDMU     ODIUXNGQ       
GFAHNRCFJ       : WNFDJJUCJLR     RVMTJQPRPFOXUE  CFJEWCPYFAJED   VQGSX           TEHHNBHXRBQJY   QIQNYYNWKEK    
VFPFVAOBJFOWDOL : RHPBMFOVWYCOF   UYWLXWBUJ      
REBQQHXQQLITQTP : AYVM            MNWQWITFBQUJHV  RXQRDNVM       
CGWXIMASTQP     : FTFUIL          CPJVQLKQNLC     VTVWQI         
FEVWKAPBJ       : SLCMJOWCXRMT    TSJMOWEUGDDGW   SXFQPESAVP      NFGTWCGDY      
RDYDY           : LTDUDYCAFSENY   DKADUOQQU       OWPO            AEXLFDNOMCNB   
YOKB            : OGKJWPYEJUMBTRK HRKPUGQMKNXV    SYXJYTJYNEGHLT  RYDYCV         
HAGVCBPSQP      : PJWVCCLE        YWIJ            RVMTJQPRPFOXUE  GEKXGQ          NPUFPLBYUSWOVFC
WNXIPPJCEEFF    : LTYIAGLWBBSCHEP UUBDEDKII       XBVBFL          MXQP            AOABYLOULID    
GAIUKKUUMBQQEJ  : QTHODKAEMEQ     VCTYFONXHTH     YAPANCMTMVYJLW 
WYJUMJDD        : PHTRNWJOXIV     LLSVHODVGBET    RSTRQFWHAWTIORS SRHUJ          
MFGSMNCSO       : VCLGIQGDSOWV    PELXLBVBOFV     GSSX           
PYXKVMNNDRWMPVX : IJUKWNVORH      VHPEORVFACN     WGPAFPEGXESIUR  QKFO           
KKPPMEWUXL      : FUOW            SONCSALGUOIFYVT CAPRXHI         WEJFOU         
CEWPWYPJWCXK    : DWAVVTRBKCFXF  
RJTJHSVSF       : YBQVWT          WSQRTYCBTYYTHD  ISOFBIILXEV     IAGWFKHNVIUTDMY AGTQNKWOGPCETYJ
KTSIOQT         : UVWLHLWQLRKDLSU MCWNRPRQOAHCRF  UGXYWHSTSQR     SWEVYRW        
UBYLXABHWEHIL   : LTYIAGLWBBSCHEP YJNGUUKBRVEAK   PVOWDX         
RGLABIUG        : PCQSOLDT        BUTBSNLRYYC     KCVCCCAGKPGI    FHGM           
FCOPQHKRDN      : RHNKHAGUGBPM    DPCIRLJD        QYXOQFJVSQERSN  NJWLHVLUJB     
QNQR            : GDORWHRTSNJXJ  
OXFYK           : LMGCYVWFAFN     NTPQJRVS       
SQUU            : WEKKD           AMPAI           ESWUOAAY       
DPACXCSNUBAMGP  : MPFPFYCL        XXXLLPCNHGGE   
WDWQBLPGMAPGSKD : VSUELMXNNMJYGQN HUHJFSMMWACN    YSBKAXQQXYU    
QTMSTONJ        : JJOVYBPQABSPVY  JOONVDOKLM     
OMXWCEVI        : SUGBRXRBUYIX    PULHKKCGIGL     EERMKGGXFNGLD   YAPANCMTMVYJLW  UJPPRGVUCJDU   
PJPFRDHJLAVO    : WXUJKOOF        XLISK           IFNTWJEML      
MKYHGNVSB       : DYACXFAKKOYJI   SSUCFFJK        QJTVWXTAOI     
FYMJEIR         : HAXRQHNNRKWWRI  HJUGWEOCGGKE    OWURLVBVCCQXH   FBUGJHB         BOXSPS          QAAHRCQUIPX     CDNVLXQKR      
XDXFWDMIQM      : NBNO            AOABYLOULID     TDCB           
IYRUX           : QJQLPKDI        WCEYLLS         SNYLCKIJVSYNE   PXFWXLSRHMQQ   
CNXUOMC         : MDAYBQMMUBCCQ   XNQY           
YLWKGFILFQJ     : XHUYGRHOKOGT    JLACQXSGNE     
DRCSWKTRGUTKI   : PJWVCCLE        HTAAV           GCAKDFH         WVKJGTHYUWG     SYXJYTJYNEGHLT 
HAGJSIUPSDUDPC  : WLLPCLHVJYEFQTD MGPBPBLATJSGPGV UUPDADEOIEF     MPEWQMTHXFNHF   DTIXMCRI        MTCHOKYND       NNKTJBJTAX     
BLAS            : FJAMIV          CCACLORI        QNHDMRQCVCBHFYL GXPQQIMOGBSQJIY
USBO            : GDORWHRTSNJXJ   RYJBXYCEHL     
HJGTUCBWKK      : CUHI            YAPHAKCE        PVKAIJFEI      
SIFL            : YAKMSXXB        OTQRVAU        
CPDELESLAJGUKX  : WLSNGSSGXKQKY   PJWVCCLE        KFCLYRYRAKLXGMU QNTKMLCWU       DCYFYSBQPKOKGK 
UHPOERSB        : QTUGYNSDFVW     WBMIB           WNHM            EARR           
FQXNXLCABHH     : DYLBPWIBJ      
OABQJKLVIS      : NRCVVFAWVVDSFG  ILYRIUOCF       SPADOPKHKOFLU   TKEBYBNWTQBY   
RIIWCD          : MJKBIPUWENHLROC FGFADJLQKB      VOVHOILCP       CUWQDRSMDQNCJAK XHRJIVYYWK     
GIRGWP          : UUBDEDKII       ITFUEKQJORAO    IHSUVAIEGYUHW   NCJOIBISJVJF    NQAB            EOWPD          
BSVKALYAPP      : YGIQNMEWJLA     TBXR            SRHUJ          
ABHKVBCGLBKOAT  : OQJWHEDUXFMFKB  VGHSQHNSYTN     RRVNMMJW       
RAVJUWCT        : HEWUN           PNLGVAFHCQXF    ATLTAQKLF       MPEWQMTHXFNHF   FVWPBJFNXKJE    YNFYAPXVUNN     CFTNBYSOH      
CFJEWCPYFAJED   : AYVM            NANEDBD         GFAHNRCFJ       RIGD            XBRRHKMA       
KQPXFRRELTBVP   : BMNMEUBIHV      IFXFYMGDEVATOM  NRAVHBNK        MNDKTEVSET     
XLKDQWHQYAP     : PTCEU           EHWRKSJPLQAPETC QLGCEFUV        RNDQWONWJAPVC   VFLCKLULXBTGIR 
CCKFSX          : MXQKF           LSLPNJI         RJNKUYRT        XTSDHJR         VXWRQVH        
IVDDNHOJIMYJL   : WYOPLWBHDKQYY   ICIDBCKOSYDHDST BUHCJIFGSCYVDUE RXBVFJ          UUMDVKLSOC     
VQGSX           : GFAHNRCFJ       OGUAJJ         
TXODAQNHJNF     : UBKOJDHV        BJCKSCIDUJPTIYR LWUHWUPRGRNLBW 
JIXWQO          : XUIKW           TTIBFW          ISVXNBGCETYJW   KNQUMRFVB       GOITUNDLXVX    
BCIMPXJGEEGBBF  : NANEDBD         YEPW            VOOXB           NBNO           
GHJVRSKWPTG     : UDCFITMTPFGQS   HSGEKMYHKRB    
TYFDAHNNWLYFPF  : CHIOGERUSGFQQ   UFHNFQUGNQCPH   RYGKQ           PGHXNATXJCAGE   YYCBB           DCYFYSBQPKOKGK  NJWLHVLUJB     
QISJOD          : KWWGILQSFE      FLWSJPLIWNHSU   SWXXWHCO        DMMUEDSCGFENRAY
LUNV            : NRAVHBNK        NYODAQDPEV      IHGGPQ         
ERATLBYQC       : UFGXKB          IIEVBYBTFXF     CHDLCDMXLVG     RGTE           
FRFSSMJXYCHTN   : QTUGYNSDFVW     EKIUDLSF        XUIKW           GCDYTYFSUOHP    NABFVESBABYM    RSKILSPSX      
WGJRUFMYAOSLQS  : LLSVHODVGBET    UENCA          
UBKOJDHV        : OJMADLFHY       TXODAQNHJNF     FSIXSNCOKQLSPTQ PRCITXFSFT      VLVJFBRHNGRGE  
FWTORHNO        : DFWDCQUL        HYVRLSXGUYLJHE  ELHTUVHTYVWKI   UMQBLYXV        PCNTIIQB       
YJLHXMHMFUFAACE : PKMNII          VAOG            MGPIAWOMDSKD    VUHP           
QPSXLHGJBWDJK   : RCDYIFBLHKR     IXUOSXCIQYF     KUUINYCFUB      GYOPOW          PVDE           
AKDLRBXBQFVXI   : WYOPLWBHDKQYY   HJUGWEOCGGKE    JKCCVSFUYGYGYEP WJNCYTOF        VYEHRA          FWBQIYC         XCAYMSQ        
BOJRECSPMYBN    : TANIEQJESFAF    HCAF            RLNVIWVKDXJKNOD WVUYAKKXDRKF    JBDAKKEDOQHKUH  JBGCLM          XTLGFFRMAXNNPOA
EYLYYX          : MVPLJPW         JKOQMWNLVBY     EOILPUYGPNXX   
KPGKSWQOWBLXPX  : OIUOPAGKTSQIOVT HBIYWCDAELF     QJIN            PCNTIIQB       
TCLJ            : KIHAMBJCRTGQH   PSMCBCIASYTTD   KYELWWYVRSD     LAUQEERLIC     
MNDKTEVSET      : DRJBKCVGYMVFP   SWXXWHCO        KQPXFRRELTBVP  
QLGCEFUV        : LPYBWHFBQXDIOH  YEGIQEMOKQINE   XLKDQWHQYAP     MXOGDRQVLXO     NHNPDBXM        YOCMYUM         EGFBAK          ALEWUBRNS      
VJBLHTHKHS      : FBPLG           JTJCGWWARDGFM   AEWINYRHYXXSP  
TGEGDJFVPBVINCM : JMFKJ           SCVDGYMDW       YHXLTF          LDIATUDWBWOBRKN FKAPR           COUVYLIOBFR    
HHPKFANSJJATQVV : CXMGUAITL       MDAYBQMMUBCCQ   VIFFDKMEHOKI    RJQWXL          KISOCFDWTSV     VRBKOTUQ       
CCSFN           : XDUHOGGBHNTH    RUNK           
EDCCOPFBLO      : POCOY           OAWSDTFROTM     DCORQR          LOKJCKXWXEUR    MTCHOKYND      
EBQGOMPAOMQKK   : DEUHXBUSHTQOOEE HKCRAADHK       ILFKHHWHIUYJ    IFKXIRFB        PBSUWH          RFTC           
POBWDBDIDGWUN   : CVVYDGQAME      GLGGP          
HCKNGDTWPLXHAQ  : YHUV            PSISPBIA        PYQFHK          FHSMPNPIYKEWK   NJWLHVLUJB     
MWJCAHFBKNFQL   : WADATF          GYAOILPAFGST    VUUSBKOJD       BNCLMDNQGML     FPYV            URTHWXBPSS     
GMJJYWRCSOU     : YOIGMRRSIDYSB   BJCKSCIDUJPTIYR
OEHGVU          : OIXEFXMXACPIUH  VGHSQHNSYTN     UIOJY          
IWFPEGCRNVFOC   : SPBURPBYWINVLBC WTUMIMXCOGB     SWCBDQQBM       QPLA           
ANSXFXSUSAJWI   : WWQTEDMXXSWOM   DXEVWFC         MPYYN          
UFWFEEUILA      : GLJLJ           QIQNYYNWKEK    
BVKRX           : YFFOLQ          BJCKSCIDUJPTIYR FHSKSLKQPE     
SOASTXLQS       : VXWYKF          MLDLDLWEFF      DBIUUIDF        FKAPR           PEBSLBBUQJDQ   
DRYWM           : MKBKGYOHGEIUENW
USKBPSO         : QJIN            YEPW           
WQNHI           : MYULM           AEMU            YMJPNOVBD      
OBDOTYMIQFWVWV  : PXTLTRX         HPQCNV          NIMTC           KDCPFAC        
LCPGMRYHGQEWFOI : NDMHTG          KUUINYCFUB     
DJYRGAGOQLNOKL  : AYVII           IOBEA           TJCTBFGEJCGHWIR OOUKDTQE        PHIEHCLDHEVW    VGMDEUGFMDIAVHQ
XNXFCRGJYWNXE   : STHEWF          RVPGDFGAYRWAP   JRLXLSKHFGFA    ICSCN           FNRYPLT         QPLA            CPJVQLKQNLC     PVDE           
GAHSBYYCHPU     : HAVMYPKRQM      ICQXVQO         RWOLXPHH        MKSVPWKPPXYBWO 
FKFQSGGSLIL     : YOVNL           VYEHRA          BYCQWVERTFQNFJV
RMQH            : RRNUJO          OJUBGVFLOJU     DMMXUYWP        RWOLXPHH        UJPPRGVUCJDU   
VKTXRMA         : DSNP            MNRVSJILBTI     RXQRDNVM       
NCBFWWKHEDCKJXX : GVNM            RWQKMHSL       
JRLXLSKHFGFA    : MCQBIG          XNXFCRGJYWNXE   QBMLDQMI       
HTIJWNJVAQD     : RWVJFVHHW      
VNOTOGFIRFTLPB  : GRIRERXIBNQPWXN IXUOSXCIQYF    
YJSTQODDMSM     : MGPBPBLATJSGPGV WPWMUICIKFSPO   UESDIHHFIFQ    
VDNBBEQUSWC     : LYSVP           IKVAFPHENTBQRRR YHVCBNSSNJVQ   
RHVF            : AMMVBO          EJJRMBXUNW      BHPRRP          SAPXP           FHSKSLKQPE     
YXYKRSCIX       : PXTLTRX         XPNPCSBDBDOH    VOVHOILCP       PVOWDX          BJCKN           XEPP           
UTRIPWVQBAHXUH  : MFNYMIPUHAXIY   FUEUATDN        BVIEVIAMJAQOA   OMBDNJVDENFD    PUFGLDN         LEYVU           YUOCOQJKLIB    
YBKUGKVGLHA     : IOBEA           FSLFHJPLR       IAJTAFORRRWP    AXIUNFGC        GQAYH          
LJFSGYKOQJN     : NDVKDF          VJLMAN          PYBF            MRJNHJFSKOVFRX  NNDUC          
KPTJLBMK        : KEQIWMYGWWKU    LTLAHV          LWUHWUPRGRNLBW 
WHMKDTVMV       : AGKBKGGWCHLLB   XJBQCLHVKB     
XHJQOKD         : NPKEYKB         TJHGQ           DFVCGNGUXA     
CNSOA           : TGPGDEIXPRPYS   IHXOH           UXLTFYBEASMGF  
ILWMAHQXOEKT    : VMKPOHPRLDFL    HMWSTUV         WDCSRQVB        PSSOLAOXSRUFIR 
IHXOH           : NDMHTG          BDIEN           CNSOA           FUYJGIPDUGBVL   JCSIQOUCCN     
AYWKCCO         : PJWVCCLE        JJVDVGCRDNX    
XDUHOGGBHNTH    : SCQMXUTVDF      XTPPTFTKALA     CCSFN           PBSUWH          RVJQVRKLGSFND  
ATACEHBSP       : YXHRMPMEL       MYULM           LSDAIHMOLVUVQY  LAODFFDOT      
SQGGSIUNGB      : VUUSBKOJD       AYRKG          
PRQVSXLMHRPDSR  : SNNG            SSPVP           HSQTBWRHNA     
ASBRCUIKDEV     : ANAEH           YIIB           
RCBAUSSSNTHDBY  : RCDYIFBLHKR     NDYQNMN         BBJNMB          XLVAILOIVIXCFG 
HRKPUGQMKNXV    : BHPRRP          DPHIMKMFHBNFMX  YOKB            EUMRKXUVXCRG   
CRRVVUXSQQOEKV  : MJKBIPUWENHLROC BIXNSBBPXERD    EXGJL           VUKEH           FVWPBJFNXKJE    VHIAYHJIPS      EOILPUYGPNXX   
OUEVNPLIXE      : PHTRNWJOXIV     LUHKL           YYJUVENO       
KUUINYCFUB      : QYXOQFJVSQERSN  QPSXLHGJBWDJK   LCPGMRYHGQEWFOI DSRFQVHYH       TDCB           
UTVMKAWGMLEQJ   : NXJEAY          RTNBWXCVXGQR    DSRFQVHYH       FDUOHFJJQNGAFD 
IUCICBTWYCKXHSV : BWBTYSYSUVWE    LSGKRXTYUN      YBQVWT          BBRDSLNRAMHJAI  NTPQJRVS        LWUHWUPRGRNLBW 
XQETDPVDVIQAC   : OSIWUN          MVHISWCA        NFUELWT         LDIATUDWBWOBRKN PUFGLDN        
TKVXTAAPWYRK    : IYCEAWHPCQQDDO  RFWRVY          HDRBSYR         FQAUR          
YFUJ            : LPRUU           WVKJGTHYUWG     DFVCGNGUXA     
OOWT            : AVFLGXX         EGYLMHL         FHSMPNPIYKEWK   AHOQGYJLIAMMMOG
UWCEOFG         : FHLPMSXB        UFGXKB          PIUBVWHR        NNYUTLHX        NANUT           JRLXTKUTT      
BSPAOQCE        : WWQTEDMXXSWOM   UVUONEDQDBXM    MEKHAHO         UCQRYRRHHTJ     SRQGNMAE        UFANSHDUGBOF    EDJS            VERRBLDRYVUDB  
BSPAOQCE        : FINGFUKYQYUHY  
DYACXFAKKOYJI   : OSIWUN          MKYHGNVSB       PYILNTEYUECEEJ  OWPO           
FIJLYO          : CGBDTHSCTRCRBTP FGFADJLQKB      ALEWUBRNS      
QSMGSC          : RYGKQ           QPXLRWNWAOWE    LGEPQBVL        OQPK           
WGPAFPEGXESIUR  : PYXKVMNNDRWMPVX JTHPUSVXPCKHR   DXEVWFC         WBRQPQXQB       MPYYN          
GYAOILPAFGST    : CGBDTHSCTRCRBTP EAJBLKJ         MWJCAHFBKNFQL   EUMRKXUVXCRG    NIMTC           JBDAKKEDOQHKUH  OGMWEBENYMODI   HWNWBVDCKSMI   
NXOK            : KMMAC           IUQL           
EKMVQUTVNFSHA   : FVIBSMTAC       JPDAXQQAVQUVYEC FBLETSSRNMOL    HQCQ           
ICPRN           : KLXCQKRHME      VTUMMNSW        AVBTHM          XDUBUXUQSI     
RUNK            : VXWYKF          UGGKRAK         HXLIYQGC        CCSFN           FHGM            RGTE           
DXPTK           : RUECIENSMOFCS   PGHXNATXJCAGE   AJUCEEBCCWTUR  
AWLVNJQJYXD     : NCJKLFYHIVB     ICIFQLX         OVDBDSMKPAT     SAGBFWVBS      
XERCULPADMQP    : KIKGEANIPXERBK  WXUJKOOF        UGPDLYHR       
VPUPC           : RGKHEVCTHYU     CLLLXGF         OOAVYNQUFGPISYF
PYILNTEYUECEEJ  : DYACXFAKKOYJI  
GEKXGQ          : RTRLPWLBXTL     HAGVCBPSQP     
WISSBP          : UOKSXDIAVEAH    AIGAH          
DKADUOQQU       : VUUS            QSGDDWRMMLA     RDYDY           LFCDTICYQB     
LAUQEERLIC      : ILFKHHWHIUYJ    TCLJ            QPXLRWNWAOWE    NCJOIBISJVJF   
OSWOEPH         : QADNTNEIX       SUTFFBRU        DAQWKSEJNBBMA  
FSIRULOJC       : WJEWHGI         LKSSEEIGWMNEMT  LAODFFDOT      
FURHRKL         : GUNBJXVUNUI    
CYGGJWAINGXV    : MGPIAWOMDSKD    JVHBSJRTN       FYLRKLOCJXQUJ   BHAQSXKQBMGEO   HECVNPXRIVMP   
FQTALGOVKWDHQKY : XJFKHV          VOVHOILCP       SSUCFFJK        PCGU           
XWFXFLJF        : JVQORYALRAGB    VWEQ            BHAQSXKQBMGEO  
RSTRQFWHAWTIORS : BNRMO           ACMXFN          GTIF            WYJUMJDD        KKDPKDWX        UMQBLYXV       
UBCHCFFCM       : BTQKXWFCQFKNA   PIRPVCIWGCXQB   XCFGSPCQTTXPCBK UDGXUFAPXYITTYJ
HXMOOGKIXBQ     : VXWYKF          NNQGL           AIWPSLUAMKH     FGFADJLQKB      UFANSHDUGBOF   
JSUFBLWVY       : LSLPNJI         QLQMUKG         VJMLOLDWHERUW  
YDBCKGGWMNVBFM  : WADATF          YSBKAXQQXYU     YAIPPPWQXH      PAUVYCSSIDAMC  
PWGQNECGCHJPGGP : USJLHURXHE      QHCMLIAF        VDWBMCUHVRFUWIN MCWNRPRQOAHCRF  UROQVXALBHMTIDD OXHNFXARG      
FUYJGIPDUGBVL   : PKCVTEPTCJ      IHXOH           GLMKSOVXXC      FFXHSQJDKIHOT  
GDLPTBTY        : RAQMDSWRBULNA   NCPHLKI         ICIDBCKOSYDHDST YWUYCXGW        OGMWEBENYMODI   FCHCH          
XGTQ            : FTFUIL          UQMAQKGIYV      KFCLYRYRAKLXGMU
CINKD           : NDVKDF          EQHG            LCNXR           GSSX            FWVWDDMSGCAQC  
VLAOPUWSS       : YNKACCAMWO      TRSPDKIVCNMA    DJJENP          PUSBSEQ        
JANWPHX         : DPHIMKMFHBNFMX  MBGBD           GSUORJOLHAQHI  
IKMPHDFJLUVQMS  : TTQDFUEEHYSOYOR AYVM            UVVDCS          HDFKEH          VGHSQHNSYTN     RFTC           
MJUJG           : LATDDHCGRE      BIGKM           LWUHWUPRGRNLBW 
DQWFEVUNUIWH    : AYDOG           OWURLVBVCCQXH   NHNPDBXM        SNYLCKIJVSYNE   XCDVURKD        IBDVJXCPIIGIDA 
OOAVYNQUFGPISYF : NKSFTHJ         VPUPC           COHQQIX        
FSIXSNCOKQLSPTQ : KBXSLWSTFGKXO   CHEDXNTTP       CQUOPH          UBKOJDHV        HVKVRXUHDDBD    QQNKRK         
IQAJHSHM        : VPCQG           GTYWCO          OGUAJJ          XTGDAFXIHPG     LWUHWUPRGRNLBW 
YWUYCXGW        : GDLPTBTY       
FRVJJGCWBRQTX   : EUALDOBRHY      FRIQOWLLT       LSDAIHMOLVUVQY  RIXTHN          RDHKSNFTHDWDI  
NANUT           : UWCEOFG         VWENJRWLXVXD   
HUWEPX          : RSUNQDEMWSYCRPA DCRE            OKONDQUKQBILV   PGHXNATXJCAGE   YEPW            NTRPVOPBQUOL   
PGHXNATXJCAGE   : BTQKXWFCQFKNA   IFXFYMGDEVATOM  TYFDAHNNWLYFPF  DXPTK           HUWEPX         
AXQELTTINRPKOVB : XUQHLXUHYYQADPX IYCEAWHPCQQDDO  MXOGDRQVLXO     NAICSOCNRIYCJ   MOTUIRGE       
GSUORJOLHAQHI   : JANWPHX         UEBBJSBRGISQJY 
CIUVOJPJRF      : VRXSB           ECGUECKDEX     
KPRGSGNM        : NTBSMYXOYFCUK   RVPGDFGAYRWAP   GQAIVCUGIAUAI   LKSSEEIGWMNEMT 
CEMSRVUIG       : UXJMRCUAFR      AMPAI           SAIRYCCJOBDBR  
FIODG           : MLCHASPC        KQAPESJS        PJWVCCLE        QNQQNWJCWDB     JFMK            CVVYDGQAME     
MXOGDRQVLXO     : CYWPXUVTNXAEV   QLGCEFUV        AXQELTTINRPKOVB BHGYNLWEWLR    
NDXRJMMCJHMPKSA : XRHU           
XJFKHV          : FBPLG           FQTALGOVKWDHQKY LMGCYVWFAFN     PAKRMJMYNG     
LOKJCKXWXEUR    : BBLRQHSIQQGXWS  RRQTYPWJB       OIUVWSWVAABNGL  EDCCOPFBLO      YUWYOF          EEJHHDDMW      
HGPSNFKAA       : FBPLG           LIYNCEPQLYY     TSJMOWEUGDDGW   NJWLHVLUJB     
AXWHKED         : XDJM            UESDIHHFIFQ     UXLTFYBEASMGF  
RTNBWXCVXGQR    : PBPWBLAMQLPEJO  UTVMKAWGMLEQJ  
AXMVLTGMTROTQ   : CHEDXNTTP       BQOHOGVNUNM    
EVDHPXVRW       : BPWHWVLGJWJOMJ  KCVCCCAGKPGI    YKYKG          
VSUELMXNNMJYGQN : ATXURSIPUO      SPADOPKHKOFLU   WDWQBLPGMAPGSKD FBQJTBJRGDUUDT  ANSFQTDDKGHQEOM
KCVCCCAGKPGI    : RGLABIUG        EVDHPXVRW       BFLVCEYVWNYQD  
FGFADJLQKB      : RIIWCD          FIJLYO          HXMOOGKIXBQ     ICYSIDPYEICII  
YLFGETKOXHSBJ   : MTOOJEOM        WWQTEDMXXSWOM   RFWRVY          MEKHAHO         GETDK          
JVLPGUUNDWQOI   : APRXFA          EERMKGGXFNGLD   PNLKWSBWGHAPQG  ANHOL           RXQRDNVM       
YJPBWXHBRR      : PEANAPN         OGFIJHXXVN      JLPEWBQDHP      GOLMKUJB        QHIWFVFS       
RBLUNHELSV      : UGOXNOSDQHQEA   GNSGWXHULN      IJUKWNVORH      JBBTXNLAIN      JMPYIXQTBSR     QBMLDQMI       
PSISPBIA        : SWUHKH          JELBLBFBJTWGUY  HCKNGDTWPLXHAQ  YBQVWT          TEHHNBHXRBQJY   XXXLLPCNHGGE   
JMFKJ           : FLLVERVSK       TGEGDJFVPBVINCM GETDK          
TNWOGPPTKF      : STHEWF          HXPBMBEUCUSBIYJ SOTYQBGHXEVUSV  UXLTFYBEASMGF  
RRVNMMJW        : FJAMIV          ABHKVBCGLBKOAT 
YAPANCMTMVYJLW  : VTUMMNSW        MVPLJPW         FDHQOBWM        GAIUKKUUMBQQEJ  OMXWCEVI        AHOQGYJLIAMMMOG
RMPM            : QJWLPYENSHKU    QJCXHTYKGAT     JBGCLM         
XPQRMHGYQD      : OGFIJHXXVN      VSMDMNUGVM      PXGMFB          PYWCJVTCJSR     TDCB           
RFWRVY          : TKVXTAAPWYRK    YLFGETKOXHSBJ   GSSX           
RNDQWONWJAPVC   : XLKDQWHQYAP     OKKHOIFSQBE     GOBVUNVONXHKCJ  YYRGFLXYLE      OWKBNCFYVXMGS  
NUHAENYUSG      : MGPIAWOMDSKD    DAUDPMPGIYL     UEBBJSBRGISQJY  TPSWGDJJNWEK   
XDHTEMLRRFRI    : GVNM            UROQVXALBHMTIDD WEJFOU         
QRVINXXESFE     : OPXHSADSEVKN    PBSUWH          ALJTKFSVQ       YEEBFOQIINQVIJ 
UEUNM           : HXLIYQGC        RWBURWQTUPNVQ  
ORSKVHYNBEH     : YNQAISONKKAKUK  FHSKSLKQPE     
WYCSHRSG        : PNLGVAFHCQXF   
MNBMJ           : BIXNSBBPXERD    VTUTO           GCMJ           
JYVWN           : RBJCD           MEKHAHO        
RYJBXYCEHL      : NHFJG           USBO            GTYLHU         
IPUPIN          : PXFWXLSRHMQQ    HASMEYR        
GCMJ            : NTQO            MGPIAWOMDSKD    KIJCCSU         MNBMJ           TWSBMTAJPCT     NBIQPSRAYQRIY  
XSDWOALCRMN     : RDRVSKFD       
MNWQWITFBQUJHV  : CUHI            REBQQHXQQLITQTP YYCBB           WUGUSIPQGBK     GEBKJH          IRPOGREJLAPM    BOUKJRVURLQNQD 
LICDGUI         : WXUHR           KHQHYTSFXY      HBCACXYDVCICHW  DUDLUWH        
KISOCFDWTSV     : LATDDHCGRE      RTRLPWLBXTL     PQPMTBEKCJSBGVN TKCNGOFSSH      BUHCJIFGSCYVDUE HHPKFANSJJATQVV AIGAH           BAFLTQBJ       
PGHWHATSHP      : YOVNL           MCUUCSXWHQ      ARLFGYWGR       FLPPC          
TXPYGKHMWRFOT   : YWKS            QHCMLIAF        OJYARQBXW      
TSJMOWEUGDDGW   : NYKSA           BMBSRWCTSOS     RBJCD           FEVWKAPBJ       HGPSNFKAA      
QNJKNYJ         : KMLBSRKEOOOA    JPNYFIVVCMUCAO  QPQVVHOIHFHPKNV YFRFJHKI       
MQJJIQAEGTYQ    : PBPWBLAMQLPEJO  TQOKRT         
NPMKXPPGPOWD    : HNHLU           PYAMVC          WNWRFAOIHSKGQ   DUFIPFPBHGY    
HQCQ            : DFAMCDVMYHEIIBN AKFBVWYLPUF     EKMVQUTVNFSHA   RWTRYLVDTS      NLWRNJWRS      
OJYARQBXW       : MKVIDH          GNAVXUYG        MSOKBBCN        TXPYGKHMWRFOT   BNCLMDNQGML     BVIEVIAMJAQOA   JLACQXSGNE     
WPGMFSXDLNKB    : XRHU            OOSHMIXJFYHMMB 
JGFRY           : LFWTGCQOUSKPU   PCQSOLDT        VHUD            SHGUEEUFN      
KNXUMX          : MVVIICOVX       RNWDKACUEHM    
FBNDYMSFABAXGN  : ANCTTTN         NGODLAJSKDCMP   UCLTBWIB       
SOSDWAUWHHMH    : PQPMTBEKCJSBGVN EKIUDLSF        VGCW            PEBSLBBUQJDQ   
YFRFJHKI        : BHQLBUEBF       QNJKNYJ         DXEVWFC         INQSTGG         OYUIEEUWRASYDPE
FPVGPT          : WQKIY           TBMDIH         
EKIUDLSF        : NUHSJHBYL       QWKMKVMWS       XPFQVS          GUOCB           FRFSSMJXYCHTN   SOSDWAUWHHMH    EUMRKXUVXCRG    ODOIJDHNRWYVMOX
EKIUDLSF        : IAGWFKHNVIUTDMY
ROQEVSDBMK      : HORWIK          QVSEMIMXRBJHQLS CQUOPH          EARR            KCGBPHOIVPAWF   IROHXT         
VUUSBKOJD       : OVXN            MWJCAHFBKNFQL   SQGGSIUNGB      VERRBLDRYVUDB  
YHVIEBTW        : WHQUTTCGWGJKG   OSIWUN          MXQP            PYQFHK          NGGKDHPWYPXSUBJ
DQUV            : DNYHCROXPMORLR 
QOBTELHC        : GGUODLXC        IKWFTWFBCSCVC   QBAKWGU        
EUMRKXUVXCRG    : HRKPUGQMKNXV    GYAOILPAFGST    EKIUDLSF       
SAGBFWVBS       : QARNRHYLA       AWLVNJQJYXD     HSGEKMYHKRB     NXNLXER        
SVIY            : HPQCNV          UEWMCVXMAIPFQTS XTLGFFRMAXNNPOA
PBSUWH          : AYVII           DIERGJ          EBQGOMPAOMQKK   XDUHOGGBHNTH    QRVINXXESFE     XFEEBORTE       XEPP           
JGJFENYKT       : IFNTWJEML       QJIN            HASYQRWK       
MCUUCSXWHQ      : HIFWOATYDMU     PGHWHATSHP      WJDRKSQJUFSKEK  YEEBFOQIINQVIJ 
PRCITXFSFT      : WHQUTTCGWGJKG   VCLGIQGDSOWV    GBGUGKBT        UBKOJDHV        LOBHIIJRYUF    
LDJRQIEMERRYOTT : NPKEYKB         PXLMNYAPEXVXE   EVHSPCPTXJ      NUEWFWHVDFJLUF 
SBGLSXNB        : YUGJXAIK        QAAHRCQUIPX    
NIMTC           : DXCUJHE         HNHLU           OBDOTYMIQFWVWV  GYAOILPAFGST    DBIUUIDF       
HHAAAKEPO       : YSVPTSDQMOG     HYXJG           YQEXE           PUSBSEQ        
HPMDJCVKIHGGWHD : YNRTLIPADSMQP   NLWRNJWRS      
SRHUJ           : FTFUIL          PNLKWSBWGHAPQG  XBJSDCFOI       WYJUMJDD        BSVKALYAPP      JMQEG          
FLQFYXUNXE      : RUECIENSMOFCS   FVNPNRONMAGE    QAAHRCQUIPX    
NHNPDBXM        : TCOBVSDKGVDPUY  OICXFUUHULD     VJOCUN          QLGCEFUV        DQWFEVUNUIWH   
GMQLAJEJHPAMDTR : NNQGL           ILFKHHWHIUYJ    XTLSVBYSY      
TPQRTWHC        : PKSDRDQQKI      LMFEGBVRS       SRTJ            SWIB           
WHNWWUG         : APRXFA          TEXPDESSNOULN   SCRGPJNSLAXTIXK LEYVU          
ORNXVWFLWTPSO   : VGHSQHNSYTN     IKVAFPHENTBQRRR
MEKHAHO         : BSPAOQCE        YLFGETKOXHSBJ   JYVWN           PUFNEBVNGQ     
UMMKLLGRYWKMU   : KEQIWMYGWWKU    VDFWVGXBDB      DMMXUYWP        UURRQHLLYYLN    FCHCH          
JDUIWMENGQRRXS  : UJTUPMOANA      RRYFVAUNUNHSJBV SVVI            ESWUOAAY       
NYVCL           : JLPDQKERDRLUMW  ORSST           UGGKRAK         AWFLSFECCQXSMX  QKFO           
NYPGXOSKJ       : WPWMUICIKFSPO   PEVXEFSJC      
VOVHOILCP       : EQHG            UBXOTDKUTBUINWW RIIWCD          YXYKRSCIX       FQTALGOVKWDHQKY OMBDNJVDENFD   
WJDRKSQJUFSKEK  : VMKPOHPRLDFL    LPRUU           MCUUCSXWHQ      XTLGFFRMAXNNPOA
FYLRKLOCJXQUJ   : DAUDPMPGIYL     CYGGJWAINGXV    SMLUXYQDOS     
MNRVSJILBTI     : STRQYHHMKFIOW   VKTXRMA         IAJTAFORRRWP    SFVXRLW         PTQPFOCPBQVF   
OTMYMRAYKNM     : JIEOPWSPCRYJY   PMNGSF          GOTNJLNQAJV    
PXYISKD         : HHYSTYYQJ       HXQUHOFK        PYAJRVTBIM     
AVBTHM          : KMLBSRKEOOOA    OTAAVTQCCEMX    ACMXFN          ICPRN          
IGQQVMEW        : PGJRCFQWAHDOST  JUMKN           EARR           
VAAIP           : RYGKQ           ALJTKFSVQ       WAWRFUPYGOV     DBOSGWSDGJIBU  
JFNKNGU         : KGKIGN         
MXQP            : VXSA            WNXIPPJCEEFF    YHVIEBTW        OCAGJERUWEPLJN 
YCBHLTYJIFIK    : LXVCG           ARLFGYWGR       HWJDQ          
KMMAC           : FCQM            NXOK            IJQBUFUUTCHVK   RTPYYF          EMSNBJBXOSIBH  
FRLUAGQOGHFXGJC : VDPYE           DPCIRLJD       
WXPIHWRRACE     : PKCVTEPTCJ      JVHBSJRTN      
DIPKCBIDJYRQIYQ : RVMTJQPRPFOXUE  XDUBUXUQSI     
LSGKRXTYUN      : BMNMEUBIHV      LQSHYVNSAS      GDMLCGBOSBHL    RMYUIQ          FPCQYOHHBC      IUCICBTWYCKXHSV YHXLTF         
WPWMUICIKFSPO   : WHQUTTCGWGJKG   YJSTQODDMSM     NYPGXOSKJ       XPQVXYYMUYWB    BIGKM          
KFCLYRYRAKLXGMU : JCUL            CPDELESLAJGUKX  XGTQ            GEHWYCUMDA     
FSLFHJPLR       : XVRJ            PKMNII          YBKUGKVGLHA     JMPYIXQTBSR     DTIXMCRI        LJLYPNVVCD      AGTQNKWOGPCETYJ
QKSFGDNIQMDQ    : YKOOCXHCIQOYT   IGETS           FCEU            CLLLXGF         SOTYQBGHXEVUSV  GUPMMXXCSYJLM   FHSKSLKQPE     
FBUGJHB         : GNSGWXHULN      FYMJEIR         WJURI           JMQEG           FWVWDDMSGCAQC  
PVOWDX          : UBYLXABHWEHIL   YXYKRSCIX       TTIBFW          SEDAIQRIDLUP    COUVYLIOBFR    
OROHEJ          : NDTMTD          JEKAUFQ         DUAENJRLMY     
KODVGRYWA       : NCPHLKI         WGYWJRMHQSHRQV  DPNLHLEHL       NELFWDTBAHTSYM  PGQUKSYUNLAWA  
AUKJ            : JPDAXQQAVQUVYEC WAWRFUPYGOV     QAAHRCQUIPX     CFTNBYSOH      
OOUKDTQE        : UXJMRCUAFR      VSMDMNUGVM      DJYRGAGOQLNOKL 
FVWPBJFNXKJE    : RAVJUWCT        CRRVVUXSQQOEKV  IJPNJWSWDANBCCJ JBGCLM          NFGTWCGDY      
KDCPFAC         : WISNLVBGNJYV    MLTMTOYKT       NTQO            WUIQYB          OBDOTYMIQFWVWV 
FQDAEJ          : JPNYFIVVCMUCAO  VHIAYHJIPS      TTIBFW          GPQVYVIQOL     
UPCCLBROKWFL    : PBPWBLAMQLPEJO  GVNM            CQEA           
ORLAVQ          : XLISK           BUTBSNLRYYC     OWURLVBVCCQXH   HYGDTTGGTCGRU  
BQVSVNXVTJROY   : JNDYGBCHQEHJK   GPGLQ          
SNYLCKIJVSYNE   : IYRUX           DQWFEVUNUIWH    FHJYBKXTURK     VHIAYHJIPS     
LUSPLOIJE       : FTFUIL          AXJWPPDXLTD     VDFWVGXBDB     
HASYQRWK        : MGPIAWOMDSKD    TGPGDEIXPRPYS   NNYUTLHX        JGJFENYKT       YYSSVSAOAIR    
WVKJGTHYUWG     : OUHNPYDD        DRCSWKTRGUTKI   YFUJ            YBQVWT          GYSGHCSJKW     
JDSYRKJBQT      : YLGHHHOVCLGN    ACMXFN          BPRBBBNORALL    LXVCG           YUWYOF          QGUUUPRLGRNRT   ITFUEKQJORAO   
RMKI            : XVRJ           
ISMHOYQXVXYSUHR : VUKEH           ABOHLI          SUTFFBRU       
LKHDUQGMNP      : IIQOAK          IGDJOJKEUIKRVCA CVVYDGQAME      OBAQJLW        
ABOHLI          : OYVQNTXRIVWFEMP FTLH            ISMHOYQXVXYSUHR HUJXAYDPHIKB    BYCQWVERTFQNFJV
SYXJYTJYNEGHLT  : HRHNKGMSABKOG   JERK            YOKB            DRCSWKTRGUTKI   MKPGDGRUBRN    
SWPMGEAVKCYBM   : VEFTAFMUW       GOJULKCANCMKQW  PYWCJVTCJSR     KVDLHJFBEPMSK  
JJFLJQMGC       : LTJFTNAMD       ECGUECKDEX      SFCPSPRPPAOSSH  DUFIPFPBHGY    
VHUD            : RCKVAVUOVX      JGFRY          
OWPO            : VCSYBRXKWTCN    AKIFIUF         RDYDY           DYACXFAKKOYJI   RCEPMLHLGO      XEVQVRYHF      
EUSGSFLSHXHSJNG : YHUV            POCOY           BJBUBA         
GTYLHU          : CBCKYRFME       YJNGUUKBRVEAK   KDBRVC          RYJBXYCEHL      DTHSIRMBYQ     
CAPRXHI         : VHPEORVFACN     DCWVYUTVEXMYD   KKPPMEWUXL      VWFIVAOVB       XFQJEKYNPONANQO
ODIUXNGQ        : HEWUN           UFHNFQUGNQCPH   TEXPDESSNOULN   MSASCY          DMMXUYWP        LHTXHACLNBXC   
GYOPOW          : AYDOG           QPSXLHGJBWDJK   TLFKMQLK        GPPTUM          XIFGOHGULGNW   
WQKIY           : KDMIUSDUBQLRC   QUECMLJBBTBP    OKONDQUKQBILV   FPVGPT          BWDVRHG        
DBIUUIDF        : GMSDIRGMSBLEMH  TDMJFVTKE       SOASTXLQS       NIMTC           OTQRVAU         EMWJYJPRMBNYA  
RKEO            : YEPW            COUVYLIOBFR     HVHYIQ         
TXCPEBGWRDIR    : YWIJ            KCGWCILJLUOBMG  CTODFLKVIB     
SCVDGYMDW       : NMCQUHBB        TGEGDJFVPBVINCM IHGGPQ         
ICSCN           : CXMGUAITL       EJJRMBXUNW      XNXFCRGJYWNXE   SFVXRLW        
RWTRYLVDTS      : DFWDCQUL        HQCQ            TJFNSPSLLXKWDJ  EEJHHDDMW       XXXLLPCNHGGE   
YBQVWT          : ORSST           RJTJHSVSF       IUCICBTWYCKXHSV PSISPBIA        WVKJGTHYUWG    
CCTQFQOOUHSKJ   : LTDUDYCAFSENY   STRQYHHMKFIOW   YKSXOSPPEYPG    GVLQMJVSPW      MOTUIRGE       
JFEJQBOMVNLAF   : SMSRYLBPWMTG    LUHKL           NATQN           RIXTHN         
YYCBB           : TYFDAHNNWLYFPF  MNWQWITFBQUJHV  GLMKSOVXXC      RNWDKACUEHM    
UIOJY           : YYBSHIVKORH     TOISLNVNRKSYJIT OEHGVU         
SSUCFFJK        : BDIEN           MKYHGNVSB       FQTALGOVKWDHQKY NTPQJRVS       
ANHOL           : JVLPGUUNDWQOI   YHXLTF         
BNCLMDNQGML     : OQSX            MWJCAHFBKNFQL   OJYARQBXW       DDHPSDIPL       LWNQYRILK      
DWQPPLNURU      : DJSKDEIYLRXJLP  TGPGDEIXPRPYS   QDDQCI          GPUV           
ELHTUVHTYVWKI   : AKIFIUF         FWTORHNO        DUAENJRLMY     
BBJNMB          : BDIEN           RCBAUSSSNTHDBY  GSVUIH          LJLYPNVVCD     
JTJCGWWARDGFM   : VJBLHTHKHS      FINGFUKYQYUHY  
ALJTKFSVQ       : QRVINXXESFE     VAAIP           CAWDHRXHEPX     NKURHIQKQGVLHPS
YRHMFKFQEOUMLTO : APRXFA          DIERGJ         
XUIKW           : DHYH            CTMUAWTRH       JIXWQO          FRFSSMJXYCHTN   YPCHVMUWDWY    
XHHJOCHFAGX     : IPNG            BTCCOXDSSVCVY   GOLMKUJB        YHVCBNSSNJVQ   
UFTCXBTT        : BOMVVXUSORWR    JYIYGOJOLGWRTR  IYCEAWHPCQQDDO  VERRBLDRYVUDB  
HNFLLAVYAJYJSIX : JOONVDOKLM     
PEVXEFSJC       : SRDQICXP        BNCOSITJC       FUEUATDN        MBGBD           NYPGXOSKJ       XEIAMKJRTVP    
HDRBSYR         : PXTLTRX         TKVXTAAPWYRK    CUWQDRSMDQNCJAK ERMSDHERGNN    
MFBLGBWGK       : KDEDKXVCMAI     XKTBXOX         WDMMJDNPA      
OKKHOIFSQBE     : VJLMAN          VDPYE           RNDQWONWJAPVC   YERFMSD        
BOXSPS          : FYMJEIR        
JTHPUSVXPCKHR   : EQHG            WGPAFPEGXESIUR  TVTYQF         
TBMDIH          : CACA            FPVGPT         
LOQM            : UEWMCVXMAIPFQTS RUVFO           RDHKSNFTHDWDI  
QFSJAFDJUACQ    : QLQQBV         
TVKBPIUQWABGV   : JWRFXEUCGNTVBG  NBIQPSRAYQRIY  
UOAX            : DKMELPASP       CYWPXUVTNXAEV   HXOTKXISD      
ITRKYUTTXXMXRI  : VDPYE           SXFQPESAVP     
SXVPOUQQB       : MYQWBGQGFNN     GUPMMXXCSYJLM   MIXINSDULSCVQNP
GWEIUJQOBDNYW   : GWLPYJS         RCUUUMTTTOOLTI  DCWVYUTVEXMYD   RIXTHN         
YUWYOF          : VOYDMXJLHJ      LOKJCKXWXEUR    JDSYRKJBQT     
JEKAUFQ         : IPNG            WBMIB           TJHGQ           OROHEJ          HLBMGVSJGGGXVI 
HHTELD          : KEQIWMYGWWKU    PXXKIC          NKURHIQKQGVLHPS HWNWBVDCKSMI   
XVOBAECWMDUJDJ  : YVYPUSO         AMFWVXTQNW      SFNBXCOMTFLTU   AXIUNFGC        GLGGP          
RTUDVQIMEP      : IVOTOQFXMQWS    HAXRQHNNRKWWRI  PNLGVAFHCQXF    VDBVEQHISJLG    TAJNEPHB       
BVIEVIAMJAQOA   : MMMPYTDPU       UTRIPWVQBAHXUH  OJYARQBXW      
RUQW            : WADATF          RDRVSKFD        PUMGUEB        
IPCDUX          : HYVRLSXGUYLJHE  NGGKDHPWYPXSUBJ RDHKSNFTHDWDI   RDFFTSRC       
DMDVJERRKPA     : WLJHEEKVLA      RAKASDXFWWST    FKAPR          
CLNTCNBUKSTSBJ  : KIJCCSU         XTPPTFTKALA     CYWPXUVTNXAEV   VNHKUS          KDBRVC          BBRDSLNRAMHJAI  RCEPMLHLGO     
GETDK           : XNEJSSKKBKFMO   PSMCBCIASYTTD   YLFGETKOXHSBJ   JMFKJ          
IIQOAK          : RGKHEVCTHYU     MDAYBQMMUBCCQ   NCACFGTOBAJBSSR LKHDUQGMNP      TYCLMEFI        BJCKSCIDUJPTIYR RXQRDNVM        PEBSLBBUQJDQ   
SMLUXYQDOS      : EFDWRNSBFLL     DHCQCTLMAD      FYLRKLOCJXQUJ  
BLTUOGQUMM      : RSRF            NYXWUAININKDQ   VLVJFBRHNGRGE  
WTIFMYI         : DADXWQHY        DAWKJHFYPI      CQUOPH          TWSBMTAJPCT     OBAQJLW        
XDJM            : NFUELWT         ATLTAQKLF       AXWHKED        
KNRNDMNGAJ      : HIRNIDXGNYOYR   NYKSA           AYVM           
OPTLDJMAFWISWS  : RHNKHAGUGBPM    UASGW           LMGCYVWFAFN    
UVEJVOXPEBE     : IFXFYMGDEVATOM  QCPETS          HWUURWXQBW     
JEDNU           : IDJEXOUOPGWVY   NDMHTG          YOVNL           IJPNJWSWDANBCCJ EARR            NCJOIBISJVJF   
HHYSTYYQJ       : AOUAGJTYYUMHUW  YEMEHRK         PXYISKD        
PELNCPWBGU      : WBMIB           SOEM            LJSUF           ERMSDHERGNN    
MVVIICOVX       : TRSPDKIVCNMA    KNXUMX          DUAENJRLMY     
FHJYBKXTURK     : XBVBFL          SNYLCKIJVSYNE   QNHDMRQCVCBHFYL RPVXXLBJGPIC   
DXEVWFC         : ORSST           ANSXFXSUSAJWI   WGPAFPEGXESIUR  YFRFJHKI        YAYIXYHDQPN     ULAWVAYJSS      HSNYFC         
XPQVXYYMUYWB    : YEJYDWWYJCIWUQ  UGGKRAK         WPWMUICIKFSPO   GTOVRAT        
IAJTAFORRRWP    : CJTCPGMS        VRXSB           FTPDTBQOXMLYOVL YBKUGKVGLHA     MNRVSJILBTI    
UNDXICPY        : UGGKRAK         FCEU            OGRK           
PYBF            : LJFSGYKOQJN    
AEWINYRHYXXSP   : BUHCJIFGSCYVDUE VJBLHTHKHS      PUFGLDN         KVJULEAWDOHLQ   BMNJUVTBWDFOEBS GSSX           
SIONXRN         : GSVUIH          KSCWLOWTG       UCLTBWIB       
VDFWVGXBDB      : QSAFMSE         HXOTKXISD       UMMKLLGRYWKMU   LUSPLOIJE      
AJUCEEBCCWTUR   : UENCA           BWBTYSYSUVWE    YEJYDWWYJCIWUQ  DXPTK          
LFCDTICYQB      : CGRXXPJSFYBWUFI CMHTMNEIIXRW    DRJBKCVGYMVFP   GTDUFTFUAMNCA   DKADUOQQU      
WBXCCGDOBFSGI   : XSAUHOADBDT     IBJFLRWQOO      OFBJNQPMEHG     NMNGLRSXTLVPETL UFLJWNHTKTQEPFV UBXOTDKUTBUINWW FDUOHFJJQNGAFD  DPMWGJMAIDNGSW 
WBXCCGDOBFSGI   : JLPEWBQDHP     
KHQHYTSFXY      : OVDBDSMKPAT     LICDGUI         XNXQCYEVYXS     MPMBY          
HBCACXYDVCICHW  : AKUJGRRETOGICC  LICDGUI        
ORMYM           : POCOY           VDWBMCUHVRFUWIN SQRF           
HFHGYANAYQJ     : YERFMSD         BJCKSCIDUJPTIYR CNJIRN          PTQPFOCPBQVF   
TJGTKMR         : SKEKLCA         KLXCQKRHME      BOMVVXUSORWR    NEPU            TJCTBFGEJCGHWIR
UWVTFKLTMAS     : MGOIIHNK        JGGOAJCNWXDK    BIGKM           YPCHVMUWDWY     NGGKDHPWYPXSUBJ ERBUCE          XKHEBKKYP      
FCCHDSHELQ      : QSAFMSE         NAIYIEEXBGB     SNEMXTACQUCBK   CNUEJHMOQMBB    UPYXSVOEAHRGXU 
HCPBMCVCYU      : PWUVNQF         VNSUTCHOOKO     QYXOQFJVSQERSN  RFTC            EMSNBJBXOSIBH  
UALITX          : WJEWHGI         AYRKG           TSBMX           QKKEPQPDONBK   
OTQRVAU         : LXVCG           SIFL            DBIUUIDF        FNABIQPDXFLV   
JBDAKKEDOQHKUH  : IJGMNQMG        BOJRECSPMYBN    GYAOILPAFGST    TFKMYEIAGONAR   YYJUVENO       
TEHHNBHXRBQJY   : OXVPVBBRRDYQE   FBLETSSRNMOL    GFAHNRCFJ       PSISPBIA       
GQAIVCUGIAUAI   : JRBLWCKYLGDBT   MLCHASPC        ELGQQBVSGHNNW   VXWRQVH         KPRGSGNM        HVHYIQ         
UROQVXALBHMTIDD : LQSHYVNSAS      TKVWBF          PWGQNECGCHJPGGP XDHTEMLRRFRI    YYAEXXFNGFJXTI  LUIUALWFFCLA   
WKDY            : TOISLNVNRKSYJIT DCWVYUTVEXMYD   OWURLVBVCCQXH   YHVCBNSSNJVQ   
YERFMSD         : JVHBSJRTN       OKKHOIFSQBE     HFHGYANAYQJ     SNEMXTACQUCBK   BJBUBA          LWUHWUPRGRNLBW 
DMMUEDSCGFENRAY : VHNDAQAGHAW     CQGGUQ          QISJOD          AFDLEHPWYMGLI  
DJTPMTMLAFSM    : TUJUGDGLP       OABYPNNW        DTHSIRMBYQ      QDDQCI         
XCDNOARTSVAAC   : BEYWCITCPNJEX   SBVDO           GXTDXXNT        EOUOU           TANIEQJESFAF    CSTWUMATIM      GVLQMJVSPW      FCHCH          
TCPRIYNXN       : OIUOPAGKTSQIOVT QWKMKVMWS       OHSNIXIOQFNIVE  ANAEH           QGUUUPRLGRNRT  
NBJSTWUUYA      : TUWXGULYTFHHQCW ALEWUBRNS      
PACJUXM         : KLXCQKRHME      WLSNGSSGXKQKY   FPCQYOHHBC     
BBRDSLNRAMHJAI  : YHUV            BGJRHCOY        QKHPWTCT        IUCICBTWYCKXHSV CLNTCNBUKSTSBJ  PYWCJVTCJSR    
UCQRYRRHHTJ     : VRXSB           BSPAOQCE        RIGD            COHQQIX        
QKFO            : MGPIAWOMDSKD    QJOTHFVLPBI     PYXKVMNNDRWMPVX NYVCL           OBDU            UFANSHDUGBOF   
IJQBUFUUTCHVK   : QHODO           VPCQG           UBXOTDKUTBUINWW KMMAC           BWDVRHG        
QNTKMLCWU       : CPDELESLAJGUKX  QTXG            UPYXSVOEAHRGXU 
INQSTGG         : VEFTAFMUW       CTMUAWTRH       HTHXFCKRFMGHYS  ATXURSIPUO      OKONDQUKQBILV   YFRFJHKI        GPPTUM         
PXGMFB          : YXHRMPMEL       DPHIMKMFHBNFMX  JMXU            XPQRMHGYQD      MXMCS          
YEPW            : BWBTYSYSUVWE    RSTSCPBBXF      BCIMPXJGEEGBBF  USKBPSO         HUWEPX          RKEO           
SNEMXTACQUCBK   : SNNG            OYLAKOCJAXHSXI  CTMUAWTRH       FCCHDSHELQ      YERFMSD         JINQHJLV        ODOIJDHNRWYVMOX
UEBBJSBRGISQJY  : GSUORJOLHAQHI   NUHAENYUSG      VLVJFBRHNGRGE  
GOBVUNVONXHKCJ  : BTQKXWFCQFKNA   JYQKIS          KAOYGFE         RNDQWONWJAPVC   HDKAYKPCQTGNUSM BYCQWVERTFQNFJV
VGCW            : KNKMG           SOSDWAUWHHMH    YKOXESTGCILURMA
NQNFWVXNIXVOOWN : RGKHEVCTHYU     MLCHASPC        CSTWUMATIM      ROWWP          
MJBCKIMMTJIALI  : GRFLYW          BYCQWVERTFQNFJV JLACQXSGNE     
YYAEXXFNGFJXTI  : IPNG            YSVPTSDQMOG     OTCSMNJEARQ     NMNGLRSXTLVPETL UROQVXALBHMTIDD NGGKDHPWYPXSUBJ NUEWFWHVDFJLUF 
FWUGYFRNSLWDOJL : UUXWQKGWBSKNFQE RVJQVRKLGSFND   AXIUNFGC       
KKDPKDWX        : OTCSMNJEARQ     RSTRQFWHAWTIORS AIGAH           RXNLOIMNGIGRB  
CHKXRVDQSMPBE   : JLPDQKERDRLUMW  RKVKSIEXKIX     IFXFYMGDEVATOM  VHPEORVFACN     SIDFYSLBXQLE   
TRFYIQLLBXQSJW  : SPYEAVV         YJHWBTKKPQ      HSNYFC         
HJRRTPLRVDKI    : IIEVBYBTFXF     JLXNN           CTMUAWTRH       BAVEYEEMAKGFQW  RGLXLNGEHOIS   
LOBHIIJRYUF     : WYIFUPORHTFVS   AKFBVWYLPUF     YYBSHIVKORH     PRCITXFSFT      LMFEGBVRS       MKVTKSUGI      
SYTE            : FLLVERVSK       DHLAYCFYNAC     IHKQCPP         FRIBKM          FCQM           
LMFEGBVRS       : TPQRTWHC        LOBHIIJRYUF    
WDCSRQVB        : VJLMAN          ILWMAHQXOEKT    UGXYWHSTSQR     YKSXOSPPEYPG    QYUOPNO         FQAUR          
EKTDHBFB        : USJLHURXHE      PIRPVCIWGCXQB   RRYFVAUNUNHSJBV ILYRIUOCF       AGTQNKWOGPCETYJ PHTK           
YHXLTF          : VHTA            NQUWJVGVATVBQ   TGEGDJFVPBVINCM LSGKRXTYUN      ANHOL           HWUURWXQBW      EMSNBJBXOSIBH  
CGNWY           : IALKNDPHMRRBIOD MLKEQWDQTAH    
TFKMYEIAGONAR   : HEWUN           MPLOFPICLYQ     AGFTWULUPLTIX   PXXKIC          JBDAKKEDOQHKUH  JQUTAFTRAYRDCP  RWBURWQTUPNVQ   FMTMWQCEEGV    
BAVEYEEMAKGFQW  : MCQBIG          PXLMNYAPEXVXE   HJRRTPLRVDKI   
SFVXRLW         : MNRVSJILBTI     ICSCN          
TYCLMEFI        : RAQMDSWRBULNA   HBNWWDBFBLWN    CTODFLKVIB      VMKPOHPRLDFL    FTKDA           IIQOAK          PGEQNEU        
FGOFMSTPDB      : EUALDOBRHY      ATXURSIPUO      EQHG            PSSOLAOXSRUFIR  JLACQXSGNE     
WAWRFUPYGOV     : WWEVX           VAAIP           AUKJ           
NAOBFTLPAR      : UGOXNOSDQHQEA   HCAF            IMNOMTTP        SRTJ           
HFWDUDGR        : BIXNSBBPXERD    ITFUEKQJORAO   
GOTNJLNQAJV     : PTCEU           MVPLJPW         YFFOLQ          OTMYMRAYKNM     MNKSLGPJWDBD   
LKSSEEIGWMNEMT  : VAOG            FSIRULOJC       KPRGSGNM       
RAQTHHPUSBI     : BJBAKVUGRUXT   
DTHSIRMBYQ      : SNNG            GMSDIRGMSBLEMH  GTYLHU          DJTPMTMLAFSM   
FPYV            : DPCIRLJD        MWJCAHFBKNFQL   FMYXNBCPNIKMO  
NPUFPLBYUSWOVFC : AKUJGRRETOGICC  KYELWWYVRSD     OQSX            HAGVCBPSQP     
CKUKEHNDAALQ    : RJQWXL          HDQBTCUSDYYSV   ITFUEKQJORAO    FMYXNBCPNIKMO  
JMPYIXQTBSR     : VHNDAQAGHAW     IFXFYMGDEVATOM  DHYH            UHTYPTIPCEHDBJ  LSDAIHMOLVUVQY  RBLUNHELSV      FSLFHJPLR      
PGQUKSYUNLAWA   : VMKPOHPRLDFL    KODVGRYWA       WVTSLSR        
WCSPE           : BBLRQHSIQQGXWS  IVOTOQFXMQWS   
DUDLUWH         : LAMVHDMVDVHPKUO VFJPCEVGVRLYLP  LICDGUI         XNQY           
PYQFHK          : WLLPCLHVJYEFQTD FDHQOBWM        AGFTWULUPLTIX   HCKNGDTWPLXHAQ  YHVIEBTW        IRXJVHOGBV      BREQDGTMW      
SFCPSPRPPAOSSH  : OBXFA           JJFLJQMGC       DAQWKSEJNBBMA   BJBAKVUGRUXT   
XKTBXOX         : YOIGMRRSIDYSB   MFBLGBWGK       RBDMMUMGUQU     HWUURWXQBW     
NPHGUQQXLVCCQR  : WMUJBL          EGYLMHL         DBOSGWSDGJIBU  
IKVAFPHENTBQRRR : QQEKJFGACCAGGN  VDNBBEQUSWC     ORNXVWFLWTPSO   WSQRTYCBTYYTHD 
FHGM            : RGLABIUG        RUNK            LDERS          
AFDLEHPWYMGLI   : YUQGHU          DMMUEDSCGFENRAY PHIEHCLDHEVW    YMJPNOVBD      
SAPXP           : WLHQS           RHVF            SAIRYCCJOBDBR  
BJBUBA          : GBGUGKBT        EUSGSFLSHXHSJNG YERFMSD        
IJPNJWSWDANBCCJ : FVWPBJFNXKJE    JEDNU           MRJNHJFSKOVFRX  CSTWUMATIM      IROHXT         
MRJNHJFSKOVFRX  : MJKBIPUWENHLROC DUWXDEO         DAWKJHFYPI      GVNM            LJFSGYKOQJN     IJPNJWSWDANBCCJ
BHAQSXKQBMGEO   : CYGGJWAINGXV    XWFXFLJF        WJURI           TDCB           
NFUFOKOXSHKJDRC : UKHYBGJEPEFE    MDAYBQMMUBCCQ   WSQRTYCBTYYTHD 
BFLDVHBIXFVGLK  : PPANEQ          FCEU           
ARLFGYWGR       : OUHNPYDD        PXLMNYAPEXVXE   PGHWHATSHP      YCBHLTYJIFIK   
QBMLDQMI        : RRNUJO          JRLXLSKHFGFA    RBLUNHELSV     
PHLTPJBNR       : NNJPFAMP       
BGMSUUCTTINACOM : AKUJGRRETOGICC  EQHG            FBQJTBJRGDUUDT  MTCHOKYND      
UDCFITMTPFGQS   : AWFLSFECCQXSMX  GHJVRSKWPTG     VERRBLDRYVUDB  
EVHSPCPTXJ      : YUGJXAIK        LDJRQIEMERRYOTT
LMGCYVWFAFN     : OXFYK           XJFKHV          OPTLDJMAFWISWS 
THKYP           : MGPIAWOMDSKD    WGYWJRMHQSHRQV  GYSGHCSJKW     
UOKSXDIAVEAH    : WISSBP          TTYSDYTMCKCP    XLVAILOIVIXCFG  DPMWGJMAIDNGSW  COHQQIX        
NTRPVOPBQUOL    : FCEU            VCCAJRTFTA      HUWEPX         
XYSODNFN        : PYWXEHXOBEPBGPS AOABYLOULID    
DSRFQVHYH       : WCTDCMG         KUUINYCFUB      UTVMKAWGMLEQJ   XRHU            UURRQHLLYYLN    KVDLHJFBEPMSK  
UAKQQCRHYGV     : QSGDDWRMMLA     LEYVU          
HUJXAYDPHIKB    : HRHNKGMSABKOG   XRAYTGCGTG      ABOHLI          YMJPNOVBD      
CAWDHRXHEPX     : VHTA            IFLPROXOQRPWJTM NLUDEYMQ        ALJTKFSVQ       BMNJUVTBWDFOEBS HLBMGVSJGGGXVI 
HGIQ            : POFAKRKTSAV    
YAYIXYHDQPN     : XUTD            VCCAJRTFTA      DXEVWFC         FLPPC           FNABIQPDXFLV   
QDDQCI          : BVLECJ          JJOVYBPQABSPVY  NYODAQDPEV      DWQPPLNURU      DJTPMTMLAFSM    KDWIHBJDBWETDJ  HDKAYKPCQTGNUSM HLBMGVSJGGGXVI 
VHIAYHJIPS      : CRRVVUXSQQOEKV  FQDAEJ          SNYLCKIJVSYNE   HYGDTTGGTCGRU   GPUV           
TTYSDYTMCKCP    : UOKSXDIAVEAH    OMBDNJVDENFD   
VUROWAPSJYVIIHR : VCLGIQGDSOWV   
CSTWUMATIM      : UEJVYHOE        ONEJEQOTRDDJA   XCDNOARTSVAAC   NQNFWVXNIXVOOWN IJPNJWSWDANBCCJ DTFWD          
SRQGNMAE        : SCQMXUTVDF      QVSEMIMXRBJHQLS BSPAOQCE       
BUFMV           : UGOXNOSDQHQEA   SRGLAI          YOGVIBYPUDK    
VEKNENGX        : EERMKGGXFNGLD   KDMIUSDUBQLRC  
DMMXUYWP        : EBDY            EJJRMBXUNW      RMQH            UMMKLLGRYWKMU   ODIUXNGQ       
NVICWNM         : OWURLVBVCCQXH   XMBDEPXJWEDGRQ 
ITMGWI          : SOEOLQXKREUV    UOGRFTUIQVTMKDY WWEVX          
HXQUHOFK        : UGSEQSXONJVMFD  VNSUTCHOOKO     PXYISKD         ANSFQTDDKGHQEOM
RIXTHN          : WNWRFAOIHSKGQ   FRVJJGCWBRQTX   JFEJQBOMVNLAF   GWEIUJQOBDNYW  
XLVAILOIVIXCFG  : RCBAUSSSNTHDBY  UOKSXDIAVEAH    SEDAIQRIDLUP   
PFFKOVSYYMK     : WYIFUPORHTFVS   BHGYNLWEWLR     RYDYCV          XXXLLPCNHGGE    XGCYPLRD       
GTOVRAT         : TVPECP          XPQVXYYMUYWB    LFLVDWTFE       UPDWDA          XKATUTWYKLNTXT 
LFLVDWTFE       : XUTD            XSAUHOADBDT     FUOW            XSFMAHPKMIRVQA  DLHILWHOUHLP    GTOVRAT         IAKHIW          FHPWGMBRJVT    
TTIBFW          : LYSVP           JIXWQO          PVOWDX          FQDAEJ         
AXXMIY          : HIRNIDXGNYOYR   TEUIBP          GRHFPMHO        JMQEG          
FNRYPLT         : MQXSEQKG        QSBEUNY         QUECMLJBBTBP    XNXFCRGJYWNXE   CWNAED         
SIAVFTDLWYGHAN  : BBLRQHSIQQGXWS  CHIOGERUSGFQQ   JLMXTNGJELYMHDL
YNFYAPXVUNN     : BUTBSNLRYYC     RAVJUWCT       
FBQJTBJRGDUUDT  : RRYFVAUNUNHSJBV YOSHGDMSTS      UUPDADEOIEF     VSUELMXNNMJYGQN BGMSUUCTTINACOM HQEOCIVRJA     
KVQRUGWTIMTFKHU : NEPU            JQUTAFTRAYRDCP  NUEWFWHVDFJLUF  COUVYLIOBFR    
NYXWUAININKDQ   : OIUOPAGKTSQIOVT UFGXKB          XUQHLXUHYYQADPX BLTUOGQUMM     
GCDYTYFSUOHP    : OIXEFXMXACPIUH  QSBEUNY         FRFSSMJXYCHTN   FJXMGBHIAVISXJ  GHFUIVTLEKSJ   
TWSBMTAJPCT     : GCMJ            WTIFMYI        
MIPSYWYDDBY     : WTJOKIIGOQMW    THNNHOGYVQNXCU 
GTYWCO          : NAIYIEEXBGB     HYAF            IQAJHSHM        AGTQNKWOGPCETYJ
VOOXB           : PDQGCHGXWD      NXJEAY          DKMELPASP       YAKMSXXB        NBULUBHOB       QJEIXW          BCIMPXJGEEGBBF  NGKULLOHSSKDI  
ANAEH           : BNRMO           ASBRCUIKDEV     TCPRIYNXN       WAGOLUYTFQQN   
QPXLRWNWAOWE    : PPIDKTL         IGFASAISBPSWKK  QSMGSC          LAUQEERLIC      QJTVWXTAOI      ESWUOAAY       
QGUUUPRLGRNRT   : IALKNDPHMRRBIOD JDSYRKJBQT      TCPRIYNXN       RTDHRCSVUENKY   CVVYDGQAME     
RAKASDXFWWST    : VHTA            TBWSXSKUS       VWYWEQV         DMDVJERRKPA     YFXTWWQNPEDHM  
HSGEKMYHKRB     : KIHAMBJCRTGQH   FATRPBLVEHUDE   GHJVRSKWPTG     SAGBFWVBS       CNVHPMGIAOIHOQR JMQEG          
XULROOKOCMKHM   : EAJBLKJ         QUECMLJBBTBP    RUKT           
EJIAJPTST       : SRDQICXP        UGGKRAK        
FVNPNRONMAGE    : FLQFYXUNXE     
SUTFFBRU        : GSDHOXY         OSWOEPH         ISMHOYQXVXYSUHR AWNJSYFSI       HCQNXLXCJFK    
DDHPSDIPL       : SSPVP           JKCCVSFUYGYGYEP RVMTJQPRPFOXUE  BNCLMDNQGML    
LCIBTWOGWUK     : OIUVWSWVAABNGL  LXVCG           OQPK           
NGKULLOHSSKDI   : VOOXB          
GSVUIH          : OYVQNTXRIVWFEMP OOKSGECDKM      SUSQXVWHQPBRPVY BBJNMB          SIONXRN        
QIQNYYNWKEK     : HRHNKGMSABKOG   DFWDCQUL        KCCVERGFYHE     GFAHNRCFJ       UFWFEEUILA      IIEVVWYYTKIJ    XMBDEPXJWEDGRQ 
RIGD            : UHTYPTIPCEHDBJ  CFJEWCPYFAJED   UCQRYRRHHTJ     QAAHRCQUIPX    
NYPBCAJKSFHEO   : VMKPOHPRLDFL   
UYWLXWBUJ       : CCKIMBVXM       DLHILWHOUHLP    VFPFVAOBJFOWDOL YTNMGBWYP      
ICYSIDPYEICII   : TBBG            QARNRHYLA       MVPLJPW         FGFADJLQKB     
UESDIHHFIFQ     : DMXHO           YJSTQODDMSM     AXWHKED         IGDJOJKEUIKRVCA
ERGNAORYJAE     : XXBKO           MLCHASPC        NXDDBEDGFBW    
BKHDSSQOYJRHQB  : NDTMTD          SCRGPJNSLAXTIXK BYCQWVERTFQNFJV OSPVGLL        
BIGKM           : CABUQEP         SHDYPSCWVINN    MJUJG           WPWMUICIKFSPO   UWVTFKLTMAS     YQPQKDMKYCIXOEH
QAAHRCQUIPX     : FYMJEIR         SBGLSXNB        FLQFYXUNXE      AUKJ            RIGD            NQAB           
AEMU            : AYVII           RUECIENSMOFCS   WQNHI           RTDHRCSVUENKY  
DTFWD           : MGOIIHNK        RMACGMX         ICFVUBMTMMMB    CSTWUMATIM     
YPCHVMUWDWY     : HMWSTUV         XUIKW           UWVTFKLTMAS     YQPQKDMKYCIXOEH
RBDMMUMGUQU     : FTFUIL          AKUJGRRETOGICC  OVXN            XKTBXOX        
MYNTXQTWJVHHKCE : XLISK           SPADOPKHKOFLU  
BEASHFHTBU      : HEBM            NNJPFAMP        DRJBKCVGYMVFP  
XNXQCYEVYXS     : VTMQECNJUEDEY   XSAUHOADBDT     KHQHYTSFXY      VRBKOTUQ       
HQEOCIVRJA      : SUSQXVWHQPBRPVY WXURYYWCUBTBM   FBQJTBJRGDUUDT  BJBAKVUGRUXT   
FJXMGBHIAVISXJ  : LUHKL           UFLJWNHTKTQEPFV GCDYTYFSUOHP   
WJURI           : FBUGJHB         BHAQSXKQBMGEO  
IMTMWPFIRANB    : LNDRJFLTEHJSN  
BJCKSCIDUJPTIYR : MXGSRPGEW       CVIFMHLLNVHXBN  TXODAQNHJNF     GMJJYWRCSOU     BVKRX           IIQOAK          HFHGYANAYQJ     UNUWMNFELNX    
HVKVRXUHDDBD    : VUUS            QFJA            QJOTHFVLPBI     FSIXSNCOKQLSPTQ YYRGFLXYLE      KCGBPHOIVPAWF  
FDUOHFJJQNGAFD  : GEGUJCHMDWOTU   UTVMKAWGMLEQJ   WBXCCGDOBFSGI   RXQRDNVM        JLPEWBQDHP     
EUKNSW          : KAACHQE         RSTSCPBBXF     
LUIUALWFFCLA    : DNYHCROXPMORLR  UROQVXALBHMTIDD
SIDFYSLBXQLE    : CHKXRVDQSMPBE  
XRHU            : PGJRCFQWAHDOST  FTFUIL          NTMUDJNURPNEB   NDXRJMMCJHMPKSA WPGMFSXDLNKB    DSRFQVHYH      
SQNNS           : YSRMMCNQOKQN    MLDLDLWEFF      DNONRLTVSQCWB   OXHNFXARG       YIIB           
MYHOKJIDRLKSEYV : VCSYBRXKWTCN    PDQGCHGXWD      CYWPXUVTNXAEV   FHUWRTBBYONJ    HWTEHHEYWCQ    
PHIEHCLDHEVW    : DJYRGAGOQLNOKL  AFDLEHPWYMGLI   QPAUUKRPQMJBEAH
OXHNFXARG       : XXBKO           OBXFA           PWGQNECGCHJPGGP SQNNS           OSNPD          
JTQFAPB         : XJKP            SRTJ           
GLMKSOVXXC      : DLHILWHOUHLP    FUYJGIPDUGBVL   YYCBB           LDIATUDWBWOBRKN
UXLTFYBEASMGF   : CNSOA           AXWHKED         TNWOGPPTKF      ENOSNMUJME     
YMJPNOVBD       : WQNHI           AFDLEHPWYMGLI   HUJXAYDPHIKB   
WUGUSIPQGBK     : MFNYMIPUHAXIY   MNWQWITFBQUJHV 
CNUEJHMOQMBB    : FCCHDSHELQ      OGMWEBENYMODI   XTGDAFXIHPG    
QPAUUKRPQMJBEAH : KQAPESJS        TFPH            PHIEHCLDHEVW    OWGIIFNRAIBIDHM EOILPUYGPNXX   
MXMCS           : PXGMFB          AIGAH          
LDIATUDWBWOBRKN : TGEGDJFVPBVINCM XQETDPVDVIQAC   GLMKSOVXXC      DBOSGWSDGJIBU  
AEXLFDNOMCNB    : JIEOPWSPCRYJY   IFNTWJEML       RDYDY           RGTE           
IUQL            : CGBDTHSCTRCRBTP DYRBRY          NXOK           
TIAYH           : HKCRAADHK       MTJMKITNFELMESV VFJPCEVGVRLYLP  UVUONEDQDBXM    SMTXTP         
VWENJRWLXVXD    : SPADOPKHKOFLU   DLHILWHOUHLP    NANUT          
NTPQJRVS        : MXQKF           OXFYK           IUCICBTWYCKXHSV SSUCFFJK       
OGRKQRK         : AKIFIUF        
UGXYWHSTSQR     : OABYPNNW        KTSIOQT         WDCSRQVB        BHGYNLWEWLR     PXFWXLSRHMQQ   
VUHP            : YSVPTSDQMOG     YJLHXMHMFUFAACE MKVTKSUGI      
XCDVURKD        : CXMGUAITL       MPEWQMTHXFNHF   DQWFEVUNUIWH    RVJQVRKLGSFND   TMNMSRQPGCSXCGG
VWFIVAOVB       : TFPH            CAPRXHI         UJPPRGVUCJDU   
DTIXMCRI        : HFMGCUXCWDRMPJ  HAGJSIUPSDUDPC  FSLFHJPLR       QXPNTUYVHNTTNUN
BALBCQWYKHFVFC  : NREHTXT         NDMHTG          IMNOMTTP        MHKEHIWWBV      FKAPR           FQAUR          
NABFVESBABYM    : YNQAISONKKAKUK  FRFSSMJXYCHTN   YYSSVSAOAIR     HECVNPXRIVMP   
SWEVYRW         : KTSIOQT         LHTXHACLNBXC    LWNQYRILK      
ITFUEKQJORAO    : SSPVP           RJQWXL          OKONDQUKQBILV   JVHBSJRTN       GIRGWP          JDSYRKJBQT      HFWDUDGR        CKUKEHNDAALQ   
ITFUEKQJORAO    : TKEBYBNWTQBY   
FMYXNBCPNIKMO   : FPYV            CKUKEHNDAALQ   
LGEPQBVL        : EQECMUYRXLFJOG  QSMGSC          BYCQWVERTFQNFJV LCNWGGJHGXWYVO 
ICQXVQO         : XVRJ            LQSHYVNSAS      YAMVWGQJYC      GAHSBYYCHPU    
VCTWPUY         : HDQBTCUSDYYSV  
IHSUVAIEGYUHW   : OGFIJHXXVN      FDHQOBWM        GIRGWP          TQOKRT         
MHKEHIWWBV      : SMQK            SAOBN           BALBCQWYKHFVFC  UNUWMNFELNX     LKNBYXFBWPGDS  
WSQRTYCBTYYTHD  : DIERGJ          AVFLGXX         RJTJHSVSF       IKVAFPHENTBQRRR NFUFOKOXSHKJDRC PUMGUEB        
IAKHIW          : STRQYHHMKFIOW   FATRPBLVEHUDE   WLJHEEKVLA      LFLVDWTFE       FNABIQPDXFLV   
UDYDDVGYWDTQU   : UCQBGPCMSU      PIUBVWHR        QPLA            XBRRHKMA        LCNWGGJHGXWYVO 
RWOLXPHH        : WUIQYB          GAHSBYYCHPU     RMQH            GEBKJH          QPLA           
JQUTAFTRAYRDCP  : IJUKWNVORH      AGFTWULUPLTIX   TFKMYEIAGONAR   KVQRUGWTIMTFKHU IRBHPV         
DPMWGJMAIDNGSW  : LPFMOOCKC       SWCBDQQBM       WBXCCGDOBFSGI   UOKSXDIAVEAH   
NGGKDHPWYPXSUBJ : YHVIEBTW        IPCDUX          UWVTFKLTMAS     YYAEXXFNGFJXTI  NFGTWCGDY      
GYSGHCSJKW      : SRDQICXP        NCCK            UVVDCS          WVKJGTHYUWG     THKYP           BMNJUVTBWDFOEBS XNHNVNHSRP     
SRTJ            : UKHYBGJEPEFE    EJJRMBXUNW      KBXSLWSTFGKXO   KJLJNPYLSRTMCA  TPQRTWHC        NAOBFTLPAR      JTQFAPB         YYRGFLXYLE     
SRTJ            : PVDE           
CPSFYLCYD       : SMHJUT          WVUYAKKXDRKF    MPYYN          
RYEDDMCYSLBOUO  : LSLPNJI         NFUELWT        
TJFNSPSLLXKWDJ  : BTQKXWFCQFKNA   LAMVHDMVDVHPKUO YWKS            EBNVDPGRIGQLU   VYEHRA          RWTRYLVDTS      SWATYKSFIA     
GEBKJH          : IPNG            MNWQWITFBQUJHV  RWOLXPHH       
OGUAJJ          : JRBLWCKYLGDBT   RIYLHXFKXI      VQGSX           IQAJHSHM        TUWXGULYTFHHQCW
AYRKG           : XWBKWINQORV     GLJLJ           IFKXIRFB        SQGGSIUNGB      UALITX         
FWBQIYC         : BNCOSITJC       AKDLRBXBQFVXI   DGCLNNRNIMY    
CNJIRN          : QVSEMIMXRBJHQLS MVPLJPW         UFLJWNHTKTQEPFV HFHGYANAYQJ    
CUWQDRSMDQNCJAK : WBMIB           RIIWCD          HDRBSYR         PCGJESLYXMM     UFUKHHWHKRJFR  
FHUWRTBBYONJ    : OAWSDTFROTM     EQHG            MYHOKJIDRLKSEYV
BFLVCEYVWNYQD   : WWQTEDMXXSWOM   MKDJMMSGL       HPQCNV          KCVCCCAGKPGI   
CDNVLXQKR       : FTLH            FYMJEIR        
LTLAHV          : PSMCBCIASYTTD   CYWPXUVTNXAEV   NPBHJFHB        EGYLMHL         KPTJLBMK       
KDWIHBJDBWETDJ  : AOUAGJTYYUMHUW  UCQPDCY         QDDQCI         
GYRTWIEPU       : QTEGNRKOWUNODCV
LJSUF           : KCCVERGFYHE     PELNCPWBGU      FLPPC           UNUWMNFELNX    
FKAPR           : ATXURSIPUO      HAANR           TGEGDJFVPBVINCM SOASTXLQS       DMDVJERRKPA     BALBCQWYKHFVFC 
YWGXBABMVK      : GPGLQ           TJVAUQPVN      
PELXLBVBOFV     : VMKPOHPRLDFL    SLAGPTU         MJYHBWOYX       IXUOSXCIQYF     MFGSMNCSO      
MYQWBGQGFNN     : SXVPOUQQB      
QNHDMRQCVCBHFYL : WYIFUPORHTFVS   TDIE            OICXFUUHULD     BLAS            FHJYBKXTURK     KVJULEAWDOHLQ   TMNMSRQPGCSXCGG TJJJSL         
GHFUIVTLEKSJ    : LATDDHCGRE      AKIFIUF         VXWYKF          GCDYTYFSUOHP   
GPQVYVIQOL      : VJOCUN          FQDAEJ         
ROWWP           : OCKTBI          NQNFWVXNIXVOOWN OBDU           
TVTYQF          : DCRE            OQSX            JTHPUSVXPCKHR   XQGKPXA         ESWUOAAY       
KSCWLOWTG       : VTMQECNJUEDEY   WLJHEEKVLA      SIONXRN         EFNNAOGKXEPTJ  
SFNBXCOMTFLTU   : XHUYGRHOKOGT    QSFGBUQDIP      XVOBAECWMDUJDJ 
PSSOLAOXSRUFIR  : TYERMUMFUOIX    ILWMAHQXOEKT    FGOFMSTPDB     
QJTVWXTAOI      : APRXFA          HMWSTUV         MKYHGNVSB       QPXLRWNWAOWE    XCAYMSQ         IRXJVHOGBV     
UURRQHLLYYLN    : UMMKLLGRYWKMU   DSRFQVHYH       DCYFYSBQPKOKGK  NALVQMHFPXIWD   RUOVJMFIXXCKYR 
FHSMPNPIYKEWK   : PNLKWSBWGHAPQG  HCKNGDTWPLXHAQ  OOWT            PUSBSEQ         GLGGP          
YYJUVENO        : OUEVNPLIXE      JBDAKKEDOQHKUH  SJUUJLWNTVFKMN 
UCLTBWIB        : FBNDYMSFABAXGN  SIONXRN         YKOXESTGCILURMA
RWQKMHSL        : NCBFWWKHEDCKJXX
AIGAH           : WISSBP          KISOCFDWTSV     KKDPKDWX        MXMCS          
LDERS           : SDMTAOJRRBVA    FHGM            HVHYIQ         
RNWDKACUEHM     : MKDJMMSGL       MDAYBQMMUBCCQ   XDCLGEDWQS      RVPGDFGAYRWAP   KNXUMX          YYCBB           DUCVNLEOAQUKA  
AWNJSYFSI       : EQECMUYRXLFJOG  SUTFFBRU        XMBDEPXJWEDGRQ 
URTHWXBPSS      : MWJCAHFBKNFQL   JRLXTKUTT      
RXQRDNVM        : REBQQHXQQLITQTP VKTXRMA         JVLPGUUNDWQOI   IIQOAK          FDUOHFJJQNGAFD 
YOCMYUM         : QLGCEFUV        DBOSGWSDGJIBU   DFVCGNGUXA     
NWSIOOR         : OYLAKOCJAXHSXI  KDMIUSDUBQLRC   IGRJEW         
MTCHOKYND       : OFWFQVF         HAGJSIUPSDUDPC  EDCCOPFBLO      BGMSUUCTTINACOM
SQRF            : RGKHEVCTHYU     POFAKRKTSAV     YFFOLQ          IFNTWJEML       ORMYM           NYJLTPU        
QTXG            : YAMVWGQJYC      QNTKMLCWU       SWATYKSFIA      RXBVFJ         
SSCIRWQGLLUAF   : SMQK            HYXJG           GLJLJ           EMSNBJBXOSIBH  
JVKKLOD         : GUNBJXVUNUI     UFLJWNHTKTQEPFV
HWJDQ           : WCTDCMG         YCBHLTYJIFIK    HWNWBVDCKSMI   
BWDVRHG         : KRUFTJ          OHSNIXIOQFNIVE  WQKIY           IJQBUFUUTCHVK   PXFWXLSRHMQQ   
EARR            : QSBEUNY         CQFOD           AVFLGXX         UHPOERSB        ROQEVSDBMK      IGQQVMEW        JEDNU          
PTQPFOCPBQVF    : PEANAPN         MNRVSJILBTI     HFHGYANAYQJ    
SRGLAI          : MJJY            WPRGWPDR        KBXSLWSTFGKXO   BUFMV           BYCQWVERTFQNFJV
DGCLNNRNIMY     : BWXLVMHKGRQYJ   WJEWHGI         FWBQIYC         HLBMGVSJGGGXVI  ANSFQTDDKGHQEOM
IRPOGREJLAPM    : MNWQWITFBQUJHV 
HUHJFSMMWACN    : BMBSRWCTSOS     CQGGUQ          NPBHJFHB        WDWQBLPGMAPGSKD GUPMMXXCSYJLM  
RVJQVRKLGSFND   : HTAAV           XDUHOGGBHNTH    FWUGYFRNSLWDOJL XCDVURKD       
PUFNEBVNGQ      : YSRMMCNQOKQN    MEKHAHO        
UPDWDA          : NYODAQDPEV      GTOVRAT        
YJHWBTKKPQ      : UXJMRCUAFR      FVIBSMTAC       XUQHLXUHYYQADPX TRFYIQLLBXQSJW  MYLPXQE        
UJPPRGVUCJDU    : OMXWCEVI        RMQH            VWFIVAOVB      
YKSXOSPPEYPG    : RHNKHAGUGBPM    CCTQFQOOUHSKJ   WDCSRQVB       
ASLSUIDMAUSVRWH : SWUHKH         
RUVFO           : WXURYYWCUBTBM   VCCAJRTFTA      LOQM            FYQGUVIHQWRF    AOABYLOULID     QQNKRK         
VJMLOLDWHERUW   : QJEIXW          LXVCG           JSUFBLWVY       FCHCH          
DCYFYSBQPKOKGK  : EOPYLGEQD       FBPLG           SUGERLLSXEJK    OHSNIXIOQFNIVE  CPDELESLAJGUKX  TYFDAHNNWLYFPF  UURRQHLLYYLN    XTLGFFRMAXNNPOA
WFLIRYWG        : VHNDAQAGHAW     OSIWUN          AWWDCNMXSUBEWH  BJBAKVUGRUXT   
VPJNLICQNCW     : XJBQCLHVKB      XEVQVRYHF      
WAGOLUYTFQQN    : SOEOLQXKREUV    RJYAH           KCGWCILJLUOBMG  ANAEH           DAQWKSEJNBBMA  
BHGYNLWEWLR     : OOKSGECDKM      SCRGPJNSLAXTIXK LXVCG           MXOGDRQVLXO     PFFKOVSYYMK     UGXYWHSTSQR     GEHWYCUMDA     
NKURHIQKQGVLHPS : FBPLG           BRWO            ALJTKFSVQ       HHTELD         
IGDJOJKEUIKRVCA : AMMVBO          HCAF            LKHDUQGMNP      UESDIHHFIFQ    
NUEWFWHVDFJLUF  : LTJFTNAMD       LDJRQIEMERRYOTT YYAEXXFNGFJXTI  KVQRUGWTIMTFKHU XDUBUXUQSI      LWNQYRILK      
FLPPC           : KEOLXWWV        SHDYPSCWVINN    PGHWHATSHP      YAYIXYHDQPN     LJSUF           NBIQPSRAYQRIY   EEJHHDDMW       ESWUOAAY       
FLPPC           : BOUKJRVURLQNQD 
AJYKTTGY        : IAUANRDRC       NTBSMYXOYFCUK   NANEDBD        
UMQBLYXV        : FWTORHNO        RSTRQFWHAWTIORS
CBHNYMAEARVFTWO : QWKMKVMWS       PYAJRVTBIM     
JINQHJLV        : BWXLVMHKGRQYJ   NRCUDUAJY       SNEMXTACQUCBK  
MKBKGYOHGEIUENW : EPLN            ONEJEQOTRDDJA   DPCIRLJD        DRYWM          
JCSIQOUCCN      : KIHAMBJCRTGQH   IHXOH          
NBIQPSRAYQRIY   : GCMJ            TVKBPIUQWABGV   FLPPC          
RTDHRCSVUENKY   : LNDRJFLTEHJSN   DUWXDEO         APRXFA          OXVPVBBRRDYQE   QGUUUPRLGRNRT   AEMU            SHGUEEUFN      
OMBDNJVDENFD    : NNYUTLHX        UTRIPWVQBAHXUH  VOVHOILCP       TTYSDYTMCKCP   
YOGVIBYPUDK     : AKIFIUF         BUFMV           XFQJEKYNPONANQO
XQGKPXA         : IFXFYMGDEVATOM  VIFFDKMEHOKI    TVTYQF          DCJOUD          PYAJRVTBIM     
CFTNBYSOH       : UECRTFBTDXK     RAVJUWCT        AUKJ           
VGMDEUGFMDIAVHQ : YKOOCXHCIQOYT   DJYRGAGOQLNOKL 
RJFTPJYKXCLSRS  : GGDGERBL        FATRPBLVEHUDE   EAJBLKJ        
PCGU            : PXTLTRX         PHTRNWJOXIV     FQTALGOVKWDHQKY GXPKMEDASBLFHG 
DBOSGWSDGJIBU   : YAPHAKCE        YOSHGDMSTS      PPANEQ          JFMK            VAAIP           NPHGUQQXLVCCQR  LDIATUDWBWOBRKN YOCMYUM        
ULAWVAYJSS      : AHUTYCNP        GEGUJCHMDWOTU   DXEVWFC        
LJHT            : NPKEYKB         QOGXPTGOHL      HYAF            YFFOLQ          MJYHBWOYX       JLACQXSGNE      XNQY            OSPVGLL        
NAICSOCNRIYCJ   : LATDDHCGRE      RSQVLEIPUQNJ    AXQELTTINRPKOVB
SHGUEEUFN       : UOGRFTUIQVTMKDY HBIYWCDAELF     JGFRY           RTDHRCSVUENKY   PCNTIIQB        YIOGDBBVLNDC   
YSBKAXQQXYU     : LLSVHODVGBET    DAWKJHFYPI      JYQKIS          WWEVX           TBWSXSKUS       ELGQQBVSGHNNW   ICIFQLX         WDWQBLPGMAPGSKD
YSBKAXQQXYU     : YDBCKGGWMNVBFM 
OWGIIFNRAIBIDHM : OFWFQVF         QPAUUKRPQMJBEAH
NBNO            : XDXFWDMIQM      BCIMPXJGEEGBBF  GPPTUM         
QYUOPNO         : WDCSRQVB       
IHGGPQ          : HTHXFCKRFMGHYS  QCPETS          LUNV            SCVDGYMDW       TUWXGULYTFHHQCW
XEIAMKJRTVP     : GPGLQ           YFFOLQ          WCEYLLS         PEVXEFSJC      
YFXTWWQNPEDHM   : XSAUHOADBDT     HKCRAADHK       QJIN            RAKASDXFWWST   
PUFGLDN         : XHUYGRHOKOGT    HNHLU           AYVM            UTRIPWVQBAHXUH  XQETDPVDVIQAC   AEWINYRHYXXSP  
DCJOUD          : DUWXDEO         MGPBPBLATJSGPGV HSQTBWRHNA      BDAGF           XQGKPXA        
MNKSLGPJWDBD    : CACA            ICFVUBMTMMMB    GOTNJLNQAJV     QBAKWGU        
ISVXNBGCETYJW   : KAACHQE         AYVM            JIXWQO         
YTNMGBWYP       : SOEOLQXKREUV    RHNKHAGUGBPM    UYWLXWBUJ      
OBDU            : QKFO            ROWWP          
HDKAYKPCQTGNUSM : AMMVBO          JYQKIS          GOBVUNVONXHKCJ  QDDQCI         
RGTE            : BQOHOGVNUNM     ERATLBYQC       RUNK            AEXLFDNOMCNB   
WDMMJDNPA       : RMACGMX         WNHM            MFBLGBWGK      
YEEBFOQIINQVIJ  : NWTJBO          YNRTLIPADSMQP   GTIF            QRVINXXESFE     MCUUCSXWHQ     
ODOIJDHNRWYVMOX : XVRJ            UCQBGPCMSU      BRWO            XSFMAHPKMIRVQA  EKIUDLSF        SNEMXTACQUCBK  
NCJOIBISJVJF    : GRHFPMHO        GIRGWP          LAUQEERLIC      JEDNU          
TPSWGDJJNWEK    : FTFUIL          LQSHYVNSAS      NRCUDUAJY       QQEKJFGACCAGGN  NUHAENYUSG      VUEJFG          XTLGFFRMAXNNPOA
CWNAED          : CQFOD           EOUOU           FNRYPLT        
OSNPD           : PGJRCFQWAHDOST  PVKAIJFEI       OXHNFXARG       JXNJDYGWA      
YYRGFLXYLE      : RWVJFVHHW       RNDQWONWJAPVC   HVKVRXUHDDBD    SRTJ           
UPRTTCRVCHWGNC  : CCKIMBVXM       MMMPYTDPU       CTPJMD          UTDGOCNL        GOLMKUJB       
IROLANMRVRETQRA : HXLIYQGC        DJTAVUOA       
OQPK            : RUECIENSMOFCS   QSMGSC          LCIBTWOGWUK     HWQWMVARTAIKI  
UEJWMIFAMF      : SBVDO           IBDVJXCPIIGIDA 
ETVEKIVGACDTVF  : AQCPQHVGHATG    KWWGILQSFE      ECVTAMEWVRMCOOU XTLSVBYSY      
KVJULEAWDOHLQ   : DPNLHLEHL       UBXOTDKUTBUINWW AEWINYRHYXXSP   QNHDMRQCVCBHFYL
QBAKWGU         : NBULUBHOB       NGODLAJSKDCMP   QOBTELHC        MNKSLGPJWDBD   
EEJHHDDMW       : PQPMTBEKCJSBGVN GRFLYW          LOKJCKXWXEUR    RWTRYLVDTS      FLPPC           SJUUJLWNTVFKMN 
LJLYPNVVCD      : DPHIMKMFHBNFMX  FSLFHJPLR       BBJNMB         
SWATYKSFIA      : ILYRIUOCF       SYFUVST         TJFNSPSLLXKWDJ  QTXG            XMBDEPXJWEDGRQ 
MKSVPWKPPXYBWO  : OXHFKADFEUQM    WTUMIMXCOGB     GAHSBYYCHPU     EDJS           
SMTXTP          : TIAYH          
VLVJFBRHNGRGE   : IHKQCPP         WGYWJRMHQSHRQV  UBKOJDHV        BLTUOGQUMM      UEBBJSBRGISQJY  XXXLLPCNHGGE   
FQAUR           : LHQAICSRGF      TKVXTAAPWYRK    WDCSRQVB        BALBCQWYKHFVFC  EMWJYJPRMBNYA  
YQPQKDMKYCIXOEH : NNQGL           FCEU            BIGKM           YPCHVMUWDWY    
IBDVJXCPIIGIDA  : AQCPQHVGHATG    BOMVVXUSORWR    FVTMVGQ         DQWFEVUNUIWH    UEJWMIFAMF      HXRUPO         
ERBUCE          : IGETS           UWVTFKLTMAS    
OGMWEBENYMODI   : UFLJWNHTKTQEPFV GYAOILPAFGST    GDLPTBTY        CNUEJHMOQMBB   
BMNJUVTBWDFOEBS : BKEYETFP        AEWINYRHYXXSP   CAWDHRXHEPX     GYSGHCSJKW     
LHTXHACLNBXC    : WPRGWPDR        QCPQCLOXGQKKV   ODIUXNGQ        SWEVYRW        
ICHURSSNMT      : IRBHPV         
RYDYCV          : YOKB            PFFKOVSYYMK     ECVTAMEWVRMCOOU
PGEQNEU         : GNSGWXHULN      WADATF          TYCLMEFI       
RXBVFJ          : GRHFPMHO        VGHSQHNSYTN     IVDDNHOJIMYJL   QTXG           
OGRK            : UNDXICPY        RXNLOIMNGIGRB   TJJJSL          PAUVYCSSIDAMC  
HWUURWXQBW      : NXJEAY          UVEJVOXPEBE     YHXLTF          XKTBXOX        
RDHKSNFTHDWDI   : QSFGBUQDIP      SUSQXVWHQPBRPVY FRVJJGCWBRQTX   LOQM            IPCDUX         
DAQWKSEJNBBMA   : RYGKQ           JPGMHHXKAAVHVJK OSWOEPH         SFCPSPRPPAOSSH  WAGOLUYTFQQN   
OYUIEEUWRASYDPE : SLMHBKQ         MSOKBBCN        YFRFJHKI        HWQWMVARTAIKI   BQDIV          
AHOQGYJLIAMMMOG : HIRNIDXGNYOYR   IGETS           OOWT            YAPANCMTMVYJLW 
PCNTIIQB        : DYLBPWIBJ       JYQKIS          CHDLCDMXLVG     FWTORHNO        KPGKSWQOWBLXPX  SHGUEEUFN       NALVQMHFPXIWD  
LAODFFDOT       : NRCVVFAWVVDSFG  JYIYGOJOLGWRTR  SMHJUT          SCRGPJNSLAXTIXK KXUAPFS         ATACEHBSP       FSIRULOJC      
VUEJFG          : TPSWGDJJNWEK    GQAYH          
RTPYYF          : NAIYIEEXBGB     AGFTWULUPLTIX   KMMAC          
NALVQMHFPXIWD   : RSUNQDEMWSYCRPA JYQKIS          MGPBPBLATJSGPGV NANEDBD         UURRQHLLYYLN    PCNTIIQB       
NYJLTPU         : TTQDFUEEHYSOYOR DLBJKO          IGRJEW          ILHNBSQKB       SQRF           
WVTSLSR         : YOSHGDMSTS      RBJCD           PGQUKSYUNLAWA  
XFQJEKYNPONANQO : CAPRXHI         YOGVIBYPUDK     CQPCYKKYFT      PCGJESLYXMM    
RXNLOIMNGIGRB   : VUKEH           KKDPKDWX        OGRK           
JBGCLM          : WTUMIMXCOGB     JKCCVSFUYGYGYEP RGUESWSIOMNKASW BOJRECSPMYBN    RMPM            FVWPBJFNXKJE   
KCGBPHOIVPAWF   : YNOGUWGCBYGBML  CVIFMHLLNVHXBN  ROQEVSDBMK      HVKVRXUHDDBD   
NQAB            : RMACGMX         VPCQG           GIRGWP          QAAHRCQUIPX    
JJPMJBORFC      : XEPP           
UOID            : ATXURSIPUO      TJHGQ           PKSDRDQQKI     
XMGIL           : HORWIK          QCSLQRKFKTOP   
IIEVVWYYTKIJ    : MUQLJDMNHOCEG   QIQNYYNWKEK     UDGXUFAPXYITTYJ
TMNMSRQPGCSXCGG : FLLVERVSK       XCDVURKD        QNHDMRQCVCBHFYL ALEWUBRNS      
RFTC            : EBQGOMPAOMQKK   IKMPHDFJLUVQMS  HCPBMCVCYU     
SAIRYCCJOBDBR   : BUCJIJTSRTAC    CEMSRVUIG       SAPXP          
TJJJSL          : HBIYWCDAELF     RCUUUMTTTOOLTI  QNHDMRQCVCBHFYL OGRK           
QPLA            : SMQK            IWFPEGCRNVFOC   XNXFCRGJYWNXE   UDYDDVGYWDTQU   RWOLXPHH        ALEWUBRNS      
FFXHSQJDKIHOT   : FUYJGIPDUGBVL   BOUKJRVURLQNQD 
PYAJRVTBIM      : VCSYBRXKWTCN    DEUHXBUSHTQOOEE PIUBVWHR        JKOQMWNLVBY     PXYISKD         CBHNYMAEARVFTWO XQGKPXA        
NFEBFIGMGPHWYKJ : BNCOSITJC       HVHYIQ         
SXFQPESAVP      : JJVDVGCRDNX     FEVWKAPBJ       ITRKYUTTXXMXRI 
YAIPPPWQXH      : VXWYKF          HYAF            FLWSJPLIWNHSU   YDBCKGGWMNVBFM 
KNQUMRFVB       : VIUBVKCYJJELDD  VKCRPYTCYBE     JIXWQO          CKMAXWXJTJKTHS 
TITLMOLLGHMGRFV : CMHTMNEIIXRW    KSFAGVSIBVF     KVDLHJFBEPMSK  
EOILPUYGPNXX    : CCKIMBVXM       KJLJNPYLSRTMCA  AGFTWULUPLTIX   EYLYYX          CRRVVUXSQQOEKV  QPAUUKRPQMJBEAH
BAFLTQBJ        : AXJWPPDXLTD     NPBHJFHB        KISOCFDWTSV    
MPMBY           : LAMVHDMVDVHPKUO UQMAQKGIYV      KHQHYTSFXY      GPGDLJSKTMF     CFXANPGRREFR   
GUPMMXXCSYJLM   : HORWIK          QKSFGDNIQMDQ    SXVPOUQQB       HUHJFSMMWACN   
JXNJDYGWA       : KBXSLWSTFGKXO   RGUESWSIOMNKASW OSNPD           FHSKSLKQPE     
COHQQIX         : YNRTLIPADSMQP   YUQGHU          AVFLGXX         OOAVYNQUFGPISYF UCQRYRRHHTJ     UOKSXDIAVEAH   
ENOSNMUJME      : CULHOGAIPOO     UXLTFYBEASMGF   RGLXLNGEHOIS   
YQEXE           : APRXFA          HHAAAKEPO       RDRVSKFD       
DFVCGNGUXA      : XBJSDCFOI       XHJQOKD         YFUJ            YOCMYUM        
GXPKMEDASBLFHG  : OFWFQVF         PCGU           
XKHEBKKYP       : FVWXN           XMBXOHF         UWVTFKLTMAS    
NXNLXER         : JTSFSYYR        JCUL            XDCLGEDWQS      SAGBFWVBS      
VFLCKLULXBTGIR  : QXVCDULLSMUJ    KXUAPFS         XLKDQWHQYAP     PAKRMJMYNG     
PYWCJVTCJSR     : XPQRMHGYQD      SWPMGEAVKCYBM   BBRDSLNRAMHJAI 
QXPNTUYVHNTTNUN : DTIXMCRI       
FHPWGMBRJVT     : BPWHWVLGJWJOMJ  XRAYTGCGTG      NRAVHBNK        QHCMLIAF        ICIDBCKOSYDHDST LFLVDWTFE      
OOSHMIXJFYHMMB  : VNSUTCHOOKO     BNRMO           ACMXFN          WPGMFSXDLNKB   
CVVYDGQAME      : YNRTLIPADSMQP   POBWDBDIDGWUN   FIODG           LKHDUQGMNP      QGUUUPRLGRNRT  
FNABIQPDXFLV    : PLDMDJMXJKHA    OTQRVAU         YAYIXYHDQPN     IAKHIW         
SVVI            : LTYIAGLWBBSCHEP WWEVX           JDUIWMENGQRRXS 
XQPVP           : LPYBWHFBQXDIOH  WJNCYTOF        AXPJYVXFEQ     
CVHCKLGRBI      : SUGERLLSXEJK   
MYLPXQE         : BMBSRWCTSOS     JBBTXNLAIN      FUEUATDN        YJHWBTKKPQ      XGCYPLRD        SJUUJLWNTVFKMN 
HWTEHHEYWCQ     : BCBUVLLTF       BLKAEBRGDDADMC  UHTYPTIPCEHDBJ  DPHIMKMFHBNFMX  KNKMG           SPADOPKHKOFLU   MYHOKJIDRLKSEYV
EMWJYJPRMBNYA   : DBIUUIDF        FQAUR          
PAUVYCSSIDAMC   : AGKBKGGWCHLLB   YNQAISONKKAKUK  KQPFS           YDBCKGGWMNVBFM  OGRK           
RUOVJMFIXXCKYR  : RWVJFVHHW       TVPECP          EBDY            QXVCDULLSMUJ    XPNPCSBDBDOH    ICIDBCKOSYDHDST UURRQHLLYYLN   
BTCCOXDSSVCVY   : LSLPNJI         QBIJBNAYTYBJXA  XHHJOCHFAGX    
AXIUNFGC        : UVWLHLWQLRKDLSU YBKUGKVGLHA     XVOBAECWMDUJDJ  FWUGYFRNSLWDOJL
PAKRMJMYNG      : KRUFTJ          XJFKHV          VFLCKLULXBTGIR  FYQGUVIHQWRF   
RWBURWQTUPNVQ   : BCBUVLLTF       UEUNM           TFKMYEIAGONAR  
SEDAIQRIDLUP    : MKVIDH          TBBG            EQECMUYRXLFJOG  PVOWDX          XLVAILOIVIXCFG 
UDGXUFAPXYITTYJ : VTMQECNJUEDEY   SWUHKH          IALKNDPHMRRBIOD UBCHCFFCM       IIEVVWYYTKIJ    VRNFTFM         IRXJVHOGBV     
RGLXLNGEHOIS    : FHLPMSXB        HJRRTPLRVDKI    ENOSNMUJME     
XTGDAFXIHPG     : FPCQYOHHBC      IQAJHSHM        CNUEJHMOQMBB    WBRQPQXQB      
XCAYMSQ         : JJOVYBPQABSPVY  LUHKL           AKDLRBXBQFVXI   QJTVWXTAOI     
GOITUNDLXVX     : JIXWQO          JLACQXSGNE      EOWPD           UFUKHHWHKRJFR  
PEBSLBBUQJDQ    : SOASTXLQS       SOSDWAUWHHMH    IIQOAK          TQOKRT         
GQAYH           : EBDY            BHPRRP          JERK            YBKUGKVGLHA     VUEJFG         
HYGDTTGGTCGRU   : PIUBVWHR        ORLAVQ          VHIAYHJIPS      AOABYLOULID    
UPYXSVOEAHRGXU  : YEMEHRK         FCCHDSHELQ      QNTKMLCWU      
IROHXT          : LTYIAGLWBBSCHEP ROQEVSDBMK      IJPNJWSWDANBCCJ MPFPFYCL       
TAJNEPHB        : NPKEYKB         RTUDVQIMEP     
CQEA            : BMNMEUBIHV      PTCEU           CUHI            XDCLGEDWQS      UPCCLBROKWFL    ISOFBIILXEV     CPJVQLKQNLC     COOYJHCIGDR    
CQPCYKKYFT      : KIHAMBJCRTGQH   IMNOMTTP        JVHBSJRTN       XFQJEKYNPONANQO
YKOXESTGCILURMA : IFLPROXOQRPWJTM KGPDURSLWFYTVNT VGCW            UCLTBWIB       
GGWRIOKNPW      : VTUMMNSW        UENCA           GLJLJ          
OCUW            : DADXWQHY        FMTMWQCEEGV    
HLBMGVSJGGGXVI  : JEKAUFQ         CAWDHRXHEPX     QDDQCI          DGCLNNRNIMY    
COUVYLIOBFR     : EFDWRNSBFLL     TGEGDJFVPBVINCM PVOWDX          RKEO            KVQRUGWTIMTFKHU XMBDEPXJWEDGRQ 
JOONVDOKLM      : EOWKO           QTMSTONJ        HNFLLAVYAJYJSIX VERRBLDRYVUDB  
UUMDVKLSOC      : SDMTAOJRRBVA    LTDUDYCAFSENY   RJYAH           IVDDNHOJIMYJL  
LEYVU           : YLGHHHOVCLGN    WUIQYB          HXPBMBEUCUSBIYJ UTRIPWVQBAHXUH  WHNWWUG         UAKQQCRHYGV    
EMSNBJBXOSIBH   : KMMAC           HCPBMCVCYU      YHXLTF          SSCIRWQGLLUAF  
XFEEBORTE       : NKSFTHJ         SHWJUOVXAOVUV   JJVDVGCRDNX     PBSUWH         
IRBHPV          : SSPVP           OIUOPAGKTSQIOVT UEWMCVXMAIPFQTS JQUTAFTRAYRDCP  ICHURSSNMT      THNNHOGYVQNXCU 
TLFKMQLK        : WGYWJRMHQSHRQV  VXSA            GYOPOW          FHSKSLKQPE     
GVLQMJVSPW      : TFPH            NDTMTD          SLAGPTU         CCTQFQOOUHSKJ   XCDNOARTSVAAC  
ISOFBIILXEV     : BBLRQHSIQQGXWS  KCGWCILJLUOBMG  JIEOPWSPCRYJY   GLJLJ           RJTJHSVSF       CQEA           
RDFFTSRC        : ILHNBSQKB       IPCDUX         
PNSDAOXP        : MMMPYTDPU       WJNCYTOF        NDYQNMN        
IAGWFKHNVIUTDMY : KEOLXWWV        FRIQOWLLT       KQPFS           RJTJHSVSF       EKIUDLSF        SJUUJLWNTVFKMN 
TSBMX           : ECJBJSNLOXTDIH  UALITX         
CNVHPMGIAOIHOQR : BCBUVLLTF       RRNUJO          QBNELMTSHGOXN   HSGEKMYHKRB    
GPGDLJSKTMF     : WNWRFAOIHSKGQ   MPMBY          
BFBETXNJKV      : KIKGEANIPXERBK  VWEQ           
NNDUC           : YUGJXAIK        LJFSGYKOQJN    
OCAGJERUWEPLJN  : MXQP           
POTLOJW         : HEWUN           XJKP            FINGFUKYQYUHY  
GPPTUM          : KMLBSRKEOOOA    AYVII           WVUYAKKXDRKF    GYOPOW          INQSTGG         NBNO            YYSSVSAOAIR    
OBAQJLW         : TBWSXSKUS       LKHDUQGMNP      WTIFMYI         TQOKRT         
HVHYIQ          : SCRGPJNSLAXTIXK RKEO            GQAIVCUGIAUAI   LDERS           NFEBFIGMGPHWYKJ ANSFQTDDKGHQEOM
XIBRVSDTUJLKDG  : XFSAPPIRPY      LPYBWHFBQXDIOH  CLLLXGF         XIFGOHGULGNW   
DUAENJRLMY      : NYODAQDPEV      OROHEJ          ELHTUVHTYVWKI   MVVIICOVX      
TAPMMNXQH       : POCOY           MPLOFPICLYQ     FATRPBLVEHUDE  
JLPEWBQDHP      : IFXFYMGDEVATOM  XDCLGEDWQS      YJPBWXHBRR      WBXCCGDOBFSGI   FDUOHFJJQNGAFD 
ERMSDHERGNN     : AGKBKGGWCHLLB   QIVPXOB         HDRBSYR         PELNCPWBGU     
ECVTAMEWVRMCOOU : RKVKSIEXKIX     UVWLHLWQLRKDLSU QLQMUKG         ETVEKIVGACDTVF  RYDYCV         
XMBDEPXJWEDGRQ  : EUALDOBRHY      NVICWNM         QIQNYYNWKEK     AWNJSYFSI       SWATYKSFIA      COUVYLIOBFR     VERRBLDRYVUDB  
XTLSVBYSY       : GMQLAJEJHPAMDTR ETVEKIVGACDTVF  NXDDBEDGFBW    
GEHWYCUMDA      : YUQGHU          KFCLYRYRAKLXGMU BHGYNLWEWLR    
UAFSE           : AGFTWULUPLTIX  
BYCQWVERTFQNFJV : WEKKD           GVRAWCRBD       FKFQSGGSLIL     ABOHLI          GOBVUNVONXHKCJ  MJBCKIMMTJIALI  BKHDSSQOYJRHQB  LGEPQBVL       
BYCQWVERTFQNFJV : SRGLAI         
RUKT            : YYBSHIVKORH     XULROOKOCMKHM  
YYSSVSAOAIR     : RIYLHXFKXI      HASYQRWK        NABFVESBABYM    GPPTUM         
MIXINSDULSCVQNP : CYIRJFHO        SXVPOUQQB      
BJBAKVUGRUXT    : QLQQBV          YOVNL           MDAYBQMMUBCCQ   BHQLBUEBF       RAQTHHPUSBI     SFCPSPRPPAOSSH  HQEOCIVRJA      WFLIRYWG       
PUSBSEQ         : AWFLSFECCQXSMX  VLAOPUWSS       HHAAAKEPO       FHSMPNPIYKEWK  
JLACQXSGNE      : PNFMLWONXJHEB   YLWKGFILFQJ     OJYARQBXW       MJBCKIMMTJIALI  FGOFMSTPDB      LJHT            GOITUNDLXVX     SAOPLSYFSX     
JLACQXSGNE      : XEVQVRYHF      
YHIJGD          : BYAEQNARWBAKXBO
XBRRHKMA        : VNSUTCHOOKO     NCACFGTOBAJBSSR CFJEWCPYFAJED   UDYDDVGYWDTQU   QHIWFVFS       
HECVNPXRIVMP    : CYGGJWAINGXV    NABFVESBABYM   
SWIB            : KCCVERGFYHE     TPQRTWHC        CGNPW           LWUHWUPRGRNLBW 
THNNHOGYVQNXCU  : MCONQTDVKE      MIPSYWYDDBY     IRBHPV         
GSSX            : JPGMHHXKAAVHVJK MFGSMNCSO       CINKD           RFWRVY          AEWINYRHYXXSP  
NHMAYXTVGW      : TTQDFUEEHYSOYOR NTMUDJNURPNEB  
AGTQNKWOGPCETYJ : QJCXHTYKGAT     RJTJHSVSF       FSLFHJPLR       EKTDHBFB        GTYWCO         
UFANSHDUGBOF    : XWBKWINQORV     IJUKWNVORH      BSPAOQCE        HXMOOGKIXBQ     QKFO           
NNKTJBJTAX      : RBJCD           HAGJSIUPSDUDPC  QHIWFVFS       
PCGJESLYXMM     : BVLECJ          JJOVYBPQABSPVY  CUWQDRSMDQNCJAK XFQJEKYNPONANQO CFXANPGRREFR    SKABU          
VRNFTFM         : IFXFYMGDEVATOM  UDGXUFAPXYITTYJ
SAOPLSYFSX      : MJJY            FJAMIV          YWGKCRQN        ICFVUBMTMMMB    JLACQXSGNE     
LCNWGGJHGXWYVO  : WISNLVBGNJYV    NTBSMYXOYFCUK   UEWMCVXMAIPFQTS LGEPQBVL        UDYDDVGYWDTQU  
BIUPMNRC        : UEWMCVXMAIPFQTS SJUUJLWNTVFKMN 
DUFIPFPBHGY     : HHIAPQQD        SUGERLLSXEJK    YOVNL           NPMKXPPGPOWD    JJFLJQMGC      
MKVTKSUGI       : LOBHIIJRYUF     VUHP           
KSFAGVSIBVF     : VQDJKTORMHUR    OGFIJHXXVN      GRHFPMHO        TITLMOLLGHMGRFV
HWNWBVDCKSMI    : NDMHTG          GYAOILPAFGST    HHTELD          HWJDQ          
WEJFOU          : KKPPMEWUXL      XDHTEMLRRFRI    LKNBYXFBWPGDS  
HCQNXLXCJFK     : MKDJMMSGL       NRCVVFAWVVDSFG  SUTFFBRU       
FYQGUVIHQWRF    : UVWLHLWQLRKDLSU RUVFO           PAKRMJMYNG     
VRBKOTUQ        : HHPKFANSJJATQVV XNXQCYEVYXS     UFUKHHWHKRJFR  
IRXJVHOGBV      : USJLHURXHE      BHPRRP          BDAGF           PYQFHK          QJTVWXTAOI      UDGXUFAPXYITTYJ
RCEPMLHLGO      : RWUG            OWPO            CLNTCNBUKSTSBJ 
CGNPW           : AMFWVXTQNW      JMXU            ICFVUBMTMMMB    SWIB           
MOTUIRGE        : JCQICTO         VMKPOHPRLDFL    AXQELTTINRPKOVB CCTQFQOOUHSKJ  
XKATUTWYKLNTXT  : XWBKWINQORV     TOYYKQRORHTB    DFWDCQUL        GTOVRAT        
HXRUPO          : WADATF          XBVBFL          IBDVJXCPIIGIDA 
CFXANPGRREFR    : WXUJKOOF        MPMBY           PCGJESLYXMM    
AOABYLOULID     : NEPU            WNXIPPJCEEFF    XDXFWDMIQM      XYSODNFN        RUVFO           HYGDTTGGTCGRU  
HWQWMVARTAIKI   : TANIEQJESFAF    OQPK            OYUIEEUWRASYDPE
CPJVQLKQNLC     : NNYUTLHX        ENQOMOCP        RVPGDFGAYRWAP   CGWXIMASTQP     XNXFCRGJYWNXE   CQEA           
GOLMKUJB        : IFNTWJEML       HMWSTUV         YJPBWXHBRR      XHHJOCHFAGX     UPRTTCRVCHWGNC 
XYTSTVBEFFIUPG  : QCSLQRKFKTOP    STRQYHHMKFIOW   EFNNAOGKXEPTJ  
BREQDGTMW       : PVKAIJFEI       PYQFHK         
BJCKN           : YGIQNMEWJLA     JBBTXNLAIN      YRWMDEFMK       YXYKRSCIX      
JMQEG           : POXKTNDHHPFTWQ  SRHUJ           FBUGJHB         AXXMIY          HSGEKMYHKRB    
FMTMWQCEEGV     : AMPAI           TFKMYEIAGONAR   OCUW           
WBRQPQXQB       : IVOTOQFXMQWS    FUOW            JIEOPWSPCRYJY   WGPAFPEGXESIUR  XTGDAFXIHPG    
EOWPD           : JVQORYALRAGB    PVKAIJFEI       CLLLXGF         GIRGWP          GOITUNDLXVX    
TKEBYBNWTQBY    : FKLBOGIKWQJ     OABQJKLVIS      ITFUEKQJORAO   
YHVCBNSSNJVQ    : SCQMXUTVDF      VDNBBEQUSWC     XHHJOCHFAGX     WKDY           
MPFPFYCL        : DPACXCSNUBAMGP  IROHXT         
COOYJHCIGDR     : CQEA            QKKEPQPDONBK    GLGGP          
FVRXOIKMYAYQG   : BKWVTVTC        UVVDCS          QPQVVHOIHFHPKNV
XHRJIVYYWK      : HCQHKWPMJTSH    AGFTWULUPLTIX   RIIWCD          DUCVNLEOAQUKA  
YUOCOQJKLIB     : MFNYMIPUHAXIY   UTRIPWVQBAHXUH 
UNUWMNFELNX     : HFMGCUXCWDRMPJ  YFFOLQ          BJCKSCIDUJPTIYR MHKEHIWWBV      LJSUF          
VTVWQI          : IGFASAISBPSWKK  CGWXIMASTQP    
RDRVSKFD        : KQAPESJS        HYAF            XSDWOALCRMN     RUQW            YQEXE          
PHTK            : EKTDHBFB       
QKKEPQPDONBK    : UGOXNOSDQHQEA   UALITX          COOYJHCIGDR    
XDUBUXUQSI      : TOYYKQRORHTB    JWVHHYUT        RWUG            ICPRN           DIPKCBIDJYRQIYQ NUEWFWHVDFJLUF 
YIOGDBBVLNDC    : SMSRYLBPWMTG    RGKHEVCTHYU     NNJPFAMP        SHGUEEUFN      
UFUKHHWHKRJFR   : CUWQDRSMDQNCJAK GOITUNDLXVX     VRBKOTUQ        BQDIV          
XNQY            : CNXUOMC         DUDLUWH         LJHT           
ANSFQTDDKGHQEOM : RLNVIWVKDXJKNOD VSUELMXNNMJYGQN HXQUHOFK        DGCLNNRNIMY     HVHYIQ         
XTLGFFRMAXNNPOA : BNRMO           BOJRECSPMYBN    SVIY            WJDRKSQJUFSKEK  DCYFYSBQPKOKGK  TPSWGDJJNWEK   
ESWUOAAY        : MGPBPBLATJSGPGV SQUU            JDUIWMENGQRRXS  QPXLRWNWAOWE    TVTYQF          FLPPC          
HSNYFC          : ILHNBSQKB       DXEVWFC         TRFYIQLLBXQSJW 
BQDIV           : BCBUVLLTF       VCCAJRTFTA      FTPDTBQOXMLYOVL OICXFUUHULD     OYUIEEUWRASYDPE UFUKHHWHKRJFR  
XXXLLPCNHGGE    : ECJBJSNLOXTDIH  DPACXCSNUBAMGP  PSISPBIA        RWTRYLVDTS      PFFKOVSYYMK     VLVJFBRHNGRGE   NOHCYYIDGCAHW  
XGCYPLRD        : RJYAH           PFFKOVSYYMK     MYLPXQE        
YIIB            : RJNKUYRT        OICXFUUHULD     ASBRCUIKDEV     SQNNS          
NJWLHVLUJB      : UFGXKB          AFLSFVHLGENB    FRIBKM          FCOPQHKRDN      TYFDAHNNWLYFPF  HCKNGDTWPLXHAQ  HGPSNFKAA      
XIFGOHGULGNW    : OYVQNTXRIVWFEMP GYOPOW          XIBRVSDTUJLKDG 
SKABU           : YHUV            NFUELWT         PCGJESLYXMM    
CKMAXWXJTJKTHS  : CCACLORI        CYWPXUVTNXAEV   KNQUMRFVB      
QHIWFVFS        : OIXEFXMXACPIUH  NDYQNMN         YJPBWXHBRR      XBRRHKMA        NNKTJBJTAX     
GLGGP           : POBWDBDIDGWUN   XVOBAECWMDUJDJ  FHSMPNPIYKEWK   COOYJHCIGDR    
JRLXTKUTT       : BYASQR          RBJCD           UWCEOFG         URTHWXBPSS     
EFNNAOGKXEPTJ   : CABUQEP         MLDLDLWEFF      KSCWLOWTG       XYTSTVBEFFIUPG 
RPVXXLBJGPIC    : KGPDURSLWFYTVNT OGKJWPYEJUMBTRK FHJYBKXTURK    
FWVWDDMSGCAQC   : ELGQQBVSGHNNW   CINKD           FBUGJHB         RSKILSPSX      
GXPQQIMOGBSQJIY : JYIYGOJOLGWRTR  JJVDVGCRDNX     BLAS           
KGKIGN          : AQCPQHVGHATG    QHODO           YSRMMCNQOKQN    QBNELMTSHGOXN   JFNKNGU        
SJUUJLWNTVFKMN  : GWLPYJS         XLISK           YYJUVENO        EEJHHDDMW       MYLPXQE         IAGWFKHNVIUTDMY BIUPMNRC       
DUCVNLEOAQUKA   : HBNWWDBFBLWN    UJTUPMOANA      FAWVWIKB        QBIJBNAYTYBJXA  IJGMNQMG        RNWDKACUEHM     XHRJIVYYWK     
BOUKJRVURLQNQD  : MNWQWITFBQUJHV  FLPPC           FFXHSQJDKIHOT   NLWRNJWRS      
FCHCH           : GDLPTBTY        UMMKLLGRYWKMU   XCDNOARTSVAAC   VJMLOLDWHERUW  
PUMGUEB         : MJKBIPUWENHLROC QJQLPKDI        MBGBD           RUQW            WSQRTYCBTYYTHD 
EDJS            : KDEDKXVCMAI     NUHSJHBYL       BSPAOQCE        MKSVPWKPPXYBWO 
VERRBLDRYVUDB   : DIERGJ          BSPAOQCE        VUUSBKOJD       UFTCXBTT        UDCFITMTPFGQS   JOONVDOKLM      XMBDEPXJWEDGRQ 
NFGTWCGDY       : FEVWKAPBJ       FVWPBJFNXKJE    NGGKDHPWYPXSUBJ
FHSKSLKQPE      : BYAEQNARWBAKXBO ITNUMQ          BVKRX           RHVF            ORSKVHYNBEH     QKSFGDNIQMDQ    JXNJDYGWA       TLFKMQLK       
QQNKRK          : YYBSHIVKORH     OPXHSADSEVKN    FSIXSNCOKQLSPTQ RUVFO          
XNHNVNHSRP      : DADXWQHY        PWJB            LUHKL           RWUG            GYSGHCSJKW     
TDCB            : YNKACCAMWO      XDXFWDMIQM      KUUINYCFUB      XPQRMHGYQD      BHAQSXKQBMGEO  
OWKBNCFYVXMGS   : XNEJSSKKBKFMO   UGPDLYHR        WJEWHGI         RNDQWONWJAPVC  
OSPVGLL         : VTUMMNSW        YUGJXAIK        BKHDSSQOYJRHQB  LJHT           
EGFBAK          : WXUJKOOF        IKWFTWFBCSCVC   IGFASAISBPSWKK  QLGCEFUV       
DJTAVUOA        : KIJCCSU         YWGKCRQN        IROLANMRVRETQRA
PVDE            : SSPVP           QPSXLHGJBWDJK   XNXFCRGJYWNXE   SRTJ           
XEVQVRYHF       : NCJKLFYHIVB     PPANEQ          OWPO            VPJNLICQNCW     JLACQXSGNE     
NLWRNJWRS       : JELBLBFBJTWGUY  HQCQ            HPMDJCVKIHGGWHD BOUKJRVURLQNQD 
TQOKRT          : UCQPDCY         MQJJIQAEGTYQ    IHSUVAIEGYUHW   PEBSLBBUQJDQ    OBAQJLW        
PXFWXLSRHMQQ    : BRWO            DFNSRRIDRHCNQ   RCUUUMTTTOOLTI  AVFLGXX         IYRUX           IPUPIN          UGXYWHSTSQR     BWDVRHG        
GEEFVSO         : SOEOLQXKREUV    WCEYLLS         VIFFDKMEHOKI   
MKPGDGRUBRN     : BWBTYSYSUVWE    TOISLNVNRKSYJIT WLHQS           SYXJYTJYNEGHLT 
YKYKG           : VIUBVKCYJJELDD  EVDHPXVRW       LKNBYXFBWPGDS  
RSKILSPSX       : RJYAH           FRFSSMJXYCHTN   FWVWDDMSGCAQC  
NOHCYYIDGCAHW   : XXXLLPCNHGGE   
KVDLHJFBEPMSK   : NREHTXT         SWPMGEAVKCYBM   DSRFQVHYH       TITLMOLLGHMGRFV
LKNBYXFBWPGDS   : OIUVWSWVAABNGL  MHKEHIWWBV      WEJFOU          YKYKG          
MPYYN           : PTCEU           VCSYBRXKWTCN    ATLTAQKLF       ANSXFXSUSAJWI   WGPAFPEGXESIUR  CPSFYLCYD      
LWNQYRILK       : BBLRQHSIQQGXWS  BNCLMDNQGML     SWEVYRW         NUEWFWHVDFJLUF 
NXDDBEDGFBW     : LSTPXIXQOACUVWN ERGNAORYJAE     XTLSVBYSY      
GPUV            : RIYLHXFKXI      HIRNIDXGNYOYR   NLUDEYMQ        MCONQTDVKE      DWQPPLNURU      VHIAYHJIPS     
TUWXGULYTFHHQCW : RCKVAVUOVX      NBJSTWUUYA      OGUAJJ          IHGGPQ         
HASMEYR         : JPDAXQQAVQUVYEC XPFQVS          IPUPIN         
XEPP            : DEUHXBUSHTQOOEE VSVQHHVDXOPXWFT YXYKRSCIX       PBSUWH          JJPMJBORFC     
LWUHWUPRGRNLBW  : UEJVYHOE        TXODAQNHJNF     KPTJLBMK        IUCICBTWYCKXHSV MJUJG           IQAJHSHM        YERFMSD         SWIB           
ETVLVOXAPSJOYA  : SCRGPJNSLAXTIXK TPIKOALY        NANEDBD        
ALEWUBRNS       : HXOTKXISD       SWXXWHCO        QLGCEFUV        FIJLYO          NBJSTWUUYA      TMNMSRQPGCSXCGG QPLA           
FINGFUKYQYUHY   : ORSST           QCSLQRKFKTOP    BSPAOQCE        JTJCGWWARDGFM   POTLOJW        
