LCPSKLRYVMC     : MIQXXY          RBWHJGGPHIUYMW  BECJMHH        
JNBPBW          : XNXPYP          GTLHFTEET       BAFKREJSFVREN   XPCV            VBYKDOXNK      
LSREHFMX        : MBLTOUUJDRB     GTLHFTEET       GJPAVRCJP       IAHWCB         
KECWITRSGLR     : SVXGGFITKNYGYV  ANVYORNRUSTEP   SVUMMECK       
XVTJMXYPUNBQF   : LCYE            VHYQWBG         EBIHJHTYLCAL    AFOOSSSFHWH    
XMUVGFAJCLFV    : AHYVIUEM        LCYE            GPKL           
NHYUHUORJOSAM   : OTTPEGRWVGAJC   BAFKREJSFVREN   FSYBSLDSY      
BDNJ            : PPJBRLHUGESM    VHYQWBG         NECMAN          JGKQYJOADJDGO   VSJOJVJKHE     
BEYHKBS         : VSPWLKF         PQTBHLRKRX      SVUMMECK        NECMAN          TGGDUIHGMPVAE  
MBLTOUUJDRB     : LSREHFMX        PPJBRLHUGESM   
CRRCGBFLQ       : WTXWGMHPRQH     IJXQ           
OTTPEGRWVGAJC   : NHYUHUORJOSAM   HOVEAJSNAN      EBIHJHTYLCAL    NECMAN          MIQXXY          IJXQ            VBYKDOXNK      
GWDLPGI         : PPJBRLHUGESM    CVANHELKOVKED  
YDVHEDTUSIPPYVX : ODQASAJO        RVYSUIPYWATPF   VBYKDOXNK      
UVBVFE          : VSPWLKF         EBJTC           XIXMOIH         AEPEAGN         VSJOJVJKHE     
ODQASAJO        : YDVHEDTUSIPPYVX LCYE            RLNFPIFEVL     
OMGS            : HOVEAJSNAN      IJXQ            TGGDUIHGMPVAE  
CPJLHBM         : GTLHFTEET       SVUMMECK        DSXDAQK        
AHYVIUEM        : XMUVGFAJCLFV    NECMAN          XPCV            DISDWF         
SSDSLDE         : GJVRSDOWIIXLID  ORPCEE          ANVYORNRUSTEP   AEPEAGN        
ESNNNGPESDNT    : BAFKREJSFVREN   OBRWXMGHWG     
RVYSUIPYWATPF   : YDVHEDTUSIPPYVX PPJBRLHUGESM    OKESK           MPEFX          
ELTHROWHFEXLWDY : LFDFU           JGKQYJOADJDGO   AEPEAGN         QCRQKSXJUBFQD  
VSPWLKF         : BEYHKBS         UVBVFE          GJPAVRCJP      
LFDFU           : ELTHROWHFEXLWDY XNXPYP          RLNFPIFEVL      RBWHJGGPHIUYMW 
TBWPIQHIYMMY    : AXGCTWYSOCD     YHOSFIMLAVBTQC  URBNC           BECJMHH        
LCYE            : XVTJMXYPUNBQF   XMUVGFAJCLFV    ODQASAJO        FTYVE           KHEESXLPDJ      QCRQKSXJUBFQD  
SVXGGFITKNYGYV  : KECWITRSGLR     CVANHELKOVKED   HOVEAJSNAN      AEPEAGN         QNKHLKLKFPIOB  
XNSPUBQ         : LPRFDCAJIUY     OKESK           MLOFMPMEKTO     QUJGRGKYMFJRSU  EBIHJHTYLCAL    NECMAN          WEKVHPWV        MWQQCAMHY      
PPJBRLHUGESM    : BDNJ            MBLTOUUJDRB     GWDLPGI         RVYSUIPYWATPF   GQQCGOVEN       SFNYTLFJ        KHEESXLPDJ     
XWJJLKRMGBNW    : DIIXPERVSEAV    JGKQYJOADJDGO  
FTYVE           : LCYE            DIIXPERVSEAV    RBWHJGGPHIUYMW  URADOAPL       
LPRFDCAJIUY     : XNSPUBQ         DIIXPERVSEAV    OKESK          
TVGFJRWWAAKWYP  : RLNFPIFEVL      SSMD           
XNXPYP          : JNBPBW          LFDFU           QUJGRGKYMFJRSU  NECMAN          WEKVHPWV       
GTLHFTEET       : JNBPBW          LSREHFMX        CPJLHBM         IAHWCB         
BAFKREJSFVREN   : JNBPBW          NHYUHUORJOSAM   ESNNNGPESDNT    HOVEAJSNAN      IHGSIUYROT      OBRWXMGHWG      BECJMHH        
EBJTC           : UVBVFE          NWDRL           WTXWGMHPRQH     GQQCGOVEN       AFOOSSSFHWH     RBWHJGGPHIUYMW 
GJVRSDOWIIXLID  : SSDSLDE         WYPD            AGWNJBK         FSYBSLDSY      
DIIXPERVSEAV    : XWJJLKRMGBNW    FTYVE           LPRFDCAJIUY    
WYPD            : GJVRSDOWIIXLID  GJPAVRCJP       FSYBSLDSY       KOXEBFASDKGUO   TSBDDIHJDGWU    DISDWF          YUAAWIMC       
NWDRL           : EBJTC           XFNWAFXOJWWY   
CVANHELKOVKED   : GWDLPGI         SVXGGFITKNYGYV  XFNWAFXOJWWY    YUAAWIMC       
AXGCTWYSOCD     : TBWPIQHIYMMY    HOVEAJSNAN      EBIHJHTYLCAL    AFOOSSSFHWH     WEKVHPWV       
AGWNJBK         : GJVRSDOWIIXLID  FQUIMN          AFOOSSSFHWH     OBRWXMGHWG      RBWHJGGPHIUYMW 
ORPCEE          : SSDSLDE         YHOSFIMLAVBTQC  OBRWXMGHWG     
OKESK           : RVYSUIPYWATPF   XNSPUBQ         LPRFDCAJIUY     YHOSFIMLAVBTQC  KOXEBFASDKGUO  
ANVYORNRUSTEP   : KECWITRSGLR     SSDSLDE         RLNFPIFEVL     
PQTBHLRKRX      : BEYHKBS         MIQXXY         
GJPAVRCJP       : LSREHFMX        VSPWLKF         WYPD            DISDWF         
YHOSFIMLAVBTQC  : TBWPIQHIYMMY    ORPCEE          OKESK           EVPWUBFGSH      FQUIMN          QNKHLKLKFPIOB  
EVPWUBFGSH      : YHOSFIMLAVBTQC  XIXMOIH         WTXWGMHPRQH     TSBDDIHJDGWU   
MLOFMPMEKTO     : XNSPUBQ         SFNYTLFJ        BECJMHH        
FQUIMN          : AGWNJBK         YHOSFIMLAVBTQC  VBYKDOXNK      
QUJGRGKYMFJRSU  : XNSPUBQ         XNXPYP          SFNYTLFJ        USLRHVEVUJWCJPI
XIXMOIH         : UVBVFE          EVPWUBFGSH      KHEESXLPDJ     
HOVEAJSNAN      : OTTPEGRWVGAJC   OMGS            SVXGGFITKNYGYV  BAFKREJSFVREN   AXGCTWYSOCD     VKFNAPUMDI      MWQQCAMHY      
IHGSIUYROT      : BAFKREJSFVREN   VHYQWBG        
WTXWGMHPRQH     : CRRCGBFLQ       EBJTC           EVPWUBFGSH     
VHYQWBG         : XVTJMXYPUNBQF   BDNJ            IHGSIUYROT      XFNWAFXOJWWY    IAHWCB         
MPEFX           : RVYSUIPYWATPF  
GQQCGOVEN       : PPJBRLHUGESM    EBJTC           QCRQKSXJUBFQD  
SVUMMECK        : KECWITRSGLR     BEYHKBS         CPJLHBM         RBWHJGGPHIUYMW  VBYKDOXNK      
EBIHJHTYLCAL    : XVTJMXYPUNBQF   OTTPEGRWVGAJC   XNSPUBQ         AXGCTWYSOCD     AFOOSSSFHWH     VKFNAPUMDI     
SFNYTLFJ        : PPJBRLHUGESM    MLOFMPMEKTO     QUJGRGKYMFJRSU  XFNWAFXOJWWY   
AFOOSSSFHWH     : XVTJMXYPUNBQF   EBJTC           AXGCTWYSOCD     AGWNJBK         EBIHJHTYLCAL   
FSYBSLDSY       : NHYUHUORJOSAM   GJVRSDOWIIXLID  WYPD            QCRQKSXJUBFQD  
NECMAN          : BDNJ            BEYHKBS         OTTPEGRWVGAJC   AHYVIUEM        XNSPUBQ         XNXPYP         
KHTRVKM         : DSXDAQK         TSBDDIHJDGWU    QNKHLKLKFPIOB  
DSXDAQK         : CPJLHBM         KHTRVKM         USLRHVEVUJWCJPI
RLNFPIFEVL      : ODQASAJO        LFDFU           TVGFJRWWAAKWYP  ANVYORNRUSTEP   KOXEBFASDKGUO  
KOXEBFASDKGUO   : WYPD            OKESK           RLNFPIFEVL     
URBNC           : TBWPIQHIYMMY    SSMD            MWQQCAMHY      
GPKL            : XMUVGFAJCLFV    URADOAPL        SSMD           
USLRHVEVUJWCJPI : QUJGRGKYMFJRSU  DSXDAQK         RBWHJGGPHIUYMW 
XFNWAFXOJWWY    : NWDRL           CVANHELKOVKED   VHYQWBG         SFNYTLFJ        YUAAWIMC       
KHEESXLPDJ      : LCYE            PPJBRLHUGESM    XIXMOIH        
MIQXXY          : LCPSKLRYVMC     OTTPEGRWVGAJC   PQTBHLRKRX     
WEKVHPWV        : XNSPUBQ         XNXPYP          AXGCTWYSOCD     JGKQYJOADJDGO   MWQQCAMHY      
TSBDDIHJDGWU    : WYPD            EVPWUBFGSH      KHTRVKM         QNKHLKLKFPIOB  
IJXQ            : CRRCGBFLQ       OTTPEGRWVGAJC   OMGS           
XPCV            : JNBPBW          AHYVIUEM        URADOAPL       
JGKQYJOADJDGO   : BDNJ            ELTHROWHFEXLWDY XWJJLKRMGBNW    WEKVHPWV        TGGDUIHGMPVAE  
OBRWXMGHWG      : ESNNNGPESDNT    BAFKREJSFVREN   AGWNJBK         ORPCEE         
AEPEAGN         : UVBVFE          SSDSLDE         ELTHROWHFEXLWDY SVXGGFITKNYGYV  DISDWF         
TGGDUIHGMPVAE   : BEYHKBS         OMGS            JGKQYJOADJDGO  
RBWHJGGPHIUYMW  : LCPSKLRYVMC     LFDFU           FTYVE           EBJTC           AGWNJBK         SVUMMECK        USLRHVEVUJWCJPI
BECJMHH         : LCPSKLRYVMC     TBWPIQHIYMMY    BAFKREJSFVREN   MLOFMPMEKTO    
QNKHLKLKFPIOB   : SVXGGFITKNYGYV  YHOSFIMLAVBTQC  KHTRVKM         TSBDDIHJDGWU   
URADOAPL        : FTYVE           GPKL            XPCV           
SSMD            : TVGFJRWWAAKWYP  URBNC           GPKL            CPBYCGMCY       DISDWF         
VKFNAPUMDI      : HOVEAJSNAN      EBIHJHTYLCAL    MWQQCAMHY      
IAHWCB          : LSREHFMX        GTLHFTEET       VHYQWBG         DISDWF          MWQQCAMHY      
VBYKDOXNK       : JNBPBW          OTTPEGRWVGAJC   YDVHEDTUSIPPYVX FQUIMN          SVUMMECK       
CPBYCGMCY       : SSMD           
QCRQKSXJUBFQD   : ELTHROWHFEXLWDY LCYE            GQQCGOVEN       FSYBSLDSY      
DISDWF          : AHYVIUEM        WYPD            GJPAVRCJP       AEPEAGN         SSMD            IAHWCB         
YUAAWIMC        : WYPD            CVANHELKOVKED   XFNWAFXOJWWY   
VSJOJVJKHE      : BDNJ            UVBVFE         
MWQQCAMHY       : XNSPUBQ         HOVEAJSNAN      URBNC           WEKVHPWV        VKFNAPUMDI      IAHWCB         
