NKSKSPCLM       : MYNDG           NVQSGPYLSO      GBLKCSIXEKHQWYW
TUHOHXHBTOF     : YPNGHLIIIL      TCIIYDVSKIELOYF EDCQNTPOIB      IGAXIMYWLLVXP   EXLDX           UDVGSYEKAE      XTWAE           IVKAGFLDAMCL   
TUHOHXHBTOF     : OCWXOUFQCTT    
XWMDHADGNSQJDM  : BGOJ            UHSOISWNK       YIOGVCTTTMIUK   PBMFDOTEQUXNYI  TRJLDWLXOVDN    WRRUQA         
HXQHRNQJWQ      : FREGIEJOWXBIN   HPHCG          
YNHGSF          : MYHXXDUDJD      PJMOF           IYISEXMJEWWSTD 
HLMIOVXH        : LLFAQ           GOJYQXUXDMPRAE  OVEOXFVQWICVLQ  RVFTQ          
JKYLTACD        : UIEX            XLMUSKIETWEF    GOTHHVWNJDPRN   FXXS           
RTDONWPB        : TUARSFGXFMLFBYY FUJODO          WOOCEITAPSD     EGGHJOYXVOT     VDTQXUXDERCHX  
WTMCB           : YHDBHHCATNIMPKX GBBHMGLWAJFQIA  OQFN            QRLFJEF         VCNDBBVYO      
RLONKXCTKEHEEL  : XLMUSKIETWEF    AYCWCOBO        GBLSYELEKQIDQIG YWQBNM         
XDDESQBI        : RBFCC           DIUAK           TKFMPYUL        VNWJLBQ         URPDMWSBC       QIFKBQACJ       SRJXIRWCD      
JHNVMRVEDMTPKVM : TSBFWKHYSQLO    YVBPNSIJNVN     DEPXYBFRIM      JFGG           
AVYG            : EWHCBKGUUGDUVC  TCEUDONOSJNXNSP PGBLDJT         RSOHRMAN        JKKSWYLXPBAL   
IFNMLIDORX      : WOOYARYW        GQKKWFDYMJYTAI  LVABGCJBWHKAGNV FLXKHQCYOS      NBCPTQ         
BNUNFSTLINDSMR  : AAKL            IFLEHSMEXAUKBW  JCHWLCSYII     
OOPXYBDMNQ      : UYXDQFXBJOA     GEGBSPO         DVQULNMM        KHMDTLUJG       MIJNKG          QQGCYPDLL      
SFPSDSHAHO      : SDJTDPEKIFRYSBW OXSLV           SKIKHNNLPQWGE   LOQTSYQ        
DCETIWGANWQGU   : JRDALHKBFH      SOWNDICCI       BJWMA          
HAFWQDPXUJEN    : VALW            KVFNJGG         CBKDFK          BLCOJCXB        TTVXDYABVM      GAUF           
EWHCBKGUUGDUVC  : AVYG            OXEHWCNNEEYM    ALHD            VYJQBOPV       
EXENALKT        : JXOY            HMQSPHXLV       DURSVATA        BPNXLIJMUHUSY   YSXMHGUSHXD    
BRLMVAFDYMFAYO  : QQVIUYHUE       FKQQBNYUCJNY    TTMETKNXRM     
TUARSFGXFMLFBYY : RTDONWPB        CYJKKSL         TFADWMVTQVWTYRI HBOCPJSRILPB    QJDFTXLAYOOI    NRHQPVAULJIK    VPHWXFQJWK     
ATEORGTWFGFII   : FIQJH           MRISFYVJPTKGX   GPAJSFTOLOXLGT  DPBMVNAVKMVG   
FEQIXJN         : GAUYGJ          FQUSVRAVJP      RVFTQ          
JSTXXUWAOYVSN   : SJRKTCAYHM      XXWPIBVTA       XXXXMMV         GNTS            SKIKHNNLPQWGE  
YHNHPSPAOU      : QOLUJCKKWT      GNTS            HUGIDPEEY      
FFFQS           : IOGBHSYBOIFYHCR FQFVGPLWQGAOJ   LLGJIXHQ        DTJE           
BLGBMDXORYMNMC  : CCHYWOQKOS      DNVKHNVLKOA     WIIAXXAJG       MJPYSCPE        CQNGFNOBHLMLH   XOJKLXEKE      
VRVLKLOYJVGOB   : RHRX            ALJAWNAMWJKLBWB HMNTNWQELTKSY   NUTCSXHXO       NVQSGPYLSO      JSGNJJBYEKDQ   
KNBXTEKWCBRBP   : WJTFCEPH        REXUS           ENRA           
PSTLMQYXENYP    : WOOYARYW        OQLSPGCCUA      MSQBQ           MVQPWYVYFWFLM  
IHLIRYJPV       : URPDMWSBC       CWICLBRR        WXYHSOEENKHEQJ 
DURGMUWTK       : EVHXUSLC        OVXNMONJ        CVBCFRRI        EDRGQ          
OXEHWCNNEEYM    : EWHCBKGUUGDUVC  BJWMA          
KUFMGUKVXFPFU   : DFEWTHLOX      
COWTFWXOVDDJJJJ : FGQYUOEEOORY    IFSHFIRUGUXLK   XRVKPDQGXSLM   
WVUCKD          : UHEJL           RMRUEADBCSOGXA  ALJAWNAMWJKLBWB
UYXDQFXBJOA     : OOPXYBDMNQ      XWCXUTYJS       QRWNBPJSLFVHFH  IRVUBW          FNQQOHDYVE      PAOAY          
UWFL            : AXIQL           JRTLCIQBFCVM    JWWBQTW        
IOFTAQ          : JNGEOS          IWGFOCGMJD     
WOOYARYW        : IFNMLIDORX      PSTLMQYXENYP    NYTEIVNCQNFXSUF FMDP            PGBLDJT         NASSCDXDLQTTG  
WAJEAMNPOSMNXX  : WPQSYQGROKKOK   XTNPBLYOYM      NGULORNGWMWKWXD
JPODPHXPVO      : SRRUMJLRNIN     HRSQDDSXIVWL    LDTLQBQRWINVVD  VKIQFJDOPRYIUN  SYFJLATOBV      DIUWNGA        
XJNXCMAO        : GRDLHXBYSHSAW   VCBYBKMJIX      FJYEI           EMEXQIGBCOD    
BBGSS           : PLEMCARXGNTS    WOAQJLUTEVYHSNQ HAHFTGQTUNKRKE  KGTYGMIDUYOY   
HGXFPJW         : JGJYEQEM        CCXWYCEBDRE     EYHNUKFDWOXKJK  INUTRRR        
OPLOFKETINKGRY  : PFXNYYXJBVEBIW  EDCQNTPOIB      HRSQDDSXIVWL    IVHFLENETH      KEQUIQ          HXFPDGUCUYDBRJ 
GQKKWFDYMJYTAI  : IFNMLIDORX      UHEKMEAXBWCYPTM
GYHUOMFSIPIUYA  : TIEXOVD         VVABNNU         PVMH           
IJNSTMXYLMIMG   : JFLINXEUNPBUHUX DKLKBA         
WXRWHO          : LVQONEVU        OWLAP          
VTGFJOCIQWSAK   : QBEQ            JMKLKMKCODKX    OVXNMONJ        WPMPY           GHUO            BJQMBLT        
VALW            : HAFWQDPXUJEN    DXAQBFVKKAMARS  KCDWIIXSHJLQMQN VOUXPWC        
AGBHSXHMURBGNUM : XIYCDGFHPLEDH   JAJVVJCI        WYUGVOKJ       
HDXRUULWI       : BOTCALU         MLYQEO          BJWMA           MXDWPFDTTYMPRQ  HIKY           
VINSVNBWWUXFJS  : QVYAMXNDTAMPF   KRTJAXUDPMVC    GHLIAWLTOCFVYDB EMVSHYCPVU      GHRGFLAY       
LAMIOIR         : JXOY            GGCTNIQCGEMTQ   GDPKB           CWNNJYXH        CPJC           
IKNDXMNYIXO     : MYNDG           FMDGKMPPGO      GIFYKRCOOE      DISFTCFQRIEO    UXYJUTVCIYC    
UFFTCARJKNIXNXG : XLMUSKIETWEF    QMMQFJAJJFBMC   QYRHXWFCE       PEEIKHL         SWKLQWQJWV     
GYWQLMV         : FEFKWMGDDT      NRWMFRWDBILPNJH VCTXYIHHS      
AKKKI           : QOBHDPE         SUGMTVMASP     
OFHUCJWVV       : HAHFTGQTUNKRKE  TMDB            TQWCBCG         URCCMPQ         UGWI           
JGJYEQEM        : HGXFPJW         KJNL            ILXBLBVSUHX     FGQYUOEEOORY    GAUF           
BDDQAOS         : OMGYQ           IUFWP          
BFWDUDK         : KVUD            QFQITBJA        INMIYSCMC       KCKFDXJD        AYFQFTUHTOWJS   YNIYJMEW       
HWQDUBNBKMGD    : PPAWY           IJUOPMNFET     
SUWW            : VSORCWVRNONDNT  IUWMPIBGHPAD    APOJWYEFFQRL   
NYQGLUNIAINLC   : TXHJPXWAUEBAG   LPTQGCQCMRES    BRHXKMROH      
KTBFWOG         : QFIDHRQDSOKY    IHMRPJTDLAFJL   QAVKGLO         EAWRYQX         GNJEGQGKICG    
DMNW            : FQUSVRAVJP      URCCMPQ         ESUWPTVYMMGSAQ 
KVFNJGG         : HAFWQDPXUJEN    BQPMFGQXUQMAYQ  TYFBSBMVOVPFHJ 
RBFCC           : XDDESQBI        TVEKNSPTUK      XXWPIBVTA       HIJKJF         
QPSLCOMHLDP     : AAKL            ESYMTULCGBFHASH SYFJLATOBV      OIKDPFVJ        QFPBGRRXEUPYYA  RSOHRMAN        HXFPDGUCUYDBRJ  MUSIYRHAGSLBO  
JFLINXEUNPBUHUX : IJNSTMXYLMIMG   EVGRA           IFSHFIRUGUXLK   HLGRVWRUTTQEPP 
WAFNRB          : TYFBSBMVOVPFHJ  RMRJQVNNVKJTE   COMAASXKUW      FQVYBYTTTF      TWFYTGHSFHIUWDM QXOQR           KCMEYRP        
TPQDCUTAGY      : HRDU            URPDMWSBC       OXMQRNLIMFRNFWP BREXX          
QOLUJCKKWT      : YHNHPSPAOU      EVGRA           GHMXQKRLXGJGGII GYSFPNXUMYBD    AIIGFDWJAOGT    GHWXV           HXFPDGUCUYDBRJ 
UIEX            : JKYLTACD        OLCIHUMWKYEBQ  
SRRUMJLRNIN     : JPODPHXPVO      CQNNKA          GCNGNNSRFXJTKHB BADARSCLSSALSPX
QOBHDPE         : AKKKI           IFLEHSMEXAUKBW  GBLSYELEKQIDQIG QCPC            SCYKS          
ROYQKGNVLL      : EARMGXPBQFN     NOOWLMLOESVDC   LPTQGCQCMRES    GVKP            SRDCMIVFFPBD    EWAKCJXFVEARMCM ECOBRTI        
GEGBSPO         : OOPXYBDMNQ      AUXQOXUUIAWUS   IRYQP           GYFWXGN         EPFSUNCTLY      AHRFPMY         ICTGQJRBUBY    
EABTQPXBTNFIH   : DCJDDKHAWB      YWDUNFUBXMDULEQ PXRNLGOT       
KAHSN           : XFBIMGKBJEWTUU  QAVKGLO         VPSKTLBEJWRPGMK JCHWLCSYII     
EARMGXPBQFN     : ROYQKGNVLL      TFADWMVTQVWTYRI RQLEWUFBGBKAUI  HMNTNWQELTKSY  
HQQXHOBDEH      : FRXAATBDIP      JCRPIGGWMCGIJC  WXNI            MYGV            ESUWPTVYMMGSAQ 
LEVLNPCTVELJ    : FQFVGPLWQGAOJ   XUKDQCS        
MYNDG           : NKSKSPCLM       IKNDXMNYIXO    
ANUQOCGPFKYSYD  : NXPX            BVRHKXHBGOD    
MTHONFSYO       : PLFHPMVNUIHOPDK FDQPUSQXBLPBIAR VOHFB           UIDWBJHIPPON    PGBLDJT        
LQUQYYQ         : TSBFWKHYSQLO    JNKRVR          SKSTHTVNUBHA    GCNGNNSRFXJTKHB UNWKQL          GHWXV          
TIEXOVD         : GYHUOMFSIPIUYA  JGORATAPD       HMKDLMH         EWKQEOCCXT      SGLHBMJS        MDDTWJALKBJDTPF
VVABNNU         : GYHUOMFSIPIUYA  LRENLLICXNBP    KBBSFNDMNMMWNYT KGTYGMIDUYOY   
EKBAKR          : UHEJL           LLFAQ           DURSVATA        KGJUUDJHIAKW   
XKBPMAGCVQITHE  : MSQBQ           HSTOXDHWJ       VEBEN           FQUSVRAVJP      XNWYDRGMD       MDDTWJALKBJDTPF YSXMHGUSHXD    
JCULGLBDGGOJGB  : LTGMIYESTHE     CGIP            NTTGBTWYYM      YIOOOKF         UHDPDKRWJHWH   
NYQOODQX        : NYTEIVNCQNFXSUF WYUGVOKJ        YWQBNM         
OONIWUH         : FNFXRKVVKAWRX  
YFRHQTNYCCLKFR  : WJUVQ           NCBGIOQGKQPTYQ  CNVJS           CGSMKINN        ATWVWANTJYF    
EKPVOITVXKMIHJS : BVLAYIELVMAMS   YDLEEY         
IXKSQGGRKKFUPWS : BKOKKP          WISKMVTCKWDHQ   MUGTIKXWSOKHF   YSKMOFG         VXIKRDVKFBNGRPI
IIRYRNUPBJXI    : DVQULNMM        HOEGTLRDYLUBFD  MPWQFVEJAXILATX
QBEQ            : VTGFJOCIQWSAK   NAYPAIH         CWICLBRR        AAGNWOOKDOGJ    GHRGFLAY       
WJTFCEPH        : KNBXTEKWCBRBP   MLNG            NFYLGLV         IMUIDGB         XOJKLXEKE      
FHTB            : PLEMCARXGNTS    FUKIGA          EIBFIESMA      
DVQULNMM        : OOPXYBDMNQ      IIRYRNUPBJXI    XJQMBQXNIX      EPIYASCGJCCVIP  MOBIKDJUXEY    
MXSGYW          : WJUVQ           QVSTLYLCLERTHVQ CELRETRMCENFTBK FLPMYCFFGNCIIHB EPXXLXM         CBGUAMHD       
MVJIBNOQUPXE    : TAMS            LWWTSFRG        MPXSHWBTGCS     WJSWGX          YVBPNSIJNVN     PEIRMBJNMEE    
CVOAOJLDXYDNYVT : QWVNBQHHXBJMPRY QHOD            UHJEHNLRHPPI    XCDFOAKUN      
VSORCWVRNONDNT  : SUWW            IWGFOCGMJD      CIDGT           UTDBOWJ         FEBDRLF        
RSERHPFM        : YETFH          
GRCFOXFMQ       : LCDIAVSSUCI     YINFVUJUHCSFPVX JRRIH          
EVSA            : FJOPBM          CJWOTIYKHBQG    KEBBYBXONOIARXO VTBVNKS        
GRDLHXBYSHSAW   : XJNXCMAO        OWRDAULA        KFLX            RMRUEADBCSOGXA 
PLFHPMVNUIHOPDK : MTHONFSYO       REQUDU          OUGV            CBWLXCNR        KINLOGGLYC     
SSJWHSWIR       : NWJHVKQYH       GAUYGJ          CBGUAMHD        TITYFMXIUJ     
RKROLHBSPSF     : KBIGUMQ         OOHNYIXGGMYCPL  PWDUFQJC        RAQMOAYQLE      SSFTQM          FREGIEJOWXBIN   URPDMWSBC       HGMKXTMAVINW   
RKROLHBSPSF     : LHPWJAJPR      
HAYORQTEIMWU    : CIIGPPPFCVIJFM  KBIGUMQ         ERITSKSLNCF    
ENKOIAGUUVGC    : TAOEKDJSVRUP    PVMH            NVKMHPXX       
BTRHIB          : PQPXNQNXPWHNE   YQEOFCWUCVUA    JSAMOACSSWE     IILDIQHAT       UQDTNLNQ       
JRDALHKBFH      : DCETIWGANWQGU   HCELYBSYFH      GUHBYBLCTDFIC  
LVABGCJBWHKAGNV : IFNMLIDORX      QFIDHRQDSOKY    MLNG            INRF            MDXYBEUJ        NYQW           
UEEHPWKP        : KRJYCXPMSJD     KVUD            PJRMDDIKNMJWD   UQSOPOFGYSKIK   YESRM          
SBNAIDLGDOOH    : YPMUPTJFC       ISNEDDDLYPRS   
QFIDHRQDSOKY    : KTBFWOG         LVABGCJBWHKAGNV INUTRRR        
AXIQL           : UWFL            JMKLKMKCODKX    FSMWYJWNAIPEK   RCCJKRLN       
TYDECRLHGCP     : SGIBPONHX       KENYPSB         XTWAE           YSKMOFG        
SWQXEIRJD       : GUHBYBLCTDFIC   NGULORNGWMWKWXD
TCEUDONOSJNXNSP : AVYG            AFIDXMMYCJWFA   TMBM           
CYETGYQYAUHRHMX : LTWBSVAR        VOUXPWC         QQMHXKN        
REXUS           : KNBXTEKWCBRBP   KFELQOGTJTHUK   TGQNSLKMORY     LLFAQ           CVBOMWIGCVIENX  PVMH           
JNWWM           : XGTJVAAG        YTEIUUIRUN      AAGNWOOKDOGJ   
REQUDU          : PLFHPMVNUIHOPDK WBLYBBYQ        YCHEXJMOCU     
MWINWDX         : CCXWYCEBDRE     HSTQ           
MKOO            : NNHPTUESY       CGSMKINN        IXCVRIK         TWFYTGHSFHIUWDM ENRA           
SOWNDICCI       : DCETIWGANWQGU   FOHAAHDYEDVGD   BMMCMLATTQUQ    UUBAWHAMF       IFSHFIRUGUXLK   TTMETKNXRM     
RAUJWBGOPDWDA   : TDDOEYIGVTGBIWV FGQYUOEEOORY   
BQPMFGQXUQMAYQ  : KVFNJGG         ILXBLBVSUHX     CWICLBRR        LNNT           
HHWK            : LRENLLICXNBP    WIFF            KAETMGVIVNVLWEE MJKKO           LYTSGLKSECGWYUE WCTMOSWVWUGBLEQ
GHFNXUSUY       : ERHO            EGGHJOYXVOT     QAVKGLO         HQAWE          
XCMNOSTISQYFRX  : TVWPQHWVWRBIIY  NQWI            GIEYHUKPFYQB    LNNT            FAHFSI         
YIFVUIF         : KBBPPNOBO       JOTXUL         
PUDLNX          : TCDLLYEDPJDJ    EMOKTBUQ        DIUWNGA         NVOYBA         
JXOY            : EXENALKT        LAMIOIR         YGJFCESVOVJMYJW RCCJKRLN        RVFTQ           OEEMP          
ERHO            : GHFNXUSUY       OJXJBRGLAM      BALBGTWFOKRDGJ  HGUFTQ         
BNSUN           : CCXWYCEBDRE     FFWGCP          GNHQPUIOIWIWEQ  JFGG           
TVWPQHWVWRBIIY  : XCMNOSTISQYFRX  ROHLFOBDRLVL    MGEJL           MJKKO           VMLI           
TAMS            : MVJIBNOQUPXE    QFQITBJA        SDJTDPEKIFRYSBW DKLKBA          DNVKHNVLKOA     DTTPY           SUGMTVMASP     
SKXHXYUSTIJPHGH : YDLEEY          JCWCXBK         GBBHMGLWAJFQIA 
PFXNYYXJBVEBIW  : OPLOFKETINKGRY  DKLKBA          TOXPAKEB        CGILMWGH       
BKOKKP          : IXKSQGGRKKFUPWS HMKDLMH        
DLPMBWVJALQXBPX : OWRDAULA        BVLAYIELVMAMS   TKFMPYUL        OJGPFVCTXXGF    YBWJEUCAGDHKL   CGILMWGH       
CBVGCG          : KIMULRQYRKFHL   FLXKHQCYOS      KBXOVDOBCEWXWVW DFOSYOKK       
SJRKTCAYHM      : JSTXXUWAOYVSN   BGMIXSNIKS      XLQCPDUGQ       LCMPPQQD        DBHCXQXNB      
WPQSYQGROKKOK   : WAJEAMNPOSMNXX  EWILYERVJCLJT   FHHEIEVSFTOHS   QXIQPD          DWTUAJKYFQMXYRD
PISROANASATWAU  : CYYL            TCIIYDVSKIELOYF JAJVVJCI        IMUIDGB         ULFIRLXN       
OLEFCYGUF       : IVHFLENETH      XILROGJBKNOP    MYGV            PXLDPNBQDOMOY  
KRJYCXPMSJD     : UEEHPWKP       
YDNYYNCTUSIY    : WOOCEITAPSD     MJKKO           ENRA           
MXHIFGSARTCRJ   : OJXJBRGLAM      YQYISMGGRGYIVY  JMGK           
KVUD            : BFWDUDK         UEEHPWKP        ADAWT           HUGIDPEEY       YLSJTEXXBOJLS  
BTYAHBWEVFFW    : XOFBIQCI        LYTSGLKSECGWYUE QAVKGLO        
FEAMMUMG        : FHHSOUKHMR      XRQMYXOHLM      GLPTKHLFRYQH    JUMDHW         
RXBJIW          : KFELQOGTJTHUK   PAOAY          
NWJHVKQYH       : SSJWHSWIR       MSFDDNTCT       GMVGMHWYI       CYHBYSJLO       IAYOFR          VQODQHGL       
UOARGHXHUKCH    : SABFGJPSBGYP    RWIWRBDYSCVAWFH LHPWJAJPR      
RYOVIYURNRBW    : SHKNPJQLSUEV    RFXXYVWWCIS     UQAHB          
NOOWLMLOESVDC   : ROYQKGNVLL      FDQPUSQXBLPBIAR SJJVSXDAXTRTJPQ
PGYHBXX         : FUXWPCF         IYQHGSUQMMP     OTWOII         
JXRDNMEKCUYRRN  : URTFSTTL        VDTQXUXDERCHX   WUUTNORXTCDMJKV NVKMHPXX        RSWDQJX         OLCIHUMWKYEBQ  
GCKBXPDP        : BJPP            LLFAQ           XXXXMMV         RJVKGEKTTOX     KBKLECLWWVYNKCQ
LQNMONLANEDBSKM : RXDXKAC         KTQVTKHWCF      SEVM            FAHFSI         
FNMYBSF         : KSWJRWGVX       JGORATAPD       FNQQOHDYVE      SJAAFGAGXEE     KVQUC          
EGETL           : KXYA            RWIWRBDYSCVAWFH
AAMPMB          : VWVCIJG         XVJCA           KVHHWGVXXEBLHK  SSFTQM          IECDGOSO        XXVDAIGNHHVEIX  XRVKPDQGXSLM    UGWI           
YETFH           : RSERHPFM        TYFBSBMVOVPFHJ  IPQB            PWILJXYRGIHTYM  XGTJVAAG        CAFITFSJX       RFYOK          
XTKU            : MSKSFNUNVXL     SVEF            OMGYQ          
XIYCDGFHPLEDH   : AGBHSXHMURBGNUM HJOB            UQPKULVUAWKKVU  IFTUKCUBIWYWPM  LACOCILEULU     QXOQR          
DTYQXF          : FHHSOUKHMR      DMDCDKXPOQTKWGQ
CYYL            : PISROANASATWAU  WJSWGX          XTRRL          
WGHRH           : RVKFTN          UNKEWKMUKMYMYJ  GPEPCEYMSVLN   
CIIGPPPFCVIJFM  : HAYORQTEIMWU    UQSOPOFGYSKIK   TFADWMVTQVWTYRI SMIDHKWOQAQLW  
EFEJWIKXTIWCPQ  : IGXGSYFGOM      IPAWYVCPYDLP    HPHCG          
XTUGCKYT        : TAMMIIBYW       GBBHMGLWAJFQIA  IECDGOSO       
BSBMXPSCUWNTFAR : TPXTSELJXVAGGG  SQAHJD         
IOGBHSYBOIFYHCR : FFFQS           RGXNCGYSKRBUTQJ OQFN            FNQQOHDYVE     
UUWSKQWHPMBX    : PLEMCARXGNTS    UNAUMEWNLWWCVQ  EIBFIESMA       NCGINENJDNTJYW  QIFKBQACJ       DQBBHCOIOX      HHUBJCAMSE     
UCXLIYSEAWSIETR : GKONFDMFMK      RFXXYVWWCIS    
LCDIAVSSUCI     : GRCFOXFMQ       TTVXDYABVM      OUHFPOONMD      KYRSOCALGILEKD  OEEMP           MUSIYRHAGSLBO  
DIUAK           : XDDESQBI        VLYAWE          KBBSFNDMNMMWNYT SLBJGXKEP      
LVTHATEUF       : AHRTXBF        
OWRDAULA        : GRDLHXBYSHSAW   DLPMBWVJALQXBPX JKKSWYLXPBAL   
HUOJDWPOTPB     : GFDA            CWNNJYXH       
EWILYERVJCLJT   : WPQSYQGROKKOK   XXWPIBVTA       XFBIMGKBJEWTUU  ATWVWANTJYF     HGUFTQ         
LRENLLICXNBP    : VVABNNU         HHWK            CXWKQYTGL       GNHQPUIOIWIWEQ 
UHEJL           : WVUCKD          EKBAKR          EFLFMKEFBJV     OTWOII          MJXAH           BGITF           VTBVNKS        
TYFBSBMVOVPFHJ  : KVFNJGG         WAFNRB          YETFH           OUGV            IILDIQHAT      
UUXDXVRY        : QUFI            CRCPV           HAHFTGQTUNKRKE  KCKFDXJD        EPOGYIA        
VWVCIJG         : AAMPMB          OCCPXBOCRKJJWI  URTFSTTL        BADARSCLSSALSPX
JNGEOS          : IOFTAQ          OLHAMBBPVSU     VHYDACNBBBVNKOC YKXIXOJJHMUTMCM QYRHXWFCE       JKKSWYLXPBAL   
EPSLYCV         : UKQDXLHFAVPVWKN UNKEWKMUKMYMYJ  JDNVAUE        
XWCXUTYJS       : UYXDQFXBJOA     QBFMREVDFNNYJRU KBXOVDOBCEWXWVW
FUJODO          : RTDONWPB        ONFH            IKCNG           COEQIPTRGMTNWDB NCGINENJDNTJYW  FJYEI           BADARSCLSSALSPX HLGRVWRUTTQEPP 
QUFI            : UUXDXVRY        FVLATFPYJUJHHRK PTLIL           DGND           
FOHAAHDYEDVGD   : SOWNDICCI       FQFVGPLWQGAOJ   NGJTNPKJASAER   ECOBRTI         XUCQAMPUH      
DECXDHUMYYBBRX  : VOHFB           MNILPO          NISI            XVJYJMMOEESL   
ANOQVOTFT       : KJPCQKGXW       IKGTWCNDX       CELRETRMCENFTBK WHBUKAEXWNTJTQG
LYQRCHWHMWKTSYU : XMNQMA          XNCYQONYR       UHJEHNLRHPPI    HMNTNWQELTKSY  
CWLADOPTFL      : EWXOOL          NBCPTQ          QSBIVGFMOFKSQVU DSLATEG        
YQFTCH          : MXDTMEPJMU      WTPRYND         HMKDLMH         CBCNCN         
WJUVQ           : YFRHQTNYCCLKFR  MXSGYW          DVDQ            GBAXVMRHNWQMOI 
TDDOEYIGVTGBIWV : RAUJWBGOPDWDA   KSWJ           
KJPCQKGXW       : ANOQVOTFT       WTHR            CARLKSNWXPKP   
IRCBYXHFMLEUSAQ : UQSOPOFGYSKIK   GMVGMHWYI       INUTRRR        
DAXBS           : OLHAMBBPVSU     WPMPY           RQQSNVISWUO    
KINCUVAUC       : AUXQOXUUIAWUS   GRSFCUX         EXYQKUMT       
MGMOGVTUHA      : VQWW            ARTOOXKPCJLSLY 
ACICFKCHDNT     : URTFSTTL        EIBFIESMA       OXMQRNLIMFRNFWP PJISIILOCUPKKE 
BVLAYIELVMAMS   : EKPVOITVXKMIHJS DLPMBWVJALQXBPX XXXXMMV        
IPEIHEKRIRFLYK  : ADAWT           JFNJAVNLLEMWL   QDRHAAYVNYLQS  
TBDRPFSXJFVVHIQ : QCPC            DHFOUXVNONIKGVU KMUVHAQISCLE   
SGIBPONHX       : TYDECRLHGCP     YSNFRPP         DWTUAJKYFQMXYRD UGWI           
OLHAMBBPVSU     : JNGEOS          DAXBS           MNTYIDEUVEU     FHIRNUFHVPLDMJ  DPNUCHGUCN      JRQWBM          XNRECAPTT      
RGXNCGYSKRBUTQJ : IOGBHSYBOIFYHCR DKHRWBLLPLPK    RCNEWVIAPFBXCL  KXQO            DBHCXQXNB      
BJPP            : GCKBXPDP        GOWLWVGHNIE     YVFXW           MXDWPFDTTYMPRQ  MFWMSNGIBOUGHI  XNWYDRGMD       LDPPLTNWIEYD   
XRKBVCYOAQ      : FGQYUOEEOORY    UOVSFXE        
GOWLWVGHNIE     : BJPP            WBQBUGKD        KOGAOBTSFTVQMQM HBOCPJSRILPB    LDPPLTNWIEYD   
BOTCALU         : HDXRUULWI       YDLEEY          CVHMVAR         XPMXFTBFVN      FNFXRKVVKAWRX  
JMKLKMKCODKX    : VTGFJOCIQWSAK   AXIQL           FLPMYCFFGNCIIHB OPHM            QMMQFJAJJFBMC  
HJRFRCVAGHCWBG  : AHRFPMY         HLGRVWRUTTQEPP 
NDXYSKMDYAFODQ  : TGQNSLKMORY     UFXE            EHJAQEU         EVSQ           
AAXSGPWCSFJ     : IYQHGSUQMMP     RDIOFJSCL       ARNSAS          SJJVSXDAXTRTJPQ LHPWJAJPR      
DNDFDHDCAPR     : LXJBVRMEIBPEOUO BALBGTWFOKRDGJ  HEAORSPVWXUP   
ORLDUERVEPQ     : TTESYLUSYP      BYXFROFBBKE    
IPQB            : YETFH           NDMIAKHPFGL     KBIGUMQ         YULY            QHTKCRDTGK     
DXAQBFVKKAMARS  : VALW            OGPBDNQQNB      GCQJFXWT       
JGUHK           : HHEWHPT         HXFPDGUCUYDBRJ 
FQFVGPLWQGAOJ   : FFFQS           LEVLNPCTVELJ    FOHAAHDYEDVGD   EYKVUFAPEJ      EXLUHKEDBOBRV  
SOQDARQALLRVR   : NRPQEUFQ        HRDU            GAUYGJ          MYGV            RAFE           
FEFKWMGDDT      : GYWQLMV         JLSDC           NRWMFRWDBILPNJH KBXXGH          YESRM          
TCDLLYEDPJDJ    : PUDLNX          DVYPKQHLRYG     YPMUPTJFC       DNVKHNVLKOA     CGMV           
FVLATFPYJUJHHRK : QUFI            XMNQMA          QHNP            YIOOOKF         MRSQVT         
NNHPTUESY       : MKOO            NGJTNPKJASAER   KFLX            MNTYIDEUVEU     DOEYKVLOCWEAOD  VRVGDMVMVOEX   
KIMULRQYRKFHL   : CBVGCG          YNNAKIDPFNXHH   RJVKGEKTTOX     EAWRYQX        
EWXOOL          : CWLADOPTFL      DTSRO           GYSFPNXUMYBD    GNHQPUIOIWIWEQ 
EYKVUFAPEJ      : FQFVGPLWQGAOJ   RNPWMF         
PVVBOOAI        : MGHQFFNVVT      MGSSTPEMODJH   
FSMWYJWNAIPEK   : AXIQL           APGJFATEQHM     INUTRRR         OYTFHPR         DGYOECX        
AFIDXMMYCJWFA   : TCEUDONOSJNXNSP UQSOPOFGYSKIK   TXHJPXWAUEBAG   PXLDPNBQDOMOY   NGULORNGWMWKWXD
GKONFDMFMK      : UCXLIYSEAWSIETR XILROGJBKNOP    XFBIMGKBJEWTUU  TQIDWVXLE      
MSKSFNUNVXL     : XTKU            OPHM            PJISIILOCUPKKE 
LMPWJUWYD       : MSFDDNTCT       RNPWMF          TFADWMVTQVWTYRI SKLM            HRLOCGOHVJX     ALMHNPBCW      
NRPQEUFQ        : SOQDARQALLRVR   EVHXUSLC        VHYDACNBBBVNKOC TOXPAKEB        OPHM            NWKTPO         
TMBM            : TCEUDONOSJNXNSP WOOCEITAPSD    
QHHOISYTFO      : FHHSOUKHMR      WBQBUGKD        JRTLCIQBFCVM    KSPDEKRCFWBMKW  AYFQFTUHTOWJS   GOJYQXUXDMPRAE  HXBEVQDABN      RVSFAYQKWICRDP 
QKPPPYFHQVO     : XMNQMA          QWEIINPSHESYHD  DTJE            OOHVDFFXORRM    PAOAY          
DFEWTHLOX       : KUFMGUKVXFPFU   UGLJSUOKE       NISI            HGUFTQ         
VMEPLAW         : RMRUEADBCSOGXA  EYHNUKFDWOXKJK  HPHCG          
SQPI            : CXWKQYTGL      
FJOPBM          : EVSA            NTQSUADKQKWJ    FUKIGA          CLVJPLPIQSL     FQVYBYTTTF     
OQLSPGCCUA      : PSTLMQYXENYP    CGITCVYQEIIKNVI DBHCXQXNB      
SOEKDEIGWYXHH   : JDPFTMFSUUUGVXA GUHBYBLCTDFIC   EIRYDG          EPFSUNCTLY      TQUFHGFMVHUJMRW
QVSTLYLCLERTHVQ : MXSGYW          CTKDPPBMWAN     ECOBRTI        
VLYAWE          : DIUAK           KVHHWGVXXEBLHK  UKRNP           UDVGSYEKAE      YCHEXJMOCU     
FMDGKMPPGO      : IKNDXMNYIXO     UUBAWHAMF       OKIPVU          MJPYSCPE       
AAKL            : BNUNFSTLINDSMR  QPSLCOMHLDP     SDJTDPEKIFRYSBW WGLWHVJG        XAGVAAVJ        CLVJPLPIQSL     CNCLCBYYA      
XSVTCSKNQWMR    : IVHFLENETH      ULFIRLXN       
SABFGJPSBGYP    : UOARGHXHUKCH    KGJUUDJHIAKW    PYUAHVRQVEGOVND QDVNG           BJQMBLT         XUCQAMPUH      
CRCPV           : UUXDXVRY        AHRTXBF         RFPMMVEQIWPTE   MIFPHL         
IUWMPIBGHPAD    : SUWW            NLSKBYAFUFRWDAQ XUKDQCS         XNCYQONYR       TGANO           KFDWKHLSYBCI   
BGOJ            : XWMDHADGNSQJDM  YINFVUJUHCSFPVX SVEF            XUKDQCS         UDVGSYEKAE     
HCSPELHGFLVEOHY : ADDORTOUHWX     UGLJSUOKE       GYSFPNXUMYBD    BRUNY           LNNT           
VQWW            : MGMOGVTUHA      LCQXJOYA        VEYXR           BRHXKMROH       HBAUUG         
GPALYDR         : OOHNYIXGGMYCPL  JJRYBBXSPVIJHON GPAJSFTOLOXLGT 
MLYQEO          : HDXRUULWI       TGANO           QQIHFEGLARKCRQ  XVQOEIEEXMUHYL  SRJXIRWCD       DBHCXQXNB      
RXDXKAC         : LQNMONLANEDBSKM WBQBUGKD        XYROFNXDKQRMWAF KOGAOBTSFTVQMQM
JDPFTMFSUUUGVXA : SOEKDEIGWYXHH   QSBIVGFMOFKSQVU RSOHRMAN        VJNMJLCPLL      SJJVSXDAXTRTJPQ
MLNG            : WJTFCEPH        LVABGCJBWHKAGNV UQSOPOFGYSKIK   REUDO          
CBKDFK          : HAFWQDPXUJEN    IIJNLN          NRHQPVAULJIK   
HMQSPHXLV       : EXENALKT        SHKNPJQLSUEV   
FRXAATBDIP      : HQQXHOBDEH      LWWTSFRG        TLSCBOVKDP      TRSKPPAH        PJISIILOCUPKKE 
XVJCA           : AAMPMB          EUTKGEPTMAVQMP  DHFOUXVNONIKGVU
FHHSOUKHMR      : FEAMMUMG        DTYQXF          QHHOISYTFO      JSHP            AYCYFQ         
YPNGHLIIIL      : TUHOHXHBTOF     EVHXUSLC        JFNJAVNLLEMWL  
SECQAOSCLYJS    : LCQXJOYA        PDXIXUCQYGY    
APGJFATEQHM     : FSMWYJWNAIPEK   FGBBSTWI       
UUIDJVVNB       : QFKYSULOU      
PPKSBJEVFHMMSR  : KBBPPNOBO      
MXDTMEPJMU      : YQFTCH          MYHXXDUDJD      KBBPPNOBO      
LTGMIYESTHE     : JCULGLBDGGOJGB  KSPDEKRCFWBMKW 
DKHRWBLLPLPK    : RGXNCGYSKRBUTQJ DVYPKQHLRYG     IGAXIMYWLLVXP   WCGALSHXNVCPY   YWONWGBJHREC   
TCIIYDVSKIELOYF : TUHOHXHBTOF     PISROANASATWAU  WGLWHVJG        WBLYBBYQ       
EDCQNTPOIB      : TUHOHXHBTOF     OPLOFKETINKGRY  ULFIRLXN        EYXNGOOSVTKQB   OXSLV           RSOHRMAN        OVEOXFVQWICVLQ  FBTUPLGVBVJXLGG
TQQUMUDXUGTP    : GBBHMGLWAJFQIA  ERITSKSLNCF    
FTEVTJSAP       : CBCNCN          VRQCCIVLGV      BTUOCXNPRCUYXVC
QFQITBJA        : BFWDUDK         TAMS            DVVH            TLSCBOVKDP      JCHWLCSYII      OXMQRNLIMFRNFWP
DTSRO           : EWXOOL          MDXYBEUJ        IGSKVYWP        EPXXLXM         HXBEVQDABN     
PLEMCARXGNTS    : BBGSS           FHTB            UUWSKQWHPMBX    IGXGSYFGOM      DEWEHLHLSPATID  RKMDA           JUMDHW         
TKFMPYUL        : XDDESQBI        DLPMBWVJALQXBPX LPTQGCQCMRES    IERUHIIJB       BEROLNNAIA      NMXKSQCIYWSBWUF JMGK           
FLXKHQCYOS      : IFNMLIDORX      CBVGCG          INBSCMHEQL      NRWMFRWDBILPNJH PVMH            EMVSHYCPVU     
VFOXYNEOJYAE    : NJISCEMN        KUSFVTMOYIK    
FSYGOMJVBHGIB   : QBFMREVDFNNYJRU WOEBGPDD        YLSJTEXXBOJLS  
HRDU            : TPQDCUTAGY      SOQDARQALLRVR   PEALPSPFQY      MGSSTPEMODJH   
KJNL            : JGJYEQEM        GUDIQOIMAPJ     KFDWKHLSYBCI   
SDJTDPEKIFRYSBW : SFPSDSHAHO      TAMS            AAKL            EHJAQEU         EGSBFAAY       
KFELQOGTJTHUK   : REXUS           RXBJIW          IIJNLN          IKCNG           ARNSAS         
WDVIYYXDKILEKG  : VNWJLBQ         DOHFNJHWO       HHUBJCAMSE     
JCRPIGGWMCGIJC  : HQQXHOBDEH      IHMRPJTDLAFJL   CVHMVAR         AEKTFVTTNO      QYJSQLAY       
FBXBJXDJDPTQT   : RXTUGGPISFIW    DRKYAWIWWQMWRM  GYSFPNXUMYBD    RFPMMVEQIWPTE   GEMWOWE        
WBQBUGKD        : GOWLWVGHNIE     QHHOISYTFO      RXDXKAC         XHWHYMTRRFS     JEFLCVMPJJI    
HRSQDDSXIVWL    : JPODPHXPVO      OPLOFKETINKGRY  QQVIUYHUE       XNWYDRGMD      
WOOCEITAPSD     : RTDONWPB        YDNYYNCTUSIY    TMBM            ADDORTOUHWX     KKWHRMAS        MAQESPJMBJUPOB 
WYOHEFQ         : WJSWGX         
XHADCANXWAFVQVB : JIIHN           RSWDQJX         QQMHXKN        
FUXWPCF         : PGYHBXX         KHDOKSDMFOOBKFV FNQSPYCMQFDGV   VFSLEXBVDGEY    DNLRCTMKFRAN    OOHVDFFXORRM   
DVVH            : QFQITBJA        EOSCTB          EPFSUNCTLY      VPHWXFQJWK     
NGBWIFAJU       : LEBAVJSBJQMBN   YVBPNSIJNVN     UHDPDKRWJHWH   
IWGFOCGMJD      : IOFTAQ          VSORCWVRNONDNT  YSKMOFG         FHKORMEM        UQDTNLNQ       
IUOPIRLGA       : VPAXPDWJIGFIID  SJJVSXDAXTRTJPQ
VIQTRVVBSXJQG   : FIQJH           FHHEIEVSFTOHS   SFPAAKSLJDEIHJT NUDXXPESJYINNW 
HLYVUCGGXXVIP   : BJWMA          
QRWNBPJSLFVHFH  : UYXDQFXBJOA     TMDB           
MYHXXDUDJD      : YNHGSF          MXDTMEPJMU      CELRETRMCENFTBK VOHFB           OQFN            LFSQRKWQPD      GUHBYBLCTDFIC   SFPAAKSLJDEIHJT
JANAKERJRUABPN  : RFPMMVEQIWPTE  
NUQVUDWCDWFAC   : FNFXRKVVKAWRX  
EFBGSDSXXCR     : YCISMHSYM       HMKDLMH        
EVLUGYRWUNC     : PGBLDJT         EOIMDH         
RHRX            : VRVLKLOYJVGOB   VKIQFJDOPRYIUN  CMWDQT          GAUF            EWAKCJXFVEARMCM
TROCUUUYP       : JMPRPWCSPJXYNU  CNFONMPCXHHB    BOHF            CHYORI         
WTPRYND         : YQFTCH          CVBOMWIGCVIENX  AXHRQVN         EGYHOSY         VYTA            DMDCDKXPOQTKWGQ
TDNRABVU        : CAIM            UNAUMEWNLWWCVQ  WHSC           
EOTO            : VFSLEXBVDGEY    IVMKYLHASF      NCGINENJDNTJYW 
NDMIAKHPFGL     : IPQB            DGND            CWNNJYXH        DBXUITCSAWIDDA 
YKKEIFHWYKAWH   : JSHP            NTTGBTWYYM      ABLBY           MKREDYCOJEQXJIA JRRIH          
BVPPGDU         : YKCCWU          TGFCA          
OUGV            : PLFHPMVNUIHOPDK TYFBSBMVOVPFHJ  KYGYO           UQSLXOQMVWA    
NFYLGLV         : WJTFCEPH        APOJWYEFFQRL    TWFYTGHSFHIUWDM EDRGQ          
UDURE           : KTQVTKHWCF      IGXGSYFGOM      RJVWDDIOMFNUU   CVBCFRRI        MXDWPFDTTYMPRQ 
RCOOFKGX        : CELRETRMCENFTBK WPMPY           LYTSGLKSECGWYUE KBBPPNOBO      
MSQBQ           : PSTLMQYXENYP    XKBPMAGCVQITHE  VMLI           
YDLEEY          : EKPVOITVXKMIHJS SKXHXYUSTIJPHGH BOTCALU         DTBMCMHBVYBEWBM KRTJAXUDPMVC   
QWVNBQHHXBJMPRY : CVOAOJLDXYDNYVT IRVUBW          LLFAQ          
PTLIL           : QUFI            YKCCWU          RHXIXSIHYMXKGJK BTVXCVKJEKU     WIIAXXAJG       GPAJSFTOLOXLGT  SQJBI           ERITSKSLNCF    
YINFVUJUHCSFPVX : GRCFOXFMQ       BGOJ            CCXWYCEBDRE     KBBPPNOBO       HEAORSPVWXUP    FYAVEHKXHY      KNDIILILVAN    
DVYPKQHLRYG     : TCDLLYEDPJDJ    DKHRWBLLPLPK    GNOUYQEEJQ      KXYA            CBCNCN          BREXX          
JRTLCIQBFCVM    : UWFL            QHHOISYTFO      NCBGIOQGKQPTYQ  DPBMVNAVKMVG    FKKHYQF        
OUWMSWQRXICQROJ : AOLCF           BGMIXSNIKS     
WOAQJLUTEVYHSNQ : BBGSS           ADRGMOTQHJWF    CBWLXCNR        QSBIVGFMOFKSQVU CWXKGFTTQNEIFM  DLGBXLEX        XOJKLXEKE      
IPWEOPVMAAGRQRI : VTOQKNCHPQP     FNQQOHDYVE      GUHBYBLCTDFIC   HBAUUG         
IKGTWCNDX       : ANOQVOTFT       CNFONMPCXHHB    DTBMCMHBVYBEWBM KXBJCC         
MSFDDNTCT       : NWJHVKQYH       LMPWJUWYD       KBBPPNOBO       GUHBYBLCTDFIC   NMXKSQCIYWSBWUF
TPXTSELJXVAGGG  : BSBMXPSCUWNTFAR ATLAPXVTJM     
FIQJH           : ATEORGTWFGFII   VIQTRVVBSXJQG   VEBEN           XSVRNVDXULRHJQ  YVTBT          
VALCFBVJVE      : DQRIXACMWJV    
NCBGIOQGKQPTYQ  : YFRHQTNYCCLKFR  JRTLCIQBFCVM   
IHMRPJTDLAFJL   : KTBFWOG         JCRPIGGWMCGIJC  FGQYUOEEOORY    DEWEHLHLSPATID  LXJBVRMEIBPEOUO YLSJTEXXBOJLS  
NTQSUADKQKWJ    : FJOPBM          MYGV            UHDPDKRWJHWH    MDVIFJQQYCWKTE 
SKSU            : XRQMYXOHLM      GYFWXGN         VYJQBOPV       
CHKUSFXGHFPUIGO : JMXPW           GYXRYKXRULOVAPW KRTJAXUDPMVC    NVKMHPXX        PDKVUEWGSXK    
YKCCWU          : BVPPGDU         PTLIL           GUHBYBLCTDFIC   DRHXUFKA       
TGQNSLKMORY     : REXUS           NDXYSKMDYAFODQ  UIDWBJHIPPON   
NGJTNPKJASAER   : FOHAAHDYEDVGD   NNHPTUESY       NUQDYBGOHUL     WBXEPTARQXSYH   VARRJG          MFWMSNGIBOUGHI  MOSYOM         
IVHFLENETH      : OPLOFKETINKGRY  OLEFCYGUF       XSVTCSKNQWMR    VKYE           
EVHXUSLC        : DURGMUWTK       NRPQEUFQ        YPNGHLIIIL      RAQMOAYQLE      NUTCSXHXO       XPWEKWXLEGXGU  
IRVUBW          : UYXDQFXBJOA     QWVNBQHHXBJMPRY CGIP            OOHVDFFXORRM   
CDHOODYTQF      : REUDO           HSTQ           
XYROFNXDKQRMWAF : RXDXKAC         HAYM            EPOGYIA        
WISKMVTCKWDHQ   : IXKSQGGRKKFUPWS NHFAINV         PJMOF           DRHXUFKA       
ROHLFOBDRLVL    : TVWPQHWVWRBIIY  VEBEN           OUHFPOONMD     
SNGMKO          : RJVWDDIOMFNUU   DTJE            QXOQR           BJQMBLT        
WCEQGQQ         : YQYISMGGRGYIVY  YFQAYBRX       
AHRTXBF         : LVTHATEUF       CRCPV           FMDP            CAIM            ULFIRLXN        WXDPMLK         FFWGCP          DGND           
AHRTXBF         : PPPUTRKKIY     
PGIJSEVTYLAO    : OIKDPFVJ        OKCHKSK         RAIDF          
OVTQ            : AYCWCOBO        GAQFCF          OKIPVU          BYXFROFBBKE    
NYTEIVNCQNFXSUF : WOOYARYW        NYQOODQX        FNFXRKVVKAWRX   BTUOCXNPRCUYXVC NWTUVQOMGKIKFI 
HAHFTGQTUNKRKE  : BBGSS           OFHUCJWVV       UUXDXVRY        KYGYO           TPXHKJOORSVSKD 
ADRGMOTQHJWF    : WOAQJLUTEVYHSNQ GSKVARYKDW      MUGTIKXWSOKHF   TLVXA           SOUXMAPBH      
TMDB            : OFHUCJWVV       QRWNBPJSLFVHFH  SYAKM           AUXQOXUUIAWUS   KRQWVQVILCFJ    EOIMDH          LHFTPJCVSOMRM   QMMQFJAJJFBMC  
MGGS            : DRXW            DDHGPELJASP     DGYOECX         QDRHAAYVNYLQS  
CQNNKA          : SRRUMJLRNIN     DRKYAWIWWQMWRM  TLSCBOVKDP     
GAUYGJ          : FEQIXJN         SSJWHSWIR       SOQDARQALLRVR   MPXSHWBTGCS    
CBWLXCNR        : PLFHPMVNUIHOPDK WOAQJLUTEVYHSNQ MRISFYVJPTKGX   OGPBDNQQNB      YESRM          
SVEF            : XTKU            BGOJ            CTEHQ          
NBCPTQ          : IFNMLIDORX      CWLADOPTFL      JCWCXBK         IGFJSD          GOTHHVWNJDPRN  
ESYMTULCGBFHASH : QPSLCOMHLDP     FOGUU          
JCWCXBK         : SKXHXYUSTIJPHGH NBCPTQ          XMNQMA          BMMCMLATTQUQ    GSLK            PDXIXUCQYGY    
ONFH            : FUJODO          PWILJXYRGIHTYM  CIDGT          
XMNQMA          : LYQRCHWHMWKTSYU FVLATFPYJUJHHRK QKPPPYFHQVO     JCWCXBK         CBGUAMHD        DDQAROC        
JMPRPWCSPJXYNU  : TROCUUUYP       FAXHDSVDMAK     AIIGFDWJAOGT    SGLHBMJS        NRHQPVAULJIK   
LVQONEVU        : WXRWHO          DGYOECX         QHTKCRDTGK     
TJBMVBAHPPAIMCD : MNYOFCPESD      NMXKSQCIYWSBWUF
NBECXIP         : JMXPW           GLPTKHLFRYQH    KFDWKHLSYBCI   
YGJFCESVOVJMYJW : JXOY            PXLDPNBQDOMOY   HMKDLMH         KGWYOSEV       
BWAPBDTQG       : SPSG            XOFBIQCI        DBHCXQXNB      
UEILAJRMQUSL    : GHMXQKRLXGJGGII NQWI            MNYOFCPESD      IXILKNGBRLL     NVKMHPXX        ISNEDDDLYPRS   
HHEWHPT         : JGUHK           QQQHOVL         KVQUC           TQUFHGFMVHUJMRW
QSBIVGFMOFKSQVU : CWLADOPTFL      JDPFTMFSUUUGVXA WOAQJLUTEVYHSNQ KWNMUAFMD      
PJRMDDIKNMJWD   : UEEHPWKP        KKOSSTFN        IXCVRIK        
VVXYFVFMJTRTOIR : KEQUIQ          UBUHFURSRFFT    QMMQFJAJJFBMC  
LJVFW           : JRQWBM          BVRHKXHBGOD    
KFLX            : GRDLHXBYSHSAW   NNHPTUESY       JOTXUL          XSVRNVDXULRHJQ 
VWWDSTCTB       : KBIGUMQ         NVKMHPXX       
YNJUHFLSYXGJVL  : CTKDPPBMWAN     FTVXH           QAJQ           
WXNI            : HQQXHOBDEH      NLSKBYAFUFRWDAQ PYUAHVRQVEGOVND GPVMAPBQRJH    
HGVHKRBOL       : UNWKQL         
MNTYIDEUVEU     : OLHAMBBPVSU     NNHPTUESY       BMMCMLATTQUQ    NLPELNHY       
PQPXNQNXPWHNE   : BTRHIB          OVXNMONJ        TEWOLI          RRMRXCROQ      
FHIRNUFHVPLDMJ  : OLHAMBBPVSU     FHHEIEVSFTOHS  
JOYAGYPWMQOJ    : DIUWNGA        
DQRIXACMWJV     : VALCFBVJVE      TAMMIIBYW       GIEYHUKPFYQB    ANAQVUCKNQ     
CJWOTIYKHBQG    : EVSA            WIDX            OIPCAMBY        ARTOOXKPCJLSLY 
OUKFEKIUCTVC    : JJRYBBXSPVIJHON KUFHTJSOK       XTWAE           DNLRCTMKFRAN    YTEIUUIRUN      GMRBJITQ       
KBIGUMQ         : RKROLHBSPSF     HAYORQTEIMWU    IPQB            VWWDSTCTB      
DMCEWLGNR       : VKYE            EVSQ            HFICMH          IXILKNGBRLL     OTWOII         
EMOKTBUQ        : PUDLNX          YQYISMGGRGYIVY  SUUMSW         
OOHNYIXGGMYCPL  : RKROLHBSPSF     GPALYDR         UOOOU           JIIHN           OCWXOUFQCTT    
UKQDXLHFAVPVWKN : EPSLYCV         OXMQRNLIMFRNFWP SOLVKBDPPH     
CELRETRMCENFTBK : MXSGYW          ANOQVOTFT       MYHXXDUDJD      RCOOFKGX        PBMFDOTEQUXNYI 
LDTLQBQRWINVVD  : JPODPHXPVO      CBGUAMHD        MOBIKDJUXEY    
XILROGJBKNOP    : OLEFCYGUF       GKONFDMFMK      UNKEWKMUKMYMYJ  NGULORNGWMWKWXD
RCYDGUOWWIQVS   : WSKMOVQG        VCTXYIHHS      
SOKSOUFIJNRM    : PGBLDJT        
FDQPUSQXBLPBIAR : MTHONFSYO       NOOWLMLOESVDC   CVBOMWIGCVIENX  QAJQ            VOUXPWC         WCHJXLDG        EGSBFAAY       
SYAKM           : TMDB            DRXW            KCKFDXJD        IMVBJ           RMRJQVNNVKJTE  
BJCKTRCISKMJC   : ORWIJRRGP       DHCRWRBXLBON    GDPKB           SWKLQWQJWV     
ESKGGAJPCBW     : NPREMBFKNFOLECH
DYJRVLBBXWU     : SLGWYFWUGKGIDJ  OKIPVU          EVSQ           
GNOUYQEEJQ      : DVYPKQHLRYG     RKKYQUU         TOHIACMDYKPIPL 
QQVIUYHUE       : BRLMVAFDYMFAYO  HRSQDDSXIVWL    WCTMOSWVWUGBLEQ HJOB            VCTXYIHHS       EFGTLJHWL      
EVGRA           : JFLINXEUNPBUHUX QOLUJCKKWT      TLVXA          
PWDUFQJC        : RKROLHBSPSF     BJWMA           DKLKBA          XHHSJEDDNUNB    GOJYQXUXDMPRAE  LYKYHOTTAG     
BJWMA           : DCETIWGANWQGU   OXEHWCNNEEYM    HDXRUULWI       HLYVUCGGXXVIP   PWDUFQJC        VPSKTLBEJWRPGMK
FTHPQIYLNHQL    : UNAUMEWNLWWCVQ  NVOYBA          MKREDYCOJEQXJIA
ILXBLBVSUHX     : JGJYEQEM        BQPMFGQXUQMAYQ  AAYAORMLEYERRH  FREGIEJOWXBIN   EXMDBYD        
KHMXJXFFHXW     : OSXMFDISW       QXUPJLWFPSBLG   RHIYQK          DLGBXLEX        KNDIILILVAN    
WIFF            : HHWK            KGWYOSEV        GPVMAPBQRJH     TNPUVKMYGRU    
RVKFTN          : WGHRH           UNAUMEWNLWWCVQ 
XLMUSKIETWEF    : JKYLTACD        RLONKXCTKEHEEL  UFFTCARJKNIXNXG FQVYBYTTTF      VDTQXUXDERCHX   TWFYTGHSFHIUWDM
LLGJIXHQ        : FFFQS           OTWOII         
OSXMFDISW       : KHMXJXFFHXW     GOTHHVWNJDPRN  
ELBYXLDRKJYHVKP : VRVSNKNKSIFIN  
UOOOU           : OOHNYIXGGMYCPL  ITFQBG          CWNNJYXH        GHRGFLAY       
HSTOXDHWJ       : XKBPMAGCVQITHE  DHCRWRBXLBON   
INMIYSCMC       : BFWDUDK         UQSLXOQMVWA     OIKE            UTDBOWJ         YFUDER         
TAMMIIBYW       : XTUGCKYT        DQRIXACMWJV     YRGWCIXLVK      TGANO           PDKVUEWGSXK    
FGQYUOEEOORY    : COWTFWXOVDDJJJJ JGJYEQEM        RAUJWBGOPDWDA   XRKBVCYOAQ      IHMRPJTDLAFJL   YTEIUUIRUN      EMVSHYCPVU     
GIFYKRCOOE      : IKNDXMNYIXO     GLPTKHLFRYQH   
BMMCMLATTQUQ    : SOWNDICCI       JCWCXBK         MNTYIDEUVEU     CYJKKSL         VDTQXUXDERCHX  
AUXQOXUUIAWUS   : GEGBSPO         KINCUVAUC       TMDB            WQQJGO          TISWDMESOEFJQO 
KHDOKSDMFOOBKFV : FUXWPCF         GVJFGOGPPHJ     SKIKHNNLPQWGE   GCQJFXWT       
OVXNMONJ        : DURGMUWTK       VTGFJOCIQWSAK   PQPXNQNXPWHNE   NHTFOCY         IXILKNGBRLL     OTWOII         
VKIQFJDOPRYIUN  : JPODPHXPVO      RHRX            OQFN            OIKE            YAVHLIULGC      NWKTPO         
LCQXJOYA        : VQWW            SECQAOSCLYJS    WJSWGX          XRQMYXOHLM      LNNT            XOJKLXEKE      
YNCPDMCY        : SLGWYFWUGKGIDJ  VPAXPDWJIGFIID 
KSEWVSM         : WCHJXLDG       
TULHKALDXWRAWHB : GBBHMGLWAJFQIA  XHHSJEDDNUNB    KCMEYRP         HKFSOBEP       
KRQWVQVILCFJ    : TMDB            NTTGBTWYYM     
RAQMOAYQLE      : RKROLHBSPSF     EVHXUSLC        AOLCF           GHWXV           BJQMBLT        
IYQHGSUQMMP     : PGYHBXX         AAXSGPWCSFJ     UQSOPOFGYSKIK   YUOFUPRF        BKPYLOQOHISCTH 
FNQSPYCMQFDGV   : FUXWPCF         WIIAXXAJG       MFWMSNGIBOUGHI  FVGE           
HMQMDBNUJ       : BALBGTWFOKRDGJ  IMVBJ           AYFQFTUHTOWJS  
PGNCSFM         : IXCVRIK         FYAVEHKXHY     
VFSLEXBVDGEY    : FUXWPCF         EOTO            HJOB            QFKYSULOU      
LLFAQ           : HLMIOVXH        EKBAKR          REXUS           GCKBXPDP        QWVNBQHHXBJMPRY LGHBMTWHA      
NLSKBYAFUFRWDAQ : IUWMPIBGHPAD    WXNI            SEVM            YULY            QSWPOKROCPQKX   QRLFJEF         QQMHXKN        
EOSCTB          : DVVH            RNNKJQ          JWMOD           CGSMKINN        IAYOFR          SOLVKBDPPH      UQAHB          
SPSG            : BWAPBDTQG       OPHM            GPAJSFTOLOXLGT  SKIKHNNLPQWGE  
SYFJLATOBV      : JPODPHXPVO      QPSLCOMHLDP     TPXHKJOORSVSKD  JWWBQTW         QQIHFEGLARKCRQ  GIEYHUKPFYQB    KTHELKH        
VDQTHQMY        : COEQIPTRGMTNWDB TLSCBOVKDP      KFDWKHLSYBCI   
DRXW            : MGGS            SYAKM           DEWEHLHLSPATID  TKHUTNTPKRGW    YVTBT          
FRLAAHUYOG      : SSFTQM         
OCCPXBOCRKJJWI  : VWVCIJG         UXYJUTVCIYC    
CCHYWOQKOS      : BLGBMDXORYMNMC  CVHMVAR         TTVXDYABVM     
MRISFYVJPTKGX   : ATEORGTWFGFII   CBWLXCNR        WOEBGPDD       
QHNP            : FVLATFPYJUJHHRK SKLM            JRQWBM         
URTFSTTL        : JXRDNMEKCUYRRN  VWVCIJG         ACICFKCHDNT     YQYISMGGRGYIVY  GRSFCUX        
LEBAVJSBJQMBN   : NGBWIFAJU       GHWXV           KFDWKHLSYBCI   
HLAATPP         : UGLJSUOKE       EXLUHKEDBOBRV   URCCMPQ         RFPMMVEQIWPTE   CWXKGFTTQNEIFM 
NJISCEMN        : VFOXYNEOJYAE    DHCRWRBXLBON    KVQUC           PDKVUEWGSXK    
ATLAPXVTJM      : TPXTSELJXVAGGG  JDNVAUE         NCGINENJDNTJYW  EOAXDLMDYVWEBMF FQWVHS         
KAETMGVIVNVLWEE : HHWK            NASSCDXDLQTTG   TOXPAKEB        QHTKCRDTGK     
KTQVTKHWCF      : LQNMONLANEDBSKM UDURE           VTOQKNCHPQP     DEWEHLHLSPATID  FCSYO          
VOHFB           : MTHONFSYO       DECXDHUMYYBBRX  MYHXXDUDJD      VRVSNKNKSIFIN   MJPYSCPE        DWTUAJKYFQMXYRD WHSC           
LWWTSFRG        : MVJIBNOQUPXE    FRXAATBDIP      GBLSYELEKQIDQIG
EFIIGUEYQBJYX   : JJRYBBXSPVIJHON SMIDHKWOQAQLW   LNNT           
GSKVARYKDW      : ADRGMOTQHJWF   
WPMPY           : VTGFJOCIQWSAK   DAXBS           RCOOFKGX        IHNGSRPI        DNYEWMN        
VEBEN           : XKBPMAGCVQITHE  FIQJH           ROHLFOBDRLVL    PYUAHVRQVEGOVND NRHQPVAULJIK    BVRHKXHBGOD     BFVTLQ         
LMPMWOMLWFX     : YUOFUPRF        SJHOCVPPFM      GNHQPUIOIWIWEQ  SAUSOIYQCU     
FQUSVRAVJP      : FEQIXJN         DMNW            XKBPMAGCVQITHE  QWEIINPSHESYHD  AXHRQVN         DWTUAJKYFQMXYRD
IIJNLN          : CBKDFK          KFELQOGTJTHUK   EXLUHKEDBOBRV  
JYPYNOPAANF     : SOUXMAPBH      
INRF            : LVABGCJBWHKAGNV BYSMII          EMEXQIGBCOD    
PWILJXYRGIHTYM  : YETFH           ONFH            SQJBI           ICTGQJRBUBY    
ADDORTOUHWX     : HCSPELHGFLVEOHY WOOCEITAPSD     DVDQ            RIKHSNU         XLQCPDUGQ      
MPXSHWBTGCS     : MVJIBNOQUPXE    GAUYGJ         
KCKFDXJD        : BFWDUDK         UUXDXVRY        SYAKM           YRGWCIXLVK      QSWPOKROCPQKX   GCQJFXWT       
ORWIJRRGP       : BJCKTRCISKMJC   GMQGXRU         DCJOUWIKJNXX   
SHKNPJQLSUEV    : RYOVIYURNRBW    HMQSPHXLV       QBVLXQAJ        EWOQPFRDGO      FREKLHWVIPUCTTW
IGNNGYRLNLJY    : RNPWMF          SUGMTVMASP     
BQFTF           : QQQHOVL         BJDCBURPXJ      VJNMJLCPLL      IFTUKCUBIWYWPM 
DPNUCHGUCN      : OLHAMBBPVSU     FREGIEJOWXBIN   DMTLJKASMUQ     FKLOEHG         ERITSKSLNCF    
KXYA            : EGETL           DVYPKQHLRYG     HPSDMM         
IYGTPRDOPHHUDN  : RIKHSNU         DTTPY           KYRSOCALGILEKD 
IFLEHSMEXAUKBW  : BNUNFSTLINDSMR  QOBHDPE         GROXGIBYORMDOS  VEYXR           KRTJAXUDPMVC    SMIDHURRWBO     QNQEDDQWUMPAO  
NHMTBENHSDQBB   : NUQDYBGOHUL     CVBOMWIGCVIENX  FDDNPBW        
QYEVKIEG        : VTOQKNCHPQP     KHMDTLUJG       CYHBYSJLO       MAQESPJMBJUPOB  XVJYJMMOEESL   
IGXGSYFGOM      : EFEJWIKXTIWCPQ  PLEMCARXGNTS    UDURE           SRJXIRWCD       DQBBHCOIOX     
IPAWYVCPYDLP    : EFEJWIKXTIWCPQ  HRLOCGOHVJX     DDQAROC        
QLPBRVYDEXL     : GMQGXRU         BVRHKXHBGOD     FYAVEHKXHY     
YQEOFCWUCVUA    : BTRHIB          EVXCFYVOMVD     GAQFCF          SFPAAKSLJDEIHJT
KYGYO           : OUGV            HAHFTGQTUNKRKE  JOTXUL          BTUOCXNPRCUYXVC QNQEDDQWUMPAO  
RDBSWWU         : JMXPW          
DSLATEG         : CWLADOPTFL      OGPBDNQQNB     
JIIHN           : XHADCANXWAFVQVB OOHNYIXGGMYCPL  HPHCG          
CNFONMPCXHHB    : TROCUUUYP       IKGTWCNDX       QQIHFEGLARKCRQ  HAYM            YESRM          
FAXHDSVDMAK     : JMPRPWCSPJXYNU  WHBUKAEXWNTJTQG
MUGTIKXWSOKHF   : IXKSQGGRKKFUPWS ADRGMOTQHJWF    KVQUC           BTUOCXNPRCUYXVC
HOYIRE          : HPHCG          
RNNKJQ          : EOSCTB          GVKP            GRSFCUX         FQAINPWKTCWCL  
MDXYBEUJ        : LVABGCJBWHKAGNV DTSRO           HQAWE           NIOTNLFOBNKGSY  PEEIKHL        
UGLJSUOKE       : DFEWTHLOX       HCSPELHGFLVEOHY HLAATPP         DRHXUFKA       
JMXPW           : CHKUSFXGHFPUIGO NBECXIP         RDBSWWU         DTBMCMHBVYBEWBM TOXPAKEB        ARTOOXKPCJLSLY  KBXXGH         
FMDP            : WOOYARYW        AHRTXBF         GMQGXRU         CXWKQYTGL       YIOOOKF         KBXOVDOBCEWXWVW EFLFMKEFBJV     LYKYHOTTAG     
FMDP            : CQNGFNOBHLMLH  
DCJDDKHAWB      : EABTQPXBTNFIH   EFLFMKEFBJV     MIJNKG          CAFITFSJX       BREXX          
DOEYKVLOCWEAOD  : NNHPTUESY       AOLCF           RJVKGEKTTOX     OKOWGYSFVLR     MOBIKDJUXEY    
TQWJWCNGIQ      : BALBGTWFOKRDGJ  EHJAQEU         QDVNG          
RQQSNVISWUO     : DAXBS           FPHNCPGN        KKWHRMAS        XXVDAIGNHHVEIX  GPVMAPBQRJH    
JSHP            : FHHSOUKHMR      YKKEIFHWYKAWH   SLHXUBDJKGM     IRCSNVCHTRDWYDG EWKQEOCCXT      QJDFTXLAYOOI   
VTOQKNCHPQP     : IPWEOPVMAAGRQRI KTQVTKHWCF      QYEVKIEG        QLVYPOBDJHVHPT 
JLSDC           : FEFKWMGDDT      CGSMKINN        GVHP           
QBVLXQAJ        : SHKNPJQLSUEV    CNCLCBYYA       EGSUCYKDNFRP   
UQSOPOFGYSKIK   : UEEHPWKP        CIIGPPPFCVIJFM  IRCBYXHFMLEUSAQ AFIDXMMYCJWFA   MLNG            IYQHGSUQMMP     DPHBJ          
BLNMESRP        : VJSUAWRTWVU    
UOVSFXE         : XRKBVCYOAQ      TKHUTNTPKRGW    RNGRTITEKEYNID  RFYOK          
TVEKNSPTUK      : RBFCC           GCNGNNSRFXJTKHB GFDA            PYUAHVRQVEGOVND VOUXPWC         BADARSCLSSALSPX
FUKIGA          : FHTB            FJOPBM          KOGAOBTSFTVQMQM WSKMOVQG        TPOWBCLIJLMPGP 
KSPDEKRCFWBMKW  : QHHOISYTFO      LTGMIYESTHE     LYTSGLKSECGWYUE OKCHKSK         FQWVHS         
OJXJBRGLAM      : ERHO            MXHIFGSARTCRJ   UGWI           
KWNMUAFMD       : QSBIVGFMOFKSQVU PBPNXTENRIFF    ALMHNPBCW      
YUOFUPRF        : IYQHGSUQMMP     LMPMWOMLWFX     CAIM            KUFHTJSOK       JDNVAUE         FUQVCGLTJTE     TITYFMXIUJ     
EVXCFYVOMVD     : YQEOFCWUCVUA    EXYQKUMT       
JAJVVJCI        : AGBHSXHMURBGNUM PISROANASATWAU  SKSTHTVNUBHA    VCBYBKMJIX      QYJSQLAY       
OIKDPFVJ        : QPSLCOMHLDP     PGIJSEVTYLAO    NMXKSQCIYWSBWUF DMDCDKXPOQTKWGQ
MNILPO          : DECXDHUMYYBBRX  VYTA            YEXNWIKEFCD    
LFCHIV          : BKPYLOQOHISCTH 
IHNGSRPI        : WPMPY           SJJVSXDAXTRTJPQ
XTNPBLYOYM      : WAJEAMNPOSMNXX  EDWNJ           FAHFSI         
KENYPSB         : TYDECRLHGCP     JJRYBBXSPVIJHON SRDCMIVFFPBD    DTTPY          
BYSMII          : INRF            HCELYBSYFH      NQWI            RWIWRBDYSCVAWFH
CAIM            : TDNRABVU        AHRTXBF         YUOFUPRF        WCGALSHXNVCPY   AMPWYYLPUERLJF 
IGAXIMYWLLVXP   : TUHOHXHBTOF     DKHRWBLLPLPK    GMVGMHWYI       DMTLJKASMUQ    
YHDBHHCATNIMPKX : WTMCB           EPFSUNCTLY     
WGLWHVJG        : AAKL            TCIIYDVSKIELOYF UIDWBJHIPPON    LPTQGCQCMRES   
WUQUMB          : INUTRRR        
UFXE            : NDXYSKMDYAFODQ  IDCTWYHUILDJU   AAGNWOOKDOGJ    NLPELNHY        FBTUPLGVBVJXLGG
CGIP            : JCULGLBDGGOJGB  IRVUBW          MYGV            FQAINPWKTCWCL   EFGTLJHWL      
WHBUKAEXWNTJTQG : ANOQVOTFT       FAXHDSVDMAK     DSBL           
HCELYBSYFH      : JRDALHKBFH      BYSMII          YWDUNFUBXMDULEQ CQNGFNOBHLMLH   TNPUVKMYGRU     FAHFSI          HLGRVWRUTTQEPP 
NPREMBFKNFOLECH : ESKGGAJPCBW     KVHHWGVXXEBLHK  ICHARFU         BLXGF          
XXWPIBVTA       : JSTXXUWAOYVSN   RBFCC           EWILYERVJCLJT   CWJRHPJKDMBMQA 
MYGV            : HQQXHOBDEH      OLEFCYGUF       SOQDARQALLRVR   NTQSUADKQKWJ    CGIP            EPXXLXM        
TLVXA           : ADRGMOTQHJWF    EVGRA           ACRFS           HUGIDPEEY       YCHEXJMOCU      SKIKHNNLPQWGE  
DKLKBA          : IJNSTMXYLMIMG   TAMS            PFXNYYXJBVEBIW  PWDUFQJC        YRGWCIXLVK     
FHHEIEVSFTOHS   : WPQSYQGROKKOK   VIQTRVVBSXJQG   FHIRNUFHVPLDMJ  CHYORI          XXVDAIGNHHVEIX  GNTS            SOLVKBDPPH      LGHBMTWHA      
IYYMSMJQMJV     : MJKKO           GXNYIITPGNE     KYRSOCALGILEKD  TQCD            LQADDYPAAPDDHY 
UIDWBJHIPPON    : MTHONFSYO       TGQNSLKMORY     WGLWHVJG       
VHYDACNBBBVNKOC : JNGEOS          NRPQEUFQ        BLXGF           VKYE            TEWOLI          NAYPAIH         VYJQBOPV       
KEQUIQ          : OPLOFKETINKGRY  VVXYFVFMJTRTOIR AEKTFVTTNO      GSLK            BOHF            IVKAGFLDAMCL    KFDWKHLSYBCI    YWQBNM         
TXHJPXWAUEBAG   : NYQGLUNIAINLC   AFIDXMMYCJWFA   RAFE           
OJGPFVCTXXGF    : DLPMBWVJALQXBPX NIOTNLFOBNKGSY  GJFDCTLXUJHUU  
DPHBJ           : UQSOPOFGYSKIK   JGORATAPD       KBKLECLWWVYNKCQ FFWGCP          HFICMH         
KSWJRWGVX       : FNMYBSF         YFQAYBRX       
EDWNJ           : XTNPBLYOYM      CARLKSNWXPKP    BREXX           FDDNPBW        
UHSOISWNK       : XWMDHADGNSQJDM  VMLI            BJDCBURPXJ      SJAAFGAGXEE     KRTJAXUDPMVC   
DTBMCMHBVYBEWBM : YDLEEY          IKGTWCNDX       JMXPW          
FKQQBNYUCJNY    : BRLMVAFDYMFAYO  YVFXW           LGHBMTWHA      
AYCWCOBO        : RLONKXCTKEHEEL  OVTQ            SAUSOIYQCU      MKREDYCOJEQXJIA RFFLRLFFB      
CMWDQT          : RHRX            YFBVATXIVAXUXWD HPHCG          
EWOQPFRDGO      : SHKNPJQLSUEV    QAJQ            UXYJUTVCIYC     MUSIYRHAGSLBO  
RDIOFJSCL       : AAXSGPWCSFJ     GVKP           
DDHGPELJASP     : MGGS            YVTBT           HRLOCGOHVJX    
JGORATAPD       : TIEXOVD         FNMYBSF         DPHBJ           QQIHFEGLARKCRQ  HFICMH          FXXS           
SLHXUBDJKGM     : JSHP            BLCOJCXB       
OCYBNCVDB       : RFXXYVWWCIS     UDGNAXQIB       EFGTLJHWL      
JSAMOACSSWE     : BTRHIB          YNIYJMEW        RSWDQJX         UGWI           
WCGALSHXNVCPY   : DKHRWBLLPLPK    CAIM           
RXTUGGPISFIW    : FBXBJXDJDPTQT   JUMDHW         
CTEHQ           : SVEF            OWCGFLJUGSWKK   TKHUTNTPKRGW    GCNGNNSRFXJTKHB FHASJD          CPJC           
NTTGBTWYYM      : JCULGLBDGGOJGB  YKKEIFHWYKAWH   KRQWVQVILCFJ   
PGBLDJT         : AVYG            WOOYARYW        MTHONFSYO       EVLUGYRWUNC     SOKSOUFIJNRM    MIFPHL         
ROBALBEHHLYQBU  : VYTA            RQLEWUFBGBKAUI  GNJEGQGKICG    
KVHHWGVXXEBLHK  : AAMPMB          VLYAWE          NPREMBFKNFOLECH KVQUC           SYYW            HPHCG           DMDCDKXPOQTKWGQ WXYHSOEENKHEQJ 
DEWEHLHLSPATID  : PLEMCARXGNTS    IHMRPJTDLAFJL   DRXW            KTQVTKHWCF     
UNKEWKMUKMYMYJ  : WGHRH           EPSLYCV         XILROGJBKNOP   
HOEGTLRDYLUBFD  : IIRYRNUPBJXI   
UBUHFURSRFFT    : VVXYFVFMJTRTOIR JCHWLCSYII      QFKYSULOU      
GDSPRYWNKOTMAON : BYJL            BEROLNNAIA      CARLKSNWXPKP    HHUBJCAMSE      DDQAROC        
SSFTQM          : RKROLHBSPSF     AAMPMB          FRLAAHUYOG      CVHMVAR         EUTKGEPTMAVQMP  KKWHRMAS        HQBMMS         
NHTFOCY         : OVXNMONJ       
KEBBYBXONOIARXO : EVSA            TPXHKJOORSVSKD 
SJHOCVPPFM      : LMPMWOMLWFX     EGGHJOYXVOT     QAVKGLO        
TQWCBCG         : OFHUCJWVV       JUMDHW         
DHCRWRBXLBON    : BJCKTRCISKMJC   HSTOXDHWJ       NJISCEMN        SAUSOIYQCU      XHWHYMTRRFS     GPEPCEYMSVLN    SUNQHRVAJGO    
XUKDQCS         : LEVLNPCTVELJ    IUWMPIBGHPAD    BGOJ            QVYAMXNDTAMPF   EIBFIESMA      
QQQHOVL         : HHEWHPT         BQFTF           CAFITFSJX       MOBIKDJUXEY    
CNVJS           : YFRHQTNYCCLKFR  IYISEXMJEWWSTD  VPAXPDWJIGFIID  CJIWVD         
GMQGXRU         : ORWIJRRGP       QLPBRVYDEXL     FMDP            LXJBVRMEIBPEOUO KOGAOBTSFTVQMQM YIOGVCTTTMIUK   CTKDPPBMWAN     KUFHTJSOK      
GMQGXRU         : XLQCPDUGQ      
NVIAYYDRXT      : XOFBIQCI        GROXGIBYORMDOS  TWFYTGHSFHIUWDM
PEALPSPFQY      : HRDU            DGGOXMOLCJBHCC  EUTKGEPTMAVQMP  KVQUC          
GHMXQKRLXGJGGII : QOLUJCKKWT      UEILAJRMQUSL    SQAHJD          JFNJAVNLLEMWL  
DGGOXMOLCJBHCC  : PEALPSPFQY      GROXGIBYORMDOS  MKREDYCOJEQXJIA IVPPSTMUA       HMNTNWQELTKSY  
IMUIDGB         : WJTFCEPH        PISROANASATWAU  TSBFWKHYSQLO    WQQJGO          JLGMEXRDGRAI    QFKYSULOU      
GJBPRJ          : EYHNUKFDWOXKJK  UQDTNLNQ        OWLAP          
EOIMDH          : EVLUGYRWUNC     TMDB            ULFIRLXN       
TSBFWKHYSQLO    : JHNVMRVEDMTPKVM LQUQYYQ         IMUIDGB        
OWCGFLJUGSWKK   : CTEHQ           BGMIXSNIKS     
YNNAKIDPFNXHH   : KIMULRQYRKFHL   RFFLRLFFB      
SXPKUUSCGCAMWWY : ALHD            MNYOFCPESD      CMMVFDQSADMOB   FJYEI           MPWQFVEJAXILATX
DAXSAIEDXLRVUBM : SMIDHURRWBO     IJUOPMNFET     
YFBVATXIVAXUXWD : CMWDQT          NXPX            HSTQ            SCYKS          
XBYXJFEJSVGOYU  : NYQW            QQIHFEGLARKCRQ 
XAGVAAVJ        : AAKL            NHLAW           VCNDBBVYO      
WJSWGX          : MVJIBNOQUPXE    CYYL            WYOHEFQ         LCQXJOYA        QFRCKKYRXQEYUL  YWDUNFUBXMDULEQ MFQWCOBY       
GBBHMGLWAJFQIA  : WTMCB           SKXHXYUSTIJPHGH XTUGCKYT        TQQUMUDXUGTP    TULHKALDXWRAWHB XDXMDPLH        CMMVFDQSADMOB  
IBAGDCCOCBXWAH  : DSBL            KUSFVTMOYIK     FHKORMEM        YVTBT           HKFSOBEP       
DNYEWMN         : WPMPY           UGWI           
LPTQGCQCMRES    : NYQGLUNIAINLC   ROYQKGNVLL      TKFMPYUL        WGLWHVJG        EWAKCJXFVEARMCM HKFSOBEP       
IVMKYLHASF      : EOTO            KKOSSTFN        MIFPHL          FGBBSTWI        OVEOXFVQWICVLQ 
IFJGTYQ         : YEXNWIKEFCD    
QLVYPOBDJHVHPT  : VTOQKNCHPQP     AKEYKMPBCRASU   RONUHPDS        JLGMEXRDGRAI    KBBSFNDMNMMWNYT XNRECAPTT      
CVHMVAR         : BOTCALU         JCRPIGGWMCGIJC  CCHYWOQKOS      SSFTQM          YSNFRPP         CVBCFRRI        MIFPHL          DLGBXLEX       
JYMRSMIAFVXFM   : VNWJLBQ         SVFARVOAVIHE   
IRYQP           : GEGBSPO         YQYISMGGRGYIVY  BVQLGSGWQFJQWNX OUPQWK         
IKCNG           : FUJODO          KFELQOGTJTHUK   NQWI           
AEKTFVTTNO      : JCRPIGGWMCGIJC  KEQUIQ          MXDWPFDTTYMPRQ  GOJYQXUXDMPRAE  VLUHCMDUNTJL   
YPMUPTJFC       : SBNAIDLGDOOH    TCDLLYEDPJDJ    KBXXGH          GVHP           
EUTKGEPTMAVQMP  : XVJCA           SSFTQM          PEALPSPFQY      XTRRL           DTJE            OOHVDFFXORRM    YWQBNM         
JJRYBBXSPVIJHON : GPALYDR         OUKFEKIUCTVC    EFIIGUEYQBJYX   KENYPSB         EGGHJOYXVOT     BPNXLIJMUHUSY   IFJGKDXRHYDLXP  LOYEGTWHBH     
JJRYBBXSPVIJHON : XOJKLXEKE      
ULFIRLXN        : PISROANASATWAU  XSVTCSKNQWMR    EDCQNTPOIB      AHRTXBF         EOIMDH          YIUBAQQQOBISN   DGYOECX        
XJQMBQXNIX      : DVQULNMM        YVBPNSIJNVN     NUTCSXHXO      
LXJBVRMEIBPEOUO : DNDFDHDCAPR     IHMRPJTDLAFJL   GMQGXRU        
GMVGMHWYI       : NWJHVKQYH       IRCBYXHFMLEUSAQ IGAXIMYWLLVXP   YAVHLIULGC      FVGE           
XXXXMMV         : JSTXXUWAOYVSN   GCKBXPDP        BVLAYIELVMAMS   FREKLHWVIPUCTTW TQIDWVXLE       IJUOPMNFET      RSWDQJX        
NUQDYBGOHUL     : NGJTNPKJASAER   NHMTBENHSDQBB   QXIQPD          TAOEKDJSVRUP    HRLOCGOHVJX    
DRKYAWIWWQMWRM  : FBXBJXDJDPTQT   CQNNKA         
GYSFPNXUMYBD    : QOLUJCKKWT      EWXOOL          HCSPELHGFLVEOHY FBXBJXDJDPTQT   CPJC           
XOFBIQCI        : BTYAHBWEVFFW    BWAPBDTQG       NVIAYYDRXT      XLQCPDUGQ       LQADDYPAAPDDHY 
KHMDTLUJG       : OOPXYBDMNQ      QYEVKIEG        FGBBSTWI        BFVTLQ         
ICHARFU         : NPREMBFKNFOLECH
GVKP            : ROYQKGNVLL      RNNKJQ          RDIOFJSCL       YCISMHSYM       BRHXKMROH      
CXWKQYTGL       : LRENLLICXNBP    SQPI            FMDP            RCCJKRLN        KBQGTXWW        QJDFTXLAYOOI    VRVGDMVMVOEX   
TPXHKJOORSVSKD  : HAHFTGQTUNKRKE  SYFJLATOBV      KEBBYBXONOIARXO OLCIHUMWKYEBQ  
RKMDA           : PLEMCARXGNTS    LYOKHM          EGYHOSY        
FXIROH          : RVSFAYQKWICRDP 
XTRRL           : CYYL            EUTKGEPTMAVQMP  FNQQOHDYVE      BEROLNNAIA     
YVBPNSIJNVN     : JHNVMRVEDMTPKVM MVJIBNOQUPXE    NGBWIFAJU       XJQMBQXNIX      SOWNRJDJOS      DBXUITCSAWIDDA 
NASSCDXDLQTTG   : WOOYARYW        KAETMGVIVNVLWEE FQAINPWKTCWCL  
PXLDPNBQDOMOY   : OLEFCYGUF       AFIDXMMYCJWFA   YGJFCESVOVJMYJW HIJKJF          OKOWGYSFVLR     YESRM          
KOGAOBTSFTVQMQM : GOWLWVGHNIE     RXDXKAC         FUKIGA          GMQGXRU         EWKQEOCCXT      AVRBQPBU        ATWVWANTJYF    
IERUHIIJB       : TKFMPYUL        OUCTBDWTQCMV    GPVMAPBQRJH     UDGNAXQIB      
XNCYQONYR       : LYQRCHWHMWKTSYU IUWMPIBGHPAD    LCMPPQQD        GJFDCTLXUJHUU  
BLXGF           : NPREMBFKNFOLECH VHYDACNBBBVNKOC SUGMTVMASP     
WSKMOVQG        : RCYDGUOWWIQVS   FUKIGA          YKXIXOJJHMUTMCM XVQOEIEEXMUHYL 
YQYISMGGRGYIVY  : MXHIFGSARTCRJ   WCEQGQQ         EMOKTBUQ        URTFSTTL        IRYQP           XHHSJEDDNUNB    QIFKBQACJ       DTJE           
YQYISMGGRGYIVY  : AAGNWOOKDOGJ   
BALBGTWFOKRDGJ  : ERHO            DNDFDHDCAPR     HMQMDBNUJ       TQWJWCNGIQ      YNHMXJKNUVSJT  
WIDX            : CJWOTIYKHBQG    PYUAHVRQVEGOVND SUGMTVMASP      KGTYGMIDUYOY    MPWQFVEJAXILATX
VKYE            : IVHFLENETH      DMCEWLGNR       VHYDACNBBBVNKOC EYXNGOOSVTKQB   GBLSYELEKQIDQIG LTWUFXNNFAQVA  
HELE            : QRLFJEF         CMMVFDQSADMOB   SRJXIRWCD      
NHFAINV         : WISKMVTCKWDHQ  
UKRNP           : VLYAWE          GIEYHUKPFYQB    FGBBSTWI       
YBWJEUCAGDHKL   : DLPMBWVJALQXBPX BYJL            QHOD            ECOBRTI        
XRQMYXOHLM      : FEAMMUMG        SKSU            LCQXJOYA       
GYJVOHWPFGWC    : CBGUAMHD        AHRFPMY        
YIOGVCTTTMIUK   : XWMDHADGNSQJDM  GMQGXRU         NVKMHPXX        EFGTLJHWL      
EXLUHKEDBOBRV   : FQFVGPLWQGAOJ   HLAATPP         IIJNLN          LQADDYPAAPDDHY 
QXUPJLWFPSBLG   : KHMXJXFFHXW     KYDOK           OLCIHUMWKYEBQ  
GSLK            : JCWCXBK         KEQUIQ          ADAWT           MSQDETWLTUE    
XFBIMGKBJEWTUU  : KAHSN           EWILYERVJCLJT   GKONFDMFMK      KSWJ            MSQDETWLTUE     UXYJUTVCIYC    
MGEJL           : TVWPQHWVWRBIIY  GVJFGOGPPHJ     MRSQVT          KNDIILILVAN    
FPHNCPGN        : RQQSNVISWUO     RMRJQVNNVKJTE   SLGWYFWUGKGIDJ  OKIPVU          YESRM          
ALHD            : EWHCBKGUUGDUVC  SXPKUUSCGCAMWWY UUBAWHAMF       RBBIJ           DUQYX           QRLFJEF         XNRECAPTT      
TKHUTNTPKRGW    : DRXW            UOVSFXE         CTEHQ           NRWMFRWDBILPNJH XPWEKWXLEGXGU  
MJKKO           : HHWK            TVWPQHWVWRBIIY  YDNYYNCTUSIY    IYYMSMJQMJV     FEBDRLF         FJYEI          
RCCJKRLN        : AXIQL           JXOY            CXWKQYTGL       XSVRNVDXULRHJQ  BFVTLQ          SWKLQWQJWV     
TQBPDKNXAHP     : UHEKMEAXBWCYPTM
YYJALSKWJMQNQ   : LOQTSYQ        
YIOOOKF         : JCULGLBDGGOJGB  FVLATFPYJUJHHRK FMDP            URPDMWSBC       UESYQID        
BLCOJCXB        : HAFWQDPXUJEN    SLHXUBDJKGM     ABLBY          
AAYAORMLEYERRH  : ILXBLBVSUHX     SUUMSW          VRVS           
CWJRHPJKDMBMQA  : XXWPIBVTA       VRVSNKNKSIFIN   WQQJGO          JCHWLCSYII      OOHVDFFXORRM   
GAQFCF          : OVTQ            YQEOFCWUCVUA    MNYOFCPESD      SVFARVOAVIHE   
OQFN            : WTMCB           IOGBHSYBOIFYHCR MYHXXDUDJD      VKIQFJDOPRYIUN  NGULORNGWMWKWXD
XHHSJEDDNUNB    : PWDUFQJC        TULHKALDXWRAWHB YQYISMGGRGYIVY  QWEIINPSHESYHD  BJDCBURPXJ      DFOSYOKK       
CCMSCCBE        : SGLHBMJS        IYISEXMJEWWSTD  QDVNG           RVFTQ          
GGXIUQ          : VNWJLBQ         OPHM           
KQNTXJGEOJTL    : CYJKKSL         SRDCMIVFFPBD    CPJC            JMGK           
ULDXXWCCAHXJPXR : COEQIPTRGMTNWDB OXMQRNLIMFRNFWP
RHXIXSIHYMXKGJK : PTLIL          
UNAUMEWNLWWCVQ  : UUWSKQWHPMBX    TDNRABVU        FTHPQIYLNHQL    RVKFTN          WECAJCKU       
NXPX            : ANUQOCGPFKYSYD  YFBVATXIVAXUXWD MDRSV           FDDNPBW        
IGFJSD          : NBCPTQ          JRRIH           OEEMP          
BOHF            : TROCUUUYP       KEQUIQ          KKWHRMAS       
UHEKMEAXBWCYPTM : GQKKWFDYMJYTAI  TQBPDKNXAHP     DNVKHNVLKOA     DISFTCFQRIEO   
KKOSSTFN        : PJRMDDIKNMJWD   IVMKYLHASF      GJFDCTLXUJHUU   ICTGQJRBUBY    
APOJWYEFFQRL    : SUWW            NFYLGLV         JEFLCVMPJJI    
RNPWMF          : EYKVUFAPEJ      LMPWJUWYD       IGNNGYRLNLJY   
CVBOMWIGCVIENX  : REXUS           WTPRYND         FDQPUSQXBLPBIAR NHMTBENHSDQBB   XPWEKWXLEGXGU  
LYTSGLKSECGWYUE : HHWK            BTYAHBWEVFFW    RCOOFKGX        KSPDEKRCFWBMKW 
WCTMOSWVWUGBLEQ : HHWK            QQVIUYHUE       RJVKGEKTTOX    
FLPMYCFFGNCIIHB : MXSGYW          JMKLKMKCODKX   
JWWBQTW         : UWFL            SYFJLATOBV      KSWJ           
QFRCKKYRXQEYUL  : WJSWGX          GXNYIITPGNE    
CYJKKSL         : TUARSFGXFMLFBYY BMMCMLATTQUQ    KQNTXJGEOJTL    TEWOLI         
FIRGB           : ABLBY           JRRIH           EXMDBYD         JFGG           
FREKLHWVIPUCTTW : SHKNPJQLSUEV    XXXXMMV        
BYJL            : GDSPRYWNKOTMAON YBWJEUCAGDHKL   AMPWYYLPUERLJF  YWQBNM         
TEWOLI          : PQPXNQNXPWHNE   VHYDACNBBBVNKOC CYJKKSL         KBQGTXWW       
RJVWDDIOMFNUU   : UDURE           SNGMKO          DURSVATA        PPAWY           FBTUPLGVBVJXLGG
YRGWCIXLVK      : TAMMIIBYW       KCKFDXJD        DKLKBA          AIFIWFROKXWUFJU UQDTNLNQ        UDGNAXQIB      
CHYORI          : TROCUUUYP       FHHEIEVSFTOHS   OYTFHPR         NVQSGPYLSO     
EGGHJOYXVOT     : RTDONWPB        GHFNXUSUY       SJHOCVPPFM      JJRYBBXSPVIJHON KSWJ           
YSNFRPP         : SGIBPONHX       CVHMVAR         KCMEYRP        
DNDLQ           : IFTUKCUBIWYWPM 
LHFTPJCVSOMRM   : TMDB            GLPTKHLFRYQH   
GGFHCUPV        : AMPWYYLPUERLJF  AVRBQPBU        BKPYLOQOHISCTH  VOUXPWC        
HMNVPC          : JNKRVR         
DNVKHNVLKOA     : BLGBMDXORYMNMC  TAMS            TCDLLYEDPJDJ    UHEKMEAXBWCYPTM KGJUUDJHIAKW   
JNKRVR          : LQUQYYQ         HMNVPC          DEPXYBFRIM      BVWPAUCK        RAFE           
AMPWYYLPUERLJF  : CAIM            BYJL            GGFHCUPV        KBBPPNOBO      
TOXPAKEB        : PFXNYYXJBVEBIW  NRPQEUFQ        KAETMGVIVNVLWEE JMXPW          
NQWI            : XCMNOSTISQYFRX  UEILAJRMQUSL    BYSMII          IKCNG           NYQW            QWHEAERAUND     TQUFHGFMVHUJMRW
OIPCAMBY        : CJWOTIYKHBQG    WTHR            DOHFNJHWO      
QWEIINPSHESYHD  : QKPPPYFHQVO     FQUSVRAVJP      XHHSJEDDNUNB    IILDIQHAT       MRSQVT          YWQBNM         
IMVBJ           : SYAKM           HMQMDBNUJ       EOAXDLMDYVWEBMF
PBMFDOTEQUXNYI  : XWMDHADGNSQJDM  CELRETRMCENFTBK FMYADYSCJTXAXCK
NYQW            : LVABGCJBWHKAGNV XBYXJFEJSVGOYU  NQWI           
JWMOD           : EOSCTB          OXSLV           NIOTNLFOBNKGSY  WCHJXLDG       
EYXNGOOSVTKQB   : EDCQNTPOIB      VKYE            CGITCVYQEIIKNVI EXYQKUMT       
LYOKHM          : RKMDA           DUPWTOVTCSDDXC  EAWRYQX         FQWVHS         
IGXORUB         : ECOBRTI        
ABLBY           : YKKEIFHWYKAWH   BLCOJCXB        FIRGB           SGLHBMJS       
HPSDMM          : KXYA            DIUWNGA         CARLKSNWXPKP   
FNQQOHDYVE      : UYXDQFXBJOA     FNMYBSF         IOGBHSYBOIFYHCR IPWEOPVMAAGRQRI XTRRL          
CCXWYCEBDRE     : HGXFPJW         MWINWDX         BNSUN           YINFVUJUHCSFPVX FFWGCP         
SOWNRJDJOS      : YVBPNSIJNVN     QVYAMXNDTAMPF   RBBIJ          
HIJKJF          : RBFCC           PXLDPNBQDOMOY   LQADDYPAAPDDHY 
SKSTHTVNUBHA    : LQUQYYQ         JAJVVJCI        VYTA            TQCD            YVTBT          
COEQIPTRGMTNWDB : FUJODO          VDQTHQMY        ULDXXWCCAHXJPXR EMEXQIGBCOD    
IRCSNVCHTRDWYDG : JSHP            XDXMDPLH        CQNGFNOBHLMLH  
TLSCBOVKDP      : FRXAATBDIP      QFQITBJA        CQNNKA          VDQTHQMY        QODRWP          MGSSTPEMODJH    VPHWXFQJWK     
DSBL            : WHBUKAEXWNTJTQG IBAGDCCOCBXWAH  WXDPMLK         YESRM          
VNWJLBQ         : XDDESQBI        WDVIYYXDKILEKG  JYMRSMIAFVXFM   GGXIUQ         
TTESYLUSYP      : ORLDUERVEPQ     NHLAW           FVGE            CAFITFSJX      
CGSMKINN        : YFRHQTNYCCLKFR  MKOO            EOSCTB          JLSDC           TOHIACMDYKPIPL  TNGPADHFB      
QBFMREVDFNNYJRU : XWCXUTYJS       FSYGOMJVBHGIB   KCDWIIXSHJLQMQN VCBYBKMJIX      MGHQFFNVVT      QCPC           
FREGIEJOWXBIN   : HXQHRNQJWQ      RKROLHBSPSF     ILXBLBVSUHX     DPNUCHGUCN      MPWQFVEJAXILATX
LFSQRKWQPD      : MYHXXDUDJD      UQSLXOQMVWA     HPHCG          
DEPXYBFRIM      : JHNVMRVEDMTPKVM JNKRVR          DVDQ            AYFQFTUHTOWJS   HFJBYGGFWESAPAB
OXSLV           : SFPSDSHAHO      EDCQNTPOIB      JWMOD           KSWJ            BTUOCXNPRCUYXVC
VMLI            : TVWPQHWVWRBIIY  MSQBQ           UHSOISWNK       PDXIXUCQYGY    
GBLSYELEKQIDQIG : RLONKXCTKEHEEL  QOBHDPE         LWWTSFRG        VKYE            UNWKQL         
AOLCF           : OUWMSWQRXICQROJ RAQMOAYQLE      DOEYKVLOCWEAOD  GYFWXGN         HQAWE          
WTHR            : KJPCQKGXW       OIPCAMBY        AKEYKMPBCRASU   MDVIFJQQYCWKTE  EXYQKUMT        XVJYJMMOEESL   
TGANO           : IUWMPIBGHPAD    MLYQEO          TAMMIIBYW      
CIDGT           : VSORCWVRNONDNT  ONFH           
RMRUEADBCSOGXA  : WVUCKD          GRDLHXBYSHSAW   VMEPLAW         WBXEPTARQXSYH  
RJVKGEKTTOX     : GCKBXPDP        KIMULRQYRKFHL   DOEYKVLOCWEAOD  WCTMOSWVWUGBLEQ SVFARVOAVIHE    GVHP           
TFADWMVTQVWTYRI : TUARSFGXFMLFBYY EARMGXPBQFN     CIIGPPPFCVIJFM  LMPWJUWYD       BREXX          
SKLM            : LMPWJUWYD       QHNP           
KYDOK           : QXUPJLWFPSBLG  
KBXOVDOBCEWXWVW : CBVGCG          XWCXUTYJS       FMDP            MIJNKG          TQUFHGFMVHUJMRW
URCCMPQ         : OFHUCJWVV       DMNW            HLAATPP        
KBBPPNOBO       : YIFVUIF         PPKSBJEVFHMMSR  MXDTMEPJMU      RCOOFKGX        YINFVUJUHCSFPVX MSFDDNTCT       AMPWYYLPUERLJF  MKLCCEPFSWL    
RMRJQVNNVKJTE   : WAFNRB          SYAKM           FPHNCPGN        RBBIJ          
NHLAW           : XAGVAAVJ        TTESYLUSYP      VJSUAWRTWVU     ECOBRTI        
BJDCBURPXJ      : BQFTF           UHSOISWNK       XHHSJEDDNUNB    HRLOCGOHVJX     QQMHXKN         XJFJNPODSQ      MOBIKDJUXEY    
QVYAMXNDTAMPF   : VINSVNBWWUXFJS  XUKDQCS         SOWNRJDJOS      JDNVAUE         UHDPDKRWJHWH   
DOHFNJHWO       : WDVIYYXDKILEKG  OIPCAMBY        GBAXVMRHNWQMOI  RQLEWUFBGBKAUI 
XJEPI           : INUTRRR         JFGG           
WBLYBBYQ        : REQUDU          TCIIYDVSKIELOYF VRVSNKNKSIFIN   GAUF           
UQSLXOQMVWA     : OUGV            INMIYSCMC       LFSQRKWQPD      ICTGQJRBUBY    
GYXRYKXRULOVAPW : CHKUSFXGHFPUIGO QXOQR          
OPHM            : JMKLKMKCODKX    MSKSFNUNVXL     NRPQEUFQ        SPSG            GGXIUQ          VDTQXUXDERCHX   WECAJCKU       
AXHRQVN         : WTPRYND         FQUSVRAVJP     
WXVX            : OYTFHPR        
QXIQPD          : WPQSYQGROKKOK   NUQDYBGOHUL     TNPUVKMYGRU     EDRGQ          
GYFWXGN         : GEGBSPO         SKSU            AOLCF           IXILKNGBRLL     AIFIWFROKXWUFJU GUDIQOIMAPJ    
NAYPAIH         : QBEQ            VHYDACNBBBVNKOC SEVM            RSWDQJX        
EXLDX           : TUHOHXHBTOF     LTWBSVAR        UHDPDKRWJHWH    INBSCMHEQL      SYYW           
CVBCFRRI        : DURGMUWTK       UDURE           CVHMVAR         PXRNLGOT        FAHFSI         
AKEYKMPBCRASU   : QLVYPOBDJHVHPT  WTHR            TRJLDWLXOVDN   
COMAASXKUW      : WAFNRB         
YCISMHSYM       : EFBGSDSXXCR     GVKP           
KBKLECLWWVYNKCQ : GCKBXPDP        DPHBJ           QHOD            UGWI           
ADAWT           : KVUD            IPEIHEKRIRFLYK  GSLK            YLSJTEXXBOJLS  
BEROLNNAIA      : TKFMPYUL        GDSPRYWNKOTMAON XTRRL           KGJUUDJHIAKW    GJFDCTLXUJHUU  
SLGWYFWUGKGIDJ  : DYJRVLBBXWU     YNCPDMCY        FPHNCPGN        FTVXH          
HMKDLMH         : TIEXOVD         BKOKKP          YQFTCH          EFBGSDSXXCR     YGJFCESVOVJMYJW AAGNWOOKDOGJ    HUGIDPEEY      
DURSVATA        : EXENALKT        EKBAKR          RJVWDDIOMFNUU   OMGYQ          
FIRHNOCTCKFFWQO : QQIHFEGLARKCRQ  UQAHB          
BRUNY           : HCSPELHGFLVEOHY BVWPAUCK        MPWQFVEJAXILATX
SUUMSW          : EMOKTBUQ        AAYAORMLEYERRH  KBXXGH          FBTUPLGVBVJXLGG
URPDMWSBC       : XDDESQBI        IHLIRYJPV       TPQDCUTAGY      RKROLHBSPSF     YIOOOKF        
DMTLJKASMUQ     : DPNUCHGUCN      IGAXIMYWLLVXP   EPIYASCGJCCVIP  BPNXLIJMUHUSY   EIRYDG          FKKHYQF        
VRVSNKNKSIFIN   : ELBYXLDRKJYHVKP VOHFB           CWJRHPJKDMBMQA  WBLYBBYQ        EYHNUKFDWOXKJK  XPWEKWXLEGXGU  
IGSKVYWP        : DTSRO           GDPKB           XVQOEIEEXMUHYL 
HBOCPJSRILPB    : TUARSFGXFMLFBYY GOWLWVGHNIE     GCQJFXWT       
ARNSAS          : AAXSGPWCSFJ     KFELQOGTJTHUK   KFDWKHLSYBCI    BJQMBLT        
OKOWGYSFVLR     : DOEYKVLOCWEAOD  PXLDPNBQDOMOY   YFQAYBRX       
OIKE            : INMIYSCMC       VKIQFJDOPRYIUN 
DVDQ            : WJUVQ           ADDORTOUHWX     DEPXYBFRIM     
GROXGIBYORMDOS  : IFLEHSMEXAUKBW  NVIAYYDRXT      DGGOXMOLCJBHCC  MVQPWYVYFWFLM   VXIKRDVKFBNGRPI JSGNJJBYEKDQ   
IXCVRIK         : MKOO            PJRMDDIKNMJWD   PGNCSFM         JRRIH          
SOUXMAPBH       : ADRGMOTQHJWF    JYPYNOPAANF     XCDFOAKUN      
QFPBGRRXEUPYYA  : QPSLCOMHLDP     EPXXLXM         XVQOEIEEXMUHYL 
BVQLGSGWQFJQWNX : IRYQP          
EGYHOSY         : WTPRYND         RKMDA          
YVFXW           : BJPP            FKQQBNYUCJNY    VJSUAWRTWVU    
WXDPMLK         : AHRTXBF         DSBL            ACRFS          
IDCTWYHUILDJU   : UFXE            IUFWP           MKREDYCOJEQXJIA LQADDYPAAPDDHY 
CTKDPPBMWAN     : QVSTLYLCLERTHVQ YNJUHFLSYXGJVL  GMQGXRU         NWKTPO          YSXMHGUSHXD    
RCNEWVIAPFBXCL  : RGXNCGYSKRBUTQJ
GUHBYBLCTDFIC   : JRDALHKBFH      SWQXEIRJD       SOEKDEIGWYXHH   MYHXXDUDJD      IPWEOPVMAAGRQRI MSFDDNTCT       YKCCWU          WRRUQA         
VEYXR           : VQWW            IFLEHSMEXAUKBW  UXYJUTVCIYC    
XPMXFTBFVN      : BOTCALU        
EIBFIESMA       : FHTB            UUWSKQWHPMBX    ACICFKCHDNT     XUKDQCS         MFWMSNGIBOUGHI 
SJAAFGAGXEE     : FNMYBSF         UHSOISWNK      
SEVM            : LQNMONLANEDBSKM NLSKBYAFUFRWDAQ NAYPAIH         IILDIQHAT      
DIUWNGA         : JPODPHXPVO      PUDLNX          JOYAGYPWMQOJ    HPSDMM          FKKHYQF        
QHOD            : CVOAOJLDXYDNYVT YBWJEUCAGDHKL   KBKLECLWWVYNKCQ
MVQPWYVYFWFLM   : PSTLMQYXENYP    GROXGIBYORMDOS  VRQCCIVLGV     
RKKYQUU         : GNOUYQEEJQ      HSTQ            ESUWPTVYMMGSAQ 
KBQGTXWW        : CXWKQYTGL       TEWOLI          FJYEI          
LTWBSVAR        : CYETGYQYAUHRHMX EXLDX          
YWONWGBJHREC    : DKHRWBLLPLPK    VCBYBKMJIX      TQIDWVXLE      
RFXXYVWWCIS     : RYOVIYURNRBW    UCXLIYSEAWSIETR OCYBNCVDB       AYCYFQ         
MNYOFCPESD      : TJBMVBAHPPAIMCD UEILAJRMQUSL    SXPKUUSCGCAMWWY GAQFCF          FJYEI          
BGMIXSNIKS      : SJRKTCAYHM      OUWMSWQRXICQROJ OWCGFLJUGSWKK   KCDWIIXSHJLQMQN
KUFHTJSOK       : OUKFEKIUCTVC    YUOFUPRF        GMQGXRU        
CLVJPLPIQSL     : FJOPBM          AAKL            EOAXDLMDYVWEBMF
FTVXH           : YNJUHFLSYXGJVL  SLGWYFWUGKGIDJ  WHSC            LYKYHOTTAG     
JDNVAUE         : EPSLYCV         ATLAPXVTJM      YUOFUPRF        QVYAMXNDTAMPF  
EWKQEOCCXT      : TIEXOVD         JSHP            KOGAOBTSFTVQMQM UTDBOWJ         JFNJAVNLLEMWL   PAOAY          
NCGINENJDNTJYW  : UUWSKQWHPMBX    FUJODO          EOTO            ATLAPXVTJM     
VYTA            : WTPRYND         MNILPO          ROBALBEHHLYQBU  SKSTHTVNUBHA   
AYFQFTUHTOWJS   : BFWDUDK         QHHOISYTFO      HMQMDBNUJ       DEPXYBFRIM     
RIKHSNU         : ADDORTOUHWX     IYGTPRDOPHHUDN  GAUF           
YULY            : IPQB            NLSKBYAFUFRWDAQ QLUSMHOC        WRRUQA         
KUSFVTMOYIK     : VFOXYNEOJYAE    IBAGDCCOCBXWAH  QMMQFJAJJFBMC   ECILKAIIXVYMH  
EYHNUKFDWOXKJK  : HGXFPJW         VMEPLAW         GJBPRJ          VRVSNKNKSIFIN   LOYEGTWHBH     
GXNYIITPGNE     : IYYMSMJQMJV     QFRCKKYRXQEYUL  PEEIKHL        
OMGYQ           : BDDQAOS         XTKU            DURSVATA        SQAHJD         
GGCTNIQCGEMTQ   : LAMIOIR         CBGUAMHD        GHWXV          
REUDO           : MLNG            CDHOODYTQF      FIFPIYU         LDPPLTNWIEYD   
SVFARVOAVIHE    : JYMRSMIAFVXFM   GAQFCF          RJVKGEKTTOX    
MXDWPFDTTYMPRQ  : HDXRUULWI       BJPP            UDURE           AEKTFVTTNO      MJPYSCPE       
UHDPDKRWJHWH    : JCULGLBDGGOJGB  NGBWIFAJU       NTQSUADKQKWJ    QVYAMXNDTAMPF   EXLDX          
HLEVMH          : TYOOSWPKGPSY    GCQJFXWT        RAIDF          
EPXXLXM         : MXSGYW          DTSRO           MYGV            QFPBGRRXEUPYYA  ALMHNPBCW      
RFPMMVEQIWPTE   : CRCPV           FBXBJXDJDPTQT   JANAKERJRUABPN  HLAATPP         FVGE            LNNT           
BVWPAUCK        : JNKRVR          BRUNY           WHSC            XHWHYMTRRFS     BGITF          
GCNGNNSRFXJTKHB : SRRUMJLRNIN     LQUQYYQ         TVEKNSPTUK      CTEHQ           HHUBJCAMSE     
QAVKGLO         : KTBFWOG         KAHSN           GHFNXUSUY       BTYAHBWEVFFW    SJHOCVPPFM      HAYM            GHLIAWLTOCFVYDB MUSIYRHAGSLBO  
IECDGOSO        : AAMPMB          XTUGCKYT        JLGMEXRDGRAI   
IUFWP           : BDDQAOS         IDCTWYHUILDJU   GHLIAWLTOCFVYDB CGMV            VRVS           
EPIYASCGJCCVIP  : DVQULNMM        DMTLJKASMUQ     QDVNG          
KXQO            : RGXNCGYSKRBUTQJ
YEXNWIKEFCD     : MNILPO          IFJGTYQ         GFDA           
RONUHPDS        : QLVYPOBDJHVHPT  NRWMFRWDBILPNJH TTMETKNXRM      ISNEDDDLYPRS   
HQAWE           : GHFNXUSUY       MDXYBEUJ        AOLCF           GIEYHUKPFYQB   
UUBAWHAMF       : SOWNDICCI       FMDGKMPPGO      ALHD            GVHP           
XLQCPDUGQ       : SJRKTCAYHM      ADDORTOUHWX     GMQGXRU         XOFBIQCI        FFWGCP          KXBJCC          DLGBXLEX        NUDXXPESJYINNW 
NISI            : DECXDHUMYYBBRX  DFEWTHLOX       KGWYOSEV       
AYCYFQ          : FHHSOUKHMR      RFXXYVWWCIS     IVPPSTMUA       NWTUVQOMGKIKFI 
BTVXCVKJEKU     : PTLIL           RFFLRLFFB      
NMXKSQCIYWSBWUF : TKFMPYUL        MSFDDNTCT       TJBMVBAHPPAIMCD OIKDPFVJ       
AVRBQPBU        : KOGAOBTSFTVQMQM GGFHCUPV        JCHWLCSYII      EWAKCJXFVEARMCM ALJAWNAMWJKLBWB
OGPBDNQQNB      : DXAQBFVKKAMARS  CBWLXCNR        DSLATEG        
FFWGCP          : BNSUN           AHRTXBF         DPHBJ           CCXWYCEBDRE     XLQCPDUGQ       GPEPCEYMSVLN    ECOBRTI        
BKPYLOQOHISCTH  : IYQHGSUQMMP     LFCHIV          GGFHCUPV        TRJLDWLXOVDN   
MKLCCEPFSWL     : KBBPPNOBO      
GNHQPUIOIWIWEQ  : BNSUN           LRENLLICXNBP    EWXOOL          LMPMWOMLWFX    
INBSCMHEQL      : FLXKHQCYOS      EXLDX           TNGPADHFB      
XGTJVAAG        : JNWWM           YETFH           SRBUFVMDU      
RBBIJ           : ALHD            SOWNRJDJOS      RMRJQVNNVKJTE   CYHBYSJLO       RAIDF          
QIFKBQACJ       : XDDESQBI        UUWSKQWHPMBX    YQYISMGGRGYIVY  GPEPCEYMSVLN    ALMHNPBCW      
QQIHFEGLARKCRQ  : MLYQEO          SYFJLATOBV      CNFONMPCXHHB    JGORATAPD       XBYXJFEJSVGOYU  FIRHNOCTCKFFWQO
LTWUFXNNFAQVA   : VKYE            BYXFROFBBKE     QHTKCRDTGK     
GEMWOWE         : FBXBJXDJDPTQT   PVMH           
FQVYBYTTTF      : WAFNRB          FJOPBM          XLMUSKIETWEF   
SAUSOIYQCU      : LMPMWOMLWFX     AYCWCOBO        DHCRWRBXLBON    GMRBJITQ       
XDXMDPLH        : GBBHMGLWAJFQIA  IRCSNVCHTRDWYDG UESYQID        
QAJQ            : YNJUHFLSYXGJVL  FDQPUSQXBLPBIAR EWOQPFRDGO      DHFOUXVNONIKGVU GBLKCSIXEKHQWYW
KKWHRMAS        : WOOCEITAPSD     RQQSNVISWUO     SSFTQM          BOHF           
VJSUAWRTWVU     : BLNMESRP        NHLAW           YVFXW           YIUBAQQQOBISN   SRJXIRWCD       MSQDETWLTUE    
YKXIXOJJHMUTMCM : JNGEOS          WSKMOVQG        OWLAP          
EHJAQEU         : NDXYSKMDYAFODQ  SDJTDPEKIFRYSBW TQWJWCNGIQ     
BPNXLIJMUHUSY   : EXENALKT        JJRYBBXSPVIJHON DMTLJKASMUQ     DWTUAJKYFQMXYRD
EIRYDG          : SOEKDEIGWYXHH   DMTLJKASMUQ     IVKAGFLDAMCL    WHSC            OLDCDT         
RHIYQK          : KHMXJXFFHXW     KMUVHAQISCLE   
WIIAXXAJG       : BLGBMDXORYMNMC  PTLIL           FNQSPYCMQFDGV   MUSIYRHAGSLBO  
VDTQXUXDERCHX   : RTDONWPB        JXRDNMEKCUYRRN  XLMUSKIETWEF    BMMCMLATTQUQ    OPHM            VPAXPDWJIGFIID 
YFQAYBRX        : WCEQGQQ         KSWJRWGVX       OKOWGYSFVLR     BTUOCXNPRCUYXVC MDVIFJQQYCWKTE 
CYHBYSJLO       : NWJHVKQYH       QYEVKIEG        RBBIJ           CBGUAMHD        BYXFROFBBKE    
IILDIQHAT       : BTRHIB          TYFBSBMVOVPFHJ  QWEIINPSHESYHD  SEVM           
ACRFS           : TLVXA           WXDPMLK         GFDA            CBCNCN          PDXIXUCQYGY    
GVJFGOGPPHJ     : KHDOKSDMFOOBKFV MGEJL           MDRSV          
TAOEKDJSVRUP    : ENKOIAGUUVGC    NUQDYBGOHUL     GBAXVMRHNWQMOI  CGILMWGH       
UTDBOWJ         : VSORCWVRNONDNT  INMIYSCMC       EWKQEOCCXT      UESYQID        
JOTXUL          : YIFVUIF         KFLX            KYGYO          
DUQYX           : ALHD           
FKLOEHG         : DPNUCHGUCN      PXRNLGOT       
ATWVWANTJYF     : YFRHQTNYCCLKFR  EWILYERVJCLJT   KOGAOBTSFTVQMQM OEEMP           KMUVHAQISCLE   
UDVGSYEKAE      : TUHOHXHBTOF     VLYAWE          BGOJ            DNLRCTMKFRAN    TOHIACMDYKPIPL 
FOGUU           : ESYMTULCGBFHASH VOUXPWC         HGMKXTMAVINW    ALMHNPBCW      
DUPWTOVTCSDDXC  : LYOKHM          FEBDRLF         WRRUQA         
CBGUAMHD        : MXSGYW          SSJWHSWIR       XMNQMA          LDTLQBQRWINVVD  GYJVOHWPFGWC    GGCTNIQCGEMTQ   CYHBYSJLO       HEAORSPVWXUP   
AIIGFDWJAOGT    : QOLUJCKKWT      JMPRPWCSPJXYNU 
FNFXRKVVKAWRX   : OONIWUH         BOTCALU         NUQVUDWCDWFAC   NYTEIVNCQNFXSUF EWAKCJXFVEARMCM ALJAWNAMWJKLBWB
GFDA            : HUOJDWPOTPB     TVEKNSPTUK      YEXNWIKEFCD     ACRFS          
NIOTNLFOBNKGSY  : MDXYBEUJ        OJGPFVCTXXGF    JWMOD           EPOGYIA         DGYOECX        
QSWPOKROCPQKX   : NLSKBYAFUFRWDAQ KCKFDXJD        RFFLRLFFB       MSQDETWLTUE    
KGJUUDJHIAKW    : EKBAKR          SABFGJPSBGYP    DNVKHNVLKOA     BEROLNNAIA     
QRLFJEF         : WTMCB           NLSKBYAFUFRWDAQ HELE            ALHD            OLCIHUMWKYEBQ  
VPSKTLBEJWRPGMK : KAHSN           BJWMA           OOAMPKK         FBTUPLGVBVJXLGG VPHWXFQJWK      SRBUFVMDU      
XTWAE           : TUHOHXHBTOF     TYDECRLHGCP     OUKFEKIUCTVC   
NVOYBA          : PUDLNX          FTHPQIYLNHQL    PXRNLGOT       
GBAXVMRHNWQMOI  : WJUVQ           DOHFNJHWO       TAOEKDJSVRUP   
DTJE            : FFFQS           QKPPPYFHQVO     SNGMKO          EUTKGEPTMAVQMP  YQYISMGGRGYIVY  FHASJD         
HGUFTQ          : ERHO            EWILYERVJCLJT   DFEWTHLOX      
TTVXDYABVM      : HAFWQDPXUJEN    LCDIAVSSUCI     CCHYWOQKOS      UGWI            SLBJGXKEP      
FCSYO           : KTQVTKHWCF      CAFITFSJX       LOQTSYQ        
HJOB            : XIYCDGFHPLEDH   QQVIUYHUE       VFSLEXBVDGEY   
SRDCMIVFFPBD    : ROYQKGNVLL      KENYPSB         KQNTXJGEOJTL   
GDPKB           : LAMIOIR         BJCKTRCISKMJC   IGSKVYWP       
GIEYHUKPFYQB    : XCMNOSTISQYFRX  DQRIXACMWJV     SYFJLATOBV      UKRNP           HQAWE          
KGWYOSEV        : YGJFCESVOVJMYJW WIFF            NISI           
IAYOFR          : NWJHVKQYH       EOSCTB          WECAJCKU        HLBNBBVGLU      BTUOCXNPRCUYXVC
ITFQBG          : UOOOU          
VQODQHGL        : NWJHVKQYH       QDVNG          
MKREDYCOJEQXJIA : YKKEIFHWYKAWH   FTHPQIYLNHQL    AYCWCOBO        DGGOXMOLCJBHCC  IDCTWYHUILDJU   JCHWLCSYII      QDRHAAYVNYLQS  
EFLFMKEFBJV     : UHEJL           FMDP            DCJDDKHAWB     
QJDFTXLAYOOI    : TUARSFGXFMLFBYY JSHP            CXWKQYTGL       LHPWJAJPR      
FIFPIYU         : REUDO          
KCDWIIXSHJLQMQN : VALW            QBFMREVDFNNYJRU BGMIXSNIKS      RNGRTITEKEYNID  PDXIXUCQYGY    
DNLRCTMKFRAN    : FUXWPCF         OUKFEKIUCTVC    UDVGSYEKAE      FHASJD         
WECAJCKU        : UNAUMEWNLWWCVQ  OPHM            IAYOFR          GMRBJITQ       
DCJOUWIKJNXX    : ORWIJRRGP       VRVGDMVMVOEX   
DTTPY           : TAMS            IYGTPRDOPHHUDN  KENYPSB         XNWYDRGMD      
RNGRTITEKEYNID  : UOVSFXE         KCDWIIXSHJLQMQN
YAVHLIULGC      : VKIQFJDOPRYIUN  GMVGMHWYI      
CWICLBRR        : IHLIRYJPV       QBEQ            BQPMFGQXUQMAYQ 
LCMPPQQD        : SJRKTCAYHM      XNCYQONYR       QNQEDDQWUMPAO  
VCBYBKMJIX      : XJNXCMAO        JAJVVJCI        QBFMREVDFNNYJRU YWONWGBJHREC    YQMDAFQ        
KRTJAXUDPMVC    : VINSVNBWWUXFJS  YDLEEY          CHKUSFXGHFPUIGO IFLEHSMEXAUKBW  UHSOISWNK      
KTHELKH         : SYFJLATOBV      GOTHHVWNJDPRN   VXIKRDVKFBNGRPI
OKIPVU          : FMDGKMPPGO      OVTQ            DYJRVLBBXWU     FPHNCPGN       
EVSQ            : NDXYSKMDYAFODQ  DMCEWLGNR       DYJRVLBBXWU     YNIYJMEW        EMEXQIGBCOD    
PBPNXTENRIFF    : KWNMUAFMD      
MJPYSCPE        : BLGBMDXORYMNMC  FMDGKMPPGO      VOHFB           MXDWPFDTTYMPRQ  ECOBRTI        
GAIHG           : KBBSFNDMNMMWNYT
DWTUAJKYFQMXYRD : WPQSYQGROKKOK   SGIBPONHX       VOHFB           FQUSVRAVJP      BPNXLIJMUHUSY  
GOTHHVWNJDPRN   : JKYLTACD        NBCPTQ          OSXMFDISW       KTHELKH         FQAINPWKTCWCL  
XSVRNVDXULRHJQ  : FIQJH           KFLX            RCCJKRLN        CBCNCN          SMIDHURRWBO     VCNDBBVYO      
OUHFPOONMD      : LCDIAVSSUCI     ROHLFOBDRLVL    GHWXV          
RSOHRMAN        : AVYG            QPSLCOMHLDP     JDPFTMFSUUUGVXA EDCQNTPOIB      QODRWP          HQBMMS         
PJMOF           : YNHGSF          WISKMVTCKWDHQ   SRJXIRWCD       TNPUVKMYGRU     FYAVEHKXHY     
GOJYQXUXDMPRAE  : HLMIOVXH        QHHOISYTFO      PWDUFQJC        AEKTFVTTNO      KSWJ           
XVQOEIEEXMUHYL  : MLYQEO          WSKMOVQG        IGSKVYWP        QFPBGRRXEUPYYA  CWNNJYXH       
YTEIUUIRUN      : JNWWM           OUKFEKIUCTVC    FGQYUOEEOORY    GHRGFLAY       
MGHQFFNVVT      : PVVBOOAI        QBFMREVDFNNYJRU QYJSQLAY        UQDTNLNQ       
AAGNWOOKDOGJ    : QBEQ            JNWWM           UFXE            YQYISMGGRGYIVY  HMKDLMH        
CGITCVYQEIIKNVI : OQLSPGCCUA      EYXNGOOSVTKQB   XCDFOAKUN       RFYOK          
RRMRXCROQ       : PQPXNQNXPWHNE   FQWVHS         
UHJEHNLRHPPI    : CVOAOJLDXYDNYVT LYQRCHWHMWKTSYU SFPAAKSLJDEIHJT FHASJD          UGWI           
WQQJGO          : AUXQOXUUIAWUS   IMUIDGB         CWJRHPJKDMBMQA 
SGLHBMJS        : TIEXOVD         JMPRPWCSPJXYNU  CCMSCCBE        ABLBY          
CWXKGFTTQNEIFM  : WOAQJLUTEVYHSNQ HLAATPP        
CGILMWGH        : PFXNYYXJBVEBIW  DLPMBWVJALQXBPX TAOEKDJSVRUP    XNRECAPTT       DLGBXLEX       
TOHIACMDYKPIPL  : GNOUYQEEJQ      CGSMKINN        UDVGSYEKAE      LNNT            EGSBFAAY       
IYISEXMJEWWSTD  : YNHGSF          CNVJS           CCMSCCBE        LDPPLTNWIEYD   
CARLKSNWXPKP    : KJPCQKGXW       EDWNJ           GDSPRYWNKOTMAON HPSDMM         
CBCNCN          : YQFTCH          FTEVTJSAP       DVYPKQHLRYG     ACRFS           XSVRNVDXULRHJQ 
INUTRRR         : HGXFPJW         QFIDHRQDSOKY    IRCBYXHFMLEUSAQ FSMWYJWNAIPEK   WUQUMB          XJEPI          
OUPQWK          : IRYQP           ECILKAIIXVYMH  
IFSHFIRUGUXLK   : COWTFWXOVDDJJJJ JFLINXEUNPBUHUX SOWNDICCI       KVQUC           TYOOSWPKGPSY   
YSKMOFG         : IXKSQGGRKKFUPWS TYDECRLHGCP     IWGFOCGMJD     
WUUTNORXTCDMJKV : JXRDNMEKCUYRRN  WXYHSOEENKHEQJ 
FEBDRLF         : VSORCWVRNONDNT  MJKKO           DUPWTOVTCSDDXC 
EPFSUNCTLY      : GEGBSPO         SOEKDEIGWYXHH   DVVH            YHDBHHCATNIMPKX
YNIYJMEW        : BFWDUDK         JSAMOACSSWE     EVSQ            JKKSWYLXPBAL   
OUCTBDWTQCMV    : IERUHIIJB      
UQPKULVUAWKKVU  : XIYCDGFHPLEDH   FBDCCLON       
ARTOOXKPCJLSLY  : MGMOGVTUHA      CJWOTIYKHBQG    JMXPW           OKCHKSK        
IVKAGFLDAMCL    : TUHOHXHBTOF     KEQUIQ          EIRYDG         
YIUBAQQQOBISN   : ULFIRLXN        VJSUAWRTWVU     OCWXOUFQCTT    
OYTFHPR         : FSMWYJWNAIPEK   CHYORI          WXVX            GMRBJITQ        KNDIILILVAN    
XXVDAIGNHHVEIX  : AAMPMB          RQQSNVISWUO     FHHEIEVSFTOHS   FMYADYSCJTXAXCK
YQMDAFQ         : VCBYBKMJIX      JLGMEXRDGRAI   
VRQCCIVLGV      : FTEVTJSAP       MVQPWYVYFWFLM   TITYFMXIUJ     
KYRSOCALGILEKD  : LCDIAVSSUCI     IYGTPRDOPHHUDN  IYYMSMJQMJV    
PDXIXUCQYGY     : SECQAOSCLYJS    JCWCXBK         VMLI            ACRFS           KCDWIIXSHJLQMQN CAFITFSJX       JKKSWYLXPBAL   
SFTCRSWKHYKUH   : IXILKNGBRLL     RQLEWUFBGBKAUI 
JLGMEXRDGRAI    : IMUIDGB         QLVYPOBDJHVHPT  IECDGOSO        YQMDAFQ         QLUSMHOC       
BRHXKMROH       : NYQGLUNIAINLC   VQWW            GVKP            VRVS           
NRWMFRWDBILPNJH : GYWQLMV         FEFKWMGDDT      FLXKHQCYOS      TKHUTNTPKRGW    RONUHPDS        GAUF           
PYUAHVRQVEGOVND : SABFGJPSBGYP    WXNI            VEBEN           TVEKNSPTUK      WIDX           
HAYM            : XYROFNXDKQRMWAF CNFONMPCXHHB    QAVKGLO         TRSKPPAH       
VRVGDMVMVOEX    : NNHPTUESY       CXWKQYTGL       DCJOUWIKJNXX   
HFJBYGGFWESAPAB : DEPXYBFRIM      XOJKLXEKE      
PVMH            : GYHUOMFSIPIUYA  ENKOIAGUUVGC    REXUS           FLXKHQCYOS      GEMWOWE        
TNGPADHFB       : CGSMKINN        INBSCMHEQL      KSWJ            HEAORSPVWXUP   
MIFPHL          : CRCPV           PGBLDJT         IVMKYLHASF      CVHMVAR         SMIDHURRWBO    
OKCHKSK         : PGIJSEVTYLAO    KSPDEKRCFWBMKW  ARTOOXKPCJLSLY  SMIDHURRWBO     RVSFAYQKWICRDP 
JCHWLCSYII      : BNUNFSTLINDSMR  KAHSN           QFQITBJA        UBUHFURSRFFT    CWJRHPJKDMBMQA  AVRBQPBU        MKREDYCOJEQXJIA
NRHQPVAULJIK    : TUARSFGXFMLFBYY CBKDFK          JMPRPWCSPJXYNU  VEBEN          
SMIDHURRWBO     : IFLEHSMEXAUKBW  DAXSAIEDXLRVUBM XSVRNVDXULRHJQ  MIFPHL          OKCHKSK         DPBMVNAVKMVG   
FHKORMEM        : IWGFOCGMJD      IBAGDCCOCBXWAH 
VCTXYIHHS       : GYWQLMV         RCYDGUOWWIQVS   QQVIUYHUE       FMYADYSCJTXAXCK
AHRFPMY         : GEGBSPO         HJRFRCVAGHCWBG  GYJVOHWPFGWC    RSWDQJX        
KBXXGH          : FEFKWMGDDT      JMXPW           YPMUPTJFC       SUUMSW         
WBXEPTARQXSYH   : NGJTNPKJASAER   RMRUEADBCSOGXA 
TQCD            : IYYMSMJQMJV     SKSTHTVNUBHA    TISWDMESOEFJQO 
KSWJ            : TDDOEYIGVTGBIWV XFBIMGKBJEWTUU  JWWBQTW         EGGHJOYXVOT     OXSLV           GOJYQXUXDMPRAE  TNGPADHFB      
JMCHTLSSPQ      : SRJXIRWCD      
FMYADYSCJTXAXCK : PBMFDOTEQUXNYI  XXVDAIGNHHVEIX  VCTXYIHHS       NLPELNHY       
WHSC            : TDNRABVU        VOHFB           FTVXH           BVWPAUCK        EIRYDG          SMIDHKWOQAQLW   TGFCA          
FGBBSTWI        : APGJFATEQHM     IVMKYLHASF      KHMDTLUJG       UKRNP           DHFOUXVNONIKGVU
VPAXPDWJIGFIID  : IUOPIRLGA       YNCPDMCY        CNVJS           VDTQXUXDERCHX   MRSQVT         
SMIDHKWOQAQLW   : CIIGPPPFCVIJFM  EFIIGUEYQBJYX   WHSC            FDDNPBW        
VJNMJLCPLL      : JDPFTMFSUUUGVXA BQFTF           QNQEDDQWUMPAO  
TQIDWVXLE       : GKONFDMFMK      XXXXMMV         YWONWGBJHREC    QDRHAAYVNYLQS   SUGMTVMASP     
SQAHJD          : BSBMXPSCUWNTFAR GHMXQKRLXGJGGII OMGYQ          
VARRJG          : NGJTNPKJASAER   SOLVKBDPPH     
TRJLDWLXOVDN    : XWMDHADGNSQJDM  AKEYKMPBCRASU   BKPYLOQOHISCTH  JNOBJHY         QODRWP         
BYXFROFBBKE     : ORLDUERVEPQ     OVTQ            LTWUFXNNFAQVA   CYHBYSJLO      
KVQUC           : FNMYBSF         HHEWHPT         NJISCEMN        MUGTIKXWSOKHF   KVHHWGVXXEBLHK  PEALPSPFQY      IFSHFIRUGUXLK  
QWHEAERAUND     : NQWI            MSQDETWLTUE     ANAQVUCKNQ     
IFJGKDXRHYDLXP  : JJRYBBXSPVIJHON HHUBJCAMSE     
QMMQFJAJJFBMC   : UFFTCARJKNIXNXG JMKLKMKCODKX    TMDB            VVXYFVFMJTRTOIR KUSFVTMOYIK     EDRGQ          
PPAWY           : HWQDUBNBKMGD    RJVWDDIOMFNUU   KFDWKHLSYBCI   
HFICMH          : DMCEWLGNR       DPHBJ           JGORATAPD       TYOOSWPKGPSY   
XHWHYMTRRFS     : WBQBUGKD        DHCRWRBXLBON    BVWPAUCK        WGTNVCJBHPAYJT 
RAFE            : SOQDARQALLRVR   TXHJPXWAUEBAG   JNKRVR          WCHJXLDG       
YVTBT           : FIQJH           DRXW            DDHGPELJASP     IBAGDCCOCBXWAH  SKSTHTVNUBHA   
KBBSFNDMNMMWNYT : VVABNNU         DIUAK           QLVYPOBDJHVHPT  GAIHG          
SYYW            : KVHHWGVXXEBLHK  EXLDX           BVRHKXHBGOD     NSWBWPKG       
YFUDER          : INMIYSCMC       GLPTKHLFRYQH    TYOOSWPKGPSY   
GNTS            : JSTXXUWAOYVSN   YHNHPSPAOU      FHHEIEVSFTOHS   VCNDBBVYO      
UNWKQL          : LQUQYYQ         HGVHKRBOL       GBLSYELEKQIDQIG HRLOCGOHVJX    
EAWRYQX         : KTBFWOG         KIMULRQYRKFHL   LYOKHM          KINLOGGLYC     
QYRHXWFCE       : UFFTCARJKNIXNXG JNGEOS          NVKMHPXX       
CMMVFDQSADMOB   : SXPKUUSCGCAMWWY GBBHMGLWAJFQIA  HELE            WXYHSOEENKHEQJ 
OXMQRNLIMFRNFWP : TPQDCUTAGY      ACICFKCHDNT     QFQITBJA        UKQDXLHFAVPVWKN ULDXXWCCAHXJPXR DPBMVNAVKMVG   
XRVKPDQGXSLM    : COWTFWXOVDDJJJJ AAMPMB         
MFWMSNGIBOUGHI  : BJPP            NGJTNPKJASAER   FNQSPYCMQFDGV   EIBFIESMA       FXXS           
GAUF            : HAFWQDPXUJEN    JGJYEQEM        RHRX            WBLYBBYQ        RIKHSNU         NRWMFRWDBILPNJH
SRJXIRWCD       : XDDESQBI        MLYQEO          IGXGSYFGOM      HELE            VJSUAWRTWVU     PJMOF           JMCHTLSSPQ     
JRRIH           : GRCFOXFMQ       YKKEIFHWYKAWH   IGFJSD          FIRGB           IXCVRIK         WYUGVOKJ        ESUWPTVYMMGSAQ 
XNWYDRGMD       : XKBPMAGCVQITHE  BJPP            HRSQDDSXIVWL    DTTPY          
SFPAAKSLJDEIHJT : VIQTRVVBSXJQG   MYHXXDUDJD      YQEOFCWUCVUA    UHJEHNLRHPPI   
CNCLCBYYA       : AAKL            QBVLXQAJ       
TISWDMESOEFJQO  : AUXQOXUUIAWUS   TQCD            WGTNVCJBHPAYJT 
WYUGVOKJ        : AGBHSXHMURBGNUM NYQOODQX        JRRIH           DBHCXQXNB       OCWXOUFQCTT    
VOUXPWC         : VALW            CYETGYQYAUHRHMX FDQPUSQXBLPBIAR TVEKNSPTUK      GGFHCUPV        FOGUU           HXFPDGUCUYDBRJ  DBXUITCSAWIDDA 
VOUXPWC         : XCDFOAKUN      
IXILKNGBRLL     : UEILAJRMQUSL    DMCEWLGNR       OVXNMONJ        GYFWXGN         SFTCRSWKHYKUH   TYOOSWPKGPSY   
DBHCXQXNB       : SJRKTCAYHM      RGXNCGYSKRBUTQJ OQLSPGCCUA      MLYQEO          BWAPBDTQG       WYUGVOKJ       
HXBEVQDABN      : QHHOISYTFO      DTSRO          
LYKYHOTTAG      : PWDUFQJC        FMDP            FTVXH           TWFYTGHSFHIUWDM GHUO           
DQBBHCOIOX      : UUWSKQWHPMBX    IGXGSYFGOM      ISNEDDDLYPRS   
PEEIKHL         : UFFTCARJKNIXNXG MDXYBEUJ        GXNYIITPGNE    
FXXS            : JKYLTACD        JGORATAPD       MFWMSNGIBOUGHI 
HHUBJCAMSE      : UUWSKQWHPMBX    WDVIYYXDKILEKG  GDSPRYWNKOTMAON GCNGNNSRFXJTKHB IFJGKDXRHYDLXP  LQADDYPAAPDDHY  NUTCSXHXO      
AIFIWFROKXWUFJU : YRGWCIXLVK      GYFWXGN         MIJNKG          XUCQAMPUH      
HUGIDPEEY       : YHNHPSPAOU      KVUD            TLVXA           HMKDLMH         DPBMVNAVKMVG   
HLBNBBVGLU      : IAYOFR          QQMHXKN        
FJYEI           : XJNXCMAO        FUJODO          SXPKUUSCGCAMWWY MJKKO           KBQGTXWW        MNYOFCPESD      FVGE           
JRQWBM          : OLHAMBBPVSU     LJVFW           QHNP            MIJNKG          PETUWDDDHNORNYD
MRSQVT          : FVLATFPYJUJHHRK MGEJL           QWEIINPSHESYHD  VPAXPDWJIGFIID 
FHASJD          : CTEHQ           DTJE            DNLRCTMKFRAN    UHJEHNLRHPPI    SJJVSXDAXTRTJPQ
RQLEWUFBGBKAUI  : EARMGXPBQFN     ROBALBEHHLYQBU  DOHFNJHWO       SFTCRSWKHYKUH  
JNOBJHY         : TRJLDWLXOVDN    TYOOSWPKGPSY   
GHLIAWLTOCFVYDB : VINSVNBWWUXFJS  QAVKGLO         IUFWP          
JFNJAVNLLEMWL   : IPEIHEKRIRFLYK  YPNGHLIIIL      GHMXQKRLXGJGGII EWKQEOCCXT     
BTUOCXNPRCUYXVC : FTEVTJSAP       NYTEIVNCQNFXSUF KYGYO           MUGTIKXWSOKHF   OXSLV           YFQAYBRX        IAYOFR         
YNHMXJKNUVSJT   : BALBGTWFOKRDGJ  QQMHXKN        
YWDUNFUBXMDULEQ : EABTQPXBTNFIH   HCELYBSYFH      WJSWGX         
GPEPCEYMSVLN    : WGHRH           DHCRWRBXLBON    FFWGCP          QIFKBQACJ       KGTYGMIDUYOY   
FVGE            : FNQSPYCMQFDGV   GMVGMHWYI       TTESYLUSYP      RFPMMVEQIWPTE   FJYEI           DHFOUXVNONIKGVU
DRHXUFKA        : YKCCWU          WISKMVTCKWDHQ   UGLJSUOKE      
YESRM           : UEEHPWKP        FEFKWMGDDT      CBWLXCNR        CNFONMPCXHHB    PXLDPNBQDOMOY   FPHNCPGN        DSBL           
VCNDBBVYO       : WTMCB           XAGVAAVJ        XSVRNVDXULRHJQ  GNTS           
GVHP            : JLSDC           YPMUPTJFC       RJVKGEKTTOX     UUBAWHAMF      
HSTQ            : MWINWDX         CDHOODYTQF      YFBVATXIVAXUXWD RKKYQUU         DISFTCFQRIEO   
OVEOXFVQWICVLQ  : HLMIOVXH        EDCQNTPOIB      IVMKYLHASF      OOAMPKK         DFOSYOKK       
OTWOII          : PGYHBXX         UHEJL           DMCEWLGNR       LLGJIXHQ        OVXNMONJ        FAHFSI         
EPOGYIA         : UUXDXVRY        XYROFNXDKQRMWAF NIOTNLFOBNKGSY 
CQNGFNOBHLMLH   : BLGBMDXORYMNMC  FMDP            HCELYBSYFH      IRCSNVCHTRDWYDG
CGMV            : TCDLLYEDPJDJ    IUFWP           KXBJCC         
DGND            : QUFI            NDMIAKHPFGL     AHRTXBF        
GRSFCUX         : KINCUVAUC       URTFSTTL        RNNKJQ         
LNNT            : BQPMFGQXUQMAYQ  XCMNOSTISQYFRX  HCSPELHGFLVEOHY LCQXJOYA        EFIIGUEYQBJYX   RFPMMVEQIWPTE   TOHIACMDYKPIPL 
CWNNJYXH        : LAMIOIR         HUOJDWPOTPB     NDMIAKHPFGL     UOOOU           XVQOEIEEXMUHYL 
EWAKCJXFVEARMCM : ROYQKGNVLL      RHRX            LPTQGCQCMRES    AVRBQPBU        FNFXRKVVKAWRX   SUNQHRVAJGO    
HBAUUG          : VQWW            IPWEOPVMAAGRQRI
TTMETKNXRM      : BRLMVAFDYMFAYO  SOWNDICCI       RONUHPDS        EXMDBYD         ERITSKSLNCF    
CPJC            : LAMIOIR         CTEHQ           GYSFPNXUMYBD    KQNTXJGEOJTL   
GHWXV           : QOLUJCKKWT      LQUQYYQ         RAQMOAYQLE      LEBAVJSBJQMBN   GGCTNIQCGEMTQ   OUHFPOONMD     
MIJNKG          : OOPXYBDMNQ      DCJDDKHAWB      KBXOVDOBCEWXWVW AIFIWFROKXWUFJU JRQWBM         
RFFLRLFFB       : AYCWCOBO        YNNAKIDPFNXHH   BTVXCVKJEKU     QSWPOKROCPQKX   MPWQFVEJAXILATX
WOEBGPDD        : FSYGOMJVBHGIB   MRISFYVJPTKGX   SUGMTVMASP     
MDVIFJQQYCWKTE  : NTQSUADKQKWJ    WTHR            YFQAYBRX        NGULORNGWMWKWXD
HXFPDGUCUYDBRJ  : OPLOFKETINKGRY  QPSLCOMHLDP     QOLUJCKKWT      JGUHK           VOUXPWC        
NVKMHPXX        : ENKOIAGUUVGC    JXRDNMEKCUYRRN  CHKUSFXGHFPUIGO UEILAJRMQUSL    VWWDSTCTB       YIOGVCTTTMIUK   QYRHXWFCE      
WCHJXLDG        : FDQPUSQXBLPBIAR KSEWVSM         JWMOD           RAFE            ECILKAIIXVYMH  
IVPPSTMUA       : DGGOXMOLCJBHCC  AYCYFQ         
MJXAH           : UHEJL          
OOAMPKK         : VPSKTLBEJWRPGMK OVEOXFVQWICVLQ  HLGRVWRUTTQEPP 
RVSFAYQKWICRDP  : QHHOISYTFO      FXIROH          OKCHKSK         SOLVKBDPPH     
DGYOECX         : FSMWYJWNAIPEK   MGGS            LVQONEVU        ULFIRLXN        NIOTNLFOBNKGSY 
QNQEDDQWUMPAO   : IFLEHSMEXAUKBW  KYGYO           LCMPPQQD        VJNMJLCPLL      WXYHSOEENKHEQJ 
QCPC            : QOBHDPE         TBDRPFSXJFVVHIQ QBFMREVDFNNYJRU
IFTUKCUBIWYWPM  : XIYCDGFHPLEDH   BQFTF           DNDLQ          
TRSKPPAH        : FRXAATBDIP      HAYM           
QYJSQLAY        : JCRPIGGWMCGIJC  JAJVVJCI        MGHQFFNVVT     
TWFYTGHSFHIUWDM : WAFNRB          MKOO            NFYLGLV         XLMUSKIETWEF    NVIAYYDRXT      LYKYHOTTAG      RFYOK          
PEIRMBJNMEE     : MVJIBNOQUPXE   
EGSBFAAY        : SDJTDPEKIFRYSBW FDQPUSQXBLPBIAR TOHIACMDYKPIPL 
HRLOCGOHVJX     : LMPWJUWYD       IPAWYVCPYDLP    DDHGPELJASP     NUQDYBGOHUL     BJDCBURPXJ      UNWKQL         
TPOWBCLIJLMPGP  : FUKIGA         
GPVMAPBQRJH     : WXNI            WIFF            RQQSNVISWUO     IERUHIIJB       VTBVNKS        
FQAINPWKTCWCL   : RNNKJQ          CGIP            NASSCDXDLQTTG   GOTHHVWNJDPRN  
QDRHAAYVNYLQS   : IPEIHEKRIRFLYK  MGGS            MKREDYCOJEQXJIA TQIDWVXLE      
CAFITFSJX       : YETFH           DCJDDKHAWB      QQQHOVL         TTESYLUSYP      FCSYO           PDXIXUCQYGY    
VRVS            : AAYAORMLEYERRH  IUFWP           BRHXKMROH       EDRGQ          
HGMKXTMAVINW    : RKROLHBSPSF     FOGUU           EFGTLJHWL      
GPAJSFTOLOXLGT  : ATEORGTWFGFII   GPALYDR         PTLIL           SPSG            DFOSYOKK       
DPBMVNAVKMVG    : ATEORGTWFGFII   JRTLCIQBFCVM    SMIDHURRWBO     OXMQRNLIMFRNFWP HUGIDPEEY      
MDRSV           : NXPX            GVJFGOGPPHJ     OLDCDT          KMUVHAQISCLE   
EOAXDLMDYVWEBMF : ATLAPXVTJM      IMVBJ           CLVJPLPIQSL     RSWDQJX         OEEMP          
ISNEDDDLYPRS    : SBNAIDLGDOOH    UEILAJRMQUSL    RONUHPDS        DQBBHCOIOX      UXYJUTVCIYC    
NLPELNHY        : MNTYIDEUVEU     UFXE            FMYADYSCJTXAXCK
KXBJCC          : IKGTWCNDX       XLQCPDUGQ       CGMV           
HPHCG           : HXQHRNQJWQ      EFEJWIKXTIWCPQ  VMEPLAW         JIIHN           HOYIRE          CMWDQT          KVHHWGVXXEBLHK  LFSQRKWQPD     
GLPTKHLFRYQH    : FEAMMUMG        NBECXIP         GIFYKRCOOE      LHFTPJCVSOMRM   YFUDER         
EXMDBYD         : ILXBLBVSUHX     FIRGB           TTMETKNXRM     
JFGG            : JHNVMRVEDMTPKVM BNSUN           FIRGB           XJEPI          
XNRECAPTT       : OLHAMBBPVSU     QLVYPOBDJHVHPT  ALHD            CGILMWGH        TQUFHGFMVHUJMRW
BGITF           : UHEJL           BVWPAUCK       
DLGBXLEX        : WOAQJLUTEVYHSNQ KHMXJXFFHXW     CVHMVAR         XLQCPDUGQ       CGILMWGH       
IJUOPMNFET      : HWQDUBNBKMGD    DAXSAIEDXLRVUBM XXXXMMV        
EMEXQIGBCOD     : XJNXCMAO        INRF            COEQIPTRGMTNWDB EVSQ           
ALJAWNAMWJKLBWB : VRVLKLOYJVGOB   WVUCKD          AVRBQPBU        FNFXRKVVKAWRX   OLDCDT         
BVRHKXHBGOD     : ANUQOCGPFKYSYD  LJVFW           VEBEN           QLPBRVYDEXL     SYYW           
DISFTCFQRIEO    : IKNDXMNYIXO     UHEKMEAXBWCYPTM HSTQ           
QDVNG           : SABFGJPSBGYP    TQWJWCNGIQ      CCMSCCBE        EPIYASCGJCCVIP  VQODQHGL        SRBUFVMDU      
OCWXOUFQCTT     : TUHOHXHBTOF     OOHNYIXGGMYCPL  YIUBAQQQOBISN   WYUGVOKJ       
YCHEXJMOCU      : REQUDU          VLYAWE          TLVXA          
SOLVKBDPPH      : UKQDXLHFAVPVWKN EOSCTB          FHHEIEVSFTOHS   VARRJG          RVSFAYQKWICRDP  EDRGQ          
NWKTPO          : NRPQEUFQ        VKIQFJDOPRYIUN  CTKDPPBMWAN    
LDPPLTNWIEYD    : BJPP            GOWLWVGHNIE     REUDO           IYISEXMJEWWSTD 
SUNQHRVAJGO     : DHCRWRBXLBON    EWAKCJXFVEARMCM
FBTUPLGVBVJXLGG : EDCQNTPOIB      UFXE            RJVWDDIOMFNUU   SUUMSW          VPSKTLBEJWRPGMK RWIWRBDYSCVAWFH
GMRBJITQ        : OUKFEKIUCTVC    SAUSOIYQCU      WECAJCKU        OYTFHPR        
SQJBI           : PTLIL           PWILJXYRGIHTYM  PDKVUEWGSXK    
GJFDCTLXUJHUU   : OJGPFVCTXXGF    XNCYQONYR       KKOSSTFN        BEROLNNAIA     
EMVSHYCPVU      : VINSVNBWWUXFJS  FLXKHQCYOS      FGQYUOEEOORY    PPPUTRKKIY      EXYQKUMT       
QODRWP          : TLSCBOVKDP      RSOHRMAN        TRJLDWLXOVDN   
GUDIQOIMAPJ     : KJNL            GYFWXGN         BFVTLQ          EFGTLJHWL      
GNJEGQGKICG     : KTBFWOG         ROBALBEHHLYQBU 
SUGMTVMASP      : AKKKI           TAMS            IGNNGYRLNLJY    BLXGF           WIDX            TQIDWVXLE       WOEBGPDD       
KGTYGMIDUYOY    : BBGSS           VVABNNU         WIDX            GPEPCEYMSVLN   
GHUO            : VTGFJOCIQWSAK   LYKYHOTTAG     
BREXX           : TPQDCUTAGY      DVYPKQHLRYG     DCJDDKHAWB      EDWNJ           TFADWMVTQVWTYRI
RVFTQ           : HLMIOVXH        FEQIXJN         JXOY            CCMSCCBE       
FBDCCLON        : UQPKULVUAWKKVU  MOBIKDJUXEY    
JMGK            : MXHIFGSARTCRJ   TKFMPYUL        KQNTXJGEOJTL   
MSQDETWLTUE     : GSLK            XFBIMGKBJEWTUU  VJSUAWRTWVU     QSWPOKROCPQKX   QWHEAERAUND     NWTUVQOMGKIKFI  FKKHYQF        
SKIKHNNLPQWGE   : SFPSDSHAHO      JSTXXUWAOYVSN   KHDOKSDMFOOBKFV SPSG            TLVXA          
RSWDQJX         : JXRDNMEKCUYRRN  XHADCANXWAFVQVB JSAMOACSSWE     XXXXMMV         NAYPAIH         AHRFPMY         EOAXDLMDYVWEBMF
OEEMP           : JXOY            LCDIAVSSUCI     IGFJSD          ATWVWANTJYF     EOAXDLMDYVWEBMF
JUMDHW          : FEAMMUMG        PLEMCARXGNTS    RXTUGGPISFIW    TQWCBCG         DHFOUXVNONIKGVU
OLDCDT          : EIRYDG          MDRSV           ALJAWNAMWJKLBWB DHFOUXVNONIKGVU RAIDF          
MAQESPJMBJUPOB  : WOOCEITAPSD     QYEVKIEG       
ECOBRTI         : ROYQKGNVLL      FOHAAHDYEDVGD   QVSTLYLCLERTHVQ YBWJEUCAGDHKL   IGXORUB         NHLAW           FFWGCP          MJPYSCPE       
LACOCILEULU     : XIYCDGFHPLEDH   DDQAROC         ICTGQJRBUBY    
HMNTNWQELTKSY   : VRVLKLOYJVGOB   EARMGXPBQFN     LYQRCHWHMWKTSYU DGGOXMOLCJBHCC 
TQUFHGFMVHUJMRW : SOEKDEIGWYXHH   HHEWHPT         NQWI            KBXOVDOBCEWXWVW XNRECAPTT      
UGWI            : OFHUCJWVV       AAMPMB          SGIBPONHX       OJXJBRGLAM      JSAMOACSSWE     DNYEWMN         KBKLECLWWVYNKCQ TTVXDYABVM     
UGWI            : UHJEHNLRHPPI   
MGSSTPEMODJH    : PVVBOOAI        HRDU            TLSCBOVKDP      SLBJGXKEP      
OOHVDFFXORRM    : QKPPPYFHQVO     FUXWPCF         IRVUBW          EUTKGEPTMAVQMP  CWJRHPJKDMBMQA  EFGTLJHWL      
NUDXXPESJYINNW  : VIQTRVVBSXJQG   XLQCPDUGQ      
WGTNVCJBHPAYJT  : XHWHYMTRRFS     TISWDMESOEFJQO 
PJISIILOCUPKKE  : ACICFKCHDNT     MSKSFNUNVXL     FRXAATBDIP     
DDQAROC         : XMNQMA          IPAWYVCPYDLP    GDSPRYWNKOTMAON LACOCILEULU    
QLUSMHOC        : YULY            JLGMEXRDGRAI   
YLSJTEXXBOJLS   : KVUD            FSYGOMJVBHGIB   IHMRPJTDLAFJL   ADAWT          
QXOQR           : WAFNRB          XIYCDGFHPLEDH   SNGMKO          GYXRYKXRULOVAPW
UXYJUTVCIYC     : IKNDXMNYIXO     OCCPXBOCRKJJWI  EWOQPFRDGO      XFBIMGKBJEWTUU  VEYXR           ISNEDDDLYPRS    ENRA           
MUSIYRHAGSLBO   : QPSLCOMHLDP     LCDIAVSSUCI     EWOQPFRDGO      QAVKGLO         WIIAXXAJG      
BFVTLQ          : VEBEN           KHMDTLUJG       RCCJKRLN        GUDIQOIMAPJ     OWLAP          
KCMEYRP         : WAFNRB          TULHKALDXWRAWHB YSNFRPP        
TYOOSWPKGPSY    : HLEVMH          IFSHFIRUGUXLK   HFICMH          YFUDER          IXILKNGBRLL     JNOBJHY        
VPHWXFQJWK      : TUARSFGXFMLFBYY DVVH            TLSCBOVKDP      VPSKTLBEJWRPGMK VTBVNKS        
BADARSCLSSALSPX : SRRUMJLRNIN     VWVCIJG         FUJODO          TVEKNSPTUK     
HQBMMS          : SSFTQM          RSOHRMAN       
LQADDYPAAPDDHY  : IYYMSMJQMJV     XOFBIQCI        EXLUHKEDBOBRV   HIJKJF          IDCTWYHUILDJU   HHUBJCAMSE      QHTKCRDTGK     
SRBUFVMDU       : XGTJVAAG        VPSKTLBEJWRPGMK QDVNG           MFQWCOBY       
VXIKRDVKFBNGRPI : IXKSQGGRKKFUPWS GROXGIBYORMDOS  KTHELKH         SLBJGXKEP      
TNPUVKMYGRU     : WIFF            HCELYBSYFH      QXIQPD          PJMOF          
WRRUQA          : XWMDHADGNSQJDM  GUHBYBLCTDFIC   YULY            DUPWTOVTCSDDXC 
KFDWKHLSYBCI    : IUWMPIBGHPAD    KJNL            NBECXIP         VDQTHQMY        LEBAVJSBJQMBN   KEQUIQ          ARNSAS          PPAWY          
PXRNLGOT        : EABTQPXBTNFIH   CVBCFRRI        FKLOEHG         NVOYBA         
LOYEGTWHBH      : JJRYBBXSPVIJHON EYHNUKFDWOXKJK 
HEAORSPVWXUP    : DNDFDHDCAPR     YINFVUJUHCSFPVX CBGUAMHD        TNGPADHFB       RAIDF          
PDKVUEWGSXK     : CHKUSFXGHFPUIGO TAMMIIBYW       NJISCEMN        SQJBI          
SJJVSXDAXTRTJPQ : NOOWLMLOESVDC   AAXSGPWCSFJ     JDPFTMFSUUUGVXA IUOPIRLGA       IHNGSRPI        FHASJD         
LGHBMTWHA       : LLFAQ           FHHEIEVSFTOHS   FKQQBNYUCJNY   
NSWBWPKG        : SYYW           
GHRGFLAY        : VINSVNBWWUXFJS  QBEQ            UOOOU           YTEIUUIRUN      EGSUCYKDNFRP   
QQGCYPDLL       : OOPXYBDMNQ     
SLBJGXKEP       : DIUAK           TTVXDYABVM      MGSSTPEMODJH    VXIKRDVKFBNGRPI
MDDTWJALKBJDTPF : TIEXOVD         XKBPMAGCVQITHE 
HKFSOBEP        : TULHKALDXWRAWHB IBAGDCCOCBXWAH  LPTQGCQCMRES   
MPWQFVEJAXILATX : IIRYRNUPBJXI    SXPKUUSCGCAMWWY WIDX            FREGIEJOWXBIN   BRUNY           RFFLRLFFB      
DBXUITCSAWIDDA  : NDMIAKHPFGL     YVBPNSIJNVN     VOUXPWC        
QQMHXKN         : CYETGYQYAUHRHMX XHADCANXWAFVQVB NLSKBYAFUFRWDAQ BJDCBURPXJ      HLBNBBVGLU      YNHMXJKNUVSJT  
MOSYOM          : NGJTNPKJASAER  
UQDTNLNQ        : BTRHIB          IWGFOCGMJD      GJBPRJ          YRGWCIXLVK      MGHQFFNVVT     
PPPUTRKKIY      : AHRTXBF         EMVSHYCPVU     
JKKSWYLXPBAL    : AVYG            OWRDAULA        JNGEOS          YNIYJMEW        PDXIXUCQYGY    
DHFOUXVNONIKGVU : TBDRPFSXJFVVHIQ XVJCA           QAJQ            FGBBSTWI        FVGE            JUMDHW          OLDCDT         
UQAHB           : RYOVIYURNRBW    EOSCTB          FIRHNOCTCKFFWQO
FAHFSI          : XCMNOSTISQYFRX  LQNMONLANEDBSKM XTNPBLYOYM      HCELYBSYFH      CVBCFRRI        OTWOII         
ECILKAIIXVYMH   : KUSFVTMOYIK     OUPQWK          WCHJXLDG       
UDGNAXQIB       : OCYBNCVDB       IERUHIIJB       YRGWCIXLVK      DMDCDKXPOQTKWGQ
PETUWDDDHNORNYD : JRQWBM         
XCDFOAKUN       : CVOAOJLDXYDNYVT SOUXMAPBH       CGITCVYQEIIKNVI VOUXPWC        
UESYQID         : YIOOOKF         XDXMDPLH        UTDBOWJ        
GCQJFXWT        : DXAQBFVKKAMARS  KHDOKSDMFOOBKFV KCKFDXJD        HBOCPJSRILPB    HLEVMH         
NUTCSXHXO       : VRVLKLOYJVGOB   EVHXUSLC        XJQMBQXNIX      HHUBJCAMSE      ENRA           
KMUVHAQISCLE    : TBDRPFSXJFVVHIQ RHIYQK          ATWVWANTJYF     MDRSV          
NWTUVQOMGKIKFI  : NYTEIVNCQNFXSUF AYCYFQ          MSQDETWLTUE    
EXYQKUMT        : KINCUVAUC       EVXCFYVOMVD     EYXNGOOSVTKQB   WTHR            EMVSHYCPVU     
EDRGQ           : DURGMUWTK       NFYLGLV         QXIQPD          QMMQFJAJJFBMC   VRVS            SOLVKBDPPH     
QHTKCRDTGK      : IPQB            LVQONEVU        KAETMGVIVNVLWEE LTWUFXNNFAQVA   LQADDYPAAPDDHY 
OWLAP           : WXRWHO          GJBPRJ          YKXIXOJJHMUTMCM BFVTLQ         
XOJKLXEKE       : BLGBMDXORYMNMC  WJTFCEPH        WOAQJLUTEVYHSNQ LCQXJOYA        JJRYBBXSPVIJHON HFJBYGGFWESAPAB
DMDCDKXPOQTKWGQ : DTYQXF          WTPRYND         OIKDPFVJ        KVHHWGVXXEBLHK  UDGNAXQIB      
DFOSYOKK        : CBVGCG          XHHSJEDDNUNB    OVEOXFVQWICVLQ  GPAJSFTOLOXLGT 
XJFJNPODSQ      : BJDCBURPXJ     
FQWVHS          : ATLAPXVTJM      KSPDEKRCFWBMKW  LYOKHM          RRMRXCROQ       LOQTSYQ         TITYFMXIUJ     
FYAVEHKXHY      : YINFVUJUHCSFPVX PGNCSFM         QLPBRVYDEXL     PJMOF          
RAIDF           : PGIJSEVTYLAO    HLEVMH          RBBIJ           OLDCDT          HEAORSPVWXUP   
RWIWRBDYSCVAWFH : UOARGHXHUKCH    EGETL           BYSMII          FBTUPLGVBVJXLGG CJIWVD         
FDDNPBW         : NHMTBENHSDQBB   EDWNJ           NXPX            SMIDHKWOQAQLW  
LOQTSYQ         : SFPSDSHAHO      YYJALSKWJMQNQ   FCSYO           FQWVHS         
VYJQBOPV        : EWHCBKGUUGDUVC  SKSU            VHYDACNBBBVNKOC CJIWVD         
NVQSGPYLSO      : NKSKSPCLM       VRVLKLOYJVGOB   CHYORI         
VLUHCMDUNTJL    : AEKTFVTTNO     
SCYKS           : QOBHDPE         YFBVATXIVAXUXWD
EGSUCYKDNFRP    : QBVLXQAJ        GHRGFLAY       
FKKHYQF         : JRTLCIQBFCVM    DMTLJKASMUQ     DIUWNGA         MSQDETWLTUE    
MOBIKDJUXEY     : DVQULNMM        LDTLQBQRWINVVD  DOEYKVLOCWEAOD  QQQHOVL         BJDCBURPXJ      FBDCCLON       
XVJYJMMOEESL    : DECXDHUMYYBBRX  QYEVKIEG        WTHR            MFQWCOBY       
FUQVCGLTJTE     : YUOFUPRF       
GBLKCSIXEKHQWYW : NKSKSPCLM       QAJQ           
TITYFMXIUJ      : SSJWHSWIR       YUOFUPRF        VRQCCIVLGV      FQWVHS         
EFGTLJHWL       : QQVIUYHUE       CGIP            OCYBNCVDB       YIOGVCTTTMIUK   HGMKXTMAVINW    GUDIQOIMAPJ     OOHVDFFXORRM   
HLGRVWRUTTQEPP  : JFLINXEUNPBUHUX FUJODO          HJRFRCVAGHCWBG  HCELYBSYFH      OOAMPKK        
ENRA            : KNBXTEKWCBRBP   MKOO            YDNYYNCTUSIY    UXYJUTVCIYC     NUTCSXHXO      
TGFCA           : BVPPGDU         WHSC           
LHPWJAJPR       : RKROLHBSPSF     UOARGHXHUKCH    AAXSGPWCSFJ     QJDFTXLAYOOI   
OLCIHUMWKYEBQ   : UIEX            JXRDNMEKCUYRRN  TPXHKJOORSVSKD  QXUPJLWFPSBLG   QRLFJEF        
ALMHNPBCW       : LMPWJUWYD       KWNMUAFMD       EPXXLXM         QIFKBQACJ       FOGUU          
BJQMBLT         : VTGFJOCIQWSAK   SABFGJPSBGYP    SNGMKO          RAQMOAYQLE      ARNSAS         
WXYHSOEENKHEQJ  : IHLIRYJPV       KVHHWGVXXEBLHK  WUUTNORXTCDMJKV CMMVFDQSADMOB   QNQEDDQWUMPAO  
ERITSKSLNCF     : HAYORQTEIMWU    TQQUMUDXUGTP    PTLIL           DPNUCHGUCN      TTMETKNXRM      XUCQAMPUH      
ESUWPTVYMMGSAQ  : DMNW            HQQXHOBDEH      RKKYQUU         JRRIH          
HIKY            : HDXRUULWI      
CJIWVD          : CNVJS           RWIWRBDYSCVAWFH VYJQBOPV       
KINLOGGLYC      : PLFHPMVNUIHOPDK EAWRYQX        
XPWEKWXLEGXGU   : EVHXUSLC        TKHUTNTPKRGW    CVBOMWIGCVIENX  VRVSNKNKSIFIN  
RFYOK           : YETFH           UOVSFXE         CGITCVYQEIIKNVI TWFYTGHSFHIUWDM
YSXMHGUSHXD     : EXENALKT        XKBPMAGCVQITHE  CTKDPPBMWAN    
PAOAY           : UYXDQFXBJOA     RXBJIW          QKPPPYFHQVO     EWKQEOCCXT     
NGULORNGWMWKWXD : WAJEAMNPOSMNXX  SWQXEIRJD       AFIDXMMYCJWFA   XILROGJBKNOP    OQFN            MDVIFJQQYCWKTE 
KNDIILILVAN     : YINFVUJUHCSFPVX KHMXJXFFHXW     MGEJL           OYTFHPR        
ANAQVUCKNQ      : DQRIXACMWJV     QWHEAERAUND    
MFQWCOBY        : WJSWGX          SRBUFVMDU       XVJYJMMOEESL   
QFKYSULOU       : UUIDJVVNB       VFSLEXBVDGEY    UBUHFURSRFFT    IMUIDGB        
YWQBNM          : RLONKXCTKEHEEL  NYQOODQX        KEQUIQ          EUTKGEPTMAVQMP  BYJL            QWEIINPSHESYHD 
SWKLQWQJWV      : UFFTCARJKNIXNXG BJCKTRCISKMJC   RCCJKRLN       
XUCQAMPUH       : FOHAAHDYEDVGD   SABFGJPSBGYP    AIFIWFROKXWUFJU ERITSKSLNCF    
JEFLCVMPJJI     : WBQBUGKD        APOJWYEFFQRL   
VTBVNKS         : EVSA            UHEJL           GPVMAPBQRJH     VPHWXFQJWK     
JSGNJJBYEKDQ    : VRVLKLOYJVGOB   GROXGIBYORMDOS 
ICTGQJRBUBY     : GEGBSPO         PWILJXYRGIHTYM  KKOSSTFN        UQSLXOQMVWA     LACOCILEULU    
