PGQMIVPKSY      : SSHQ            UWUNBNSLAGPWKRO
REVMRXXJRCJICET : QIBVGBUU        VMJKKKPSPOEOLO  FRGYSVINTEGTHVQ GWVSTWFHISD    
QBIHQOAF        : XJCLLYBFKF      HLVMEOBOCUQI    PXCFAUOSWYU    
VVKP            : TENQFUO         OKMHORERP       MMYKVGJFDQID    TXBR            VLLOY           TUGMWVSF        FRKLJYFTWHDBN   AUNYKQAWOMB    
FJBBWSA         : QTIYQPISPFXOAYA
ETANEEU         : PILX            QWKLWWPTLNGME   YROWQHL         PIAA           
INBTU           : UEMY            ISNQWLDOXRLMRV  YSNY            SMWVLFS         RADPVMTXEAIJENC
KWAKUXUKWCWXDV  : SWTDOSUY        LDDE            TTKTJGUKAGGNG  
FSXBUOFYJHKWJ   : KLMKU           WEYHSX          RRTIKBR        
TGQQIBLJXYGA    : PLKSXSYFDNXDE   DYAODFCNHNPL    NCSWQRREUWWCB   YYTAEKRVUFKAMXC TITQOOTVKJHNHK  BPCFTHHTQC     
FGTYNOYPKNWLYF  : HMDXJPLCXOO     QEADNWRHPCT     PQFIFHYQOKH     JAQHWUFE        LRHICHCWHQBHGK 
VQERYV          : UDPBUMDTPGQ     VWFHUMSPCGM     ENHTSLWVANSNDSO
HYYQAAXCXFKR    : QEWMFILOXH     
YGFOSVN         : WCUO            VLLWWFCWQRUTT   TUAKXNFWFFEJ    MHSGHKGUICP    
UUFTLMNKKYSJXLL : FCAPOKHIOY      FDCHFNUYMHVOE   NUDOLJXQRVHGJK 
JOXQYPWAXFOTB   : KLGLOXBBIV      SFXFOREAP      
BXAGTOSIY       : KVGITDHJSE      GXECEVVLHYTJTNR RQNOCQTGWR      OQLUOU         
JTPHIDHTRFLTWKT : OLPOTLOYJSE     OEPAHSFQORFXL   NWRC           
PLQSSRT         : OCKBGJTLFJ      SSPAAKCA       
BNHVXJCHFTON    : HGKIMLYIGOJ     AVVIUNALSWO     EKEQF           XTHNCWMYSA     
XIRFV           : RNYBXXEJTQYEOO  IYIPRQUPHTLHSH  NOHLUBQHJSDD   
EGJCW           : IQQWYDLLKWP     SLLRFLCWIAD    
URPPLLQ         : VEFOW           XGJQRHCYCM      ANHVJUABYNOUF   KTKVIUHBXDXR    ONTWWCHOUDUED  
SOAEQIMKYAIAKC  : QEAELET         KBEON           XDYWROLNAQXIWG  DVMWPAUD       
GPMNY           : OHHPLM          CQOEABML        EQHCJTGSKS      AEXCAUWNU       OKTEGTEIDU      CNGOTCSJGQQ     OQLUOU         
MWLEMBSXTU      : XXEEBSNRD      
JWACFMPHNXHACO  : UXIRIADHBHDS    BQPL            CHYYHC          FGTHOBI         YAWRMOJDV       TRYDUAWFHL     
RBUQRJPEPDHIDE  : PJDXEYF         VWHJJOKITTXC    ONTWWCHOUDUED  
WPDX            : QOEGYH          IVRGFWVRO      
KMHTCH          : KHHNARRQ        LDQOOMGNHJ      HJJDCI         
DJQKDRHUKQKQGP  : YVEETDORVTT     LWHVHWJAOB     
RTCWSRCSMPGTJ   : MXUBHX          FDYHANXKWBDTHSX VBTJBWJBBSWT    DQLNELYHXEC    
ENLNGVRXF       : RLTUUYB         TADCECKSKVL    
KVBBFTCWN       : TXFSRABRMMNF    NRXPQMJCLNYG    MMPNSWYXOUE     DLCSHOAUFE     
TIBYCNOIJAS     : HCJHAEPS        BXQKWOEQYB      UDPBUMDTPGQ     PEVCBYODQRFYTTC
NFEVDXW         : XNVPKQISND      MLHIGVA         KYNK            UFMMEDUBNCBUT   VWGLQRJGDLA     DJEPUYTI       
OHHPLM          : GPMNY           QRBPNJXYVKBQY   JAJSNLVCH      
PJYVGIY         : UBNYORRXA       LMWBE           ALUCTXTNTPRQ   
KMVUWVNM        : CLGIHYLXNSFUNGB OLKYY           WOMKAI          QGWGNLOBBRCIERA
UQIBOFMDPTVDJ   : APUU            SLORELGXSHFXP   PQAMIGFTMTG     RDVUYQKM        VQJVUKKA       
SSHQ            : PGQMIVPKSY      QIBVGBUU        RFBJUBVW        GTEKDKKVWICADWH VFBVLFNNBUFQ   
PQGCF           : WTRLYPUDLRMUAUI
WCYMPNIIV       : JXXSJVORBKGPXCH KSLHLPSJUK      GRVFQJRVBAFI   
XEXDVRY         : NBUXFJFBMIFFHMQ SROQKDYKVOJY    UYII            GADOOLHVMPOGP   TJTWJCNLVCDCQKD RATF            TSLSXIUWN      
BHTWO           : SIACPPPNXNUMM   BLNGDYBKBO      SFEICSTT        SBSJCUCID       QNHWPBAMXMBMQHI
XGFHILJH        : NYWRK           EHKQVMS         RJJXXSSFKYGCH   YROWQHL        
KVFXGOWR        : VOYRAT          MRCTLXATBJ     
DPRYIRALBV      : PQUMIWGVBIFJ    GRMFLFGMHY      WBLTWCANHLTC    PHJDTSC         WSMYAYVQ        OKBRUCO        
PILX            : ETANEEU         WUAQG           SGGBIXPPXV      OHJIYW          HWSB            LJXETNDVPRWQ   
SIACPPPNXNUMM   : BHTWO           QEXRO           BXPRELJCU       KDNFBUKGQDUBON 
BPDUO           : HBMQDFI         LKUV            SIBSGGIM        XAEDB          
MQYNMMFVXDMS    : LSNXFVFVOI      FXKWINPJNM     
MWDEMRCDMQP     : GUGAHGVXBBYQKJ  WDXYQIFX        FAXOETCWC       TBMQR           XEVYSODSEUXMU   SACBTTPHUC      HVFRMEIUQFSA   
RGCNWRCORSBGXYG : EURF           
LBRAXVHLPJOCB   : BWTNPIHIYSYS    OMPNW           WRTSO          
DUMIK           : KXYTEGWVIBD     MLHIGVA         PGTLRICECFPS    AYKMSYNHTTJIGFS QSDHMEDWF       MDJMQENDWNS    
APYTICAIC       : DXQGPMVRWFU     LAHIMNGH       
MPJH            : GTBWBXORMGPOO   LSNXFVFVOI      XTJMDTWN        TMAJOAXIOFSG    BVEYCXQIY      
IDAVSJ          : YPCHJVXCHHIQ   
WMSAK           : DKPFPYFMWPNEJ   ILXEMUROFPEFCG 
KUQLMPHWR       : XBBB            YKFBQWY         XWVIVIIXI      
GVSUMFCFNH      : NBOXWFCUOHWVBM  IADTDHK         YFLRYVJBJAJ     TJBPRL         
LCQXYGS         : BVUSUHG         XRPJPDKASHELSE  SUCDMQJXUISI   
QYMNRABJIXE     : LWHVHWJAOB      RKDSUKYWRLHBR   JMQYDRSYMPANKI 
GANEOSGVGQD     : PQFIFHYQOKH     FSWT           
SUTSDNUTOJJHKM  : VXMRV           OTHOCYOD        BIGHXDOC        VQRU           
UNWNTXDXOWHLFX  : AXAGEIUDCJFPUQG
AQLVLOJIK       : TFTLGPPXYVBNO   XWAQRD          IIQSS          
SUKFHDAUBPP     : CWMRKOTOYIR     EOJMGICEOY      XPVBARJTMAYWFT  IJSTWW         
SPPRYD          : YLCJUGXSGUDOJUF FPJHMP          HAXTSBHHCSO     SACXVJIPC      
WUAQG           : PILX            TBMQR           FDCHFNUYMHVOE   LKFOPMUKH      
CVILGJG         : DJIJUTTQVDJYOKD PVMTVJGUN       NFMQLFEFXCOY    BVUSUHG         YROWQHL        
VLLYNGAF        : IFWCHNEM        WRLMXVMKQYQWU   LSICIYHCDFCCPIT
DAQVSPYQPTQG    : KXONLBJLGL      ORVFQIRMEKLTB   TQXAPVAXEADTH   IOIJSLLBVQ     
OIBWVJICNEPYE   : BQED            NJQBRDQPUY      MDEPVV          YUQURHUHAUCSS   ETGXPJCLRXBP    YVDRUMJS        AILAKCK        
HGKIMLYIGOJ     : BNHVXJCHFTON    RLOHTIKN        TQWPOIU         OUOGPLQMSF      PQXXKWQGRE     
EGPKJGVKETTOYH  : UBFXI           EDPGCP          XSKQIJVLFJ      XKXFCYFQDYLGOE  MAXHLHUDJHJPX   CVBJHJLMK      
OIAUQIHYUS      : EPHD            PDMXLIYMEDHLINL SJJKBAOVVHIQXE  EURF            IJSTWW          CQKTKDOFDO     
DYOPXVVPIFW     : JUTTLHRLXP      CHYYHC          FDTTVQWRTYGFDQ 
RDBLRAVLQGLN    : JWKNYIDUVFPOG   YFPK            LEJJNKGHMNGYGAB IQPBPBKCF      
WVXRQAXQPNQLJ   : LMWBE           YTIDREIIOS      LLUQMVNQESFC    PEWP           
VQGDIJGVB       : LOOOWL          MBNVQPVYH      
TPYBDNAALBSCB   : BFIAR           KLJNYAYCCTSKRRN MOJTPTFUAH      FPAUUYCVSKRII   UYHE           
USGMGRVDICI     : RFBJUBVW        GNPMURD         ROVDQRWM        UMNHJIIMXPK     XDNJISPEX       AQGICUYMMIBSNH  AIESLEJUKJL    
LOOOWL          : VQGDIJGVB       EQSRWEEDVE      HWPOUA         
VOILO           : JWKNYIDUVFPOG   GWVBTAPBDQBMVXH ODYOC          
YRDC            : SEBAFMVBKNQ     VLLOY           MXFHWTGKWLGFY   CQKTKDOFDO     
VWQELXVHDEJLY   : VOMOQGCIDUKPK   QPKHTELKTGLUVI  OKBRUCO        
AOMWCQUQ        : NBUXFJFBMIFFHMQ VHCHVFFVYX      NENGWOENMX      FJYORWRX       
JHMIAPMXOKO     : PSDLGVXJGA      MPRYQRSWTWIYT   EGPSPKSPHOPR    XYYTMTL        
VMPGRVPDVPFMC   : JIPAAFPO        OGOYJNAUDJ      XANFQUQ         TTPYNQASSVV     RHJQQUOQFDKBY   XLGOI          
OUAFWLOJVOBJO   : SOHAB           UUFFSSNJN      
TEJRSYALWQQSI   : KLCJPHYUCYERP   DKECMC          IVWVB           KVKXCLONKI      FTBP           
FKBVHDDGQSRNJT  : MSIXCJEDEUCET   WAFAWNWMVWSTNDC UWPAHCPEXFNDB  
YLSDU           : YMRKNBWNRJ     
XVNJTGB         : MSKAAD          UJRK            HVJSIUCOJ      
OXWBBSIHYRXRJ   : VLLOY           WBNLYRJG        XFVRJHA         UAUIOVRWLWBY    TTWAHJXF       
BFIAR           : TPYBDNAALBSCB   MKKLNBWADYG    
FOOENC          : BHEPSRSFA       KWGORIXDUHM     QBYFXWMDHIFMKS  IVFENJRNMIIUSP  XLGOI          
JIQXWQU         : KXYTEGWVIBD     TSBCXRIYAHCPCHK MUQQBDTCPOO    
SQIAPAXJKMKRUNJ : CWVMCLDCBADG    XMPDSJ          SOXDO          
UBNYORRXA       : PJYVGIY         OHUSDVELSIG     DIMCQQOXDRXBAGM
XYAVYUMJWEK     : LDDE            WJPIQQE        
NWJAOHPBGLE     : COHKH           FCTADGVATHGW    XCCCPICLQHJGL   QSPHXIBIO       WDFR           
MSNESPNQOPOPMD  : NRCFMCBH        VDEWUVLFJNOLCQ  QEAELET         XAEDB           WTLJMFCG       
LHLKWKUXACNDKYH : WQEEJYCWXIIBW   AELBNLRWQQEDQJT XMPDSJ          UOXMIQROJWDI   
OCTS            : OSCAV           CQALJQVWLKMUN   YYQDGBGSTNKS    SQDKCU          PMEFBQEATBSTH  
JIPAAFPO        : VMPGRVPDVPFMC   MXUBHX          WQCARERGGP      AWSFAGYSX       NWRC           
QASFLPPIPPMEUW  : ONXDY           TWCV            MNWGPAYG        YHXAOL         
EDVIWPFIA       : MNWGPAYG        GYQOMGYCTDUJW   HVHPNDGEI      
IBDAR           : WGQXR           JIGXUH         
SUGXGW          : QOYUF           GLIJ            MDMOHTUUTGUFL   AIESLEJUKJL    
QOEDSCCBIFW     : DWKAQI          PEIOXBCJJLM     NKYR            AUYKEN          OEPAHSFQORFXL  
EOYMRW          : YNETWFUAWBKC    MNRHCXYVFUIEFO  VQEYAWTFMA     
SAWMOPHWO       : QSEXTMXE        PMLUEN         
VDGLJL          : NQERXTYKRSGE    UTCKVDFXBROIXE  KUEOQXFONMFJVL 
NNHWUHQYXP      : RBVAISVUUBYQPTY LAHIMNGH       
PNMKPLXGEFEUV   : CQALJQVWLKMUN   SCTVNYYBNEHBJQP EYXDXCMU        PWOG           
XELJQSAE        : ELKNFDQGEP      RIHUOSAYO       LJLEA           CBLE            HVFRMEIUQFSA   
WAJPBKFRAUELL   : RIHUOSAYO       WLWGOXWQRLRGDU  OVDLJUX         AYREJNBPBSHKBK 
LTUQAPOBPTOB    : UEVWIOJWC       GTBWBXORMGPOO   PKDOYGMFHKRRHN  BBXXKNNNOD     
JDOMCQX         : YNNN            RSNGOOLP        MFTOCFKNA       DDVUCAXLY       MOKNF          
SIXMJUQWIJIDG   : RPMR            KXONLBJLGL      MIDCSQ          GRGNVWS        
DXQGPMVRWFU     : APYTICAIC       GVRRDTY         FTBP           
TXFSRABRMMNF    : KVBBFTCWN       SWETP           GPCNTVRTPVPL    QNHWPBAMXMBMQHI
VPTYXVF         : TTHOEE          EURF            XWHB            WUIYDKTPGYJSUO  WGPSOHCAETJCPY  WOUYWTG         XCNFNI         
OLMBJGAPENL     : MLCBKDIIPCOB    DVQK            THKYECRD        CONJTFYMPPNYOJ 
UEVWIOJWC       : LTUQAPOBPTOB    BNCSJXYVXNT     GXIVAFVCEOLNS   MITXTRQM       
JAHDA           : ONKUEDOJEMB     QQQGLWXYHUE    
BHEPSRSFA       : FOOENC          COHKH           AKSOYE          FOHKSRHCDKUV    HHGX            SXWJJDOSTFR     CROWIUYTAJN    
UEHIIENFCVVNSXF : QKHILUL         GFVOCBAJ        QQWMQFL         SFXFOREAP      
XOIAWLHBEDUWIV  : GQTXBHPMMLETVG  KUBJYQDCGYM     ORHYWISWJUPJY   CPUVXEB        
FCCNLGDSIBOYWO  : QTTRO           VGMYWSOWAJDSY   HUYYRKNCJQO    
BOVLPS          : HJJDCI          DAPYVSJGEOK    
YVEETDORVTT     : DJQKDRHUKQKQGP  BNWVTTBINM      GQTXBHPMMLETVG 
KHHNARRQ        : KMHTCH          URHLRUHHHAR     LRDBH           YNXJGCRV       
OFXPUTCMOCNM    : JPUVMF          MITXTRQM        KMKYET         
SIJHAIEWIQE     : NTHGRDD         PIAA           
GHIXXYME        : TYJMRRSUNO      EULQ            OIKJKAXPG       GQFYIRTXALPT    PMSEYFCLHPUFWQ 
FBQJNHLB        : RQNOCQTGWR      SQDKCU          QOKYCQP        
TTDFEG          : NLVWAJUUMP      WBIVG          
KDYB            : KRINQKCTPHIY    BORAOCAC        OLHTKQB         ENHTSLWVANSNDSO VWDO            TVNQYJRV       
OHQWGPWUVVA     : POBJJJTMDJATJ   XCVRXXC         THDRVQR        
NJKWWLTSIX      : AGQDLB          ABDSCLS        
OGOYJNAUDJ      : VMPGRVPDVPFMC   EVJFYTGNABUSAE  RWKWNKSSLFOJNUS RNJW           
CPEYNAVNWLAJK   : FWVTKABJVWGB    MHENRVPPG       AYREJNBPBSHKBK 
WFSFDT          : JWKGHW          VMSG            DHHHUTBWUDT     DKAJBYT        
LIWWYWRE        : SOXDO           MTRHBQRBWJ      UVCBGF         
EGBKIOKGFH      : KVVEBA          GLIJ           
HQCGOJYVMUUA    : DQBDYAJ         QOAPLHL         YAWRMOJDV       YOEDENWXWYPCV  
RWFRPLBV        : FRQCTWUPK       IIYDNSKY       
CHATTIBEAIW     : LPOIDCVARR      PPIMJEGMEJTBN   YPCHJVXCHHIQ    ERHOWXFVTOVC    DLCSHOAUFE     
ONOQK           : XTTP            EQGPRIPSHUH     LGUAXUVYIAN     IKHTSAV         OGDUWHFQW      
LHERYEY         : EGSGHU         
TKTRFYYHU       : EQGVMBUTVNITPX  ISEANUQNICEEU   IOGMTXFRVM      BHJL            CDTJKFD        
QVASEWAUL       : DPLU            DHNCTCR        
NXVCFCTGG       : AXAGEIUDCJFPUQG GVDV            TSVTH           GFWQ            LDEFLBBKTMLE   
ACIVUN          : KRSOJMBUNS      XCNFNI         
VXRRO           : QBYLMMKCWRFV    VPMREBBUJYJCUBA WGYBKYUCIMR    
RHTRKPDCDDXFICC : DEHLPF          POCVRIGXFWOPS   DOQTMOAYFFLT    IJSTWW         
LAQNIPIYM       : HQEKUWVUQLDGW   QCAXAUNVHHISQ   TCQABJFAWSDWG   FGTHOBI         VDXSSJSGDGWWOS  NTUQEMJ        
WFBLUTUPNFFQHK  : PDMXLIYMEDHLINL UHAVIW          YKLWOYE        
HQEKUWVUQLDGW   : LAQNIPIYM       FYFXJREUJDFED  
SEBAFMVBKNQ     : YRDC            KWCM            KLCJPHYUCYERP   VWSBIXQMNLGMUY  GAPTQYTNJNY    
SHADDJVJ        : OQAHPAS         ELXVSRDBIDUFE   NENGWOENMX      WPRAEDM         WUBBMRHPNARVUVY
SHTNAGT         : FYFJAFQGYEHBU   IQQWYDLLKWP     TMAJOAXIOFSG    FYFXJREUJDFED   CFWKC          
DXBJA           : QJIVBVQYDQ      MBPQNDEASFYSIA  TPUWBBIIB       RGISOYCT       
QMCU            : VLRMXMAHHMYTNL  MYVRVQEJWDQN    EFENLP          QCJILCBIN      
PLRKVTPB        : MJWHEGHHVTVNV   WECRTAT         PAABUUDSNFM    
MNCFWVVWEPDJNG  : CDMNPFE         QWXYTOQOV       XLKOUG          AWYEMEDAXC      KPGJP           QEHTBXCOBKNUC  
NKMDOJCEWVOS    : CUBROIORPPPCTLN RPIOSDOGFCHT    JWYLUMBHCFYCDPI
FWVTKABJVWGB    : CPEYNAVNWLAJK   BCSYDGSQXQDA    CWDGXRTCDD      WHXDRRQVOJKI    EIPJHLMOXC     
LMDTISHUXVGBBDY : JAKEMSWNNXED    NWYYKSANKVOYLO  TBDBIWGSWIBB   
YRYXPSKPU       : QFDYDFCEGXUVKB  GDFK            EJFUFLN         GRLMLH         
LTAOJ           : OWSTJ           EFPVFEPJ        COBBHGBNHUNT    ERPQ           
COHKH           : NWJAOHPBGLE     BHEPSRSFA       YJMLIXSLSMN     KLMKU          
HGLNJOS         : HXOPNNHCBJRYYW  QSEXTMXE        WAVDCOIEJTE     SNTYFTATUPNSDQY FUFKSSSGOD     
GTCIRRBC        : LHNIORGFYFBBRO  VDEWUVLFJNOLCQ  YDUEFOAIKMMXULO QIVQBTXYNHJNQW 
XVVUXKELO       : MTHCUERRDTYAC   CSUAU           DOQXPYYSC       SUQAIQCBDHQ     XMSQGUY        
TBCKK           : NWJLJNIDJXNDNN  CMNGIU          MLNBKLTE        BKXA            GTFRQFDIGVXXEB  OMVWAWQAEPC     YQKHOPQ         EGDXQR         
VATMTFVNHEGAHKJ : PJESEPL         OCKBGJTLFJ      MESRBXDWO       EXDQSVIWHLUKVQ  LSICIYHCDFCCPIT
HFBFSHTJCNLE    : GPCNTVRTPVPL    JIGXUH         
VPWWJ           : MJNIXOQTRXS     OLIUGDLVIKHKXFH ERHOWXFVTOVC    CRPYREBRMMAJRJQ
SOFIYLQBTCKALQ  : GOGJQOL         LLUQMVNQESFC    HMLY            JIGXUH          NKDUNILSKGPVIXV
QLMMUOAIUBHKAE  : YJJNPILPCQEJIK  QWKLWWPTLNGME   DTSN            ROVUKVJWMYVF    TPBQJVDUSGX    
LYNTHMFBNYDBBO  : YXNSMRPMXP      UCXWBVI         UHQDUEHE        NDIWUMOIGPCRLUC
GHFU            : RUTMP           CPMRIFVESJPXW   BIGHXDOC        FQFM           
CJWLH           : NQXJBBDDGVELXEU YORXLSRNK       WKBMLRCCS       AIESLEJUKJL     OJGFJNNVDKIEXTJ WKYXGSJPW      
SRCYOOXDKHRPI   : AUTCIGHO        QMJWICQMV      
RNJUCDEM        : TAWTIHUKP       FPAUUYCVSKRII   FAFNETRTESWTD   URGAXUR        
YJMLIXSLSMN     : COHKH           TJCHBRBTWFKGY   AWSFAGYSX       XPGKUVGAAF     
CERH            : ENNOFNP         RLNC            VDGQFUC        
CYHKHBBQVFVAREC : KLWBKU          BAFRQYLOFP      XSFB            EFENLP          TUEVNLAYGFAUBH 
RPMR            : SIXMJUQWIJIDG   KSLHLPSJUK      QSUWNAALSNH     FWNAEHOJ        JSCIASCRNK      OTBUIGE        
XLUN            : WELJVQWYFJXKI   QHXW            CFTIBBIF        DKECMC          LXCSMCPRJBCP    ATVAVYUKYHVPA  
YSXIHAKQMRRNLOT : KSYAHJBCJC      FCAPOKHIOY      SJJKBAOVVHIQXE  WVUEYAJALAML    EMIXU           TAYUJ           JMLBEUS         OTBUIGE        
QNOURIKGCUG     : LMWBE           VMJKKKPSPOEOLO  OHCTNPIIJJOAY   MCONXWQPBYA    
QTTRO           : FCCNLGDSIBOYWO  PIGDOQF         QOKJQG          NTUQEMJ         ULOM            QCJILCBIN      
BWTNPIHIYSYS    : LBRAXVHLPJOCB   KVGITDHJSE      EQQXLMCRO      
RITNCEXIGVQWMLQ : MBNVQPVYH       BQPL            YQPVYROLNYMQHM  ONTWWCHOUDUED  
AMJYIWP         : EFPVFEPJ        GVFLSICEUNAMMV  NCOVRFGUVWJL    XAGAAMKLJ      
FAPAYKFQTYGVF   : GXECEVVLHYTJTNR HSBBHTVRXJBAX   OGTSKFLDPQNK    SACXVJIPC      
HMDXJPLCXOO     : FGTYNOYPKNWLYF  MXUBHX          YJJNPILPCQEJIK  JEJEEVKM       
NWHFPMF         : GEAHNKJQSUTJM   DJYQM           RYKBMSWWUMP    
PGQU            : JRGJUTHCOLXDWUN SMODTYUV        MESRBXDWO       ASBIRNCOESGDNP  CSUAU          
MWEJCLSQ        : QHQRIANDV       LLMK           
QAGFEHTSPHRYPI  : XBFSSQOFW       WUIYDKTPGYJSUO  SHWPLXLRMOTIV  
WQEEJYCWXIIBW   : LHLKWKUXACNDKYH JQRKFISRBORHWPY AUVIOPYAPHGAWS 
RLTUUYB         : ENLNGVRXF       XFKOUXDBIAS     YLFAGWWXRNTT   
SWTDOSUY        : KWAKUXUKWCWXDV  KARLTJGRLC     
RPNVCNAYNLHQIKL : TGBYMJ          BJIH            BGPVIV          MAXHLHUDJHJPX  
EGSGHU          : LHERYEY         QKTWKDDGBG      SGGBIXPPXV      DKPFPYFMWPNEJ   VVTIFXJUMOEUGC  XFVRJHA         TDXXYIGPBYDWSX 
EQGVMBUTVNITPX  : TKTRFYYHU       COQEQNRWBQ      VUOGXKKPAEDF   
QNGAFQKQMQYGYGD : EEIOBOVOYFKGWVK XNUUCA          WVOIUTQOCF      QSDHMEDWF      
NWJLJNIDJXNDNN  : TBCKK           WKBMLRCCS       PGLTVPJ        
GEIGJYQAOKYWJ   : AJUJJYY         FDYHANXKWBDTHSX BNEHEXSJXD      GIGVTQMH       
CMWYWIIMROVPEB  : DGJR            HIEDQRCRGYINJQ  VXDGHNQRIQCM    TKUQRBKBXDKV   
UEMY            : INBTU           JWSQHMVEK       ONWIBAVBEIME   
VIOOK           : NWVEMG          XCVRXXC         VVLEJUUVSHBCVBR VPMREBBUJYJCUBA FKIMNFQINI     
YLCJUGXSGUDOJUF : SPPRYD          PEIOXBCJJLM     BOCR            YXTBI           DTSN            ERHOWXFVTOVC   
NKJVFPK         : KCIFJHA         MHYSXBGF        QOKJQG          TAYUJ          
CGOSVYX         : HRMLNYCG        BGBCPLLRSRQXPE 
KCIFJHA         : NKJVFPK         LAPURBDSURC     EIPJHLMOXC     
EEIOBOVOYFKGWVK : QNGAFQKQMQYGYGD TENQFUO         EGPSPKSPHOPR    NMJDDFGTLMJRF  
EBUCAVAMAITL    : VOHRKLPCO       OQOPLDYRWWJLUKQ UCUPLTFQXWT     XAEHJCPUGABWIX 
UDUYOLADH       : JWKGHW          JVQYXOM         PPHVCWDCRMI     OJGFJNNVDKIEXTJ
EPEMMCWOHXMJ    : QWOTVPNU        XOEOQGLRRUEDI  
KLMKU           : FSXBUOFYJHKWJ   COHKH           EQYSKKUCHRP     OSMMGBQNJMUXO  
WMDC            : LNWW            ROKDCAVM        HTQWFUSJ        UOXMIQROJWDI   
ESUHVDYCUDOH    : WCDLX           TAYVXR          ULLPFCIVGN      BSQW            UGUBUX          HTYGKCUVY      
NYPNLB          : QNLW            SACXVJIPC       PHLUXUR        
VNCIKLHWOMJTF   : THDRVQR         WGYBKYUCIMR    
BEJCG           : PTLC            QXKNX           BKWMQV          NHBCNMTYAAW    
HXOPNNHCBJRYYW  : HGLNJOS         GBRJGSEPQBMG   
LIPKYCTU        : MIDCSQ          BORAOCAC        CKIFUXG         NAVACWPJ        QBJCW           LTTRYXXOW       RADPVMTXEAIJENC UMFFUIDQS      
BXNKA           : VQCOLFHHUAGK    ULLPFCIVGN      SHYE            FXKWINPJNM     
RKUIAKVKMYV     : YXNSMRPMXP      FGAXW           SLXOTJPGPIDYJ  
XUEFGOW         : XBTTFFNYLA      LDDE            RUHPCXLLTI      WLWGOXWQRLRGDU  QNUNCHJVW       OFNAUPPEBSXS   
NYNJJOHYBKVUUS  : JTSDK           FXYJUJV         JICJXJ         
WEYHSX          : FSXBUOFYJHKWJ   IDWSHOCAIKPCUM  WLKOL          
AXAGEIUDCJFPUQG : UNWNTXDXOWHLFX  NXVCFCTGG       QTIYQPISPFXOAYA OLKYELHDCWHKOT 
PHOMDJHGJNIQH   : CPMRIFVESJPXW   MVYWXDY         CVMTTWVI        GHUPPBPCN      
WJJWSNI         : RTDUAXOB        MKLDYRGDADIACBL SXWJJDOSTFR    
SKYXCTOKYFTNTY  : TMAJOAXIOFSG   
DGJR            : CMWYWIIMROVPEB  GHOTSDM         JJAU            IXXKDHKHSCLJJ   HTEABNGGFPEPTK 
ABBYMKYFAHTTT   : SGRH            NYWRK           KQEDNF          EHOBCC          QECCCRAKVMGV    DVMWPAUD       
RXPHIQOCEI      : TJCHBRBTWFKGY   GTFRQFDIGVXXEB  ENHTSLWVANSNDSO EKNRYTBXRIUSY  
ELKNFDQGEP      : XELJQSAE        TITQOOTVKJHNHK  PKSXHED        
ROBTXUNRSI      : JCCVOMLJECN     CGWEAW          DFXHGRNLKMCBN  
IPABGDFQH       : MFHC            TAYVXR          UJSQX           SQDKCU          GOHTPAQGTTPIAV 
CRCK            : DHCWTHEFYM      OQOPLDYRWWJLUKQ WMGEMJUD       
SQDLMUCOPDLF    : FEMXCLUI       
ENNOFNP         : CERH            SBSJCUCID       CKIFUXG         BRISOUEK        LEXQKWROFGW     UFNTLN         
SXCAK           : LNKSVVJQNCT     MCYVDOBEMJE     UTKECNWQSLU     NOHLUBQHJSDD   
TORSKKWV        : WLWGOXWQRLRGDU  PPHVCWDCRMI     WBPTCJELJ      
TAQJDC          : HYTPYD          OMPNW           UNYOKTGU        CPUTWIRTECTW    SMHCHHYUJHNEBLK WLXOKBGXVQYPQI 
BJFOALESY       : OHCTNPIIJJOAY   MKLDYRGDADIACBL
QEADNWRHPCT     : FGTYNOYPKNWLYF  EPHD            GDFJPCGCCEX     XTCTAIH         MQWXWNMLC       SLORELGXSHFXP  
ATJDKUG         : DEHLPF          XFPOCX          AJDIMDWCKT      FQPLR           BRUPDCJFKTXPQ  
MHYSXBGF        : NKJVFPK         TGBYMJ          IOGMTXFRVM      RRBERWGIIFUTO   TNKKX           XDIQUNYF        FPAUUYCVSKRII   PVMGMW         
HDKNFPBEIIWM    : PDMXLIYMEDHLINL LDQOOMGNHJ      BXKQJRUI        QVYXOSSQWALIKD  GWVBTAPBDQBMVXH AUYKEN          BJECQYWLECHWS  
LNWW            : WMDC            JVFAAW          EHPQGGUR        ADQVSKVYMFJT    JEAYVIMP        DBRDK          
KSYAHJBCJC      : YSXIHAKQMRRNLOT YFXHOTD         SBSJCUCID       TWJPYSPPF       LJXETNDVPRWQ   
OWSTJ           : LTAOJ           FGTHOBI         SACBTTPHUC     
AAIG            : NAGXXWWNMTQDOXV QWDCWHBHJLVT    MFUKUGEFEK     
SDWVR           : NAHJSTD         EHKQVMS         EAVQ            LTTRYXXOW      
VQDGLD          : SGNWCRQT        THMYAGDMHMOD    NEYOK          
TOJVXNHNKCHU    : SBRO            HARPREIH        CROWIUYTAJN     CJLFDPNHH      
JWSQHMVEK       : UEMY            UORFYM         
RIHUOSAYO       : XELJQSAE        WAJPBKFRAUELL   ATMGQYSBQMITY   KMTXEBWSVXMEX   GEIWMFKWKBOWVAH HUALKQSTV       MJNIXOQTRXS    
KLPYU           : MFUKUGEFEK      MHYDMBTHYMPTUS 
JWKGHW          : WFSFDT          UDUYOLADH       MQRPURBWIQKRE  
BNKP            : YBVF            RKDSUKYWRLHBR   EQYSKKUCHRP     XFKOUXDBIAS     MESRBXDWO       IFVDUXLBNBMIM  
RCCJLL          : SQDXJUADBCLQN   GRMFLFGMHY      RLYIIFNFMOOVCM  CBIXIKRV        MEGSXFVMISTIE   WURIVEDXA      
CGHCVXMHNLCSVBE : KLHBL           CGMAFTNX        KMOAWMHJAOYVIN 
IBIJQUBCM       : KLJNYAYCCTSKRRN KPPLVEECUPDQV   FAIP            VAGAUMTDTKUDXRH KLCJPHYUCYERP   DWPTN           SRLH           
GVRRDTY         : DXQGPMVRWFU     GBAKT           HLICDXFSDSWX   
VUMJEBWI        : KVBTRJNLLILIVS  JAQHWUFE        CFWKC           FQFM           
UJAARDKEVFHBSNJ : TIXELMCGICDKCRV LGUAXUVYIAN     BFHDHJUROYJEOEY GEKUYHUKPGUQWE 
FCTADGVATHGW    : NWJAOHPBGLE     QQWMQFL         SLXOTJPGPIDYJ  
OSCAV           : OCTS            PHBIXHCHNVCVM   FPAXMERRAOSSYIC GMDAVFRNXEMFX  
TBOXA           : DWKAQI         
IBNVKECOBCR     : FQDFO          
ATDKACRQXVQTB   : GEIWMFKWKBOWVAH GTDK            IXXKDHKHSCLJJ  
WRLWMTXCQLJUAK  : LRKDNRRTNXNEMD  FQABYRFHGI      YSNY           
UTBQALTCFKAEEVF : YJJNPILPCQEJIK  NCOVRFGUVWJL    FXYJUJV        
VWDSMATOSFXPHK  : SEFRS           KRINQKCTPHIY    RLOHTIKN        YKLWOYE        
EFPVFEPJ        : LTAOJ           AMJYIWP         KPIDLYUPHDQOBO  PEJOAF          KQNBL           HWHOJHXB       
CMNGIU          : TBCKK           NQERXTYKRSGE    XNVPKQISND      TDKLPULIRGJEDW  AMKLOW          FPMF           
GUGAHGVXBBYQKJ  : MWDEMRCDMQP     SGJPVGUKWXRNX   BRVJJMPHDMUQ    GWFOWDWKIR      PAYXVNRCI       SGKWIWAI       
POWNVBFGNHSBQB  : MFOWOHBQF       WBLTWCANHLTC    ETUSJBVCQFOOGDU FNEOJD         
QKTWKDDGBG      : EGSGHU          CXLXPCANIMSBN   WVUEYAJALAML    CFWKC           SUQAIQCBDHQ     NEBPQFCCWNL    
CWVMCLDCBADG    : SQIAPAXJKMKRUNJ FOFDYKCU        VHMDSFR         MVYWXDY         WCWTPGABOFKKGX 
QOYUF           : SUGXGW          PEVCBYODQRFYTTC JYFCCPVIO       ASRJGSON        RQGFABXFR       PGLTVPJ        
VXMRV           : SUTSDNUTOJJHKM  KLHBL          
UBFXI           : EGPKJGVKETTOYH  MXUBHX          UNYOKTGU        BOCR            MKKLNBWADYG     IBIEIYWN       
BFNNKBSMDSRLY   : NAGXXWWNMTQDOXV VLRMXMAHHMYTNL  LMDONPFW        RKDSUKYWRLHBR   FTRQQKHFHFPS    URBTFXMSAKSANY  JDKCOB         
AXGHBCI         : PJDXEYF         IBYNYIF         UCUPLTFQXWT     NLLI            VWGLQRJGDLA    
TENQFUO         : VVKP            EEIOBOVOYFKGWVK SUSLATUUVYXX    KUBJYQDCGYM     JJWUJGWNHJ      JHOPOQAIDWFNV  
MRVCHIDBWITO    : QSEXTMXE        HYJQANMYJEAUNIS JUMCVUBTC       DVMWPAUD       
TAWTIHUKP       : RNJUCDEM        YGXTCQOKO       HRMLNYCG        AMOWMMV         WTTBQDCCHMDH    JNAHKAEDAGH    
GTBWBXORMGPOO   : MPJH            LTUQAPOBPTOB    USISYSJSYJV     GMJJO           FPJHMP         
UPWFLNA         : UCXWBVI         IWHHGOIDQYWUR   MIGGWIFWYMGINPO
QACYHYMYKSUNS   : TTHOEE          QOEGYH          DJNTWMEXOB      QBGVSVCBQT     
OHRBP           : RBVAISVUUBYQPTY FTFLSNEJKFP     ONKUEDOJEMB     UJSQX          
SGJPVGUKWXRNX   : GUGAHGVXBBYQKJ  OLEJJMGJATDTPBW GOXECEMEM      
MHTYGGUDWNBL    : SBIMGEVJEPDRUDH UUAG           
TOODHVNWTVUESS  : RWKWNKSSLFOJNUS FWYYNOLTUKBN    JYOLI           FBDTTT          KGXITFTLBR      XAEHJCPUGABWIX 
IQQVXMWGTRLQHMC : NQHYD          
ISVMBRCALXUS    : YVRTKWFRFRAGCN  GBRJGSEPQBMG    OXUJND         
PPCGIAGVXO      : NCHF            UUFFSSNJN      
PAIAPMGXFCMIVQ  : GTDIVDIQTGXBO   KVVIIPCQUJS     TFTLGPPXYVBNO   URGAXUR        
KPIDLYUPHDQOBO  : EFPVFEPJ        XFKOUXDBIAS     PIGDOQF         RADPVMTXEAIJENC
SGGBIXPPXV      : PILX            EGSGHU          MAXHLHUDJHJPX  
LGSCTDTDGHEB    : QJIVBVQYDQ      SERRRI          NRPGCHAPKNUXU   YKMI           
LGQAIFGBNOFWOU  : MSKAAD          MFTOCFKNA       MJNIXOQTRXS     AWSANHDR       
MSKAAD          : XVNJTGB         LGQAIFGBNOFWOU  UEOVDXXHGHTKEUS BPMMVLYVALY    
TGBYMJ          : RPNVCNAYNLHQIKL MHYSXBGF        SUSLATUUVYXX    JWLWJL          PHJDTSC         FPAUUYCVSKRII  
PJPWARFHAIWONT  : JHETWSGTEMTJH   FVFQG           PUXRKXK         CDBDFMXTRWRU    MBVTOXP        
JKSEV           : HJTJXQRTCOSL    MAXHLHUDJHJPX  
EYXBGCCULGL     : RASODSS        
XKYPPGQAFHOANAM : UXIRIADHBHDS    BKBBWRRQBUDW    XUHGREGLTAHYM   DDETVTESQTNAV   JEAYVIMP       
EIBL            : NAGXXWWNMTQDOXV PXGAPLRSSBFAG   CMPUKHWNPX      DHHHUTBWUDT     NWYYKSANKVOYLO  WURIVEDXA      
COQEQNRWBQ      : EQGVMBUTVNITPX  HUALKQSTV       PAYXVNRCI       FJLJM          
LPNDXEEDLS      : XHBXLPJW        COBBHGBNHUNT   
BSSJY           : FFUCAHLB        ASNODCCVUQGT    EIPJHLMOXC     
NKNPYE          : UJRK            LLBMXQBIYCG     OJGFJNNVDKIEXTJ
QUPPVINKXBNXFRD : ECQUK           XMRIYQQ         XBJJIKTPQUTIK   BQIFCPNNRTMKI  
MJWHEGHHVTVNV   : PLRKVTPB        FMBYVIGLF       MHYDMBTHYMPTUS 
LMWBE           : PJYVGIY         WVXRQAXQPNQLJ   QNOURIKGCUG     DYXPRXLS        WJLCSSAD        LUAKMQUUCB     
JRGJUTHCOLXDWUN : PGQU            WKVHBVTYHWMST   VDGQFUC        
DWKAQI          : QOEDSCCBIFW     TBOXA           PJDXEYF         XTTP            EXDQSVIWHLUKVQ  TADCECKSKVL    
MLCBKDIIPCOB    : OLMBJGAPENL     AOFP            NOCBPUXSGSGDS  
LLACWXFVUS      : PENFGYWKYY      FTSVDGYUF       FSPOJRCONTYRKSR
YPJBJUQXGS      : CFSBW           FDTTVQWRTYGFDQ  ROVUKVJWMYVF   
SYKCQMSR        : AWPFO           XTTP            SERPRL         
EDPGCP          : EGPKJGVKETTOYH  FOFDYKCU        HUALKQSTV       SVNCQ           JXSYUFHUGEUKS   GPWJHJCMLKQW   
XLJYMCLN        : INTRPLPOTHYUMGX UMNHJIIMXPK     WFLSGANVTV     
GGLOCN          : WHFNWUHURHUYML  QQQGLWXYHUE     TEQLAGAUTTUOEW 
BALRNFL         : RFBJUBVW        ABDSCLS         IRMSUKCLGBLVWGM TJBPRL         
LPRURIJSV       : JAKEMSWNNXED    KQEDNF          HVHPNDGEI       SPARUDPTMOT    
RIUFX           : TBDBIWGSWIBB   
LEUCGIMJJ       : QBUNIYWFNHC     UCUPLTFQXWT     DWPTN           PMLUEN         
DYFPDTFV        : BXSEU           DJNTWMEXOB      WBGJUDGSLQQW   
YGXTCQOKO       : TAWTIHUKP       TJBPRL         
KWGORIXDUHM     : FOOENC          VROXGVONA       RWKWNKSSLFOJNUS MWNQJPBT        ORVFQIRMEKLTB   QBGVSVCBQT     
LNDDQ           : WRLMXVMKQYQWU   YMYNHYVGJ       YROWQHL         CJYUQPAFTCDYAIO
KOLJ            : UQNW            EPHD            RUHPCXLLTI      YTOXIVDFWTHWVE  LLMK           
JEYDULTOVQW     : CQALJQVWLKMUN  
LILOFSBBGQ      : FESUMUNC        ANTGEMSDS       BJECQYWLECHWS  
JHETWSGTEMTJH   : PJPWARFHAIWONT  JTSDK           FWDHIFGYQMRN    NYPHVBACLAMJCWS
DXCUVPGEDW      : THEANY          IUKPKBKY        QLSQCVSF        QIXUEBPTSJ      MRCTLXATBJ      VWSBIXQMNLGMUY  IGKH           
XANFQUQ         : VMPGRVPDVPFMC   QSRPVDBKCYRQN   KLHBL           JUTTLHRLXP      GWVBTAPBDQBMVXH NWRC           
BNWVTTBINM      : YVEETDORVTT     DOILWHJUNMW     UEOVDXXHGHTKEUS
UQNW            : KOLJ            EPHD            SHPKXHJLHPVRO  
LOVPRSCQSRXJOQ  : DEQPQYHCTH     
PEJOAF          : EFPVFEPJ        KLWBKU          HPDTERYLJNAWIPC
ISEANUQNICEEU   : TKTRFYYHU       JCCVOMLJECN     PQAMIGFTMTG    
YYRRQPDFGPW     : GVFLSICEUNAMMV  CEYMOQUQRRYOL   KBKOADOWBSHNKE  TADCECKSKVL    
BLNGDYBKBO      : BHTWO           RQNOCQTGWR      JMDOYYCUHWDKWI  LGUAXUVYIAN     MEIAIPD        
REQWJW          : RWMGIADAROR    
IWSAQLRUQAMPNP  : GBRJGSEPQBMG    EHOBCC          WQRMLUBBHBEXC  
EVJFYTGNABUSAE  : OGOYJNAUDJ      BGPVIV          XLKOUG          AEVO            WJXVI          
VOMOQGCIDUKPK   : VWQELXVHDEJLY   YDUPCWQPXS      PVMTVJGUN      
FOFDYKCU        : CWVMCLDCBADG    EDPGCP          EOJMGICEOY      IVFENJRNMIIUSP  VEPCWFMSCYEDE  
RUTMP           : GHFU            XHBXLPJW        XSKQIJVLFJ     
SGRH            : ABBYMKYFAHTTT   NMUKOJDTXIAYHMA BOAFEUHCFVA    
IABKK           : SOJUIXJJP       WECRTAT         WAFAWNWMVWSTNDC OEXEYO          YKLWOYE        
FVVSWDJEGKQKGJF : QOEGYH          TSVKYICTGOY     HPOPHRWXRSX    
GRTCNAU         : UURAP           TTAKQOSGAMTURF  KVMALGWGTVNRTOX
WDXYQIFX        : MWDEMRCDMQP     CDII            EOTNOUAO        UTCKVDFXBROIXE 
CQFHBLOLCBR     : GDFK           
GXWBRBO         : FDCHFNUYMHVOE   WLXDIKYVVW     
XLQE            : ROVDQRWM        PWDTMVJRHIOIC   QIXUEBPTSJ     
RUWXSF          : PJQSAQLWBFEBTA  CSEXSKPR        INYHHSIA       
KLJNYAYCCTSKRRN : TPYBDNAALBSCB   IBIJQUBCM       NLVWAJUUMP      GGXHGLGATAGVRVR
SEFRS           : VWDSMATOSFXPHK  SQDXJUADBCLQN   DWBHUEHMWQWA    CCNCUY         
VEOQDOLJQVWCLV  : FDCHFNUYMHVOE   CKQLPJJIYCOAMU  MFTOCFKNA       FFUCAHLB        LCFVE          
NAHJSTD         : SDWVR           GQEC            NLUSCWWOGC     
IOGMTXFRVM      : TKTRFYYHU       MHYSXBGF        HHGX            HBVBRONBAFUJDNM
MPYAYPYXUKUXXUH : SUQAIQCBDHQ     QWRWLDTK       
QBMDJBJW        : MOLNQ           VWIIAD          OJGFJNNVDKIEXTJ PQXXKWQGRE     
HERFQCTHCU      : YJWIOC          EKDHURFXIDMKPOT YMYNHYVGJ       EJFUFLN         MHSGHKGUICP    
TTHOEE          : VPTYXVF         QACYHYMYKSUNS   YXNSMRPMXP      POPHHY          NTHGRDD         JXKID          
FYTORVCVHDF     : AQWFRWXLV       RRJEUAYGIJ     
DPLU            : QVASEWAUL       QKRP            MSIXCJEDEUCET  
EWPNYMWVGGK     : YLQEXOQEGXUDW   RLOHTIKN        YUHDHXFLNCMGJ   OCRSYLBYOJDPWDS XTXJIADIKA      TYWLTUKONO      FLVEFCPKWJ     
KARLTJGRLC      : SWTDOSUY        NAGXXWWNMTQDOXV CBFT            UJSQX           DQLNELYHXEC    
QJIVBVQYDQ      : DXBJA           LGSCTDTDGHEB    UDTIPCGOAO      SMHCHHYUJHNEBLK OOHWUMT        
QRBPNJXYVKBQY   : OHHPLM          IDVHOUVTLCTA    JXJM            UIRCAGKQTRTMVT  WGPSOHCAETJCPY  YUQURHUHAUCSS   JBQYVUATYXKLNP 
AFPNHTGSEDUBV   : SXDN           
GOKWJNPWWNXUBY  : LLMK            BTSJXUGNIB     
AWPFO           : SYKCQMSR        LMHHO           TMOLVPDTWCG     XAGAAMKLJ      
OKMHORERP       : VVKP            WAFDNAEDJC      ULLPFCIVGN      YYTAEKRVUFKAMXC RUICIATJXKE    
XFIXQXN         : JXJM            IEILQRBNIUYEG   EAVQ           
UDQSERGEOW      : QITUQEDGNM      LUKG            TFOWFRDIRKR    
FCAPOKHIOY      : UUFTLMNKKYSJXLL YSXIHAKQMRRNLOT TRVAWLPPFHUILP  OKVE           
NAGXXWWNMTQDOXV : AAIG            BFNNKBSMDSRLY   EIBL            KARLTJGRLC      FJJAYUUKUKIY    NFMQLFEFXCOY    QSDHMEDWF      
EMUQU           : NJQBRDQPUY      HLVMEOBOCUQI    JMDOYYCUHWDKWI  WBYHEJROCVAO    OKBRUCO         UUCS           
SMODTYUV        : PGQU            KMOAWMHJAOYVIN  UQDOQBGICS      VYRGFADQF       MHDBOKOC       
KVGITDHJSE      : BXAGTOSIY       BWTNPIHIYSYS    UNIQBNEGCQ      GQFYIRTXALPT    FWDHIFGYQMRN    QOKYCQP        
XSAVQFJNXGL     : ROKDCAVM        EOJMGICEOY      PMGVCML         EEFHYUNLT      
UCWPBRNCCJ      : PEIOXBCJJLM     ABXJAIMKPLOW    NRPGCHAPKNUXU  
MFOWOHBQF       : POWNVBFGNHSBQB  VVSQI           FSWT            VQRU            SBIMGEVJEPDRUDH
RCPYNDWV        : KVLFGMXPSI      HWSB            UNRIYDM         JPBA           
PQUMIWGVBIFJ    : DPRYIRALBV      LFMHUHYAC       MNRHCXYVFUIEFO 
MXUBHX          : RTCWSRCSMPGTJ   JIPAAFPO        HMDXJPLCXOO     UBFXI           XCVRXXC         QXKNX           FQAPJBOB        GDFK           
PTKT            : VJRHUGGHVFUT    PDMXLIYMEDHLINL FMBYVIGLF       LBUEIJFN       
LHPKFIA         : GBNMBWANHTGCPR 
EPHD            : OIAUQIHYUS      QEADNWRHPCT     KOLJ            UQNW            JLNHWOXXMHC     DKAJBYT        
DEHLPF          : RHTRKPDCDDXFICC ATJDKUG         BPENDU          MCDJQFCSPIB    
QCAXAUNVHHISQ   : LAQNIPIYM       UTPMOTI         FTBP            WLXOKBGXVQYPQI 
DXIDUMSEPRHVYU  : UDPBUMDTPGQ     LDGTQVGJTETLR   AREOIFYNHRM    
GTDIVDIQTGXBO   : PAIAPMGXFCMIVQ  TKUQRBKBXDKV   
UOVSXBPKWTD     : RNYBXXEJTQYEOO  QBJCW           ITGQUVDY        ERPQ           
EYPYN           : CBXEVOKPCPHOC   VWFHUMSPCGM     CIMHYFBGYA      YERA           
USISYSJSYJV     : GTBWBXORMGPOO   GHWCEILBXJFFVV  EGPSPKSPHOPR    FMMCCUFJTI      WHXDRRQVOJKI   
CQDAMBCCOBYRRD  : YUUCIDWBGBXHHUN
HCJHAEPS        : TIBYCNOIJAS    
IDVHOUVTLCTA    : QRBPNJXYVKBQY   PSKXOLIS       
XDTBCNSF        : LJLEA           VVTIFXJUMOEUGC  RLWF           
AJUJJYY         : GEIGJYQAOKYWJ   BRQRXYGYBKIMWX 
FHID            : LDCH            MYVRVQEJWDQN    THKYECRD       
YXNSMRPMXP      : LYNTHMFBNYDBBO  RKUIAKVKMYV     TTHOEE          XYYTMTL         MCDJQFCSPIB    
RRTIKBR         : FSXBUOFYJHKWJ   IAUR            WBNLYRJG       
NOWWNYCSGMWAM   : NBUXFJFBMIFFHMQ LAHIMNGH        HFSTQYG         HFXEIQWJBY      TQXAPVAXEADTH  
OHJIYW          : PILX            PHSJBQASUIRE    QOAPLHL         CMPUKHWNPX      FWNAEHOJ        WLVKDDVIMXFWQ   KMUBS          
POBJJJTMDJATJ   : OHQWGPWUVVA     PEIOXBCJJLM     EAUTQDNF        BPENDU         
HIEDQRCRGYINJQ  : CMWYWIIMROVPEB  VATRC           PHJDTSC         DHNCTCR         QAML            HYTXIOTVCIRFR  
IAFWBOIMKVRWVLG : HLGS            UTCKVDFXBROIXE  XTHNCWMYSA     
SQDXJUADBCLQN   : RCCJLL          SEFRS           QWOTVPNU        HSBBHTVRXJBAX   EIGYSGPGQLXDM  
GVFLSICEUNAMMV  : AMJYIWP         YYRRQPDFGPW     SOBKSUICHUUQAJ  IJSTWW         
SUSLATUUVYXX    : TENQFUO         TGBYMJ          IUKPKBKY        CWDGXRTCDD      JMDOYYCUHWDKWI  DAPYVSJGEOK    
QNRXJYLFHQ      : OSMMGBQNJMUXO   NQUV            KMTOEGWEFVL     KMUBS           ALUCTXTNTPRQ   
CEJQQHQLEMWEG   : XFPOCX          CSUAU           FFTC           
BCSYDGSQXQDA    : FWVTKABJVWGB    PQFIFHYQOKH     PHJDTSC         NYONQYLBE       XQUXXQPTJXTE   
IHUTKBFBTOU     : YGFFDRCEFQU     WAWKNCILIWH    
THEANY          : DXCUVPGEDW      IVRGFWVRO       THMYAGDMHMOD   
RTDUAXOB        : WJJWSNI         YKLWOYE        
RBVAISVUUBYQPTY : NNHWUHQYXP      OHRBP           XNQCWDO        
BFMQ            : SWETP           ANTGEMSDS      
QIBVGBUU        : REVMRXXJRCJICET SSHQ            MFHC            YORJEVCBG       HRMLNYCG        TDKLPULIRGJEDW  PHJDTSC        
LMHHO           : AWPFO           JLNHWOXXMHC     TFTLGPPXYVBNO   GETEXIACJSSFPDB
BKNXLOO         : XTJMDTWN        UJSQX           XFVRJHA         NOCBPUXSGSGDS   BHVN            SMVVWXBEONQO   
KPPLVEECUPDQV   : IBIJQUBCM       UUCGBLPDNNXXKK  NVYJUTYBNFXNTUI BNCSJXYVXNT    
LSNXFVFVOI      : MQYNMMFVXDMS    MPJH            RKGO           
EITVAYGPOUNSYQN : RYCS            RATF            HCKGHLAEWPNQ   
VHMDSFR         : CWVMCLDCBADG    SEJBWOQQPFWKBYS TDDIJO         
MPYIGJQMS       : FGAXW           FSVBVPMJNMYE    NBOXWFCUOHWVBM  PEFGKQSPSDMQOR  QGRURJLJXQIRTM 
IUKPKBKY        : DXCUVPGEDW      SUSLATUUVYXX    FELD            UUFFSSNJN      
LRKDNRRTNXNEMD  : WRLWMTXCQLJUAK  YLBUPMNA        OMPNW           SCTNXSK         EIPJHLMOXC     
VLRMXMAHHMYTNL  : QMCU            BFNNKBSMDSRLY   MESRBXDWO      
KWMXCD          : FKVKGPHNWWKR    SEJBWOQQPFWKBYS OSPCYGFNFCW     KXJLPTIBLLE    
UWFUKKJ         : ETTBXHTSTBSK    QKHILUL         QIGDNSL        
RFBJUBVW        : SSHQ            USGMGRVDICI     BALRNFL         JHOPOQAIDWFNV  
FJJAYUUKUKIY    : NAGXXWWNMTQDOXV KXONLBJLGL      LTJGISGL       
ATMGQYSBQMITY   : RIHUOSAYO       URHLRUHHHAR     FESUMUNC        HTVGNGMUF       GLNQ            XCCCPICLQHJGL   UAQCVQXUVEKM   
UUCGBLPDNNXXKK  : KPPLVEECUPDQV   MPRYQRSWTWIYT   MUQQBDTCPOO     OJJPHANVSIMAI  
JAKEMSWNNXED    : LMDTISHUXVGBBDY LPRURIJSV       PVMTVJGUN       COYIYPQVHIWWP   DMAGBJ         
XCOTWRCAFT      : OMTTRTPEXR      QITUQEDGNM      RJJXXSSFKYGCH   QFTKJW          LWSNCX          CIMHYFBGYA     
SHESRQBC        : HBMQDFI         XTXJIADIKA     
OIGJFUXGYBRAF   : AHUBG           WVOIUTQOCF     
VEAXFGRKY       : MBNVQPVYH       GJOQKRHMGEF     MFUKUGEFEK      IMXJOOVXDM     
QUVKVXC         : JEGTMNP         JYGBS           BKWMQV         
IKWQFWYHAQ      : JCCVOMLJECN     ARQBQLFC        KMTOEGWEFVL    
FYFJAFQGYEHBU   : SHTNAGT         WHFNWUHURHUYML  ORHYWISWJUPJY   OEXEYO          ERPQ           
XHBXLPJW        : LPNDXEEDLS      RUTMP           KRINQKCTPHIY    XWAQRD          UYYLLQCDDWHTN   FCKCKELLGHOJJYI
AELBNLRWQQEDQJT : LHLKWKUXACNDKYH ONDXCVHOHK      PQXXKWQGRE     
JXJM            : QRBPNJXYVKBQY   XFIXQXN         PTSQWXJ         APMWXIBSUANCQ   ANVWCQMEY       SOXDO          
LMDONPFW        : BFNNKBSMDSRLY   BHJL           
TYSGAHTTGNK     : LWHVHWJAOB      BQPL            VXWKH           YUUCIDWBGBXHHUN NOFMKMEJY      
QEWMFILOXH      : HYYQAAXCXFKR    PQAMIGFTMTG    
KMTXEBWSVXMEX   : RIHUOSAYO       UMNHJIIMXPK     NCSWQRREUWWCB   DORDQ          
AREN            : EHKQVMS         WFLSGANVTV      YMRKNBWNRJ     
RGLPTSA         : QHDDQRXVHCQVFKM WWIGNJK        
KXONLBJLGL      : DAQVSPYQPTQG    SIXMJUQWIJIDG   FJJAYUUKUKIY    PLKSXSYFDNXDE   MTMULDSVFCRL    HEBLYDHH       
YJJNPILPCQEJIK  : QLMMUOAIUBHKAE  HMDXJPLCXOO     UTBQALTCFKAEEVF BDTAPVXE        RSNGOOLP        GPUTBR         
AGQDLB          : NJKWWLTSIX      JQAPP           IDWSHOCAIKPCUM  WRTSO           OIKJKAXPG       TSLSXIUWN      
CQOEABML        : GPMNY           MFQGAI         
NWVEMG          : VIOOK           MBNVQPVYH       GIEW           
DJIJUTTQVDJYOKD : CVILGJG         VWFHUMSPCGM     IJOQWMWIQHB     SACXVJIPC       EKNRYTBXRIUSY  
BRXBUM          : AKSOYE          VATRC           HORACUDOTSHQVH 
JCMGGA          : FDYHANXKWBDTHSX
YFXHOTD         : KSYAHJBCJC      BRVJJMPHDMUQ    HLVMEOBOCUQI   
MANVYDIEWJYWKTL : SACXVJIPC       FSXMC          
GNPMURD         : USGMGRVDICI     RYUCMNYQ        DLCSHOAUFE      FKMMPV         
WCDLX           : ESUHVDYCUDOH    QOEGYH          VUEGMJE         GJICJVYNDPFFTC  KRFLGPVFXM      SERPRL         
VMJKKKPSPOEOLO  : REVMRXXJRCJICET QNOURIKGCUG     UCDSSRKAYLUIU   YJBRWVDGHUYS    XGEHVABFESIBIO  GTIOL           NWYYKSANKVOYLO  EQRXVRBL       
WTSMJHHDLFANJNN : JAJSNLVCH       SNTYFTATUPNSDQY XHUIDXYOGJL     VLFIDAFXPNX    
JCCVOMLJECN     : ROBTXUNRSI      ISEANUQNICEEU   IKWQFWYHAQ      RJJXXSSFKYGCH   TWCV            RADYYUB        
PEIOXBCJJLM     : QOEDSCCBIFW     YLCJUGXSGUDOJUF UCWPBRNCCJ      POBJJJTMDJATJ   IMSYM           FQDFO           ONTWWCHOUDUED  
ROKDCAVM        : WMDC            XSAVQFJNXGL     DDEV           
AKSOYE          : BHEPSRSFA       BRXBUM          BYFPJOP         WVYLVFOSDKUET   PEUVETTXHLEPGT 
BRQRXYGYBKIMWX  : AJUJJYY         ROVDQRWM        CPSUMI          CSEXSKPR        QMJWICQMV      
OMTTRTPEXR      : XCOTWRCAFT      OGPSFTKWH       FHASEBK         QIODJQLNEUAUYP  AWYEMEDAXC      HTEABNGGFPEPTK 
SGNWCRQT        : VQDGLD          SWQJTOUYRARSNK  UWTSFLFJC       BFFDOGAH        MUQQBDTCPOO    
QSRPVDBKCYRQN   : XANFQUQ         GRASFU          YOYMBXDM        FCAOPFUJVTQHNU 
MFHC            : IPABGDFQH       QIBVGBUU        XBAFMXSQ        ONDXCVHOHK     
HVDA            : NNRVRWTNINRUOF  YWWOHAIHK       SHWPLXLRMOTIV   CVLNLPC        
SYHKRB          : CVLVHIWMVYGP    AMOWMMV         RRTHJITJGQOIVUM YNXJGCRV       
JVOYUTAFVBAO    : IWPQSTDLI       NNRVRWTNINRUOF  TTPYNQASSVV    
NBUXFJFBMIFFHMQ : XEXDVRY         AOMWCQUQ        NOWWNYCSGMWAM   EKEQF           OEPAHSFQORFXL   ETJLSCEEELAKY   MXFHWTGKWLGFY  
PMJODKJW        : QWKLWWPTLNGME   JGAKJ           KACAMXQLLHB     RMEJEXUL       
QSMQJEHKC       : KXYTEGWVIBD     SERRRI          NSIIJQ          TDXXYIGPBYDWSX 
PLKSXSYFDNXDE   : TGQQIBLJXYGA    KXONLBJLGL      OSPCYGFNFCW     DVFBBFIBT       SLXOTJPGPIDYJ  
OSQYEQ          : FTFLSNEJKFP     MKKLNBWADYG    
WLCQVIXG        : UUFFSSNJN      
DYXPRXLS        : LMWBE           HBMQDFI         MAVECCWBMKALBUX CPUVXEB         OKVE           
OHCTNPIIJJOAY   : QNOURIKGCUG     BJFOALESY       KPPGSLVTIGMWX   CITKNIVPAXDCPYU QNUNCHJVW       KIYXVAEMNYCR    YERA           
LDCH            : FHID            ASBIRNCOESGDNP 
AQWFRWXLV       : FYTORVCVHDF     VEXX            DHPNONUMC       HYPX            RPTNKN          EDHHJTRIAYEQE   SXWJJDOSTFR    
FAXOETCWC       : MWDEMRCDMQP     CUELV           RUFLYFG         BQJNXKQRDOSFUIF EAVQ            XRPJPDKASHELSE 
GNBGOMRRP       : FGAXW           AQGICUYMMIBSNH  TJCHBRBTWFKGY   FWNAEHOJ        JNAHKAEDAGH    
ERUDAMA         : ACCKL           XYYTMTL        
AVJFXH          : WAFDNAEDJC      VOYRAT          OTBUIGE        
FBACFMIUNQKBKCS : YLBUPMNA        BNEHEXSJXD      LRHICHCWHQBHGK 
GMJJO           : GTBWBXORMGPOO   KHNNMVLRH       ILXEMUROFPEFCG 
MMYKVGJFDQID    : VVKP            RPIOSDOGFCHT    YYNNBPC        
PSDLGVXJGA      : JHMIAPMXOKO     KLHBL           BCLANSPTWAT     MJUMGUS         NRXPQMJCLNYG    NAVACWPJ        GHUPPBPCN      
VJRHUGGHVFUT    : PTKT            FPAXMERRAOSSYIC DNIUMRLFFNWHUU  RYKBMSWWUMP    
ECQUK           : QUPPVINKXBNXFRD NNWFAYAMRCPPSFR HVHPNDGEI      
PDPUQXQ         : LBUEIJFN        FFUBSOWKM       MOKNF          
IYQMWCEFXNNHJ   : SROQKDYKVOJY    CEPUVHWM        JMMFKDNL        FMMD            NRFM           
CDII            : WDXYQIFX        XUHGREGLTAHYM   XWVIVIIXI      
CFSBW           : YPJBJUQXGS      BCLANSPTWAT    
SROQKDYKVOJY    : XEXDVRY         IYQMWCEFXNNHJ   HJHR            YVDRUMJS        WLXOKBGXVQYPQI 
QWIE            : OFJW            GQTXBHPMMLETVG  FDTTVQWRTYGFDQ  EOHR            QQWMQFL         HCKGHLAEWPNQ   
TBLA            : BUMRRYYWGL      OGTSKFLDPQNK    YSAHPV         
THOCCPYAITOB    : LUKG            BTOIMNM         KOOLAETTEXSDGB  BPLVSAYLRU     
TBQQRBPMTOX     : TCQABJFAWSDWG   INTRPLPOTHYUMGX FELPICOECVMM    OQAHPAS         XNQCWDO         CSYWYLLDR      
WTCITOFCFJEWIHF : UNYOKTGU       
VJJSMCJEFB      : GWVBTAPBDQBMVXH IJOQWMWIQHB    
ARQBQLFC        : IKWQFWYHAQ      QSEXTMXE        TJCHBRBTWFKGY   GBPKX           WURIVEDXA      
WJLCSSAD        : LMWBE           PXGAPLRSSBFAG   PMEFBQEATBSTH   WUBBMRHPNARVUVY CNGOTCSJGQQ     MFCNCNHGCUPXCPL
HIVQRQDTAJADDCW : LPOIDCVARR      GRVFQJRVBAFI   
FOHKSRHCDKUV    : BHEPSRSFA       XNVPKQISND      BGBCPLLRSRQXPE  ELXVSRDBIDUFE   GFVOCBAJ       
AVVIUNALSWO     : BNHVXJCHFTON    DQLNELYHXEC     TUAKXNFWFFEJ   
YTIDREIIOS      : WVXRQAXQPNQLJ   MFGRPY          ITGQUVDY       
GDFJPCGCCEX     : QEADNWRHPCT     QOEGYH          BVUSUHG         YDBVRNESWYXQMB  HFJKA          
YNNN            : JDOMCQX         LTTRYXXOW      
MCONXWQPBYA     : QNOURIKGCUG     GBRJGSEPQBMG    CHYYHC          VAGAUMTDTKUDXRH FQFM           
UDXXII          : AOFP            FTRQQKHFHFPS    VWJBRQKACSTWUR  TCOQ            OKTEGTEIDU     
MQRPURBWIQKRE   : JWKGHW          JYFCCPVIO      
GRMFLFGMHY      : DPRYIRALBV      RCCJLL          CBIXIKRV        RCEXBFLMG       YPMCJIP         NMJDDFGTLMJRF   WVSV            KFESSEAQBJCKPBH
GRMFLFGMHY      : AUNYKQAWOMB    
LWHVHWJAOB      : DJQKDRHUKQKQGP  QYMNRABJIXE     TYSGAHTTGNK     LKUV            WUIYDKTPGYJSUO  GTFRQFDIGVXXEB  FPAXMERRAOSSYIC BPCFTHHTQC     
JCURSH          : ORHYWISWJUPJY   GFWQ           
YVRTKWFRFRAGCN  : ISVMBRCALXUS    UAQCVQXUVEKM    YOFCON         
JLNHWOXXMHC     : EPHD            LMHHO           FWDHIFGYQMRN    SFTFGDQ         SLXOTJPGPIDYJ  
BXQKWOEQYB      : TIBYCNOIJAS     JCOASWTKDR      YDBVRNESWYXQMB  OCRSYLBYOJDPWDS
TJQVPSLVC       : DKTTOIFERNGVEFY QHQRIANDV       INYHHSIA       
KLWBKU          : CYHKHBBQVFVAREC PEJOAF          XGEHVABFESIBIO  KDNFBUKGQDUBON  FFPRF           DKAJBYT        
TAYVXR          : ESUHVDYCUDOH    IPABGDFQH       FSVBVPMJNMYE    XJBVJ           NRXPQMJCLNYG    FCAOPFUJVTQHNU  MEIAIPD        
WGNOHQMBCDYSXKO : VUUMLOM         HPOPHRWXRSX    
KBOH            : LJLEA           KIYXVAEMNYCR    XCNFNI          KAYFHOCTCBAI   
BEVXEUTC        : TSVKYICTGOY     XSFB           
EAUTQDNF        : POBJJJTMDJATJ   YIDEJLV         QEAELET         EKNRYTBXRIUSY   WTLJMFCG       
PLGKJQAM        : ACCKL           ELIVQ           LFTYGH         
DEKIFPGDVC      : BRISOUEK       
BQED            : OIBWVJICNEPYE   UHQDUEHE        ORVFQIRMEKLTB  
ATPNBVGMCQYV    : CLGIHYLXNSFUNGB OIFTVPMXYDEKTS  XAEHJCPUGABWIX  KARSANDANHGT   
NYWRK           : XGFHILJH        ABBYMKYFAHTTT   CWMRKOTOYIR     SXDN            RSNGOOLP       
AANDXRFYL       : YLQEXOQEGXUDW   FKDBJ           GPWJHJCMLKQW    SFTFGDQ         YERA           
CXLXPCANIMSBN   : QKTWKDDGBG      DJNTWMEXOB      QRAGEJOGUP     
UCNTTA          : DUCFEHSDEWATQNK KDNFBUKGQDUBON  XDYWROLNAQXIWG  ILXEMUROFPEFCG 
TCQABJFAWSDWG   : LAQNIPIYM       TBQQRBPMTOX     QHDDQRXVHCQVFKM BGPVIV          GWJP            LFTYGH         
MIDCSQ          : SIXMJUQWIJIDG   LIPKYCTU       
UGLRICLDCMYFF   : PDMXLIYMEDHLINL WKDFMGKFIXBS    KBEON          
IQGINYNKG       : QITUQEDGNM      AEXCAUWNU       BCLANSPTWAT     KHBTVBCTGTNWPC  NTUQEMJ         FRRIERJGJ      
YQUCKNYHUNYDRKI : UUAG           
YIDEJLV         : EAUTQDNF        IVRGFWVRO       JXSYUFHUGEUKS   YQHEXQMVKPSFT  
UJRK            : XVNJTGB         NKNPYE          PWOG            QSWIUFQIDUQGMBF
XCVRXXC         : OHQWGPWUVVA     VIOOK           MXUBHX          NLVWAJUUMP      YMYNHYVGJ      
ALIPKMHWUDVFHA  : IUEGM           SDQJGIWDMXVKR  
UXIRIADHBHDS    : JWACFMPHNXHACO  XKYPPGQAFHOANAM EQGPRIPSHUH     YFPK            DBREDRYNQ      
EWTEIC          : GTQPOHMO       
UQDR            : YMRKNBWNRJ     
INTRPLPOTHYUMGX : XLJYMCLN        TBQQRBPMTOX     NOKIBV         
JQAPP           : AGQDLB          TUGMWVSF        YRYIELOMAUVWVKA TQWPOIU         SDQJGIWDMXVKR  
TXBR            : VVKP            XWHB            RQNOCQTGWR      WVOIUTQOCF     
RWMGIADAROR     : REQWJW          UNYOKTGU        XCCCPICLQHJGL  
LAHIMNGH        : APYTICAIC       NNHWUHQYXP      NOWWNYCSGMWAM   YWWOHAIHK      
YKPOIM          : JKGLJ           EQRXVRBL        JFMHYVHRXJ     
JEJEEVKM        : HMDXJPLCXOO     DHPNONUMC       BYIYTJBBKS      WHMMNKQAVQRHYI 
POPHHY          : TTHOEE          PPLFNJ          KXJLPTIBLLE     WAGCN          
HGBVWHG         : MIWEJJHFCTB     NWYYKSANKVOYLO 
IQQWYDLLKWP     : EGJCW           SHTNAGT         AOAPS           LVYNDKEGAVT     BUMRRYYWGL      WVOIUTQOCF      EFKIDVVJD      
UCDSSRKAYLUIU   : VMJKKKPSPOEOLO  GIEW            XNQCWDO        
FTFLSNEJKFP     : OHRBP           OSQYEQ          WUBBMRHPNARVUVY
QCUISRLVKGNW    : GTEKDKKVWICADWH SDQJGIWDMXVKR  
PJDXEYF         : RBUQRJPEPDHIDE  AXGHBCI         DWKAQI          CKQLPJJIYCOAMU  QLSQCVSF        UTKECNWQSLU    
EQSRWEEDVE      : LOOOWL          BBXXKNNNOD      YDUEFOAIKMMXULO ITGQUVDY       
XBFSSQOFW       : QAGFEHTSPHRYPI  MRBJQXYRF       SMAMUGANJUIQ    ODYOC          
CHWNKUTJBTP     : SHYE            MTIHFGQSNQ     
OJRTP           : YYQDGBGSTNKS    TNJYQIVS       
PTSQWXJ         : JXJM            KVVIIPCQUJS     JMMFKDNL        BIGHXDOC       
QBUNIYWFNHC     : LEUCGIMJJ       LHNSRJCRBVNDKI  DEQPQYHCTH      THMYAGDMHMOD    OLKYELHDCWHKOT 
SFEICSTT        : BHTWO           JSHFLACK        XJCLLYBFKF      BTOIMNM         LEXQKWROFGW    
JSHFLACK        : SFEICSTT        EAVQ            HEYDONYYYOUPW  
TBMQR           : MWDEMRCDMQP     WUAQG           EWJPDRYFF       GUJL           
QOEGYH          : WPDX            QACYHYMYKSUNS   FVVSWDJEGKQKGJF WCDLX           GDFJPCGCCEX     PIMYINTRJJM    
ROVDQRWM        : USGMGRVDICI     XLQE            BRQRXYGYBKIMWX  TVNQYJRV       
JFPQRRVE        : JXXSJVORBKGPXCH BGBCPLLRSRQXPE  IHJTA           FMMCCUFJTI      EXDQSVIWHLUKVQ 
PHSJBQASUIRE    : OHJIYW          YOYMBXDM        WLWGOXWQRLRGDU  XSFB           
LTYOMQO         : XGJQRHCYCM      LJKCQ           YSAHPV          FTSCAHP        
BAFRQYLOFP      : CYHKHBBQVFVAREC THSLUAP         GRGNVWS         LTTRYXXOW       ULOM           
PJQSAQLWBFEBTA  : RUWXSF          OLEJJMGJATDTPBW FQDFO           PGLTVPJ        
IMSYM           : PEIOXBCJJLM     CCNCUY          PMLUEN         
YUOSVAHCQOTCHM  : BTCJWGMKAEHAB   NCOVRFGUVWJL    AEAKRVMB        RECDV          
XBBB            : KUQLMPHWR       QEXRO           EQGPRIPSHUH     VCPTBSFKBQ      AXVDAFEEKDPOKNT
FDCHFNUYMHVOE   : UUFTLMNKKYSJXLL WUAQG           GXWBRBO         VEOQDOLJQVWCLV  HFSTQYG        
HBMQDFI         : BPDUO           SHESRQBC        DYXPRXLS        ELIVQ           HYJQANMYJEAUNIS
HPLLQMPRX       : JYFCCPVIO       FGXNMLB         ODYOC          
WAFDNAEDJC      : OKMHORERP       AVJFXH          INHQEETDT       GWVSTWFHISD    
OOBPBTUJET      : SWQJTOUYRARSNK  HKAJDLWWCTMQNQ  KOOLAETTEXSDGB  QBGVSVCBQT     
WHFNWUHURHUYML  : GGLOCN          FYFJAFQGYEHBU   CHLIHEIKRWYKIRV PAABUUDSNFM    
SOJUIXJJP       : IABKK           OVWPLD          FKIMNFQINI      BRJV           
FKVKGPHNWWKR    : KWMXCD          XGEHVABFESIBIO  XYFLNCNC       
FLPDLCOMWFVRNV  : TBGPWYYB        ROVOC           OQLUOU          IOIJSLLBVQ     
YLQEXOQEGXUDW   : EWPNYMWVGGK     AANDXRFYL       MOJTPTFUAH     
WELJVQWYFJXKI   : XLUN            SEJBWOQQPFWKBYS KRFLGPVFXM      GBNMBWANHTGCPR  URGAXUR         ILXEMUROFPEFCG 
XEVYSODSEUXMU   : MWDEMRCDMQP    
SSAPYNBUEX      : BHVN            DIKL           
LKUV            : BPDUO           LWHVHWJAOB      DUCFEHSDEWATQNK
NVYJUTYBNFXNTUI : KPPLVEECUPDQV   BHTUCXRB        YPMCJIP         HUYYRKNCJQO     QSPHXIBIO      
PKDOYGMFHKRRHN  : LTUQAPOBPTOB    RUXVSX          RJFI            HORACUDOTSHQVH  OLPOTLOYJSE    
UMNHJIIMXPK     : USGMGRVDICI     XLJYMCLN        KMTXEBWSVXMEX   PQGTJESUH       XXHABFHRGTST    QOODYRBCJ       LYTAV           HTEABNGGFPEPTK 
UMNHJIIMXPK     : JNAHKAEDAGH    
JGVYVGCNHKCN    : NGMNXFC         ETGXPJCLRXBP   
OFJW            : QWIE            HUALKQSTV       QFTKJW          FFTC           
XTJMDTWN        : MPJH            BKNXLOO         KMHRKUA         GUJL           
UDTIPCGOAO      : QJIVBVQYDQ      CEYMOQUQRRYOL   TRVAWLPPFHUILP  TNJYQIVS        KBKESUHXU      
PWDTMVJRHIOIC   : XLQE            MHDUBQCAAVQPMS  APUU            LEXQKWROFGW    
WGWT            : MSIXCJEDEUCET   OTBUIGE        
FQABYRFHGI      : WRLWMTXCQLJUAK  KVKXCLONKI     
BXSEU           : DYFPDTFV        XWOETDOMXYSCDL  DIJMDDBL        IBIEIYWN       
CEYMOQUQRRYOL   : YYRRQPDFGPW     UDTIPCGOAO     
VEXX            : AQWFRWXLV       JUTTLHRLXP      XFKOUXDBIAS     YUUCIDWBGBXHHUN VEINQWDGPCGP   
PDMXLIYMEDHLINL : OIAUQIHYUS      WFBLUTUPNFFQHK  HDKNFPBEIIWM    PTKT            UGLRICLDCMYFF   GRWYLBMTVLBEK   ASYBUJHMRD     
CEPUVHWM        : IYQMWCEFXNNHJ   YQUVJDCERYL     ENWJH          
SIBSGGIM        : BPDUO           JYFCCPVIO       TTAKQOSGAMTURF  UEOVDXXHGHTKEUS OOHWUMT         WGEOLL         
GABHMHKVTUL     : FRGYSVINTEGTHVQ KGXITFTLBR      VBBYWOX        
PPLFNJ          : POPHHY          NWSCLFTIQEECV   RKDOQEFKAQ      QOODYRBCJ      
KVLFGMXPSI      : RCPYNDWV        DFIMFDOAFYJGUT  YKLWOYE        
NQERXTYKRSGE    : VDGLJL          CMNGIU          QSEXTMXE        MNRHCXYVFUIEFO  GFVOCBAJ        WDRE           
VVLEJUUVSHBCVBR : VIOOK           NFMQLFEFXCOY    FSPOJRCONTYRKSR SACXVJIPC      
JVFAAW          : LNWW            CHLIHEIKRWYKIRV GQEC           
TYJMRRSUNO      : GHIXXYME        UNRIYDM        
TBGPWYYB        : FLPDLCOMWFVRNV  WEDIPOEXQVKNUUO EWJPDRYFF       RPIOSDOGFCHT    ADQVSKVYMFJT    GUJL           
WCUO            : YGFOSVN         NLUSCWWOGC      TQXAPVAXEADTH   JUMCVUBTC       KXHTUWULFQIV    XTUEJXVGEGCAHR 
QWOTVPNU        : EPEMMCWOHXMJ    SQDXJUADBCLQN   MOLNQ           OGDUWHFQW       WHHAJ           XYYTMTL         AYREJNBPBSHKBK 
CPSUMI          : BRQRXYGYBKIMWX  QHDDQRXVHCQVFKM YLBUPMNA        NKYR            LBUEIJFN       
UDPBUMDTPGQ     : VQERYV          TIBYCNOIJAS     DXIDUMSEPRHVYU  BTCJWGMKAEHAB   KBEON           XXHABFHRGTST    SHPKXHJLHPVRO   OMVJFHI        
CIHUFXODNDYO    : LKVJRHE         LVYNDKEGAVT     GPCNTVRTPVPL    MDJMQENDWNS     NVXVCVRAX       IGRRDQGYDJI    
QHDDQRXVHCQVFKM : RGLPTSA         TCQABJFAWSDWG   CPSUMI          TIXELMCGICDKCRV SUAMPKGBRDNR    RYUCMNYQ       
DHPNONUMC       : AQWFRWXLV       JEJEEVKM        JJXYO           BCLANSPTWAT     NAYFQOOIL      
DHARPQCUTSMTQT  : HLVMEOBOCUQI    GETEXIACJSSFPDB
HPDTERYLJNAWIPC : PEJOAF          BYIYTJBBKS      LQLQL           QWXYTOQOV       VXEIWRT         OCRSYLBYOJDPWDS AWSANHDR       
SJJKBAOVVHIQXE  : OIAUQIHYUS      YSXIHAKQMRRNLOT
HWSB            : PILX            RCPYNDWV        KCTOBF          DLCSHOAUFE     
MBNVQPVYH       : VQGDIJGVB       RITNCEXIGVQWMLQ VEAXFGRKY       NWVEMG          LBUEIJFN        XSKQIJVLFJ     
JAJSNLVCH       : OHHPLM          WTSMJHHDLFANJNN EIGYSGPGQLXDM  
MSIMYAUXSXAFBPD : GIEW            HWHOJHXB        LWSNCX          EYXDXCMU       
HYTPYD          : TAQJDC          YNINBTYKPUKBX  
JXFWVKEOYYY     : YORXLSRNK      
BYIYTJBBKS      : JEJEEVKM        HPDTERYLJNAWIPC CUELV           RKGO           
DBGWQGCKRCS     : RKDSUKYWRLHBR   EOJMGICEOY      AYPKG          
YDUPCWQPXS      : VOMOQGCIDUKPK   GEKUYHUKPGUQWE 
WMKBOU          : KVPIMXMSWDIUE   LXCSMCPRJBCP   
TAUCYN          : XDNJISPEX       PMPAYH         
DYCGTQHWOYBLPSJ : YOJNAWLHQOGONHB VGRQWCOPHODS    WUBBMRHPNARVUVY
TIXELMCGICDKCRV : UJAARDKEVFHBSNJ QHDDQRXVHCQVFKM VMCALFMXGCUBI   PHJDTSC        
SAPMTWLIXOTQ    : JYOLI           NOKIBV          YDBVRNESWYXQMB  BPLVSAYLRU      MKQTQSPG       
FYEPYKCLMIV     : KVVEBA          MHENRVPPG       XBAFMXSQ        XKOY           
LHVFFDAFTOYS    : IDWSHOCAIKPCUM 
JTSDK           : NYNJJOHYBKVUUS  JHETWSGTEMTJH   FMBYVIGLF       GFVOCBAJ        JYODW          
KLHBL           : CGHCVXMHNLCSVBE VXMRV           XANFQUQ         PSDLGVXJGA      EOYUDUWQOCN     PTLC            BTCJWGMKAEHAB   RQGFABXFR      
DYJNVBBFYJMEL   : JOOWIMRHHH      BVUSUHG         TEQLAGAUTTUOEW 
XBTTFFNYLA      : XUEFGOW         FDYHANXKWBDTHSX NFMQLFEFXCOY    HJHR           
VLLWWFCWQRUTT   : YGFOSVN         OSREXVPVCDYNE   XIQT            GXWQNF          KRSOJMBUNS     
SFMXQ           : LDQOOMGNHJ      CCIXDMFPNI      VCRF            UHAVIW         
XTCTAIH         : QEADNWRHPCT     BKBBWRRQBUDW    GTIOL           PMLUEN         
THDRVQR         : OHQWGPWUVVA     VNCIKLHWOMJTF   AUTCIGHO        FELPICOECVMM    AIDGRLFW       
XTTP            : ONOQK           DWKAQI          SYKCQMSR       
OLKQF           : KVMALGWGTVNRTOX
DFIMFDOAFYJGUT  : KVLFGMXPSI      GETEXIACJSSFPDB NTUQEMJ        
NRCFMCBH        : MSNESPNQOPOPMD  WRTSO           JWUOHXH        
PXGAPLRSSBFAG   : EIBL            WJLCSSAD        OGPSFTKWH       AEAKRVMB       
ALXMRT          : ACCKL           ITTASX          XYFLNCNC        FNFNPD         
FHAJMMLNTGGSMG  : GJOQKRHMGEF     UILVXJRSVDKL    XISDDRL         UNIQBNEGCQ      BFWG           
ABDSCLS         : NJKWWLTSIX      BALRNFL         FMBYVIGLF       BYCBVYJXXXDEFQ 
KVVIIPCQUJS     : PAIAPMGXFCMIVQ  PTSQWXJ         IESMVHYNAQEBIJF QHXW            QIGDNSL         QIODJQLNEUAUYP  MUFGTNGJSG      LDEFLBBKTMLE   
XFPOCX          : ATJDKUG         CEJQQHQLEMWEG   MOJTPTFUAH      SJNYP           XNRPAHK         JMQYDRSYMPANKI  TSLSXIUWN      
WKDFMGKFIXBS    : UGLRICLDCMYFF   WLWGOXWQRLRGDU  MUQKWNNBGCLRSC  OWFCBRIME      
YORJEVCBG       : QIBVGBUU        BCLANSPTWAT     UYNLGVEUU       CJKK           
FGAXW           : RKUIAKVKMYV     MPYIGJQMS       GNBGOMRRP       LRDBH          
XRYJXGVETEPRHK  : WLWGOXWQRLRGDU  AJDIMDWCKT      SHYE            RPTNKN          KMKYET          GDXTRLEA       
IAUR            : RRTIKBR         LRDBH           SBIMGEVJEPDRUDH
QTIYQPISPFXOAYA : FJBBWSA         AXAGEIUDCJFPUQG BXPRELJCU      
GXECEVVLHYTJTNR : BXAGTOSIY       FAPAYKFQTYGVF   TMAJOAXIOFSG    UVCBGF         
JCOASWTKDR      : BXQKWOEQYB      HWPOUA         
DQBDYAJ         : HQCGOJYVMUUA    LPBY            XOEOQGLRRUEDI  
EIASPYMBVDSJMV  : DYAODFCNHNPL    AUVIOPYAPHGAWS  KOOLAETTEXSDGB  LRFFRQ          BNHTNPKSSPAJM   XYYTMTL        
NQXJBBDDGVELXEU : CJWLH           FFUBSOWKM       TTAKQOSGAMTURF 
LDDE            : KWAKUXUKWCWXDV  XYAVYUMJWEK     XUEFGOW         LRFFRQ         
FSVBVPMJNMYE    : MPYIGJQMS       TAYVXR          OQOPLDYRWWJLUKQ YDBVRNESWYXQMB 
KHNNMVLRH       : GMJJO           YPCHJVXCHHIQ    LHGFEAG         NJWRHSMRLTWRQU 
XDNJISPEX       : USGMGRVDICI     TAUCYN          MTRHBQRBWJ     
CBFT            : KARLTJGRLC      HSBBHTVRXJBAX   IHJTA          
OHDPNPAXEN      : TPCDEURWUCCRIPP HUYYRKNCJQO     QCJILCBIN      
ACCKL           : ERUDAMA         PLGKJQAM        ALXMRT          EKNRYTBXRIUSY  
NBOXWFCUOHWVBM  : GVSUMFCFNH      MPYIGJQMS       POCVRIGXFWOPS   EGDXQR         
LPBY            : DQBDYAJ         QOKJQG          DOQXPYYSC       WSQYC           BPMMVLYVALY    
CWMRKOTOYIR     : SUKFHDAUBPP     NYWRK           JYFCCPVIO       FRGYSVINTEGTHVQ
LHNIORGFYFBBRO  : GTCIRRBC        IQPBPBKCF      
ISNQWLDOXRLMRV  : INBTU           RGKWFTQFHFLGL  
GHOTSDM         : DGJR            QWFWWWUSLGRE    EORLUMVAGQJ    
KLGLOXBBIV      : JOXQYPWAXFOTB   XMKQP          
YSDEJBWWPQ      : OCRSYLBYOJDPWDS JDKCOB         
UYDLTXQ         : XGJQRHCYCM     
YBVF            : BNKP           
LDQOOMGNHJ      : KMHTCH          HDKNFPBEIIWM    SFMXQ           EIJJIV          HVFRMEIUQFSA   
QMRODKJ         : ANHVJUABYNOUF   MMPNSWYXOUE     XPBBQSNHWVNRHY 
JMMFKDNL        : IYQMWCEFXNNHJ   PTSQWXJ         MCYVDOBEMJE     PXCFAUOSWYU    
MQWXWNMLC       : QEADNWRHPCT     DJNEV           LRHICHCWHQBHGK  XSFB           
BLFVCUNSAA      : SJVK            XFKOUXDBIAS     AMOWMMV        
AMTO            : HPOPHRWXRSX     IJSTWW         
HUISCUKYS       : UIIEDVUJQCMB    KYNK           
OHUSDVELSIG     : UBNYORRXA       YSWSBMUKUYK     LRFFRQ          YOFCON         
EIJJIV          : LDQOOMGNHJ      BIGHXDOC        BFHDHJUROYJEOEY
APMWXIBSUANCQ   : JXJM            EKEQF           PGTLRICECFPS   
YLBUPMNA        : LRKDNRRTNXNEMD  FBACFMIUNQKBKCS CPSUMI          QHQRIANDV       FQPLR           JXKID          
WEDIPOEXQVKNUUO : TBGPWYYB        XROBCQTEDG      CVBJHJLMK      
PQGTJESUH       : UMNHJIIMXPK    
KWCM            : SEBAFMVBKNQ     GIEW            QOODYRBCJ      
BRVJJMPHDMUQ    : GUGAHGVXBBYQKJ  YFXHOTD         FHASEBK        
PHBIXHCHNVCVM   : OSCAV           KLOUNHNCTFPQH   VQEYAWTFMA      NBGEFBSVPR     
SOBKSUICHUUQAJ  : GVFLSICEUNAMMV  RJFI            HPOPHRWXRSX     NRPGCHAPKNUXU  
QSEXTMXE        : SAWMOPHWO       HGLNJOS         MRVCHIDBWITO    ARQBQLFC        NQERXTYKRSGE    ONWIBAVBEIME    VXWKH          
HRMLNYCG        : CGOSVYX         TAWTIHUKP       QIBVGBUU        WAXJMNJXN       RGISOYCT       
ETJBENKCICC     : UKBFPHWFNVJV    RNJW            HJJDCI          OWTITW         
PVMTVJGUN       : CVILGJG         VOMOQGCIDUKPK   JAKEMSWNNXED   
EHKQVMS         : XGFHILJH        SDWVR           AREN            XSRHPOTKPVW    
DYAODFCNHNPL    : TGQQIBLJXYGA    EIASPYMBVDSJMV  EAIGTRG         QKGMMFAXU       ODYOC           TRYDUAWFHL      TBFFJQINBV     
GHWCEILBXJFFVV  : USISYSJSYJV     QECCCRAKVMGV    IBIEIYWN       
KRINQKCTPHIY    : KDYB            VWDSMATOSFXPHK  XHBXLPJW        KUBJYQDCGYM     FYNPSUDYKAFL   
ALCIUBLYJYCHKIN : VWGLQRJGDLA    
GQTXBHPMMLETVG  : XOIAWLHBEDUWIV  YVEETDORVTT     QWIE            MHYDMBTHYMPTUS 
YTUHOW          : NCSWQRREUWWCB   FQPLR           PWOG            TAWQVEOPLAGD   
QITUQEDGNM      : UDQSERGEOW      XCOTWRCAFT      IQGINYNKG       HFWDXNDEJUTJ    ODYOC           SLXOTJPGPIDYJ  
HMBQEPFQVYMER   : VVLWGC          QVFMELANEOBOYVH VQJVUKKA       
XNVPKQISND      : NFEVDXW         CMNGIU          FOHKSRHCDKUV    AWVLSJYXYNUIT  
RJRFXTOKWIPONGK : CPMRIFVESJPXW   JYFCCPVIO       YPMCJIP        
URHLRUHHHAR     : KHHNARRQ        ATMGQYSBQMITY   WAVDCOIEJTE     KHBTVBCTGTNWPC  LEXQKWROFGW     TSBCXRIYAHCPCHK
NXOGJJNHDFR     : PQTWRV          BTOIMNM         MBVTOXP        
NJQBRDQPUY      : OIBWVJICNEPYE   EMUQU           AOAPS           EOTNOUAO       
NTIWEK          : LBKILSWISCJQOCC GTFRQFDIGVXXEB  DHHHUTBWUDT     SDQJGIWDMXVKR  
HYPX            : AQWFRWXLV       SMWVLFS         VMSG           
YJWIOC          : HERFQCTHCU      RWKWNKSSLFOJNUS
QPKHTELKTGLUVI  : VWQELXVHDEJLY   DXKPMABEAWW     QANBQTE         MTIHFGQSNQ      MUQQBDTCPOO    
TMOLVPDTWCG     : AWPFO           AWVLSJYXYNUIT   TXSM            GRWYLBMTVLBEK   AYREJNBPBSHKBK 
KUYMOQYVK       : MOLNQ           FOOYSIWIHVJUB   CSYWYLLDR      
JXXSJVORBKGPXCH : WCYMPNIIV       JFPQRRVE        UKBFPHWFNVJV    JPUVMF          ETTBXHTSTBSK    UILVXJRSVDKL   
YGFFDRCEFQU     : IHUTKBFBTOU     FRKLJYFTWHDBN   HORACUDOTSHQVH  RPIOSDOGFCHT    TXSM            YQHEXQMVKPSFT   QNHWPBAMXMBMQHI
PIMYINTRJJM     : QOEGYH          QEOEKEUJLYUB    VBTJBWJBBSWT    KOOLAETTEXSDGB 
VUDU            : AEXCAUWNU       WAWKNCILIWH     VCPTBSFKBQ     
KXYTEGWVIBD     : DUMIK           JIQXWQU         QSMQJEHKC       GWJP           
XMRIYQQ         : QUPPVINKXBNXFRD MKHI            RPTNKN         
NLVWAJUUMP      : TTDFEG          KLJNYAYCCTSKRRN XCVRXXC         WLWGOXWQRLRGDU  XXHABFHRGTST    KJFTNKABNHJN    WBYHEJROCVAO   
YOVSUCPSNSYPT   : LKVJRHE         EAIGTRG         CSEXSKPR        PGLTVPJ        
HCKAVANJ        : URQWMJSYMSNTI   MSXFNPXPEHVJD   XMDJ            EORLUMVAGQJ    
MLHIGVA         : NFEVDXW         DUMIK           VVSQI           QANBQTE         XJDDQKBSPHN     AAMBDSPSJENQC   AMKLOW         
VQCOLFHHUAGK    : BXNKA           ASTGPRBJPGSX   
RRBERWGIIFUTO   : MHYSXBGF        EFBLGEERL       HBVBRONBAFUJDNM UCARMJNCY      
CLGIHYLXNSFUNGB : KMVUWVNM        ATPNBVGMCQYV    WLVKDDVIMXFWQ  
EURF            : RGCNWRCORSBGXYG OIAUQIHYUS      VPTYXVF        
JEGTMNP         : QUVKVXC         GQOD           
EWJPDRYFF       : TBMQR           TBGPWYYB        WTRLYPUDLRMUAUI
SXDN            : AFPNHTGSEDUBV   NYWRK           AJDIMDWCKT     
LQLQL           : HPDTERYLJNAWIPC TRVAWLPPFHUILP  GETEXIACJSSFPDB
XMPDSJ          : SQIAPAXJKMKRUNJ LHLKWKUXACNDKYH MKLDYRGDADIACBL EGPSPKSPHOPR    CBXEVOKPCPHOC   KLLBEMQ         UWPAHCPEXFNDB  
IBYNYIF         : AXGHBCI         UKBFPHWFNVJV    WCWTPGABOFKKGX  CONJTFYMPPNYOJ 
CHLIHEIKRWYKIRV : WHFNWUHURHUYML  JVFAAW          HFWDXNDEJUTJ    KLCJPHYUCYERP   XDIQUNYF       
PJESEPL         : VATMTFVNHEGAHKJ UYII           
RKDSUKYWRLHBR   : QYMNRABJIXE     BNKP            BFNNKBSMDSRLY   DBGWQGCKRCS     MKLDYRGDADIACBL BXOJARXEBNGURAC JIGXUH         
OMPNW           : LBRAXVHLPJOCB   TAQJDC          LRKDNRRTNXNEMD  RSNGOOLP        GIEW            VAKEEEFX        SMVVWXBEONQO   
HTQWFUSJ        : WMDC            LCYF            SCTNXSK        
EYFQEALR        : QVYXOSSQWALIKD  MTMULDSVFCRL   
KLOUNHNCTFPQH   : PHBIXHCHNVCVM   UHLN            WHXRAO         
MYVRVQEJWDQN    : QMCU            FHID            MYSLDCPF        PNLJRQ          GPWJHJCMLKQW   
SYCUMNJHBSWF    : BOCR           
CUELV           : FAXOETCWC       BYIYTJBBKS      VDEWUVLFJNOLCQ  RIGUYBCHVCBBYVP XTXJIADIKA      CJYUQPAFTCDYAIO
KSLHLPSJUK      : WCYMPNIIV       RPMR            LFMHUHYAC       DKECMC          FOOYSIWIHVJUB   ATXVIC         
FDYHANXKWBDTHSX : RTCWSRCSMPGTJ   GEIGJYQAOKYWJ   JCMGGA          XBTTFFNYLA      FELD           
YJBRWVDGHUYS    : VMJKKKPSPOEOLO 
LSVP            : RYCS            BKBBWRRQBUDW    RYUCMNYQ       
GPHECEHIXODXVCH : MOKNF           QCJILCBIN      
TEUAMCUMVLXOKP  : UNYOKTGU        UAVAGTJRESBM    MTIHFGQSNQ      TILBISQNOI      YYNNBPC        
QIRWMVGW        : LKFOPMUKH       CVLVHIWMVYGP    MIGGWIFWYMGINPO AAMBDSPSJENQC  
VATRC           : HIEDQRCRGYINJQ  BRXBUM          FRQCTWUPK       HTVGNGMUF      
QWKLWWPTLNGME   : ETANEEU         QLMMUOAIUBHKAE  PMJODKJW        FHOOE           UMKC            VWGLQRJGDLA    
EOJMGICEOY      : SUKFHDAUBPP     FOFDYKCU        XSAVQFJNXGL     DBGWQGCKRCS     TYWLTUKONO     
MAVECCWBMKALBUX : DYXPRXLS        GVDV            CLKJ            HWPOUA         
DKTTOIFERNGVEFY : TJQVPSLVC       MCYVDOBEMJE    
HWXKYVNNGO      : IQPBPBKCF       AYREJNBPBSHKBK  FPMF           
JJXYO           : DHPNONUMC       TRVAWLPPFHUILP  BSHDTJOD        IGRRDQGYDJI     QEHTBXCOBKNUC  
UKBFPHWFNVJV    : ETJBENKCICC     JXXSJVORBKGPXCH IBYNYIF         UFNTLN         
BDTAPVXE        : YJJNPILPCQEJIK  ASBIRNCOESGDNP  FGXNMLB         JYUFCCDGTUQRY   EHOBCC         
EULQ            : GHIXXYME        MITXTRQM        JWUOHXH        
JPUVMF          : OFXPUTCMOCNM    JXXSJVORBKGPXCH FRGYSVINTEGTHVQ
RUHPCXLLTI      : XUEFGOW         KOLJ            XYFLNCNC        GEAHNKJQSUTJM   UOXMIQROJWDI   
YCPRANV         : KOOLAETTEXSDGB 
TSVKYICTGOY     : FVVSWDJEGKQKGJF BEVXEUTC        AYVWHBMJXXSNCCG EFKIDVVJD       UMFFUIDQS      
JVQYXOM         : UDUYOLADH       THSLUAP        
KUBJYQDCGYM     : XOIAWLHBEDUWIV  TENQFUO         KRINQKCTPHIY    OGDUWHFQW       MEGSXFVMISTIE   EORLUMVAGQJ    
RKNSUQMCHNKQJBR : NOKIBV          SPFSDOCTFB      OSPCYGFNFCW     UAVAGTJRESBM   
PEVCBYODQRFYTTC : TIBYCNOIJAS     QOYUF           ONTWWCHOUDUED   AMHHG           LXCSMCPRJBCP   
EQHCJTGSKS      : GPMNY           UEPE            FCVUWHGPPRVTOX  YMYNHYVGJ      
VUEGMJE         : WCDLX           ORVFQIRMEKLTB   GRGNVWS        
MDEPVV          : OIBWVJICNEPYE   OSREXVPVCDYNE   LFMHUHYAC       SJVK            LKVJRHE         XDYWROLNAQXIWG 
VROXGVONA       : KWGORIXDUHM     AOAPS          
JGTTYGSVKYJV    : RLWF            NOCBPUXSGSGDS  
BJIH            : RPNVCNAYNLHQIKL OQLUOU          KXGPQAPVE       RYKBMSWWUMP    
HFWDXNDEJUTJ    : QITUQEDGNM      CHLIHEIKRWYKIRV RUKUIVUIPJLTPHX
FRQCTWUPK       : RWFRPLBV        VATRC           FGTHOBI         RLOHTIKN        VMTTPX          TKINOQHUBN      LUAKMQUUCB     
BGBCPLLRSRQXPE  : CGOSVYX         FOHKSRHCDKUV    JFPQRRVE        ULLPFCIVGN     
VOYRAT          : KVFXGOWR        AVJFXH          UYII            SPFSDOCTFB      GBPKX           FQBOJEUOPSJPQ  
UNYOKTGU        : TAQJDC          UBFXI           WTCITOFCFJEWIHF RWMGIADAROR     TEUAMCUMVLXOKP  ROVUKVJWMYVF   
IESMVHYNAQEBIJF : KVVIIPCQUJS     QBYLMMKCWRFV    BKBBWRRQBUDW    XIDFSDDKP      
AEXCAUWNU       : GPMNY           IQGINYNKG       VUDU           
YQUVJDCERYL     : CEPUVHWM        WBNLYRJG        YQKHOPQ         TILBISQNOI      ASNODCCVUQGT   
MOJTPTFUAH      : TPYBDNAALBSCB   YLQEXOQEGXUDW   XFPOCX          MMYHINFCKK      WJPIQQE         VWFHUMSPCGM    
XJBVJ           : TAYVXR         
SWQJTOUYRARSNK  : SGNWCRQT        OOBPBTUJET      LHPMIW          KRFLGPVFXM      ONDXCVHOHK      EQRXVRBL       
CUBROIORPPPCTLN : NKMDOJCEWVOS    MJOEQTLEDJE     CVBJHJLMK      
EKEQF           : BNHVXJCHFTON    NBUXFJFBMIFFHMQ APMWXIBSUANCQ   JYGBS           QKGMMFAXU      
NGMNXFC         : JGVYVGCNHKCN    FESUMUNC        PGLTVPJ        
NGGQY           : QBJCW           WVOIUTQOCF      BRFKDCDRDOY    
CPMRIFVESJPXW   : GHFU            PHOMDJHGJNIQH   RJRFXTOKWIPONGK TTPYNQASSVV     THMYAGDMHMOD    NWRC           
QEOEKEUJLYUB    : PIMYINTRJJM     TNKKX           EJFUFLN         MMPNSWYXOUE    
BUGXWWNQHSNL    : SQPCPINSJURBUS  IXXKDHKHSCLJJ  
WBLTWCANHLTC    : DPRYIRALBV      POWNVBFGNHSBQB  KLLBEMQ         GETEXIACJSSFPDB
GBRJGSEPQBMG    : HXOPNNHCBJRYYW  ISVMBRCALXUS    IWSAQLRUQAMPNP  MCONXWQPBYA     DJEPUYTI        FJYORWRX       
VYGHNFKYC       : SERRRI          VVTIFXJUMOEUGC  NENGWOENMX     
ECWLNRPK        : PQAMIGFTMTG    
SEJBWOQQPFWKBYS : VHMDSFR         KWMXCD          WELJVQWYFJXKI   URQWMJSYMSNTI   MKKLNBWADYG     KEDBDVKIYCO     AYVWHBMJXXSNCCG
MYSLDCPF        : MYVRVQEJWDQN    DWBHUEHMWQWA    NUDOLJXQRVHGJK  TFTLGPPXYVBNO   SOQOSRYGPQINFT  BPENDU         
DVTSIVNNFPMT    : SLNQQUN         VXEIWRT         XBAFMXSQ        TNKKX          
FMMD            : IYQMWCEFXNNHJ   MOLNQ           RRYHXDXJI      
NCSWQRREUWWCB   : TGQQIBLJXYGA    KMTXEBWSVXMEX   YTUHOW          QEXRO           YPCHJVXCHHIQ    MHYDMBTHYMPTUS 
AWVLSJYXYNUIT   : XNVPKQISND      TMOLVPDTWCG     MYIYVYLTNBWVDJP
UYII            : XEXDVRY         PJESEPL         VOYRAT          UAUIOVRWLWBY    QGRURJLJXQIRTM  KBKESUHXU      
BHTUCXRB        : NVYJUTYBNFXNTUI WBYHEJROCVAO   
UCXWBVI         : LYNTHMFBNYDBBO  UPWFLNA         HORACUDOTSHQVH  NTHGRDD         WAWKNCILIWH    
HJTJXQRTCOSL    : JKSEV           EKDHURFXIDMKPOT JXSYUFHUGEUKS   XMSQGUY        
VOHRKLPCO       : EBUCAVAMAITL    ANHVJUABYNOUF   RNYBXXEJTQYEOO 
YSNY            : INBTU           WRLWMTXCQLJUAK  WFLSGANVTV      VCVLKGFHJWTWUF 
LHNSRJCRBVNDKI  : QBUNIYWFNHC     DTSN            MSIXCJEDEUCET   WOUYWTG         CVLNLPC         JBOOAXPMO      
KGIRXUFPWTFYM   : KVVEBA          JMLBEUS         XDYWROLNAQXIWG 
XGEHVABFESIBIO  : VMJKKKPSPOEOLO  KLWBKU          FKVKGPHNWWKR    VMTTPX         
QHXW            : XLUN            KVVIIPCQUJS     FBDTTT          XRPJPDKASHELSE 
RWKWNKSSLFOJNUS : OGOYJNAUDJ      TOODHVNWTVUESS  KWGORIXDUHM     YJWIOC          OSGJPQKLTMPHCH 
UURAP           : GRTCNAU         MTHCUERRDTYAC  
DYQQPYPPO       : EEFHYUNLT       TBDBIWGSWIBB   
MAHCMCVXIMJXJ   : OMVJFHI         WTRLYPUDLRMUAUI JMQYDRSYMPANKI 
IFWCHNEM        : VLLYNGAF        ONWIBAVBEIME    LGUAXUVYIAN    
VDEWUVLFJNOLCQ  : MSNESPNQOPOPMD  GTCIRRBC        CUELV           JJWUJGWNHJ      PGLTVPJ        
ABXJAIMKPLOW    : UCWPBRNCCJ      LJKCQ           OEPAHSFQORFXL   PAYXVNRCI      
SLNQQUN         : DVTSIVNNFPMT    CVLVHIWMVYGP   
QCTCR           : BSHDTJOD        XOEOQGLRRUEDI  
QWDCWHBHJLVT    : AAIG            QKRP            BCLANSPTWAT     MNRHCXYVFUIEFO  LGUAXUVYIAN     DLVJFUWNKUPQ    JMLBEUS        
HKAJDLWWCTMQNQ  : OOBPBTUJET      LVYNDKEGAVT     XIQT            LYTAV           XPGKUVGAAF     
RLYIIFNFMOOVCM  : RCCJLL          NFMQLFEFXCOY    IIQSS           XWOETDOMXYSCDL 
DUCFEHSDEWATQNK : UCNTTA          LKUV            MJOEQTLEDJE    
FVFQG           : PJPWARFHAIWONT  PKSXHED         ASYBUJHMRD      GAPTQYTNJNY    
EOYUDUWQOCN     : KLHBL           ONKUEDOJEMB     XNUUCA          EIGYSGPGQLXDM   GRLMLH         
HTXA            : MKKLNBWADYG     HBVBRONBAFUJDNM AUVIOPYAPHGAWS 
FWYYNOLTUKBN    : TOODHVNWTVUESS  SHYE            THSLUAP        
NRFM            : IYQMWCEFXNNHJ   BMVSGUX         ASRJGSON        URGAXUR        
LJLEA           : XELJQSAE        XDTBCNSF        KBOH            QEAELET         BXPRELJCU      
RQWLQYKVXMWOBLI : EDVTVN          VCRF            FWDHIFGYQMRN    RRTHJITJGQOIVUM BFFDOGAH       
VLLOY           : VVKP            YRDC            OXWBBSIHYRXRJ   ABBGHI          PHLUXUR        
UNRIYDM         : RCPYNDWV        TYJMRRSUNO      CRPYREBRMMAJRJQ
SERRRI          : LGSCTDTDGHEB    QSMQJEHKC       VYGHNFKYC       PQFIFHYQOKH     YLFAGWWXRNTT    TBPPUYDXJX     
EHPQGGUR        : LNWW            XPVBARJTMAYWFT  ASTGPRBJPGSX   
SPCFFDICSBKRGW  : QXKNX           ASRJGSON        DIMM            UWUNBNSLAGPWKRO
CDMTWUNBE       : PGTLRICECFPS    YFLRYVJBJAJ     ROVUKVJWMYVF    LHGFEAG         HUYYRKNCJQO     DNIUMRLFFNWHUU 
ULLPFCIVGN      : ESUHVDYCUDOH    BXNKA           OKMHORERP       BGBCPLLRSRQXPE  KVBTRJNLLILIVS  XXEEBSNRD       QKPMBBIW       
JYFCCPVIO       : QOYUF           MQRPURBWIQKRE   HPLLQMPRX       SIBSGGIM        CWMRKOTOYIR     RJRFXTOKWIPONGK NMUKOJDTXIAYHMA SYXHDSNEJYTJJLE
MRBJQXYRF       : XBFSSQOFW       XNUUCA         
OSREXVPVCDYNE   : VLLWWFCWQRUTT   MDEPVV          PFSQDILBKLXBO   HXQVBFKK       
PGTLRICECFPS    : DUMIK           APMWXIBSUANCQ   CDMTWUNBE       DMAGBJ         
ONKUEDOJEMB     : JAHDA           OHRBP           EOYUDUWQOCN     JPBA            NRBBUGPVMB      OVWPLD          CCIXDMFPNI      SQDKCU         
ONKUEDOJEMB     : TFOWFRDIRKR     MMPNSWYXOUE    
QEAELET         : SOAEQIMKYAIAKC  MSNESPNQOPOPMD  EAUTQDNF        LJLEA           KYNK            LVXFSOSYA      
BHJL            : TKTRFYYHU       LMDONPFW        MSIXCJEDEUCET  
QQQGLWXYHUE     : JAHDA           GGLOCN          MAXHLHUDJHJPX   XHVXYEQLX      
MPRYQRSWTWIYT   : JHMIAPMXOKO     UUCGBLPDNNXXKK  WBYHEJROCVAO    UFMMEDUBNCBUT   CQKTKDOFDO     
CDMNPFE         : MNCFWVVWEPDJNG  FTCBEWGXKGR    
OQFMRPJXDVPUX   : VAGAUMTDTKUDXRH HCKGHLAEWPNQ    EGDXQR         
OSGJPQKLTMPHCH  : RWKWNKSSLFOJNUS BOCR            JBOOAXPMO      
JPBA            : RCPYNDWV        ONKUEDOJEMB     NHBCNMTYAAW     WAXJMNJXN      
PTLC            : BEJCG           KLHBL           PQFIFHYQOKH    
QXKNX           : BEJCG           MXUBHX          SPCFFDICSBKRGW  RLWF           
CQALJQVWLKMUN   : OCTS            PNMKPLXGEFEUV   JEYDULTOVQW     FFUBSOWKM      
JWKNYIDUVFPOG   : RDBLRAVLQGLN    VOILO           FELPICOECVMM    WEGTTPJXGFJMK  
CGWEAW          : ROBTXUNRSI      VQJVUKKA       
LPOIDCVARR      : CHATTIBEAIW     HIVQRQDTAJADDCW KMUIJNVQHAGXXH 
QEXRO           : SIACPPPNXNUMM   XBBB            NCSWQRREUWWCB   FAFNETRTESWTD   MJBKCDIIQAJV    FSXMC          
MKLDYRGDADIACBL : WJJWSNI         BJFOALESY       XMPDSJ          RKDSUKYWRLHBR  
RUXVSX          : PKDOYGMFHKRRHN  NOKIBV          UAIYI           CSUHJFFKO       OTBUIGE        
MKETIVIOLVAQWT  : WBNLYRJG        XKOY           
BTCJWGMKAEHAB   : YUOSVAHCQOTCHM  UDPBUMDTPGQ     KLHBL          
BQPL            : JWACFMPHNXHACO  RITNCEXIGVQWMLQ TYSGAHTTGNK    
JUTTLHRLXP      : DYOPXVVPIFW     XANFQUQ         VEXX            GPUTBR          KGKT           
WSYBEXHQJKWQKAT : LOCY            ETJLSCEEELAKY   SXWJJDOSTFR     JFXFPHRJM       QSWIUFQIDUQGMBF
RLAPWW          : TQWPOIU        
QIVJTTBBTTAWXB  : PAABUUDSNFM     WUBBMRHPNARVUVY
QKRP            : DPLU            QWDCWHBHJLVT    FJLJM          
EQYSKKUCHRP     : KLMKU           BNKP            DDVUCAXLY       PEUVETTXHLEPGT 
CLKVIN          : YXIWFA          ETHTIOUUIHV     GHUPPBPCN      
CHYYHC          : JWACFMPHNXHACO  DYOPXVVPIFW     MCONXWQPBYA     KVKXCLONKI      TXWATQXCECTL   
AOAPS           : IQQWYDLLKWP     NJQBRDQPUY      VROXGVONA       PENFGYWKYY      WEGTTPJXGFJMK   NPBDKQOWRWHOSNY
GRASFU          : QSRPVDBKCYRQN   WXJFDOXGBCJCFFO
MOLNQ           : QBMDJBJW        QWOTVPNU        KUYMOQYVK       FMMD            UVGLRNORUOJWE  
AOFP            : MLCBKDIIPCOB    UDXXII          ROVUKVJWMYVF    ODYOC           BRISOUEK        QSWIUFQIDUQGMBF
JYOLI           : TOODHVNWTVUESS  SAPMTWLIXOTQ    YNETWFUAWBKC    HAXTSBHHCSO    
RIGUYBCHVCBBYVP : CUELV           NNRVRWTNINRUOF  ASTGPRBJPGSX   
JGIH            : HAXTSBHHCSO     JAQHWUFE        IKHTSAV         MRBONKXDQBOB    HCKGHLAEWPNQ    MHSGHKGUICP    
YOYMBXDM        : QSRPVDBKCYRQN   PHSJBQASUIRE    MTIHFGQSNQ      JYODW          
UEPE            : EQHCJTGSKS      MUFGTNGJSG     
QFDYDFCEGXUVKB  : YRYXPSKPU       OIFTVPMXYDEKTS  LHNFBM          GJJEUBHJVK      WBYHEJROCVAO    FUFKSSSGOD      EYXDXCMU        OQLUOU         
QFDYDFCEGXUVKB  : TAWQVEOPLAGD   
RJFI            : PKDOYGMFHKRRHN  SOBKSUICHUUQAJ  LWCD            TTWAHJXF        CBXEVOKPCPHOC   QIODJQLNEUAUYP  COBBHGBNHUNT   
RJJXXSSFKYGCH   : XGFHILJH        XCOTWRCAFT      JCCVOMLJECN     KBKESUHXU      
DKPFPYFMWPNEJ   : WMSAK           EGSGHU          MDMOHTUUTGUFL   YERA           
LUKG            : UDQSERGEOW      THOCCPYAITOB    NKHHIOSVWLKNSGW MHENRVPPG       FDGPAQIF        RSMXLOKOBDLA   
VEFOW           : URPPLLQ         SSPAAKCA       
YYQDGBGSTNKS    : OCTS            OJRTP          
WRLMXVMKQYQWU   : VLLYNGAF        LNDDQ           NVERAYWWYKF    
CJTMKSGQBH      : SBRO            ODYOC          
UBNFVJFQURO     : CCNCUY          OLKYELHDCWHKOT 
EYJFRJAMLLHBWCH : FKDBJ           WFLSGANVTV      CSRGHVYE       
GQOD            : JEGTMNP         WBNLYRJG        OGTSKFLDPQNK    ERHOWXFVTOVC    WQRMLUBBHBEXC   TBPPUYDXJX      IKPKLWS         RGISOYCT       
CKQLPJJIYCOAMU  : VEOQDOLJQVWCLV  PJDXEYF         FQPLR           HARPREIH        HVHPNDGEI      
VWHJJOKITTXC    : RBUQRJPEPDHIDE  JOOWIMRHHH     
MFGRPY          : YTIDREIIOS      WFLSGANVTV      GLNQ            OLIUGDLVIKHKXFH IOIJSLLBVQ     
GJOQKRHMGEF     : VEAXFGRKY       FHAJMMLNTGGSMG  FGTHOBI         CPUVXEB         OGTSKFLDPQNK   
CNNLEB          : YNETWFUAWBKC    QGWGNLOBBRCIERA GTQPOHMO       
AUTCIGHO        : SRCYOOXDKHRPI   THDRVQR         HLMOANEK        NOHLUBQHJSDD   
AQGICUYMMIBSNH  : USGMGRVDICI     GNBGOMRRP       RUKUIVUIPJLTPHX UTPMOTI         JEAYVIMP       
PWLDDOYGJS      : FMMCCUFJTI      GOHTPAQGTTPIAV  IIQSS           LVNKE          
SBSJCUCID       : BHTWO           ENNOFNP         KSYAHJBCJC      QDTLFRMLLVF    
FESUMUNC        : LILOFSBBGQ      ATMGQYSBQMITY   NGMNXFC         MDJMQENDWNS    
NRBBUGPVMB      : ONKUEDOJEMB     CITKNIVPAXDCPYU XWOETDOMXYSCDL 
VVSQI           : MFOWOHBQF       MLHIGVA         AJDIMDWCKT     
LKFOPMUKH       : WUAQG           QIRWMVGW        WAWKNCILIWH    
FXKJLEMOCTEXIH  : NUDOLJXQRVHGJK  GGXHGLGATAGVRVR BRJV           
GEIWMFKWKBOWVAH : RIHUOSAYO       ATDKACRQXVQTB   JOOWIMRHHH      TTKTJGUKAGGNG  
HFSTQYG         : NOWWNYCSGMWAM   FDCHFNUYMHVOE   NRXPQMJCLNYG    INYHHSIA       
BCLANSPTWAT     : PSDLGVXJGA      CFSBW           IQGINYNKG       DHPNONUMC       YORJEVCBG       QWDCWHBHJLVT    QCHBM          
FELPICOECVMM    : TBQQRBPMTOX     THDRVQR         JWKNYIDUVFPOG   HRWD            XPVBARJTMAYWFT 
FGTHOBI         : JWACFMPHNXHACO  LAQNIPIYM       OWSTJ           FRQCTWUPK       GJOQKRHMGEF     VXEIWRT        
MKHI            : XMRIYQQ         TMAJOAXIOFSG    XUHGREGLTAHYM   CEDYELLGG       BRFKDCDRDOY     DAPYVSJGEOK    
DHCWTHEFYM      : CRCK            YENSNOXJ        UIIEDVUJQCMB   
OSMMGBQNJMUXO   : KLMKU           QNRXJYLFHQ      WLWGOXWQRLRGDU  GBNMBWANHTGCPR 
TBQDL           : TSVTH           ATBYULHKRCKEDQ  TYWLTUKONO     
HTVGNGMUF       : ATMGQYSBQMITY   VATRC           JWLWJL          CONJTFYMPPNYOJ 
ETUSJBVCQFOOGDU : POWNVBFGNHSBQB  IRMSUKCLGBLVWGM FXYJUJV        
HLGS            : IAFWBOIMKVRWVLG MTMULDSVFCRL    NOKIBV         
PMGVCML         : XSAVQFJNXGL     IQPBPBKCF       FRRIERJGJ      
RKGO            : LSNXFVFVOI      BYIYTJBBKS      XKXFCYFQDYLGOE  FAFNETRTESWTD  
BXIXAADQQL      : URQWMJSYMSNTI   PHPYDD          TRANNB          ATBYULHKRCKEDQ 
LOCY            : WSYBEXHQJKWQKAT XSKQIJVLFJ     
WHMMNKQAVQRHYI  : JEJEEVKM        LCYF            PUOQIVLXDP     
AGXAIAEAQRWEGB  : LXCSMCPRJBCP   
DXKPMABEAWW     : QPKHTELKTGLUVI  BMVSGUX         ANHVJUABYNOUF   VWFHUMSPCGM     WKYXGSJPW      
GVDV            : NXVCFCTGG       MAVECCWBMKALBUX PEWP            MWNQJPBT       
MVYWXDY         : PHOMDJHGJNIQH   CWVMCLDCBADG    YPCHJVXCHHIQ    BLHFHN         
WVUEYAJALAML    : YSXIHAKQMRRNLOT QKTWKDDGBG      HRWD            LDGTQVGJTETLR  
QOAPLHL         : HQCGOJYVMUUA    OHJIYW          OKBRUCO        
FKDBJ           : AANDXRFYL       EYJFRJAMLLHBWCH FAIP            DOILWHJUNMW    
BOCR            : YLCJUGXSGUDOJUF UBFXI           SYCUMNJHBSWF    OSGJPQKLTMPHCH  FTCBEWGXKGR     QPSBJFGXMJMNVRT
BORAOCAC        : KDYB            LIPKYCTU        YOEDENWXWYPCV   GDXTRLEA        DNIUMRLFFNWHUU  MEGSXFVMISTIE   DJYQM           WVYLVFOSDKUET  
BORAOCAC        : GOXECEMEM      
PQFIFHYQOKH     : FGTYNOYPKNWLYF  GANEOSGVGQD     BCSYDGSQXQDA    SERRRI          PTLC            QVYXOSSQWALIKD  SLLRFLCWIAD     IEUFUVEDOGQIC  
PQFIFHYQOKH     : ALUCTXTNTPRQ   
WLWGOXWQRLRGDU  : WAJPBKFRAUELL   XUEFGOW         TORSKKWV        PHSJBQASUIRE    WKDFMGKFIXBS    XRYJXGVETEPRHK  NLVWAJUUMP      OSMMGBQNJMUXO  
WLWGOXWQRLRGDU  : MJNIXOQTRXS     XXEEBSNRD      
HUALKQSTV       : RIHUOSAYO       COQEQNRWBQ      EDPGCP          OFJW            SUAMPKGBRDNR   
UORFYM          : JWSQHMVEK       QFTKJW          PQXXKWQGRE     
MLNBKLTE        : TBCKK           ANHVJUABYNOUF   WHHAJ           PMSEYFCLHPUFWQ 
OLEJJMGJATDTPBW : SGJPVGUKWXRNX   PJQSAQLWBFEBTA  WTLJMFCG       
QORRDWEPL       : MAXHLHUDJHJPX   LDLL           
CWDGXRTCDD      : FWVTKABJVWGB    SUSLATUUVYXX    QSUWNAALSNH     KQEDNF          TKINOQHUBN      MXFHWTGKWLGFY   VDGQFUC        
KPPGSLVTIGMWX   : OHCTNPIIJJOAY   XIQT            YSAHPV         
BXKQJRUI        : HDKNFPBEIIWM    XYFLNCNC        TWJPYSPPF       XTUEJXVGEGCAHR  KARSANDANHGT   
BGPVIV          : RPNVCNAYNLHQIKL EVJFYTGNABUSAE  TCQABJFAWSDWG   TPUWBBIIB       HEYDONYYYOUPW   TILBISQNOI     
AISP            : ONDXCVHOHK      CEDYELLGG       KARSANDANHGT   
LBKILSWISCJQOCC : NTIWEK          TMAJOAXIOFSG    IWEPPAYNS       YSAHPV         
YKFBQWY         : KUQLMPHWR       ASNODCCVUQGT   
SACBTTPHUC      : MWDEMRCDMQP     OWSTJ           AYVWHBMJXXSNCCG GRBWFQT        
IWPQSTDLI       : JVOYUTAFVBAO    PAABUUDSNFM     PUOQIVLXDP      ONTWWCHOUDUED   PVMGMW         
ORHYWISWJUPJY   : XOIAWLHBEDUWIV  FYFJAFQGYEHBU   JCURSH          GEKUYHUKPGUQWE  KGKT           
FSJPPOHXNWOGQT  : WVOIUTQOCF      KMUIJNVQHAGXXH  RADPVMTXEAIJENC
ACHRJIRTDOFAG   : GRLMLH         
YAWRMOJDV       : JWACFMPHNXHACO  HQCGOJYVMUUA    IGKH           
QVYXOSSQWALIKD  : HDKNFPBEIIWM    EYFQEALR        PQFIFHYQOKH    
OTHOCYOD        : SUTSDNUTOJJHKM  GJTYEHJ         NQHYD           YNXJGCRV        CROWIUYTAJN    
IRMSUKCLGBLVWGM : BALRNFL         ETUSJBVCQFOOGDU KVPIMXMSWDIUE   ODYOC           UCARMJNCY      
IADTDHK         : GVSUMFCFNH      LFMHUHYAC       VLVG            EDJMHL          ADQVSKVYMFJT   
RYCS            : EITVAYGPOUNSYQN LSVP            RCEXBFLMG       NAYFQOOIL       MFUKUGEFEK      VCPTBSFKBQ     
HSBBHTVRXJBAX   : FAPAYKFQTYGVF   SQDXJUADBCLQN   CBFT            MDJMQENDWNS     JWYLUMBHCFYCDPI LDLL           
YENSNOXJ        : DHCWTHEFYM      ATBYULHKRCKEDQ  KXHTUWULFQIV    IHMDLOTNXWAQAHN
ITTASX          : ALXMRT          QMJWICQMV      
LHPMIW          : SWQJTOUYRARSNK  DJNEV          
EQGPRIPSHUH     : ONOQK           UXIRIADHBHDS    XBBB            MHDUBQCAAVQPMS  GQFYIRTXALPT    TCOQ            RIILFNXGJEKRGMA
KVBTRJNLLILIVS  : VUMJEBWI        ULLPFCIVGN      FDTTVQWRTYGFDQ 
IDWSHOCAIKPCUM  : WEYHSX          AGQDLB          LHVFFDAFTOYS    XWAQRD          NFBGDYHOGN     
XWHB            : VPTYXVF         TXBR            LFMHUHYAC       WLKOL          
YNINBTYKPUKBX   : HYTPYD          BNCSJXYVXNT     UFEMLAPANAOSSWU AUVIOPYAPHGAWS  IEUFUVEDOGQIC  
TIWXKFLAJ       : DOFPNDIEA       DIMM            FXYJUJV         DLCSHOAUFE     
PSGMAJICYQP     : SOHAB           SHYE           
KQNBL           : EFPVFEPJ        SLORELGXSHFXP   AREOIFYNHRM    
EMIXU           : YSXIHAKQMRRNLOT ABBGHI          NEERDRGFPR     
YFPK            : RDBLRAVLQGLN    UXIRIADHBHDS    ASBIRNCOESGDNP  QKPMBBIW       
YSWSBMUKUYK     : OHUSDVELSIG     VFBVLFNNBUFQ    ASNODCCVUQGT   
ONWIBAVBEIME    : UEMY            QSEXTMXE        IFWCHNEM        OCKBGJTLFJ      NOKIBV          RIWADM         
TDKLPULIRGJEDW  : CMNGIU          QIBVGBUU        CMPUKHWNPX      ALAGLY          GADOOLHVMPOGP  
DJNTWMEXOB      : QACYHYMYKSUNS   DYFPDTFV        CXLXPCANIMSBN   NLUSCWWOGC      SMVVWXBEONQO   
SJNYP           : XFPOCX          JWRNYKRRL      
FCVUWHGPPRVTOX  : EQHCJTGSKS      PKATKRADVQOCL  
XNUUCA          : QNGAFQKQMQYGYGD EOYUDUWQOCN     MRBJQXYRF       WOUYWTG         NAXBKEL        
QBYLMMKCWRFV    : VXRRO           IESMVHYNAQEBIJF WAFAWNWMVWSTNDC TBDBIWGSWIBB   
EDVTVN          : RQWLQYKVXMWOBLI DQLNELYHXEC    
PFSQDILBKLXBO   : OSREXVPVCDYNE   BBXXKNNNOD     
OCKBGJTLFJ      : PLQSSRT         VATMTFVNHEGAHKJ ONWIBAVBEIME    UYYLLQCDDWHTN  
LFMHUHYAC       : PQUMIWGVBIFJ    KSLHLPSJUK      MDEPVV          IADTDHK         XWHB           
EKDHURFXIDMKPOT : HERFQCTHCU      HJTJXQRTCOSL   
IHJTA           : JFPQRRVE        CBFT            SIYOFBRBHRDGKO  SOXDO           CSYWYLLDR       OTBUIGE        
YNETWFUAWBKC    : EOYMRW          JYOLI           CNNLEB          HTEABNGGFPEPTK 
IVRGFWVRO       : WPDX            THEANY          YIDEJLV         IUEGM           CSUHJFFKO       NWRC           
NQUV            : QNRXJYLFHQ      YXIWFA         
OVWPLD          : SOJUIXJJP       ONKUEDOJEMB     PNLJRQ          WGPSOHCAETJCPY  MAXHLHUDJHJPX   XYYTMTL         ALUCTXTNTPRQ   
JKGLJ           : YKPOIM          AEFKGBAIGOIVHMV CSDO           
VLVG            : IADTDHK         APUU            WLXDIKYVVW      UTPMOTI        
ONRLJLBV        : OKELHOYCYR      LWCD            WSMYAYVQ       
TSVTH           : NXVCFCTGG       TBQDL           MXFHWTGKWLGFY  
SWEXIPIRBRD     : YNXJGCRV        KCTOBF         
FAIP            : IBIJQUBCM       FKDBJ           EEFHYUNLT       SMAMUGANJUIQ    WHXRAO         
VHCHVFFVYX      : AOMWCQUQ        FYFXJREUJDFED   AYKMSYNHTTJIGFS
UHLN            : KLOUNHNCTFPQH   IFVDUXLBNBMIM   LHNFBM          URBTFXMSAKSANY  PXCFAUOSWYU    
RLOHTIKN        : HGKIMLYIGOJ     VWDSMATOSFXPHK  EWPNYMWVGGK     FRQCTWUPK       HBVBRONBAFUJDNM SCTNXSK        
MTMULDSVFCRL    : KXONLBJLGL      EYFQEALR        HLGS            AHUBG           JAQHWUFE       
NKHHIOSVWLKNSGW : LUKG            BSHDTJOD        EQHREHRHTX     
UJSQX           : IPABGDFQH       OHRBP           KARLTJGRLC      BKNXLOO         EJFAPWM        
CBIXIKRV        : RCCJLL          GRMFLFGMHY      YUHDHXFLNCMGJ  
FJDMRTGNQTAEOHB : KUCDA           LCFVE           BLHFHN         
CMPUKHWNPX      : EIBL            OHJIYW          TDKLPULIRGJEDW  NKYR            NEERDRGFPR      UWTSFLFJC       XKOY           
CPUVXEB         : XOIAWLHBEDUWIV  DYXPRXLS        GJOQKRHMGEF    
VUUMLOM         : WGNOHQMBCDYSXKO GTEKDKKVWICADWH OGFHNIWAHXUCP   OMVJFHI         TALTYGXCRND     SKNMTAIL       
ETTBXHTSTBSK    : UWFUKKJ         JXXSJVORBKGPXCH KOOLAETTEXSDGB  XYYTMTL         SANLDDHJAGDR   
SJVK            : BLFVCUNSAA      MDEPVV          ETLWHNFAKPRYOVE RADPVMTXEAIJENC
UILVXJRSVDKL    : FHAJMMLNTGGSMG  JXXSJVORBKGPXCH QIXUEBPTSJ      PHLUXUR        
QHQRIANDV       : MWEJCLSQ        TJQVPSLVC       YLBUPMNA        ALAGLY          NTHGRDD        
XGJQRHCYCM      : URPPLLQ         LTYOMQO         UYDLTXQ         UUAG            KFESSEAQBJCKPBH
BMVSGUX         : NRFM            DXKPMABEAWW     FSWT            WTLJMFCG       
GWJP            : TCQABJFAWSDWG   KXYTEGWVIBD    
BXPRELJCU       : SIACPPPNXNUMM   QTIYQPISPFXOAYA LJLEA           AUYKEN          DVQK           
VMCALFMXGCUBI   : TIXELMCGICDKCRV WUIYDKTPGYJSUO  TKINOQHUBN     
BBXXKNNNOD      : LTUQAPOBPTOB    EQSRWEEDVE      PFSQDILBKLXBO   CVMTTWVI        WQRMLUBBHBEXC  
URQWMJSYMSNTI   : HCKAVANJ        SEJBWOQQPFWKBYS BXIXAADQQL      PTSDDPJRPFMIKN  NVERAYWWYKF    
CKIFUXG         : LIPKYCTU        ENNOFNP         NAVACWPJ        CJKK            MCDJQFCSPIB     MEIAIPD         TXWATQXCECTL   
XFKOUXDBIAS     : RLTUUYB         BNKP            KPIDLYUPHDQOBO  VEXX            BLFVCUNSAA      AQYSHFBPEVVTF   NEERDRGFPR      SSPAAKCA       
WFLSGANVTV      : XLJYMCLN        AREN            YSNY            EYJFRJAMLLHBWCH MFGRPY          GMDAVFRNXEMFX   KJCBNGC         ILXEMUROFPEFCG 
XISDDRL         : FHAJMMLNTGGSMG  YLFAGWWXRNTT    BLHFHN         
RSNGOOLP        : JDOMCQX         YJJNPILPCQEJIK  NYWRK           OMPNW           MJUMGUS         SUAMPKGBRDNR    EEDEW          
LKVJRHE         : CIHUFXODNDYO    YOVSUCPSNSYPT   MDEPVV          XPVBARJTMAYWFT 
HRWD            : FELPICOECVMM    WVUEYAJALAML   
HBYAGDTUG       : OVDLJUX         UCUPLTFQXWT     OLHTKQB        
NWSCLFTIQEECV   : PPLFNJ          WURIVEDXA      
GWVBTAPBDQBMVXH : VOILO           HDKNFPBEIIWM    XANFQUQ         VJJSMCJEFB      TJTWJCNLVCDCQKD
KUCDA           : FJDMRTGNQTAEOHB VNHDVKEDLVRJ   
KVVEBA          : EGBKIOKGFH      FYEPYKCLMIV     KGIRXUFPWTFYM   FTSVDGYUF      
YORXLSRNK       : CJWLH           JXFWVKEOYYY     SOPEAASLFGSVHX  JOOWIMRHHH      CLFQEHGFR      
QBYFXWMDHIFMKS  : FOOENC          FCKCKELLGHOJJYI IXXKDHKHSCLJJ   DFXHGRNLKMCBN  
GOGJQOL         : SOFIYLQBTCKALQ  EEFHYUNLT       GFWQ            NJWRHSMRLTWRQU  FKIMNFQINI      SBIMGEVJEPDRUDH
GJTYEHJ         : OTHOCYOD        KRFLGPVFXM      CSRGHVYE       
ALAGLY          : TDKLPULIRGJEDW  QHQRIANDV       CVLVHIWMVYGP    NLLI           
OIFTVPMXYDEKTS  : ATPNBVGMCQYV    QFDYDFCEGXUVKB  CLFQEHGFR      
CCIXDMFPNI      : SFMXQ           ONKUEDOJEMB     VGMYWSOWAJDSY   LRDBH          
OQOPLDYRWWJLUKQ : EBUCAVAMAITL    CRCK            FSVBVPMJNMYE    OVDLJUX         VXDGHNQRIQCM    MKKLNBWADYG     YERA           
VMTTPX          : FRQCTWUPK       XGEHVABFESIBIO  KIYXVAEMNYCR   
NCOVRFGUVWJL    : AMJYIWP         UTBQALTCFKAEEVF YUOSVAHCQOTCHM  GIGVTQMH        JSCIASCRNK     
OKELHOYCYR      : ONRLJLBV        JBQYVUATYXKLNP 
WECRTAT         : PLRKVTPB        IABKK          
ELIVQ           : PLGKJQAM        HBMQDFI         FMMCCUFJTI     
SOPEAASLFGSVHX  : YORXLSRNK       PKSXHED         DLCSHOAUFE     
YDUEFOAIKMMXULO : GTCIRRBC        EQSRWEEDVE      MTHCUERRDTYAC   JXKID          
EFBLGEERL       : RRBERWGIIFUTO  
MJUMGUS         : PSDLGVXJGA      RSNGOOLP        YRYIELOMAUVWVKA BTOIMNM         DORDQ          
YXTBI           : YLCJUGXSGUDOJUF EXDQSVIWHLUKVQ  GRBWFQT        
OVDLJUX         : WAJPBKFRAUELL   HBYAGDTUG       OQOPLDYRWWJLUKQ WGQXR           VLFIDAFXPNX    
ABBGHI          : VLLOY           EMIXU           RCEXBFLMG       YPCHJVXCHHIQ    WMGEMJUD        KMUIJNVQHAGXXH 
SVNCQ           : EDPGCP          TQXAPVAXEADTH   UWPAHCPEXFNDB  
LLUQMVNQESFC    : WVXRQAXQPNQLJ   SOFIYLQBTCKALQ  UFMMEDUBNCBUT  
QLSQCVSF        : DXCUVPGEDW      PJDXEYF         YUQURHUHAUCSS   CFWKC          
ANHVJUABYNOUF   : URPPLLQ         QMRODKJ         VOHRKLPCO       DXKPMABEAWW     MLNBKLTE        WXJFDOXGBCJCFFO
QSUWNAALSNH     : RPMR            CWDGXRTCDD      XKOY           
PFFVLFJSD       : CEERVOGDJWD     NYPHVBACLAMJCWS FNFNPD         
PEWP            : WVXRQAXQPNQLJ   GVDV            BSQW            SMWVLFS         XROBCQTEDG      TPIGJKB        
NKYR            : QOEDSCCBIFW     CPSUMI          CMPUKHWNPX     
TMAJOAXIOFSG    : MPJH            SHTNAGT         SKYXCTOKYFTNTY  GXECEVVLHYTJTNR MKHI            LBKILSWISCJQOCC UVGLRNORUOJWE   TAFJACJ        
XEXFORLKH       : FGXNMLB         YQKHOPQ        
JWLWJL          : TGBYMJ          HTVGNGMUF      
MHENRVPPG       : CPEYNAVNWLAJK   FYEPYKCLMIV     LUKG           
WBNLYRJG        : OXWBBSIHYRXRJ   RRTIKBR         YQUVJDCERYL     MKETIVIOLVAQWT  GQOD            APUU            QNUNCHJVW      
DTSN            : QLMMUOAIUBHKAE  YLCJUGXSGUDOJUF LHNSRJCRBVNDKI  GIGVTQMH       
EMXCWLTLSAYM    : TVNQYJRV        JIGXUH         
RCEXBFLMG       : GRMFLFGMHY      RYCS            ABBGHI          EXBAFASIIVCBINV OXFIMO         
YPMCJIP         : GRMFLFGMHY      NVYJUTYBNFXNTUI RJRFXTOKWIPONGK EQHREHRHTX     
MFTOCFKNA       : JDOMCQX         LGQAIFGBNOFWOU  VEOQDOLJQVWCLV  ELXVSRDBIDUFE   VAKEEEFX        UFEMLAPANAOSSWU TWJPYSPPF      
PNLJRQ          : MYVRVQEJWDQN    OVWPLD         
VVTIFXJUMOEUGC  : EGSGHU          XDTBCNSF        VYGHNFKYC       LGUAXUVYIAN     GXTWAOLQRPSP   
LVYNDKEGAVT     : IQQWYDLLKWP     CIHUFXODNDYO    HKAJDLWWCTMQNQ  VXWKH           VMSG           
FNEOJD          : POWNVBFGNHSBQB  RUFLYFG        
UIIEDVUJQCMB    : HUISCUKYS       DHCWTHEFYM      HFXEIQWJBY      BVEYCXQIY       FSWDDVS         XMDJ           
KBEON           : SOAEQIMKYAIAKC  UGLRICLDCMYFF   UDPBUMDTPGQ     ISXKCYDDJJQ     FQBOJEUOPSJPQ   EXDQSVIWHLUKVQ 
UNIQBNEGCQ      : KVGITDHJSE      FHAJMMLNTGGSMG 
NNRVRWTNINRUOF  : HVDA            JVOYUTAFVBAO    RIGUYBCHVCBBYVP EJFUFLN        
RLWF            : XDTBCNSF        JGTTYGSVKYJV    QXKNX           RPIOSDOGFCHT    PIGDOQF        
TUGMWVSF        : VVKP            JQAPP           BTLHNCH        
JOOWIMRHHH      : DYJNVBBFYJMEL   VWHJJOKITTXC    GEIWMFKWKBOWVAH YORXLSRNK       UAVAGTJRESBM   
UYNLGVEUU       : YORJEVCBG       BKBBWRRQBUDW    NVXVCVRAX      
SOHAB           : OUAFWLOJVOBJO   PSGMAJICYQP     CSUHJFFKO      
VVLWGC          : HMBQEPFQVYMER   PIGDOQF         SGKWIWAI       
FMBYVIGLF       : MJWHEGHHVTVNV   PTKT            JTSDK           ABDSCLS        
BSQW            : ESUHVDYCUDOH    PEWP            JMDOYYCUHWDKWI  TILBISQNOI     
LTJGISGL        : FJJAYUUKUKIY   
DIMCQQOXDRXBAGM : UBNYORRXA       NHBCNMTYAAW     UWHMARPWUUCGN  
OQAHPAS         : SHADDJVJ        TBQQRBPMTOX     LHNFBM          EHOBCC         
LBUEIJFN        : PTKT            PDPUQXQ         CPSUMI          MBNVQPVYH       GQEC            MTIHFGQSNQ     
TPKMGI          : MRBONKXDQBOB   
XISX            : OLKYELHDCWHKOT 
HHGX            : BHEPSRSFA       IOGMTXFRVM      PUXRKXK         GRGNVWS         YKMI            DHNCTCR        
NOKIBV          : INTRPLPOTHYUMGX SAPMTWLIXOTQ    RKNSUQMCHNKQJBR RUXVSX          HLGS            ONWIBAVBEIME   
VCRF            : SFMXQ           RQWLQYKVXMWOBLI GBPKX           TEPLHKKRBAQEQ   QKPMBBIW       
FYFXJREUJDFED   : HQEKUWVUQLDGW   SHTNAGT         VHCHVFFVYX      IWEPPAYNS       SHPKXHJLHPVRO  
LLBMXQBIYCG     : NKNPYE          EVWDXTWLNHTLCJ  LVNKE          
AIDGRLFW        : THDRVQR         WWIGNJK         PEUVETTXHLEPGT 
RQNOCQTGWR      : BXAGTOSIY       FBQJNHLB        BLNGDYBKBO      TXBR            GDFK           
IUEGM           : ALIPKMHWUDVFHA  IVRGFWVRO       DWBHUEHMWQWA   
QNLW            : NYPNLB          ROVUKVJWMYVF    VNHDVKEDLVRJ   
MHDUBQCAAVQPMS  : PWDTMVJRHIOIC   EQGPRIPSHUH     FXKWINPJNM      EDCDLKWEONMPS  
JYGBS           : QUVKVXC         EKEQF           RDVUYQKM        GMDAVFRNXEMFX   NDIWUMOIGPCRLUC
VXWKH           : TYSGAHTTGNK     QSEXTMXE        LVYNDKEGAVT     LEXQKWROFGW     NYPHVBACLAMJCWS QCJILCBIN      
YTOXIVDFWTHWVE  : KOLJ            JHOPOQAIDWFNV   NQHYD           NOCBPUXSGSGDS  
MSIXCJEDEUCET   : FKBVHDDGQSRNJT  DPLU            WGWT            LHNSRJCRBVNDKI  BHJL            YKMI           
MJNIXOQTRXS     : VPWWJ           RIHUOSAYO       LGQAIFGBNOFWOU  WLWGOXWQRLRGDU  ASRJGSON        FSXMC          
FRKLJYFTWHDBN   : VVKP            YGFFDRCEFQU     WHRYLMGWGOQX    LRHICHCWHQBHGK 
VPMREBBUJYJCUBA : VXRRO           VIOOK           WHXDRRQVOJKI    AAMBDSPSJENQC   PMLUEN         
PHJDTSC         : DPRYIRALBV      TGBYMJ          HIEDQRCRGYINJQ  BCSYDGSQXQDA    QIBVGBUU        TIXELMCGICDKCRV XROBCQTEDG     
MAKRDXC         : DWPTN          
PQTWRV          : NXOGJJNHDFR     KDNFBUKGQDUBON  XWAQRD          LCFVE           BTIYA           QAML           
DWBHUEHMWQWA    : SEFRS           MYSLDCPF        IUEGM           CVLVHIWMVYGP    TVNQYJRV        DVMWPAUD       
PENFGYWKYY      : LLACWXFVUS      AOAPS           KVPIMXMSWDIUE   TUAKXNFWFFEJ   
PPIMJEGMEJTBN   : CHATTIBEAIW     NNWFAYAMRCPPSFR IQPBPBKCF       TAWQVEOPLAGD   
NMUKOJDTXIAYHMA : SGRH            JYFCCPVIO       EIPJHLMOXC     
YRYIELOMAUVWVKA : JQAPP           MJUMGUS         RUKUIVUIPJLTPHX QRAGEJOGUP      SERPRL         
YWWOHAIHK       : HVDA            LAHIMNGH        KMFMG           IVFENJRNMIIUSP  WHHAJ          
ISXKCYDDJJQ     : KBEON          
WRTSO           : LBRAXVHLPJOCB   AGQDLB          NRCFMCBH        AJDIMDWCKT      NEERDRGFPR      KMOCWDAJV       QSWIUFQIDUQGMBF
FQDFO           : IBNVKECOBCR     PEIOXBCJJLM     PJQSAQLWBFEBTA  WKKK           
VXDGHNQRIQCM    : CMWYWIIMROVPEB  OQOPLDYRWWJLUKQ ELXVSRDBIDUFE   ATVAVYUKYHVPA  
FQAPJBOB        : MXUBHX          PMEFBQEATBSTH   FTBP           
HPOPHRWXRSX     : FVVSWDJEGKQKGJF WGNOHQMBCDYSXKO AMTO            SOBKSUICHUUQAJ  SKNMTAIL       
YFLRYVJBJAJ     : GVSUMFCFNH      CDMTWUNBE       NMJDDFGTLMJRF   AIESLEJUKJL    
CBLE            : XELJQSAE        ETHTIOUUIHV    
NAYFQOOIL       : DHPNONUMC       RYCS            RQGFABXFR      
CGMAFTNX        : CGHCVXMHNLCSVBE FIAICV         
JJWUJGWNHJ      : TENQFUO         VDEWUVLFJNOLCQ  IPARMRFOEYISFT  SAWNAFRUTXE    
YYTAEKRVUFKAMXC : TGQQIBLJXYGA    OKMHORERP       OLHTKQB         NEBPQFCCWNL    
RPRN            : CAJT            BXOJARXEBNGURAC WTTBQDCCHMDH   
BKWMQV          : BEJCG           QUVKVXC        
AHUBG           : OIGJFUXGYBRAF   MTMULDSVFCRL    YQPVYROLNYMQHM  WOUYWTG         XTUEJXVGEGCAHR 
BNCSJXYVXNT     : UEVWIOJWC       KPPLVEECUPDQV   YNINBTYKPUKBX   SPFSDOCTFB      GMDAVFRNXEMFX  
HORACUDOTSHQVH  : BRXBUM          PKDOYGMFHKRRHN  YGFFDRCEFQU     UCXWBVI        
QKHILUL         : UEHIIENFCVVNSXF UWFUKKJ         YAKE            YLLLJSPKXI     
GJICJVYNDPFFTC  : WCDLX           OSPCYGFNFCW     KMTOEGWEFVL    
IWEPPAYNS       : LBKILSWISCJQOCC FYFXJREUJDFED   OIKJKAXPG       JWRNYKRRL       HUYYRKNCJQO    
WCWTPGABOFKKGX  : CWVMCLDCBADG    IBYNYIF         RLNC           
XFVRJHA         : OXWBBSIHYRXRJ   EGSGHU          BKNXLOO         QBJCW          
NRXPQMJCLNYG    : KVBBFTCWN       PSDLGVXJGA      TAYVXR          HFSTQYG         MHYDMBTHYMPTUS  KYNK           
GIEW            : NWVEMG          UCDSSRKAYLUIU   MSIMYAUXSXAFBPD KWCM            OMPNW           DHNCTCR         QQWMQFL         HVAQNPTTVF     
QIVQBTXYNHJNQW  : GTCIRRBC        JJAU            BFWG            BRISOUEK       
ONXDY           : QASFLPPIPPMEUW 
POCVRIGXFWOPS   : RHTRKPDCDDXFICC NBOXWFCUOHWVBM  UYYLLQCDDWHTN   VCVLKGFHJWTWUF 
SPFSDOCTFB      : RKNSUQMCHNKQJBR VOYRAT          BNCSJXYVXNT    
WQCARERGGP      : JIPAAFPO        RKDOQEFKAQ      YKMI            HEBLYDHH       
QWXYTOQOV       : MNCFWVVWEPDJNG  HPDTERYLJNAWIPC IIQSS           LDLL           
GDFK            : YRYXPSKPU       CQFHBLOLCBR     MXUBHX          RQNOCQTGWR      SXWJJDOSTFR    
JGAKJ           : PMJODKJW        JVGJBIGQFU     
ELXVSRDBIDUFE   : SHADDJVJ        FOHKSRHCDKUV    MFTOCFKNA       VXDGHNQRIQCM   
BUMRRYYWGL      : TBLA            IQQWYDLLKWP     OIKJKAXPG       JFXFPHRJM       AILAKCK        
PTSDDPJRPFMIKN  : URQWMJSYMSNTI  
QIXUEBPTSJ      : DXCUVPGEDW      XLQE            UILVXJRSVDKL    WJXVI           VLFIDAFXPNX    
TJCHBRBTWFKGY   : YJMLIXSLSMN     RXPHIQOCEI      GNBGOMRRP       ARQBQLFC       
OLKYY           : KMVUWVNM        RPQQVWIF        GPWJHJCMLKQW   
RKDOQEFKAQ      : PPLFNJ          WQCARERGGP      BIGHXDOC        ORVFQIRMEKLTB   UVCBGF         
VAKEEEFX        : OMPNW           MFTOCFKNA       QNUNCHJVW       PMSEYFCLHPUFWQ  NANNDLNICLBPIBC GHMOFWPDGL     
MKKLNBWADYG     : BFIAR           UBFXI           OSQYEQ          SEJBWOQQPFWKBYS HTXA            OQOPLDYRWWJLUKQ JQRKFISRBORHWPY QWFWWWUSLGRE   
MKKLNBWADYG     : KANGDNIFQHQRP  
LJKCQ           : LTYOMQO         ABXJAIMKPLOW    CRPYREBRMMAJRJQ SMHCHHYUJHNEBLK AEOISJOAFE     
PSKXOLIS        : IDVHOUVTLCTA   
MBPQNDEASFYSIA  : DXBJA           YMYNHYVGJ       GXIVAFVCEOLNS   VGMYWSOWAJDSY   BNSFSTHDIGGDW  
GLNQ            : ATMGQYSBQMITY   MFGRPY          LVGYXGLCUCUMFVS DIJMDDBL       
EIGYSGPGQLXDM   : SQDXJUADBCLQN   JAJSNLVCH       EOYUDUWQOCN     YLLLJSPKXI      YNXJGCRV       
WAVDCOIEJTE     : HGLNJOS         URHLRUHHHAR     PKSXHED        
AQYSHFBPEVVTF   : XFKOUXDBIAS    
FDTTVQWRTYGFDQ  : DYOPXVVPIFW     YPJBJUQXGS      QWIE            KVBTRJNLLILIVS 
KEDBDVKIYCO     : SEJBWOQQPFWKBYS LAPURBDSURC     AEAKRVMB        EVGYCVJF       
AIAOQGIKCC      : THTXRHA         JIGXUH          KXGPQAPVE      
WXJFDOXGBCJCFFO : GRASFU          ANHVJUABYNOUF   UUAG           
GQEC            : NAHJSTD         JVFAAW          LBUEIJFN       
PEFGKQSPSDMQOR  : MPYIGJQMS       TKUQRBKBXDKV    NPYVTLVWYSHE    PAYXVNRCI       GWVSTWFHISD    
FSDHUPJDUBSERX  : ONTWWCHOUDUED   URBTFXMSAKSANY 
LNKSVVJQNCT     : SXCAK           SWETP           WVOIUTQOCF      LFTYGH          VUOGXKKPAEDF   
TITQOOTVKJHNHK  : TGQQIBLJXYGA    ELKNFDQGEP      MIGGWIFWYMGINPO
LDGTQVGJTETLR   : DXIDUMSEPRHVYU  WVUEYAJALAML    OLPOTLOYJSE    
FTRQQKHFHFPS    : BFNNKBSMDSRLY   UDXXII          OQLUOU          MCDJQFCSPIB    
FCAOPFUJVTQHNU  : QSRPVDBKCYRQN   TAYVXR          NQHYD           SCMMSBOB       
YPCHJVXCHHIQ    : IDAVSJ          CHATTIBEAIW     KHNNMVLRH       NCSWQRREUWWCB   MVYWXDY         ABBGHI          FXIUYAAASOO    
AJDIMDWCKT      : ATJDKUG         XRYJXGVETEPRHK  SXDN            VVSQI           WRTSO           TQKDPUSNLDDQNLI
INHQEETDT       : WAFDNAEDJC      EOTNOUAO        DVQK           
MGUMIETSUIV     : BEYVUNBHGPNLULN SLLRFLCWIAD    
MESRBXDWO       : VATMTFVNHEGAHKJ PGQU            BNKP            VLRMXMAHHMYTNL  MIBFKNUGQJJGKM 
NVERAYWWYKF     : WRLMXVMKQYQWU   URQWMJSYMSNTI   RYUCMNYQ        DIJMDDBL       
WNATJWCFGQJYJ   : HLVMEOBOCUQI   
YOJNAWLHQOGONHB : DYCGTQHWOYBLPSJ TSLSXIUWN       BFFDOGAH       
EAIGTRG         : DYAODFCNHNPL    YOVSUCPSNSYPT   VWFHUMSPCGM     QIODJQLNEUAUYP 
YMRKNBWNRJ      : YLSDU           AREN            UQDR            GLIJ           
UIRCAGKQTRTMVT  : QRBPNJXYVKBQY   LFTYGH          WGEOLL         
FQPLR           : ATJDKUG         YLBUPMNA        YTUHOW          CKQLPJJIYCOAMU  OGDUWHFQW       DMAGBJ         
XJCLLYBFKF      : QBIHQOAF        SFEICSTT        OIKJKAXPG       YKLWOYE        
TWCV            : QASFLPPIPPMEUW  JCCVOMLJECN    
MMYHINFCKK      : MOJTPTFUAH      SCTVNYYBNEHBJQP PEUVETTXHLEPGT  NWRC           
CVMTTWVI        : PHOMDJHGJNIQH   BBXXKNNNOD     
WJPIQQE         : XYAVYUMJWEK     MOJTPTFUAH      LIOMMUUYKGLIBO  RGISOYCT       
UAUIOVRWLWBY    : OXWBBSIHYRXRJ   UYII            HYJQANMYJEAUNIS CNGOTCSJGQQ     SUCDMQJXUISI   
WBGJUDGSLQQW    : DYFPDTFV        KLCJPHYUCYERP   UYYLLQCDDWHTN   KRSOJMBUNS      JXKID          
BOAFEUHCFVA     : SGRH            YYNNBPC         ATVAVYUKYHVPA  
SMWVLFS         : INBTU           HYPX            PEWP           
NFMQLFEFXCOY    : CVILGJG         NAGXXWWNMTQDOXV VVLEJUUVSHBCVBR XBTTFFNYLA      RLYIIFNFMOOVCM  MIBFKNUGQJJGKM  TDDIJO         
QEWNLBVJCUEQ    : QJHKRTJXQADXF   TPUWBBIIB       WAXJMNJXN      
BEYVUNBHGPNLULN : MGUMIETSUIV     JYUFCCDGTUQRY   THMYAGDMHMOD   
NEERDRGFPR      : EMIXU           CMPUKHWNPX      XFKOUXDBIAS     WRTSO           QKPMBBIW       
LWCD            : RJFI            ONRLJLBV        XBAFMXSQ        IIQSS           TADCECKSKVL    
IFVDUXLBNBMIM   : BNKP            UHLN            HEYDONYYYOUPW   LDLL           
VAGAUMTDTKUDXRH : IBIJQUBCM       MCONXWQPBYA     OQFMRPJXDVPUX   MAXHLHUDJHJPX   GBNMBWANHTGCPR  TEQLAGAUTTUOEW 
RPIOSDOGFCHT    : NKMDOJCEWVOS    MMYKVGJFDQID    TBGPWYYB        YGFFDRCEFQU     RLWF            QVXQTMRHYH      GLIJ            URBTFXMSAKSANY 
RPIOSDOGFCHT    : GRVFQJRVBAFI   
WUIYDKTPGYJSUO  : VPTYXVF         QAGFEHTSPHRYPI  LWHVHWJAOB      VMCALFMXGCUBI   NGIEINBTXGYCWHH
OXUJND          : ISVMBRCALXUS    FKIMNFQINI     
JHOPOQAIDWFNV   : TENQFUO         RFBJUBVW        YTOXIVDFWTHWVE  CBXEVOKPCPHOC   PQXXKWQGRE     
ASBIRNCOESGDNP  : PGQU            LDCH            BDTAPVXE        YFPK           
TPCDEURWUCCRIPP : OHDPNPAXEN      PHPYDD          FDVQRB          AUVIOPYAPHGAWS  WBYHEJROCVAO   
RIWADM          : ONWIBAVBEIME    XWAQRD          EQHREHRHTX     
TRVAWLPPFHUILP  : FCAPOKHIOY      UDTIPCGOAO      LQLQL           JJXYO           VQEYAWTFMA      HEBLYDHH        DDEV            ASNODCCVUQGT   
TRVAWLPPFHUILP  : MKQTQSPG       
KMFMG           : YWWOHAIHK       QFTKJW          INYHHSIA       
CVLVHIWMVYGP    : SYHKRB          QIRWMVGW        SLNQQUN         ALAGLY          DWBHUEHMWQWA   
HMLY            : SOFIYLQBTCKALQ  JSCIASCRNK      XMSQGUY        
SHYE            : BXNKA           CHWNKUTJBTP     XRYJXGVETEPRHK  FWYYNOLTUKBN    PSGMAJICYQP     YUUCIDWBGBXHHUN DAPYVSJGEOK    
QIGDNSL         : UWFUKKJ         KVVIIPCQUJS     NLUSCWWOGC      AYKMSYNHTTJIGFS
XIQT            : VLLWWFCWQRUTT   HKAJDLWWCTMQNQ  KPPGSLVTIGMWX   LAPURBDSURC     URGAXUR        
CSEXSKPR        : RUWXSF          BRQRXYGYBKIMWX  YOVSUCPSNSYPT   EORLUMVAGQJ    
CFTIBBIF        : XLUN           
BNEHEXSJXD      : GEIGJYQAOKYWJ   FBACFMIUNQKBKCS
RUFLYFG         : FAXOETCWC       FNEOJD          TJTWJCNLVCDCQKD KJCBNGC        
UAIYI           : RUXVSX          SCTNXSK         LVNKE          
HJHR            : SROQKDYKVOJY    XBTTFFNYLA     
GTEKDKKVWICADWH : SSHQ            QCUISRLVKGNW    VUUMLOM         JMLBEUS         TQKDPUSNLDDQNLI
YMYNHYVGJ       : LNDDQ           HERFQCTHCU      XCVRXXC         EQHCJTGSKS      MBPQNDEASFYSIA  VQJVUKKA       
NSIIJQ          : QSMQJEHKC       GWFOWDWKIR      AUVIOPYAPHGAWS  WGYBKYUCIMR     XLGOI          
QCHBM           : BCLANSPTWAT     PEUVETTXHLEPGT  BRJV           
XXHABFHRGTST    : UMNHJIIMXPK     UDPBUMDTPGQ     NLVWAJUUMP      EDHHJTRIAYEQE   IXXKDHKHSCLJJ   FSXMC          
RRJEUAYGIJ      : FYTORVCVHDF     AUVIOPYAPHGAWS 
MCYVDOBEMJE     : SXCAK           JMMFKDNL        DKTTOIFERNGVEFY TDDIJO         
QMJWICQMV       : SRCYOOXDKHRPI   BRQRXYGYBKIMWX  ITTASX          AREOIFYNHRM    
XAGAAMKLJ       : AMJYIWP         AWPFO           OSPCYGFNFCW     TSLSXIUWN      
NLUSCWWOGC      : NAHJSTD         WCUO            DJNTWMEXOB      QIGDNSL         FSWDDVS        
YQPVYROLNYMQHM  : RITNCEXIGVQWMLQ AHUBG           SUAMPKGBRDNR    UWTSFLFJC      
VXEIWRT         : HPDTERYLJNAWIPC DVTSIVNNFPMT    FGTHOBI         IJSTWW          UMQMXN         
KVPIMXMSWDIUE   : WMKBOU          IRMSUKCLGBLVWGM PENFGYWKYY     
JQRKFISRBORHWPY : WQEEJYCWXIIBW   MKKLNBWADYG     DOQTMOAYFFLT   
KMOCWDAJV       : WRTSO           YKHKCVLEEI      DMAGBJ          CJLFDPNHH      
OGTSKFLDPQNK    : FAPAYKFQTYGVF   TBLA            GQOD            GJOQKRHMGEF    
RADYYUB         : JCCVOMLJECN    
FPJHMP          : SPPRYD          GTBWBXORMGPOO   QDTLFRMLLVF     OFGNEHMPTHOJRJ  DEQPQYHCTH      RLNC           
XLKOUG          : MNCFWVVWEPDJNG  EVJFYTGNABUSAE  QOODYRBCJ       WPRAEDM         KAYFHOCTCBAI    JBOOAXPMO      
HLVMEOBOCUQI    : QBIHQOAF        EMUQU           YFXHOTD         DHARPQCUTSMTQT  WNATJWCFGQJYJ  
QDYLLOWUDMHBBR  : TJTWJCNLVCDCQKD EJFUFLN         TBPPUYDXJX      OWRGQTCH       
XBAFMXSQ        : MFHC            FYEPYKCLMIV     DVTSIVNNFPMT    LWCD            ANTGEMSDS      
VGRQWCOPHODS    : DYCGTQHWOYBLPSJ GBAKT           XJDDQKBSPHN     KMTOEGWEFVL    
BQJNXKQRDOSFUIF : FAXOETCWC       MWNQJPBT        AWSANHDR       
BTLHNCH         : TUGMWVSF       
SYXHDSNEJYTJJLE : JYFCCPVIO       AIESLEJUKJL     UYHE           
AYVWHBMJXXSNCCG : TSVKYICTGOY     SEJBWOQQPFWKBYS SACBTTPHUC      SCTVNYYBNEHBJQP SNTYFTATUPNSDQY
EEFHYUNLT       : XSAVQFJNXGL     DYQQPYPPO       FAIP            GOGJQOL         FTBP           
UGUBUX          : ESUHVDYCUDOH    TUOFDF          SAWNAFRUTXE    
RUKUIVUIPJLTPHX : HFWDXNDEJUTJ    AQGICUYMMIBSNH  YRYIELOMAUVWVKA ETGXPJCLRXBP   
MFUKUGEFEK      : AAIG            KLPYU           VEAXFGRKY       RYCS           
FIAICV          : CGMAFTNX        MHYDMBTHYMPTUS 
WGPSOHCAETJCPY  : VPTYXVF         QRBPNJXYVKBQY   OVWPLD          CEERVOGDJWD     FXIUYAAASOO    
KJFTNKABNHJN    : NLVWAJUUMP      MHSGHKGUICP    
LLMK            : MWEJCLSQ        KOLJ            GOKWJNPWWNXUBY  TCOQ            QWRWLDTK       
EDJMHL          : IADTDHK         VGMYWSOWAJDSY   DIJMDDBL        DACABVLYIRYANRC
BVUSUHG         : LCQXYGS         CVILGJG         GDFJPCGCCEX     DYJNVBBFYJMEL   MEGSXFVMISTIE  
NAVACWPJ        : LIPKYCTU        PSDLGVXJGA      CKIFUXG         KPGJP          
EATRO           : QJHKRTJXQADXF   IWHHGOIDQYWUR   RPQQVWIF        EQHREHRHTX     
KTKVIUHBXDXR    : URPPLLQ         PUXRKXK        
GXIVAFVCEOLNS   : UEVWIOJWC       MBPQNDEASFYSIA  KVMALGWGTVNRTOX
JMDOYYCUHWDKWI  : BLNGDYBKBO      EMUQU           SUSLATUUVYXX    BSQW            XAEDB          
OLPOTLOYJSE     : JTPHIDHTRFLTWKT PKDOYGMFHKRRHN  LDGTQVGJTETLR   PNGHT          
FTSVDGYUF       : LLACWXFVUS      KVVEBA          UUFFSSNJN       AEFKGBAIGOIVHMV
WBIVG           : TTDFEG          UHQDUEHE       
SQDKCU          : OCTS            FBQJNHLB        IPABGDFQH       ONKUEDOJEMB    
WGQXR           : IBDAR           OVDLJUX        
EQQXLMCRO       : BWTNPIHIYSYS   
XPVBARJTMAYWFT  : SUKFHDAUBPP     EHPQGGUR        FELPICOECVMM    LKVJRHE        
CCNCUY          : SEFRS           IMSYM           UBNFVJFQURO    
NQHYD           : IQQVXMWGTRLQHMC OTHOCYOD        YTOXIVDFWTHWVE  FCAOPFUJVTQHNU  GMDAVFRNXEMFX   HEYDONYYYOUPW  
TTKTJGUKAGGNG   : KWAKUXUKWCWXDV  GEIWMFKWKBOWVAH
KLCJPHYUCYERP   : TEJRSYALWQQSI   SEBAFMVBKNQ     IBIJQUBCM       CHLIHEIKRWYKIRV WBGJUDGSLQQW    XNRPAHK         FYNPSUDYKAFL    YROWQHL        
KLCJPHYUCYERP   : IKHTSAV         AIESLEJUKJL    
SUAMPKGBRDNR    : QHDDQRXVHCQVFKM HUALKQSTV       RSNGOOLP        YQPVYROLNYMQHM 
UHQDUEHE        : LYNTHMFBNYDBBO  BQED            WBIVG          
OGPSFTKWH       : OMTTRTPEXR      PXGAPLRSSBFAG  
THSLUAP         : BAFRQYLOFP      JVQYXOM         FWYYNOLTUKBN    TFTLGPPXYVBNO  
FDGPAQIF        : LUKG            CPUTWIRTECTW    CRPYREBRMMAJRJQ XRPJPDKASHELSE 
MNRHCXYVFUIEFO  : EOYMRW          PQUMIWGVBIFJ    NQERXTYKRSGE    QWDCWHBHJLVT    RYUCMNYQ        URBTFXMSAKSANY 
OIKJKAXPG       : GHIXXYME        AGQDLB          IWEPPAYNS       BUMRRYYWGL      XJCLLYBFKF      GWFOWDWKIR     
FGXNMLB         : HPLLQMPRX       BDTAPVXE        XEXFORLKH       KMTOEGWEFVL    
DKECMC          : TEJRSYALWQQSI   XLUN            KSLHLPSJUK      HEBLYDHH       
HLMOANEK        : AUTCIGHO       
NUDOLJXQRVHGJK  : UUFTLMNKKYSJXLL MYSLDCPF        FXKJLEMOCTEXIH  AYKMSYNHTTJIGFS KXGPQAPVE      
MWNQJPBT        : KWGORIXDUHM     GVDV            BQJNXKQRDOSFUIF EVWDXTWLNHTLCJ 
PIGDOQF         : QTTRO           KPIDLYUPHDQOBO  RLWF            VVLWGC         
MITXTRQM        : UEVWIOJWC       OFXPUTCMOCNM    EULQ            SFTFGDQ         RBVOHKO        
AUYKEN          : QOEDSCCBIFW     HDKNFPBEIIWM    BXPRELJCU       ALUCTXTNTPRQ   
TFTLGPPXYVBNO   : AQLVLOJIK       PAIAPMGXFCMIVQ  LMHHO           MYSLDCPF        THSLUAP        
SBRO            : TOJVXNHNKCHU    CJTMKSGQBH      KVKXCLONKI     
LGUAXUVYIAN     : ONOQK           UJAARDKEVFHBSNJ BLNGDYBKBO      IFWCHNEM        QWDCWHBHJLVT    VVTIFXJUMOEUGC  VQRU            VOJSF          
TUOFDF          : UGUBUX          GBPKX          
BGUEVKMR        : APVKDVRRRJGWBN 
EGPSPKSPHOPR    : JHMIAPMXOKO     EEIOBOVOYFKGWVK USISYSJSYJV     XMPDSJ          LRFFRQ         
FMMCCUFJTI      : USISYSJSYJV     JFPQRRVE        PWLDDOYGJS      ELIVQ           OGFHNIWAHXUCP   JISCWDTLQAPJS  
PMPAYH          : TAUCYN          XCCCPICLQHJGL  
GQFYIRTXALPT    : GHIXXYME        KVGITDHJSE      EQGPRIPSHUH     QOKJQG          XCCCPICLQHJGL  
WHRYLMGWGOQX    : FRKLJYFTWHDBN   SHWPLXLRMOTIV  
GADOOLHVMPOGP   : XEXDVRY         TDKLPULIRGJEDW  YLFAGWWXRNTT   
RGKWFTQFHFLGL   : ISNQWLDOXRLMRV  QANBQTE         SFXFOREAP       IVNEHNBLS       EQRXVRBL       
WMGEMJUD        : CRCK            ABBGHI         
CAJT            : RPRN            ASTGPRBJPGSX   
QJHKRTJXQADXF   : QEWNLBVJCUEQ    EATRO           BLHFHN         
HTTEGDIUMFY     : WBYHEJROCVAO   
HBVBRONBAFUJDNM : IOGMTXFRVM      RRBERWGIIFUTO   HTXA            RLOHTIKN        FRGYSVINTEGTHVQ
MRCTLXATBJ      : KVFXGOWR        DXCUVPGEDW      WAGCN          
QOODYRBCJ       : UMNHJIIMXPK     PPLFNJ          KWCM            XLKOUG          VWGLQRJGDLA    
PKSXHED         : ELKNFDQGEP      FVFQG           SOPEAASLFGSVHX  WAVDCOIEJTE     KRFLGPVFXM      TPUWBBIIB       MFCNCNHGCUPXCPL
QOKJQG          : QTTRO           NKJVFPK         LPBY            GQFYIRTXALPT   
QGRURJLJXQIRTM  : MPYIGJQMS       UYII            EHOBCC          KGKT           
KDNFBUKGQDUBON  : SIACPPPNXNUMM   KLWBKU          UCNTTA          PQTWRV          SHWPLXLRMOTIV  
MFQGAI          : CQOEABML        JFEWYKVRCLXDNTG BMSM            HEBLYDHH        KMTOEGWEFVL     BNHTNPKSSPAJM  
NRPGCHAPKNUXU   : LGSCTDTDGHEB    UCWPBRNCCJ      SOBKSUICHUUQAJ  LTNTX           FJYORWRX       
UFEMLAPANAOSSWU : YNINBTYKPUKBX   MFTOCFKNA       OTBUIGE        
OKVE            : FCAPOKHIOY      DYXPRXLS        SUQAIQCBDHQ    
XNRPAHK         : XFPOCX          KLCJPHYUCYERP   VMSTRVXHEAS     LNKAAERLKBVMC  
CITKNIVPAXDCPYU : OHCTNPIIJJOAY   NRBBUGPVMB     
VYCHUIXU        : DWPTN          
RNYBXXEJTQYEOO  : XIRFV           UOVSXBPKWTD     VOHRKLPCO       UQDOQBGICS      YPVQAVJOYLFVP  
MTHCUERRDTYAC   : XVVUXKELO       UURAP           YDUEFOAIKMMXULO OLHTKQB        
VBTJBWJBBSWT    : RTCWSRCSMPGTJ   PIMYINTRJJM     HFJKA           TALTYGXCRND     NVHLUT         
BIGHXDOC        : SUTSDNUTOJJHKM  GHFU            PTSQWXJ         EIJJIV          RKDOQEFKAQ      JISCWDTLQAPJS   CSUHJFFKO       AEOISJOAFE     
TTPYNQASSVV     : VMPGRVPDVPFMC   JVOYUTAFVBAO    CPMRIFVESJPXW   WPRAEDM         AYREJNBPBSHKBK 
HYJQANMYJEAUNIS : MRVCHIDBWITO    HBMQDFI         UAUIOVRWLWBY    KPGJP          
YUQURHUHAUCSS   : OIBWVJICNEPYE   QRBPNJXYVKBQY   QLSQCVSF        LXFTLVCY        XSRHPOTKPVW    
HAXTSBHHCSO     : SPPRYD          JYOLI           JGIH            WOUYWTG         DQLNELYHXEC    
NENGWOENMX      : AOMWCQUQ        SHADDJVJ        VYGHNFKYC       BKBBWRRQBUDW    EXBAFASIIVCBINV ATVAVYUKYHVPA  
HFXEIQWJBY      : NOWWNYCSGMWAM   UIIEDVUJQCMB   
UTKECNWQSLU     : SXCAK           PJDXEYF         IPARMRFOEYISFT  CPUTWIRTECTW   
TTWAHJXF        : OXWBBSIHYRXRJ   RJFI            VGMYWSOWAJDSY  
GFWQ            : NXVCFCTGG       JCURSH          GOGJQOL         ROBXCCL         CJYUQPAFTCDYAIO BRJV            RASODSS        
TAYUJ           : YSXIHAKQMRRNLOT NKJVFPK        
PUXRKXK         : PJPWARFHAIWONT  HHGX            KTKVIUHBXDXR    BJECQYWLECHWS   LNKAAERLKBVMC  
LHNFBM          : QFDYDFCEGXUVKB  UHLN            OQAHPAS        
IYIPRQUPHTLHSH  : XIRFV           ASTGPRBJPGSX    CJLFDPNHH      
NYONQYLBE       : BCSYDGSQXQDA   
KRFLGPVFXM      : WCDLX           WELJVQWYFJXKI   SWQJTOUYRARSNK  GJTYEHJ         PKSXHED         ERHOWXFVTOVC   
PHPYDD          : BXIXAADQQL      TPCDEURWUCCRIPP YKMI            PPHVCWDCRMI     QCJILCBIN      
WKBMLRCCS       : CJWLH           NWJLJNIDJXNDNN  NOHLUBQHJSDD    FUFKSSSGOD      GTQPOHMO       
FYNPSUDYKAFL    : KRINQKCTPHIY    KLCJPHYUCYERP  
DDVUCAXLY       : JDOMCQX         EQYSKKUCHRP    
MNWGPAYG        : QASFLPPIPPMEUW  EDVIWPFIA       ODYOC          
XWAQRD          : AQLVLOJIK       XHBXLPJW        IDWSHOCAIKPCUM  PQTWRV          RIWADM          AILAKCK         GHMOFWPDGL     
FDVQRB          : TPCDEURWUCCRIPP YOFCON         
QVXQTMRHYH      : RPIOSDOGFCHT    YSAHPV          CQKTKDOFDO     
IWHHGOIDQYWUR   : UPWFLNA         EATRO           HWHOJHXB        CLKJ            XXEEBSNRD       YOFCON          OJJPHANVSIMAI  
APUU            : UQIBOFMDPTVDJ   PWDTMVJRHIOIC   VLVG            WBNLYRJG        QBGVSVCBQT     
SLORELGXSHFXP   : UQIBOFMDPTVDJ   QEADNWRHPCT     KQNBL           NOCBPUXSGSGDS  
FXKWINPJNM      : MQYNMMFVXDMS    BXNKA           MHDUBQCAAVQPMS  GLIJ            XJDDQKBSPHN    
RPTNKN          : AQWFRWXLV       XRYJXGVETEPRHK  XMRIYQQ         JDKCOB          XYYTMTL        
XCCCPICLQHJGL   : NWJAOHPBGLE     ATMGQYSBQMITY   RWMGIADAROR     PMPAYH          GQFYIRTXALPT    AMOWMMV         IHMDLOTNXWAQAHN
GYQOMGYCTDUJW   : EDVIWPFIA       EKNRYTBXRIUSY  
VMSTRVXHEAS     : XNRPAHK        
JFEWYKVRCLXDNTG : MFQGAI          NTHGRDD         TUEVNLAYGFAUBH 
FFUBSOWKM       : PDPUQXQ         NQXJBBDDGVELXEU CQALJQVWLKMUN   HVHPNDGEI       GOXECEMEM      
TQWPOIU         : HGKIMLYIGOJ     JQAPP           RLAPWW          RPQQVWIF       
IVFENJRNMIIUSP  : FOOENC          FOFDYKCU        YWWOHAIHK       UWBMDGSCFYTBGM  EORLUMVAGQJ    
ORVFQIRMEKLTB   : DAQVSPYQPTQG    KWGORIXDUHM     BQED            VUEGMJE         RKDOQEFKAQ     
QVFMELANEOBOYVH : HMBQEPFQVYMER   RRTHJITJGQOIVUM
YXIWFA          : CLKVIN          NQUV            MIBFKNUGQJJGKM  FHASEBK         KACAMXQLLHB     GBHK            FJLJM          
WOMKAI          : KMVUWVNM        FSWT            DBRDK          
YAKE            : QKHILUL         BYFPJOP         XDYWROLNAQXIWG 
OSPCYGFNFCW     : KWMXCD          PLKSXSYFDNXDE   RKNSUQMCHNKQJBR GJICJVYNDPFFTC  XAGAAMKLJ       JJAU            CSYWYLLDR      
DVFBBFIBT       : PLKSXSYFDNXDE  
LVGYXGLCUCUMFVS : GLNQ           
JAQHWUFE        : FGTYNOYPKNWLYF  VUMJEBWI        JGIH            MTMULDSVFCRL    UCARMJNCY       KMKYET         
GLIJ            : SUGXGW          EGBKIOKGFH      YMRKNBWNRJ      RPIOSDOGFCHT    FXKWINPJNM     
GWFOWDWKIR      : GUGAHGVXBBYQKJ  NSIIJQ          OIKJKAXPG      
FFUCAHLB        : BSSJY           VEOQDOLJQVWCLV 
UAVAGTJRESBM    : TEUAMCUMVLXOKP  RKNSUQMCHNKQJBR JOOWIMRHHH      SIYOFBRBHRDGKO 
GBPKX           : ARQBQLFC        VOYRAT          VCRF            TUOFDF          XXEEBSNRD       FAFNETRTESWTD  
SSPAAKCA        : PLQSSRT         VEFOW           XFKOUXDBIAS    
QDTLFRMLLVF     : SBSJCUCID       FPJHMP          MHYDMBTHYMPTUS 
OGFHNIWAHXUCP   : VUUMLOM         FMMCCUFJTI      UUFFSSNJN      
CBXEVOKPCPHOC   : EYPYN           XMPDSJ          RJFI            JHOPOQAIDWFNV   URGAXUR        
MJOEQTLEDJE     : CUBROIORPPPCTLN DUCFEHSDEWATQNK TRANNB          AYKMSYNHTTJIGFS
JBQYVUATYXKLNP  : QRBPNJXYVKBQY   OKELHOYCYR     
WEGTTPJXGFJMK   : JWKNYIDUVFPOG   AOAPS           XBJJIKTPQUTIK  
SWETP           : TXFSRABRMMNF    BFMQ            LNKSVVJQNCT     DJNEV           XSFB            RBVOHKO        
QKGMMFAXU       : DYAODFCNHNPL    EKEQF           DMAGBJ         
AUVIOPYAPHGAWS  : WQEEJYCWXIIBW   EIASPYMBVDSJMV  HTXA            YNINBTYKPUKBX   TPCDEURWUCCRIPP NSIIJQ          RRJEUAYGIJ      AWSFAGYSX      
PQAMIGFTMTG     : UQIBOFMDPTVDJ   ISEANUQNICEEU   QEWMFILOXH      ECWLNRPK        OMVWAWQAEPC    
TEPLHKKRBAQEQ   : VCRF            OQLUOU         
MSXFNPXPEHVJD   : HCKAVANJ        SKNMTAIL       
EJFAPWM         : UJSQX           GTDK           
JWRNYKRRL       : SJNYP           IWEPPAYNS       MRBONKXDQBOB   
KLLBEMQ         : XMPDSJ          WBLTWCANHLTC    WLXOKBGXVQYPQI 
TPUWBBIIB       : DXBJA           BGPVIV          QEWNLBVJCUEQ    PKSXHED         IPARMRFOEYISFT  CRPYREBRMMAJRJQ
IPARMRFOEYISFT  : JJWUJGWNHJ      UTKECNWQSLU     TPUWBBIIB       PMEFBQEATBSTH   TAWQVEOPLAGD   
TWKGPVCFSB      : GOXECEMEM      
TJTWJCNLVCDCQKD : XEXDVRY         GWVBTAPBDQBMVXH RUFLYFG         QDYLLOWUDMHBBR  MBVTOXP        
DLVJFUWNKUPQ    : QWDCWHBHJLVT    UVCBGF         
QBJCW           : LIPKYCTU        UOVSXBPKWTD     NGGQY           XFVRJHA         VEPCWFMSCYEDE  
LYTAV           : UMNHJIIMXPK     HKAJDLWWCTMQNQ  PAYXVNRCI       GTIOL          
FAPPFRSQ        : ETLWHNFAKPRYOVE TDCWOIIPYW     
DXKALVUDOKVRTX  : DEQPQYHCTH      NANNDLNICLBPIBC AMHHG          
AMOWMMV         : TAWTIHUKP       SYHKRB          BLFVCUNSAA      XCCCPICLQHJGL  
OLIUGDLVIKHKXFH : VPWWJ           MFGRPY          NVXVCVRAX      
TRANNB          : BXIXAADQQL      MJOEQTLEDJE     LRHICHCWHQBHGK 
QNUNCHJVW       : XUEFGOW         OHCTNPIIJJOAY   WBNLYRJG        VAKEEEFX        ODYOC           ROBXCCL        
GTDK            : ATDKACRQXVQTB   EJFAPWM         BVEYCXQIY       HFJKA          
ASRJGSON        : QOYUF           NRFM            SPCFFDICSBKRGW  MJNIXOQTRXS    
KIYXVAEMNYCR    : OHCTNPIIJJOAY   KBOH            VMTTPX          GMDAVFRNXEMFX   UOXMIQROJWDI   
NOHLUBQHJSDD    : XIRFV           SXCAK           AUTCIGHO        WKBMLRCCS       LHGFEAG        
JXSYUFHUGEUKS   : EDPGCP          YIDEJLV         HJTJXQRTCOSL    LCYF            YLLLJSPKXI     
LXFTLVCY        : YUQURHUHAUCSS   XSRHPOTKPVW     UMQMXN         
FQBOJEUOPSJPQ   : VOYRAT          KBEON           XAEDB          
WLXDIKYVVW      : GXWBRBO         VLVG            SNTYFTATUPNSDQY QBGVSVCBQT     
PKATKRADVQOCL   : FCVUWHGPPRVTOX  SQPCPINSJURBUS 
SHPKXHJLHPVRO   : UQNW            UDPBUMDTPGQ     FYFXJREUJDFED  
NNWFAYAMRCPPSFR : ECQUK           PPIMJEGMEJTBN  
KMOAWMHJAOYVIN  : CGHCVXMHNLCSVBE SMODTYUV       
VDPEDPGQ        : TDDIJO         
IIYDNSKY        : RWFRPLBV        BRISOUEK        NVXVCVRAX      
BYFPJOP         : AKSOYE          YAKE           
NMJDDFGTLMJRF   : EEIOBOVOYFKGWVK GRMFLFGMHY      YFLRYVJBJAJ     TNJYQIVS        VCPTBSFKBQ      EVWDXTWLNHTLCJ  PVMGMW         
ANTGEMSDS       : LILOFSBBGQ      BFMQ            XBAFMXSQ        WGEOLL         
EYKNP           : CNGOTCSJGQQ    
OEPAHSFQORFXL   : JTPHIDHTRFLTWKT QOEDSCCBIFW     NBUXFJFBMIFFHMQ ABXJAIMKPLOW   
SMAMUGANJUIQ    : XBFSSQOFW       FAIP            VQRU            OWFCBRIME      
VGMYWSOWAJDSY   : FCCNLGDSIBOYWO  CCIXDMFPNI      MBPQNDEASFYSIA  EDJMHL          TTWAHJXF       
AYKMSYNHTTJIGFS : DUMIK           VHCHVFFVYX      QIGDNSL         NUDOLJXQRVHGJK  MJOEQTLEDJE     XENUCC          FJLJM          
DOFPNDIEA       : TIWXKFLAJ       KMHRKUA        
OFGNEHMPTHOJRJ  : FPJHMP          YQKHOPQ        
BTOIMNM         : THOCCPYAITOB    SFEICSTT        NXOGJJNHDFR     MJUMGUS        
SCTVNYYBNEHBJQP : PNMKPLXGEFEUV   MMYHINFCKK      AYVWHBMJXXSNCCG YQKHOPQ         YPVQAVJOYLFVP  
LAPURBDSURC     : KCIFJHA         KEDBDVKIYCO     XIQT           
FOOYSIWIHVJUB   : KUYMOQYVK       KSLHLPSJUK      LXSTXJD         SQOHPOEP       
XMKQP           : KLGLOXBBIV      HVHPNDGEI      
QFTKJW          : XCOTWRCAFT      OFJW            UORFYM          KMFMG           DJNEV           MIGGWIFWYMGINPO HLICDXFSDSWX   
ERHOWXFVTOVC    : CHATTIBEAIW     VPWWJ           YLCJUGXSGUDOJUF GQOD            KRFLGPVFXM     
ROVUKVJWMYVF    : QLMMUOAIUBHKAE  YPJBJUQXGS      UNYOKTGU        CDMTWUNBE       AOFP            QNLW            XQUXXQPTJXTE    VYRGFADQF      
RPQQVWIF        : OLKYY           EATRO           TQWPOIU         OXFIMO          JWYLUMBHCFYCDPI
GETEXIACJSSFPDB : LMHHO           DHARPQCUTSMTQT  DFIMFDOAFYJGUT  LQLQL           WBLTWCANHLTC    KMUIJNVQHAGXXH 
BQYYVGQO        : FSWDDVS         MUFGTNGJSG      EFENLP         
HKWQPLWVF       : KVKXCLONKI     
VQEYAWTFMA      : EOYMRW          PHBIXHCHNVCVM   TRVAWLPPFHUILP 
ODYOC           : VOILO           XBFSSQOFW       HPLLQMPRX       DYAODFCNHNPL    QITUQEDGNM      AOFP            CJTMKSGQBH      IRMSUKCLGBLVWGM
ODYOC           : MNWGPAYG        QNUNCHJVW       IVNEHNBLS       TUEVNLAYGFAUBH 
WSMYAYVQ        : DPRYIRALBV      ONRLJLBV       
HPPOTLFX        : WAWKNCILIWH    
HWHOJHXB        : EFPVFEPJ        MSIMYAUXSXAFBPD IWHHGOIDQYWUR  
YROWQHL         : ETANEEU         XGFHILJH        CVILGJG         LNDDQ           KLCJPHYUCYERP   CSUHJFFKO      
JMLBEUS         : YSXIHAKQMRRNLOT KGIRXUFPWTFYM   QWDCWHBHJLVT    GTEKDKKVWICADWH XYFLNCNC       
KMHRKUA         : XTJMDTWN        DOFPNDIEA      
EOTNOUAO        : WDXYQIFX        NJQBRDQPUY      INHQEETDT       NPYVTLVWYSHE   
ONDXCVHOHK      : AELBNLRWQQEDQJT MFHC            SWQJTOUYRARSNK  AISP            DIJMDDBL        CVBJHJLMK      
DEQPQYHCTH      : LOVPRSCQSRXJOQ  QBUNIYWFNHC     FPJHMP          DXKALVUDOKVRTX  THTXRHA         UCARMJNCY       KARSANDANHGT    DBREDRYNQ      
XYFLNCNC        : FKVKGPHNWWKR    ALXMRT          RUHPCXLLTI      BXKQJRUI        JMLBEUS        
CSUAU           : XVVUXKELO       PGQU            CEJQQHQLEMWEG  
JJAU            : DGJR            QIVQBTXYNHJNQW  OSPCYGFNFCW     GRWYLBMTVLBEK   EVWDXTWLNHTLCJ  BPCFTHHTQC     
FYVURWFVQMIQNN  : KUEOQXFONMFJVL  BQIFCPNNRTMKI   IOIJSLLBVQ     
CSRGHVYE        : EYJFRJAMLLHBWCH GJTYEHJ         NHBCNMTYAAW     ENWJH           BNSFSTHDIGGDW  
VWIIAD          : QBMDJBJW        MEGSXFVMISTIE  
FELD            : IUKPKBKY        FDYHANXKWBDTHSX FFPRF           WKVHBVTYHWMST  
JISCWDTLQAPJS   : FMMCCUFJTI      BIGHXDOC        XBJJIKTPQUTIK   VEPCWFMSCYEDE  
TQXAPVAXEADTH   : DAQVSPYQPTQG    NOWWNYCSGMWAM   WCUO            SVNCQ           WVSV            UYYLLQCDDWHTN   QBGVSVCBQT     
IKHTSAV         : ONOQK           JGIH            KLCJPHYUCYERP   IJSTWW          IVNEHNBLS      
FRGYSVINTEGTHVQ : REVMRXXJRCJICET GABHMHKVTUL     CWMRKOTOYIR     JPUVMF          HBVBRONBAFUJDNM BFWG           
VWJBRQKACSTWUR  : UDXXII          YKMI            CDBDFMXTRWRU    LRDBH           LEXQKWROFGW    
BKXA            : TBCKK          
TKUQRBKBXDKV    : CMWYWIIMROVPEB  GTDIVDIQTGXBO   PEFGKQSPSDMQOR 
TXSM            : TMOLVPDTWCG     YGFFDRCEFQU     FHOOE           KJCBNGC         DJEPUYTI       
UQDOQBGICS      : SMODTYUV        RNYBXXEJTQYEOO  OJGFJNNVDKIEXTJ
EXDQSVIWHLUKVQ  : VATMTFVNHEGAHKJ DWKAQI          JFPQRRVE        YXTBI           KBEON           XMDJ            WVYLVFOSDKUET  
RQGFABXFR       : QOYUF           KLHBL           NAYFQOOIL       UVCBGF         
GBAKT           : GVRRDTY         VGRQWCOPHODS    PCRLHLXH        YNXJGCRV        SERPRL         
OUOGPLQMSF      : HGKIMLYIGOJ     FWNAEHOJ       
FBDTTT          : TOODHVNWTVUESS  QHXW           
BVEYCXQIY       : MPJH            UIIEDVUJQCMB    GTDK            MUQKWNNBGCLRSC 
TTAKQOSGAMTURF  : GRTCNAU         SIBSGGIM        NQXJBBDDGVELXEU RBVOHKO        
SIYOFBRBHRDGKO  : IHJTA           UAVAGTJRESBM   
BKBBWRRQBUDW    : XKYPPGQAFHOANAM XTCTAIH         LSVP            IESMVHYNAQEBIJF UYNLGVEUU       NENGWOENMX      SMHCHHYUJHNEBLK
UCUPLTFQXWT     : EBUCAVAMAITL    AXGHBCI         LEUCGIMJJ       HBYAGDTUG       MIBFKNUGQJJGKM  LTTRYXXOW      
QANBQTE         : QPKHTELKTGLUVI  MLHIGVA         RGKWFTQFHFLGL   TALTYGXCRND     RMEJEXUL       
WHXRAO          : KLOUNHNCTFPQH   FAIP            NAXBKEL         AAMBDSPSJENQC  
UTPMOTI         : QCAXAUNVHHISQ   AQGICUYMMIBSNH  VLVG            BNSFSTHDIGGDW  
FEMXCLUI        : SQDLMUCOPDLF    ETLWHNFAKPRYOVE
UVGLRNORUOJWE   : MOLNQ           TMAJOAXIOFSG    NOCBPUXSGSGDS   SMVVWXBEONQO   
RATF            : XEXDVRY         EITVAYGPOUNSYQN SQOHPOEP       
NPYVTLVWYSHE    : PEFGKQSPSDMQOR  EOTNOUAO       
DNBXBP          : LXSTXJD         CPOQQGUTWHWP   
VFBVLFNNBUFQ    : SSHQ            YSWSBMUKUYK     CLKJ            GFVOCBAJ       
EOHR            : QWIE           
GRGNVWS         : SIXMJUQWIJIDG   BAFRQYLOFP      VUEGMJE         HHGX            YUHDHXFLNCMGJ  
XSKQIJVLFJ      : EGPKJGVKETTOYH  RUTMP           MBNVQPVYH       LOCY            GBNMBWANHTGCPR  UYHE           
UWTSFLFJC       : SGNWCRQT        CMPUKHWNPX      YQPVYROLNYMQHM  CPUTWIRTECTW   
CPUTWIRTECTW    : TAQJDC          FDGPAQIF        UTKECNWQSLU     UWTSFLFJC      
KGXITFTLBR      : TOODHVNWTVUESS  GABHMHKVTUL     YOEDENWXWYPCV   APVKDVRRRJGWBN 
VWSBIXQMNLGMUY  : SEBAFMVBKNQ     DXCUVPGEDW      IIQSS           EGDXQR          OWRGQTCH       
YDBVRNESWYXQMB  : GDFJPCGCCEX     BXQKWOEQYB      SAPMTWLIXOTQ    FSVBVPMJNMYE    IBXHVAUFDPRSUS 
TWJPYSPPF       : KSYAHJBCJC      BXKQJRUI        MFTOCFKNA      
DOQXPYYSC       : XVVUXKELO       LPBY           
KQEDNF          : ABBYMKYFAHTTT   LPRURIJSV       CWDGXRTCDD     
GTFRQFDIGVXXEB  : TBCKK           RXPHIQOCEI      LWHVHWJAOB      NTIWEK         
UTCKVDFXBROIXE  : VDGLJL          WDXYQIFX        IAFWBOIMKVRWVLG LSICIYHCDFCCPIT
CLKJ            : MAVECCWBMKALBUX IWHHGOIDQYWUR   VFBVLFNNBUFQ    AXVDAFEEKDPOKNT
DOILWHJUNMW     : BNWVTTBINM      FKDBJ           GPCNTVRTPVPL    QIODJQLNEUAUYP 
JYUFCCDGTUQRY   : BDTAPVXE        BEYVUNBHGPNLULN GRVFQJRVBAFI   
VMSG            : WFSFDT          HYPX            LVYNDKEGAVT     BJECQYWLECHWS   XBJJIKTPQUTIK  
VWFHUMSPCGM     : VQERYV          EYPYN           DJIJUTTQVDJYOKD MOJTPTFUAH      DXKPMABEAWW     EAIGTRG        
RNJW            : OGOYJNAUDJ      ETJBENKCICC    
LCYF            : HTQWFUSJ        WHMMNKQAVQRHYI  JXSYUFHUGEUKS   GRWYLBMTVLBEK   OWRGQTCH       
PAYXVNRCI       : GUGAHGVXBBYQKJ  COQEQNRWBQ      ABXJAIMKPLOW    PEFGKQSPSDMQOR  LYTAV          
ANVWCQMEY       : JXJM            IGKH            FTBP           
SQPCPINSJURBUS  : BUGXWWNQHSNL    PKATKRADVQOCL   LXSTXJD        
THTXRHA         : AIAOQGIKCC      DEQPQYHCTH      WAFAWNWMVWSTNDC EDCDLKWEONMPS  
FWJWKPVOIPEK    : ULOM            QCJILCBIN      
PAABUUDSNFM     : PLRKVTPB        WHFNWUHURHUYML  QIVJTTBBTTAWXB  IWPQSTDLI       XUHGREGLTAHYM  
YKMI            : LGSCTDTDGHEB    HHGX            MSIXCJEDEUCET   WQCARERGGP      PHPYDD          VWJBRQKACSTWUR 
TQKDPUSNLDDQNLI : AJDIMDWCKT      GTEKDKKVWICADWH
NLLI            : AXGHBCI         ALAGLY         
GWVSTWFHISD     : REVMRXXJRCJICET WAFDNAEDJC      PEFGKQSPSDMQOR  DIMM            TEQLAGAUTTUOEW 
EHOBCC          : ABBYMKYFAHTTT   IWSAQLRUQAMPNP  BDTAPVXE        OQAHPAS         QGRURJLJXQIRTM 
GIGVTQMH        : GEIGJYQAOKYWJ   NCOVRFGUVWJL    DTSN           
ASTGPRBJPGSX    : VQCOLFHHUAGK    EHPQGGUR        RIGUYBCHVCBBYVP CAJT            IYIPRQUPHTLHSH 
WWIGNJK         : RGLPTSA         AIDGRLFW        XMDJ            HVFRMEIUQFSA   
YSAHPV          : TBLA            LTYOMQO         KPPGSLVTIGMWX   LBKILSWISCJQOCC QVXQTMRHYH      NAXBKEL        
EEDEW           : RSNGOOLP        PMLUEN         
KOOLAETTEXSDGB  : THOCCPYAITOB    OOBPBTUJET      EIASPYMBVDSJMV  PIMYINTRJJM     YCPRANV         ETTBXHTSTBSK    NHBCNMTYAAW    
SLLRFLCWIAD     : EGJCW           PQFIFHYQOKH     MGUMIETSUIV     FWDHIFGYQMRN    RUICIATJXKE    
DHNCTCR         : QVASEWAUL       HIEDQRCRGYINJQ  HHGX            GIEW           
EXBAFASIIVCBINV : RCEXBFLMG       NENGWOENMX      BRFKDCDRDOY    
BXOJARXEBNGURAC : RKDSUKYWRLHBR   RPRN           
BFWG            : FHAJMMLNTGGSMG  QIVQBTXYNHJNQW  FRGYSVINTEGTHVQ KRSOJMBUNS     
SOQOSRYGPQINFT  : MYSLDCPF        JPBGVXTVEDNOLM  AMKLOW         
YUUCIDWBGBXHHUN : CQDAMBCCOBYRRD  TYSGAHTTGNK     VEXX            SHYE            AEVO            WPRAEDM         CLFQEHGFR      
NCHF            : PPCGIAGVXO      MMPNSWYXOUE     OJGFJNNVDKIEXTJ JFXFPHRJM      
CEERVOGDJWD     : PFFVLFJSD       WGPSOHCAETJCPY  FRRIERJGJ      
TFOWFRDIRKR     : UDQSERGEOW      ONKUEDOJEMB     EDHHJTRIAYEQE  
XJDDQKBSPHN     : MLHIGVA         VGRQWCOPHODS    FXKWINPJNM      ENHTSLWVANSNDSO DNIUMRLFFNWHUU 
WVOIUTQOCF      : QNGAFQKQMQYGYGD OIGJFUXGYBRAF   TXBR            IQQWYDLLKWP     NGGQY           FSJPPOHXNWOGQT  LNKSVVJQNCT    
HARPREIH        : TOJVXNHNKCHU    CKQLPJJIYCOAMU 
TNKKX           : MHYSXBGF        QEOEKEUJLYUB    DVTSIVNNFPMT    QSPHXIBIO      
GPUTBR          : YJJNPILPCQEJIK  JUTTLHRLXP      HEBLYDHH        LXSTXJD        
SCMMSBOB        : FCAOPFUJVTQHNU 
XDIQUNYF        : MHYSXBGF        CHLIHEIKRWYKIRV GDXTRLEA       
UUFFSSNJN       : OUAFWLOJVOBJO   PPCGIAGVXO      IUKPKBKY        WLCQVIXG        FTSVDGYUF       OGFHNIWAHXUCP   PUOQIVLXDP     
MIBFKNUGQJJGKM  : MESRBXDWO       NFMQLFEFXCOY    YXIWFA          UCUPLTFQXWT     HWPOUA         
BJECQYWLECHWS   : HDKNFPBEIIWM    LILOFSBBGQ      PUXRKXK         VMSG            JDKCOB         
LCFVE           : VEOQDOLJQVWCLV  FJDMRTGNQTAEOHB PQTWRV          OFNAUPPEBSXS    HTEABNGGFPEPTK  XWOETDOMXYSCDL 
GTIOL           : VMJKKKPSPOEOLO  XTCTAIH         LYTAV           BTSJXUGNIB      FSXMC          
AREOIFYNHRM     : DXIDUMSEPRHVYU  KQNBL           QMJWICQMV       ETHTIOUUIHV    
ETJLSCEEELAKY   : NBUXFJFBMIFFHMQ WSYBEXHQJKWQKAT XWVIVIIXI       FSWDDVS         COBBHGBNHUNT   
FHASEBK         : OMTTRTPEXR      BRVJJMPHDMUQ    YXIWFA          OWRGQTCH       
PUOQIVLXDP      : WHMMNKQAVQRHYI  IWPQSTDLI       UUFFSSNJN      
MDMOHTUUTGUFL   : SUGXGW          DKPFPYFMWPNEJ   LWSNCX          TDXXYIGPBYDWSX 
IEILQRBNIUYEG   : XFIXQXN         UFMMEDUBNCBUT   XMSQGUY        
HXQVBFKK        : OSREXVPVCDYNE   UFYHXGRPCDT    
GFVOCBAJ        : UEHIIENFCVVNSXF FOHKSRHCDKUV    NQERXTYKRSGE    JTSDK           VFBVLFNNBUFQ    XDYWROLNAQXIWG  IJSTWW          DJEPUYTI       
GRWYLBMTVLBEK   : PDMXLIYMEDHLINL TMOLVPDTWCG     JJAU            LCYF           
EDHHJTRIAYEQE   : AQWFRWXLV       XXHABFHRGTST    TFOWFRDIRKR    
SNTYFTATUPNSDQY : HGLNJOS         WTSMJHHDLFANJNN AYVWHBMJXXSNCCG WLXDIKYVVW      FSPOJRCONTYRKSR
CDTJKFD         : TKTRFYYHU       GXWQNF          BRFKDCDRDOY    
OGDUWHFQW       : ONOQK           QWOTVPNU        KUBJYQDCGYM     FQPLR           UWBMDGSCFYTBGM 
RDVUYQKM        : UQIBOFMDPTVDJ   JYGBS           XXEEBSNRD      
NGIEINBTXGYCWHH : WUIYDKTPGYJSUO  TCOQ            LIOMMUUYKGLIBO  THKYECRD       
FPAXMERRAOSSYIC : OSCAV           VJRHUGGHVFUT    LWHVHWJAOB     
OMVWAWQAEPC     : TBCKK           PQAMIGFTMTG    
XKXFCYFQDYLGOE  : EGPKJGVKETTOYH  RKGO            MCDJQFCSPIB    
PMEFBQEATBSTH   : OCTS            WJLCSSAD        FQAPJBOB        IPARMRFOEYISFT 
YLLLJSPKXI      : QKHILUL         EIGYSGPGQLXDM   JXSYUFHUGEUKS   IBIEIYWN        FQFM           
YTWNB           : RSMXLOKOBDLA   
GPCNTVRTPVPL    : TXFSRABRMMNF    HFBFSHTJCNLE    CIHUFXODNDYO    DOILWHJUNMW     SUQAIQCBDHQ    
BMSM            : MFQGAI          TCOQ            SAWNAFRUTXE     XHUIDXYOGJL    
FFPRF           : KLWBKU          FELD            NOCBPUXSGSGDS   NDIWUMOIGPCRLUC
IEUFUVEDOGQIC   : PQFIFHYQOKH     YNINBTYKPUKBX   VNHDVKEDLVRJ   
ETHTIOUUIHV     : CLKVIN          CBLE            AREOIFYNHRM     KPGJP          
OLHTKQB         : KDYB            HBYAGDTUG       YYTAEKRVUFKAMXC MTHCUERRDTYAC   AWYEMEDAXC      NFBGDYHOGN     
XXEEBSNRD       : MWLEMBSXTU      ULLPFCIVGN      WLWGOXWQRLRGDU  IWHHGOIDQYWUR   GBPKX           RDVUYQKM        WKKK           
DIMM            : SPCFFDICSBKRGW  TIWXKFLAJ       GWVSTWFHISD     CVBJHJLMK      
UCARMJNCY       : RRBERWGIIFUTO   IRMSUKCLGBLVWGM JAQHWUFE        DEQPQYHCTH      WKVHBVTYHWMST  
JUMCVUBTC       : MRVCHIDBWITO    WCUO            EIPJHLMOXC     
UWUNBNSLAGPWKRO : PGQMIVPKSY      SPCFFDICSBKRGW  SQOHPOEP       
CDBDFMXTRWRU    : PJPWARFHAIWONT  VWJBRQKACSTWUR  SAWNAFRUTXE     FUFKSSSGOD      EKNRYTBXRIUSY   UMQMXN         
TCOQ            : UDXXII          EQGPRIPSHUH     LLMK            NGIEINBTXGYCWHH BMSM           
ETLWHNFAKPRYOVE : SJVK            FAPPFRSQ        FEMXCLUI        AYPKG          
YLFAGWWXRNTT    : RLTUUYB         SERRRI          XISDDRL         GADOOLHVMPOGP   QSWIUFQIDUQGMBF
MTIHFGQSNQ      : CHWNKUTJBTP     QPKHTELKTGLUVI  TEUAMCUMVLXOKP  YOYMBXDM        LBUEIJFN        UMQMXN         
EJFUFLN         : YRYXPSKPU       HERFQCTHCU      QEOEKEUJLYUB    NNRVRWTNINRUOF  QDYLLOWUDMHBBR  NYPHVBACLAMJCWS
XUHGREGLTAHYM   : XKYPPGQAFHOANAM CDII            MKHI            PAABUUDSNFM     DWPTN          
HVHPNDGEI       : EDVIWPFIA       LPRURIJSV       ECQUK           CKQLPJJIYCOAMU  FFUBSOWKM       XMKQP           JXKID          
PPHVCWDCRMI     : UDUYOLADH       TORSKKWV        PHPYDD          WAWKNCILIWH     MXFHWTGKWLGFY  
QQWMQFL         : UEHIIENFCVVNSXF FCTADGVATHGW    QWIE            GIEW           
HVAQNPTTVF      : GIEW           
MUQKWNNBGCLRSC  : WKDFMGKFIXBS    BVEYCXQIY       YQKHOPQ        
FSWT            : GANEOSGVGQD     MFOWOHBQF       BMVSGUX         WOMKAI          JVGJBIGQFU      MJBKCDIIQAJV    PMLUEN         
GRBWFQT         : SACBTTPHUC      YXTBI           AMHHG          
MYIYVYLTNBWVDJP : AWVLSJYXYNUIT   RLNC            DMAGBJ          FSPOJRCONTYRKSR
LHGFEAG         : KHNNMVLRH       CDMTWUNBE       NOHLUBQHJSDD    DKAJBYT         CFWKC           QOKYCQP        
THMYAGDMHMOD    : VQDGLD          THEANY          QBUNIYWFNHC     CPMRIFVESJPXW   BEYVUNBHGPNLULN
AYDEWYHGPG      : VCPTBSFKBQ      TBPPUYDXJX     
WMBEO           : XRPJPDKASHELSE 
QIODJQLNEUAUYP  : OMTTRTPEXR      KVVIIPCQUJS     RJFI            EAIGTRG         DOILWHJUNMW     CSDO           
ATBYULHKRCKEDQ  : TBQDL           BXIXAADQQL      YENSNOXJ        XAEHJCPUGABWIX 
NHBCNMTYAAW     : BEJCG           JPBA            DIMCQQOXDRXBAGM CSRGHVYE        KOOLAETTEXSDGB 
WVSV            : GRMFLFGMHY      TQXAPVAXEADTH   GBHK           
MAXHLHUDJHJPX   : EGPKJGVKETTOYH  RPNVCNAYNLHQIKL SGGBIXPPXV      JKSEV           QQQGLWXYHUE     QORRDWEPL       OVWPLD          VAGAUMTDTKUDXRH
DHHHUTBWUDT     : WFSFDT          EIBL            NTIWEK         
CRPYREBRMMAJRJQ : VPWWJ           UNRIYDM         LJKCQ           FDGPAQIF        TPUWBBIIB      
YQHEXQMVKPSFT   : YIDEJLV         YGFFDRCEFQU     AEOISJOAFE     
FXIUYAAASOO     : YPCHJVXCHHIQ    WGPSOHCAETJCPY  GEKUYHUKPGUQWE  RYKBMSWWUMP    
AIESLEJUKJL     : USGMGRVDICI     SUGXGW          CJWLH           YFLRYVJBJAJ     SYXHDSNEJYTJJLE KLCJPHYUCYERP   AEAKRVMB        XTHNCWMYSA     
FWNAEHOJ        : RPMR            OHJIYW          GNBGOMRRP       OUOGPLQMSF      DDEV            QWRWLDTK       
WHHAJ           : QWOTVPNU        MLNBKLTE        YWWOHAIHK      
SAWNAFRUTXE     : JJWUJGWNHJ      UGUBUX          BMSM            CDBDFMXTRWRU    BTIYA           KXGPQAPVE      
JPBGVXTVEDNOLM  : SOQOSRYGPQINFT 
SMHCHHYUJHNEBLK : TAQJDC          QJIVBVQYDQ      LJKCQ           BKBBWRRQBUDW    YOFCON         
UAQCVQXUVEKM    : ATMGQYSBQMITY   YVRTKWFRFRAGCN  VYRGFADQF      
WKKK            : FQDFO           XXEEBSNRD       LEJJNKGHMNGYGAB
MRBONKXDQBOB    : JGIH            TPKMGI          JWRNYKRRL      
KBKOADOWBSHNKE  : YYRRQPDFGPW     XKOY           
WQRMLUBBHBEXC   : IWSAQLRUQAMPNP  GQOD            BBXXKNNNOD      RYUCMNYQ       
YUHDHXFLNCMGJ   : EWPNYMWVGGK     CBIXIKRV        GRGNVWS        
TPBQJVDUSGX     : QLMMUOAIUBHKAE  KJCBNGC        
HEBLYDHH        : KXONLBJLGL      WQCARERGGP      TRVAWLPPFHUILP  DKECMC          MFQGAI          GPUTBR          MMPNSWYXOUE    
OFNAUPPEBSXS    : XUEFGOW         LCFVE          
OCRSYLBYOJDPWDS : EWPNYMWVGGK     BXQKWOEQYB      HPDTERYLJNAWIPC YSDEJBWWPQ      VYRGFADQF      
MBVTOXP         : PJPWARFHAIWONT  NXOGJJNHDFR     TJTWJCNLVCDCQKD
NTHGRDD         : SIJHAIEWIQE     TTHOEE          UCXWBVI         QHQRIANDV       JFEWYKVRCLXDNTG MIGGWIFWYMGINPO
FWDHIFGYQMRN    : JHETWSGTEMTJH   KVGITDHJSE      JLNHWOXXMHC     RQWLQYKVXMWOBLI SLLRFLCWIAD    
KUEOQXFONMFJVL  : VDGLJL          FYVURWFVQMIQNN  IIQSS           OJJPHANVSIMAI  
YQKHOPQ         : TBCKK           YQUVJDCERYL     XEXFORLKH       OFGNEHMPTHOJRJ  SCTVNYYBNEHBJQP MUQKWNNBGCLRSC 
UYYLLQCDDWHTN   : XHBXLPJW        OCKBGJTLFJ      POCVRIGXFWOPS   WBGJUDGSLQQW    TQXAPVAXEADTH   HJJDCI          NDIWUMOIGPCRLUC
AEVO            : EVJFYTGNABUSAE  YUUCIDWBGBXHHUN SXWJJDOSTFR    
IMXJOOVXDM      : VEAXFGRKY      
DJNEV           : MQWXWNMLC       LHPMIW          SWETP           QFTKJW          LDLL           
WAFAWNWMVWSTNDC : FKBVHDDGQSRNJT  IABKK           QBYLMMKCWRFV    THTXRHA         XTUEJXVGEGCAHR 
DOQTMOAYFFLT    : RHTRKPDCDDXFICC JQRKFISRBORHWPY RUICIATJXKE     TUEVNLAYGFAUBH 
JVGJBIGQFU      : JGAKJ           FSWT           
ENHTSLWVANSNDSO : VQERYV          KDYB            RXPHIQOCEI      XJDDQKBSPHN    
XAEHJCPUGABWIX  : EBUCAVAMAITL    TOODHVNWTVUESS  ATPNBVGMCQYV    ATBYULHKRCKEDQ  XDYWROLNAQXIWG  DWPTN          
OMVJFHI         : UDPBUMDTPGQ     MAHCMCVXIMJXJ   VUUMLOM         NFBGDYHOGN      WGEOLL          TUEVNLAYGFAUBH 
IVWVB           : TEJRSYALWQQSI   SFXFOREAP       CNGOTCSJGQQ    
MMPNSWYXOUE     : KVBBFTCWN       QMRODKJ         QEOEKEUJLYUB    ONKUEDOJEMB     NCHF            HEBLYDHH       
XDYWROLNAQXIWG  : SOAEQIMKYAIAKC  UCNTTA          MDEPVV          KGIRXUFPWTFYM   YAKE            GFVOCBAJ        XAEHJCPUGABWIX 
VEINQWDGPCGP    : VEXX            HTEABNGGFPEPTK 
BTIYA           : PQTWRV          SAWNAFRUTXE     MXFHWTGKWLGFY   IOIJSLLBVQ     
XTXJIADIKA      : EWPNYMWVGGK     SHESRQBC        CUELV          
RYUCMNYQ        : GNPMURD         QHDDQRXVHCQVFKM LSVP            NVERAYWWYKF     MNRHCXYVFUIEFO  WQRMLUBBHBEXC   QWFWWWUSLGRE   
QSDHMEDWF       : DUMIK           QNGAFQKQMQYGYGD NAGXXWWNMTQDOXV
GEAHNKJQSUTJM   : NWHFPMF         RUHPCXLLTI      WTRLYPUDLRMUAUI YKHKCVLEEI     
GOHTPAQGTTPIAV  : IPABGDFQH       PWLDDOYGJS      DMAGBJ         
GBNMBWANHTGCPR  : LHPKFIA         WELJVQWYFJXKI   OSMMGBQNJMUXO   VAGAUMTDTKUDXRH XSKQIJVLFJ     
KXHTUWULFQIV    : WCUO            YENSNOXJ       
ITGQUVDY        : UOVSXBPKWTD     YTIDREIIOS      EQSRWEEDVE      EVWDXTWLNHTLCJ 
GMDAVFRNXEMFX   : OSCAV           WFLSGANVTV      JYGBS           BNCSJXYVXNT     NQHYD           KIYXVAEMNYCR   
CSUHJFFKO       : RUXVSX          IVRGFWVRO       SOHAB           BIGHXDOC        YROWQHL         TILBISQNOI     
SHWPLXLRMOTIV   : QAGFEHTSPHRYPI  HVDA            WHRYLMGWGOQX    KDNFBUKGQDUBON 
WTRLYPUDLRMUAUI : PQGCF           EWJPDRYFF       MAHCMCVXIMJXJ   GEAHNKJQSUTJM   UHAVIW          LEJJNKGHMNGYGAB
VDXSSJSGDGWWOS  : LAQNIPIYM       FPAUUYCVSKRII   UFYHXGRPCDT     IOIJSLLBVQ     
NOCBPUXSGSGDS   : MLCBKDIIPCOB    BKNXLOO         JGTTYGSVKYJV    YTOXIVDFWTHWVE  SLORELGXSHFXP   UVGLRNORUOJWE   FFPRF          
NJWRHSMRLTWRQU  : KHNNMVLRH       GOGJQOL         TAFJACJ         NKDUNILSKGPVIXV WTLJMFCG       
MHYDMBTHYMPTUS  : KLPYU           MJWHEGHHVTVNV   GQTXBHPMMLETVG  NCSWQRREUWWCB   NRXPQMJCLNYG    FIAICV          QDTLFRMLLVF     COYIYPQVHIWWP  
XHVXYEQLX       : QQQGLWXYHUE    
HUYYRKNCJQO     : FCCNLGDSIBOYWO  NVYJUTYBNFXNTUI OHDPNPAXEN      CDMTWUNBE       IWEPPAYNS      
KVMALGWGTVNRTOX : GRTCNAU         OLKQF           GXIVAFVCEOLNS  
DVQK            : OLMBJGAPENL     BXPRELJCU       INHQEETDT       MUFGTNGJSG     
RLNC            : CERH            WCWTPGABOFKKGX  FPJHMP          MYIYVYLTNBWVDJP PMSEYFCLHPUFWQ 
PMSEYFCLHPUFWQ  : GHIXXYME        MLNBKLTE        VAKEEEFX        RLNC            CEDYELLGG      
MIWEJJHFCTB     : HGBVWHG         ETGXPJCLRXBP   
GPWJHJCMLKQW    : EDPGCP          AANDXRFYL       MYVRVQEJWDQN    OLKYY           QBGVSVCBQT     
HTYGKCUVY       : ESUHVDYCUDOH    EIPJHLMOXC      JICJXJ          QNHWPBAMXMBMQHI UVCBGF         
FKIMNFQINI      : VIOOK           SOJUIXJJP       GOGJQOL         OXUJND         
WPRAEDM         : SHADDJVJ        XLKOUG          TTPYNQASSVV     YUUCIDWBGBXHHUN BRFKDCDRDOY    
CEDYELLGG       : MKHI            AISP            PMSEYFCLHPUFWQ  RRYHXDXJI      
IIQSS           : AQLVLOJIK       RLYIIFNFMOOVCM  PWLDDOYGJS      QWXYTOQOV       LWCD            VWSBIXQMNLGMUY  KUEOQXFONMFJVL 
GXWQNF          : VLLWWFCWQRUTT   CDTJKFD        
LWSNCX          : XCOTWRCAFT      MSIMYAUXSXAFBPD MDMOHTUUTGUFL   CFWKC          
XAEDB           : BPDUO           MSNESPNQOPOPMD  JMDOYYCUHWDKWI  FQBOJEUOPSJPQ   AWSANHDR        ALUCTXTNTPRQ   
ONTWWCHOUDUED   : URPPLLQ         RBUQRJPEPDHIDE  RITNCEXIGVQWMLQ PEIOXBCJJLM     PEVCBYODQRFYTTC IWPQSTDLI       FSDHUPJDUBSERX 
URBTFXMSAKSANY  : BFNNKBSMDSRLY   UHLN            FSDHUPJDUBSERX  RPIOSDOGFCHT    MNRHCXYVFUIEFO  ETGXPJCLRXBP    XENUCC         
OKTEGTEIDU      : GPMNY           UDXXII         
GRLMLH          : YRYXPSKPU       EOYUDUWQOCN     ACHRJIRTDOFAG  
MDJMQENDWNS     : DUMIK           CIHUFXODNDYO    FESUMUNC        HSBBHTVRXJBAX   QGWGNLOBBRCIERA FKMMPV         
TKINOQHUBN      : FRQCTWUPK       CWDGXRTCDD      VMCALFMXGCUBI   QKPMBBIW        WTTBQDCCHMDH   
HVJSIUCOJ       : XVNJTGB         BYCBVYJXXXDEFQ  KARSANDANHGT    BNHTNPKSSPAJM   DAPYVSJGEOK     PNGHT          
AWYEMEDAXC      : MNCFWVVWEPDJNG  OMTTRTPEXR      OLHTKQB        
KMKYET          : OFXPUTCMOCNM    XRYJXGVETEPRHK  JAQHWUFE        TJBPRL         
FHOOE           : QWKLWWPTLNGME   TXSM           
KMTOEGWEFVL     : QNRXJYLFHQ      IKWQFWYHAQ      GJICJVYNDPFFTC  VGRQWCOPHODS    FGXNMLB         MFQGAI          LXSTXJD         AEFKGBAIGOIVHMV
KMTOEGWEFVL     : RRYHXDXJI      
DORDQ           : KMTXEBWSVXMEX   MJUMGUS        
NEYOK           : VQDGLD          XENUCC          IGRRDQGYDJI     NEBPQFCCWNL    
LRDBH           : KHHNARRQ        FGAXW           IAUR            CCIXDMFPNI      VWJBRQKACSTWUR  WGYBKYUCIMR     JWYLUMBHCFYCDPI
ATXVIC          : KSLHLPSJUK      LTTRYXXOW       YKHKCVLEEI     
GJJEUBHJVK      : QFDYDFCEGXUVKB  LDEFLBBKTMLE    EIDURFKQX      
KXJLPTIBLLE     : KWMXCD          POPHHY          TUAKXNFWFFEJ   
UEOVDXXHGHTKEUS : MSKAAD          BNWVTTBINM      SIBSGGIM        IJSTWW          EVWDXTWLNHTLCJ  TUAKXNFWFFEJ   
SFTFGDQ         : JLNHWOXXMHC     AANDXRFYL       MITXTRQM        LTNTX          
WAWKNCILIWH     : IHUTKBFBTOU     VUDU            UCXWBVI         LKFOPMUKH       HPPOTLFX        PPHVCWDCRMI     MEGSXFVMISTIE  
WHXDRRQVOJKI    : FWVTKABJVWGB    USISYSJSYJV     VPMREBBUJYJCUBA INYHHSIA       
ENWJH           : CEPUVHWM        CSRGHVYE        XTHNCWMYSA     
IJSTWW          : SUKFHDAUBPP     OIAUQIHYUS      RHTRKPDCDDXFICC GVFLSICEUNAMMV  AMTO            VXEIWRT         IKHTSAV         GFVOCBAJ       
IJSTWW          : UEOVDXXHGHTKEUS
KHBTVBCTGTNWPC  : IQGINYNKG       URHLRUHHHAR    
DKAJBYT         : WFSFDT          EPHD            KLWBKU          LHGFEAG        
SCTNXSK         : LRKDNRRTNXNEMD  HTQWFUSJ        RLOHTIKN        UAIYI          
ETGXPJCLRXBP    : OIBWVJICNEPYE   JGVYVGCNHKCN    RUKUIVUIPJLTPHX MIWEJJHFCTB     URBTFXMSAKSANY 
EAVQ            : SDWVR           XFIXQXN         FAXOETCWC       JSHFLACK        WGEOLL         
FTCBEWGXKGR     : CDMNPFE         BOCR            EFKIDVVJD      
LXSTXJD         : FOOYSIWIHVJUB   DNBXBP          SQPCPINSJURBUS  GPUTBR          KMTOEGWEFVL    
WUBBMRHPNARVUVY : SHADDJVJ        WJLCSSAD        FTFLSNEJKFP     DYCGTQHWOYBLPSJ QIVJTTBBTTAWXB 
SFXFOREAP       : JOXQYPWAXFOTB   UEHIIENFCVVNSXF RGKWFTQFHFLGL   IVWVB           DACABVLYIRYANRC
TNJYQIVS        : OJRTP           UDTIPCGOAO      NMJDDFGTLMJRF   OWSVFAGCK      
JMQYDRSYMPANKI  : QYMNRABJIXE     XFPOCX          MAHCMCVXIMJXJ   TUAKXNFWFFEJ   
QWFWWWUSLGRE    : GHOTSDM         MKKLNBWADYG     RYUCMNYQ        LRFFRQ         
NWYYKSANKVOYLO  : LMDTISHUXVGBBDY EIBL            VMJKKKPSPOEOLO  HGBVWHG        
VWDO            : KDYB            XIDFSDDKP       QPSBJFGXMJMNVRT
KMUIJNVQHAGXXH  : LPOIDCVARR      FSJPPOHXNWOGQT  ABBGHI          GETEXIACJSSFPDB
KACAMXQLLHB     : PMJODKJW        YXIWFA         
HEYDONYYYOUPW   : JSHFLACK        BGPVIV          IFVDUXLBNBMIM   NQHYD          
XWVIVIIXI       : KUQLMPHWR       CDII            ETJLSCEEELAKY  
XBJJIKTPQUTIK   : QUPPVINKXBNXFRD WEGTTPJXGFJMK   JISCWDTLQAPJS   VMSG           
HJJDCI          : KMHTCH          BOVLPS          ETJBENKCICC     UYYLLQCDDWHTN   UMKC           
CFWKC           : SHTNAGT         VUMJEBWI        QKTWKDDGBG      QLSQCVSF        LHGFEAG         LWSNCX          GDXTRLEA       
VCPTBSFKBQ      : XBBB            VUDU            RYCS            NMJDDFGTLMJRF   AYDEWYHGPG      INYHHSIA       
TJBPRL          : GVSUMFCFNH      BALRNFL         YGXTCQOKO       KMKYET          XCNFNI         
AXVDAFEEKDPOKNT : XBBB            CLKJ            RASODSS        
JWUOHXH         : NRCFMCBH        EULQ           
RRTHJITJGQOIVUM : SYHKRB          RQWLQYKVXMWOBLI QVFMELANEOBOYVH
AEAKRVMB        : YUOSVAHCQOTCHM  PXGAPLRSSBFAG   KEDBDVKIYCO     AIESLEJUKJL     HCKGHLAEWPNQ    TDCWOIIPYW      LVNKE          
JSCIASCRNK      : RPMR            NCOVRFGUVWJL    HMLY           
VEPCWFMSCYEDE   : FOFDYKCU        QBJCW           JISCWDTLQAPJS   OWTITW         
PXCFAUOSWYU     : QBIHQOAF        JMMFKDNL        UHLN           
CNGOTCSJGQQ     : GPMNY           WJLCSSAD        UAUIOVRWLWBY    EYKNP           IVWVB           DBREDRYNQ      
LTTRYXXOW       : LIPKYCTU        SDWVR           YNNN            BAFRQYLOFP      UCUPLTFQXWT     ATXVIC         
TYWLTUKONO      : EWPNYMWVGGK     EOJMGICEOY      TBQDL          
TDXXYIGPBYDWSX  : EGSGHU          QSMQJEHKC       MDMOHTUUTGUFL   PWOG           
TVNQYJRV        : KDYB            ROVDQRWM        EMXCWLTLSAYM    DWBHUEHMWQWA   
LSICIYHCDFCCPIT : VLLYNGAF        VATMTFVNHEGAHKJ UTCKVDFXBROIXE  WKYXGSJPW       QNHWPBAMXMBMQHI
JYODW           : JTSDK           YOYMBXDM        WBPTCJELJ      
YVDRUMJS        : OIBWVJICNEPYE   SROQKDYKVOJY    BFHDHJUROYJEOEY
WOUYWTG         : VPTYXVF         LHNSRJCRBVNDKI  XNUUCA          AHUBG           HAXTSBHHCSO     FRRIERJGJ      
YOEDENWXWYPCV   : HQCGOJYVMUUA    BORAOCAC        KGXITFTLBR      BRUPDCJFKTXPQ  
BRISOUEK        : ENNOFNP         DEKIFPGDVC      AOFP            QIVQBTXYNHJNQW  IIYDNSKY        UFNTLN         
BYCBVYJXXXDEFQ  : ABDSCLS         HVJSIUCOJ       KFESSEAQBJCKPBH
FPAUUYCVSKRII   : TPYBDNAALBSCB   RNJUCDEM        MHYSXBGF        TGBYMJ          VDXSSJSGDGWWOS  FJYORWRX       
SPARUDPTMOT     : LPRURIJSV       KARSANDANHGT    UUCS           
RXSKCX          : LEXQKWROFGW    
EVWDXTWLNHTLCJ  : LLBMXQBIYCG     MWNQJPBT        NMJDDFGTLMJRF   JJAU            ITGQUVDY        UEOVDXXHGHTKEUS
TEQLAGAUTTUOEW  : GGLOCN          DYJNVBBFYJMEL   VAGAUMTDTKUDXRH GWVSTWFHISD    
HCKGHLAEWPNQ    : EITVAYGPOUNSYQN QWIE            OQFMRPJXDVPUX   JGIH            AEAKRVMB        GDXTRLEA       
PCRLHLXH        : GBAKT           BNSFSTHDIGGDW  
XENUCC          : AYKMSYNHTTJIGFS URBTFXMSAKSANY  NEYOK           SMVVWXBEONQO    FTSCAHP        
BQIFCPNNRTMKI   : QUPPVINKXBNXFRD FYVURWFVQMIQNN  RHJQQUOQFDKBY  
OXFIMO          : RCEXBFLMG       RPQQVWIF        UFNTLN         
KYNK            : NFEVDXW         HUISCUKYS       QEAELET         NRXPQMJCLNYG   
BFHDHJUROYJEOEY : UJAARDKEVFHBSNJ EIJJIV          YVDRUMJS        JIGXUH          UFYHXGRPCDT    
OJGFJNNVDKIEXTJ : CJWLH           UDUYOLADH       NKNPYE          QBMDJBJW        UQDOQBGICS      NCHF           
BRFKDCDRDOY     : NGGQY           MKHI            EXBAFASIIVCBINV CDTJKFD         WPRAEDM        
SXWJJDOSTFR     : BHEPSRSFA       WJJWSNI         AQWFRWXLV       WSYBEXHQJKWQKAT GDFK            AEVO           
RADPVMTXEAIJENC : INBTU           LIPKYCTU        KPIDLYUPHDQOBO  FSJPPOHXNWOGQT  SJVK           
DDEV            : ROKDCAVM        TRVAWLPPFHUILP  FWNAEHOJ       
CIMHYFBGYA      : EYPYN           XCOTWRCAFT     
ADQVSKVYMFJT    : LNWW            TBGPWYYB        IADTDHK        
LEXQKWROFGW     : ENNOFNP         SFEICSTT        PWDTMVJRHIOIC   URHLRUHHHAR     VXWKH           VWJBRQKACSTWUR  RXSKCX          MOKNF          
LEXQKWROFGW     : ILXEMUROFPEFCG 
NANNDLNICLBPIBC : VAKEEEFX        DXKALVUDOKVRTX  TSBCXRIYAHCPCHK
KVKXCLONKI      : TEJRSYALWQQSI   FQABYRFHGI      CHYYHC          SBRO            HKWQPLWVF       ROBXCCL         EFENLP         
ROBXCCL         : GFWQ            QNUNCHJVW       KVKXCLONKI      FRRIERJGJ      
FAFNETRTESWTD   : RNJUCDEM        QEXRO           RKGO            GBPKX           QSPHXIBIO      
GDXTRLEA        : XRYJXGVETEPRHK  BORAOCAC        XDIQUNYF        CFWKC           HCKGHLAEWPNQ   
VQRU            : SUTSDNUTOJJHKM  MFOWOHBQF       LGUAXUVYIAN     SMAMUGANJUIQ   
TILBISQNOI      : TEUAMCUMVLXOKP  YQUVJDCERYL     BGPVIV          BSQW            CSUHJFFKO      
SBIMGEVJEPDRUDH : MHTYGGUDWNBL    MFOWOHBQF       IAUR            GOGJQOL         EQRXVRBL        NWRC           
TBPPUYDXJX      : SERRRI          GQOD            QDYLLOWUDMHBBR  AYDEWYHGPG      KAYFHOCTCBAI   
YNXJGCRV        : KHHNARRQ        SYHKRB          OTHOCYOD        SWEXIPIRBRD     EIGYSGPGQLXDM   GBAKT          
XTUEJXVGEGCAHR  : WCUO            BXKQJRUI        AHUBG           WAFAWNWMVWSTNDC
FSWDDVS         : UIIEDVUJQCMB    NLUSCWWOGC      BQYYVGQO        ETJLSCEEELAKY  
LTNTX           : NRPGCHAPKNUXU   SFTFGDQ         SRLH           
RIILFNXGJEKRGMA : EQGPRIPSHUH     AYXWKDPVRW     
FFTC            : CEJQQHQLEMWEG   OFJW           
WAGCN           : POPHHY          MRCTLXATBJ     
PIAA            : ETANEEU         SIJHAIEWIQE    
IJOQWMWIQHB     : DJIJUTTQVDJYOKD VJJSMCJEFB      PHLUXUR        
TBDBIWGSWIBB    : LMDTISHUXVGBBDY RIUFX           DYQQPYPPO       QBYLMMKCWRFV    IOIJSLLBVQ     
BSHDTJOD        : JJXYO           QCTCR           NKHHIOSVWLKNSGW
FCKCKELLGHOJJYI : XHBXLPJW        QBYFXWMDHIFMKS 
UHAVIW          : WFBLUTUPNFFQHK  SFMXQ           WTRLYPUDLRMUAUI
EGDXQR          : TBCKK           NBOXWFCUOHWVBM  OQFMRPJXDVPUX   VWSBIXQMNLGMUY 
OWFCBRIME       : WKDFMGKFIXBS    SMAMUGANJUIQ   
UUAG            : MHTYGGUDWNBL    YQUCKNYHUNYDRKI XGJQRHCYCM      WXJFDOXGBCJCFFO TDCWOIIPYW     
KARSANDANHGT    : ATPNBVGMCQYV    BXKQJRUI        AISP            DEQPQYHCTH      HVJSIUCOJ       SPARUDPTMOT    
WLKOL           : WEYHSX          XWHB           
QOKYCQP         : FBQJNHLB        KVGITDHJSE      LHGFEAG         BLHFHN         
LRHICHCWHQBHGK  : FGTYNOYPKNWLYF  FBACFMIUNQKBKCS MQWXWNMLC       FRKLJYFTWHDBN   TRANNB         
ASNODCCVUQGT    : BSSJY           YQUVJDCERYL     YKFBQWY         YSWSBMUKUYK     TRVAWLPPFHUILP  COBBHGBNHUNT   
WLVKDDVIMXFWQ   : OHJIYW          CLGIHYLXNSFUNGB WSQYC           SGKWIWAI       
GXTWAOLQRPSP    : VVTIFXJUMOEUGC  EQRXVRBL        QSPHXIBIO      
MXFHWTGKWLGFY   : YRDC            NBUXFJFBMIFFHMQ CWDGXRTCDD      TSVTH           PPHVCWDCRMI     BTIYA          
NVXVCVRAX       : CIHUFXODNDYO    UYNLGVEUU       OLIUGDLVIKHKXFH IIYDNSKY       
NPBDKQOWRWHOSNY : AOAPS          
YHXAOL          : QASFLPPIPPMEUW  JNAHKAEDAGH    
MJBKCDIIQAJV    : QEXRO           FSWT           
DNIUMRLFFNWHUU  : VJRHUGGHVFUT    CDMTWUNBE       BORAOCAC        XJDDQKBSPHN    
JIGXUH          : IBDAR           HFBFSHTJCNLE    SOFIYLQBTCKALQ  RKDSUKYWRLHBR   EMXCWLTLSAYM    AIAOQGIKCC      BFHDHJUROYJEOEY
WKVHBVTYHWMST   : JRGJUTHCOLXDWUN FELD            UCARMJNCY       TDCWOIIPYW     
KFESSEAQBJCKPBH : GRMFLFGMHY      XGJQRHCYCM      BYCBVYJXXXDEFQ  SRLH           
LEJJNKGHMNGYGAB : RDBLRAVLQGLN    WKKK            WTRLYPUDLRMUAUI IVNEHNBLS       WBPTCJELJ      
IHMDLOTNXWAQAHN : YENSNOXJ        XCCCPICLQHJGL  
NAXBKEL         : XNUUCA          WHXRAO          YSAHPV          LRFFRQ         
TRYDUAWFHL      : JWACFMPHNXHACO  DYAODFCNHNPL    JDKCOB          RHJQQUOQFDKBY  
TAFJACJ         : TMAJOAXIOFSG    NJWRHSMRLTWRQU 
EQHREHRHTX      : NKHHIOSVWLKNSGW YPMCJIP         RIWADM          EATRO          
TSLSXIUWN       : XEXDVRY         AGQDLB          XFPOCX          YOJNAWLHQOGONHB XAGAAMKLJ      
IXXKDHKHSCLJJ   : DGJR            ATDKACRQXVQTB   BUGXWWNQHSNL    QBYFXWMDHIFMKS  XXHABFHRGTST    SRLH           
PQXXKWQGRE      : HGKIMLYIGOJ     QBMDJBJW        AELBNLRWQQEDQJT UORFYM          JHOPOQAIDWFNV   BLHFHN          RBVOHKO        
ROVOC           : FLPDLCOMWFVRNV 
WBYHEJROCVAO    : EMUQU           NLVWAJUUMP      BHTUCXRB        MPRYQRSWTWIYT   QFDYDFCEGXUVKB  TPCDEURWUCCRIPP HTTEGDIUMFY    
GGXHGLGATAGVRVR : KLJNYAYCCTSKRRN FXKJLEMOCTEXIH 
XSFB            : CYHKHBBQVFVAREC BEVXEUTC        PHSJBQASUIRE    MQWXWNMLC       SWETP          
MIGGWIFWYMGINPO : UPWFLNA         QIRWMVGW        TITQOOTVKJHNHK  QFTKJW          NTHGRDD         QSPHXIBIO      
XQUXXQPTJXTE    : BCSYDGSQXQDA    ROVUKVJWMYVF   
VYRGFADQF       : SMODTYUV        ROVUKVJWMYVF    UAQCVQXUVEKM    OCRSYLBYOJDPWDS
RUICIATJXKE     : OKMHORERP       SLLRFLCWIAD     DOQTMOAYFFLT    TUAKXNFWFFEJ   
IVNEHNBLS       : RGKWFTQFHFLGL   ODYOC           IKHTSAV         LEJJNKGHMNGYGAB XIDFSDDKP      
NKDUNILSKGPVIXV : SOFIYLQBTCKALQ  NJWRHSMRLTWRQU  VBBYWOX        
HWPOUA          : LOOOWL          JCOASWTKDR      MAVECCWBMKALBUX MIBFKNUGQJJGKM  GTQPOHMO       
LFTYGH          : PLGKJQAM        TCQABJFAWSDWG   LNKSVVJQNCT     UIRCAGKQTRTMVT  ERPQ           
FUFKSSSGOD      : HGLNJOS         QFDYDFCEGXUVKB  WKBMLRCCS       CDBDFMXTRWRU   
EYXDXCMU        : PNMKPLXGEFEUV   MSIMYAUXSXAFBPD QFDYDFCEGXUVKB  UWPAHCPEXFNDB  
BRUPDCJFKTXPQ   : ATJDKUG         YOEDENWXWYPCV  
CJYUQPAFTCDYAIO : LNDDQ           CUELV           GFWQ           
CROWIUYTAJN     : BHEPSRSFA       TOJVXNHNKCHU    OTHOCYOD       
BFFDOGAH        : SGNWCRQT        RQWLQYKVXMWOBLI YOJNAWLHQOGONHB BNCETYBODVHWJH 
BNSFSTHDIGGDW   : MBPQNDEASFYSIA  CSRGHVYE        UTPMOTI         PCRLHLXH       
LRFFRQ          : EIASPYMBVDSJMV  LDDE            OHUSDVELSIG     EGPSPKSPHOPR    QWFWWWUSLGRE    NAXBKEL        
TSBCXRIYAHCPCHK : JIQXWQU         URHLRUHHHAR     NANNDLNICLBPIBC SDQJGIWDMXVKR  
OOHWUMT         : QJIVBVQYDQ      SIBSGGIM       
AMHHG           : PEVCBYODQRFYTTC DXKALVUDOKVRTX  GRBWFQT         QNHWPBAMXMBMQHI
DBREDRYNQ       : UXIRIADHBHDS    DEQPQYHCTH      CNGOTCSJGQQ     FTBP           
WSQYC           : LPBY            WLVKDDVIMXFWQ   AEFKGBAIGOIVHMV TADCECKSKVL     DBRDK          
XSRHPOTKPVW     : EHKQVMS         YUQURHUHAUCSS   LXFTLVCY       
DFXHGRNLKMCBN   : ROBTXUNRSI      QBYFXWMDHIFMKS 
WGYBKYUCIMR     : VXRRO           VNCIKLHWOMJTF   NSIIJQ          LRDBH          
WJXVI           : EVJFYTGNABUSAE  QIXUEBPTSJ      WKYXGSJPW      
CJKK            : YORJEVCBG       CKIFUXG        
YYNNBPC         : MMYKVGJFDQID    TEUAMCUMVLXOKP  BOAFEUHCFVA    
OKBRUCO         : DPRYIRALBV      VWQELXVHDEJLY   EMUQU           QOAPLHL        
KCTOBF          : HWSB            SWEXIPIRBRD    
XNQCWDO         : RBVAISVUUBYQPTY TBQQRBPMTOX     UCDSSRKAYLUIU   TALTYGXCRND    
CPOQQGUTWHWP    : DNBXBP         
AEFKGBAIGOIVHMV : JKGLJ           FTSVDGYUF       KMTOEGWEFVL     WSQYC           JHRDLDQPSRKBFLN
DWPTN           : IBIJQUBCM       LEUCGIMJJ       MAKRDXC         VYCHUIXU        XUHGREGLTAHYM   XAEHJCPUGABWIX 
MUFGTNGJSG      : KVVIIPCQUJS     UEPE            BQYYVGQO        DVQK           
ASYBUJHMRD      : PDMXLIYMEDHLINL FVFQG           BLHFHN         
GBHK            : YXIWFA          WVSV           
AEOISJOAFE      : LJKCQ           BIGHXDOC        YQHEXQMVKPSFT   QECCCRAKVMGV    MKQTQSPG       
PWOG            : PNMKPLXGEFEUV   UJRK            YTUHOW          TDXXYIGPBYDWSX  YKHKCVLEEI     
JFXFPHRJM       : WSYBEXHQJKWQKAT BUMRRYYWGL      NCHF           
SOXDO           : SQIAPAXJKMKRUNJ LIWWYWRE        JXJM            IHJTA           KRSOJMBUNS      UUCS           
JDKCOB          : BFNNKBSMDSRLY   YSDEJBWWPQ      RPTNKN          BJECQYWLECHWS   TRYDUAWFHL     
UFMMEDUBNCBUT   : NFEVDXW         MPRYQRSWTWIYT   LLUQMVNQESFC    IEILQRBNIUYEG  
OEXEYO          : IABKK           FYFJAFQGYEHBU   GOXECEMEM      
EFENLP          : QMCU            CYHKHBBQVFVAREC BQYYVGQO        KVKXCLONKI      RHJQQUOQFDKBY  
CSYWYLLDR       : TBQQRBPMTOX     KUYMOQYVK       IHJTA           OSPCYGFNFCW     MHSGHKGUICP     QEHTBXCOBKNUC  
HFJKA           : GDFJPCGCCEX     VBTJBWJBBSWT    GTDK            DACABVLYIRYANRC
VQJVUKKA        : UQIBOFMDPTVDJ   HMBQEPFQVYMER   CGWEAW          YMYNHYVGJ       IOIJSLLBVQ     
RECDV           : YUOSVAHCQOTCHM 
GRVFQJRVBAFI    : WCYMPNIIV       HIVQRQDTAJADDCW RPIOSDOGFCHT    JYUFCCDGTUQRY   BNCETYBODVHWJH 
QKPMBBIW        : ULLPFCIVGN      YFPK            VCRF            NEERDRGFPR      TKINOQHUBN     
UWBMDGSCFYTBGM  : IVFENJRNMIIUSP  OGDUWHFQW       SACXVJIPC      
XKOY            : FYEPYKCLMIV     MKETIVIOLVAQWT  CMPUKHWNPX      QSUWNAALSNH     KBKOADOWBSHNKE  HLICDXFSDSWX   
YKHKCVLEEI      : KMOCWDAJV       GEAHNKJQSUTJM   ATXVIC          PWOG           
BHVN            : BKNXLOO         SSAPYNBUEX      DIJMDDBL       
EIPJHLMOXC      : FWVTKABJVWGB    KCIFJHA         BSSJY           LRKDNRRTNXNEMD  NMUKOJDTXIAYHMA JUMCVUBTC       HTYGKCUVY       WTLJMFCG       
IQPBPBKCF       : RDBLRAVLQGLN    LHNIORGFYFBBRO  HWXKYVNNGO      PMGVCML         PPIMJEGMEJTBN   JBOOAXPMO      
OLKYELHDCWHKOT  : AXAGEIUDCJFPUQG QBUNIYWFNHC     UBNFVJFQURO     XISX            JNAHKAEDAGH    
AILAKCK         : OIBWVJICNEPYE   BUMRRYYWGL      XWAQRD          BNHTNPKSSPAJM  
SMVVWXBEONQO    : BKNXLOO         OMPNW           DJNTWMEXOB      UVGLRNORUOJWE   XENUCC         
FXYJUJV         : NYNJJOHYBKVUUS  UTBQALTCFKAEEVF ETUSJBVCQFOOGDU TIWXKFLAJ      
DQLNELYHXEC     : RTCWSRCSMPGTJ   KARLTJGRLC      AVVIUNALSWO     EDVTVN          HAXTSBHHCSO     HYTXIOTVCIRFR   RASODSS        
AAMBDSPSJENQC   : MLHIGVA         QIRWMVGW        VPMREBBUJYJCUBA WHXRAO          XTHNCWMYSA      UVCBGF         
AYXWKDPVRW      : RIILFNXGJEKRGMA
SGKWIWAI        : GUGAHGVXBBYQKJ  VVLWGC          WLVKDDVIMXFWQ  
DLCSHOAUFE      : KVBBFTCWN       CHATTIBEAIW     GNPMURD         HWSB            TIWXKFLAJ       SOPEAASLFGSVHX 
IGKH            : DXCUVPGEDW      YAWRMOJDV       ANVWCQMEY       KXGPQAPVE      
NYPHVBACLAMJCWS : JHETWSGTEMTJH   PFFVLFJSD       VXWKH           EJFUFLN         UOXMIQROJWDI   
LXCSMCPRJBCP    : XLUN            WMKBOU          PEVCBYODQRFYTTC AGXAIAEAQRWEGB 
JICJXJ          : NYNJJOHYBKVUUS  HTYGKCUVY      
AMKLOW          : CMNGIU          MLHIGVA         SOQOSRYGPQINFT  KGKT           
SUQAIQCBDHQ     : XVVUXKELO       QKTWKDDGBG      MPYAYPYXUKUXXUH OKVE            GPCNTVRTPVPL   
QRAGEJOGUP      : CXLXPCANIMSBN   YRYIELOMAUVWVKA CQKTKDOFDO     
BPENDU          : DEHLPF          POBJJJTMDJATJ   MYSLDCPF       
BNHTNPKSSPAJM   : EIASPYMBVDSJMV  MFQGAI          HVJSIUCOJ       AILAKCK        
COYIYPQVHIWWP   : JAKEMSWNNXED    MHYDMBTHYMPTUS  KAYFHOCTCBAI   
DMAGBJ          : JAKEMSWNNXED    PGTLRICECFPS    FQPLR           KMOCWDAJV       QKGMMFAXU       MYIYVYLTNBWVDJP GOHTPAQGTTPIAV 
QAML            : HIEDQRCRGYINJQ  PQTWRV         
CLFQEHGFR       : YORXLSRNK       OIFTVPMXYDEKTS  YUUCIDWBGBXHHUN
XIDFSDDKP       : IESMVHYNAQEBIJF VWDO            IVNEHNBLS       FJYORWRX       
XROBCQTEDG      : WEDIPOEXQVKNUUO PEWP            PHJDTSC        
HTEABNGGFPEPTK  : DGJR            OMTTRTPEXR      UMNHJIIMXPK     YNETWFUAWBKC    LCFVE           VEINQWDGPCGP   
YPVQAVJOYLFVP   : RNYBXXEJTQYEOO  SCTVNYYBNEHBJQP
EQRXVRBL        : VMJKKKPSPOEOLO  YKPOIM          SWQJTOUYRARSNK  RGKWFTQFHFLGL   SBIMGEVJEPDRUDH GXTWAOLQRPSP   
KRSOJMBUNS      : ACIVUN          VLLWWFCWQRUTT   WBGJUDGSLQQW    BFWG            SOXDO          
FSPOJRCONTYRKSR : LLACWXFVUS      VVLEJUUVSHBCVBR SNTYFTATUPNSDQY MYIYVYLTNBWVDJP
NTUQEMJ         : LAQNIPIYM       QTTRO           IQGINYNKG       DFIMFDOAFYJGUT 
XYYTMTL         : JHMIAPMXOKO     YXNSMRPMXP      ERUDAMA         QWOTVPNU        EIASPYMBVDSJMV  OVWPLD          ETTBXHTSTBSK    RPTNKN         
XYYTMTL         : TKDVKKNAJ      
NDIWUMOIGPCRLUC : LYNTHMFBNYDBBO  JYGBS           FFPRF           UYYLLQCDDWHTN  
QWRWLDTK        : MPYAYPYXUKUXXUH LLMK            FWNAEHOJ       
SERPRL          : SYKCQMSR        WCDLX           YRYIELOMAUVWVKA GBAKT           RASODSS        
UUCS            : EMUQU           SPARUDPTMOT     SOXDO           ALUCTXTNTPRQ   
SDQJGIWDMXVKR   : ALIPKMHWUDVFHA  JQAPP           QCUISRLVKGNW    NTIWEK          TSBCXRIYAHCPCHK
VUOGXKKPAEDF    : EQGVMBUTVNITPX  LNKSVVJQNCT     KMUBS          
XHUIDXYOGJL     : WTSMJHHDLFANJNN BMSM            UFNTLN         
VLFIDAFXPNX     : WTSMJHHDLFANJNN OVDLJUX         QIXUEBPTSJ     
BPCFTHHTQC      : TGQQIBLJXYGA    LWHVHWJAOB      JJAU           
TDDIJO          : VHMDSFR         NFMQLFEFXCOY    MCYVDOBEMJE     VDPEDPGQ       
VNHDVKEDLVRJ    : KUCDA           QNLW            IEUFUVEDOGQIC  
SACXVJIPC       : SPPRYD          FAPAYKFQTYGVF   NYPNLB          DJIJUTTQVDJYOKD MANVYDIEWJYWKTL VVLEJUUVSHBCVBR UWBMDGSCFYTBGM  CONJTFYMPPNYOJ 
SACXVJIPC       : IOIJSLLBVQ     
UWPAHCPEXFNDB   : FKBVHDDGQSRNJT  XMPDSJ          SVNCQ           EYXDXCMU       
JFMHYVHRXJ      : YKPOIM         
TUAKXNFWFFEJ    : YGFOSVN         AVVIUNALSWO     PENFGYWKYY      KXJLPTIBLLE     UEOVDXXHGHTKEUS JMQYDRSYMPANKI  RUICIATJXKE    
KJCBNGC         : WFLSGANVTV      RUFLYFG         TXSM            TPBQJVDUSGX     EKNRYTBXRIUSY   LVNKE          
NOFMKMEJY       : TYSGAHTTGNK     RMEJEXUL       
FTBP            : TEJRSYALWQQSI   DXQGPMVRWFU     QCAXAUNVHHISQ   FQAPJBOB        EEFHYUNLT       ANVWCQMEY       DBREDRYNQ      
OWSVFAGCK       : TNJYQIVS        ERPQ           
FNFNPD          : ALXMRT          PFFVLFJSD      
EKNRYTBXRIUSY   : RXPHIQOCEI      DJIJUTTQVDJYOKD EAUTQDNF        ACCKL           GYQOMGYCTDUJW   CDBDFMXTRWRU    KJCBNGC         DBRDK          
JXKID           : TTHOEE          YLBUPMNA        YDUEFOAIKMMXULO WBGJUDGSLQQW    HVHPNDGEI      
QGWGNLOBBRCIERA : KMVUWVNM        CNNLEB          MDJMQENDWNS     VBBYWOX        
LDEFLBBKTMLE    : NXVCFCTGG       KVVIIPCQUJS     GJJEUBHJVK     
OQLUOU          : BXAGTOSIY       GPMNY           FLPDLCOMWFVRNV  BJIH            QFDYDFCEGXUVKB  FTRQQKHFHFPS    TEPLHKKRBAQEQ  
CJLFDPNHH       : TOJVXNHNKCHU    KMOCWDAJV       IYIPRQUPHTLHSH  UMKC           
MUQQBDTCPOO     : JIQXWQU         UUCGBLPDNNXXKK  SGNWCRQT        QPKHTELKTGLUVI  FTSCAHP        
UMQMXN          : VXEIWRT         LXFTLVCY        CDBDFMXTRWRU    MTIHFGQSNQ      LVXFSOSYA      
UYHE            : TPYBDNAALBSCB   SYXHDSNEJYTJJLE XSKQIJVLFJ      SQOHPOEP       
MHDBOKOC        : SMODTYUV       
GUJL            : TBMQR           XTJMDTWN        TBGPWYYB       
NBGEFBSVPR      : PHBIXHCHNVCVM  
UMKC            : QWKLWWPTLNGME   HJJDCI          CJLFDPNHH      
XPBBQSNHWVNRHY  : QMRODKJ        
WDRE            : NQERXTYKRSGE   
VWGLQRJGDLA     : NFEVDXW         AXGHBCI         ALCIUBLYJYCHKIN QWKLWWPTLNGME   QOODYRBCJ      
DDETVTESQTNAV   : XKYPPGQAFHOANAM
AYREJNBPBSHKBK  : WAJPBKFRAUELL   CPEYNAVNWLAJK   QWOTVPNU        TMOLVPDTWCG     HWXKYVNNGO      TTPYNQASSVV    
BNCETYBODVHWJH  : BFFDOGAH        GRVFQJRVBAFI    RHJQQUOQFDKBY   FQFM           
JHRDLDQPSRKBFLN : AEFKGBAIGOIVHMV
MEGSXFVMISTIE   : RCCJLL          KUBJYQDCGYM     BORAOCAC        BVUSUHG         VWIIAD          WAWKNCILIWH    
BPLVSAYLRU      : THOCCPYAITOB    SAPMTWLIXOTQ    DIKL           
CVLNLPC         : HVDA            LHNSRJCRBVNDKI 
XWOETDOMXYSCDL  : BXSEU           RLYIIFNFMOOVCM  NRBBUGPVMB      LCFVE          
YERA            : EYPYN           OHCTNPIIJJOAY   AANDXRFYL       DKPFPYFMWPNEJ   OQOPLDYRWWJLUKQ WAXJMNJXN      
JWYLUMBHCFYCDPI : NKMDOJCEWVOS    HSBBHTVRXJBAX   RPQQVWIF        LRDBH           OWTITW         
TALTYGXCRND     : VUUMLOM         VBTJBWJBBSWT    QANBQTE         XNQCWDO        
IGRRDQGYDJI     : CIHUFXODNDYO    JJXYO           NEYOK          
PHLUXUR         : NYPNLB          VLLOY           UILVXJRSVDKL    IJOQWMWIQHB    
UFNTLN          : ENNOFNP         UKBFPHWFNVJV    BRISOUEK        OXFIMO          XHUIDXYOGJL    
EDCDLKWEONMPS   : MHDUBQCAAVQPMS  THTXRHA         KGKT           
XCNFNI          : VPTYXVF         ACIVUN          KBOH            TJBPRL         
KAYFHOCTCBAI    : KBOH            XLKOUG          TBPPUYDXJX      COYIYPQVHIWWP  
FTSCAHP         : LTYOMQO         XENUCC          MUQQBDTCPOO    
YKLWOYE         : WFBLUTUPNFFQHK  VWDSMATOSFXPHK  IABKK           RTDUAXOB        KVLFGMXPSI      XJCLLYBFKF     
IKPKLWS         : GQOD           
YOFCON          : YVRTKWFRFRAGCN  OHUSDVELSIG     FDVQRB          IWHHGOIDQYWUR   SMHCHHYUJHNEBLK
TKDVKKNAJ       : XYYTMTL        
LIOMMUUYKGLIBO  : WJPIQQE         NGIEINBTXGYCWHH
PVMGMW          : MHYSXBGF        IWPQSTDLI       NMJDDFGTLMJRF   UMFFUIDQS      
WAXJMNJXN       : HRMLNYCG        JPBA            QEWNLBVJCUEQ    YERA           
GEKUYHUKPGUQWE  : UJAARDKEVFHBSNJ YDUPCWQPXS      ORHYWISWJUPJY   FXIUYAAASOO    
SQOHPOEP        : FOOYSIWIHVJUB   RATF            UWUNBNSLAGPWKRO UYHE           
QECCCRAKVMGV    : ABBYMKYFAHTTT   GHWCEILBXJFFVV  AEOISJOAFE     
DIKL            : SSAPYNBUEX      BPLVSAYLRU      KGKT            XLGOI          
DIJMDDBL        : BXSEU           GLNQ            NVERAYWWYKF     EDJMHL          ONDXCVHOHK      BHVN           
SRLH            : IBIJQUBCM       LTNTX           KFESSEAQBJCKPBH IXXKDHKHSCLJJ  
PMLUEN          : SAWMOPHWO       LEUCGIMJJ       IMSYM           XTCTAIH         VPMREBBUJYJCUBA EEDEW           FSWT           
DAPYVSJGEOK     : BOVLPS          SUSLATUUVYXX    MKHI            SHYE            HVJSIUCOJ      
AWSFAGYSX       : JIPAAFPO        YJMLIXSLSMN     AUVIOPYAPHGAWS 
DJEPUYTI        : NFEVDXW         GBRJGSEPQBMG    TXSM            GFVOCBAJ       
WKYXGSJPW       : CJWLH           DXKPMABEAWW     LSICIYHCDFCCPIT WJXVI          
COBBHGBNHUNT    : LTAOJ           LPNDXEEDLS      RJFI            ETJLSCEEELAKY   ASNODCCVUQGT   
WBPTCJELJ       : TORSKKWV        JYODW           LEJJNKGHMNGYGAB
LJXETNDVPRWQ    : PILX            KSYAHJBCJC      EVGYCVJF       
GTQPOHMO        : EWTEIC          CNNLEB          WKBMLRCCS       HWPOUA         
NEBPQFCCWNL     : QKTWKDDGBG      YYTAEKRVUFKAMXC NEYOK           UWHMARPWUUCGN  
THKYECRD        : OLMBJGAPENL     FHID            NGIEINBTXGYCWHH
ULOM            : QTTRO           BAFRQYLOFP      FWJWKPVOIPEK   
GTOUAE          : HLICDXFSDSWX   
BTSJXUGNIB      : GOKWJNPWWNXUBY  GTIOL           WTTBQDCCHMDH   
QNHWPBAMXMBMQHI : BHTWO           TXFSRABRMMNF    YGFFDRCEFQU     HTYGKCUVY       LSICIYHCDFCCPIT AMHHG          
FJLJM           : COQEQNRWBQ      QKRP            YXIWFA          AYKMSYNHTTJIGFS
EVGYCVJF        : KEDBDVKIYCO     LJXETNDVPRWQ   
AUNYKQAWOMB     : VVKP            GRMFLFGMHY      PGLTVPJ        
FKMMPV          : GNPMURD         MDJMQENDWNS    
BLHFHN          : MVYWXDY         FJDMRTGNQTAEOHB XISDDRL         QJHKRTJXQADXF   QOKYCQP         PQXXKWQGRE      ASYBUJHMRD     
MKQTQSPG        : SAPMTWLIXOTQ    TRVAWLPPFHUILP  AEOISJOAFE     
AWSANHDR        : LGQAIFGBNOFWOU  HPDTERYLJNAWIPC BQJNXKQRDOSFUIF XAEDB          
NFBGDYHOGN      : IDWSHOCAIKPCUM  OLHTKQB         OMVJFHI        
WTLJMFCG        : MSNESPNQOPOPMD  EAUTQDNF        OLEJJMGJATDTPBW BMVSGUX         NJWRHSMRLTWRQU  EIPJHLMOXC     
IBXHVAUFDPRSUS  : YDBVRNESWYXQMB 
XTHNCWMYSA      : BNHVXJCHFTON    IAFWBOIMKVRWVLG AIESLEJUKJL     ENWJH           AAMBDSPSJENQC  
GHMOFWPDGL      : VAKEEEFX        XWAQRD          XPGKUVGAAF     
CQKTKDOFDO      : OIAUQIHYUS      YRDC            MPRYQRSWTWIYT   QVXQTMRHYH      QRAGEJOGUP     
MCDJQFCSPIB     : DEHLPF          YXNSMRPMXP      CKIFUXG         FTRQQKHFHFPS    XKXFCYFQDYLGOE 
WGEOLL          : SIBSGGIM        UIRCAGKQTRTMVT  ANTGEMSDS       OMVJFHI         EAVQ           
QPSBJFGXMJMNVRT : BOCR            VWDO            VDGQFUC        
KBKESUHXU       : UDTIPCGOAO      UYII            RJJXXSSFKYGCH  
DJYQM           : NWHFPMF         BORAOCAC       
GHUPPBPCN       : PHOMDJHGJNIQH   PSDLGVXJGA      CLKVIN         
SLXOTJPGPIDYJ   : RKUIAKVKMYV     FCTADGVATHGW    PLKSXSYFDNXDE   JLNHWOXXMHC     QITUQEDGNM     
MOKNF           : JDOMCQX         PDPUQXQ         GPHECEHIXODXVCH LEXQKWROFGW    
HLICDXFSDSWX    : GVRRDTY         QFTKJW          XKOY            GTOUAE         
XMDJ            : HCKAVANJ        UIIEDVUJQCMB    EXDQSVIWHLUKVQ  WWIGNJK        
JBOOAXPMO       : LHNSRJCRBVNDKI  OSGJPQKLTMPHCH  XLKOUG          IQPBPBKCF      
CVBJHJLMK       : EGPKJGVKETTOYH  WEDIPOEXQVKNUUO CUBROIORPPPCTLN ONDXCVHOHK      DIMM           
FPMF            : CMNGIU          HWXKYVNNGO     
TDCWOIIPYW      : FAPPFRSQ        AEAKRVMB        UUAG            WKVHBVTYHWMST  
XOEOQGLRRUEDI   : EPEMMCWOHXMJ    DQBDYAJ         QCTCR          
XPGKUVGAAF      : YJMLIXSLSMN     HKAJDLWWCTMQNQ  GHMOFWPDGL     
KPGJP           : MNCFWVVWEPDJNG  NAVACWPJ        HYJQANMYJEAUNIS ETHTIOUUIHV    
JEAYVIMP        : LNWW            XKYPPGQAFHOANAM AQGICUYMMIBSNH  XLGOI          
HVFRMEIUQFSA    : MWDEMRCDMQP     XELJQSAE        LDQOOMGNHJ      WWIGNJK        
UFYHXGRPCDT     : HXQVBFKK        VDXSSJSGDGWWOS  BFHDHJUROYJEOEY OJJPHANVSIMAI  
ERPQ            : LTAOJ           UOVSXBPKWTD     FYFJAFQGYEHBU   LFTYGH          OWSVFAGCK      
QBGVSVCBQT      : QACYHYMYKSUNS   KWGORIXDUHM     OOBPBTUJET      APUU            WLXDIKYVVW      TQXAPVAXEADTH   GPWJHJCMLKQW   
MTRHBQRBWJ      : LIWWYWRE        XDNJISPEX      
CONJTFYMPPNYOJ  : OLMBJGAPENL     IBYNYIF         HTVGNGMUF       SACXVJIPC       TBFFJQINBV     
SKNMTAIL        : VUUMLOM         HPOPHRWXRSX     MSXFNPXPEHVJD  
MFCNCNHGCUPXCPL : WJLCSSAD        PKSXHED         KXGPQAPVE       SUCDMQJXUISI   
HYTXIOTVCIRFR   : HIEDQRCRGYINJQ  DQLNELYHXEC    
PGLTVPJ         : NWJLJNIDJXNDNN  QOYUF           PJQSAQLWBFEBTA  YOVSUCPSNSYPT   NGMNXFC         VDEWUVLFJNOLCQ  AUNYKQAWOMB    
WLXOKBGXVQYPQI  : TAQJDC          QCAXAUNVHHISQ   SROQKDYKVOJY    KLLBEMQ        
KGKT            : JUTTLHRLXP      ORHYWISWJUPJY   QGRURJLJXQIRTM  AMKLOW          EDCDLKWEONMPS   DIKL           
PNGHT           : OLPOTLOYJSE     HVJSIUCOJ      
BPMMVLYVALY     : MSKAAD          LPBY            UWHMARPWUUCGN  
LUAKMQUUCB      : LMWBE           FRQCTWUPK      
VCVLKGFHJWTWUF  : YSNY            POCVRIGXFWOPS  
RHJQQUOQFDKBY   : VMPGRVPDVPFMC   BQIFCPNNRTMKI   TRYDUAWFHL      EFENLP          BNCETYBODVHWJH 
EFKIDVVJD       : IQQWYDLLKWP     TSVKYICTGOY     FTCBEWGXKGR     MEIAIPD        
TAWQVEOPLAGD    : YTUHOW          QFDYDFCEGXUVKB  PPIMJEGMEJTBN   IPARMRFOEYISFT 
UVCBGF          : LIWWYWRE        GXECEVVLHYTJTNR RKDOQEFKAQ      DLVJFUWNKUPQ    RQGFABXFR       HTYGKCUVY       AAMBDSPSJENQC  
UMFFUIDQS       : LIPKYCTU        TSVKYICTGOY     PVMGMW         
VOJSF           : LGUAXUVYIAN    
WVYLVFOSDKUET   : AKSOYE          BORAOCAC        EXDQSVIWHLUKVQ  LDLL           
EORLUMVAGQJ     : GHOTSDM         HCKAVANJ        KUBJYQDCGYM     CSEXSKPR        IVFENJRNMIIUSP 
FSXMC           : MANVYDIEWJYWKTL QEXRO           MJNIXOQTRXS     XXHABFHRGTST    GTIOL          
IBIEIYWN        : UBFXI           BXSEU           GHWCEILBXJFFVV  YLLLJSPKXI      VBBYWOX        
URGAXUR         : RNJUCDEM        PAIAPMGXFCMIVQ  WELJVQWYFJXKI   NRFM            XIQT            CBXEVOKPCPHOC  
RGISOYCT        : DXBJA           HRMLNYCG        GQOD            WJPIQQE         TPIGJKB        
WTTBQDCCHMDH    : TAWTIHUKP       RPRN            TKINOQHUBN      BTSJXUGNIB     
PEUVETTXHLEPGT  : AKSOYE          EQYSKKUCHRP     AIDGRLFW        MMYHINFCKK      QCHBM          
INYHHSIA        : RUWXSF          TJQVPSLVC       HFSTQYG         KMFMG           WHXDRRQVOJKI    VCPTBSFKBQ     
MEIAIPD         : BLNGDYBKBO      TAYVXR          CKIFUXG         EFKIDVVJD      
TXWATQXCECTL    : CHYYHC          CKIFUXG        
LVNKE           : PWLDDOYGJS      LLBMXQBIYCG     UAIYI           AEAKRVMB        KJCBNGC        
GOXECEMEM       : SGJPVGUKWXRNX   BORAOCAC        FFUBSOWKM       TWKGPVCFSB      OEXEYO         
JNAHKAEDAGH     : TAWTIHUKP       GNBGOMRRP       UMNHJIIMXPK     YHXAOL          OLKYELHDCWHKOT 
CSDO            : JKGLJ           QIODJQLNEUAUYP 
RBVOHKO         : MITXTRQM        SWETP           TTAKQOSGAMTURF  PQXXKWQGRE     
OTBUIGE         : RPMR            YSXIHAKQMRRNLOT AVJFXH          WGWT            RUXVSX          IHJTA           UFEMLAPANAOSSWU WDFR           
IOIJSLLBVQ      : DAQVSPYQPTQG    FLPDLCOMWFVRNV  MFGRPY          FYVURWFVQMIQNN  BTIYA           VDXSSJSGDGWWOS  TBDBIWGSWIBB    VQJVUKKA       
IOIJSLLBVQ      : SACXVJIPC      
OWRGQTCH        : QDYLLOWUDMHBBR  VWSBIXQMNLGMUY  LCYF            FHASEBK        
NWRC            : JTPHIDHTRFLTWKT JIPAAFPO        XANFQUQ         CPMRIFVESJPXW   IVRGFWVRO       MMYHINFCKK      SBIMGEVJEPDRUDH
TADCECKSKVL     : ENLNGVRXF       DWKAQI          YYRRQPDFGPW     LWCD            WSQYC          
KMUBS           : OHJIYW          QNRXJYLFHQ      VUOGXKKPAEDF   
XMSQGUY         : XVVUXKELO       HJTJXQRTCOSL    HMLY            IEILQRBNIUYEG  
KXGPQAPVE       : BJIH            AIAOQGIKCC      NUDOLJXQRVHGJK  SAWNAFRUTXE     IGKH            MFCNCNHGCUPXCPL
XRPJPDKASHELSE  : LCQXYGS         FAXOETCWC       QHXW            FDGPAQIF        WMBEO          
NVHLUT          : VBTJBWJBBSWT   
SANLDDHJAGDR    : ETTBXHTSTBSK   
TUEVNLAYGFAUBH  : CYHKHBBQVFVAREC JFEWYKVRCLXDNTG ODYOC           DOQTMOAYFFLT    OMVJFHI        
VDGQFUC         : CERH            JRGJUTHCOLXDWUN CWDGXRTCDD      QPSBJFGXMJMNVRT
ALUCTXTNTPRQ    : PJYVGIY         QNRXJYLFHQ      PQFIFHYQOKH     OVWPLD          AUYKEN          XAEDB           UUCS           
FQFM            : GHFU            VUMJEBWI        MCONXWQPBYA     YLLLJSPKXI      BNCETYBODVHWJH  RMEJEXUL       
FJYORWRX        : AOMWCQUQ        GBRJGSEPQBMG    NRPGCHAPKNUXU   FPAUUYCVSKRII   XIDFSDDKP      
WURIVEDXA       : RCCJLL          EIBL            ARQBQLFC        NWSCLFTIQEECV  
UOXMIQROJWDI    : LHLKWKUXACNDKYH WMDC            RUHPCXLLTI      KIYXVAEMNYCR    NYPHVBACLAMJCWS
MHSGHKGUICP     : YGFOSVN         HERFQCTHCU      JGIH            KJFTNKABNHJN    CSYWYLLDR      
ATVAVYUKYHVPA   : XLUN            VXDGHNQRIQCM    BOAFEUHCFVA     NENGWOENMX     
AYPKG           : DBGWQGCKRCS     ETLWHNFAKPRYOVE
RYKBMSWWUMP     : NWHFPMF         VJRHUGGHVFUT    BJIH            FXIUYAAASOO    
ILXEMUROFPEFCG  : WMSAK           GMJJO           UCNTTA          WELJVQWYFJXKI   WFLSGANVTV      LEXQKWROFGW    
RSMXLOKOBDLA    : LUKG            YTWNB          
APVKDVRRRJGWBN  : BGUEVKMR        KGXITFTLBR     
DVMWPAUD        : SOAEQIMKYAIAKC  ABBYMKYFAHTTT   MRVCHIDBWITO    DWBHUEHMWQWA   
FRRIERJGJ       : IQGINYNKG       PMGVCML         CEERVOGDJWD     WOUYWTG         ROBXCCL        
RMEJEXUL        : PMJODKJW        QANBQTE         NOFMKMEJY       FQFM           
VBBYWOX         : GABHMHKVTUL     NKDUNILSKGPVIXV QGWGNLOBBRCIERA IBIEIYWN       
QSPHXIBIO       : NWJAOHPBGLE     NVYJUTYBNFXNTUI TNKKX           FAFNETRTESWTD   GXTWAOLQRPSP    MIGGWIFWYMGINPO
SUCDMQJXUISI    : LCQXYGS         UAUIOVRWLWBY    MFCNCNHGCUPXCPL
OJJPHANVSIMAI   : UUCGBLPDNNXXKK  IWHHGOIDQYWUR   KUEOQXFONMFJVL  UFYHXGRPCDT    
BRJV            : SOJUIXJJP       FXKJLEMOCTEXIH  QCHBM           GFWQ           
GAPTQYTNJNY     : SEBAFMVBKNQ     FVFQG          
EIDURFKQX       : GJJEUBHJVK     
DACABVLYIRYANRC : EDJMHL          SFXFOREAP       HFJKA          
FLVEFCPKWJ      : EWPNYMWVGGK    
KANGDNIFQHQRP   : MKKLNBWADYG    
QSWIUFQIDUQGMBF : UJRK            WSYBEXHQJKWQKAT AOFP            WRTSO           YLFAGWWXRNTT   
RRYHXDXJI       : FMMD            CEDYELLGG       KMTOEGWEFVL    
QCJILCBIN       : QMCU            QTTRO           OHDPNPAXEN      GPHECEHIXODXVCH VXWKH           PHPYDD          FWJWKPVOIPEK   
QEHTBXCOBKNUC   : MNCFWVVWEPDJNG  JJXYO           CSYWYLLDR      
DBRDK           : LNWW            WOMKAI          WSQYC           EKNRYTBXRIUSY  
TBFFJQINBV      : DYAODFCNHNPL    CONJTFYMPPNYOJ 
RASODSS         : EYXBGCCULGL     GFWQ            AXVDAFEEKDPOKNT DQLNELYHXEC     SERPRL         
WDFR            : NWJAOHPBGLE     OTBUIGE        
UWHMARPWUUCGN   : DIMCQQOXDRXBAGM NEBPQFCCWNL     BPMMVLYVALY    
TPIGJKB         : PEWP            RGISOYCT       
OWTITW          : ETJBENKCICC     VEPCWFMSCYEDE   JWYLUMBHCFYCDPI
LDLL            : QORRDWEPL       HSBBHTVRXJBAX   QWXYTOQOV       IFVDUXLBNBMIM   DJNEV           WVYLVFOSDKUET  
XLGOI           : VMPGRVPDVPFMC   FOOENC          NSIIJQ          DIKL            JEAYVIMP       
LNKAAERLKBVMC   : XNRPAHK         PUXRKXK        
LVXFSOSYA       : QEAELET         UMQMXN         
